Empty_Lines,Lines_Of_Comments,Lines_Of_Program,Physic_Lines,n1_Number_Of_Distinct_Operators,n2_Number_Of_Distinct_Operands,n_Program_Vocabulary,N1_Total_Number_Of_Operators,N2_Total_Number_Of_Operands,N_Program_Length,B_Number_of_Delivered_Bugs_1,B_Number_of_Delivered_Bugs_2,D_Difficulty,E_Effort,T_Time_Required_To_Program,V_Volume,_N_Calculated_Program_Length,McCab_Number,IsVulnerable
0,0,73,73,28,68,96,488,313,801,0.000333,1.758185,56,295375.0779,16409.72655,5274.554963,548.553411,19,2
0,0,73,73,28,68,96,488,313,801,0.000333,1.758185,56,295375.0779,16409.72655,5274.554963,548.553411,19,2
0,0,63,63,30,78,108,412,278,690,0.000333,1.553624,45,209739.2569,11652.18094,4660.872376,637.468091,13,2
0,0,36,36,29,57,86,227,141,368,0.000333,0.788288,28,66216.23203,3678.679557,2364.86543,473.35618,10,2
0,0,11,11,12,23,35,50,45,95,0.000333,0.162427,6,2923.69132,162.427296,487.281887,147.061475,2,2
0,0,4,4,7,7,14,22,15,37,0.000333,0.046957,6,845.232793,46.957377,140.872132,39.302969,1,2
0,0,4,4,7,5,12,14,9,23,0.000333,0.027485,3,247.362413,13.742356,82.454138,31.261125,1,2
0,0,97,97,27,79,106,503,376,879,0.000333,1.971281,52,307519.7881,17084.43267,5913.84208,626.380642,19,2
0,0,97,97,27,79,106,503,376,879,0.000333,1.971281,52,307519.7881,17084.43267,5913.84208,626.380642,19,2
0,0,3,3,8,11,19,22,15,37,0.000333,0.052391,4,628.693272,34.927404,157.173318,62.053748,1,2
0,0,11,11,12,23,35,50,45,95,0.000333,0.162427,6,2923.69132,162.427296,487.281887,147.061475,2,2
0,0,5,5,12,15,27,34,23,57,0.000333,0.090343,6,1626.171526,90.342863,271.028588,101.622909,2,2
0,0,8,8,19,23,42,51,39,90,0.000333,0.16177,9,4367.777112,242.654284,485.308568,184.752548,2,2
0,0,93,93,29,73,102,646,403,1049,0.000333,2.333125,70,489956.1929,27219.78849,6999.374184,592.738642,23,2
0,0,3,3,9,6,15,11,9,20,0.000333,0.026046,4,312.551248,17.363958,78.137812,44.0391,1,2
0,0,46,46,13,25,38,313,184,497,0.000333,0.869407,42,109545.2389,6085.846606,2608.219974,164.202121,2,2
0,0,51,51,28,73,101,340,213,553,0.000333,1.22733,28,103095.7466,5727.541478,3681.99095,586.463131,14,2
0,0,60,60,19,47,66,359,254,613,0.000333,1.235071,45,166734.6118,9263.033988,3705.213595,341.776299,7,2
0,0,3,3,9,8,17,15,10,25,0.000333,0.034062,4,408.746284,22.708127,102.186571,52.529325,2,2
0,0,3,3,7,8,15,10,10,20,0.000333,0.026046,3,234.413436,13.022969,78.137812,43.651484,1,2
0,0,34,34,16,41,57,224,168,392,0.000333,0.762164,32,73167.77234,4064.876241,2286.492886,283.659632,1,2
0,0,3,3,7,10,17,11,12,23,0.000333,0.031337,3,282.034936,15.668608,94.011645,52.870765,1,2
0,0,9,9,14,18,32,58,40,98,0.000333,0.163333,14,6860,381.111111,490,128.361619,2,2
0,0,8,8,12,18,30,42,27,69,0.000333,0.112858,6,2031.452707,112.858484,338.575451,118.0782,4,2
0,0,8,8,12,14,26,48,27,75,0.000333,0.117511,6,2115.197873,117.510993,352.532979,96.322519,5,2
0,0,52,52,28,46,74,351,252,603,0.000333,1.2481,70,262101.0266,14561.16814,3744.300379,388.689788,9,2
0,0,11,11,12,15,27,55,47,102,0.000333,0.161666,18,8729.973454,484.998525,484.998525,101.622909,2,2
0,0,9,9,12,13,25,46,37,83,0.000333,0.12848,12,4625.280765,256.960043,385.440064,91.125266,2,2
0,0,40,40,21,58,79,260,191,451,0.000333,0.947668,30,85290.15352,4738.341862,2843.005117,432.001564,23,2
0,0,4,4,11,10,21,18,15,33,0.000333,0.048315,5,724.732375,40.26291,144.946475,71.273029,1,2
0,0,12,12,10,12,22,57,36,93,0.000333,0.138242,15,6220.907108,345.60595,414.727141,76.238831,3,2
0,0,12,12,10,12,22,57,36,93,0.000333,0.138242,15,6220.907108,345.60595,414.727141,76.238831,3,2
0,0,44,44,22,47,69,284,207,491,0.000333,0.999762,44,131968.5624,7331.586798,2999.285508,359.173172,8,2
0,0,14,14,16,19,35,70,49,119,0.000333,0.203462,16,9766.154864,542.564159,610.384679,144.710623,1,2
0,0,7,7,8,16,24,41,35,76,0.000333,0.116152,8,2787.6572,154.869844,348.45715,88,7,2
0,0,7,7,8,16,24,41,35,76,0.000333,0.116152,8,2787.6572,154.869844,348.45715,88,7,2
0,0,4,4,6,7,13,16,12,28,0.000333,0.034537,3,310.836936,17.268719,103.612312,35.161259,2,2
0,0,43,43,20,42,62,285,183,468,0.000333,0.928855,40,111462.5549,6192.364163,2786.563873,312.915894,2,2
0,0,11,11,13,25,38,46,43,89,0.000333,0.155689,6,2802.393292,155.688516,467.065549,164.202121,1,2
0,0,8,8,12,20,32,66,41,107,0.000333,0.178333,12,6420,356.666667,535,129.458112,1,2
0,0,8,8,12,20,32,66,41,107,0.000333,0.178333,12,6420,356.666667,535,129.458112,1,2
0,0,3,3,9,8,17,19,15,34,0.000333,0.046325,4,555.894946,30.883053,138.973737,52.529325,1,2
0,0,23,23,21,39,60,123,83,206,0.000333,0.405606,20,24336.38925,1352.021625,1216.819463,298.369352,5,2
0,0,33,33,13,25,38,197,131,328,0.000333,0.573773,30,51639.60673,2868.867041,1721.320224,164.202121,2,2
0,0,48,48,20,41,61,333,220,553,0.000333,1.093233,50,163984.8874,9110.271521,3279.697748,306.098194,2,2
0,0,9,9,14,19,33,55,37,92,0.000333,0.154695,7,3248.589813,180.477212,464.084259,134.013592,2,2
0,0,65,65,21,68,89,333,269,602,0.000333,1.299464,30,116951.7458,6497.319209,3898.391525,506.186139,34,2
0,0,5,5,9,10,19,37,22,59,0.000333,0.083543,8,2005.021786,111.390099,250.627723,61.748606,1,2
0,0,8,8,12,20,32,66,41,107,0.000333,0.178333,12,6420,356.666667,535,129.458112,1,2
0,0,8,8,12,20,32,66,41,107,0.000333,0.178333,12,6420,356.666667,535,129.458112,1,2
0,0,12,12,10,12,22,57,36,93,0.000333,0.138242,15,6220.907108,345.60595,414.727141,76.238831,3,2
0,0,12,12,10,12,22,57,36,93,0.000333,0.138242,15,6220.907108,345.60595,414.727141,76.238831,3,2
0,0,12,12,10,12,22,51,33,84,0.000333,0.124864,10,3745.92256,208.106809,374.592256,76.238831,2,2
0,0,67,67,24,45,69,429,309,738,0.000333,1.502697,72,324582.5555,18032.3642,4508.091049,357.172489,21,2
0,0,34,34,20,33,53,195,157,352,0.000333,0.672076,40,80649.12,4480.506667,2016.228,252.903568,3,2
0,0,42,42,20,34,54,237,191,428,0.000333,0.821031,50,123154.5925,6841.921808,2463.091851,259.412299,5,2
0,0,11,11,12,17,29,54,36,90,0.000333,0.145739,12,5246.619475,291.47886,437.21829,112.506418,2,2
0,0,11,11,12,17,29,54,36,90,0.000333,0.145739,12,5246.619475,291.47886,437.21829,112.506418,2,2
0,0,69,69,28,66,94,450,292,742,0.000333,1.621168,56,272356.276,15130.90422,4863.504928,533.53595,15,2
0,0,3,3,7,8,15,10,10,20,0.000333,0.026046,3,234.413436,13.022969,78.137812,43.651484,1,2
0,0,4,4,9,7,16,30,19,49,0.000333,0.065333,8,1568,87.111111,196,48.180809,1,2
0,0,25,25,18,45,63,173,121,294,0.000333,0.585773,18,31631.76536,1757.320298,1757.320298,322.192039,17,2
0,0,7,7,9,19,28,53,42,95,0.000333,0.152233,8,3653.589741,202.977208,456.698718,109.239948,1,2
0,0,3,3,10,14,24,23,24,47,0.000333,0.071831,5,1077.466188,59.859233,215.493238,86.52225,1,2
0,0,42,42,20,54,74,245,157,402,0.000333,0.832067,20,49924.00506,2773.555837,2496.200253,397.202487,18,2
0,0,59,59,26,65,91,441,263,704,0.000333,1.527162,52,238237.3462,13235.40812,4581.487427,513.665341,16,2
0,0,7,7,8,13,21,33,28,61,0.000333,0.08931,8,2143.450902,119.080606,267.931363,72.105716,6,2
0,0,7,7,8,13,21,33,28,61,0.000333,0.08931,8,2143.450902,119.080606,267.931363,72.105716,6,2
0,0,39,39,18,50,68,256,216,472,0.000333,0.957761,36,103438.1686,5746.564922,2873.282461,357.25146,1,2
0,0,19,19,19,36,55,102,68,170,0.000333,0.32761,9,8845.480362,491.415576,982.831151,266.827923,5,2
0,0,28,28,17,41,58,164,130,294,0.000333,0.574082,24,41333.9139,2296.32855,1722.246413,289.1465,1,2
0,0,19,19,14,34,48,138,125,263,0.000333,0.489615,21,30845.74789,1713.652661,1468.845138,226.276706,1,2
0,0,59,59,25,49,74,406,293,699,0.000333,1.446803,60,260424.4742,14468.02634,4340.407903,391.217187,18,2
0,0,18,18,11,31,42,80,81,161,0.000333,0.289388,10,8681.631051,482.312836,868.163105,191.633833,1,2
0,0,41,41,19,46,65,237,182,419,0.000333,0.841124,27,68131.04707,3785.05817,2523.372114,334.794473,2,2
0,0,4,4,6,7,13,11,11,22,0.000333,0.027137,3,244.229021,13.568279,81.409674,35.161259,1,2
0,0,10,10,16,22,38,51,32,83,0.000333,0.145193,8,3484.623869,193.590215,435.577984,162.107496,3,2
0,0,7,7,8,13,21,33,28,61,0.000333,0.08931,8,2143.450902,119.080606,267.931363,72.105716,6,2
0,0,7,7,8,13,21,33,28,61,0.000333,0.08931,8,2143.450902,119.080606,267.931363,72.105716,6,2
0,0,59,59,28,87,115,361,230,591,0.000333,1.348562,28,113279.1694,6293.287187,4045.68462,695.142022,13,2
0,0,59,59,28,87,115,361,230,591,0.000333,1.348562,28,113279.1694,6293.287187,4045.68462,695.142022,13,2
0,0,7,7,8,16,24,41,35,76,0.000333,0.116152,8,2787.6572,154.869844,348.45715,88,7,2
0,0,12,12,10,12,22,51,33,84,0.000333,0.124864,10,3745.92256,208.106809,374.592256,76.238831,2,2
0,0,33,33,16,41,57,220,159,379,0.000333,0.736888,24,53055.96757,2947.553754,2210.665315,283.659632,1,2
0,0,8,8,12,13,25,43,35,78,0.000333,0.12074,12,4346.649394,241.480522,362.220783,91.125266,2,2
0,0,58,58,27,40,67,289,204,493,0.000333,0.996861,65,194387.8281,10799.32378,2990.581971,341.259086,2,2
1,0,13,14,13,24,37,46,45,91,0.000333,0.15802,6,2844.361538,158.020085,474.060256,158.144816,1,2
0,0,8,8,12,20,32,66,41,107,0.000333,0.178333,12,6420,356.666667,535,129.458112,1,2
0,0,8,8,12,20,32,66,41,107,0.000333,0.178333,12,6420,356.666667,535,129.458112,1,2
0,0,27,27,19,28,47,156,90,246,0.000333,0.455476,27,36893.57915,2049.643286,1366.428858,215.316561,2,2
0,0,9,9,16,17,33,54,35,89,0.000333,0.14965,16,7183.217226,399.067624,448.951077,133.486868,5,2
0,0,4,4,8,12,20,24,17,41,0.000333,0.059066,4,708.796208,39.377567,177.199052,67.01955,1,2
0,0,7,7,10,14,24,40,27,67,0.000333,0.102397,5,1535.962438,85.331247,307.192488,86.52225,1,2
0,0,4,4,6,9,15,15,12,27,0.000333,0.035162,3,316.458138,17.581008,105.486046,44.0391,1,2
0,0,4,4,11,11,22,22,14,36,0.000333,0.053513,5,802.697691,44.594316,160.539538,76.107496,3,2
0,0,3,3,8,7,15,15,9,24,0.000333,0.031255,4,375.061497,20.83675,93.765374,43.651484,3,2
0,0,17,17,22,24,46,117,69,186,0.000333,0.342461,22,22602.41552,1255.689751,1027.382524,208.146596,8,2
0,0,31,31,12,43,55,157,128,285,0.000333,0.549229,12,19772.25022,1098.458346,1647.687518,276.348934,1,2
0,0,5,5,8,10,18,28,17,45,0.000333,0.062549,4,750.5865,41.69925,187.646625,57.219281,1,2
0,0,7,7,9,12,21,34,20,54,0.000333,0.079062,4,948.740563,52.707809,237.185141,71.548875,1,2
0,0,6,6,9,13,22,27,21,48,0.000333,0.071351,4,856.210871,47.567271,214.052718,76.635041,1,2
0,0,3,3,8,7,15,13,9,22,0.000333,0.028651,4,343.806372,19.100354,85.951593,43.651484,1,2
0,0,9,9,16,17,33,54,35,89,0.000333,0.14965,16,7183.217226,399.067624,448.951077,133.486868,5,2
0,0,4,4,8,10,18,26,18,44,0.000333,0.061159,4,733.9068,40.7726,183.4767,57.219281,1,2
0,0,6,6,8,12,20,37,25,62,0.000333,0.08932,8,2143.676335,119.09313,267.959542,67.01955,1,2
0,0,5,5,7,9,16,23,14,37,0.000333,0.049333,3,444,24.666667,148,48.180809,1,2
0,0,5,5,10,9,19,26,15,41,0.000333,0.058055,5,870.82514,48.379174,174.165028,61.748606,1,2
0,0,3,3,8,7,15,15,9,24,0.000333,0.031255,4,375.061497,20.83675,93.765374,43.651484,3,2
0,0,8,8,10,14,24,48,32,80,0.000333,0.122266,10,3667.970001,203.776111,366.797,86.52225,1,2
0,0,5,5,8,16,24,32,27,59,0.000333,0.090171,4,1082.05115,60.113953,270.512788,88,1,2
0,0,46,46,18,48,66,294,177,471,0.000333,0.94897,27,76866.56002,4270.364445,2846.90963,343.13685,7,2
0,0,59,59,19,43,62,355,257,612,0.000333,1.214656,45,163978.5664,9109.920355,3643.968142,314.040007,1,2
0,0,8,8,10,10,20,58,36,94,0.000333,0.13542,15,6093.918614,338.551034,406.261241,66.438562,6,2
0,0,18,18,17,24,41,103,65,168,0.000333,0.300023,16,14401.09979,800.061099,900.068737,179.525968,2,2
0,0,3,3,9,7,16,19,11,30,0.000333,0.04,4,480,26.666667,120,48.180809,1,2
0,0,5,5,7,7,14,16,11,27,0.000333,0.034266,3,308.395749,17.133097,102.798583,39.302969,1,2
0,0,7,7,10,14,24,40,27,67,0.000333,0.102397,5,1535.962438,85.331247,307.192488,86.52225,1,2
0,0,3,3,7,7,14,10,8,18,0.000333,0.022844,3,205.597166,11.422065,68.532389,39.302969,3,2
0,0,7,7,10,14,24,40,27,67,0.000333,0.102397,5,1535.962438,85.331247,307.192488,86.52225,1,2
0,0,5,5,8,10,18,28,17,45,0.000333,0.062549,4,750.5865,41.69925,187.646625,57.219281,1,2
0,0,5,5,10,10,20,29,17,46,0.000333,0.06627,5,994.043462,55.224637,198.808692,66.438562,1,2
0,0,3,3,8,7,15,20,12,32,0.000333,0.041673,4,500.081996,27.782333,125.020499,43.651484,1,2
0,0,5,5,8,10,18,28,17,45,0.000333,0.062549,4,750.5865,41.69925,187.646625,57.219281,1,2
0,0,6,6,7,9,16,20,15,35,0.000333,0.046667,3,420,23.333333,140,48.180809,1,2
0,0,3,3,8,7,15,20,12,32,0.000333,0.041673,4,500.081996,27.782333,125.020499,43.651484,1,2
0,0,69,69,19,55,74,469,344,813,0.000333,1.682762,54,272607.4217,15144.85676,5048.285586,398.685407,6,2
0,0,5,5,8,8,16,19,12,31,0.000333,0.041333,4,496,27.555556,124,48,1,2
0,0,5,5,7,7,14,17,13,30,0.000333,0.038074,3,342.661943,19.036775,114.220648,39.302969,1,2
0,0,5,5,10,10,20,33,18,51,0.000333,0.073473,5,1102.091664,61.227315,220.418333,66.438562,1,2
0,0,5,5,12,12,24,25,16,41,0.000333,0.062661,6,1127.900775,62.661154,187.983463,86.0391,3,2
0,0,9,9,12,11,23,44,28,72,0.000333,0.108565,12,3908.35753,217.130974,325.696461,81.073298,1,2
0,0,6,6,8,11,19,32,20,52,0.000333,0.073631,4,883.568923,49.087162,220.892231,62.053748,1,2
0,0,25,25,14,34,48,155,74,229,0.000333,0.426319,14,17905.38978,994.743877,1278.956413,226.276706,10,2
0,0,6,6,8,11,19,31,18,49,0.000333,0.069383,4,832.593793,46.255211,208.148448,62.053748,1,2
0,0,7,7,10,11,21,31,20,51,0.000333,0.074669,5,1120.040943,62.224497,224.008189,71.273029,1,2
0,0,4,4,9,9,18,22,13,35,0.000333,0.048649,4,583.7895,32.43275,145.947375,57.05865,3,2
0,0,4,4,8,15,23,19,19,38,0.000333,0.057298,4,687.581417,38.198968,171.895354,82.603359,1,2
0,0,12,12,15,24,39,80,39,119,0.000333,0.209654,7,4402.740048,244.596669,628.962864,168.642459,5,2
0,0,3,3,7,7,14,10,8,18,0.000333,0.022844,3,205.597166,11.422065,68.532389,39.302969,3,2
0,0,5,5,10,10,20,29,17,46,0.000333,0.06627,5,994.043462,55.224637,198.808692,66.438562,1,2
0,0,8,8,13,13,26,48,31,79,0.000333,0.123778,12,4456.016853,247.556492,371.334738,96.211433,6,2
0,0,7,7,8,11,19,30,21,51,0.000333,0.072215,4,866.577213,48.143178,216.644303,62.053748,1,2
0,0,5,5,7,9,16,23,14,37,0.000333,0.049333,3,444,24.666667,148,48.180809,1,2
0,0,19,19,16,28,44,134,79,213,0.000333,0.38762,16,18605.74296,1033.652386,1162.858935,198.605938,5,2
0,0,5,5,7,8,15,17,12,29,0.000333,0.037767,3,339.899482,18.883305,113.299827,43.651484,1,2
0,0,4,4,7,13,20,18,17,35,0.000333,0.050422,3,453.80245,25.211247,151.267483,67.757201,1,2
0,0,18,18,16,22,38,89,59,148,0.000333,0.258898,16,12427.09235,690.39402,776.693272,162.107496,2,2
0,0,26,26,12,34,46,148,86,234,0.000333,0.430838,12,15510.16197,861.675665,1292.513498,215.993287,1,2
0,0,14,14,17,20,37,81,54,135,0.000333,0.234425,16,11252.41927,625.134404,703.276204,155.92543,2,2
0,0,4,4,9,10,19,19,13,32,0.000333,0.045311,4,543.734722,30.207485,135.93368,61.748606,3,2
0,0,3,3,9,8,17,16,10,26,0.000333,0.035425,4,425.096135,23.616452,106.274034,52.529325,3,2
0,0,4,4,10,9,19,20,12,32,0.000333,0.045311,5,679.668402,37.759356,135.93368,61.748606,3,2
0,0,6,6,13,12,25,39,24,63,0.000333,0.097521,12,3510.755279,195.04196,292.56294,91.125266,5,2
0,0,4,4,10,8,18,20,11,31,0.000333,0.043089,5,646.338375,35.907688,129.267675,57.219281,3,2
0,0,4,4,7,12,19,15,15,30,0.000333,0.042479,3,382.313476,21.239638,127.437825,62.671034,1,2
0,0,4,4,7,13,20,16,16,32,0.000333,0.046101,3,414.905097,23.050283,138.301699,67.757201,1,2
0,0,5,5,10,9,19,26,15,41,0.000333,0.058055,5,870.82514,48.379174,174.165028,61.748606,1,2
0,0,6,6,13,11,24,38,23,61,0.000333,0.093228,12,3356.192551,186.455142,279.682713,86.159464,4,2
0,0,3,3,7,7,14,10,8,18,0.000333,0.022844,3,205.597166,11.422065,68.532389,39.302969,3,2
0,0,4,4,10,8,18,20,11,31,0.000333,0.043089,5,646.338375,35.907688,129.267675,57.219281,3,2
0,0,5,5,10,10,20,29,17,46,0.000333,0.06627,5,994.043462,55.224637,198.808692,66.438562,1,2
0,0,3,3,9,8,17,16,11,27,0.000333,0.036787,4,441.445987,24.524777,110.361497,52.529325,2,2
0,0,6,6,7,13,20,35,24,59,0.000333,0.084998,3,764.981273,42.49896,254.993758,67.757201,1,2
0,0,3,3,9,7,16,19,11,30,0.000333,0.04,4,480,26.666667,120,48.180809,4,2
0,0,7,7,9,12,21,34,20,54,0.000333,0.079062,4,948.740563,52.707809,237.185141,71.548875,1,2
0,0,5,5,8,10,18,28,17,45,0.000333,0.062549,4,750.5865,41.69925,187.646625,57.219281,1,2
0,0,4,4,7,8,15,21,12,33,0.000333,0.042976,3,386.782169,21.487898,128.92739,43.651484,1,2
0,0,4,4,9,9,18,22,13,35,0.000333,0.048649,4,583.7895,32.43275,145.947375,57.05865,3,2
0,0,3,3,8,7,15,15,9,24,0.000333,0.031255,4,375.061497,20.83675,93.765374,43.651484,3,2
0,0,6,6,9,9,18,30,19,49,0.000333,0.068109,8,1634.610601,90.8117,204.326325,57.05865,1,2
0,0,8,8,14,12,26,44,27,71,0.000333,0.111244,14,4672.23708,259.568727,333.73122,96.322519,4,2
0,0,5,5,8,11,19,33,18,51,0.000333,0.072215,4,866.577213,48.143178,216.644303,62.053748,1,2
0,0,4,4,7,14,21,18,18,36,0.000333,0.052708,3,474.370282,26.353905,158.123427,72.954453,1,2
0,0,4,4,9,8,17,20,12,32,0.000333,0.0436,4,523.195244,29.066402,130.798811,52.529325,1,2
0,0,14,14,18,17,35,89,51,140,0.000333,0.239367,27,19388.6898,1077.149434,718.099622,144.545518,4,2
0,0,4,4,12,11,23,32,19,51,0.000333,0.076901,6,1384.209959,76.900553,230.70166,81.073298,1,2
0,0,3,3,8,7,15,15,9,24,0.000333,0.031255,4,375.061497,20.83675,93.765374,43.651484,3,2
0,0,4,4,6,10,16,19,15,34,0.000333,0.045333,3,408,22.666667,136,48.729056,1,2
0,0,5,5,8,8,16,22,14,36,0.000333,0.048,4,576,32,144,48,1,2
0,0,3,3,8,6,14,11,9,20,0.000333,0.025382,4,304.588394,16.921577,76.147098,39.509775,1,2
0,0,3,3,9,7,16,19,11,30,0.000333,0.04,4,480,26.666667,120,48.180809,1,2
0,0,18,18,17,24,41,103,65,168,0.000333,0.300023,16,14401.09979,800.061099,900.068737,179.525968,2,2
0,0,5,5,11,10,21,31,17,48,0.000333,0.070277,5,1054.156181,58.564232,210.831236,71.273029,1,2
0,0,3,3,9,8,17,16,10,26,0.000333,0.035425,4,425.096135,23.616452,106.274034,52.529325,3,2
0,0,25,25,15,26,41,136,79,215,0.000333,0.383958,21,24189.3473,1343.852628,1151.873681,180.814792,4,2
0,0,5,5,10,10,20,33,18,51,0.000333,0.073473,5,1102.091664,61.227315,220.418333,66.438562,1,2
0,0,5,5,7,7,14,16,11,27,0.000333,0.034266,3,308.395749,17.133097,102.798583,39.302969,1,2
0,0,4,4,11,10,21,24,14,38,0.000333,0.055636,5,834.54031,46.363351,166.908062,71.273029,4,2
0,0,10,10,12,15,27,59,34,93,0.000333,0.147402,12,5306.454452,294.803025,442.204538,101.622909,2,2
0,0,5,5,6,5,11,18,13,31,0.000333,0.035747,6,643.454281,35.74746,107.24238,27.119415,6,2
0,0,7,7,7,13,20,27,24,51,0.000333,0.073473,3,661.254999,36.736389,220.418333,67.757201,1,2
0,0,5,5,8,8,16,19,12,31,0.000333,0.041333,4,496,27.555556,124,48,1,2
0,0,11,11,12,17,29,62,38,100,0.000333,0.161933,12,5829.577194,323.8654,485.7981,112.506418,1,2
0,0,5,5,11,10,21,31,17,48,0.000333,0.070277,5,1054.156181,58.564232,210.831236,71.273029,1,2
0,0,4,4,7,11,18,24,17,41,0.000333,0.056989,3,512.900775,28.494488,170.966925,57.705232,1,2
0,0,6,6,7,13,20,35,24,59,0.000333,0.084998,3,764.981273,42.49896,254.993758,67.757201,1,2
0,0,3,3,9,7,16,19,11,30,0.000333,0.04,4,480,26.666667,120,48.180809,4,2
0,0,4,4,10,9,19,20,12,32,0.000333,0.045311,5,679.668402,37.759356,135.93368,61.748606,3,2
0,0,14,14,18,17,35,89,51,140,0.000333,0.239367,27,19388.6898,1077.149434,718.099622,144.545518,4,2
0,0,17,17,13,27,40,90,50,140,0.000333,0.248357,6,4470.4196,248.356644,745.069933,176.487679,8,2
0,0,5,5,10,14,24,27,21,48,0.000333,0.073359,5,1100.391,61.132833,220.0782,86.52225,1,2
0,0,7,7,7,13,20,27,24,51,0.000333,0.073473,3,661.254999,36.736389,220.418333,67.757201,1,2
0,0,4,4,6,12,18,14,15,29,0.000333,0.040309,3,362.783475,20.154638,120.927825,58.529325,1,2
0,0,3,3,14,9,23,26,12,38,0.000333,0.057298,7,1203.26748,66.848193,171.895354,81.832294,3,2
0,0,81,81,17,80,97,522,436,958,0.000333,2.107572,40,252908.6601,14050.48112,6322.716503,575.241116,45,2
0,0,9,9,8,13,21,51,35,86,0.000333,0.125913,8,3021.914387,167.884133,377.739298,72.105716,1,2
0,0,34,34,17,39,56,207,116,323,0.000333,0.625259,16,30012.41024,1667.356124,1875.77564,275.617555,2,2
0,0,5,5,10,10,20,33,18,51,0.000333,0.073473,5,1102.091664,61.227315,220.418333,66.438562,1,2
0,0,6,6,9,11,20,37,20,57,0.000333,0.082117,4,985.399606,54.744423,246.349901,66.583073,1,2
0,0,4,4,5,9,14,14,13,27,0.000333,0.034266,2,205.597166,11.422065,102.798583,40.138965,1,2
0,0,3,3,8,7,15,15,9,24,0.000333,0.031255,4,375.061497,20.83675,93.765374,43.651484,3,2
0,0,5,5,10,10,20,29,17,46,0.000333,0.06627,5,994.043462,55.224637,198.808692,66.438562,1,2
0,0,4,4,8,10,18,25,15,40,0.000333,0.055599,4,667.188,37.066,166.797,57.219281,1,2
0,0,5,5,9,10,19,26,17,43,0.000333,0.060887,4,730.643532,40.591307,182.660883,61.748606,1,2
0,0,7,7,8,13,21,39,26,65,0.000333,0.095167,8,2284.00506,126.88917,285.500632,72.105716,1,2
0,0,5,5,8,11,19,28,19,47,0.000333,0.066551,4,798.610373,44.367243,199.652593,62.053748,1,2
0,0,8,8,12,16,28,42,26,68,0.000333,0.108967,6,1961.400808,108.966712,326.900135,107.01955,2,2
0,0,6,6,13,12,25,39,24,63,0.000333,0.097521,12,3510.755279,195.04196,292.56294,91.125266,5,2
0,0,5,5,7,7,14,16,11,27,0.000333,0.034266,3,308.395749,17.133097,102.798583,39.302969,1,2
0,0,4,4,7,13,20,21,18,39,0.000333,0.056185,3,505.665587,28.092533,168.555196,67.757201,1,2
0,0,5,5,7,7,14,16,11,27,0.000333,0.034266,3,308.395749,17.133097,102.798583,39.302969,1,2
0,0,16,16,14,19,33,71,45,116,0.000333,0.19505,14,8192.09605,455.116447,585.149718,134.013592,2,2
0,0,3,3,9,8,17,16,11,27,0.000333,0.036787,4,441.445987,24.524777,110.361497,52.529325,2,2
0,0,3,3,7,7,14,10,8,18,0.000333,0.022844,3,205.597166,11.422065,68.532389,39.302969,3,2
0,0,5,5,10,10,20,29,17,46,0.000333,0.06627,5,994.043462,55.224637,198.808692,66.438562,1,2
0,0,23,23,17,37,54,115,70,185,0.000333,0.354885,8,8517.233503,473.179639,1064.654188,262.236643,8,2
0,0,3,3,8,7,15,15,9,24,0.000333,0.031255,4,375.061497,20.83675,93.765374,43.651484,3,2
0,0,5,5,7,8,15,17,12,29,0.000333,0.037767,3,339.899482,18.883305,113.299827,43.651484,1,2
0,0,7,7,11,17,28,38,31,69,0.000333,0.110569,5,1658.537448,92.140969,331.70749,107.540616,5,2
0,0,33,33,18,41,59,225,123,348,0.000333,0.682387,27,55273.31409,3070.739672,2047.159781,294.718282,5,2
0,0,4,4,8,10,18,25,15,40,0.000333,0.055599,4,667.188,37.066,166.797,57.219281,1,2
0,0,5,5,8,11,19,33,18,51,0.000333,0.072215,4,866.577213,48.143178,216.644303,62.053748,1,2
0,0,11,11,12,17,29,72,40,112,0.000333,0.181365,12,6529.126457,362.729248,544.093871,112.506418,1,2
0,0,6,6,10,13,23,38,25,63,0.000333,0.094995,5,1424.922016,79.162334,284.984403,81.324997,1,2
0,0,3,3,9,8,17,16,11,27,0.000333,0.036787,4,441.445987,24.524777,110.361497,52.529325,2,2
0,0,4,4,7,13,20,18,20,38,0.000333,0.054744,3,492.699803,27.372211,164.233268,67.757201,2,2
0,0,4,4,4,7,11,13,11,24,0.000333,0.027675,2,166.052718,9.225151,83.026359,27.651484,2,2
0,0,5,5,8,10,18,28,17,45,0.000333,0.062549,4,750.5865,41.69925,187.646625,57.219281,1,2
0,0,5,5,7,7,14,16,11,27,0.000333,0.034266,3,308.395749,17.133097,102.798583,39.302969,1,2
0,0,18,18,17,24,41,103,65,168,0.000333,0.300023,16,14401.09979,800.061099,900.068737,179.525968,2,2
0,0,32,32,20,40,60,182,99,281,0.000333,0.553279,20,33196.72515,1844.262508,1659.836257,299.315686,13,2
0,0,6,6,9,11,20,34,20,54,0.000333,0.077795,4,933.536468,51.863137,233.384117,66.583073,1,2
0,0,5,5,7,9,16,23,14,37,0.000333,0.049333,3,444,24.666667,148,48.180809,1,2
0,0,3,3,9,8,17,16,11,27,0.000333,0.036787,4,441.445987,24.524777,110.361497,52.529325,2,2
0,0,8,8,10,14,24,48,32,80,0.000333,0.122266,10,3667.970001,203.776111,366.797,86.52225,1,2
0,0,4,4,8,13,21,22,18,40,0.000333,0.058564,4,702.770788,39.042822,175.692697,72.105716,1,2
0,0,6,6,13,12,25,41,26,67,0.000333,0.103713,12,3733.660377,207.425576,311.138365,91.125266,4,2
0,0,24,24,19,30,49,161,84,245,0.000333,0.458535,18,24760.87041,1375.603912,1375.603912,227.917341,6,2
0,0,5,5,8,13,21,18,17,35,0.000333,0.051244,4,614.924439,34.162469,153.73111,72.105716,1,2
0,0,6,6,8,10,18,29,18,47,0.000333,0.065329,4,783.9459,43.55255,195.986475,57.219281,1,2
0,0,4,4,7,9,16,17,12,29,0.000333,0.038667,3,348,19.333333,116,48.180809,1,2
0,0,3,3,8,7,15,20,12,32,0.000333,0.041673,4,500.081996,27.782333,125.020499,43.651484,1,2
0,0,5,5,7,8,15,17,12,29,0.000333,0.037767,3,339.899482,18.883305,113.299827,43.651484,1,2
0,0,5,5,8,11,19,33,18,51,0.000333,0.072215,4,866.577213,48.143178,216.644303,62.053748,1,2
0,0,6,6,11,10,21,51,26,77,0.000333,0.112736,10,3382.084416,187.893579,338.208442,71.273029,2,2
0,0,5,5,8,11,19,27,17,44,0.000333,0.062303,4,747.635242,41.535291,186.908811,62.053748,1,2
0,0,7,7,10,14,24,40,27,67,0.000333,0.102397,5,1535.962438,85.331247,307.192488,86.52225,1,2
0,0,5,5,8,10,18,28,17,45,0.000333,0.062549,4,750.5865,41.69925,187.646625,57.219281,1,2
0,0,4,4,7,12,19,15,15,30,0.000333,0.042479,3,382.313476,21.239638,127.437825,62.671034,1,2
0,0,3,3,9,8,17,16,10,26,0.000333,0.035425,4,425.096135,23.616452,106.274034,52.529325,3,2
0,0,4,4,11,9,20,21,12,33,0.000333,0.047541,5,713.118136,39.617674,142.623627,66.583073,3,2
0,0,14,14,17,20,37,81,54,135,0.000333,0.234425,16,11252.41927,625.134404,703.276204,155.92543,2,2
0,0,4,4,5,9,14,15,13,28,0.000333,0.035535,2,213.211876,11.845104,106.605938,40.138965,1,2
0,0,11,11,12,20,32,64,35,99,0.000333,0.165,6,2970,165,495,129.458112,5,2
0,0,10,10,14,18,32,61,38,99,0.000333,0.165,14,6930,385,495,128.361619,2,2
0,0,21,21,20,29,49,139,80,219,0.000333,0.409874,20,24592.42912,1366.246062,1229.621456,227.320011,6,2
0,0,5,5,8,10,18,28,17,45,0.000333,0.062549,4,750.5865,41.69925,187.646625,57.219281,1,2
0,0,5,5,8,11,19,33,18,51,0.000333,0.072215,4,866.577213,48.143178,216.644303,62.053748,1,2
0,0,5,5,10,10,20,29,17,46,0.000333,0.06627,5,994.043462,55.224637,198.808692,66.438562,1,2
0,0,5,5,8,11,19,27,17,44,0.000333,0.062303,4,747.635242,41.535291,186.908811,62.053748,1,2
0,0,5,5,10,10,20,29,17,46,0.000333,0.06627,5,994.043462,55.224637,198.808692,66.438562,1,2
0,0,8,8,14,17,31,56,29,85,0.000333,0.140369,7,2947.746805,163.763711,421.106686,122.789837,4,2
0,0,25,25,11,39,50,195,165,360,0.000333,0.677263,20,40635.76457,2257.542476,2031.788228,244.184434,2,2
0,0,3,3,7,7,14,10,8,18,0.000333,0.022844,3,205.597166,11.422065,68.532389,39.302969,3,2
0,0,4,4,11,9,20,21,12,33,0.000333,0.047541,5,713.118136,39.617674,142.623627,66.583073,3,2
0,0,5,5,8,10,18,28,17,45,0.000333,0.062549,4,750.5865,41.69925,187.646625,57.219281,1,2
0,0,25,25,16,33,49,173,105,278,0.000333,0.520296,24,37461.34408,2081.185782,1560.889337,230.465006,10,2
0,0,5,5,8,13,21,20,18,38,0.000333,0.055636,4,667.632248,37.09068,166.908062,72.105716,1,2
0,0,6,6,10,14,24,41,29,70,0.000333,0.106982,10,3209.473751,178.304097,320.947375,86.52225,4,2
0,0,5,5,8,8,16,19,12,31,0.000333,0.041333,4,496,27.555556,124,48,1,2
0,0,5,5,8,11,19,33,18,51,0.000333,0.072215,4,866.577213,48.143178,216.644303,62.053748,1,2
0,0,6,6,13,12,25,41,26,67,0.000333,0.103713,12,3733.660377,207.425576,311.138365,91.125266,4,2
0,0,5,5,10,9,19,26,15,41,0.000333,0.058055,5,870.82514,48.379174,174.165028,61.748606,1,2
0,0,6,6,9,11,20,31,19,50,0.000333,0.072032,4,864.385619,48.021423,216.096405,66.583073,1,2
0,0,5,5,7,7,14,16,11,27,0.000333,0.034266,3,308.395749,17.133097,102.798583,39.302969,1,2
0,0,5,5,7,9,16,23,14,37,0.000333,0.049333,3,444,24.666667,148,48.180809,1,2
0,0,18,18,17,24,41,103,65,168,0.000333,0.300023,16,14401.09979,800.061099,900.068737,179.525968,2,2
0,0,4,4,9,12,21,25,17,42,0.000333,0.061492,4,737.909327,40.994963,184.477332,71.548875,1,2
0,0,4,4,5,9,14,15,13,28,0.000333,0.035535,2,213.211876,11.845104,106.605938,40.138965,1,2
0,0,6,6,9,9,18,23,16,39,0.000333,0.054209,4,650.5083,36.13935,162.627075,57.05865,1,2
0,0,3,3,7,7,14,10,8,18,0.000333,0.022844,3,205.597166,11.422065,68.532389,39.302969,3,2
0,0,3,3,8,6,14,11,9,20,0.000333,0.025382,4,304.588394,16.921577,76.147098,39.509775,1,2
0,0,3,3,7,7,14,10,8,18,0.000333,0.022844,3,205.597166,11.422065,68.532389,39.302969,3,2
0,0,18,18,15,41,56,122,97,219,0.000333,0.423937,14,17805.35019,989.186122,1271.810728,278.262991,2,2
0,0,3,3,8,7,15,15,9,24,0.000333,0.031255,4,375.061497,20.83675,93.765374,43.651484,3,2
0,0,5,5,11,10,21,31,17,48,0.000333,0.070277,5,1054.156181,58.564232,210.831236,71.273029,1,2
0,0,5,5,7,9,16,23,14,37,0.000333,0.049333,3,444,24.666667,148,48.180809,1,2
0,0,5,5,10,10,20,29,17,46,0.000333,0.06627,5,994.043462,55.224637,198.808692,66.438562,1,2
0,0,3,3,9,8,17,16,10,26,0.000333,0.035425,4,425.096135,23.616452,106.274034,52.529325,3,2
0,0,4,4,7,11,18,24,17,41,0.000333,0.056989,3,512.900775,28.494488,170.966925,57.705232,1,2
0,0,5,5,7,15,22,32,25,57,0.000333,0.084729,3,762.562807,42.3646,254.187602,78.254843,1,2
0,0,6,6,8,8,16,21,14,35,0.000333,0.046667,4,560,31.111111,140,48,1,2
0,0,4,4,11,10,21,24,14,38,0.000333,0.055636,5,834.54031,46.363351,166.908062,71.273029,4,2
0,0,10,10,13,20,33,67,36,103,0.000333,0.173191,6,3117.435566,173.190865,519.572594,134.544278,4,2
0,0,9,9,10,18,28,48,34,82,0.000333,0.131401,5,1971.015518,109.500862,394.203104,108.277931,1,2
0,0,17,17,16,26,42,130,74,204,0.000333,0.366678,16,17600.52407,977.806893,1100.032754,186.211433,5,2
0,0,5,5,8,10,18,28,17,45,0.000333,0.062549,4,750.5865,41.69925,187.646625,57.219281,1,2
0,0,3,3,7,7,14,10,8,18,0.000333,0.022844,3,205.597166,11.422065,68.532389,39.302969,3,2
0,0,4,4,10,9,19,22,13,35,0.000333,0.049559,5,743.387315,41.299295,148.677463,61.748606,1,2
0,0,9,9,12,11,23,44,28,72,0.000333,0.108565,12,3908.35753,217.130974,325.696461,81.073298,1,2
0,0,5,5,7,9,16,23,14,37,0.000333,0.049333,3,444,24.666667,148,48.180809,1,2
0,0,5,5,11,10,21,31,17,48,0.000333,0.070277,5,1054.156181,58.564232,210.831236,71.273029,1,2
0,0,6,6,7,13,20,27,24,51,0.000333,0.073473,3,661.254999,36.736389,220.418333,67.757201,1,2
0,0,4,4,8,10,18,31,16,47,0.000333,0.065329,4,783.9459,43.55255,195.986475,57.219281,1,2
0,0,5,5,8,8,16,24,16,40,0.000333,0.053333,8,1280,71.111111,160,48,1,2
0,0,4,4,8,7,15,17,10,27,0.000333,0.035162,4,421.944184,23.441344,105.486046,43.651484,1,2
0,0,4,4,8,10,18,14,12,26,0.000333,0.036139,4,433.6722,24.0929,108.41805,57.219281,3,2
0,0,4,4,7,14,21,18,18,36,0.000333,0.052708,3,474.370282,26.353905,158.123427,72.954453,1,2
0,0,6,6,13,12,25,41,26,67,0.000333,0.103713,12,3733.660377,207.425576,311.138365,91.125266,4,2
0,0,5,5,7,7,14,19,13,32,0.000333,0.040612,3,365.506073,20.305893,121.835358,39.302969,1,2
0,0,5,5,8,10,18,28,17,45,0.000333,0.062549,4,750.5865,41.69925,187.646625,57.219281,1,2
0,0,6,6,13,12,25,39,24,63,0.000333,0.097521,12,3510.755279,195.04196,292.56294,91.125266,5,2
0,0,6,6,7,15,22,28,27,55,0.000333,0.081756,3,735.806217,40.878123,245.268739,78.254843,1,2
0,0,3,3,8,6,14,11,9,20,0.000333,0.025382,4,304.588394,16.921577,76.147098,39.509775,1,2
0,0,23,23,16,26,42,136,80,216,0.000333,0.388247,24,27953.77352,1552.987418,1164.740563,186.211433,2,2
0,0,16,16,15,24,39,128,63,191,0.000333,0.336504,14,14133.16553,785.175863,1009.511824,168.642459,6,2
0,0,3,3,8,7,15,15,9,24,0.000333,0.031255,4,375.061497,20.83675,93.765374,43.651484,3,2
0,0,15,15,14,19,33,66,42,108,0.000333,0.181598,14,7627.123908,423.729106,544.794565,134.013592,2,2
0,0,33,33,21,41,62,224,126,350,0.000333,0.694656,30,62519.06126,3473.281181,2083.968709,311.898298,16,2
0,0,4,4,5,10,15,15,14,29,0.000333,0.037767,2,226.599655,12.58887,113.299827,44.828921,1,2
0,0,5,5,8,11,19,33,18,51,0.000333,0.072215,4,866.577213,48.143178,216.644303,62.053748,1,2
0,0,5,5,8,14,22,19,19,38,0.000333,0.056486,4,677.833606,37.657423,169.458402,77.302969,1,2
0,0,5,5,8,11,19,33,18,51,0.000333,0.072215,4,866.577213,48.143178,216.644303,62.053748,1,2
0,0,3,3,9,8,17,16,10,26,0.000333,0.035425,4,425.096135,23.616452,106.274034,52.529325,3,2
0,0,10,10,13,13,26,47,30,77,0.000333,0.120645,12,4343.2063,241.289239,361.933858,96.211433,2,2
0,0,10,10,12,15,27,59,34,93,0.000333,0.147402,12,5306.454452,294.803025,442.204538,101.622909,2,2
0,0,5,5,7,7,14,19,13,32,0.000333,0.040612,3,365.506073,20.305893,121.835358,39.302969,1,2
0,0,3,3,14,8,22,29,14,43,0.000333,0.063919,7,1342.288917,74.571607,191.75556,77.302969,3,2
0,0,6,6,8,17,25,33,28,61,0.000333,0.094425,4,1133.10091,62.950051,283.275228,93.486868,1,2
0,0,4,4,8,15,23,22,21,43,0.000333,0.064838,4,778.052656,43.225148,194.513164,82.603359,1,2
0,0,18,18,16,22,38,89,59,148,0.000333,0.258898,16,12427.09235,690.39402,776.693272,162.107496,2,2
0,0,5,5,8,11,19,27,17,44,0.000333,0.062303,4,747.635242,41.535291,186.908811,62.053748,1,2
0,0,5,5,8,10,18,28,17,45,0.000333,0.062549,4,750.5865,41.69925,187.646625,57.219281,1,2
0,0,5,5,10,10,20,29,17,46,0.000333,0.06627,5,994.043462,55.224637,198.808692,66.438562,1,2
0,0,4,4,5,9,14,14,13,27,0.000333,0.034266,2,205.597166,11.422065,102.798583,40.138965,1,2
0,0,3,3,8,7,15,20,12,32,0.000333,0.041673,4,500.081996,27.782333,125.020499,43.651484,1,2
0,0,9,9,12,15,27,38,28,66,0.000333,0.104608,6,1882.935451,104.607525,313.822575,101.622909,1,2
0,0,3,3,9,8,17,16,10,26,0.000333,0.035425,4,425.096135,23.616452,106.274034,52.529325,3,2
0,0,5,5,7,8,15,17,12,29,0.000333,0.037767,3,339.899482,18.883305,113.299827,43.651484,1,2
0,0,5,5,10,10,20,29,17,46,0.000333,0.06627,5,994.043462,55.224637,198.808692,66.438562,1,2
0,0,77,77,17,80,97,491,410,901,0.000333,1.982174,40,237860.8588,13214.49216,5946.521471,575.241116,41,2
0,0,10,10,13,13,26,47,30,77,0.000333,0.120645,12,4343.2063,241.289239,361.933858,96.211433,2,2
0,0,41,41,17,41,58,322,175,497,0.000333,0.970472,32,93165.32975,5175.851653,2911.416555,289.1465,6,2
0,0,32,32,12,31,43,186,108,294,0.000333,0.531774,18,28715.79308,1595.321838,1595.321838,196.599636,5,2
0,0,4,4,9,9,18,22,13,35,0.000333,0.048649,4,583.7895,32.43275,145.947375,57.05865,3,2
0,0,5,5,10,10,20,33,18,51,0.000333,0.073473,5,1102.091664,61.227315,220.418333,66.438562,1,2
0,0,3,3,8,7,15,15,9,24,0.000333,0.031255,4,375.061497,20.83675,93.765374,43.651484,3,2
0,0,5,5,8,8,16,26,16,42,0.000333,0.056,8,1344,74.666667,168,48,1,2
0,0,4,4,4,7,11,13,11,24,0.000333,0.027675,2,166.052718,9.225151,83.026359,27.651484,2,2
0,0,4,4,5,9,14,15,13,28,0.000333,0.035535,2,213.211876,11.845104,106.605938,40.138965,1,2
0,0,9,9,10,9,19,31,22,53,0.000333,0.075047,10,2251.401582,125.077866,225.140158,61.748606,1,2
0,0,3,3,8,7,15,20,12,32,0.000333,0.041673,4,500.081996,27.782333,125.020499,43.651484,1,2
0,0,4,4,6,8,14,14,11,25,0.000333,0.031728,3,285.551619,15.863979,95.183873,39.509775,1,2
0,0,5,5,7,7,14,16,11,27,0.000333,0.034266,3,308.395749,17.133097,102.798583,39.302969,1,2
0,0,4,4,11,9,20,21,12,33,0.000333,0.047541,5,713.118136,39.617674,142.623627,66.583073,3,2
0,0,7,7,9,12,21,34,20,54,0.000333,0.079062,4,948.740563,52.707809,237.185141,71.548875,1,2
0,0,5,5,10,10,20,33,18,51,0.000333,0.073473,5,1102.091664,61.227315,220.418333,66.438562,1,2
0,0,5,5,7,8,15,17,12,29,0.000333,0.037767,3,339.899482,18.883305,113.299827,43.651484,1,2
0,0,36,36,15,35,50,251,189,440,0.000333,0.827766,35,86915.38532,4828.632518,2483.296724,238.128265,10,2
0,0,5,5,10,9,19,26,15,41,0.000333,0.058055,5,870.82514,48.379174,174.165028,61.748606,1,2
0,0,36,36,14,32,46,251,183,434,0.000333,0.799075,35,83902.90611,4661.272562,2397.225889,213.302969,10,2
0,0,6,6,12,11,23,33,18,51,0.000333,0.076901,6,1384.209959,76.900553,230.70166,81.073298,1,2
0,0,6,6,7,13,20,35,24,59,0.000333,0.084998,3,764.981273,42.49896,254.993758,67.757201,1,2
0,0,4,4,7,11,18,24,17,41,0.000333,0.056989,3,512.900775,28.494488,170.966925,57.705232,1,2
0,0,3,3,8,7,15,15,9,24,0.000333,0.031255,4,375.061497,20.83675,93.765374,43.651484,3,2
0,0,3,3,8,7,15,15,9,24,0.000333,0.031255,4,375.061497,20.83675,93.765374,43.651484,3,2
0,0,7,7,9,12,21,34,20,54,0.000333,0.079062,4,948.740563,52.707809,237.185141,71.548875,1,2
0,0,5,5,10,12,22,26,17,43,0.000333,0.063919,5,958.777798,53.265433,191.75556,76.238831,3,2
0,0,5,5,9,13,22,26,20,46,0.000333,0.068378,4,820.535418,45.585301,205.133854,76.635041,1,2
0,0,5,5,8,11,19,27,17,44,0.000333,0.062303,4,747.635242,41.535291,186.908811,62.053748,1,2
0,0,18,18,15,24,39,106,62,168,0.000333,0.295983,14,12431.26602,690.62589,887.947573,168.642459,2,2
0,0,15,15,15,20,35,71,44,115,0.000333,0.196623,14,8258.145657,458.78587,589.867547,145.041921,2,2
0,0,3,3,7,7,14,10,8,18,0.000333,0.022844,3,205.597166,11.422065,68.532389,39.302969,3,2
0,0,5,5,7,7,14,16,11,27,0.000333,0.034266,3,308.395749,17.133097,102.798583,39.302969,1,2
0,0,5,5,10,10,20,29,17,46,0.000333,0.06627,5,994.043462,55.224637,198.808692,66.438562,1,2
0,0,3,3,8,7,15,15,9,24,0.000333,0.031255,4,375.061497,20.83675,93.765374,43.651484,3,2
0,0,3,3,8,7,15,15,9,24,0.000333,0.031255,4,375.061497,20.83675,93.765374,43.651484,3,2
0,0,6,6,9,9,18,23,16,39,0.000333,0.054209,4,650.5083,36.13935,162.627075,57.05865,1,2
0,0,4,4,11,10,21,24,14,38,0.000333,0.055636,5,834.54031,46.363351,166.908062,71.273029,4,2
0,0,4,4,8,10,18,24,15,39,0.000333,0.054209,4,650.5083,36.13935,162.627075,57.219281,1,2
0,0,3,3,8,7,15,20,12,32,0.000333,0.041673,4,500.081996,27.782333,125.020499,43.651484,1,2
0,0,10,10,14,18,32,49,38,87,0.000333,0.145,14,6090,338.333333,435,128.361619,2,2
0,0,6,6,7,9,16,27,18,45,0.000333,0.06,6,1080,60,180,48.180809,1,2
0,0,4,4,9,9,18,22,13,35,0.000333,0.048649,4,583.7895,32.43275,145.947375,57.05865,3,2
0,0,3,3,8,7,15,20,12,32,0.000333,0.041673,4,500.081996,27.782333,125.020499,43.651484,1,2
0,0,5,5,11,12,23,24,16,40,0.000333,0.060314,5,904.712391,50.2618,180.942478,81.073298,3,2
0,0,5,5,7,8,15,22,15,37,0.000333,0.048185,3,433.664856,24.092492,144.554952,43.651484,1,2
0,0,4,4,7,9,16,19,15,34,0.000333,0.045333,3,408,22.666667,136,48.180809,1,2
0,0,5,5,10,10,20,33,18,51,0.000333,0.073473,5,1102.091664,61.227315,220.418333,66.438562,1,2
0,0,4,4,9,9,18,22,13,35,0.000333,0.048649,4,583.7895,32.43275,145.947375,57.05865,3,2
0,0,18,18,15,22,37,108,59,167,0.000333,0.289993,14,12179.70197,676.650109,869.978712,156.710855,4,2
0,0,4,4,4,7,11,13,11,24,0.000333,0.027675,2,166.052718,9.225151,83.026359,27.651484,2,2
0,0,15,15,10,21,31,67,37,104,0.000333,0.171745,5,2576.182081,143.121227,515.236416,125.457947,2,2
0,0,4,4,8,7,15,15,10,25,0.000333,0.032557,4,390.68906,21.704948,97.672265,43.651484,1,2
0,0,7,7,7,13,20,39,28,67,0.000333,0.096523,6,1737.415094,96.523061,289.569182,67.757201,1,2
0,0,5,5,7,8,15,17,12,29,0.000333,0.037767,3,339.899482,18.883305,113.299827,43.651484,1,2
0,0,40,40,19,43,62,246,140,386,0.000333,0.766107,27,62054.63395,3447.479664,2298.319776,314.040007,3,2
0,0,18,18,16,22,38,89,59,148,0.000333,0.258898,16,12427.09235,690.39402,776.693272,162.107496,2,2
0,0,7,7,7,12,19,38,27,65,0.000333,0.092038,6,1656.69173,92.038429,276.115288,62.671034,1,2
0,0,7,7,7,12,19,38,27,65,0.000333,0.092038,6,1656.69173,92.038429,276.115288,62.671034,1,2
0,0,5,5,7,7,14,16,11,27,0.000333,0.034266,3,308.395749,17.133097,102.798583,39.302969,1,2
0,0,13,13,18,17,35,81,46,127,0.000333,0.21714,18,11725.54098,651.418943,651.418943,144.545518,6,2
0,0,5,5,8,10,18,28,17,45,0.000333,0.062549,4,750.5865,41.69925,187.646625,57.219281,1,2
0,0,4,4,5,10,15,17,15,32,0.000333,0.041673,2,250.040998,13.891167,125.020499,44.828921,1,2
0,0,11,11,16,18,34,61,41,102,0.000333,0.172974,16,8302.739357,461.263298,518.92121,139.05865,5,2
0,0,3,3,9,8,17,16,11,27,0.000333,0.036787,4,441.445987,24.524777,110.361497,52.529325,2,2
0,0,4,4,8,7,15,17,10,27,0.000333,0.035162,4,421.944184,23.441344,105.486046,43.651484,1,2
0,0,6,6,13,12,25,39,24,63,0.000333,0.097521,12,3510.755279,195.04196,292.56294,91.125266,5,2
0,0,7,7,9,12,21,34,20,54,0.000333,0.079062,4,948.740563,52.707809,237.185141,71.548875,1,2
0,0,5,5,8,9,17,23,16,39,0.000333,0.053137,4,637.644203,35.424678,159.411051,52.529325,1,2
0,0,6,6,8,10,18,29,21,50,0.000333,0.069499,8,1667.970001,92.665,208.49625,57.219281,1,2
0,0,4,4,10,9,19,22,13,35,0.000333,0.049559,5,743.387315,41.299295,148.677463,61.748606,1,2
0,0,5,5,10,10,20,33,18,51,0.000333,0.073473,5,1102.091664,61.227315,220.418333,66.438562,1,2
0,0,23,23,13,30,43,132,78,210,0.000333,0.379839,12,13674.18718,759.677066,1139.515598,195.312434,2,2
0,0,4,4,9,9,18,22,13,35,0.000333,0.048649,4,583.7895,32.43275,145.947375,57.05865,3,2
0,0,5,5,8,11,19,33,18,51,0.000333,0.072215,4,866.577213,48.143178,216.644303,62.053748,1,2
0,0,10,10,13,13,26,47,30,77,0.000333,0.120645,12,4343.2063,241.289239,361.933858,96.211433,2,2
0,0,4,4,11,9,20,21,12,33,0.000333,0.047541,5,713.118136,39.617674,142.623627,66.583073,3,2
0,0,18,18,16,22,38,89,59,148,0.000333,0.258898,16,12427.09235,690.39402,776.693272,162.107496,2,2
0,0,5,5,7,8,15,17,12,29,0.000333,0.037767,3,339.899482,18.883305,113.299827,43.651484,1,2
0,0,3,3,8,6,14,11,9,20,0.000333,0.025382,4,304.588394,16.921577,76.147098,39.509775,1,2
0,0,5,5,10,10,20,29,17,46,0.000333,0.06627,5,994.043462,55.224637,198.808692,66.438562,1,2
0,0,21,21,20,29,49,150,82,232,0.000333,0.434204,20,26052.25368,1447.347426,1302.612684,227.320011,8,2
0,0,5,5,7,9,16,23,14,37,0.000333,0.049333,3,444,24.666667,148,48.180809,1,2
0,0,14,14,17,20,37,81,54,135,0.000333,0.234425,16,11252.41927,625.134404,703.276204,155.92543,2,2
0,0,5,5,8,10,18,28,17,45,0.000333,0.062549,4,750.5865,41.69925,187.646625,57.219281,1,2
0,0,6,6,8,15,23,37,28,65,0.000333,0.098011,4,1176.126109,65.340339,294.031527,82.603359,1,2
0,0,25,25,18,34,52,149,79,228,0.000333,0.433233,18,23394.6046,1299.700256,1299.700256,248.032387,10,2
0,0,5,5,7,7,14,17,13,30,0.000333,0.038074,3,342.661943,19.036775,114.220648,39.302969,1,2
0,0,4,4,8,14,22,20,18,38,0.000333,0.056486,4,677.833606,37.657423,169.458402,77.302969,1,2
0,0,3,3,8,7,15,15,9,24,0.000333,0.031255,4,375.061497,20.83675,93.765374,43.651484,3,2
0,0,7,7,10,11,21,31,20,51,0.000333,0.074669,5,1120.040943,62.224497,224.008189,71.273029,1,2
0,0,21,21,18,32,50,145,86,231,0.000333,0.434577,18,23467.15404,1303.73078,1303.73078,235.05865,5,2
0,0,5,5,10,9,19,26,15,41,0.000333,0.058055,5,870.82514,48.379174,174.165028,61.748606,1,2
0,0,4,4,8,7,15,15,10,25,0.000333,0.032557,4,390.68906,21.704948,97.672265,43.651484,1,2
0,0,5,5,8,11,19,27,18,45,0.000333,0.063719,4,764.626952,42.479275,191.156738,62.053748,1,2
0,0,7,7,10,14,24,40,27,67,0.000333,0.102397,5,1535.962438,85.331247,307.192488,86.52225,1,2
0,0,13,13,10,12,22,70,41,111,0.000333,0.164999,15,7424.953645,412.497425,494.99691,76.238831,1,2
0,0,6,6,9,8,17,21,14,35,0.000333,0.047687,4,572.244798,31.791378,143.061199,52.529325,1,2
0,0,4,4,10,8,18,20,11,31,0.000333,0.043089,5,646.338375,35.907688,129.267675,57.219281,3,2
0,0,10,10,13,13,26,47,30,77,0.000333,0.120645,12,4343.2063,241.289239,361.933858,96.211433,2,2
0,0,5,5,8,8,16,19,12,31,0.000333,0.041333,4,496,27.555556,124,48,1,2
0,0,4,4,9,10,19,28,15,43,0.000333,0.060887,4,730.643532,40.591307,182.660883,61.748606,1,2
0,0,3,3,8,6,14,11,9,20,0.000333,0.025382,4,304.588394,16.921577,76.147098,39.509775,1,2
0,0,21,21,15,29,44,124,76,200,0.000333,0.363962,14,15286.40853,849.244918,1091.886324,199.484808,2,2
0,0,15,15,10,21,31,67,37,104,0.000333,0.171745,5,2576.182081,143.121227,515.236416,125.457947,2,2
0,0,10,10,12,16,28,61,37,98,0.000333,0.15704,12,5653.449388,314.080522,471.120782,107.01955,1,2
0,0,3,3,9,6,15,19,10,29,0.000333,0.037767,4,453.199309,25.177739,113.299827,44.0391,1,2
0,0,3,3,8,7,15,15,9,24,0.000333,0.031255,4,375.061497,20.83675,93.765374,43.651484,3,2
0,0,16,16,17,20,37,80,63,143,0.000333,0.248317,24,17878.84395,993.269108,744.951831,155.92543,3,2
0,0,17,17,14,22,36,83,62,145,0.000333,0.24988,14,10494.94775,583.052653,749.639125,151.410465,1,2
0,0,6,6,13,12,25,41,26,67,0.000333,0.103713,12,3733.660377,207.425576,311.138365,91.125266,4,2
0,0,6,6,8,11,19,20,19,39,0.000333,0.055223,4,662.676692,36.815372,165.669173,62.053748,1,2
0,0,5,5,8,10,18,28,17,45,0.000333,0.062549,4,750.5865,41.69925,187.646625,57.219281,1,2
0,0,19,19,14,27,41,405,60,465,0.000333,0.830421,14,34877.66355,1937.647975,2491.261682,181.684931,5,2
0,0,10,10,12,13,25,37,27,64,0.000333,0.099069,12,3566.481554,198.137864,297.206796,91.125266,1,2
0,0,4,4,9,9,18,24,14,38,0.000333,0.052819,4,633.8286,35.2127,158.45715,57.05865,1,2
0,0,7,7,10,14,24,40,27,67,0.000333,0.102397,5,1535.962438,85.331247,307.192488,86.52225,1,2
0,0,4,4,11,10,21,24,14,38,0.000333,0.055636,5,834.54031,46.363351,166.908062,71.273029,4,2
0,0,19,19,16,25,41,120,61,181,0.000333,0.323239,16,15515.47061,861.970589,969.716913,180.096405,6,2
0,0,14,14,18,17,35,89,51,140,0.000333,0.239367,27,19388.6898,1077.149434,718.099622,144.545518,4,2
0,0,14,14,17,20,37,81,54,135,0.000333,0.234425,16,11252.41927,625.134404,703.276204,155.92543,2,2
0,0,5,5,10,9,19,24,16,40,0.000333,0.056639,5,849.585503,47.199195,169.917101,61.748606,1,2
0,0,7,7,11,19,30,44,28,72,0.000333,0.117765,5,1766.480614,98.137812,353.296123,118.764371,2,2
0,0,4,4,7,6,13,14,9,23,0.000333,0.02837,3,255.330341,14.185019,85.110114,35.161259,1,2
0,0,4,4,8,10,18,25,15,40,0.000333,0.055599,4,667.188,37.066,166.797,57.219281,1,2
0,0,5,5,10,7,17,32,17,49,0.000333,0.066762,10,2002.856792,111.269822,200.285679,52.870765,2,2
0,0,4,4,10,7,17,29,15,44,0.000333,0.059949,10,1798.48365,99.915758,179.848365,52.870765,2,2
0,0,4,4,4,7,11,13,11,24,0.000333,0.027675,2,166.052718,9.225151,83.026359,27.651484,2,2
0,0,19,19,16,27,43,131,73,204,0.000333,0.368986,16,17711.32816,983.962676,1106.95801,192.381963,5,2
0,0,5,5,10,10,20,33,18,51,0.000333,0.073473,5,1102.091664,61.227315,220.418333,66.438562,1,2
0,0,3,3,8,7,15,15,9,24,0.000333,0.031255,4,375.061497,20.83675,93.765374,43.651484,3,2
0,0,4,4,5,9,14,15,13,28,0.000333,0.035535,2,213.211876,11.845104,106.605938,40.138965,1,2
0,0,35,35,18,42,60,229,127,356,0.000333,0.700951,27,56777.03241,3154.279578,2102.853052,301.535982,5,2
0,0,9,9,16,17,33,54,35,89,0.000333,0.14965,16,7183.217226,399.067624,448.951077,133.486868,5,2
0,0,5,5,7,9,16,23,14,37,0.000333,0.049333,3,444,24.666667,148,48.180809,1,2
0,0,3,3,9,8,17,16,11,27,0.000333,0.036787,4,441.445987,24.524777,110.361497,52.529325,2,2
0,0,5,5,8,11,19,27,17,44,0.000333,0.062303,4,747.635242,41.535291,186.908811,62.053748,1,2
0,0,5,5,8,11,19,27,17,44,0.000333,0.062303,4,747.635242,41.535291,186.908811,62.053748,1,2
0,0,3,3,7,7,14,10,8,18,0.000333,0.022844,3,205.597166,11.422065,68.532389,39.302969,3,2
0,0,5,5,8,11,19,33,18,51,0.000333,0.072215,4,866.577213,48.143178,216.644303,62.053748,1,2
0,0,4,4,8,14,22,22,19,41,0.000333,0.060946,4,731.346785,40.630377,182.836696,77.302969,1,2
0,0,15,15,10,21,31,67,37,104,0.000333,0.171745,5,2576.182081,143.121227,515.236416,125.457947,2,2
0,0,4,4,5,10,15,15,14,29,0.000333,0.037767,2,226.599655,12.58887,113.299827,44.828921,1,2
0,0,4,4,11,11,22,22,14,36,0.000333,0.053513,5,802.697691,44.594316,160.539538,76.107496,3,2
0,0,18,18,16,22,38,89,59,148,0.000333,0.258898,16,12427.09235,690.39402,776.693272,162.107496,3,2
0,0,7,7,10,11,21,33,21,54,0.000333,0.079062,5,1185.925704,65.884761,237.185141,71.273029,1,2
0,0,6,6,8,11,19,31,21,52,0.000333,0.073631,4,883.568923,49.087162,220.892231,62.053748,1,2
0,0,5,5,12,13,25,28,18,46,0.000333,0.071206,6,1281.704308,71.205795,213.617385,91.125266,4,2
0,0,4,4,9,9,18,22,13,35,0.000333,0.048649,4,583.7895,32.43275,145.947375,57.05865,3,2
0,0,31,31,19,39,58,156,103,259,0.000333,0.505739,18,27309.9074,1517.217078,1517.217078,286.841309,2,2
0,0,28,28,19,38,57,150,96,246,0.000333,0.478297,18,25828.03698,1434.890943,1434.890943,280.131868,6,2
0,0,3,3,7,7,14,10,8,18,0.000333,0.022844,3,205.597166,11.422065,68.532389,39.302969,3,2
0,0,3,3,8,7,15,15,9,24,0.000333,0.031255,4,375.061497,20.83675,93.765374,43.651484,3,2
0,0,7,7,8,15,23,31,27,58,0.000333,0.087456,4,1049.466374,58.303687,262.366593,82.603359,1,2
0,0,5,5,7,7,14,16,11,27,0.000333,0.034266,3,308.395749,17.133097,102.798583,39.302969,1,2
0,0,5,5,8,10,18,28,17,45,0.000333,0.062549,4,750.5865,41.69925,187.646625,57.219281,1,2
0,0,7,7,9,14,23,24,24,48,0.000333,0.072377,4,868.523896,48.251328,217.130974,81.832294,1,2
0,0,12,12,14,26,40,73,51,124,0.000333,0.219973,7,4619.433586,256.635199,659.919084,175.514402,2,2
0,0,3,3,8,7,15,20,12,32,0.000333,0.041673,4,500.081996,27.782333,125.020499,43.651484,1,2
0,0,5,5,7,8,15,17,12,29,0.000333,0.037767,3,339.899482,18.883305,113.299827,43.651484,1,2
0,0,4,4,10,9,19,22,13,35,0.000333,0.049559,5,743.387315,41.299295,148.677463,61.748606,1,2
0,0,5,5,10,10,20,27,16,43,0.000333,0.061948,5,929.21454,51.62303,185.842908,66.438562,1,2
0,0,18,18,15,24,39,106,62,168,0.000333,0.295983,14,12431.26602,690.62589,887.947573,168.642459,2,2
0,0,6,6,7,9,16,27,18,45,0.000333,0.06,6,1080,60,180,48.180809,1,2
0,0,11,11,13,20,33,69,33,102,0.000333,0.171509,6,3087.169201,171.5094,514.5282,134.544278,5,2
0,0,8,8,13,12,25,47,30,77,0.000333,0.119192,12,4290.923119,238.384618,357.576927,91.125266,5,2
0,0,5,5,7,7,14,16,11,27,0.000333,0.034266,3,308.395749,17.133097,102.798583,39.302969,1,2
0,0,10,10,13,13,26,47,30,77,0.000333,0.120645,12,4343.2063,241.289239,361.933858,96.211433,2,2
0,0,6,6,13,11,24,38,23,61,0.000333,0.093228,12,3356.192551,186.455142,279.682713,86.159464,4,2
0,0,6,6,9,9,18,21,16,37,0.000333,0.051429,4,617.1489,34.28605,154.287225,57.05865,1,2
0,0,6,6,6,7,13,19,14,33,0.000333,0.040705,6,732.687064,40.704837,122.114511,35.161259,1,2
0,0,5,5,8,10,18,28,17,45,0.000333,0.062549,4,750.5865,41.69925,187.646625,57.219281,1,2
0,0,4,4,10,11,21,20,14,34,0.000333,0.04978,5,746.693962,41.482998,149.338792,71.273029,3,2
0,0,14,14,17,20,37,81,54,135,0.000333,0.234425,16,11252.41927,625.134404,703.276204,155.92543,2,2
0,0,10,10,16,9,25,65,27,92,0.000333,0.142412,24,10253.63447,569.646359,427.234769,92.529325,7,2
0,0,3,3,8,7,15,20,12,32,0.000333,0.041673,4,500.081996,27.782333,125.020499,43.651484,1,2
0,0,9,9,14,16,30,44,33,77,0.000333,0.125944,14,5289.628062,293.868226,377.830576,117.302969,4,2
0,0,45,45,17,41,58,320,173,493,0.000333,0.962662,32,92415.50818,5134.194899,2887.984631,289.1465,2,2
0,0,5,5,7,7,14,19,12,31,0.000333,0.039343,3,354.084008,19.671334,118.028003,39.302969,1,2
0,0,7,7,9,12,21,34,20,54,0.000333,0.079062,4,948.740563,52.707809,237.185141,71.548875,1,2
0,0,5,5,7,8,15,17,12,29,0.000333,0.037767,3,339.899482,18.883305,113.299827,43.651484,1,2
0,0,4,4,8,8,16,18,12,30,0.000333,0.04,4,480,26.666667,120,48,1,2
0,0,3,3,7,7,14,10,8,18,0.000333,0.022844,3,205.597166,11.422065,68.532389,39.302969,3,2
0,0,4,4,11,10,21,24,14,38,0.000333,0.055636,5,834.54031,46.363351,166.908062,71.273029,4,2
0,0,16,16,16,25,41,127,64,191,0.000333,0.341097,16,16372.67893,909.593274,1023.292433,180.096405,5,2
0,0,19,19,16,25,41,168,81,249,0.000333,0.444677,24,32016.73078,1778.707266,1334.030449,180.096405,7,2
0,0,5,5,7,7,14,16,11,27,0.000333,0.034266,3,308.395749,17.133097,102.798583,39.302969,1,2
0,0,4,4,7,11,18,21,16,37,0.000333,0.051429,3,462.861675,25.714538,154.287225,57.705232,1,2
0,0,6,6,13,11,24,38,23,61,0.000333,0.093228,12,3356.192551,186.455142,279.682713,86.159464,4,2
0,0,4,4,4,7,11,13,11,24,0.000333,0.027675,2,166.052718,9.225151,83.026359,27.651484,2,2
0,0,6,6,11,10,21,28,17,45,0.000333,0.065885,5,988.27142,54.903968,197.654284,71.273029,1,2
0,0,14,14,17,20,37,81,54,135,0.000333,0.234425,16,11252.41927,625.134404,703.276204,155.92543,2,2
0,0,5,5,7,8,15,17,12,29,0.000333,0.037767,3,339.899482,18.883305,113.299827,43.651484,1,2
0,0,4,4,7,7,14,16,10,26,0.000333,0.032997,3,296.973684,16.498538,98.991228,39.302969,1,2
0,0,14,14,15,25,40,85,43,128,0.000333,0.227069,7,4768.447573,264.913754,681.206796,174.699764,5,2
0,0,4,4,7,11,18,24,17,41,0.000333,0.056989,3,512.900775,28.494488,170.966925,57.705232,1,2
0,0,5,5,7,9,16,23,14,37,0.000333,0.049333,3,444,24.666667,148,48.180809,1,2
0,0,6,6,10,14,24,28,25,53,0.000333,0.081001,5,1215.015063,67.500837,243.003013,86.52225,1,2
0,0,5,5,10,9,19,26,15,41,0.000333,0.058055,5,870.82514,48.379174,174.165028,61.748606,1,2
0,0,3,3,7,7,14,10,8,18,0.000333,0.022844,3,205.597166,11.422065,68.532389,39.302969,3,2
0,0,8,8,11,15,26,31,23,54,0.000333,0.084608,5,1269.118724,70.506596,253.823745,96.657107,1,2
0,0,5,5,8,13,21,18,17,35,0.000333,0.051244,4,614.924439,34.162469,153.73111,72.105716,1,2
0,0,9,9,10,15,25,48,30,78,0.000333,0.12074,10,3622.207828,201.233768,362.220783,91.82264,1,2
0,0,6,6,8,8,16,20,15,35,0.000333,0.046667,4,560,31.111111,140,48,1,2
0,0,4,4,6,14,20,17,18,35,0.000333,0.050422,3,453.80245,25.211247,151.267483,68.812744,1,2
0,0,13,13,16,18,34,73,49,122,0.000333,0.20689,16,9930.727466,551.707081,620.670467,139.05865,6,2
0,0,4,4,6,8,14,14,11,25,0.000333,0.031728,3,285.551619,15.863979,95.183873,39.509775,1,2
0,0,11,11,17,18,35,60,39,99,0.000333,0.169266,16,8124.784299,451.376905,507.799019,144.545518,5,2
0,0,3,3,9,8,17,16,11,27,0.000333,0.036787,4,441.445987,24.524777,110.361497,52.529325,2,2
0,0,8,8,12,16,28,42,26,68,0.000333,0.108967,6,1961.400808,108.966712,326.900135,107.01955,2,2
0,0,8,8,14,13,27,44,29,73,0.000333,0.115702,14,4859.495027,269.971946,347.106788,101.408685,4,2
0,0,4,4,7,11,18,15,14,29,0.000333,0.040309,3,362.783475,20.154638,120.927825,57.705232,1,2
0,0,4,4,10,8,18,20,11,31,0.000333,0.043089,5,646.338375,35.907688,129.267675,57.219281,3,2
0,0,57,57,19,44,63,330,242,572,0.000333,1.139668,45,153855.1852,8547.510291,3419.004116,320.925614,1,2
0,0,5,5,7,13,20,16,17,33,0.000333,0.047541,3,427.870881,23.770605,142.623627,67.757201,1,2
0,0,3,3,9,8,17,16,10,26,0.000333,0.035425,4,425.096135,23.616452,106.274034,52.529325,3,2
0,0,5,5,7,7,14,16,11,27,0.000333,0.034266,3,308.395749,17.133097,102.798583,39.302969,1,2
0,0,5,5,8,8,16,19,12,31,0.000333,0.041333,4,496,27.555556,124,48,1,2
0,0,6,6,9,9,18,21,16,37,0.000333,0.051429,4,617.1489,34.28605,154.287225,57.05865,1,2
0,0,6,6,8,15,23,31,27,58,0.000333,0.087456,4,1049.466374,58.303687,262.366593,82.603359,1,2
0,0,11,11,17,22,39,92,44,136,0.000333,0.239605,16,11501.03523,638.946402,718.814702,167.594364,5,2
0,0,9,9,10,9,19,31,22,53,0.000333,0.075047,10,2251.401582,125.077866,225.140158,61.748606,1,2
0,0,11,11,10,15,25,61,32,93,0.000333,0.14396,10,4318.786256,239.93257,431.878626,91.82264,3,2
0,0,27,27,15,31,46,153,104,257,0.000333,0.473185,21,29810.66388,1656.147993,1419.555423,212.183445,2,2
0,0,8,8,14,14,28,45,30,75,0.000333,0.120184,14,5047.722668,280.429037,360.551619,106.605938,5,2
0,0,5,5,7,9,16,23,14,37,0.000333,0.049333,3,444,24.666667,148,48.180809,1,2
0,0,28,28,16,36,52,155,94,249,0.000333,0.473136,16,22710.55184,1261.697324,1419.40949,250.1173,2,2
0,0,4,4,5,10,15,17,15,32,0.000333,0.041673,2,250.040998,13.891167,125.020499,44.828921,1,2
0,0,4,4,6,8,14,14,11,25,0.000333,0.031728,3,285.551619,15.863979,95.183873,39.509775,1,2
0,0,4,4,9,9,18,30,16,46,0.000333,0.063939,4,767.2662,42.6259,191.81655,57.05865,1,2
0,0,6,6,9,11,20,30,19,49,0.000333,0.070591,4,847.097907,47.060995,211.774477,66.583073,1,2
0,0,4,4,9,10,19,19,13,32,0.000333,0.045311,4,543.734722,30.207485,135.93368,61.748606,3,2
0,0,15,15,10,21,31,67,37,104,0.000333,0.171745,5,2576.182081,143.121227,515.236416,125.457947,2,2
0,0,6,6,9,9,18,30,19,49,0.000333,0.068109,8,1634.610601,90.8117,204.326325,57.05865,1,2
0,0,7,7,8,12,20,29,24,53,0.000333,0.076354,8,1832.497512,101.805417,229.062189,67.01955,1,2
0,0,3,3,9,8,17,16,10,26,0.000333,0.035425,4,425.096135,23.616452,106.274034,52.529325,3,2
0,0,14,14,15,23,38,100,44,144,0.000333,0.251901,7,5289.910934,293.883941,755.701562,162.645284,11,2
0,0,6,6,7,11,18,37,23,60,0.000333,0.083399,6,1501.173001,83.3985,250.1955,57.705232,1,2
0,0,4,4,4,7,11,13,11,24,0.000333,0.027675,2,166.052718,9.225151,83.026359,27.651484,2,2
0,0,5,5,11,11,22,24,15,39,0.000333,0.057973,5,869.589166,48.310509,173.917833,76.107496,3,2
0,0,6,6,8,12,20,29,18,47,0.000333,0.06771,4,812.522482,45.140138,203.13062,67.01955,1,2
0,0,6,6,13,12,25,39,24,63,0.000333,0.097521,12,3510.755279,195.04196,292.56294,91.125266,5,2
0,0,4,4,11,9,20,21,12,33,0.000333,0.047541,5,713.118136,39.617674,142.623627,66.583073,3,2
0,0,5,5,10,10,20,29,17,46,0.000333,0.06627,5,994.043462,55.224637,198.808692,66.438562,1,2
0,0,4,4,4,7,11,13,11,24,0.000333,0.027675,2,166.052718,9.225151,83.026359,27.651484,2,2
0,0,4,4,8,7,15,17,10,27,0.000333,0.035162,4,421.944184,23.441344,105.486046,43.651484,1,2
0,0,5,5,8,10,18,28,17,45,0.000333,0.062549,4,750.5865,41.69925,187.646625,57.219281,1,2
0,0,5,5,8,8,16,19,12,31,0.000333,0.041333,4,496,27.555556,124,48,1,2
0,0,5,5,7,7,14,16,11,27,0.000333,0.034266,3,308.395749,17.133097,102.798583,39.302969,1,2
0,0,3,3,9,6,15,19,10,29,0.000333,0.037767,4,453.199309,25.177739,113.299827,44.0391,1,2
0,0,4,4,5,9,14,15,13,28,0.000333,0.035535,2,213.211876,11.845104,106.605938,40.138965,1,2
0,0,4,4,8,10,18,25,15,40,0.000333,0.055599,4,667.188,37.066,166.797,57.219281,1,2
0,0,16,16,14,19,33,71,45,116,0.000333,0.19505,14,8192.09605,455.116447,585.149718,134.013592,2,2
0,0,4,4,7,7,14,15,10,25,0.000333,0.031728,3,285.551619,15.863979,95.183873,39.302969,1,2
0,0,4,4,11,10,21,24,14,38,0.000333,0.055636,5,834.54031,46.363351,166.908062,71.273029,4,2
0,0,10,10,12,15,27,59,34,93,0.000333,0.147402,12,5306.454452,294.803025,442.204538,101.622909,2,2
0,0,5,5,8,11,19,33,18,51,0.000333,0.072215,4,866.577213,48.143178,216.644303,62.053748,1,2
0,0,5,5,8,8,16,19,12,31,0.000333,0.041333,4,496,27.555556,124,48,1,2
0,0,5,5,9,17,26,33,28,61,0.000333,0.095576,4,1146.907291,63.717072,286.726823,98.016193,1,2
0,0,4,4,11,9,20,21,12,33,0.000333,0.047541,5,713.118136,39.617674,142.623627,66.583073,3,2
0,0,6,6,9,14,23,24,24,48,0.000333,0.072377,4,868.523896,48.251328,217.130974,81.832294,1,2
0,0,7,7,12,17,29,39,31,70,0.000333,0.113353,6,2040.352018,113.35289,340.05867,112.506418,5,2
0,0,48,48,12,20,32,263,154,417,0.000333,0.695,42,87570,4865,2085,129.458112,32,2
0,0,7,7,9,13,22,23,22,45,0.000333,0.066891,4,802.697691,44.594316,200.674423,76.635041,1,2
0,0,9,9,16,17,33,54,35,89,0.000333,0.14965,16,7183.217226,399.067624,448.951077,133.486868,5,2
0,0,3,3,5,5,10,13,8,21,0.000333,0.023253,2,139.52098,7.751166,69.76049,23.219281,1,2
0,0,18,18,15,25,40,129,76,205,0.000333,0.363665,21,22910.90045,1272.827803,1090.995259,174.699764,5,2
0,0,4,4,10,12,22,22,16,38,0.000333,0.056486,5,847.292008,47.071778,169.458402,76.238831,2,2
0,0,3,3,9,8,17,16,11,27,0.000333,0.036787,4,441.445987,24.524777,110.361497,52.529325,2,2
0,0,7,7,11,19,30,44,28,72,0.000333,0.117765,5,1766.480614,98.137812,353.296123,118.764371,2,2
0,0,4,4,5,9,14,15,13,28,0.000333,0.035535,2,213.211876,11.845104,106.605938,40.138965,1,2
0,0,5,5,9,9,18,29,17,46,0.000333,0.063939,4,767.2662,42.6259,191.81655,57.05865,1,2
0,0,4,4,4,10,14,16,13,29,0.000333,0.036804,2,220.826585,12.268144,110.413293,41.219281,1,2
0,0,4,4,8,7,15,15,10,25,0.000333,0.032557,4,390.68906,21.704948,97.672265,43.651484,1,2
0,0,4,4,7,14,21,18,18,36,0.000333,0.052708,3,474.370282,26.353905,158.123427,72.954453,1,2
0,0,8,8,9,12,21,37,22,59,0.000333,0.086382,4,1036.586912,57.588162,259.146728,71.548875,1,2
0,0,5,5,7,8,15,17,12,29,0.000333,0.037767,3,339.899482,18.883305,113.299827,43.651484,1,2
0,0,11,11,13,21,34,77,38,115,0.000333,0.195019,6,3510.34936,195.019409,585.058227,140.344382,4,2
0,0,3,3,9,8,17,16,11,27,0.000333,0.036787,4,441.445987,24.524777,110.361497,52.529325,2,2
0,0,8,8,9,12,21,37,22,59,0.000333,0.086382,4,1036.586912,57.588162,259.146728,71.548875,1,2
0,0,5,5,7,11,18,15,15,30,0.000333,0.041699,3,375.29325,20.849625,125.09775,57.705232,1,2
0,0,9,9,13,11,24,46,28,74,0.000333,0.113096,12,4071.446701,226.191483,339.287225,86.159464,1,2
0,0,10,10,12,19,31,66,35,101,0.000333,0.166791,6,3002.242964,166.791276,500.373827,123.730173,9,2
0,0,15,15,10,22,32,69,38,107,0.000333,0.178333,5,2675,148.611111,535,131.326777,2,2
0,0,10,10,14,18,32,49,38,87,0.000333,0.145,14,6090,338.333333,435,128.361619,2,2
0,0,7,7,9,12,21,34,20,54,0.000333,0.079062,4,948.740563,52.707809,237.185141,71.548875,1,2
0,0,5,5,9,14,23,26,21,47,0.000333,0.070869,4,850.429648,47.246092,212.607412,81.832294,1,2
0,0,7,7,9,12,21,34,20,54,0.000333,0.079062,4,948.740563,52.707809,237.185141,71.548875,1,2
0,0,5,5,8,11,19,33,18,51,0.000333,0.072215,4,866.577213,48.143178,216.644303,62.053748,1,2
0,0,8,8,8,12,20,35,24,59,0.000333,0.084998,8,2039.950061,113.330559,254.993758,67.01955,1,2
0,0,37,37,21,40,61,209,127,336,0.000333,0.664243,30,59781.83236,3321.212909,1992.727745,305.11579,3,2
0,0,3,3,4,5,9,12,12,24,0.000333,0.025359,4,304.3128,16.906267,76.0782,19.60964,1,2
0,0,5,5,7,9,16,23,14,37,0.000333,0.049333,3,444,24.666667,148,48.180809,1,2
0,0,9,9,11,10,21,34,23,57,0.000333,0.083454,10,2503.620931,139.090052,250.362093,71.273029,1,2
0,0,26,26,14,31,45,141,100,241,0.000333,0.441179,21,27794.26852,1544.126029,1323.536596,206.883055,2,2
0,0,27,27,14,31,45,146,104,250,0.000333,0.457654,21,28832.22876,1601.790486,1372.963274,206.883055,2,2
0,0,4,4,11,9,20,21,12,33,0.000333,0.047541,5,713.118136,39.617674,142.623627,66.583073,3,2
0,0,26,26,15,30,45,138,85,223,0.000333,0.408228,14,17145.56537,952.531409,1224.68324,205.810077,4,2
0,0,5,5,8,7,15,21,12,33,0.000333,0.042976,4,515.709559,28.650531,128.92739,43.651484,1,2
0,0,23,23,20,44,64,157,118,275,0.000333,0.55,20,33000,1833.333333,1650,326.653553,4,2
0,0,5,5,8,9,17,21,16,37,0.000333,0.050412,4,604.944501,33.608028,151.236125,52.529325,1,2
0,0,4,4,10,7,17,16,12,28,0.000333,0.03815,5,572.244798,31.791378,114.44896,52.870765,1,2
0,0,5,5,8,17,25,32,28,60,0.000333,0.092877,4,1114.525486,61.918083,278.631371,93.486868,1,2
0,0,3,3,10,8,18,22,12,34,0.000333,0.047259,5,708.88725,39.382625,141.77745,57.219281,4,2
0,0,5,5,7,7,14,16,11,27,0.000333,0.034266,3,308.395749,17.133097,102.798583,39.302969,1,2
0,0,7,7,8,15,23,37,28,65,0.000333,0.098011,4,1176.126109,65.340339,294.031527,82.603359,1,2
0,0,6,6,13,11,24,38,23,61,0.000333,0.093228,12,3356.192551,186.455142,279.682713,86.159464,4,2
0,0,11,11,16,21,37,91,43,134,0.000333,0.232689,16,11169.06802,620.503779,698.066751,156.238666,5,2
0,0,5,5,8,11,19,27,18,45,0.000333,0.063719,4,764.626952,42.479275,191.156738,62.053748,1,2
0,0,6,6,9,8,17,18,12,30,0.000333,0.040875,4,490.495541,27.249752,122.623885,52.529325,1,2
0,0,41,41,20,43,63,277,160,437,0.000333,0.87069,30,78362.1398,4353.452211,2612.071327,319.767946,12,2
0,0,4,4,11,10,21,24,14,38,0.000333,0.055636,5,834.54031,46.363351,166.908062,71.273029,4,2
0,0,6,6,7,13,20,35,24,59,0.000333,0.084998,3,764.981273,42.49896,254.993758,67.757201,1,2
0,0,3,3,9,8,17,16,10,26,0.000333,0.035425,4,425.096135,23.616452,106.274034,52.529325,3,2
0,0,4,4,4,7,11,13,11,24,0.000333,0.027675,2,166.052718,9.225151,83.026359,27.651484,2,2
0,0,3,3,7,7,14,10,8,18,0.000333,0.022844,3,205.597166,11.422065,68.532389,39.302969,3,2
0,0,4,4,10,9,19,20,12,32,0.000333,0.045311,5,679.668402,37.759356,135.93368,61.748606,3,2
0,0,7,7,9,12,21,34,20,54,0.000333,0.079062,4,948.740563,52.707809,237.185141,71.548875,1,2
0,0,16,16,14,19,33,71,45,116,0.000333,0.19505,14,8192.09605,455.116447,585.149718,134.013592,2,2
0,0,5,5,8,10,18,28,17,45,0.000333,0.062549,4,750.5865,41.69925,187.646625,57.219281,1,2
0,0,10,10,11,16,27,52,31,83,0.000333,0.131552,5,1973.278313,109.626573,394.655663,102.053748,1,2
0,0,7,7,9,12,21,34,20,54,0.000333,0.079062,4,948.740563,52.707809,237.185141,71.548875,1,2
0,0,4,4,6,13,19,15,16,31,0.000333,0.043895,3,395.057259,21.947625,131.685753,63.615491,1,2
0,0,3,3,8,7,15,15,9,24,0.000333,0.031255,4,375.061497,20.83675,93.765374,43.651484,3,2
0,0,5,5,7,7,14,16,11,27,0.000333,0.034266,3,308.395749,17.133097,102.798583,39.302969,1,2
0,0,17,17,15,24,39,123,66,189,0.000333,0.33298,14,13985.17427,776.954126,998.941019,168.642459,5,2
0,0,79,79,17,80,97,495,412,907,0.000333,1.995374,40,239444.8379,13302.491,5986.120948,575.241116,41,2
0,0,3,3,7,7,14,10,8,18,0.000333,0.022844,3,205.597166,11.422065,68.532389,39.302969,3,2
0,0,3,3,9,8,17,16,10,26,0.000333,0.035425,4,425.096135,23.616452,106.274034,52.529325,3,2
0,0,9,9,10,18,28,44,37,81,0.000333,0.129799,10,3893.957487,216.330971,389.395749,108.277931,1,2
0,0,16,16,14,19,33,71,45,116,0.000333,0.19505,14,8192.09605,455.116447,585.149718,134.013592,2,2
0,0,5,5,8,11,19,27,17,44,0.000333,0.062303,4,747.635242,41.535291,186.908811,62.053748,1,2
0,0,4,4,7,10,17,18,14,32,0.000333,0.0436,3,392.396433,21.799802,130.798811,52.870765,1,2
0,0,26,26,16,31,47,177,108,285,0.000333,0.527686,24,37993.38775,2110.743764,1583.057823,217.580086,6,2
0,0,4,4,8,8,16,18,12,30,0.000333,0.04,4,480,26.666667,120,48,1,2
0,0,5,5,7,12,19,15,16,31,0.000333,0.043895,3,395.057259,21.947625,131.685753,62.671034,1,2
0,0,5,5,8,8,16,24,16,40,0.000333,0.053333,8,1280,71.111111,160,48,1,2
0,0,3,3,8,6,14,11,9,20,0.000333,0.025382,4,304.588394,16.921577,76.147098,39.509775,1,2
0,0,5,5,7,9,16,23,14,37,0.000333,0.049333,3,444,24.666667,148,48.180809,1,2
0,0,5,5,10,10,20,33,18,51,0.000333,0.073473,5,1102.091664,61.227315,220.418333,66.438562,1,2
0,0,6,6,9,9,18,28,19,47,0.000333,0.065329,8,1567.891801,87.1051,195.986475,57.05865,1,2
0,0,14,14,18,17,35,89,51,140,0.000333,0.239367,27,19388.6898,1077.149434,718.099622,144.545518,4,2
0,0,5,5,8,11,19,27,17,44,0.000333,0.062303,4,747.635242,41.535291,186.908811,62.053748,1,2
0,0,63,63,20,44,64,352,263,615,0.000333,1.23,50,184500,10250,3690,326.653553,1,2
0,0,10,10,12,15,27,59,34,93,0.000333,0.147402,12,5306.454452,294.803025,442.204538,101.622909,2,2
0,0,15,15,14,19,33,66,42,108,0.000333,0.181598,14,7627.123908,423.729106,544.794565,134.013592,2,2
0,0,15,15,15,20,35,71,44,115,0.000333,0.196623,14,8258.145657,458.78587,589.867547,145.041921,2,2
0,0,8,8,14,13,27,32,22,54,0.000333,0.085588,7,1797.347476,99.852638,256.763925,101.408685,2,2
0,0,8,8,11,15,26,31,23,54,0.000333,0.084608,5,1269.118724,70.506596,253.823745,96.657107,1,2
0,0,5,5,9,9,18,27,17,44,0.000333,0.061159,4,733.9068,40.7726,183.4767,57.05865,1,2
0,0,3,3,10,8,18,17,13,30,0.000333,0.041699,5,625.48875,34.749375,125.09775,57.219281,1,2
0,0,4,4,11,10,21,24,14,38,0.000333,0.055636,5,834.54031,46.363351,166.908062,71.273029,4,2
0,0,11,11,12,20,32,47,36,83,0.000333,0.138333,6,2490,138.333333,415,129.458112,2,2
0,0,20,20,14,28,42,143,65,208,0.000333,0.373867,14,15702.42834,872.35713,1121.602024,187.908907,12,2
0,0,6,6,8,11,19,32,20,52,0.000333,0.073631,4,883.568923,49.087162,220.892231,62.053748,1,2
0,0,4,4,7,11,18,24,17,41,0.000333,0.056989,3,512.900775,28.494488,170.966925,57.705232,1,2
0,0,4,4,9,9,18,22,13,35,0.000333,0.048649,4,583.7895,32.43275,145.947375,57.05865,3,2
0,0,7,7,7,12,19,38,27,65,0.000333,0.092038,6,1656.69173,92.038429,276.115288,62.671034,1,2
0,0,4,4,11,9,20,21,12,33,0.000333,0.047541,5,713.118136,39.617674,142.623627,66.583073,3,2
0,0,4,4,10,9,19,20,12,32,0.000333,0.045311,5,679.668402,37.759356,135.93368,61.748606,3,2
0,0,5,5,7,8,15,20,15,35,0.000333,0.04558,3,410.223513,22.790195,136.741171,43.651484,1,2
0,0,3,3,8,7,15,15,9,24,0.000333,0.031255,4,375.061497,20.83675,93.765374,43.651484,3,2
0,0,11,11,18,19,37,57,42,99,0.000333,0.171912,18,9283.245898,515.735883,515.735883,155.769273,3,2
0,0,8,8,12,16,28,42,26,68,0.000333,0.108967,6,1961.400808,108.966712,326.900135,107.01955,2,2
0,0,5,5,8,11,19,33,18,51,0.000333,0.072215,4,866.577213,48.143178,216.644303,62.053748,1,2
0,0,5,5,8,11,19,27,18,45,0.000333,0.063719,4,764.626952,42.479275,191.156738,62.053748,1,2
0,0,5,5,8,10,18,28,17,45,0.000333,0.062549,4,750.5865,41.69925,187.646625,57.219281,1,2
0,0,10,10,12,18,30,58,29,87,0.000333,0.1423,6,2561.396891,142.299827,426.899482,118.0782,5,2
0,0,4,4,11,10,21,24,14,38,0.000333,0.055636,5,834.54031,46.363351,166.908062,71.273029,4,2
0,0,5,5,11,10,21,31,17,48,0.000333,0.070277,5,1054.156181,58.564232,210.831236,71.273029,1,2
0,0,7,7,10,14,24,40,27,67,0.000333,0.102397,5,1535.962438,85.331247,307.192488,86.52225,1,2
0,0,33,33,18,35,53,194,114,308,0.000333,0.588067,27,47633.3865,2646.29925,1764.1995,254.583556,7,2
0,0,4,4,5,9,14,15,13,28,0.000333,0.035535,2,213.211876,11.845104,106.605938,40.138965,1,2
0,0,15,15,10,21,31,67,37,104,0.000333,0.171745,5,2576.182081,143.121227,515.236416,125.457947,2,2
0,0,5,5,10,10,20,29,17,46,0.000333,0.06627,5,994.043462,55.224637,198.808692,66.438562,1,2
0,0,4,4,5,7,12,14,10,24,0.000333,0.02868,2,172.0782,9.5599,86.0391,31.261125,2,2
0,0,5,5,8,10,18,28,17,45,0.000333,0.062549,4,750.5865,41.69925,187.646625,57.219281,1,2
0,0,17,17,16,22,38,108,58,166,0.000333,0.290385,16,13938.49548,774.36086,871.155967,162.107496,2,2
0,0,5,5,12,13,25,38,21,59,0.000333,0.091329,6,1643.925091,91.329172,273.987515,91.125266,2,2
0,0,5,5,8,10,18,28,17,45,0.000333,0.062549,4,750.5865,41.69925,187.646625,57.219281,1,2
0,0,5,5,8,10,18,28,17,45,0.000333,0.062549,4,750.5865,41.69925,187.646625,57.219281,1,2
0,0,5,5,8,11,19,27,17,44,0.000333,0.062303,4,747.635242,41.535291,186.908811,62.053748,1,2
0,0,5,5,9,10,19,26,17,43,0.000333,0.060887,4,730.643532,40.591307,182.660883,61.748606,1,2
0,0,3,3,8,7,15,15,9,24,0.000333,0.031255,4,375.061497,20.83675,93.765374,43.651484,3,2
0,0,5,5,7,8,15,20,15,35,0.000333,0.04558,3,410.223513,22.790195,136.741171,43.651484,1,2
0,0,12,12,12,21,33,80,59,139,0.000333,0.233724,12,8414.049391,467.447188,701.170783,135.258216,1,2
0,0,3,3,9,8,17,16,10,26,0.000333,0.035425,4,425.096135,23.616452,106.274034,52.529325,3,2
0,0,18,18,15,24,39,109,62,171,0.000333,0.301268,14,12653.25291,702.958495,903.803779,168.642459,2,2
0,0,4,4,8,10,18,14,12,26,0.000333,0.036139,4,433.6722,24.0929,108.41805,57.219281,3,2
0,0,6,6,9,14,23,24,24,48,0.000333,0.072377,4,868.523896,48.251328,217.130974,81.832294,1,2
0,0,4,4,6,6,12,14,12,26,0.000333,0.03107,6,559.25415,31.069675,93.209025,31.01955,1,2
0,0,13,13,17,19,36,64,48,112,0.000333,0.193011,16,9264.505603,514.694756,579.0316,150.197491,3,2
0,0,39,39,18,40,58,215,132,347,0.000333,0.677573,27,54883.42394,3049.079108,2032.719405,287.935774,3,2
0,0,6,6,8,11,19,24,18,42,0.000333,0.059471,4,713.651822,39.647323,178.412956,62.053748,1,2
0,0,12,12,10,22,32,60,43,103,0.000333,0.171667,5,2575,143.055556,515,131.326777,4,2
0,0,5,5,7,7,14,17,13,30,0.000333,0.038074,3,342.661943,19.036775,114.220648,39.302969,1,2
0,0,3,3,8,6,14,11,9,20,0.000333,0.025382,4,304.588394,16.921577,76.147098,39.509775,1,2
0,0,3,3,7,7,14,10,8,18,0.000333,0.022844,3,205.597166,11.422065,68.532389,39.302969,3,2
0,0,9,9,10,10,20,32,23,55,0.000333,0.079235,10,2377.060452,132.058914,237.706045,66.438562,1,2
0,0,16,16,15,20,35,76,47,123,0.000333,0.210301,14,8832.625355,490.701409,630.901811,145.041921,2,2
0,0,5,5,7,13,20,18,18,36,0.000333,0.051863,3,466.768234,25.931569,155.589411,67.757201,1,2
0,0,5,5,10,13,23,27,20,47,0.000333,0.070869,5,1063.03706,59.057614,212.607412,81.324997,1,2
0,0,6,6,8,11,19,31,18,49,0.000333,0.069383,4,832.593793,46.255211,208.148448,62.053748,1,2
0,0,4,4,7,8,15,21,12,33,0.000333,0.042976,3,386.782169,21.487898,128.92739,43.651484,1,2
0,0,6,6,13,11,24,38,23,61,0.000333,0.093228,12,3356.192551,186.455142,279.682713,86.159464,4,2
0,0,34,34,16,34,50,503,120,623,0.000333,1.172041,24,84386.93775,4688.163208,3516.122406,236.973737,2,2
0,0,5,5,8,11,19,33,18,51,0.000333,0.072215,4,866.577213,48.143178,216.644303,62.053748,1,2
0,0,4,4,11,10,21,24,14,38,0.000333,0.055636,5,834.54031,46.363351,166.908062,71.273029,4,2
0,0,3,3,9,8,17,16,11,27,0.000333,0.036787,4,441.445987,24.524777,110.361497,52.529325,2,2
0,0,3,3,7,7,14,10,8,18,0.000333,0.022844,3,205.597166,11.422065,68.532389,39.302969,3,2
0,0,6,6,13,12,25,39,24,63,0.000333,0.097521,12,3510.755279,195.04196,292.56294,91.125266,5,2
0,0,6,6,10,11,21,27,18,45,0.000333,0.065885,5,988.27142,54.903968,197.654284,71.273029,1,2
0,0,4,4,7,11,18,24,17,41,0.000333,0.056989,3,512.900775,28.494488,170.966925,57.705232,1,2
0,0,6,6,7,13,20,35,24,59,0.000333,0.084998,3,764.981273,42.49896,254.993758,67.757201,1,2
0,0,6,6,8,11,19,32,20,52,0.000333,0.073631,4,883.568923,49.087162,220.892231,62.053748,1,2
0,0,6,6,13,11,24,38,23,61,0.000333,0.093228,12,3356.192551,186.455142,279.682713,86.159464,4,2
0,0,5,5,10,9,19,26,15,41,0.000333,0.058055,5,870.82514,48.379174,174.165028,61.748606,1,2
0,0,5,5,13,9,22,25,14,39,0.000333,0.057973,6,1043.506999,57.972611,173.917833,76.635041,2,2
0,0,5,5,10,10,20,24,19,43,0.000333,0.061948,5,929.21454,51.62303,185.842908,66.438562,1,2
0,0,25,25,15,30,45,170,104,274,0.000333,0.501589,21,31600.12272,1755.562373,1504.767748,205.810077,8,2
0,0,4,4,11,9,20,21,12,33,0.000333,0.047541,5,713.118136,39.617674,142.623627,66.583073,3,2
0,0,5,5,7,12,19,33,22,55,0.000333,0.077879,3,700.90804,38.939336,233.636013,62.671034,1,2
0,0,5,5,8,10,18,28,17,45,0.000333,0.062549,4,750.5865,41.69925,187.646625,57.219281,1,2
0,0,6,6,8,12,20,35,25,60,0.000333,0.086439,8,2074.525486,115.251416,259.315686,67.01955,1,2
0,0,28,28,19,38,57,150,96,246,0.000333,0.478297,18,25828.03698,1434.890943,1434.890943,280.131868,7,2
0,0,4,4,7,14,21,18,18,36,0.000333,0.052708,3,474.370282,26.353905,158.123427,72.954453,1,2
0,0,7,7,10,11,21,33,21,54,0.000333,0.079062,5,1185.925704,65.884761,237.185141,71.273029,1,2
0,0,5,5,8,11,19,27,17,44,0.000333,0.062303,4,747.635242,41.535291,186.908811,62.053748,1,2
0,0,5,5,8,11,19,27,18,45,0.000333,0.063719,4,764.626952,42.479275,191.156738,62.053748,1,2
0,0,10,10,13,13,26,47,30,77,0.000333,0.120645,12,4343.2063,241.289239,361.933858,96.211433,2,2
0,0,4,4,8,8,16,18,12,30,0.000333,0.04,4,480,26.666667,120,48,1,2
0,0,9,9,16,17,33,54,35,89,0.000333,0.14965,16,7183.217226,399.067624,448.951077,133.486868,5,2
0,0,4,4,11,9,20,21,12,33,0.000333,0.047541,5,713.118136,39.617674,142.623627,66.583073,3,2
0,0,18,18,16,22,38,89,59,148,0.000333,0.258898,16,12427.09235,690.39402,776.693272,162.107496,2,2
0,0,18,18,15,27,42,112,55,167,0.000333,0.300172,14,12607.23813,700.402119,900.51701,186.985321,7,2
0,0,4,4,11,11,22,22,14,36,0.000333,0.053513,5,802.697691,44.594316,160.539538,76.107496,3,2
0,0,3,3,7,7,14,10,8,18,0.000333,0.022844,3,205.597166,11.422065,68.532389,39.302969,3,2
0,0,3,3,9,7,16,19,11,30,0.000333,0.04,4,480,26.666667,120,48.180809,1,2
0,0,4,4,7,6,13,14,9,23,0.000333,0.02837,3,255.330341,14.185019,85.110114,35.161259,1,2
0,0,37,37,18,41,59,254,139,393,0.000333,0.770626,27,62420.7254,3467.818078,2311.878718,294.718282,4,2
0,0,4,4,11,9,20,21,12,33,0.000333,0.047541,5,713.118136,39.617674,142.623627,66.583073,3,2
0,0,3,3,8,7,15,15,9,24,0.000333,0.031255,4,375.061497,20.83675,93.765374,43.651484,3,2
0,0,5,5,7,8,15,17,12,29,0.000333,0.037767,3,339.899482,18.883305,113.299827,43.651484,1,2
0,0,4,4,9,9,18,22,13,35,0.000333,0.048649,4,583.7895,32.43275,145.947375,57.05865,3,2
0,0,5,5,10,10,20,33,18,51,0.000333,0.073473,5,1102.091664,61.227315,220.418333,66.438562,1,2
0,0,18,18,15,25,40,112,63,175,0.000333,0.310446,14,13038.72383,724.373546,931.337417,174.699764,2,2
0,0,6,6,8,7,15,20,13,33,0.000333,0.042976,4,515.709559,28.650531,128.92739,43.651484,1,2
0,0,6,6,13,11,24,38,23,61,0.000333,0.093228,12,3356.192551,186.455142,279.682713,86.159464,4,2
0,0,6,6,9,9,18,28,19,47,0.000333,0.065329,8,1567.891801,87.1051,195.986475,57.05865,1,2
0,0,7,7,9,12,21,34,20,54,0.000333,0.079062,4,948.740563,52.707809,237.185141,71.548875,1,2
0,0,5,5,7,9,16,23,14,37,0.000333,0.049333,3,444,24.666667,148,48.180809,1,2
0,0,5,5,7,7,14,16,11,27,0.000333,0.034266,3,308.395749,17.133097,102.798583,39.302969,1,2
0,0,4,4,4,8,12,14,12,26,0.000333,0.03107,2,186.41805,10.356558,93.209025,32,1,2
0,0,6,6,13,12,25,39,24,63,0.000333,0.097521,12,3510.755279,195.04196,292.56294,91.125266,5,2
0,0,5,5,11,12,23,24,16,40,0.000333,0.060314,5,904.712391,50.2618,180.942478,81.073298,3,2
0,0,4,4,11,9,20,21,12,33,0.000333,0.047541,5,713.118136,39.617674,142.623627,66.583073,3,2
0,0,4,4,8,10,18,14,12,26,0.000333,0.036139,4,433.6722,24.0929,108.41805,57.219281,3,2
0,0,3,3,6,4,10,17,9,26,0.000333,0.02879,6,518.220783,28.790043,86.37013,23.509775,1,2
0,0,7,7,10,12,22,39,19,58,0.000333,0.086216,5,1293.235169,71.846398,258.647034,76.238831,4,2
0,0,6,6,9,11,20,31,19,50,0.000333,0.072032,4,864.385619,48.021423,216.096405,66.583073,1,2
0,0,5,5,8,11,19,27,17,44,0.000333,0.062303,4,747.635242,41.535291,186.908811,62.053748,1,2
0,0,5,5,7,11,18,15,15,30,0.000333,0.041699,3,375.29325,20.849625,125.09775,57.705232,1,2
0,0,6,6,9,13,22,23,22,45,0.000333,0.066891,4,802.697691,44.594316,200.674423,76.635041,1,2
0,0,4,4,8,10,18,19,14,33,0.000333,0.045869,4,550.4301,30.57945,137.607525,57.219281,1,2
0,0,6,6,12,11,23,33,18,51,0.000333,0.076901,6,1384.209959,76.900553,230.70166,81.073298,1,2
0,0,3,3,7,7,14,10,8,18,0.000333,0.022844,3,205.597166,11.422065,68.532389,39.302969,3,2
0,0,6,6,13,12,25,39,24,63,0.000333,0.097521,12,3510.755279,195.04196,292.56294,91.125266,5,2
0,0,17,17,16,22,38,105,58,163,0.000333,0.285137,16,13686.59496,760.366386,855.412185,162.107496,2,2
0,0,38,38,18,40,58,227,138,365,0.000333,0.712721,27,57730.40271,3207.244595,2138.163063,287.935774,9,2
0,0,8,8,12,16,28,42,26,68,0.000333,0.108967,6,1961.400808,108.966712,326.900135,107.01955,2,2
0,0,26,26,23,29,52,169,84,253,0.000333,0.480737,22,31728.64747,1762.702637,1442.211249,244.923374,9,2
0,0,9,9,16,17,33,54,35,89,0.000333,0.14965,16,7183.217226,399.067624,448.951077,133.486868,5,2
0,0,63,63,20,45,65,343,256,599,0.000333,1.202466,50,180369.916,10020.55089,3607.39832,333.571951,1,2
0,0,4,4,4,7,11,13,11,24,0.000333,0.027675,2,166.052718,9.225151,83.026359,27.651484,2,2
0,0,90,90,20,56,76,430,314,744,0.000333,1.549486,50,232422.9035,12912.38353,4648.45807,411.650438,22,2
0,0,31,31,15,31,46,221,123,344,0.000333,0.633368,21,39902.21157,2216.789532,1900.105313,212.183445,5,2
0,0,5,5,8,8,16,19,12,31,0.000333,0.041333,4,496,27.555556,124,48,1,2
0,0,4,4,9,10,19,19,13,32,0.000333,0.045311,4,543.734722,30.207485,135.93368,61.748606,3,2
0,0,3,3,8,7,15,15,9,24,0.000333,0.031255,4,375.061497,20.83675,93.765374,43.651484,3,2
0,0,4,4,4,7,11,13,11,24,0.000333,0.027675,2,166.052718,9.225151,83.026359,27.651484,2,2
0,0,3,3,8,6,14,11,9,20,0.000333,0.025382,4,304.588394,16.921577,76.147098,39.509775,1,2
0,0,6,6,8,8,16,21,14,35,0.000333,0.046667,4,560,31.111111,140,48,1,2
0,0,3,3,8,7,15,20,12,32,0.000333,0.041673,4,500.081996,27.782333,125.020499,43.651484,1,2
0,0,5,5,10,10,20,33,18,51,0.000333,0.073473,5,1102.091664,61.227315,220.418333,66.438562,1,2
0,0,6,6,10,12,22,38,26,64,0.000333,0.095135,10,2854.036236,158.557569,285.403624,76.238831,6,2
0,0,15,15,10,21,31,67,37,104,0.000333,0.171745,5,2576.182081,143.121227,515.236416,125.457947,2,2
0,0,6,6,7,9,16,20,15,35,0.000333,0.046667,3,420,23.333333,140,48.180809,1,2
0,0,4,4,9,10,19,19,13,32,0.000333,0.045311,4,543.734722,30.207485,135.93368,61.748606,3,2
0,0,9,9,10,12,22,42,28,70,0.000333,0.104053,10,3121.602133,173.422341,312.160213,76.238831,1,2
0,0,3,3,8,7,15,15,9,24,0.000333,0.031255,4,375.061497,20.83675,93.765374,43.651484,3,2
0,0,3,3,8,7,15,15,9,24,0.000333,0.031255,4,375.061497,20.83675,93.765374,43.651484,3,2
0,0,38,38,21,44,65,252,154,406,0.000333,0.815027,30,73352.43996,4075.135553,2445.081332,332.453657,13,2
0,0,7,7,10,14,24,28,25,53,0.000333,0.081001,5,1215.015063,67.500837,243.003013,86.52225,1,2
0,0,4,4,11,10,21,24,14,38,0.000333,0.055636,5,834.54031,46.363351,166.908062,71.273029,4,2
0,0,4,4,5,8,13,14,12,26,0.000333,0.03207,2,192.422865,10.690159,96.211433,35.60964,1,2
0,0,9,9,16,17,33,54,35,89,0.000333,0.14965,16,7183.217226,399.067624,448.951077,133.486868,5,2
0,0,3,3,8,7,15,15,9,24,0.000333,0.031255,4,375.061497,20.83675,93.765374,43.651484,3,2
0,0,5,5,8,10,18,28,17,45,0.000333,0.062549,4,750.5865,41.69925,187.646625,57.219281,1,2
0,0,3,3,8,7,15,20,12,32,0.000333,0.041673,4,500.081996,27.782333,125.020499,43.651484,1,2
0,0,6,6,12,11,23,33,18,51,0.000333,0.076901,6,1384.209959,76.900553,230.70166,81.073298,1,2
0,0,10,10,13,13,26,47,30,77,0.000333,0.120645,12,4343.2063,241.289239,361.933858,96.211433,2,2
0,0,5,5,10,9,19,26,15,41,0.000333,0.058055,5,870.82514,48.379174,174.165028,61.748606,1,2
0,0,5,5,8,10,18,28,17,45,0.000333,0.062549,4,750.5865,41.69925,187.646625,57.219281,1,2
0,0,6,6,12,12,24,24,19,43,0.000333,0.065718,6,1182.920325,65.717796,197.153388,86.0391,2,2
0,0,4,4,11,11,22,22,14,36,0.000333,0.053513,5,802.697691,44.594316,160.539538,76.107496,3,2
0,0,6,6,7,9,16,20,15,35,0.000333,0.046667,3,420,23.333333,140,48.180809,1,2
0,0,13,13,18,17,35,81,46,127,0.000333,0.21714,18,11725.54098,651.418943,651.418943,144.545518,4,2
0,0,7,7,9,12,21,34,20,54,0.000333,0.079062,4,948.740563,52.707809,237.185141,71.548875,1,2
0,0,3,3,8,7,15,20,12,32,0.000333,0.041673,4,500.081996,27.782333,125.020499,43.651484,1,2
0,0,4,4,5,10,15,15,14,29,0.000333,0.037767,2,226.599655,12.58887,113.299827,44.828921,1,2
0,0,5,5,8,10,18,28,17,45,0.000333,0.062549,4,750.5865,41.69925,187.646625,57.219281,1,2
0,0,7,7,9,12,21,34,20,54,0.000333,0.079062,4,948.740563,52.707809,237.185141,71.548875,1,2
0,0,4,4,7,12,19,15,15,30,0.000333,0.042479,3,382.313476,21.239638,127.437825,62.671034,1,2
0,0,5,5,7,8,15,20,14,34,0.000333,0.044278,3,398.502841,22.139047,132.83428,43.651484,1,2
0,0,4,4,8,13,21,20,17,37,0.000333,0.054172,4,650.062979,36.11461,162.515745,72.105716,1,2
0,0,4,4,11,9,20,21,12,33,0.000333,0.047541,5,713.118136,39.617674,142.623627,66.583073,3,2
0,0,4,4,7,8,15,21,12,33,0.000333,0.042976,3,386.782169,21.487898,128.92739,43.651484,1,2
0,0,5,5,8,12,20,32,23,55,0.000333,0.079235,4,950.824181,52.823566,237.706045,67.01955,1,2
0,0,6,6,13,12,25,39,24,63,0.000333,0.097521,12,3510.755279,195.04196,292.56294,91.125266,5,2
0,0,4,4,5,9,14,15,13,28,0.000333,0.035535,2,213.211876,11.845104,106.605938,40.138965,1,2
0,0,5,5,10,17,27,40,29,69,0.000333,0.109362,5,1640.436188,91.135344,328.087238,102.706149,1,2
0,0,5,5,7,7,14,16,11,27,0.000333,0.034266,3,308.395749,17.133097,102.798583,39.302969,1,2
0,0,5,5,7,8,15,17,12,29,0.000333,0.037767,3,339.899482,18.883305,113.299827,43.651484,1,2
0,0,5,5,7,9,16,23,14,37,0.000333,0.049333,3,444,24.666667,148,48.180809,1,2
0,0,4,4,11,9,20,21,12,33,0.000333,0.047541,5,713.118136,39.617674,142.623627,66.583073,3,2
0,0,15,15,15,20,35,71,44,115,0.000333,0.196623,14,8258.145657,458.78587,589.867547,145.041921,2,2
0,0,5,5,8,8,16,19,12,31,0.000333,0.041333,4,496,27.555556,124,48,1,2
0,0,8,8,11,15,26,45,29,74,0.000333,0.115944,5,1739.162696,96.62015,347.832539,96.657107,1,2
0,0,3,3,7,7,14,10,8,18,0.000333,0.022844,3,205.597166,11.422065,68.532389,39.302969,3,2
0,0,5,5,7,9,16,23,14,37,0.000333,0.049333,3,444,24.666667,148,48.180809,1,2
0,0,5,5,8,10,18,28,17,45,0.000333,0.062549,4,750.5865,41.69925,187.646625,57.219281,1,2
0,0,5,5,10,12,22,26,17,43,0.000333,0.063919,5,958.777798,53.265433,191.75556,76.238831,3,2
0,0,6,6,12,11,23,33,18,51,0.000333,0.076901,6,1384.209959,76.900553,230.70166,81.073298,1,2
0,0,4,4,7,11,18,24,17,41,0.000333,0.056989,3,512.900775,28.494488,170.966925,57.705232,1,2
0,0,6,6,7,13,20,35,24,59,0.000333,0.084998,3,764.981273,42.49896,254.993758,67.757201,1,2
0,0,11,11,12,17,29,72,40,112,0.000333,0.181365,12,6529.126457,362.729248,544.093871,112.506418,1,2
0,0,3,3,8,7,15,15,9,24,0.000333,0.031255,4,375.061497,20.83675,93.765374,43.651484,3,2
0,0,5,5,10,10,20,29,17,46,0.000333,0.06627,5,994.043462,55.224637,198.808692,66.438562,1,2
0,0,6,6,9,8,17,21,14,35,0.000333,0.047687,4,572.244798,31.791378,143.061199,52.529325,1,2
0,0,8,8,15,14,29,45,29,74,0.000333,0.11983,14,5032.868311,279.603795,359.490594,111.906328,4,2
0,0,3,3,8,7,15,15,9,24,0.000333,0.031255,4,375.061497,20.83675,93.765374,43.651484,3,2
0,0,4,4,10,9,19,20,12,32,0.000333,0.045311,5,679.668402,37.759356,135.93368,61.748606,3,2
0,0,3,3,6,5,11,14,8,22,0.000333,0.025369,3,228.322487,12.684583,76.107496,27.119415,4,2
0,0,6,6,8,12,20,37,25,62,0.000333,0.08932,8,2143.676335,119.09313,267.959542,67.01955,1,2
0,0,19,19,16,25,41,138,81,219,0.000333,0.391101,24,28159.29334,1564.405185,1173.303889,180.096405,7,2
0,0,3,3,6,4,10,17,9,26,0.000333,0.02879,6,518.220783,28.790043,86.37013,23.509775,1,2
0,0,5,5,11,10,21,31,17,48,0.000333,0.070277,5,1054.156181,58.564232,210.831236,71.273029,1,2
0,0,5,5,8,9,17,23,15,38,0.000333,0.051775,4,621.294352,34.516353,155.323588,52.529325,1,2
0,0,4,4,11,11,22,22,14,36,0.000333,0.053513,5,802.697691,44.594316,160.539538,76.107496,3,2
0,0,4,4,6,14,20,15,17,32,0.000333,0.046101,3,414.905097,23.050283,138.301699,68.812744,1,2
0,0,4,4,6,12,18,14,15,29,0.000333,0.040309,3,362.783475,20.154638,120.927825,58.529325,1,2
0,0,3,3,7,7,14,18,11,29,0.000333,0.036804,3,331.239878,18.402215,110.413293,39.302969,4,2
0,0,8,8,14,14,28,47,32,79,0.000333,0.126594,14,5316.934544,295.385252,379.781039,106.605938,4,2
0,0,5,5,7,8,15,17,12,29,0.000333,0.037767,3,339.899482,18.883305,113.299827,43.651484,1,2
0,0,19,19,19,27,46,143,64,207,0.000333,0.381126,18,20580.79185,1143.377325,1143.377325,209.092585,6,2
0,0,4,4,6,13,19,15,16,31,0.000333,0.043895,3,395.057259,21.947625,131.685753,63.615491,1,2
0,0,6,6,8,9,17,27,16,43,0.000333,0.058587,4,703.043609,39.057978,175.760902,52.529325,1,2
0,0,4,4,8,9,17,29,16,45,0.000333,0.061312,4,735.743311,40.874628,183.935828,52.529325,1,2
0,0,7,7,13,11,24,60,36,96,0.000333,0.146719,18,7922.815201,440.1564,440.1564,86.159464,3,2
0,0,7,7,12,14,26,38,27,65,0.000333,0.101843,6,1833.17149,101.842861,305.528582,96.322519,1,2
0,0,3,3,9,8,17,16,10,26,0.000333,0.035425,4,425.096135,23.616452,106.274034,52.529325,3,2
0,0,3,3,8,6,14,11,9,20,0.000333,0.025382,4,304.588394,16.921577,76.147098,39.509775,1,2
0,0,27,27,16,33,49,150,95,245,0.000333,0.458535,16,22009.66259,1222.759033,1375.603912,230.465006,2,2
0,0,4,4,11,10,21,24,14,38,0.000333,0.055636,5,834.54031,46.363351,166.908062,71.273029,4,2
0,0,4,4,8,8,16,18,12,30,0.000333,0.04,4,480,26.666667,120,48,1,2
0,0,4,4,4,10,14,16,13,29,0.000333,0.036804,2,220.826585,12.268144,110.413293,41.219281,1,2
0,0,5,5,8,10,18,28,17,45,0.000333,0.062549,4,750.5865,41.69925,187.646625,57.219281,1,2
0,0,16,16,15,20,35,76,47,123,0.000333,0.210301,14,8832.625355,490.701409,630.901811,145.041921,2,2
0,0,4,4,9,6,15,15,12,27,0.000333,0.035162,8,843.888369,46.882687,105.486046,44.0391,1,2
0,0,5,5,7,8,15,17,12,29,0.000333,0.037767,3,339.899482,18.883305,113.299827,43.651484,1,2
0,0,5,5,8,8,16,19,12,31,0.000333,0.041333,4,496,27.555556,124,48,1,2
0,0,27,27,15,31,46,155,104,259,0.000333,0.476868,21,30042.65348,1669.036304,1430.602547,212.183445,2,2
0,0,19,19,14,24,38,109,63,172,0.000333,0.300881,14,12637.00945,702.056081,902.643532,163.342069,2,2
0,0,4,4,8,7,15,23,14,37,0.000333,0.048185,8,1156.439616,64.246645,144.554952,43.651484,1,2
0,0,6,6,8,8,16,20,15,35,0.000333,0.046667,4,560,31.111111,140,48,1,2
0,0,18,18,17,24,41,103,65,168,0.000333,0.300023,16,14401.09979,800.061099,900.068737,179.525968,2,2
0,0,12,12,11,17,28,65,32,97,0.000333,0.155438,5,2331.567137,129.531508,466.313427,107.540616,6,2
0,0,16,16,14,25,39,105,50,155,0.000333,0.273079,14,11469.32282,637.184601,819.237344,169.399374,10,2
0,0,5,5,8,10,18,28,17,45,0.000333,0.062549,4,750.5865,41.69925,187.646625,57.219281,1,2
0,0,7,7,10,14,24,28,25,53,0.000333,0.081001,5,1215.015063,67.500837,243.003013,86.52225,1,2
0,0,4,4,7,9,16,17,12,29,0.000333,0.038667,3,348,19.333333,116,48.180809,1,2
0,0,5,5,7,7,14,16,11,27,0.000333,0.034266,3,308.395749,17.133097,102.798583,39.302969,1,2
0,0,4,4,11,10,21,24,14,38,0.000333,0.055636,5,834.54031,46.363351,166.908062,71.273029,4,2
0,0,6,6,12,11,23,33,18,51,0.000333,0.076901,6,1384.209959,76.900553,230.70166,81.073298,1,2
0,0,20,20,13,26,39,171,62,233,0.000333,0.4105,12,14777.9846,820.999145,1231.498717,170.317149,11,2
0,0,4,4,9,9,18,22,13,35,0.000333,0.048649,4,583.7895,32.43275,145.947375,57.05865,3,2
0,0,4,4,11,11,22,22,14,36,0.000333,0.053513,5,802.697691,44.594316,160.539538,76.107496,3,2
0,0,71,71,29,67,96,295,252,547,0.000333,1.200658,42,151282.9285,8404.607138,3601.974488,547.309425,20,2
0,0,4,4,10,9,19,20,12,32,0.000333,0.045311,5,679.668402,37.759356,135.93368,61.748606,3,2
0,0,20,20,15,25,40,141,82,223,0.000333,0.395597,21,24922.58927,1384.588293,1186.789965,174.699764,6,2
0,0,6,6,10,10,20,30,20,50,0.000333,0.072032,10,2160.964047,120.053558,216.096405,66.438562,1,2
0,0,4,4,4,7,11,13,11,24,0.000333,0.027675,2,166.052718,9.225151,83.026359,27.651484,2,2
0,0,5,5,7,7,14,19,13,32,0.000333,0.040612,3,365.506073,20.305893,121.835358,39.302969,1,2
0,0,4,4,9,9,18,22,13,35,0.000333,0.048649,4,583.7895,32.43275,145.947375,57.05865,3,2
0,0,3,3,9,8,17,16,11,27,0.000333,0.036787,4,441.445987,24.524777,110.361497,52.529325,2,2
0,0,4,4,7,11,18,24,17,41,0.000333,0.056989,3,512.900775,28.494488,170.966925,57.705232,1,2
0,0,5,5,10,17,27,40,29,69,0.000333,0.109362,5,1640.436188,91.135344,328.087238,102.706149,1,2
0,0,10,10,13,13,26,47,30,77,0.000333,0.120645,12,4343.2063,241.289239,361.933858,96.211433,2,2
0,0,9,9,12,17,29,44,28,72,0.000333,0.116592,6,2098.64779,116.591544,349.774632,112.506418,2,2
0,0,28,28,16,30,46,164,96,260,0.000333,0.478709,24,34467.02661,1914.834811,1436.126109,211.206718,2,2
0,0,7,7,10,10,20,46,31,77,0.000333,0.110929,15,4991.82695,277.323719,332.788463,66.438562,7,2
0,0,6,6,10,14,24,26,24,50,0.000333,0.076416,5,1146.240625,63.680035,229.248125,86.52225,1,2
0,0,3,3,9,8,17,16,10,26,0.000333,0.035425,4,425.096135,23.616452,106.274034,52.529325,3,2
0,0,13,13,9,10,19,50,33,83,0.000333,0.117526,12,4230.935803,235.051989,352.577984,61.748606,1,2
0,0,5,5,8,13,21,22,19,41,0.000333,0.060028,4,720.340057,40.018892,180.085014,72.105716,1,2
0,0,4,4,5,9,14,15,13,28,0.000333,0.035535,2,213.211876,11.845104,106.605938,40.138965,1,2
0,0,14,14,17,20,37,81,54,135,0.000333,0.234425,16,11252.41927,625.134404,703.276204,155.92543,2,2
0,0,8,8,12,16,28,42,26,68,0.000333,0.108967,6,1961.400808,108.966712,326.900135,107.01955,2,2
0,0,5,5,8,11,19,27,17,44,0.000333,0.062303,4,747.635242,41.535291,186.908811,62.053748,1,2
0,0,5,5,10,9,19,26,15,41,0.000333,0.058055,5,870.82514,48.379174,174.165028,61.748606,1,2
0,0,4,4,6,12,18,14,15,29,0.000333,0.040309,3,362.783475,20.154638,120.927825,58.529325,1,2
0,0,5,5,10,10,20,29,17,46,0.000333,0.06627,5,994.043462,55.224637,198.808692,66.438562,1,2
0,0,4,4,4,7,11,13,11,24,0.000333,0.027675,2,166.052718,9.225151,83.026359,27.651484,2,2
0,0,5,5,7,9,16,23,14,37,0.000333,0.049333,3,444,24.666667,148,48.180809,1,2
0,0,9,9,16,17,33,54,35,89,0.000333,0.14965,16,7183.217226,399.067624,448.951077,133.486868,5,2
0,0,6,6,8,9,17,21,16,37,0.000333,0.050412,4,604.944501,33.608028,151.236125,52.529325,1,2
0,0,10,10,12,16,28,61,37,98,0.000333,0.15704,12,5653.449388,314.080522,471.120782,107.01955,1,2
0,0,3,3,9,8,17,16,10,26,0.000333,0.035425,4,425.096135,23.616452,106.274034,52.529325,3,2
0,0,4,4,9,10,19,19,13,32,0.000333,0.045311,4,543.734722,30.207485,135.93368,61.748606,3,2
0,0,13,13,10,12,22,58,39,97,0.000333,0.144188,15,6488.473005,360.470723,432.564867,76.238831,1,2
0,0,10,10,8,16,24,42,40,82,0.000333,0.125322,8,3007.7354,167.096411,375.966925,88,1,2
0,0,4,4,7,13,20,21,19,40,0.000333,0.057626,3,518.631371,28.812854,172.877124,67.757201,1,2
0,0,5,5,8,11,19,27,17,44,0.000333,0.062303,4,747.635242,41.535291,186.908811,62.053748,1,2
0,0,4,4,9,9,18,22,13,35,0.000333,0.048649,4,583.7895,32.43275,145.947375,57.05865,3,2
0,0,3,3,8,7,15,15,9,24,0.000333,0.031255,4,375.061497,20.83675,93.765374,43.651484,3,2
0,0,3,3,10,7,17,19,11,30,0.000333,0.040875,5,613.119426,34.06219,122.623885,52.870765,1,2
0,0,7,7,9,12,21,34,20,54,0.000333,0.079062,4,948.740563,52.707809,237.185141,71.548875,1,2
0,0,9,9,8,17,25,42,35,77,0.000333,0.119192,8,2860.615413,158.923078,357.576927,93.486868,1,2
0,0,4,4,10,8,18,20,11,31,0.000333,0.043089,5,646.338375,35.907688,129.267675,57.219281,3,2
0,0,10,10,8,18,26,67,35,102,0.000333,0.159815,4,1917.779405,106.5433,479.444851,99.05865,1,2
0,0,6,6,11,11,22,26,17,43,0.000333,0.063919,5,958.777798,53.265433,191.75556,76.107496,3,2
0,0,5,5,8,10,18,28,17,45,0.000333,0.062549,4,750.5865,41.69925,187.646625,57.219281,1,2
0,0,3,3,8,7,15,20,12,32,0.000333,0.041673,4,500.081996,27.782333,125.020499,43.651484,1,2
0,0,18,18,16,22,38,89,59,148,0.000333,0.258898,16,12427.09235,690.39402,776.693272,162.107496,2,2
0,0,3,3,9,7,16,19,11,30,0.000333,0.04,4,480,26.666667,120,48.180809,1,2
0,0,17,17,14,17,31,84,53,137,0.000333,0.226242,21,14253.22279,791.84571,678.724895,122.789837,3,2
0,0,5,5,9,9,18,27,17,44,0.000333,0.061159,4,733.9068,40.7726,183.4767,57.05865,1,2
0,0,6,6,7,13,20,27,24,51,0.000333,0.073473,3,661.254999,36.736389,220.418333,67.757201,1,2
0,0,3,3,9,8,17,16,10,26,0.000333,0.035425,4,425.096135,23.616452,106.274034,52.529325,3,2
0,0,3,3,9,8,17,16,10,26,0.000333,0.035425,4,425.096135,23.616452,106.274034,52.529325,3,2
0,0,5,5,8,10,18,28,17,45,0.000333,0.062549,4,750.5865,41.69925,187.646625,57.219281,1,2
0,0,6,6,8,11,19,37,22,59,0.000333,0.083543,8,2005.021786,111.390099,250.627723,62.053748,1,2
0,0,4,4,11,11,22,22,14,36,0.000333,0.053513,5,802.697691,44.594316,160.539538,76.107496,3,2
0,0,7,7,9,12,21,34,20,54,0.000333,0.079062,4,948.740563,52.707809,237.185141,71.548875,1,2
0,0,4,4,10,9,19,20,12,32,0.000333,0.045311,5,679.668402,37.759356,135.93368,61.748606,3,2
0,0,18,18,17,24,41,103,65,168,0.000333,0.300023,16,14401.09979,800.061099,900.068737,179.525968,2,2
0,0,10,10,12,18,30,59,29,88,0.000333,0.143935,6,2590.838234,143.935457,431.806372,118.0782,5,2
0,0,4,4,8,7,15,15,10,25,0.000333,0.032557,4,390.68906,21.704948,97.672265,43.651484,1,2
0,0,3,3,7,7,14,10,8,18,0.000333,0.022844,3,205.597166,11.422065,68.532389,39.302969,3,2
0,0,5,5,10,10,20,29,17,46,0.000333,0.06627,5,994.043462,55.224637,198.808692,66.438562,1,2
0,0,4,4,9,9,18,22,13,35,0.000333,0.048649,4,583.7895,32.43275,145.947375,57.05865,3,2
0,0,11,11,17,17,34,61,43,104,0.000333,0.176365,16,8465.538168,470.307676,529.096135,138.973737,2,2
0,0,39,39,19,43,62,224,128,352,0.000333,0.698626,18,37725.78782,2095.877101,2095.877101,314.040007,8,2
0,0,3,3,6,4,10,17,9,26,0.000333,0.02879,6,518.220783,28.790043,86.37013,23.509775,1,2
0,0,3,3,8,7,15,15,9,24,0.000333,0.031255,4,375.061497,20.83675,93.765374,43.651484,3,2
0,0,4,4,8,10,18,31,16,47,0.000333,0.065329,4,783.9459,43.55255,195.986475,57.219281,1,2
0,0,4,4,7,13,20,15,16,31,0.000333,0.04466,3,401.939313,22.329962,133.979771,67.757201,1,2
0,0,5,5,10,10,20,33,18,51,0.000333,0.073473,5,1102.091664,61.227315,220.418333,66.438562,1,2
0,0,5,5,8,10,18,28,17,45,0.000333,0.062549,4,750.5865,41.69925,187.646625,57.219281,1,2
0,0,3,3,9,8,17,16,11,27,0.000333,0.036787,4,441.445987,24.524777,110.361497,52.529325,2,2
0,0,41,41,20,42,62,279,160,439,0.000333,0.871297,30,78416.76541,4356.486967,2613.89218,312.915894,8,2
0,0,4,4,11,11,22,22,14,36,0.000333,0.053513,5,802.697691,44.594316,160.539538,76.107496,3,2
0,0,3,3,8,7,15,15,9,24,0.000333,0.031255,4,375.061497,20.83675,93.765374,43.651484,3,2
0,0,4,4,11,10,21,24,14,38,0.000333,0.055636,5,834.54031,46.363351,166.908062,71.273029,4,2
0,0,3,3,8,7,15,20,12,32,0.000333,0.041673,4,500.081996,27.782333,125.020499,43.651484,1,2
0,0,10,10,12,16,28,61,37,98,0.000333,0.15704,12,5653.449388,314.080522,471.120782,107.01955,1,2
0,0,3,3,8,6,14,21,11,32,0.000333,0.040612,4,487.34143,27.074524,121.835358,39.509775,1,2
0,0,5,5,10,10,20,29,17,46,0.000333,0.06627,5,994.043462,55.224637,198.808692,66.438562,1,2
0,0,4,4,7,11,18,24,17,41,0.000333,0.056989,3,512.900775,28.494488,170.966925,57.705232,1,2
0,0,6,6,7,13,20,35,24,59,0.000333,0.084998,3,764.981273,42.49896,254.993758,67.757201,1,2
0,0,5,5,8,9,17,21,16,37,0.000333,0.050412,4,604.944501,33.608028,151.236125,52.529325,1,2
0,0,4,4,6,8,14,14,11,25,0.000333,0.031728,3,285.551619,15.863979,95.183873,39.509775,1,2
0,0,26,26,13,38,51,138,89,227,0.000333,0.429214,12,15451.68663,858.427035,1287.640553,247.526962,1,2
0,0,6,6,8,11,19,37,22,59,0.000333,0.083543,8,2005.021786,111.390099,250.627723,62.053748,1,2
0,0,6,6,9,9,18,28,19,47,0.000333,0.065329,8,1567.891801,87.1051,195.986475,57.05865,1,2
0,0,6,6,10,14,24,28,25,53,0.000333,0.081001,5,1215.015063,67.500837,243.003013,86.52225,1,2
0,0,5,5,7,9,16,23,14,37,0.000333,0.049333,3,444,24.666667,148,48.180809,1,2
0,0,6,6,9,9,18,24,16,40,0.000333,0.055599,4,667.188,37.066,166.797,57.05865,1,2
0,0,4,4,10,11,21,20,14,34,0.000333,0.04978,5,746.693962,41.482998,149.338792,71.273029,3,2
0,0,8,8,12,16,28,42,26,68,0.000333,0.108967,6,1961.400808,108.966712,326.900135,107.01955,2,2
0,0,13,13,10,12,22,70,41,111,0.000333,0.164999,15,7424.953645,412.497425,494.99691,76.238831,1,2
0,0,5,5,7,13,20,16,17,33,0.000333,0.047541,3,427.870881,23.770605,142.623627,67.757201,1,2
0,0,8,8,10,14,24,48,31,79,0.000333,0.120737,10,3622.120376,201.22891,362.212038,86.52225,1,2
0,0,5,5,10,9,19,26,15,41,0.000333,0.058055,5,870.82514,48.379174,174.165028,61.748606,1,2
0,0,5,5,7,8,15,20,15,35,0.000333,0.04558,3,410.223513,22.790195,136.741171,43.651484,1,2
0,0,5,5,10,9,19,26,15,41,0.000333,0.058055,5,870.82514,48.379174,174.165028,61.748606,1,2
0,0,4,4,6,9,15,16,12,28,0.000333,0.036464,3,328.17881,18.232156,109.392937,44.0391,1,2
0,0,7,7,11,13,24,39,23,62,0.000333,0.094756,5,1421.338375,78.963243,284.267675,86.159464,1,2
0,0,14,14,18,17,35,89,51,140,0.000333,0.239367,27,19388.6898,1077.149434,718.099622,144.545518,6,2
0,0,4,4,11,11,22,22,14,36,0.000333,0.053513,5,802.697691,44.594316,160.539538,76.107496,3,2
0,0,3,3,8,7,15,15,9,24,0.000333,0.031255,4,375.061497,20.83675,93.765374,43.651484,3,2
0,0,32,32,20,40,60,169,90,259,0.000333,0.509962,20,30597.69329,1699.871849,1529.884664,299.315686,12,2
0,0,4,4,9,9,18,22,13,35,0.000333,0.048649,4,583.7895,32.43275,145.947375,57.05865,3,2
0,0,5,5,7,12,19,15,16,31,0.000333,0.043895,3,395.057259,21.947625,131.685753,62.671034,1,2
0,0,5,5,10,9,19,26,15,41,0.000333,0.058055,5,870.82514,48.379174,174.165028,61.748606,1,2
0,0,3,3,9,8,17,16,11,27,0.000333,0.036787,4,441.445987,24.524777,110.361497,52.529325,2,2
0,0,5,5,8,10,18,28,17,45,0.000333,0.062549,4,750.5865,41.69925,187.646625,57.219281,1,2
0,0,5,5,8,10,18,28,17,45,0.000333,0.062549,4,750.5865,41.69925,187.646625,57.219281,1,2
0,0,6,6,8,17,25,33,28,61,0.000333,0.094425,4,1133.10091,62.950051,283.275228,93.486868,1,2
0,0,7,7,8,11,19,20,19,39,0.000333,0.055223,4,662.676692,36.815372,165.669173,62.053748,1,2
0,0,5,5,8,8,16,19,12,31,0.000333,0.041333,4,496,27.555556,124,48,1,2
0,0,5,5,7,8,15,22,15,37,0.000333,0.048185,3,433.664856,24.092492,144.554952,43.651484,1,2
0,0,4,4,6,11,17,14,14,28,0.000333,0.03815,3,343.346879,19.074827,114.44896,53.563523,1,2
0,0,5,5,8,11,19,27,18,45,0.000333,0.063719,4,764.626952,42.479275,191.156738,62.053748,1,2
0,0,10,10,12,15,27,59,34,93,0.000333,0.147402,12,5306.454452,294.803025,442.204538,101.622909,2,2
0,0,7,7,8,13,21,21,22,43,0.000333,0.062957,4,755.478597,41.971033,188.869649,72.105716,1,2
0,0,6,6,12,11,23,51,26,77,0.000333,0.116105,12,4179.771247,232.209514,348.314271,81.073298,2,2
0,0,3,3,6,4,10,17,9,26,0.000333,0.02879,6,518.220783,28.790043,86.37013,23.509775,1,2
0,0,4,4,11,10,21,24,14,38,0.000333,0.055636,5,834.54031,46.363351,166.908062,71.273029,4,2
0,0,10,10,13,13,26,47,30,77,0.000333,0.120645,12,4343.2063,241.289239,361.933858,96.211433,2,2
0,0,28,28,15,37,52,147,95,242,0.000333,0.459835,14,19313.08977,1072.949431,1379.506412,251.353133,2,2
0,0,6,6,9,11,20,34,20,54,0.000333,0.077795,4,933.536468,51.863137,233.384117,66.583073,1,2
0,0,5,5,8,11,19,33,18,51,0.000333,0.072215,4,866.577213,48.143178,216.644303,62.053748,1,2
0,0,4,4,11,10,21,24,14,38,0.000333,0.055636,5,834.54031,46.363351,166.908062,71.273029,4,2
0,0,5,5,7,7,14,16,11,27,0.000333,0.034266,3,308.395749,17.133097,102.798583,39.302969,1,2
0,0,17,17,15,24,39,123,66,189,0.000333,0.33298,14,13985.17427,776.954126,998.941019,168.642459,8,2
0,0,5,5,8,10,18,28,17,45,0.000333,0.062549,4,750.5865,41.69925,187.646625,57.219281,1,2
0,0,13,13,14,25,39,88,48,136,0.000333,0.239605,7,5031.702912,279.539051,718.814702,169.399374,4,2
0,0,4,4,6,5,11,13,10,23,0.000333,0.026522,6,477.401563,26.522309,79.566927,27.119415,1,2
0,0,6,6,13,12,25,41,26,67,0.000333,0.103713,12,3733.660377,207.425576,311.138365,91.125266,4,2
0,0,6,6,7,13,20,35,24,59,0.000333,0.084998,3,764.981273,42.49896,254.993758,67.757201,1,2
0,0,6,6,9,14,23,24,24,48,0.000333,0.072377,4,868.523896,48.251328,217.130974,81.832294,1,2
0,0,4,4,11,10,21,24,14,38,0.000333,0.055636,5,834.54031,46.363351,166.908062,71.273029,4,2
0,0,5,5,10,7,17,41,21,62,0.000333,0.084474,15,3801.340442,211.18558,253.422696,52.870765,6,2
0,0,3,3,9,8,17,16,10,26,0.000333,0.035425,4,425.096135,23.616452,106.274034,52.529325,3,2
0,0,5,5,11,10,21,31,17,48,0.000333,0.070277,5,1054.156181,58.564232,210.831236,71.273029,1,2
0,0,26,26,12,29,41,161,94,255,0.000333,0.455392,18,24591.1637,1366.175761,1366.175761,183.900999,3,2
0,0,3,3,10,7,17,15,9,24,0.000333,0.0327,5,490.495541,27.249752,98.099108,52.870765,3,2
0,0,3,3,8,7,15,15,9,24,0.000333,0.031255,4,375.061497,20.83675,93.765374,43.651484,3,2
0,0,4,4,4,7,11,13,11,24,0.000333,0.027675,2,166.052718,9.225151,83.026359,27.651484,2,2
0,0,3,3,9,8,17,16,10,26,0.000333,0.035425,4,425.096135,23.616452,106.274034,52.529325,3,2
0,0,6,6,8,11,19,20,19,39,0.000333,0.055223,4,662.676692,36.815372,165.669173,62.053748,1,2
0,0,5,5,11,10,21,31,17,48,0.000333,0.070277,5,1054.156181,58.564232,210.831236,71.273029,1,2
0,0,5,5,10,9,19,26,15,41,0.000333,0.058055,5,870.82514,48.379174,174.165028,61.748606,1,2
0,0,6,6,12,11,23,33,18,51,0.000333,0.076901,6,1384.209959,76.900553,230.70166,81.073298,1,2
0,0,6,6,9,10,19,24,18,42,0.000333,0.059471,4,713.651822,39.647323,178.412956,61.748606,1,2
0,0,5,5,8,11,19,33,18,51,0.000333,0.072215,4,866.577213,48.143178,216.644303,62.053748,1,2
0,0,24,24,17,29,46,164,90,254,0.000333,0.467662,24,33671.63368,1870.646316,1402.984737,210.368317,5,2
0,0,5,5,11,10,21,31,17,48,0.000333,0.070277,5,1054.156181,58.564232,210.831236,71.273029,1,2
0,0,4,4,11,10,21,24,14,38,0.000333,0.055636,5,834.54031,46.363351,166.908062,71.273029,4,2
0,0,3,3,8,7,15,15,9,24,0.000333,0.031255,4,375.061497,20.83675,93.765374,43.651484,3,2
0,0,5,5,8,8,16,19,12,31,0.000333,0.041333,4,496,27.555556,124,48,1,2
0,0,6,6,9,11,20,37,20,57,0.000333,0.082117,4,985.399606,54.744423,246.349901,66.583073,1,2
0,0,5,5,8,8,16,19,12,31,0.000333,0.041333,4,496,27.555556,124,48,1,2
0,0,8,8,13,13,26,50,33,83,0.000333,0.130045,12,4681.637959,260.090998,390.136497,96.211433,5,2
0,0,3,3,8,6,14,11,9,20,0.000333,0.025382,4,304.588394,16.921577,76.147098,39.509775,1,2
0,0,5,5,8,11,19,33,18,51,0.000333,0.072215,4,866.577213,48.143178,216.644303,62.053748,1,2
0,0,5,5,8,11,19,27,17,44,0.000333,0.062303,4,747.635242,41.535291,186.908811,62.053748,1,2
0,0,6,6,8,11,19,31,18,49,0.000333,0.069383,4,832.593793,46.255211,208.148448,62.053748,1,2
0,0,5,5,8,8,16,19,12,31,0.000333,0.041333,4,496,27.555556,124,48,1,2
0,0,3,3,8,7,15,20,12,32,0.000333,0.041673,4,500.081996,27.782333,125.020499,43.651484,1,2
0,0,9,9,14,17,31,47,36,83,0.000333,0.137066,14,5756.776113,319.820895,411.198294,122.789837,4,2
0,0,5,5,7,8,15,20,15,35,0.000333,0.04558,3,410.223513,22.790195,136.741171,43.651484,1,2
0,0,5,5,7,7,14,17,13,30,0.000333,0.038074,3,342.661943,19.036775,114.220648,39.302969,1,2
0,0,5,5,7,7,14,17,13,30,0.000333,0.038074,3,342.661943,19.036775,114.220648,39.302969,1,2
0,0,3,3,11,10,21,19,14,33,0.000333,0.048315,5,724.732375,40.26291,144.946475,71.273029,1,2
0,0,35,35,14,31,45,216,126,342,0.000333,0.626071,28,52589.98525,2921.665847,1878.213759,206.883055,4,2
0,0,10,10,7,19,26,62,36,98,0.000333,0.153548,3,1381.929277,76.773849,460.643092,100.362107,3,2
0,0,4,4,10,11,21,20,14,34,0.000333,0.04978,5,746.693962,41.482998,149.338792,71.273029,3,2
0,0,5,5,7,11,18,15,15,30,0.000333,0.041699,3,375.29325,20.849625,125.09775,57.705232,1,2
0,0,5,5,10,9,19,26,15,41,0.000333,0.058055,5,870.82514,48.379174,174.165028,61.748606,1,2
0,0,5,5,7,8,15,17,12,29,0.000333,0.037767,3,339.899482,18.883305,113.299827,43.651484,1,2
0,0,5,5,10,9,19,26,15,41,0.000333,0.058055,5,870.82514,48.379174,174.165028,61.748606,1,2
0,0,5,5,8,11,19,33,18,51,0.000333,0.072215,4,866.577213,48.143178,216.644303,62.053748,1,2
0,0,9,9,10,9,19,31,22,53,0.000333,0.075047,10,2251.401582,125.077866,225.140158,61.748606,1,2
0,0,16,16,14,19,33,71,45,116,0.000333,0.19505,14,8192.09605,455.116447,585.149718,134.013592,2,2
0,0,3,3,8,7,15,20,12,32,0.000333,0.041673,4,500.081996,27.782333,125.020499,43.651484,1,2
0,0,5,5,10,10,20,33,18,51,0.000333,0.073473,5,1102.091664,61.227315,220.418333,66.438562,1,2
0,0,4,4,11,9,20,21,12,33,0.000333,0.047541,5,713.118136,39.617674,142.623627,66.583073,3,2
0,0,5,5,9,14,23,25,20,45,0.000333,0.067853,4,814.241152,45.23562,203.560288,81.832294,1,2
0,0,6,6,8,11,19,36,21,57,0.000333,0.080711,4,968.527473,53.807082,242.131868,62.053748,1,2
0,0,81,81,27,78,105,525,298,823,0.000333,1.841941,39,215507.1384,11972.6188,5525.824061,618.643336,39,2
0,0,4,4,6,11,17,14,14,28,0.000333,0.03815,3,343.346879,19.074827,114.44896,53.563523,1,2
0,0,18,18,16,22,38,89,59,148,0.000333,0.258898,16,12427.09235,690.39402,776.693272,162.107496,2,2
0,0,36,36,17,40,57,210,122,332,0.000333,0.645506,24,46476.46763,2582.02598,1936.519485,282.363992,2,2
0,0,4,4,8,10,18,14,12,26,0.000333,0.036139,4,433.6722,24.0929,108.41805,57.219281,3,2
0,0,3,3,8,7,15,15,9,24,0.000333,0.031255,4,375.061497,20.83675,93.765374,43.651484,3,2
0,0,7,7,9,12,21,34,20,54,0.000333,0.079062,4,948.740563,52.707809,237.185141,71.548875,1,2
0,0,5,5,10,9,19,26,15,41,0.000333,0.058055,5,870.82514,48.379174,174.165028,61.748606,1,2
0,0,4,4,6,11,17,18,16,34,0.000333,0.046325,3,416.92121,23.162289,138.973737,53.563523,1,2
0,0,5,5,10,10,20,33,18,51,0.000333,0.073473,5,1102.091664,61.227315,220.418333,66.438562,1,2
0,0,4,4,10,9,19,20,12,32,0.000333,0.045311,5,679.668402,37.759356,135.93368,61.748606,3,2
0,0,5,5,10,10,20,29,17,46,0.000333,0.06627,5,994.043462,55.224637,198.808692,66.438562,1,2
0,0,15,15,11,13,24,68,42,110,0.000333,0.168115,15,7565.188126,420.288229,504.345875,86.159464,1,2
0,0,14,14,12,25,37,74,55,129,0.000333,0.224006,12,8064.23381,448.012989,672.019484,159.115955,1,2
0,0,4,4,8,10,18,23,16,39,0.000333,0.054209,4,650.5083,36.13935,162.627075,57.219281,1,2
0,0,3,3,8,7,15,20,12,32,0.000333,0.041673,4,500.081996,27.782333,125.020499,43.651484,1,2
0,0,9,9,14,17,31,45,34,79,0.000333,0.130461,14,5479.341119,304.40784,391.381509,122.789837,5,2
0,0,4,4,9,8,17,20,12,32,0.000333,0.0436,4,523.195244,29.066402,130.798811,52.529325,1,2
0,0,5,5,9,17,26,33,28,61,0.000333,0.095576,4,1146.907291,63.717072,286.726823,98.016193,1,2
0,0,6,6,9,13,22,23,22,45,0.000333,0.066891,4,802.697691,44.594316,200.674423,76.635041,1,2
0,0,5,5,8,10,18,28,17,45,0.000333,0.062549,4,750.5865,41.69925,187.646625,57.219281,1,2
0,0,4,4,8,8,16,18,12,30,0.000333,0.04,4,480,26.666667,120,48,1,2
0,0,4,4,9,8,17,20,12,32,0.000333,0.0436,4,523.195244,29.066402,130.798811,52.529325,1,2
0,0,4,4,6,9,15,17,13,30,0.000333,0.039069,3,351.620154,19.534453,117.206718,44.0391,1,2
0,0,4,4,7,13,20,17,16,33,0.000333,0.047541,3,427.870881,23.770605,142.623627,67.757201,1,2
0,0,5,5,8,10,18,28,17,45,0.000333,0.062549,4,750.5865,41.69925,187.646625,57.219281,1,2
0,0,5,5,8,10,18,28,17,45,0.000333,0.062549,4,750.5865,41.69925,187.646625,57.219281,1,2
0,0,6,6,7,10,17,21,16,37,0.000333,0.050412,3,453.708375,25.206021,151.236125,52.870765,1,2
0,0,6,6,7,9,16,20,15,35,0.000333,0.046667,3,420,23.333333,140,48.180809,1,2
0,0,6,6,13,12,25,41,26,67,0.000333,0.103713,12,3733.660377,207.425576,311.138365,91.125266,4,2
0,0,15,15,15,20,35,71,44,115,0.000333,0.196623,14,8258.145657,458.78587,589.867547,145.041921,2,2
0,0,5,5,7,8,15,17,12,29,0.000333,0.037767,3,339.899482,18.883305,113.299827,43.651484,1,2
0,0,4,4,7,13,20,18,17,35,0.000333,0.050422,3,453.80245,25.211247,151.267483,67.757201,1,2
0,0,4,4,5,9,14,15,13,28,0.000333,0.035535,2,213.211876,11.845104,106.605938,40.138965,1,2
0,0,15,15,11,13,24,68,42,110,0.000333,0.168115,15,7565.188126,420.288229,504.345875,86.159464,1,2
0,0,5,5,8,10,18,28,17,45,0.000333,0.062549,4,750.5865,41.69925,187.646625,57.219281,1,2
0,0,4,4,4,7,11,13,11,24,0.000333,0.027675,2,166.052718,9.225151,83.026359,27.651484,2,2
0,0,4,4,10,9,19,22,13,35,0.000333,0.049559,5,743.387315,41.299295,148.677463,61.748606,1,2
0,0,6,6,8,11,19,36,21,57,0.000333,0.080711,4,968.527473,53.807082,242.131868,62.053748,1,2
0,0,6,6,11,10,21,51,26,77,0.000333,0.112736,10,3382.084416,187.893579,338.208442,71.273029,2,2
0,0,4,4,8,7,15,23,14,37,0.000333,0.048185,8,1156.439616,64.246645,144.554952,43.651484,1,2
0,0,3,3,8,6,14,11,9,20,0.000333,0.025382,4,304.588394,16.921577,76.147098,39.509775,1,2
0,0,8,8,14,13,27,45,28,73,0.000333,0.115702,14,4859.495027,269.971946,347.106788,101.408685,5,2
0,0,3,3,9,8,17,16,11,27,0.000333,0.036787,4,441.445987,24.524777,110.361497,52.529325,2,2
0,0,6,6,7,13,20,35,24,59,0.000333,0.084998,3,764.981273,42.49896,254.993758,67.757201,1,2
0,0,5,5,10,10,20,27,16,43,0.000333,0.061948,5,929.21454,51.62303,185.842908,66.438562,1,2
0,0,8,8,12,12,24,37,24,61,0.000333,0.093228,12,3356.192551,186.455142,279.682713,86.0391,1,2
0,0,20,20,10,24,34,126,77,203,0.000333,0.344252,15,15491.32435,860.629131,1032.754957,143.258381,1,2
0,0,5,5,10,10,20,29,17,46,0.000333,0.06627,5,994.043462,55.224637,198.808692,66.438562,1,2
0,0,3,3,9,8,17,16,11,27,0.000333,0.036787,4,441.445987,24.524777,110.361497,52.529325,2,2
0,0,5,5,8,11,19,33,18,51,0.000333,0.072215,4,866.577213,48.143178,216.644303,62.053748,1,2
0,0,10,10,12,15,27,59,34,93,0.000333,0.147402,12,5306.454452,294.803025,442.204538,101.622909,2,2
0,0,6,6,7,10,17,48,32,80,0.000333,0.108999,9,2942.973246,163.498514,326.997027,52.870765,1,2
0,0,3,3,7,7,14,22,14,36,0.000333,0.045688,6,822.388663,45.688259,137.064777,39.302969,1,2
0,0,5,5,9,14,23,25,20,45,0.000333,0.067853,4,814.241152,45.23562,203.560288,81.832294,1,2
0,0,3,3,11,8,19,21,15,36,0.000333,0.050975,5,764.626952,42.479275,152.92539,62.053748,1,2
0,0,6,6,9,9,18,30,19,49,0.000333,0.068109,8,1634.610601,90.8117,204.326325,57.05865,1,2
0,0,3,3,9,8,17,16,11,27,0.000333,0.036787,4,441.445987,24.524777,110.361497,52.529325,2,2
0,0,16,16,23,28,51,101,59,160,0.000333,0.302529,22,19966.9372,1109.274289,907.588055,238.647863,5,2
0,0,4,4,5,9,14,15,13,28,0.000333,0.035535,2,213.211876,11.845104,106.605938,40.138965,1,2
0,0,13,13,15,24,39,83,41,124,0.000333,0.218463,7,4587.729126,254.87384,655.389875,168.642459,5,2
0,0,6,6,8,9,17,27,16,43,0.000333,0.058587,4,703.043609,39.057978,175.760902,52.529325,1,2
0,0,4,4,11,10,21,24,14,38,0.000333,0.055636,5,834.54031,46.363351,166.908062,71.273029,4,2
0,0,5,5,7,9,16,23,14,37,0.000333,0.049333,3,444,24.666667,148,48.180809,1,2
0,0,6,6,8,11,19,32,20,52,0.000333,0.073631,4,883.568923,49.087162,220.892231,62.053748,1,2
0,0,5,5,7,7,14,17,13,30,0.000333,0.038074,3,342.661943,19.036775,114.220648,39.302969,1,2
0,0,4,4,11,9,20,21,12,33,0.000333,0.047541,5,713.118136,39.617674,142.623627,66.583073,3,2
0,0,4,4,10,9,19,20,12,32,0.000333,0.045311,5,679.668402,37.759356,135.93368,61.748606,3,2
0,0,3,3,9,8,17,16,10,26,0.000333,0.035425,4,425.096135,23.616452,106.274034,52.529325,3,2
0,0,18,18,17,24,41,103,65,168,0.000333,0.300023,16,14401.09979,800.061099,900.068737,179.525968,2,2
0,0,9,9,12,16,28,60,34,94,0.000333,0.15063,12,5422.696352,301.260908,451.891363,107.01955,1,2
0,0,16,16,14,19,33,71,45,116,0.000333,0.19505,14,8192.09605,455.116447,585.149718,134.013592,2,2
0,0,37,37,19,39,58,257,154,411,0.000333,0.802543,27,65006.0151,3611.445283,2407.630189,286.841309,11,2
0,0,6,6,13,12,25,41,26,67,0.000333,0.103713,12,3733.660377,207.425576,311.138365,91.125266,4,2
0,0,6,6,9,9,18,21,17,38,0.000333,0.052819,4,633.8286,35.2127,158.45715,57.05865,1,2
0,0,6,6,8,9,17,30,21,51,0.000333,0.069487,8,1667.684839,92.649158,208.460605,52.529325,1,2
0,0,4,4,9,10,19,19,13,32,0.000333,0.045311,4,543.734722,30.207485,135.93368,61.748606,3,2
0,0,16,16,14,17,31,76,48,124,0.000333,0.204773,14,8600.484795,477.804711,614.320342,122.789837,2,2
0,0,4,4,11,10,21,24,14,38,0.000333,0.055636,5,834.54031,46.363351,166.908062,71.273029,4,2
0,0,5,5,8,10,18,28,17,45,0.000333,0.062549,4,750.5865,41.69925,187.646625,57.219281,1,2
0,0,3,3,7,7,14,10,8,18,0.000333,0.022844,3,205.597166,11.422065,68.532389,39.302969,3,2
0,0,9,9,12,16,28,60,34,94,0.000333,0.15063,12,5422.696352,301.260908,451.891363,107.01955,1,2
0,0,4,4,10,8,18,20,11,31,0.000333,0.043089,5,646.338375,35.907688,129.267675,57.219281,3,2
0,0,5,5,10,10,20,29,17,46,0.000333,0.06627,5,994.043462,55.224637,198.808692,66.438562,1,2
0,0,5,5,8,10,18,28,17,45,0.000333,0.062549,4,750.5865,41.69925,187.646625,57.219281,1,2
0,0,4,4,4,7,11,13,11,24,0.000333,0.027675,2,166.052718,9.225151,83.026359,27.651484,2,2
0,0,5,5,10,10,20,29,17,46,0.000333,0.06627,5,994.043462,55.224637,198.808692,66.438562,1,2
0,0,4,4,11,10,21,24,14,38,0.000333,0.055636,5,834.54031,46.363351,166.908062,71.273029,4,2
0,0,5,5,7,11,18,28,21,49,0.000333,0.068109,3,612.978975,34.054388,204.326325,57.705232,1,2
0,0,3,3,8,6,14,11,9,20,0.000333,0.025382,4,304.588394,16.921577,76.147098,39.509775,1,2
0,0,10,10,12,15,27,59,34,93,0.000333,0.147402,12,5306.454452,294.803025,442.204538,101.622909,2,2
0,0,3,3,7,10,17,22,15,37,0.000333,0.050412,3,453.708375,25.206021,151.236125,52.870765,1,2
0,0,5,5,7,12,19,33,22,55,0.000333,0.077879,3,700.90804,38.939336,233.636013,62.671034,1,2
0,0,6,6,11,10,21,28,17,45,0.000333,0.065885,5,988.27142,54.903968,197.654284,71.273029,1,2
0,0,4,4,11,10,21,24,14,38,0.000333,0.055636,5,834.54031,46.363351,166.908062,71.273029,4,2
0,0,4,4,8,12,20,24,17,41,0.000333,0.059066,4,708.796208,39.377567,177.199052,67.01955,1,2
0,0,31,31,12,43,55,155,127,282,0.000333,0.543448,12,19564.12127,1086.895626,1630.343439,276.348934,1,2
0,0,4,4,9,9,18,22,13,35,0.000333,0.048649,4,583.7895,32.43275,145.947375,57.05865,3,2
0,0,4,4,11,11,22,22,14,36,0.000333,0.053513,5,802.697691,44.594316,160.539538,76.107496,3,2
0,0,5,5,7,15,22,32,25,57,0.000333,0.084729,3,762.562807,42.3646,254.187602,78.254843,1,2
0,0,4,4,6,11,17,18,16,34,0.000333,0.046325,3,416.92121,23.162289,138.973737,53.563523,1,2
0,0,5,5,10,10,20,29,17,46,0.000333,0.06627,5,994.043462,55.224637,198.808692,66.438562,1,2
0,0,4,4,7,11,18,15,14,29,0.000333,0.040309,3,362.783475,20.154638,120.927825,57.705232,1,2
0,0,14,14,17,20,37,81,54,135,0.000333,0.234425,16,11252.41927,625.134404,703.276204,155.92543,2,2
0,0,5,5,8,8,16,22,15,37,0.000333,0.049333,4,592,32.888889,148,48,1,2
0,0,13,13,18,17,35,81,46,127,0.000333,0.21714,18,11725.54098,651.418943,651.418943,144.545518,6,2
0,0,7,7,10,14,24,40,27,67,0.000333,0.102397,5,1535.962438,85.331247,307.192488,86.52225,1,2
0,0,4,4,8,13,21,22,18,40,0.000333,0.058564,4,702.770788,39.042822,175.692697,72.105716,1,2
0,0,14,14,18,17,35,89,51,140,0.000333,0.239367,27,19388.6898,1077.149434,718.099622,144.545518,4,2
0,0,21,21,16,29,45,144,82,226,0.000333,0.41372,16,19858.5408,1103.252266,1241.1588,204.881449,5,2
0,0,6,6,8,11,19,20,19,39,0.000333,0.055223,4,662.676692,36.815372,165.669173,62.053748,1,2
0,0,3,3,8,6,14,21,11,32,0.000333,0.040612,4,487.34143,27.074524,121.835358,39.509775,1,2
0,0,10,10,12,15,27,59,34,93,0.000333,0.147402,12,5306.454452,294.803025,442.204538,101.622909,2,2
0,0,9,9,16,17,33,54,35,89,0.000333,0.14965,16,7183.217226,399.067624,448.951077,133.486868,5,2
0,0,25,25,15,27,42,159,93,252,0.000333,0.452955,21,28536.1438,1585.341322,1358.863991,186.985321,2,2
0,0,10,10,9,12,21,40,28,68,0.000333,0.099559,8,2389.420678,132.745593,298.677585,71.548875,1,2
0,0,5,5,9,10,19,29,21,50,0.000333,0.070799,8,1699.171005,94.398389,212.396376,61.748606,1,2
0,0,33,33,15,33,48,232,136,368,0.000333,0.685089,28,57547.45361,3197.080756,2055.2662,225.068365,11,2
0,0,6,6,8,9,17,30,21,51,0.000333,0.069487,8,1667.684839,92.649158,208.460605,52.529325,1,2
0,0,27,27,20,47,67,173,135,308,0.000333,0.622785,20,37367.10941,2075.950523,1868.355471,347.504238,3,2
0,0,16,16,15,25,40,90,51,141,0.000333,0.250131,14,10505.48606,583.638114,750.391861,174.699764,7,2
0,0,4,4,6,9,15,15,12,27,0.000333,0.035162,3,316.458138,17.581008,105.486046,44.0391,1,2
0,0,5,5,8,9,17,28,17,45,0.000333,0.061312,4,735.743311,40.874628,183.935828,52.529325,1,2
0,0,4,4,11,9,20,21,12,33,0.000333,0.047541,5,713.118136,39.617674,142.623627,66.583073,3,2
0,0,4,4,9,9,18,22,13,35,0.000333,0.048649,4,583.7895,32.43275,145.947375,57.05865,3,2
0,0,5,5,12,13,25,28,18,46,0.000333,0.071206,6,1281.704308,71.205795,213.617385,91.125266,4,2
0,0,6,6,8,11,19,24,18,42,0.000333,0.059471,4,713.651822,39.647323,178.412956,62.053748,1,2
0,0,5,5,10,10,20,33,18,51,0.000333,0.073473,5,1102.091664,61.227315,220.418333,66.438562,1,2
0,0,95,95,17,46,63,759,430,1189,0.000333,2.368995,72,511702.9797,28427.94332,7106.985829,323.570718,55,2
0,0,5,5,10,12,22,26,18,44,0.000333,0.065405,5,981.074956,54.504164,196.214991,76.238831,1,2
0,0,7,7,12,9,21,43,19,62,0.000333,0.090775,12,3267.884163,181.54912,272.32368,71.548875,5,2
0,0,5,5,8,8,16,19,12,31,0.000333,0.041333,4,496,27.555556,124,48,1,2
0,0,4,4,11,9,20,21,12,33,0.000333,0.047541,5,713.118136,39.617674,142.623627,66.583073,3,2
0,0,3,3,8,6,14,11,9,20,0.000333,0.025382,4,304.588394,16.921577,76.147098,39.509775,1,2
0,0,4,4,6,13,19,17,17,34,0.000333,0.048143,3,433.288606,24.071589,144.429535,63.615491,1,2
0,0,9,9,8,17,25,60,31,91,0.000333,0.140864,4,1690.363653,93.909092,422.590913,93.486868,1,2
0,0,5,5,7,7,14,16,11,27,0.000333,0.034266,3,308.395749,17.133097,102.798583,39.302969,1,2
0,0,4,4,11,9,20,21,12,33,0.000333,0.047541,5,713.118136,39.617674,142.623627,66.583073,3,2
0,0,4,4,11,10,21,24,14,38,0.000333,0.055636,5,834.54031,46.363351,166.908062,71.273029,4,2
0,0,8,8,7,17,24,39,34,73,0.000333,0.111567,6,2008.213575,111.567421,334.702263,89.138353,1,2
0,0,18,18,16,22,38,89,59,148,0.000333,0.258898,16,12427.09235,690.39402,776.693272,162.107496,2,2
0,0,7,7,10,14,24,40,27,67,0.000333,0.102397,5,1535.962438,85.331247,307.192488,86.52225,1,2
0,0,31,31,18,41,59,193,117,310,0.000333,0.607873,18,32825.14822,1823.619345,1823.619345,294.718282,3,2
0,0,5,5,10,10,20,33,18,51,0.000333,0.073473,5,1102.091664,61.227315,220.418333,66.438562,1,2
0,0,6,6,12,11,23,33,18,51,0.000333,0.076901,6,1384.209959,76.900553,230.70166,81.073298,1,2
0,0,16,16,15,20,35,76,47,123,0.000333,0.210301,14,8832.625355,490.701409,630.901811,145.041921,2,2
0,0,4,4,9,11,20,28,18,46,0.000333,0.06627,4,795.234769,44.179709,198.808692,66.583073,1,2
0,0,5,5,8,10,18,28,17,45,0.000333,0.062549,4,750.5865,41.69925,187.646625,57.219281,1,2
0,0,11,11,16,18,34,60,41,101,0.000333,0.171278,16,8221.339951,456.741108,513.833747,139.05865,5,2
0,0,4,4,11,10,21,24,14,38,0.000333,0.055636,5,834.54031,46.363351,166.908062,71.273029,4,2
0,0,7,7,8,13,21,38,27,65,0.000333,0.095167,8,2284.00506,126.88917,285.500632,72.105716,1,2
0,0,17,17,10,27,37,78,45,123,0.000333,0.213588,5,3203.81382,177.989657,640.762764,161.601244,2,2
0,0,5,5,7,8,15,20,14,34,0.000333,0.044278,3,398.502841,22.139047,132.83428,43.651484,1,2
0,0,4,4,8,14,22,19,18,37,0.000333,0.055,4,659.99588,36.666438,164.99897,77.302969,1,2
0,0,3,3,8,7,15,20,12,32,0.000333,0.041673,4,500.081996,27.782333,125.020499,43.651484,1,2
0,0,7,7,9,12,21,34,20,54,0.000333,0.079062,4,948.740563,52.707809,237.185141,71.548875,1,2
0,0,4,4,11,10,21,24,14,38,0.000333,0.055636,5,834.54031,46.363351,166.908062,71.273029,4,2
0,0,7,7,15,15,30,34,23,57,0.000333,0.093231,7,1957.849348,108.769408,279.692764,117.206718,2,2
0,0,7,7,11,19,30,44,28,72,0.000333,0.117765,5,1766.480614,98.137812,353.296123,118.764371,2,2
0,0,12,12,14,23,37,77,41,118,0.000333,0.204905,7,4303.00848,239.056027,614.715497,157.344894,5,2
0,0,27,27,17,36,53,146,76,222,0.000333,0.423866,16,20345.57346,1130.309636,1271.598341,255.604168,11,2
0,0,5,5,7,7,14,16,11,27,0.000333,0.034266,3,308.395749,17.133097,102.798583,39.302969,1,2
0,0,9,9,16,17,33,54,35,89,0.000333,0.14965,16,7183.217226,399.067624,448.951077,133.486868,5,2
0,0,5,5,8,11,19,27,17,44,0.000333,0.062303,4,747.635242,41.535291,186.908811,62.053748,1,2
0,0,41,41,16,39,55,282,164,446,0.000333,0.859495,32,82511.56583,4583.97588,2578.486432,270.130687,6,2
0,0,4,4,8,7,15,15,10,25,0.000333,0.032557,4,390.68906,21.704948,97.672265,43.651484,1,2
0,0,3,3,8,6,14,11,9,20,0.000333,0.025382,4,304.588394,16.921577,76.147098,39.509775,1,2
0,0,3,3,11,13,24,16,17,33,0.000333,0.050435,5,756.518813,42.028823,151.303763,86.159464,1,2
0,0,6,6,7,13,20,35,24,59,0.000333,0.084998,3,764.981273,42.49896,254.993758,67.757201,1,2
0,0,4,4,11,9,20,21,12,33,0.000333,0.047541,5,713.118136,39.617674,142.623627,66.583073,3,2
0,0,10,10,13,20,33,67,36,103,0.000333,0.173191,6,3117.435566,173.190865,519.572594,134.544278,4,2
0,0,4,4,6,13,19,17,17,34,0.000333,0.048143,3,433.288606,24.071589,144.429535,63.615491,1,2
0,0,5,5,8,11,19,33,18,51,0.000333,0.072215,4,866.577213,48.143178,216.644303,62.053748,1,2
0,0,4,4,7,11,18,15,14,29,0.000333,0.040309,3,362.783475,20.154638,120.927825,57.705232,1,2
0,0,3,3,9,8,17,16,11,27,0.000333,0.036787,4,441.445987,24.524777,110.361497,52.529325,2,2
0,0,10,10,12,15,27,59,34,93,0.000333,0.147402,12,5306.454452,294.803025,442.204538,101.622909,2,2
0,0,3,3,7,7,14,10,8,18,0.000333,0.022844,3,205.597166,11.422065,68.532389,39.302969,3,2
0,0,14,14,17,20,37,81,54,135,0.000333,0.234425,16,11252.41927,625.134404,703.276204,155.92543,2,2
0,0,14,14,17,20,37,81,54,135,0.000333,0.234425,16,11252.41927,625.134404,703.276204,155.92543,2,2
0,0,3,3,8,7,15,15,9,24,0.000333,0.031255,4,375.061497,20.83675,93.765374,43.651484,3,2
0,0,5,5,7,7,14,16,11,27,0.000333,0.034266,3,308.395749,17.133097,102.798583,39.302969,1,2
0,0,5,5,7,9,16,23,14,37,0.000333,0.049333,3,444,24.666667,148,48.180809,1,2
0,0,5,5,8,8,16,19,12,31,0.000333,0.041333,4,496,27.555556,124,48,1,2
0,0,6,6,13,12,25,41,26,67,0.000333,0.103713,12,3733.660377,207.425576,311.138365,91.125266,4,2
0,0,11,11,12,17,29,72,40,112,0.000333,0.181365,12,6529.126457,362.729248,544.093871,112.506418,1,2
0,0,4,4,7,15,22,18,19,37,0.000333,0.055,3,494.99691,27.499828,164.99897,78.254843,1,2
0,0,14,14,17,20,37,81,54,135,0.000333,0.234425,16,11252.41927,625.134404,703.276204,155.92543,2,2
0,0,5,5,10,10,20,29,17,46,0.000333,0.06627,5,994.043462,55.224637,198.808692,66.438562,1,2
0,0,5,5,8,11,19,27,17,44,0.000333,0.062303,4,747.635242,41.535291,186.908811,62.053748,1,2
0,0,5,5,7,9,16,23,14,37,0.000333,0.049333,3,444,24.666667,148,48.180809,1,2
0,0,7,7,8,11,19,20,19,39,0.000333,0.055223,4,662.676692,36.815372,165.669173,62.053748,1,2
0,0,9,9,11,12,23,44,29,73,0.000333,0.110073,10,3302.200228,183.455568,330.220023,81.073298,4,2
0,0,9,9,11,12,23,46,29,75,0.000333,0.113089,10,3392.671467,188.481748,339.267147,81.073298,4,2
0,0,6,6,12,11,23,51,26,77,0.000333,0.116105,12,4179.771247,232.209514,348.314271,81.073298,2,2
0,0,5,5,10,10,20,29,17,46,0.000333,0.06627,5,994.043462,55.224637,198.808692,66.438562,1,2
0,0,7,7,8,12,20,29,24,53,0.000333,0.076354,8,1832.497512,101.805417,229.062189,67.01955,1,2
0,0,5,5,7,8,15,18,14,32,0.000333,0.041673,3,375.061497,20.83675,125.020499,43.651484,1,2
0,0,5,5,10,10,20,29,17,46,0.000333,0.06627,5,994.043462,55.224637,198.808692,66.438562,1,2
0,0,5,5,10,9,19,24,16,40,0.000333,0.056639,5,849.585503,47.199195,169.917101,61.748606,1,2
0,0,20,20,20,29,49,147,80,227,0.000333,0.424846,20,25490.78269,1416.154594,1274.539135,227.320011,8,2
0,0,6,6,13,12,25,41,26,67,0.000333,0.103713,12,3733.660377,207.425576,311.138365,91.125266,4,2
0,0,5,5,7,7,14,16,11,27,0.000333,0.034266,3,308.395749,17.133097,102.798583,39.302969,1,2
0,0,6,6,10,10,20,28,19,47,0.000333,0.06771,5,1015.653102,56.425172,203.13062,66.438562,1,2
0,0,5,5,8,11,19,33,18,51,0.000333,0.072215,4,866.577213,48.143178,216.644303,62.053748,1,2
0,0,6,6,13,11,24,38,23,61,0.000333,0.093228,12,3356.192551,186.455142,279.682713,86.159464,4,2
0,0,5,5,8,10,18,28,17,45,0.000333,0.062549,4,750.5865,41.69925,187.646625,57.219281,1,2
0,0,5,5,7,12,19,41,24,65,0.000333,0.092038,6,1656.69173,92.038429,276.115288,62.671034,1,2
0,0,6,6,9,12,21,21,20,41,0.000333,0.060028,4,720.340057,40.018892,180.085014,71.548875,1,2
0,0,22,22,16,25,41,130,74,204,0.000333,0.364314,16,17487.04974,971.502764,1092.940609,180.096405,2,2
0,0,7,7,9,12,21,34,20,54,0.000333,0.079062,4,948.740563,52.707809,237.185141,71.548875,1,2
0,0,3,3,7,7,14,10,8,18,0.000333,0.022844,3,205.597166,11.422065,68.532389,39.302969,3,2
0,0,4,4,6,8,14,14,11,25,0.000333,0.031728,3,285.551619,15.863979,95.183873,39.509775,1,2
0,0,7,7,15,9,24,61,31,92,0.000333,0.140606,21,8858.147551,492.119308,421.81655,87.132684,3,2
0,0,9,9,16,17,33,54,35,89,0.000333,0.14965,16,7183.217226,399.067624,448.951077,133.486868,5,2
0,0,5,5,9,10,19,26,17,43,0.000333,0.060887,4,730.643532,40.591307,182.660883,61.748606,1,2
0,0,18,18,16,22,38,89,59,148,0.000333,0.258898,16,12427.09235,690.39402,776.693272,162.107496,2,2
0,0,3,3,7,7,14,10,8,18,0.000333,0.022844,3,205.597166,11.422065,68.532389,39.302969,3,2
0,0,4,4,4,7,11,13,11,24,0.000333,0.027675,2,166.052718,9.225151,83.026359,27.651484,2,2
0,0,7,7,10,11,21,33,21,54,0.000333,0.079062,5,1185.925704,65.884761,237.185141,71.273029,1,2
0,0,3,3,7,7,14,10,8,18,0.000333,0.022844,3,205.597166,11.422065,68.532389,39.302969,3,2
0,0,7,7,11,13,24,39,23,62,0.000333,0.094756,5,1421.338375,78.963243,284.267675,86.159464,1,2
0,0,18,18,16,22,38,89,59,148,0.000333,0.258898,16,12427.09235,690.39402,776.693272,162.107496,2,2
0,0,18,18,17,24,41,103,65,168,0.000333,0.300023,16,14401.09979,800.061099,900.068737,179.525968,2,2
0,0,9,9,10,10,20,32,23,55,0.000333,0.079235,10,2377.060452,132.058914,237.706045,66.438562,1,2
0,0,10,10,12,15,27,59,34,93,0.000333,0.147402,12,5306.454452,294.803025,442.204538,101.622909,2,2
0,0,11,11,9,15,24,41,23,64,0.000333,0.097813,4,1173.7504,65.208356,293.4376,87.132684,2,2
0,0,6,6,8,13,21,21,22,43,0.000333,0.062957,4,755.478597,41.971033,188.869649,72.105716,1,2
0,0,3,3,7,7,14,10,8,18,0.000333,0.022844,3,205.597166,11.422065,68.532389,39.302969,3,2
0,0,6,6,9,9,18,30,19,49,0.000333,0.068109,8,1634.610601,90.8117,204.326325,57.05865,1,2
0,0,14,14,17,20,37,81,54,135,0.000333,0.234425,16,11252.41927,625.134404,703.276204,155.92543,2,2
0,0,5,5,10,10,20,29,17,46,0.000333,0.06627,5,994.043462,55.224637,198.808692,66.438562,1,2
0,0,5,5,10,10,20,33,18,51,0.000333,0.073473,5,1102.091664,61.227315,220.418333,66.438562,1,2
0,0,3,3,8,6,14,11,9,20,0.000333,0.025382,4,304.588394,16.921577,76.147098,39.509775,1,2
0,0,5,5,7,8,15,17,12,29,0.000333,0.037767,3,339.899482,18.883305,113.299827,43.651484,1,2
0,0,3,3,9,8,17,16,11,27,0.000333,0.036787,4,441.445987,24.524777,110.361497,52.529325,2,2
0,0,5,5,8,10,18,28,17,45,0.000333,0.062549,4,750.5865,41.69925,187.646625,57.219281,1,2
0,0,10,10,12,16,28,61,37,98,0.000333,0.15704,12,5653.449388,314.080522,471.120782,107.01955,1,2
0,0,28,28,12,28,40,177,105,282,0.000333,0.500261,18,27014.10701,1500.783723,1500.783723,177.625488,1,2
0,0,4,4,7,14,21,16,17,33,0.000333,0.048315,3,434.839425,24.157746,144.946475,72.954453,1,2
0,0,17,17,16,22,38,255,58,313,0.000333,0.547534,16,26281.62099,1460.090055,1642.601312,162.107496,2,2
0,0,5,5,8,8,16,19,12,31,0.000333,0.041333,4,496,27.555556,124,48,1,2
0,0,4,4,8,14,22,18,17,35,0.000333,0.052027,4,624.320427,34.684468,156.080107,77.302969,1,2
0,0,4,4,9,6,15,15,12,27,0.000333,0.035162,8,843.888369,46.882687,105.486046,44.0391,1,2
0,0,5,5,7,9,16,23,14,37,0.000333,0.049333,3,444,24.666667,148,48.180809,1,2
0,0,7,7,11,19,30,44,28,72,0.000333,0.117765,5,1766.480614,98.137812,353.296123,118.764371,2,2
0,0,15,15,14,19,33,66,42,108,0.000333,0.181598,14,7627.123908,423.729106,544.794565,134.013592,2,2
0,0,3,3,9,8,17,16,10,26,0.000333,0.035425,4,425.096135,23.616452,106.274034,52.529325,3,2
0,0,16,16,14,19,33,71,45,116,0.000333,0.19505,14,8192.09605,455.116447,585.149718,134.013592,2,2
0,0,9,9,16,17,33,54,35,89,0.000333,0.14965,16,7183.217226,399.067624,448.951077,133.486868,5,2
0,0,3,3,8,7,15,15,9,24,0.000333,0.031255,4,375.061497,20.83675,93.765374,43.651484,3,2
0,0,5,5,10,10,20,24,19,43,0.000333,0.061948,5,929.21454,51.62303,185.842908,66.438562,1,2
0,0,5,5,10,9,19,26,15,41,0.000333,0.058055,5,870.82514,48.379174,174.165028,61.748606,1,2
0,0,8,8,11,14,25,45,31,76,0.000333,0.117644,10,3529.330704,196.073928,352.93307,91.356717,1,2
0,0,4,4,7,14,21,21,19,40,0.000333,0.058564,3,527.078091,29.282116,175.692697,72.954453,1,2
0,0,3,3,8,7,15,15,9,24,0.000333,0.031255,4,375.061497,20.83675,93.765374,43.651484,3,2
0,0,5,5,8,11,19,33,18,51,0.000333,0.072215,4,866.577213,48.143178,216.644303,62.053748,1,2
0,0,4,4,10,9,19,22,13,35,0.000333,0.049559,5,743.387315,41.299295,148.677463,61.748606,1,2
0,0,4,4,8,7,15,15,10,25,0.000333,0.032557,4,390.68906,21.704948,97.672265,43.651484,1,2
0,0,11,11,15,21,36,83,41,124,0.000333,0.21369,7,4487.494901,249.305272,641.0707,150.842025,4,2
0,0,4,4,6,14,20,15,17,32,0.000333,0.046101,3,414.905097,23.050283,138.301699,68.812744,1,2
0,0,7,7,9,12,21,34,20,54,0.000333,0.079062,4,948.740563,52.707809,237.185141,71.548875,1,2
0,0,5,5,8,11,19,27,17,44,0.000333,0.062303,4,747.635242,41.535291,186.908811,62.053748,1,2
0,0,3,3,6,4,10,17,9,26,0.000333,0.02879,6,518.220783,28.790043,86.37013,23.509775,1,2
0,0,4,4,6,8,14,14,11,25,0.000333,0.031728,3,285.551619,15.863979,95.183873,39.509775,1,2
0,0,3,3,9,8,17,16,11,27,0.000333,0.036787,4,441.445987,24.524777,110.361497,52.529325,2,2
0,0,4,4,9,8,17,20,12,32,0.000333,0.0436,4,523.195244,29.066402,130.798811,52.529325,1,2
0,0,4,4,10,11,21,20,14,34,0.000333,0.04978,5,746.693962,41.482998,149.338792,71.273029,3,2
0,0,5,5,7,7,14,16,11,27,0.000333,0.034266,3,308.395749,17.133097,102.798583,39.302969,1,2
0,0,5,5,7,7,14,16,11,27,0.000333,0.034266,3,308.395749,17.133097,102.798583,39.302969,1,2
0,0,3,3,4,5,9,12,12,24,0.000333,0.025359,4,304.3128,16.906267,76.0782,19.60964,1,2
0,0,8,8,11,14,25,44,29,73,0.000333,0.113001,10,3390.015019,188.334168,339.001502,91.356717,1,2
0,0,4,4,7,13,20,18,20,38,0.000333,0.054744,3,492.699803,27.372211,164.233268,67.757201,2,2
0,0,3,3,8,7,15,15,9,24,0.000333,0.031255,4,375.061497,20.83675,93.765374,43.651484,3,2
0,0,3,3,8,7,15,15,9,24,0.000333,0.031255,4,375.061497,20.83675,93.765374,43.651484,3,2
0,0,5,5,8,11,19,27,18,45,0.000333,0.063719,4,764.626952,42.479275,191.156738,62.053748,1,2
0,0,4,4,8,10,18,14,12,26,0.000333,0.036139,4,433.6722,24.0929,108.41805,57.219281,3,2
0,0,5,5,8,11,19,33,18,51,0.000333,0.072215,4,866.577213,48.143178,216.644303,62.053748,1,2
0,0,4,4,9,11,20,26,16,42,0.000333,0.060507,4,726.08392,40.337996,181.52098,66.583073,1,2
0,0,4,4,4,7,11,13,11,24,0.000333,0.027675,2,166.052718,9.225151,83.026359,27.651484,2,2
0,0,5,5,9,16,25,33,27,60,0.000333,0.092877,4,1114.525486,61.918083,278.631371,92.529325,1,2
0,0,3,3,9,8,17,16,11,27,0.000333,0.036787,4,441.445987,24.524777,110.361497,52.529325,2,2
0,0,5,5,10,7,17,32,17,49,0.000333,0.066762,10,2002.856792,111.269822,200.285679,52.870765,2,2
0,0,6,6,12,11,23,33,18,51,0.000333,0.076901,6,1384.209959,76.900553,230.70166,81.073298,1,2
0,0,3,3,8,6,14,11,9,20,0.000333,0.025382,4,304.588394,16.921577,76.147098,39.509775,1,2
0,0,3,3,8,7,15,15,9,24,0.000333,0.031255,4,375.061497,20.83675,93.765374,43.651484,3,2
0,0,19,19,12,27,39,96,57,153,0.000333,0.269556,12,9703.998474,539.111026,808.666539,171.401513,6,2
0,0,10,10,13,13,26,47,30,77,0.000333,0.120645,12,4343.2063,241.289239,361.933858,96.211433,2,2
0,0,15,15,15,20,35,71,44,115,0.000333,0.196623,14,8258.145657,458.78587,589.867547,145.041921,2,2
0,0,6,6,9,10,19,24,18,42,0.000333,0.059471,4,713.651822,39.647323,178.412956,61.748606,1,2
0,0,5,5,10,9,19,26,15,41,0.000333,0.058055,5,870.82514,48.379174,174.165028,61.748606,1,2
0,0,11,11,12,18,30,112,36,148,0.000333,0.242073,12,8714.637698,484.146539,726.219808,118.0782,1,2
0,0,5,5,8,10,18,28,17,45,0.000333,0.062549,4,750.5865,41.69925,187.646625,57.219281,1,2
0,0,18,18,13,27,40,83,47,130,0.000333,0.230617,6,4151.103914,230.616884,691.850652,176.487679,3,2
0,0,11,11,14,17,31,60,38,98,0.000333,0.161837,14,6797.157338,377.619852,485.511238,122.789837,2,2
0,0,6,6,13,12,25,41,26,67,0.000333,0.103713,12,3733.660377,207.425576,311.138365,91.125266,4,2
0,0,6,6,13,12,25,41,26,67,0.000333,0.103713,12,3733.660377,207.425576,311.138365,91.125266,4,2
0,0,15,15,15,20,35,71,44,115,0.000333,0.196623,14,8258.145657,458.78587,589.867547,145.041921,2,2
0,0,4,4,9,9,18,22,13,35,0.000333,0.048649,4,583.7895,32.43275,145.947375,57.05865,3,2
0,0,4,4,8,10,18,31,16,47,0.000333,0.065329,4,783.9459,43.55255,195.986475,57.219281,1,2
0,0,6,6,10,10,20,43,23,66,0.000333,0.095082,10,2852.472543,158.470697,285.247254,66.438562,1,2
0,0,5,5,7,12,19,33,22,55,0.000333,0.077879,3,700.90804,38.939336,233.636013,62.671034,1,2
0,0,3,3,7,10,17,22,15,37,0.000333,0.050412,3,453.708375,25.206021,151.236125,52.870765,1,2
0,0,3,3,7,7,14,10,8,18,0.000333,0.022844,3,205.597166,11.422065,68.532389,39.302969,3,2
0,0,5,5,10,10,20,29,17,46,0.000333,0.06627,5,994.043462,55.224637,198.808692,66.438562,1,2
0,0,9,9,12,11,23,44,28,72,0.000333,0.108565,12,3908.35753,217.130974,325.696461,81.073298,1,2
0,0,5,5,10,10,20,33,18,51,0.000333,0.073473,5,1102.091664,61.227315,220.418333,66.438562,1,2
0,0,16,16,8,19,27,82,48,130,0.000333,0.206045,8,4945.083002,274.726833,618.135375,104.710623,1,2
0,0,6,6,10,10,20,28,19,47,0.000333,0.06771,5,1015.653102,56.425172,203.13062,66.438562,1,2
0,0,4,4,11,11,22,22,14,36,0.000333,0.053513,5,802.697691,44.594316,160.539538,76.107496,3,2
0,0,29,29,16,35,51,199,117,316,0.000333,0.597495,24,43019.67379,2389.981877,1792.486408,243.524906,8,2
0,0,4,4,7,6,13,14,9,23,0.000333,0.02837,3,255.330341,14.185019,85.110114,35.161259,1,2
0,0,4,4,9,12,21,25,17,42,0.000333,0.061492,4,737.909327,40.994963,184.477332,71.548875,1,2
0,0,11,11,16,18,34,60,41,101,0.000333,0.171278,16,8221.339951,456.741108,513.833747,139.05865,5,2
0,0,5,5,11,12,23,24,16,40,0.000333,0.060314,5,904.712391,50.2618,180.942478,81.073298,3,2
0,0,4,4,5,9,14,15,13,28,0.000333,0.035535,2,213.211876,11.845104,106.605938,40.138965,1,2
0,0,8,8,10,14,24,44,31,75,0.000333,0.114624,10,3438.721876,191.040104,343.872188,86.52225,1,2
0,0,7,7,12,17,29,39,31,70,0.000333,0.113353,6,2040.352018,113.35289,340.05867,112.506418,5,2
0,0,7,7,14,12,26,29,20,49,0.000333,0.076774,7,1612.250823,89.56949,230.321546,96.322519,2,2
0,0,3,3,8,6,14,11,9,20,0.000333,0.025382,4,304.588394,16.921577,76.147098,39.509775,1,2
0,0,6,6,13,12,25,39,24,63,0.000333,0.097521,12,3510.755279,195.04196,292.56294,91.125266,5,2
0,0,3,3,8,6,14,11,9,20,0.000333,0.025382,4,304.588394,16.921577,76.147098,39.509775,1,2
0,0,4,4,11,10,21,24,14,38,0.000333,0.055636,5,834.54031,46.363351,166.908062,71.273029,4,2
0,0,5,5,8,10,18,28,17,45,0.000333,0.062549,4,750.5865,41.69925,187.646625,57.219281,1,2
0,0,13,13,10,14,24,63,44,107,0.000333,0.16353,15,7358.864814,408.825823,490.590988,86.52225,1,2
0,0,7,7,9,12,21,34,20,54,0.000333,0.079062,4,948.740563,52.707809,237.185141,71.548875,1,2
0,0,23,23,17,34,51,157,92,249,0.000333,0.470811,16,22598.94256,1255.496809,1412.43391,242.460605,5,2
0,0,8,8,15,15,30,48,32,80,0.000333,0.13085,14,5495.717467,305.317637,392.551248,117.206718,4,2
0,0,5,5,11,10,21,31,17,48,0.000333,0.070277,5,1054.156181,58.564232,210.831236,71.273029,1,2
0,0,6,6,12,11,23,33,18,51,0.000333,0.076901,6,1384.209959,76.900553,230.70166,81.073298,1,2
0,0,9,9,12,17,29,53,33,86,0.000333,0.139262,6,2506.718193,139.262122,417.786366,112.506418,1,2
0,0,5,5,8,8,16,19,12,31,0.000333,0.041333,4,496,27.555556,124,48,1,2
0,0,6,6,9,11,20,30,19,49,0.000333,0.070591,4,847.097907,47.060995,211.774477,66.583073,1,2
0,0,15,15,14,19,33,66,42,108,0.000333,0.181598,14,7627.123908,423.729106,544.794565,134.013592,2,2
0,0,5,5,10,10,20,33,18,51,0.000333,0.073473,5,1102.091664,61.227315,220.418333,66.438562,1,2
0,0,4,4,10,8,18,20,11,31,0.000333,0.043089,5,646.338375,35.907688,129.267675,57.219281,3,2
0,0,5,5,7,9,16,23,14,37,0.000333,0.049333,3,444,24.666667,148,48.180809,1,2
0,0,9,9,8,13,21,51,35,86,0.000333,0.125913,8,3021.914387,167.884133,377.739298,72.105716,1,2
0,0,9,9,11,10,21,34,23,57,0.000333,0.083454,10,2503.620931,139.090052,250.362093,71.273029,1,2
0,0,3,3,8,7,15,15,9,24,0.000333,0.031255,4,375.061497,20.83675,93.765374,43.651484,3,2
0,0,3,3,8,7,15,15,9,24,0.000333,0.031255,4,375.061497,20.83675,93.765374,43.651484,3,2
0,0,5,5,10,10,20,33,18,51,0.000333,0.073473,5,1102.091664,61.227315,220.418333,66.438562,1,2
0,0,5,5,10,9,19,26,15,41,0.000333,0.058055,5,870.82514,48.379174,174.165028,61.748606,1,2
0,0,4,4,8,8,16,18,12,30,0.000333,0.04,4,480,26.666667,120,48,1,2
0,0,3,3,8,6,14,21,11,32,0.000333,0.040612,4,487.34143,27.074524,121.835358,39.509775,1,2
0,0,4,4,7,14,21,17,17,34,0.000333,0.04978,3,448.016377,24.889799,149.338792,72.954453,1,2
0,0,25,25,14,25,39,156,89,245,0.000333,0.431641,21,27193.39442,1510.744134,1294.923544,169.399374,4,2
0,0,6,6,8,10,18,29,18,47,0.000333,0.065329,4,783.9459,43.55255,195.986475,57.219281,1,2
0,0,31,31,19,34,53,191,108,299,0.000333,0.570883,27,46241.50183,2568.972324,1712.648216,253.684359,3,2
0,0,8,8,12,16,28,42,26,68,0.000333,0.108967,6,1961.400808,108.966712,326.900135,107.01955,2,2
0,0,4,4,7,7,14,15,10,25,0.000333,0.031728,3,285.551619,15.863979,95.183873,39.302969,1,2
0,0,4,4,5,9,14,15,13,28,0.000333,0.035535,2,213.211876,11.845104,106.605938,40.138965,1,2
0,0,7,7,9,12,21,34,20,54,0.000333,0.079062,4,948.740563,52.707809,237.185141,71.548875,1,2
0,0,14,14,11,36,47,97,79,176,0.000333,0.325869,10,9776.076379,543.115354,977.607638,224.171048,2,2
0,0,5,5,10,10,20,29,17,46,0.000333,0.06627,5,994.043462,55.224637,198.808692,66.438562,1,2
0,0,4,4,4,7,11,13,11,24,0.000333,0.027675,2,166.052718,9.225151,83.026359,27.651484,2,2
0,0,22,22,19,30,49,153,73,226,0.000333,0.422975,18,22840.63965,1268.924425,1268.924425,227.917341,10,2
0,0,6,6,9,10,19,24,18,42,0.000333,0.059471,4,713.651822,39.647323,178.412956,61.748606,1,2
0,0,5,5,8,10,18,28,17,45,0.000333,0.062549,4,750.5865,41.69925,187.646625,57.219281,1,2
0,0,3,3,7,7,14,10,8,18,0.000333,0.022844,3,205.597166,11.422065,68.532389,39.302969,3,2
0,0,3,3,8,7,15,15,9,24,0.000333,0.031255,4,375.061497,20.83675,93.765374,43.651484,3,2
0,0,38,38,18,40,58,228,138,366,0.000333,0.714674,27,57888.56819,3216.031566,2144.021044,287.935774,8,2
0,0,4,4,10,9,19,20,12,32,0.000333,0.045311,5,679.668402,37.759356,135.93368,61.748606,3,2
0,0,9,9,12,10,22,41,26,67,0.000333,0.099594,12,3585.383021,199.187946,298.781918,76.238831,1,2
0,0,7,7,11,19,30,44,28,72,0.000333,0.117765,5,1766.480614,98.137812,353.296123,118.764371,2,2
0,0,4,4,7,13,20,18,17,35,0.000333,0.050422,3,453.80245,25.211247,151.267483,67.757201,1,2
0,0,15,15,15,20,35,71,44,115,0.000333,0.196623,14,8258.145657,458.78587,589.867547,145.041921,2,2
0,0,5,5,10,9,19,26,15,41,0.000333,0.058055,5,870.82514,48.379174,174.165028,61.748606,1,2
0,0,10,10,15,17,32,60,37,97,0.000333,0.161667,14,6790,377.222222,485,128.090227,5,2
0,0,10,10,12,16,28,61,37,98,0.000333,0.15704,12,5653.449388,314.080522,471.120782,107.01955,1,2
0,0,7,7,11,19,30,44,28,72,0.000333,0.117765,5,1766.480614,98.137812,353.296123,118.764371,2,2
0,0,44,44,17,46,63,261,146,407,0.000333,0.810918,24,58386.07029,3243.670572,2432.752929,323.570718,10,2
0,0,5,5,11,10,21,31,17,48,0.000333,0.070277,5,1054.156181,58.564232,210.831236,71.273029,1,2
0,0,5,5,8,10,18,28,17,45,0.000333,0.062549,4,750.5865,41.69925,187.646625,57.219281,1,2
0,0,4,4,7,10,17,18,14,32,0.000333,0.0436,3,392.396433,21.799802,130.798811,52.870765,1,2
0,0,4,4,4,7,11,13,11,24,0.000333,0.027675,2,166.052718,9.225151,83.026359,27.651484,2,2
0,0,5,5,11,12,23,24,16,40,0.000333,0.060314,5,904.712391,50.2618,180.942478,81.073298,3,2
0,0,3,3,8,7,15,15,9,24,0.000333,0.031255,4,375.061497,20.83675,93.765374,43.651484,3,2
0,0,25,25,16,37,53,145,88,233,0.000333,0.444868,16,21353.68746,1186.31597,1334.605466,256.749775,1,2
0,0,6,6,10,12,22,31,24,55,0.000333,0.081756,10,2452.68739,136.260411,245.268739,76.238831,6,2
0,0,5,5,10,12,22,26,17,43,0.000333,0.063919,5,958.777798,53.265433,191.75556,76.238831,3,2
0,0,3,3,9,8,17,16,11,27,0.000333,0.036787,4,441.445987,24.524777,110.361497,52.529325,2,2
0,0,6,6,9,8,17,23,14,37,0.000333,0.050412,4,604.944501,33.608028,151.236125,52.529325,1,2
0,0,3,3,8,7,15,15,9,24,0.000333,0.031255,4,375.061497,20.83675,93.765374,43.651484,3,2
0,0,4,4,5,7,12,14,10,24,0.000333,0.02868,2,172.0782,9.5599,86.0391,31.261125,2,2
0,0,3,3,8,7,15,15,9,24,0.000333,0.031255,4,375.061497,20.83675,93.765374,43.651484,3,2
0,0,12,12,14,22,36,63,41,104,0.000333,0.179224,7,3763.705401,209.094745,537.6722,151.410465,1,2
0,0,4,4,11,10,21,24,14,38,0.000333,0.055636,5,834.54031,46.363351,166.908062,71.273029,4,2
0,0,18,18,15,22,37,112,61,173,0.000333,0.300412,14,12617.29605,700.960892,901.235432,156.710855,2,2
0,0,3,3,8,6,14,11,9,20,0.000333,0.025382,4,304.588394,16.921577,76.147098,39.509775,1,2
0,0,13,13,18,17,35,81,46,127,0.000333,0.21714,18,11725.54098,651.418943,651.418943,144.545518,4,2
0,0,4,4,7,13,20,21,18,39,0.000333,0.056185,3,505.665587,28.092533,168.555196,67.757201,1,2
0,0,8,8,14,13,27,47,30,77,0.000333,0.122042,14,5125.768727,284.764929,366.126338,101.408685,4,2
0,0,15,15,10,22,32,89,49,138,0.000333,0.23,10,6900,383.333333,690,131.326777,3,2
0,0,10,10,7,16,23,57,31,88,0.000333,0.132691,3,1194.220356,66.345575,398.073452,83.651484,1,2
0,0,5,5,8,10,18,28,17,45,0.000333,0.062549,4,750.5865,41.69925,187.646625,57.219281,1,2
0,0,5,5,8,10,18,28,17,45,0.000333,0.062549,4,750.5865,41.69925,187.646625,57.219281,1,2
0,0,14,14,14,12,26,67,40,107,0.000333,0.167649,21,10561.88805,586.771558,502.94705,96.322519,1,2
0,0,20,20,15,31,46,150,88,238,0.000333,0.438203,14,18404.50844,1022.472691,1314.607746,212.183445,6,2
0,0,3,3,8,7,15,15,9,24,0.000333,0.031255,4,375.061497,20.83675,93.765374,43.651484,3,2
0,0,5,5,9,9,18,27,17,44,0.000333,0.061159,4,733.9068,40.7726,183.4767,57.05865,1,2
0,0,3,3,8,7,15,15,9,24,0.000333,0.031255,4,375.061497,20.83675,93.765374,43.651484,3,2
0,0,13,13,18,17,35,81,46,127,0.000333,0.21714,18,11725.54098,651.418943,651.418943,144.545518,4,2
0,0,3,3,9,8,17,16,10,26,0.000333,0.035425,4,425.096135,23.616452,106.274034,52.529325,3,2
0,0,6,6,8,13,21,21,22,43,0.000333,0.062957,4,755.478597,41.971033,188.869649,72.105716,1,2
0,0,4,4,5,10,15,17,15,32,0.000333,0.041673,2,250.040998,13.891167,125.020499,44.828921,1,2
0,0,5,5,7,7,14,19,13,32,0.000333,0.040612,3,365.506073,20.305893,121.835358,39.302969,1,2
0,0,4,4,7,6,13,14,9,23,0.000333,0.02837,3,255.330341,14.185019,85.110114,35.161259,1,2
0,0,6,6,8,12,20,29,18,47,0.000333,0.06771,4,812.522482,45.140138,203.13062,67.01955,1,2
0,0,7,7,7,12,19,38,27,65,0.000333,0.092038,6,1656.69173,92.038429,276.115288,62.671034,1,2
0,0,6,6,7,11,18,37,23,60,0.000333,0.083399,6,1501.173001,83.3985,250.1955,57.705232,1,2
0,0,4,4,5,8,13,14,12,26,0.000333,0.03207,2,192.422865,10.690159,96.211433,35.60964,1,2
0,0,3,3,9,8,17,16,10,26,0.000333,0.035425,4,425.096135,23.616452,106.274034,52.529325,3,2
0,0,4,4,9,10,19,28,15,43,0.000333,0.060887,4,730.643532,40.591307,182.660883,61.748606,1,2
0,0,8,8,12,16,28,42,26,68,0.000333,0.108967,6,1961.400808,108.966712,326.900135,107.01955,2,2
0,0,3,3,7,7,14,10,8,18,0.000333,0.022844,3,205.597166,11.422065,68.532389,39.302969,3,2
0,0,5,5,10,9,19,26,15,41,0.000333,0.058055,5,870.82514,48.379174,174.165028,61.748606,1,2
0,0,4,4,8,10,18,31,16,47,0.000333,0.065329,4,783.9459,43.55255,195.986475,57.219281,1,2
0,0,7,7,14,12,26,49,31,80,0.000333,0.125345,14,5264.492484,292.471805,376.035177,96.322519,4,2
0,0,4,4,10,7,17,25,13,38,0.000333,0.051775,5,776.61794,43.145441,155.323588,52.870765,2,2
0,0,7,7,10,14,24,40,27,67,0.000333,0.102397,5,1535.962438,85.331247,307.192488,86.52225,1,2
0,0,3,3,9,6,15,19,10,29,0.000333,0.037767,4,453.199309,25.177739,113.299827,44.0391,1,2
0,0,3,3,10,12,22,15,16,31,0.000333,0.046081,5,691.211901,38.400661,138.24238,76.238831,1,2
0,0,3,3,9,8,17,16,11,27,0.000333,0.036787,4,441.445987,24.524777,110.361497,52.529325,2,2
0,0,8,8,14,14,28,35,23,58,0.000333,0.092942,7,1951.786098,108.432561,278.826585,106.605938,3,2
0,0,10,10,8,15,23,44,33,77,0.000333,0.116105,8,2786.514165,154.806342,348.314271,82.603359,1,2
0,0,31,31,11,32,43,193,112,305,0.000333,0.55167,15,24825.16125,1379.175625,1655.01075,198.053748,5,2
0,0,10,10,13,13,26,47,30,77,0.000333,0.120645,12,4343.2063,241.289239,361.933858,96.211433,2,2
0,0,4,4,6,5,11,14,10,24,0.000333,0.027675,6,498.158153,27.675453,83.026359,27.119415,3,2
0,0,5,5,10,10,20,33,18,51,0.000333,0.073473,5,1102.091664,61.227315,220.418333,66.438562,1,2
0,0,8,8,12,16,28,42,26,68,0.000333,0.108967,6,1961.400808,108.966712,326.900135,107.01955,2,2
0,0,4,4,5,10,15,17,15,32,0.000333,0.041673,2,250.040998,13.891167,125.020499,44.828921,1,2
0,0,5,5,11,10,21,31,17,48,0.000333,0.070277,5,1054.156181,58.564232,210.831236,71.273029,1,2
0,0,5,5,7,7,14,17,13,30,0.000333,0.038074,3,342.661943,19.036775,114.220648,39.302969,1,2
0,0,9,9,12,10,22,41,26,67,0.000333,0.099594,12,3585.383021,199.187946,298.781918,76.238831,1,2
0,0,6,6,7,13,20,35,24,59,0.000333,0.084998,3,764.981273,42.49896,254.993758,67.757201,1,2
0,0,4,4,8,10,18,31,16,47,0.000333,0.065329,4,783.9459,43.55255,195.986475,57.219281,1,2
0,0,4,4,7,11,18,24,17,41,0.000333,0.056989,3,512.900775,28.494488,170.966925,57.705232,1,2
0,0,4,4,8,14,22,18,17,35,0.000333,0.052027,4,624.320427,34.684468,156.080107,77.302969,1,2
0,0,9,9,8,17,25,60,31,91,0.000333,0.140864,4,1690.363653,93.909092,422.590913,93.486868,1,2
0,0,10,10,13,13,26,47,30,77,0.000333,0.120645,12,4343.2063,241.289239,361.933858,96.211433,2,2
0,0,5,5,7,7,14,16,11,27,0.000333,0.034266,3,308.395749,17.133097,102.798583,39.302969,1,2
0,0,15,15,10,21,31,67,37,104,0.000333,0.171745,5,2576.182081,143.121227,515.236416,125.457947,2,2
0,0,4,4,7,8,15,23,20,43,0.000333,0.055999,6,1007.977774,55.998765,167.996296,43.651484,1,2
0,0,5,5,7,7,14,16,11,27,0.000333,0.034266,3,308.395749,17.133097,102.798583,39.302969,1,2
0,0,5,5,8,8,16,19,12,31,0.000333,0.041333,4,496,27.555556,124,48,1,2
0,0,4,4,8,12,20,24,17,41,0.000333,0.059066,4,708.796208,39.377567,177.199052,67.01955,1,2
0,0,7,7,8,15,23,31,27,58,0.000333,0.087456,4,1049.466374,58.303687,262.366593,82.603359,1,2
0,0,8,8,12,16,28,42,26,68,0.000333,0.108967,6,1961.400808,108.966712,326.900135,107.01955,2,2
0,0,3,3,9,7,16,19,11,30,0.000333,0.04,4,480,26.666667,120,48.180809,1,2
0,0,3,3,8,7,15,15,9,24,0.000333,0.031255,4,375.061497,20.83675,93.765374,43.651484,3,2
0,0,10,10,12,15,27,59,34,93,0.000333,0.147402,12,5306.454452,294.803025,442.204538,101.622909,2,2
0,0,6,6,8,12,20,29,21,50,0.000333,0.072032,4,864.385619,48.021423,216.096405,67.01955,1,2
0,0,5,5,7,7,14,16,11,27,0.000333,0.034266,3,308.395749,17.133097,102.798583,39.302969,1,2
0,0,11,11,12,19,31,63,34,97,0.000333,0.160186,6,2883.342253,160.185681,480.557042,123.730173,8,2
0,0,10,10,13,13,26,47,30,77,0.000333,0.120645,12,4343.2063,241.289239,361.933858,96.211433,2,2
0,0,3,3,8,6,14,11,9,20,0.000333,0.025382,4,304.588394,16.921577,76.147098,39.509775,1,2
0,0,4,4,4,7,11,13,11,24,0.000333,0.027675,2,166.052718,9.225151,83.026359,27.651484,2,2
0,0,7,7,9,12,21,34,20,54,0.000333,0.079062,4,948.740563,52.707809,237.185141,71.548875,1,2
0,0,4,4,8,6,14,22,12,34,0.000333,0.04315,8,1035.600539,57.533363,129.450067,39.509775,1,2
0,0,4,4,5,9,14,15,13,28,0.000333,0.035535,2,213.211876,11.845104,106.605938,40.138965,1,2
0,0,5,5,7,9,16,23,14,37,0.000333,0.049333,3,444,24.666667,148,48.180809,1,2
0,0,5,5,8,11,19,33,18,51,0.000333,0.072215,4,866.577213,48.143178,216.644303,62.053748,1,2
0,0,6,6,8,11,19,31,21,52,0.000333,0.073631,4,883.568923,49.087162,220.892231,62.053748,1,2
0,0,6,6,8,11,19,31,18,49,0.000333,0.069383,4,832.593793,46.255211,208.148448,62.053748,1,2
0,0,4,4,8,13,21,20,19,39,0.000333,0.0571,4,685.201518,38.066751,171.300379,72.105716,8,2
0,0,16,16,14,19,33,71,45,116,0.000333,0.19505,14,8192.09605,455.116447,585.149718,134.013592,2,2
0,0,5,5,8,8,16,19,12,31,0.000333,0.041333,4,496,27.555556,124,48,1,2
0,0,4,4,9,8,17,20,12,32,0.000333,0.0436,4,523.195244,29.066402,130.798811,52.529325,1,2
0,0,5,5,8,10,18,28,17,45,0.000333,0.062549,4,750.5865,41.69925,187.646625,57.219281,1,2
0,0,5,5,10,10,20,29,17,46,0.000333,0.06627,5,994.043462,55.224637,198.808692,66.438562,1,2
0,0,7,7,10,14,24,40,27,67,0.000333,0.102397,5,1535.962438,85.331247,307.192488,86.52225,1,2
0,0,6,6,12,11,23,33,18,51,0.000333,0.076901,6,1384.209959,76.900553,230.70166,81.073298,1,2
0,0,7,7,10,14,24,26,24,50,0.000333,0.076416,5,1146.240625,63.680035,229.248125,86.52225,1,2
0,0,4,4,5,9,14,15,13,28,0.000333,0.035535,2,213.211876,11.845104,106.605938,40.138965,1,2
0,0,16,16,16,24,40,124,63,187,0.000333,0.331734,16,15923.20886,884.622714,995.200554,174.0391,5,2
0,0,5,5,10,10,20,29,17,46,0.000333,0.06627,5,994.043462,55.224637,198.808692,66.438562,1,2
0,0,5,5,8,10,18,28,17,45,0.000333,0.062549,4,750.5865,41.69925,187.646625,57.219281,1,2
0,0,5,5,7,8,15,17,12,29,0.000333,0.037767,3,339.899482,18.883305,113.299827,43.651484,1,2
0,0,4,4,11,10,21,24,14,38,0.000333,0.055636,5,834.54031,46.363351,166.908062,71.273029,4,2
0,0,15,15,15,36,51,110,86,196,0.000333,0.370598,14,15565.13514,864.72973,1111.795367,244.720659,1,2
0,0,38,38,17,42,59,231,128,359,0.000333,0.703956,24,50684.85251,2815.82514,2111.868855,295.9642,2,2
0,0,4,4,6,8,14,14,11,25,0.000333,0.031728,3,285.551619,15.863979,95.183873,39.509775,1,2
0,0,23,23,8,25,33,146,84,230,0.000333,0.386737,12,13922.52777,773.473765,1160.210647,140.096405,1,2
0,0,7,7,10,14,24,40,27,67,0.000333,0.102397,5,1535.962438,85.331247,307.192488,86.52225,1,2
0,0,14,14,18,17,35,89,51,140,0.000333,0.239367,27,19388.6898,1077.149434,718.099622,144.545518,6,2
0,0,7,7,11,19,30,44,28,72,0.000333,0.117765,5,1766.480614,98.137812,353.296123,118.764371,2,2
0,0,7,7,9,12,21,34,20,54,0.000333,0.079062,4,948.740563,52.707809,237.185141,71.548875,1,2
0,0,13,13,18,17,35,81,46,127,0.000333,0.21714,18,11725.54098,651.418943,651.418943,144.545518,4,2
0,0,4,4,9,9,18,22,13,35,0.000333,0.048649,4,583.7895,32.43275,145.947375,57.05865,3,2
0,0,4,4,10,8,18,20,11,31,0.000333,0.043089,5,646.338375,35.907688,129.267675,57.219281,3,2
0,0,6,6,13,12,25,41,26,67,0.000333,0.103713,12,3733.660377,207.425576,311.138365,91.125266,4,2
0,0,5,5,8,10,18,28,17,45,0.000333,0.062549,4,750.5865,41.69925,187.646625,57.219281,1,2
0,0,15,15,15,20,35,71,44,115,0.000333,0.196623,14,8258.145657,458.78587,589.867547,145.041921,2,2
0,0,30,30,25,41,66,197,110,307,0.000333,0.618543,24,44535.09587,2474.171993,1855.628995,335.756037,10,2
0,0,5,5,10,10,20,29,17,46,0.000333,0.06627,5,994.043462,55.224637,198.808692,66.438562,1,2
0,0,6,6,8,15,23,37,28,65,0.000333,0.098011,4,1176.126109,65.340339,294.031527,82.603359,1,2
0,0,18,18,17,24,41,103,65,168,0.000333,0.300023,16,14401.09979,800.061099,900.068737,179.525968,2,2
0,0,33,33,15,35,50,230,137,367,0.000333,0.690432,21,43497.19966,2416.511092,2071.295222,238.128265,5,2
0,0,5,5,7,9,16,23,14,37,0.000333,0.049333,3,444,24.666667,148,48.180809,1,2
0,0,41,41,18,43,61,287,164,451,0.000333,0.891588,27,72218.58856,4012.143809,2674.762539,308.388034,7,2
0,0,10,10,13,13,26,47,30,77,0.000333,0.120645,12,4343.2063,241.289239,361.933858,96.211433,2,2
0,0,36,36,16,40,56,657,124,781,0.000333,1.511848,24,108853.0607,6047.392259,4535.544194,276.877124,1,2
0,0,5,5,10,10,20,33,18,51,0.000333,0.073473,5,1102.091664,61.227315,220.418333,66.438562,1,2
0,0,5,5,7,7,14,16,11,27,0.000333,0.034266,3,308.395749,17.133097,102.798583,39.302969,1,2
0,0,3,3,10,7,17,15,9,24,0.000333,0.0327,5,490.495541,27.249752,98.099108,52.870765,3,2
0,0,4,4,7,8,15,14,14,28,0.000333,0.036464,3,328.17881,18.232156,109.392937,43.651484,5,2
0,0,4,4,9,9,18,22,13,35,0.000333,0.048649,4,583.7895,32.43275,145.947375,57.05865,3,2
0,0,6,6,8,11,19,36,21,57,0.000333,0.080711,4,968.527473,53.807082,242.131868,62.053748,1,2
0,0,3,3,8,6,14,11,9,20,0.000333,0.025382,4,304.588394,16.921577,76.147098,39.509775,1,2
0,0,18,18,17,24,41,103,65,168,0.000333,0.300023,16,14401.09979,800.061099,900.068737,179.525968,2,2
0,0,10,10,12,19,31,66,35,101,0.000333,0.166791,6,3002.242964,166.791276,500.373827,123.730173,4,2
0,0,7,7,13,11,24,60,36,96,0.000333,0.146719,18,7922.815201,440.1564,440.1564,86.159464,3,2
0,0,4,4,11,11,22,22,14,36,0.000333,0.053513,5,802.697691,44.594316,160.539538,76.107496,3,2
0,0,19,19,15,27,42,134,61,195,0.000333,0.350501,14,14721.02656,817.834809,1051.501897,186.985321,7,2
0,0,6,6,8,9,17,27,16,43,0.000333,0.058587,4,703.043609,39.057978,175.760902,52.529325,1,2
0,0,4,4,8,14,22,19,18,37,0.000333,0.055,4,659.99588,36.666438,164.99897,77.302969,1,2
0,0,3,3,10,7,17,15,9,24,0.000333,0.0327,5,490.495541,27.249752,98.099108,52.870765,3,2
0,0,3,3,6,4,10,17,9,26,0.000333,0.02879,6,518.220783,28.790043,86.37013,23.509775,1,2
0,0,5,5,7,9,16,23,14,37,0.000333,0.049333,3,444,24.666667,148,48.180809,1,2
0,0,7,7,15,14,29,34,22,56,0.000333,0.090682,7,1904.32855,105.796031,272.046936,111.906328,2,2
0,0,5,5,7,13,20,18,18,36,0.000333,0.051863,3,466.768234,25.931569,155.589411,67.757201,1,2
0,0,5,5,6,7,13,17,12,29,0.000333,0.035771,3,321.938255,17.885459,107.312752,35.161259,2,2
0,0,3,3,7,7,14,10,8,18,0.000333,0.022844,3,205.597166,11.422065,68.532389,39.302969,3,2
0,0,3,3,8,6,14,11,9,20,0.000333,0.025382,4,304.588394,16.921577,76.147098,39.509775,1,2
0,0,4,4,5,9,14,15,13,28,0.000333,0.035535,2,213.211876,11.845104,106.605938,40.138965,1,2
0,0,5,5,7,7,14,17,13,30,0.000333,0.038074,3,342.661943,19.036775,114.220648,39.302969,1,2
0,0,14,14,18,17,35,89,51,140,0.000333,0.239367,27,19388.6898,1077.149434,718.099622,144.545518,4,2
0,0,4,4,11,11,22,22,14,36,0.000333,0.053513,5,802.697691,44.594316,160.539538,76.107496,3,2
0,0,6,6,10,10,20,26,18,44,0.000333,0.063388,5,950.824181,52.823566,190.164836,66.438562,1,2
0,0,3,3,7,13,20,21,18,39,0.000333,0.056185,3,505.665587,28.092533,168.555196,67.757201,1,2
0,0,5,5,10,10,20,33,18,51,0.000333,0.073473,5,1102.091664,61.227315,220.418333,66.438562,1,2
0,0,4,4,7,8,15,21,12,33,0.000333,0.042976,3,386.782169,21.487898,128.92739,43.651484,1,2
0,0,7,7,11,19,30,44,28,72,0.000333,0.117765,5,1766.480614,98.137812,353.296123,118.764371,2,2
0,0,4,4,5,8,13,14,12,26,0.000333,0.03207,2,192.422865,10.690159,96.211433,35.60964,1,2
0,0,25,25,15,28,43,175,104,279,0.000333,0.504643,21,31792.4852,1766.249178,1513.927867,193.209297,7,2
0,0,6,6,9,11,20,30,19,49,0.000333,0.070591,4,847.097907,47.060995,211.774477,66.583073,1,2
0,0,14,14,17,20,37,81,54,135,0.000333,0.234425,16,11252.41927,625.134404,703.276204,155.92543,2,2
0,0,4,4,6,14,20,17,18,35,0.000333,0.050422,3,453.80245,25.211247,151.267483,68.812744,1,2
0,0,19,19,18,42,60,153,112,265,0.000333,0.521775,18,28175.86814,1565.326008,1565.326008,301.535982,2,2
0,0,3,3,8,7,15,20,12,32,0.000333,0.041673,4,500.081996,27.782333,125.020499,43.651484,1,2
0,0,3,3,8,7,15,20,12,32,0.000333,0.041673,4,500.081996,27.782333,125.020499,43.651484,1,2
0,0,5,5,8,10,18,28,17,45,0.000333,0.062549,4,750.5865,41.69925,187.646625,57.219281,1,2
0,0,4,4,10,9,19,20,12,32,0.000333,0.045311,5,679.668402,37.759356,135.93368,61.748606,3,2
0,0,4,4,11,10,21,24,14,38,0.000333,0.055636,5,834.54031,46.363351,166.908062,71.273029,4,2
0,0,5,5,7,7,14,16,11,27,0.000333,0.034266,3,308.395749,17.133097,102.798583,39.302969,1,2
0,0,5,5,8,10,18,28,17,45,0.000333,0.062549,4,750.5865,41.69925,187.646625,57.219281,1,2
0,0,4,4,5,9,14,15,13,28,0.000333,0.035535,2,213.211876,11.845104,106.605938,40.138965,1,2
0,0,27,27,13,19,32,175,83,258,0.000333,0.43,24,30960,1720,1290,128.816339,27,2
0,0,5,5,8,10,18,28,17,45,0.000333,0.062549,4,750.5865,41.69925,187.646625,57.219281,1,2
0,0,5,5,8,11,19,29,21,50,0.000333,0.070799,4,849.585503,47.199195,212.396376,62.053748,1,2
0,0,7,7,8,13,21,21,22,43,0.000333,0.062957,4,755.478597,41.971033,188.869649,72.105716,1,2
0,0,15,15,15,20,35,71,44,115,0.000333,0.196623,14,8258.145657,458.78587,589.867547,145.041921,2,2
0,0,5,5,10,10,20,33,18,51,0.000333,0.073473,5,1102.091664,61.227315,220.418333,66.438562,1,2
0,0,6,6,7,13,20,35,24,59,0.000333,0.084998,3,764.981273,42.49896,254.993758,67.757201,1,2
0,0,5,5,7,12,19,32,22,54,0.000333,0.076463,3,688.164257,38.231348,229.388086,62.671034,1,2
0,0,5,5,8,11,19,27,17,44,0.000333,0.062303,4,747.635242,41.535291,186.908811,62.053748,1,2
0,0,4,4,9,7,16,33,17,50,0.000333,0.066667,8,1600,88.888889,200,48.180809,1,2
0,0,5,5,8,11,19,27,17,44,0.000333,0.062303,4,747.635242,41.535291,186.908811,62.053748,1,2
0,0,3,3,9,8,17,16,10,26,0.000333,0.035425,4,425.096135,23.616452,106.274034,52.529325,3,2
0,0,18,18,16,22,38,89,59,148,0.000333,0.258898,16,12427.09235,690.39402,776.693272,162.107496,2,2
0,0,3,3,8,7,15,15,9,24,0.000333,0.031255,4,375.061497,20.83675,93.765374,43.651484,3,2
0,0,8,8,15,14,29,45,29,74,0.000333,0.11983,14,5032.868311,279.603795,359.490594,111.906328,4,2
0,0,5,5,7,7,14,16,11,27,0.000333,0.034266,3,308.395749,17.133097,102.798583,39.302969,1,2
0,0,3,3,8,6,14,11,9,20,0.000333,0.025382,4,304.588394,16.921577,76.147098,39.509775,1,2
0,0,9,9,16,17,33,54,35,89,0.000333,0.14965,16,7183.217226,399.067624,448.951077,133.486868,5,2
0,0,3,3,8,6,14,11,9,20,0.000333,0.025382,4,304.588394,16.921577,76.147098,39.509775,1,2
0,0,14,14,11,36,47,96,79,175,0.000333,0.324018,10,9720.53049,540.029472,972.053049,224.171048,2,2
0,0,5,5,8,8,16,24,16,40,0.000333,0.053333,8,1280,71.111111,160,48,1,2
0,0,4,4,6,11,17,18,16,34,0.000333,0.046325,3,416.92121,23.162289,138.973737,53.563523,1,2
0,0,4,4,5,9,14,14,13,27,0.000333,0.034266,2,205.597166,11.422065,102.798583,40.138965,1,2
0,0,4,4,7,8,15,21,12,33,0.000333,0.042976,3,386.782169,21.487898,128.92739,43.651484,1,2
0,0,6,6,8,8,16,20,15,35,0.000333,0.046667,4,560,31.111111,140,48,1,2
0,0,3,3,9,8,17,16,11,27,0.000333,0.036787,4,441.445987,24.524777,110.361497,52.529325,2,2
0,0,7,7,9,12,21,21,20,41,0.000333,0.060028,4,720.340057,40.018892,180.085014,71.548875,1,2
0,0,4,4,10,8,18,20,11,31,0.000333,0.043089,5,646.338375,35.907688,129.267675,57.219281,3,2
0,0,9,9,8,15,23,36,28,64,0.000333,0.096503,4,1158.031861,64.335103,289.507965,82.603359,1,2
0,0,5,5,10,9,19,26,15,41,0.000333,0.058055,5,870.82514,48.379174,174.165028,61.748606,1,2
0,0,15,15,15,20,35,71,44,115,0.000333,0.196623,14,8258.145657,458.78587,589.867547,145.041921,2,2
0,0,15,15,19,34,53,104,57,161,0.000333,0.307398,9,8299.756739,461.097597,922.195193,253.684359,2,2
0,0,5,5,8,8,16,22,15,37,0.000333,0.049333,4,592,32.888889,148,48,1,2
0,0,79,79,21,159,180,372,537,909,0.000333,2.270031,30,204302.8339,11350.15744,6810.094465,1254.987056,35,2
0,0,5,5,7,8,15,17,12,29,0.000333,0.037767,3,339.899482,18.883305,113.299827,43.651484,1,2
0,0,5,5,8,11,19,27,18,45,0.000333,0.063719,4,764.626952,42.479275,191.156738,62.053748,1,2
0,0,6,6,7,9,16,20,15,35,0.000333,0.046667,3,420,23.333333,140,48.180809,1,2
0,0,23,23,18,29,47,159,87,246,0.000333,0.455476,27,36893.57915,2049.643286,1366.428858,215.940099,5,2
0,0,5,5,7,7,14,16,11,27,0.000333,0.034266,3,308.395749,17.133097,102.798583,39.302969,1,2
0,0,6,6,12,11,23,33,18,51,0.000333,0.076901,6,1384.209959,76.900553,230.70166,81.073298,1,2
0,0,3,3,8,7,15,15,9,24,0.000333,0.031255,4,375.061497,20.83675,93.765374,43.651484,3,2
0,0,4,4,8,8,16,18,12,30,0.000333,0.04,4,480,26.666667,120,48,1,2
0,0,4,4,8,10,18,31,16,47,0.000333,0.065329,4,783.9459,43.55255,195.986475,57.219281,1,2
0,0,5,5,8,10,18,28,17,45,0.000333,0.062549,4,750.5865,41.69925,187.646625,57.219281,1,2
0,0,3,3,9,8,17,16,10,26,0.000333,0.035425,4,425.096135,23.616452,106.274034,52.529325,3,2
0,0,3,3,9,8,17,16,10,26,0.000333,0.035425,4,425.096135,23.616452,106.274034,52.529325,3,2
0,0,3,3,7,7,14,10,8,18,0.000333,0.022844,3,205.597166,11.422065,68.532389,39.302969,3,2
0,0,10,10,12,16,28,61,37,98,0.000333,0.15704,12,5653.449388,314.080522,471.120782,107.01955,1,2
0,0,5,5,11,10,21,31,17,48,0.000333,0.070277,5,1054.156181,58.564232,210.831236,71.273029,1,2
0,0,4,4,5,7,12,17,12,29,0.000333,0.034655,2,207.927825,11.551546,103.963913,31.261125,1,2
0,0,5,5,9,9,18,27,17,44,0.000333,0.061159,4,733.9068,40.7726,183.4767,57.05865,1,2
0,0,4,4,7,15,22,18,19,37,0.000333,0.055,3,494.99691,27.499828,164.99897,78.254843,1,2
0,0,3,3,8,6,14,11,9,20,0.000333,0.025382,4,304.588394,16.921577,76.147098,39.509775,1,2
0,0,4,4,10,8,18,20,11,31,0.000333,0.043089,5,646.338375,35.907688,129.267675,57.219281,3,2
0,0,3,3,8,7,15,20,12,32,0.000333,0.041673,4,500.081996,27.782333,125.020499,43.651484,1,2
0,0,7,7,9,12,21,34,20,54,0.000333,0.079062,4,948.740563,52.707809,237.185141,71.548875,1,2
0,0,3,3,9,8,17,16,10,26,0.000333,0.035425,4,425.096135,23.616452,106.274034,52.529325,3,2
0,0,4,4,11,9,20,21,12,33,0.000333,0.047541,5,713.118136,39.617674,142.623627,66.583073,3,2
0,0,8,8,12,16,28,42,26,68,0.000333,0.108967,6,1961.400808,108.966712,326.900135,107.01955,2,2
0,0,10,10,13,13,26,47,30,77,0.000333,0.120645,12,4343.2063,241.289239,361.933858,96.211433,2,2
0,0,4,4,9,8,17,33,17,50,0.000333,0.068124,8,1634.985137,90.832508,204.373142,52.529325,1,2
0,0,6,6,8,10,18,23,16,39,0.000333,0.054209,4,650.5083,36.13935,162.627075,57.219281,1,2
0,0,4,4,5,9,14,15,13,28,0.000333,0.035535,2,213.211876,11.845104,106.605938,40.138965,1,2
0,0,5,5,7,7,14,16,11,27,0.000333,0.034266,3,308.395749,17.133097,102.798583,39.302969,1,2
0,0,5,5,8,9,17,23,15,38,0.000333,0.051775,4,621.294352,34.516353,155.323588,52.529325,1,2
0,0,4,4,7,13,20,19,17,36,0.000333,0.051863,3,466.768234,25.931569,155.589411,67.757201,1,2
0,0,4,4,11,9,20,21,12,33,0.000333,0.047541,5,713.118136,39.617674,142.623627,66.583073,3,2
0,0,5,5,10,10,20,33,18,51,0.000333,0.073473,5,1102.091664,61.227315,220.418333,66.438562,1,2
0,0,3,3,8,7,15,20,12,32,0.000333,0.041673,4,500.081996,27.782333,125.020499,43.651484,1,2
0,0,6,6,12,11,23,33,18,51,0.000333,0.076901,6,1384.209959,76.900553,230.70166,81.073298,1,2
0,0,4,4,11,9,20,21,12,33,0.000333,0.047541,5,713.118136,39.617674,142.623627,66.583073,3,2
0,0,5,5,8,11,19,27,17,44,0.000333,0.062303,4,747.635242,41.535291,186.908811,62.053748,1,2
0,0,3,3,8,7,15,20,12,32,0.000333,0.041673,4,500.081996,27.782333,125.020499,43.651484,1,2
0,0,10,10,11,17,28,57,28,85,0.000333,0.136208,5,2043.125842,113.506991,408.625168,107.540616,5,2
0,0,4,4,10,8,18,20,11,31,0.000333,0.043089,5,646.338375,35.907688,129.267675,57.219281,3,2
0,0,4,4,5,9,14,15,13,28,0.000333,0.035535,2,213.211876,11.845104,106.605938,40.138965,1,2
0,0,7,7,9,12,21,21,20,41,0.000333,0.060028,4,720.340057,40.018892,180.085014,71.548875,1,2
0,0,8,8,11,13,24,30,22,52,0.000333,0.079473,5,1192.09025,66.227236,238.41805,86.159464,1,2
0,0,5,5,10,10,20,29,17,46,0.000333,0.06627,5,994.043462,55.224637,198.808692,66.438562,1,2
0,0,5,5,8,10,18,28,17,45,0.000333,0.062549,4,750.5865,41.69925,187.646625,57.219281,1,2
0,0,6,6,13,12,25,39,24,63,0.000333,0.097521,12,3510.755279,195.04196,292.56294,91.125266,5,2
0,0,5,5,8,11,19,33,18,51,0.000333,0.072215,4,866.577213,48.143178,216.644303,62.053748,1,2
0,0,6,6,9,11,20,30,19,49,0.000333,0.070591,4,847.097907,47.060995,211.774477,66.583073,1,2
0,0,18,18,15,26,41,130,75,205,0.000333,0.366099,14,15376.17425,854.231903,1098.298161,180.814792,7,2
0,0,5,5,8,8,16,19,12,31,0.000333,0.041333,4,496,27.555556,124,48,1,2
0,0,12,12,17,23,40,100,48,148,0.000333,0.262548,16,12602.32573,700.129207,787.645358,173.528793,10,2
0,0,13,13,14,20,34,63,46,109,0.000333,0.184844,14,7763.468296,431.303794,554.53345,139.741531,2,2
0,0,4,4,6,11,17,18,16,34,0.000333,0.046325,3,416.92121,23.162289,138.973737,53.563523,1,2
0,0,6,6,9,13,22,27,21,48,0.000333,0.071351,4,856.210871,47.567271,214.052718,76.635041,1,2
0,0,5,5,8,10,18,28,17,45,0.000333,0.062549,4,750.5865,41.69925,187.646625,57.219281,1,2
0,0,4,4,10,11,21,20,14,34,0.000333,0.04978,5,746.693962,41.482998,149.338792,71.273029,3,2
0,0,5,5,11,20,31,31,26,57,0.000333,0.09413,5,1411.945948,78.441442,282.38919,124.49231,1,2
0,0,4,4,6,10,16,17,14,31,0.000333,0.041333,3,372,20.666667,124,48.729056,1,2
0,0,17,17,15,25,40,124,68,192,0.000333,0.340603,14,14305.34272,794.741262,1021.810194,174.699764,6,2
0,0,9,9,8,15,23,36,28,64,0.000333,0.096503,4,1158.031861,64.335103,289.507965,82.603359,1,2
0,0,5,5,8,10,18,28,17,45,0.000333,0.062549,4,750.5865,41.69925,187.646625,57.219281,1,2
0,0,4,4,10,9,19,22,13,35,0.000333,0.049559,5,743.387315,41.299295,148.677463,61.748606,1,2
0,0,7,7,15,8,23,60,31,91,0.000333,0.137215,21,8644.526898,480.251494,411.644138,82.603359,3,2
0,0,9,9,9,16,25,85,30,115,0.000333,0.178014,4,2136.173847,118.676325,534.043462,92.529325,1,2
0,0,5,5,8,15,23,21,26,47,0.000333,0.070869,4,850.429648,47.246092,212.607412,82.603359,2,2
0,0,3,3,9,8,17,16,11,27,0.000333,0.036787,4,441.445987,24.524777,110.361497,52.529325,2,2
0,0,24,24,13,32,45,140,84,224,0.000333,0.410058,12,14762.10112,820.116729,1230.175094,208.105716,1,2
0,0,4,4,10,9,19,22,13,35,0.000333,0.049559,5,743.387315,41.299295,148.677463,61.748606,1,2
0,0,5,5,8,11,19,27,17,44,0.000333,0.062303,4,747.635242,41.535291,186.908811,62.053748,1,2
0,0,6,6,10,12,22,27,20,47,0.000333,0.069864,5,1047.96643,58.220357,209.593286,76.238831,1,2
0,0,3,3,8,6,14,11,9,20,0.000333,0.025382,4,304.588394,16.921577,76.147098,39.509775,1,2
0,0,14,14,17,20,37,81,54,135,0.000333,0.234425,16,11252.41927,625.134404,703.276204,155.92543,2,2
0,0,7,7,8,11,19,20,19,39,0.000333,0.055223,4,662.676692,36.815372,165.669173,62.053748,1,2
0,0,5,5,10,10,20,29,17,46,0.000333,0.06627,5,994.043462,55.224637,198.808692,66.438562,1,2
0,0,5,5,8,8,16,19,12,31,0.000333,0.041333,4,496,27.555556,124,48,1,2
0,0,14,14,17,20,37,81,54,135,0.000333,0.234425,16,11252.41927,625.134404,703.276204,155.92543,2,2
0,0,6,6,8,7,15,20,13,33,0.000333,0.042976,4,515.709559,28.650531,128.92739,43.651484,1,2
0,0,5,5,8,10,18,28,17,45,0.000333,0.062549,4,750.5865,41.69925,187.646625,57.219281,1,2
0,0,4,4,6,12,18,14,15,29,0.000333,0.040309,3,362.783475,20.154638,120.927825,58.529325,1,2
0,0,4,4,4,7,11,13,11,24,0.000333,0.027675,2,166.052718,9.225151,83.026359,27.651484,2,2
0,0,4,4,4,7,11,13,11,24,0.000333,0.027675,2,166.052718,9.225151,83.026359,27.651484,2,2
0,0,5,5,8,13,21,22,19,41,0.000333,0.060028,4,720.340057,40.018892,180.085014,72.105716,1,2
0,0,5,5,7,8,15,17,12,29,0.000333,0.037767,3,339.899482,18.883305,113.299827,43.651484,1,2
0,0,4,4,4,7,11,13,11,24,0.000333,0.027675,2,166.052718,9.225151,83.026359,27.651484,2,2
0,0,4,4,7,8,15,21,12,33,0.000333,0.042976,3,386.782169,21.487898,128.92739,43.651484,1,2
0,0,3,3,8,7,15,15,9,24,0.000333,0.031255,4,375.061497,20.83675,93.765374,43.651484,3,2
0,0,4,4,8,10,18,14,12,26,0.000333,0.036139,4,433.6722,24.0929,108.41805,57.219281,3,2
0,0,16,16,15,20,35,76,47,123,0.000333,0.210301,14,8832.625355,490.701409,630.901811,145.041921,2,2
0,0,6,6,8,11,19,31,18,49,0.000333,0.069383,4,832.593793,46.255211,208.148448,62.053748,1,2
0,0,4,4,5,8,13,14,12,26,0.000333,0.03207,2,192.422865,10.690159,96.211433,35.60964,1,2
0,0,5,5,11,10,21,31,17,48,0.000333,0.070277,5,1054.156181,58.564232,210.831236,71.273029,1,2
0,0,3,3,8,7,15,15,9,24,0.000333,0.031255,4,375.061497,20.83675,93.765374,43.651484,3,2
0,0,3,3,7,7,14,10,8,18,0.000333,0.022844,3,205.597166,11.422065,68.532389,39.302969,3,2
0,0,4,4,9,9,18,22,13,35,0.000333,0.048649,4,583.7895,32.43275,145.947375,57.05865,3,2
0,0,4,4,9,9,18,22,13,35,0.000333,0.048649,4,583.7895,32.43275,145.947375,57.05865,3,2
0,0,5,5,10,10,20,33,18,51,0.000333,0.073473,5,1102.091664,61.227315,220.418333,66.438562,1,2
0,0,3,3,8,6,14,11,9,20,0.000333,0.025382,4,304.588394,16.921577,76.147098,39.509775,1,2
0,0,10,10,12,16,28,61,37,98,0.000333,0.15704,12,5653.449388,314.080522,471.120782,107.01955,1,2
0,0,8,8,12,16,28,42,26,68,0.000333,0.108967,6,1961.400808,108.966712,326.900135,107.01955,2,2
0,0,4,4,8,7,15,17,10,27,0.000333,0.035162,4,421.944184,23.441344,105.486046,43.651484,1,2
0,0,5,5,7,7,14,19,13,32,0.000333,0.040612,3,365.506073,20.305893,121.835358,39.302969,1,2
0,0,14,14,17,20,37,81,54,135,0.000333,0.234425,16,11252.41927,625.134404,703.276204,155.92543,2,2
0,0,5,5,7,7,14,16,11,27,0.000333,0.034266,3,308.395749,17.133097,102.798583,39.302969,1,2
0,0,6,6,10,13,23,38,25,63,0.000333,0.094995,5,1424.922016,79.162334,284.984403,81.324997,1,2
0,0,3,3,8,7,15,20,12,32,0.000333,0.041673,4,500.081996,27.782333,125.020499,43.651484,1,2
0,0,4,4,7,7,14,15,10,25,0.000333,0.031728,3,285.551619,15.863979,95.183873,39.302969,1,2
0,0,4,4,4,7,11,13,11,24,0.000333,0.027675,2,166.052718,9.225151,83.026359,27.651484,2,2
0,0,5,5,10,9,19,26,15,41,0.000333,0.058055,5,870.82514,48.379174,174.165028,61.748606,1,2
0,0,4,4,6,11,17,14,14,28,0.000333,0.03815,3,343.346879,19.074827,114.44896,53.563523,1,2
0,0,7,7,8,9,17,30,18,48,0.000333,0.065399,8,1569.585731,87.199207,196.198216,52.529325,3,2
0,0,5,5,8,8,16,24,15,39,0.000333,0.052,4,624,34.666667,156,48,1,2
0,0,5,5,8,10,18,28,17,45,0.000333,0.062549,4,750.5865,41.69925,187.646625,57.219281,1,2
0,0,4,4,8,10,18,31,16,47,0.000333,0.065329,4,783.9459,43.55255,195.986475,57.219281,1,2
0,0,5,5,8,8,16,19,12,31,0.000333,0.041333,4,496,27.555556,124,48,1,2
0,0,6,6,13,12,25,41,26,67,0.000333,0.103713,12,3733.660377,207.425576,311.138365,91.125266,4,2
0,0,4,4,5,8,13,14,12,26,0.000333,0.03207,2,192.422865,10.690159,96.211433,35.60964,1,2
0,0,4,4,9,9,18,22,13,35,0.000333,0.048649,4,583.7895,32.43275,145.947375,57.05865,3,2
0,0,5,5,8,10,18,28,17,45,0.000333,0.062549,4,750.5865,41.69925,187.646625,57.219281,1,2
0,0,5,5,8,11,19,27,17,44,0.000333,0.062303,4,747.635242,41.535291,186.908811,62.053748,1,2
0,0,3,3,9,8,17,16,10,26,0.000333,0.035425,4,425.096135,23.616452,106.274034,52.529325,3,2
0,0,3,3,8,7,15,20,12,32,0.000333,0.041673,4,500.081996,27.782333,125.020499,43.651484,1,2
0,0,4,4,8,13,21,18,16,34,0.000333,0.04978,4,597.355169,33.186398,149.338792,72.105716,1,2
0,0,4,4,7,9,16,21,14,35,0.000333,0.046667,3,420,23.333333,140,48.180809,1,2
0,0,8,8,12,16,28,42,26,68,0.000333,0.108967,6,1961.400808,108.966712,326.900135,107.01955,2,2
0,0,3,3,8,7,15,15,9,24,0.000333,0.031255,4,375.061497,20.83675,93.765374,43.651484,3,2
0,0,7,7,14,12,26,45,27,72,0.000333,0.112811,14,4738.043236,263.224624,338.43166,96.322519,6,2
0,0,8,8,13,13,26,50,33,83,0.000333,0.130045,12,4681.637959,260.090998,390.136497,96.211433,5,2
0,0,5,5,7,7,14,16,11,27,0.000333,0.034266,3,308.395749,17.133097,102.798583,39.302969,1,2
0,0,8,8,11,14,25,45,31,76,0.000333,0.117644,10,3529.330704,196.073928,352.93307,91.356717,1,2
0,0,4,4,7,14,21,18,18,36,0.000333,0.052708,3,474.370282,26.353905,158.123427,72.954453,1,2
0,0,16,16,14,19,33,71,45,116,0.000333,0.19505,14,8192.09605,455.116447,585.149718,134.013592,2,2
0,0,5,5,8,10,18,28,17,45,0.000333,0.062549,4,750.5865,41.69925,187.646625,57.219281,1,2
0,0,14,14,9,39,48,80,65,145,0.000333,0.26994,4,3239.27825,179.959903,809.819563,234.660012,1,2
0,0,6,6,8,10,18,29,21,50,0.000333,0.069499,8,1667.970001,92.665,208.49625,57.219281,1,2
0,0,4,4,8,15,23,19,19,38,0.000333,0.057298,4,687.581417,38.198968,171.895354,82.603359,1,2
0,0,4,4,8,10,18,14,12,26,0.000333,0.036139,4,433.6722,24.0929,108.41805,57.219281,3,2
0,0,4,4,9,9,18,22,13,35,0.000333,0.048649,4,583.7895,32.43275,145.947375,57.05865,3,2
0,0,3,3,9,8,17,16,11,27,0.000333,0.036787,4,441.445987,24.524777,110.361497,52.529325,2,2
0,0,14,14,17,20,37,81,54,135,0.000333,0.234425,16,11252.41927,625.134404,703.276204,155.92543,2,2
0,0,6,6,10,9,19,26,16,42,0.000333,0.059471,5,892.064778,49.559154,178.412956,61.748606,1,2
0,0,6,6,7,13,20,35,24,59,0.000333,0.084998,3,764.981273,42.49896,254.993758,67.757201,1,2
0,0,4,4,7,11,18,24,17,41,0.000333,0.056989,3,512.900775,28.494488,170.966925,57.705232,1,2
0,0,5,5,11,10,21,31,17,48,0.000333,0.070277,5,1054.156181,58.564232,210.831236,71.273029,1,2
0,0,8,8,10,11,21,35,23,58,0.000333,0.084918,10,2547.544105,141.530228,254.754411,71.273029,4,2
0,0,4,4,7,7,14,15,10,25,0.000333,0.031728,3,285.551619,15.863979,95.183873,39.302969,1,2
0,0,4,4,9,12,21,21,16,37,0.000333,0.054172,4,650.062979,36.11461,162.515745,71.548875,2,2
0,0,10,10,13,13,26,47,30,77,0.000333,0.120645,12,4343.2063,241.289239,361.933858,96.211433,2,2
0,0,4,4,4,7,11,13,11,24,0.000333,0.027675,2,166.052718,9.225151,83.026359,27.651484,2,2
0,0,32,32,14,38,52,289,106,395,0.000333,0.750558,14,31523.43164,1751.301758,2251.673689,252.724214,5,2
0,0,7,7,9,12,21,34,20,54,0.000333,0.079062,4,948.740563,52.707809,237.185141,71.548875,1,2
0,0,3,3,8,7,15,20,12,32,0.000333,0.041673,4,500.081996,27.782333,125.020499,43.651484,1,2
0,0,5,5,7,7,14,19,13,32,0.000333,0.040612,3,365.506073,20.305893,121.835358,39.302969,1,2
0,0,3,3,8,7,15,15,9,24,0.000333,0.031255,4,375.061497,20.83675,93.765374,43.651484,3,2
0,0,5,5,8,11,19,27,17,44,0.000333,0.062303,4,747.635242,41.535291,186.908811,62.053748,1,2
0,0,5,5,10,9,19,26,15,41,0.000333,0.058055,5,870.82514,48.379174,174.165028,61.748606,1,2
0,0,10,10,14,18,32,49,32,81,0.000333,0.135,7,2835,157.5,405,128.361619,2,2
0,0,4,4,5,9,14,14,13,27,0.000333,0.034266,2,205.597166,11.422065,102.798583,40.138965,1,2
0,0,4,4,9,9,18,22,13,35,0.000333,0.048649,4,583.7895,32.43275,145.947375,57.05865,3,2
0,0,9,9,15,18,33,42,28,70,0.000333,0.117703,7,2471.753118,137.319618,353.107588,133.662009,2,2
0,0,11,11,12,17,29,62,38,100,0.000333,0.161933,12,5829.577194,323.8654,485.7981,112.506418,1,2
0,0,5,5,8,10,18,28,17,45,0.000333,0.062549,4,750.5865,41.69925,187.646625,57.219281,1,2
0,0,8,8,15,15,30,46,30,76,0.000333,0.124308,14,5220.931594,290.051755,372.923685,117.206718,5,2
0,0,8,8,13,17,30,36,25,61,0.000333,0.099773,6,1795.921958,99.773442,299.320326,117.592585,1,2
0,0,6,6,13,11,24,38,23,61,0.000333,0.093228,12,3356.192551,186.455142,279.682713,86.159464,4,2
0,0,5,5,8,8,16,20,14,34,0.000333,0.045333,4,544,30.222222,136,48,1,2
0,0,18,18,16,22,38,89,59,148,0.000333,0.258898,16,12427.09235,690.39402,776.693272,162.107496,2,2
0,0,7,7,8,12,20,33,20,53,0.000333,0.076354,4,916.248756,50.902709,229.062189,67.01955,1,2
0,0,3,3,8,7,15,15,9,24,0.000333,0.031255,4,375.061497,20.83675,93.765374,43.651484,3,2
0,0,3,3,8,7,15,15,9,24,0.000333,0.031255,4,375.061497,20.83675,93.765374,43.651484,3,2
0,0,9,9,9,10,19,38,25,63,0.000333,0.089206,8,2140.955467,118.94197,267.619433,61.748606,1,2
0,0,4,4,8,10,18,31,16,47,0.000333,0.065329,4,783.9459,43.55255,195.986475,57.219281,1,2
0,0,3,3,9,7,16,19,11,30,0.000333,0.04,4,480,26.666667,120,48.180809,1,2
0,0,48,48,22,51,73,305,192,497,0.000333,1.025448,33,101519.3126,5639.961811,3076.342806,387.401188,14,2
0,0,6,6,8,10,18,23,16,39,0.000333,0.054209,4,650.5083,36.13935,162.627075,57.219281,1,2
0,0,3,3,9,8,17,16,11,27,0.000333,0.036787,4,441.445987,24.524777,110.361497,52.529325,2,2
0,0,4,4,7,14,21,21,19,40,0.000333,0.058564,3,527.078091,29.282116,175.692697,72.954453,1,2
0,0,5,5,8,11,19,33,18,51,0.000333,0.072215,4,866.577213,48.143178,216.644303,62.053748,1,2
0,0,4,4,7,6,13,14,9,23,0.000333,0.02837,3,255.330341,14.185019,85.110114,35.161259,1,2
0,0,6,6,12,11,23,33,18,51,0.000333,0.076901,6,1384.209959,76.900553,230.70166,81.073298,1,2
0,0,4,4,8,8,16,18,12,30,0.000333,0.04,4,480,26.666667,120,48,1,2
0,0,3,3,8,7,15,15,9,24,0.000333,0.031255,4,375.061497,20.83675,93.765374,43.651484,3,2
0,0,7,7,10,16,26,25,25,50,0.000333,0.078341,5,1175.10993,65.283885,235.021986,97.219281,3,2
0,0,7,7,9,12,21,34,20,54,0.000333,0.079062,4,948.740563,52.707809,237.185141,71.548875,1,2
0,0,15,15,14,19,33,66,42,108,0.000333,0.181598,14,7627.123908,423.729106,544.794565,134.013592,2,2
0,0,4,4,8,10,18,25,15,40,0.000333,0.055599,4,667.188,37.066,166.797,57.219281,1,2
0,0,6,6,10,9,19,40,26,66,0.000333,0.093454,10,2803.632159,155.757342,280.363216,61.748606,6,2
0,0,5,5,8,10,18,28,17,45,0.000333,0.062549,4,750.5865,41.69925,187.646625,57.219281,1,2
0,0,5,5,8,10,18,28,17,45,0.000333,0.062549,4,750.5865,41.69925,187.646625,57.219281,1,2
0,0,6,6,8,7,15,20,13,33,0.000333,0.042976,4,515.709559,28.650531,128.92739,43.651484,1,2
0,0,18,18,16,22,38,89,59,148,0.000333,0.258898,16,12427.09235,690.39402,776.693272,162.107496,2,2
0,0,5,5,10,9,19,26,15,41,0.000333,0.058055,5,870.82514,48.379174,174.165028,61.748606,1,2
0,0,4,4,9,9,18,22,13,35,0.000333,0.048649,4,583.7895,32.43275,145.947375,57.05865,3,2
0,0,4,4,10,9,19,20,12,32,0.000333,0.045311,5,679.668402,37.759356,135.93368,61.748606,3,2
0,0,3,3,8,7,15,15,9,24,0.000333,0.031255,4,375.061497,20.83675,93.765374,43.651484,3,2
0,0,3,3,8,7,15,15,9,24,0.000333,0.031255,4,375.061497,20.83675,93.765374,43.651484,3,2
0,0,5,5,10,10,20,33,18,51,0.000333,0.073473,5,1102.091664,61.227315,220.418333,66.438562,1,2
0,0,5,5,8,10,18,28,17,45,0.000333,0.062549,4,750.5865,41.69925,187.646625,57.219281,1,2
0,0,8,8,10,12,22,45,33,78,0.000333,0.115945,10,3478.356663,193.242037,347.835666,76.238831,1,2
0,0,4,4,10,7,17,16,12,28,0.000333,0.03815,5,572.244798,31.791378,114.44896,52.870765,1,2
0,0,5,5,10,9,19,25,16,41,0.000333,0.058055,5,870.82514,48.379174,174.165028,61.748606,1,2
0,0,6,6,9,9,18,24,16,40,0.000333,0.055599,4,667.188,37.066,166.797,57.05865,1,2
0,0,7,7,10,14,24,40,27,67,0.000333,0.102397,5,1535.962438,85.331247,307.192488,86.52225,1,2
0,0,4,4,12,8,20,23,11,34,0.000333,0.048982,6,881.673331,48.981852,146.945555,67.01955,4,2
0,0,7,7,9,12,21,34,20,54,0.000333,0.079062,4,948.740563,52.707809,237.185141,71.548875,1,2
0,0,4,4,6,9,15,16,12,28,0.000333,0.036464,3,328.17881,18.232156,109.392937,44.0391,1,2
0,0,6,6,12,11,23,33,18,51,0.000333,0.076901,6,1384.209959,76.900553,230.70166,81.073298,1,2
0,0,3,3,8,7,15,15,9,24,0.000333,0.031255,4,375.061497,20.83675,93.765374,43.651484,3,2
0,0,5,5,8,10,18,28,17,45,0.000333,0.062549,4,750.5865,41.69925,187.646625,57.219281,1,2
0,0,4,4,5,8,13,14,12,26,0.000333,0.03207,2,192.422865,10.690159,96.211433,35.60964,1,2
0,0,5,5,8,11,19,27,17,44,0.000333,0.062303,4,747.635242,41.535291,186.908811,62.053748,1,2
0,0,34,34,12,18,30,223,114,337,0.000333,0.551207,36,59530.39671,3307.244261,1653.622131,118.0782,36,2
0,0,3,3,9,8,17,16,11,27,0.000333,0.036787,4,441.445987,24.524777,110.361497,52.529325,2,2
0,0,4,4,7,11,18,21,16,37,0.000333,0.051429,3,462.861675,25.714538,154.287225,57.705232,1,2
0,0,4,4,5,9,14,15,13,28,0.000333,0.035535,2,213.211876,11.845104,106.605938,40.138965,1,2
0,0,13,13,18,17,35,81,46,127,0.000333,0.21714,18,11725.54098,651.418943,651.418943,144.545518,4,2
0,0,8,8,16,16,32,40,25,65,0.000333,0.108333,8,2600,144.444444,325,128,3,2
0,0,5,5,10,9,19,26,15,41,0.000333,0.058055,5,870.82514,48.379174,174.165028,61.748606,1,2
0,0,9,9,10,16,26,47,32,79,0.000333,0.123778,10,3713.347377,206.297077,371.334738,97.219281,1,2
0,0,4,4,4,7,11,13,11,24,0.000333,0.027675,2,166.052718,9.225151,83.026359,27.651484,2,2
0,0,17,17,19,24,43,121,56,177,0.000333,0.32015,18,17288.07951,960.448862,960.448862,190.749723,6,2
0,0,15,15,10,21,31,67,37,104,0.000333,0.171745,5,2576.182081,143.121227,515.236416,125.457947,2,2
0,0,7,7,9,14,23,24,24,48,0.000333,0.072377,4,868.523896,48.251328,217.130974,81.832294,1,2
0,0,5,5,7,8,15,18,14,32,0.000333,0.041673,3,375.061497,20.83675,125.020499,43.651484,1,2
0,0,3,3,9,7,16,19,11,30,0.000333,0.04,4,480,26.666667,120,48.180809,1,2
0,0,4,4,9,9,18,22,13,35,0.000333,0.048649,4,583.7895,32.43275,145.947375,57.05865,3,2
0,0,5,5,8,11,19,27,18,45,0.000333,0.063719,4,764.626952,42.479275,191.156738,62.053748,1,2
0,0,4,4,7,7,14,15,10,25,0.000333,0.031728,3,285.551619,15.863979,95.183873,39.302969,1,2
0,0,3,3,8,7,15,20,12,32,0.000333,0.041673,4,500.081996,27.782333,125.020499,43.651484,1,2
0,0,5,5,7,7,14,16,11,27,0.000333,0.034266,3,308.395749,17.133097,102.798583,39.302969,1,2
0,0,8,8,12,16,28,42,26,68,0.000333,0.108967,6,1961.400808,108.966712,326.900135,107.01955,2,2
0,0,3,3,8,7,15,15,9,24,0.000333,0.031255,4,375.061497,20.83675,93.765374,43.651484,3,2
0,0,12,12,17,22,39,71,50,121,0.000333,0.213178,16,10232.5387,568.474372,639.533668,167.594364,4,2
0,0,5,5,8,10,18,28,17,45,0.000333,0.062549,4,750.5865,41.69925,187.646625,57.219281,1,2
0,0,3,3,8,7,15,15,9,24,0.000333,0.031255,4,375.061497,20.83675,93.765374,43.651484,3,2
0,0,5,5,10,9,19,26,15,41,0.000333,0.058055,5,870.82514,48.379174,174.165028,61.748606,1,2
0,0,71,71,20,55,75,346,257,603,0.000333,1.251993,40,150239.1068,8346.617045,3755.97767,404.413346,17,2
0,0,23,23,14,25,39,141,87,228,0.000333,0.401691,21,25306.50582,1405.91699,1205.071706,169.399374,2,2
0,0,4,4,5,10,15,17,15,32,0.000333,0.041673,2,250.040998,13.891167,125.020499,44.828921,1,2
0,0,12,12,12,20,32,55,41,96,0.000333,0.16,12,5760,320,480,129.458112,2,2
0,0,5,5,8,8,16,26,16,42,0.000333,0.056,8,1344,74.666667,168,48,1,2
0,0,4,4,4,7,11,13,11,24,0.000333,0.027675,2,166.052718,9.225151,83.026359,27.651484,2,2
0,0,11,11,12,23,35,63,40,103,0.000333,0.176105,6,3169.896904,176.105384,528.316151,147.061475,11,2
0,0,9,9,12,11,23,48,29,77,0.000333,0.116105,12,4179.771247,232.209514,348.314271,81.073298,1,2
0,0,5,5,7,7,14,16,11,27,0.000333,0.034266,3,308.395749,17.133097,102.798583,39.302969,1,2
0,0,7,7,9,12,21,34,20,54,0.000333,0.079062,4,948.740563,52.707809,237.185141,71.548875,1,2
0,0,5,5,8,8,16,19,12,31,0.000333,0.041333,4,496,27.555556,124,48,1,2
0,0,5,5,8,11,19,27,17,44,0.000333,0.062303,4,747.635242,41.535291,186.908811,62.053748,1,2
0,0,4,4,7,9,16,19,13,32,0.000333,0.042667,3,384,21.333333,128,48.180809,1,2
0,0,3,3,8,7,15,15,9,24,0.000333,0.031255,4,375.061497,20.83675,93.765374,43.651484,3,2
0,0,4,4,8,8,16,18,12,30,0.000333,0.04,4,480,26.666667,120,48,1,2
0,0,5,5,7,9,16,23,14,37,0.000333,0.049333,3,444,24.666667,148,48.180809,1,2
0,0,20,20,20,29,49,137,80,217,0.000333,0.406131,20,24367.84072,1353.768929,1218.392036,227.320011,6,2
0,0,4,4,7,13,20,18,20,38,0.000333,0.054744,3,492.699803,27.372211,164.233268,67.757201,2,2
0,0,3,3,9,8,17,16,11,27,0.000333,0.036787,4,441.445987,24.524777,110.361497,52.529325,2,2
0,0,3,3,8,7,15,20,12,32,0.000333,0.041673,4,500.081996,27.782333,125.020499,43.651484,1,2
0,0,5,5,7,8,15,17,12,29,0.000333,0.037767,3,339.899482,18.883305,113.299827,43.651484,1,2
0,0,7,7,9,13,22,23,22,45,0.000333,0.066891,4,802.697691,44.594316,200.674423,76.635041,1,2
0,0,3,3,8,7,15,15,9,24,0.000333,0.031255,4,375.061497,20.83675,93.765374,43.651484,3,2
0,0,5,5,8,11,19,33,18,51,0.000333,0.072215,4,866.577213,48.143178,216.644303,62.053748,1,2
0,0,6,6,13,12,25,41,26,67,0.000333,0.103713,12,3733.660377,207.425576,311.138365,91.125266,4,2
0,0,7,7,11,19,30,44,28,72,0.000333,0.117765,5,1766.480614,98.137812,353.296123,118.764371,2,2
0,0,4,4,7,6,13,14,9,23,0.000333,0.02837,3,255.330341,14.185019,85.110114,35.161259,1,2
0,0,4,4,6,11,17,14,14,28,0.000333,0.03815,3,343.346879,19.074827,114.44896,53.563523,1,2
0,0,5,5,7,12,19,32,22,54,0.000333,0.076463,3,688.164257,38.231348,229.388086,62.671034,1,2
0,0,6,6,7,13,20,35,24,59,0.000333,0.084998,3,764.981273,42.49896,254.993758,67.757201,1,2
0,0,9,9,12,16,28,60,34,94,0.000333,0.15063,12,5422.696352,301.260908,451.891363,107.01955,1,2
0,0,4,4,7,6,13,14,9,23,0.000333,0.02837,3,255.330341,14.185019,85.110114,35.161259,1,2
0,0,5,5,10,10,20,33,18,51,0.000333,0.073473,5,1102.091664,61.227315,220.418333,66.438562,1,2
0,0,4,4,11,11,22,22,14,36,0.000333,0.053513,5,802.697691,44.594316,160.539538,76.107496,3,2
0,0,9,9,12,11,23,48,29,77,0.000333,0.116105,12,4179.771247,232.209514,348.314271,81.073298,1,2
0,0,6,6,13,12,25,39,24,63,0.000333,0.097521,12,3510.755279,195.04196,292.56294,91.125266,5,2
0,0,4,4,9,11,20,28,18,46,0.000333,0.06627,4,795.234769,44.179709,198.808692,66.583073,1,2
0,0,4,4,9,9,18,22,13,35,0.000333,0.048649,4,583.7895,32.43275,145.947375,57.05865,3,2
0,0,4,4,11,9,20,21,12,33,0.000333,0.047541,5,713.118136,39.617674,142.623627,66.583073,3,2
0,0,16,16,16,25,41,127,64,191,0.000333,0.341097,16,16372.67893,909.593274,1023.292433,180.096405,6,2
0,0,3,3,8,7,15,20,12,32,0.000333,0.041673,4,500.081996,27.782333,125.020499,43.651484,1,2
0,0,4,4,7,11,18,21,16,37,0.000333,0.051429,3,462.861675,25.714538,154.287225,57.705232,1,2
0,0,5,5,10,14,24,27,21,48,0.000333,0.073359,5,1100.391,61.132833,220.0782,86.52225,1,2
0,0,4,4,7,6,13,14,9,23,0.000333,0.02837,3,255.330341,14.185019,85.110114,35.161259,1,2
0,0,3,3,8,7,15,15,9,24,0.000333,0.031255,4,375.061497,20.83675,93.765374,43.651484,3,2
0,0,9,9,12,16,28,60,34,94,0.000333,0.15063,12,5422.696352,301.260908,451.891363,107.01955,1,2
0,0,5,5,7,9,16,23,14,37,0.000333,0.049333,3,444,24.666667,148,48.180809,1,2
0,0,3,3,8,6,14,11,9,20,0.000333,0.025382,4,304.588394,16.921577,76.147098,39.509775,1,2
0,0,4,4,6,10,16,17,14,31,0.000333,0.041333,3,372,20.666667,124,48.729056,1,2
0,0,6,6,10,11,21,27,18,45,0.000333,0.065885,5,988.27142,54.903968,197.654284,71.273029,1,2
0,0,5,5,7,11,18,15,15,30,0.000333,0.041699,3,375.29325,20.849625,125.09775,57.705232,1,2
0,0,10,10,13,13,26,47,30,77,0.000333,0.120645,12,4343.2063,241.289239,361.933858,96.211433,2,2
0,0,16,16,15,20,35,76,47,123,0.000333,0.210301,14,8832.625355,490.701409,630.901811,145.041921,2,2
0,0,23,23,16,27,43,172,99,271,0.000333,0.490173,24,35292.42597,1960.690331,1470.517749,192.381963,6,2
0,0,8,8,12,16,28,42,26,68,0.000333,0.108967,6,1961.400808,108.966712,326.900135,107.01955,2,2
0,0,5,5,7,8,15,17,12,29,0.000333,0.037767,3,339.899482,18.883305,113.299827,43.651484,1,2
0,0,3,3,8,7,15,13,9,22,0.000333,0.028651,4,343.806372,19.100354,85.951593,43.651484,1,2
0,0,24,24,16,29,45,148,83,231,0.000333,0.422873,16,20297.88904,1127.660502,1268.618065,204.881449,2,2
0,0,6,6,9,8,17,23,14,37,0.000333,0.050412,4,604.944501,33.608028,151.236125,52.529325,1,2
0,0,4,4,8,10,18,25,15,40,0.000333,0.055599,4,667.188,37.066,166.797,57.219281,1,2
0,0,5,5,10,10,20,29,17,46,0.000333,0.06627,5,994.043462,55.224637,198.808692,66.438562,1,2
0,0,3,3,8,7,15,20,12,32,0.000333,0.041673,4,500.081996,27.782333,125.020499,43.651484,1,2
0,0,15,15,14,19,33,66,42,108,0.000333,0.181598,14,7627.123908,423.729106,544.794565,134.013592,2,2
0,0,3,3,8,7,15,15,9,24,0.000333,0.031255,4,375.061497,20.83675,93.765374,43.651484,3,2
0,0,4,4,11,9,20,21,12,33,0.000333,0.047541,5,713.118136,39.617674,142.623627,66.583073,3,2
0,0,14,14,10,25,35,63,46,109,0.000333,0.186364,5,2795.459244,155.303291,559.091849,149.315686,1,2
0,0,5,5,7,7,14,16,11,27,0.000333,0.034266,3,308.395749,17.133097,102.798583,39.302969,1,2
0,0,3,3,8,7,15,15,9,24,0.000333,0.031255,4,375.061497,20.83675,93.765374,43.651484,3,2
0,0,55,55,30,79,109,424,244,668,0.000333,1.507049,45,203451.6208,11302.86782,4521.147129,645.205397,33,2
0,0,3,3,7,7,14,10,8,18,0.000333,0.022844,3,205.597166,11.422065,68.532389,39.302969,3,2
0,0,4,4,8,7,15,15,10,25,0.000333,0.032557,4,390.68906,21.704948,97.672265,43.651484,1,2
0,0,13,13,18,17,35,81,46,127,0.000333,0.21714,18,11725.54098,651.418943,651.418943,144.545518,4,2
0,0,5,5,8,11,19,33,18,51,0.000333,0.072215,4,866.577213,48.143178,216.644303,62.053748,1,2
0,0,5,5,8,14,22,19,19,38,0.000333,0.056486,4,677.833606,37.657423,169.458402,77.302969,1,2
0,0,41,41,23,44,67,283,160,443,0.000333,0.895759,33,88680.15788,4926.675438,2687.277511,344.256916,21,2
0,0,5,5,8,11,19,27,17,44,0.000333,0.062303,4,747.635242,41.535291,186.908811,62.053748,1,2
0,0,13,13,15,20,35,76,48,124,0.000333,0.21201,14,8904.435317,494.690851,636.031094,145.041921,2,2
0,0,23,23,17,32,49,168,95,263,0.000333,0.492223,16,23626.69902,1312.59439,1476.668689,229.486868,6,2
0,0,4,4,6,10,16,19,15,34,0.000333,0.045333,3,408,22.666667,136,48.729056,1,2
0,0,4,4,9,9,18,22,13,35,0.000333,0.048649,4,583.7895,32.43275,145.947375,57.05865,3,2
0,0,5,5,8,10,18,28,17,45,0.000333,0.062549,4,750.5865,41.69925,187.646625,57.219281,1,2
0,0,3,3,8,7,15,15,9,24,0.000333,0.031255,4,375.061497,20.83675,93.765374,43.651484,3,2
0,0,7,7,9,12,21,34,20,54,0.000333,0.079062,4,948.740563,52.707809,237.185141,71.548875,1,2
0,0,5,5,10,10,20,29,17,46,0.000333,0.06627,5,994.043462,55.224637,198.808692,66.438562,1,2
0,0,18,18,13,28,41,92,52,144,0.000333,0.257162,6,4628.924932,257.162496,771.487489,182.711654,12,2
0,0,3,3,8,7,15,15,9,24,0.000333,0.031255,4,375.061497,20.83675,93.765374,43.651484,3,2
0,0,5,5,8,11,19,33,18,51,0.000333,0.072215,4,866.577213,48.143178,216.644303,62.053748,1,2
0,0,4,4,4,7,11,13,11,24,0.000333,0.027675,2,166.052718,9.225151,83.026359,27.651484,2,2
0,0,28,28,16,35,51,182,115,297,0.000333,0.56157,24,40433.04784,2246.280435,1684.710327,243.524906,7,2
0,0,3,3,7,7,14,10,8,18,0.000333,0.022844,3,205.597166,11.422065,68.532389,39.302969,3,2
0,0,4,4,8,10,18,24,15,39,0.000333,0.054209,4,650.5083,36.13935,162.627075,57.219281,1,2
0,0,4,4,10,9,19,22,13,35,0.000333,0.049559,5,743.387315,41.299295,148.677463,61.748606,1,2
0,0,4,4,7,14,21,16,17,33,0.000333,0.048315,3,434.839425,24.157746,144.946475,72.954453,1,2
0,0,6,6,13,11,24,38,23,61,0.000333,0.093228,12,3356.192551,186.455142,279.682713,86.159464,4,2
0,0,4,4,11,10,21,24,14,38,0.000333,0.055636,5,834.54031,46.363351,166.908062,71.273029,4,2
0,0,8,8,15,15,30,46,30,76,0.000333,0.124308,14,5220.931594,290.051755,372.923685,117.206718,5,2
0,0,15,15,14,19,33,66,42,108,0.000333,0.181598,14,7627.123908,423.729106,544.794565,134.013592,2,2
0,0,4,4,6,9,15,17,13,30,0.000333,0.039069,3,351.620154,19.534453,117.206718,44.0391,1,2
0,0,5,5,8,8,16,19,12,31,0.000333,0.041333,4,496,27.555556,124,48,1,2
0,0,36,36,12,19,31,211,116,327,0.000333,0.540007,36,58320.79897,3240.044387,1620.022193,123.730173,40,2
0,0,15,15,14,19,33,66,42,108,0.000333,0.181598,14,7627.123908,423.729106,544.794565,134.013592,2,2
0,0,3,3,9,8,17,16,10,26,0.000333,0.035425,4,425.096135,23.616452,106.274034,52.529325,3,2
0,0,4,4,7,14,21,19,18,37,0.000333,0.054172,3,487.547234,27.085957,162.515745,72.954453,1,2
0,0,6,6,9,13,22,27,21,48,0.000333,0.071351,4,856.210871,47.567271,214.052718,76.635041,1,2
0,0,5,5,8,8,16,19,12,31,0.000333,0.041333,4,496,27.555556,124,48,1,2
0,0,4,4,10,11,21,20,14,34,0.000333,0.04978,5,746.693962,41.482998,149.338792,71.273029,3,2
0,0,3,3,8,7,15,15,9,24,0.000333,0.031255,4,375.061497,20.83675,93.765374,43.651484,3,2
0,0,3,3,8,7,15,15,9,24,0.000333,0.031255,4,375.061497,20.83675,93.765374,43.651484,3,2
0,0,3,3,8,7,15,15,9,24,0.000333,0.031255,4,375.061497,20.83675,93.765374,43.651484,3,2
0,0,5,5,7,8,15,17,12,29,0.000333,0.037767,3,339.899482,18.883305,113.299827,43.651484,1,2
0,0,3,3,9,8,17,16,10,26,0.000333,0.035425,4,425.096135,23.616452,106.274034,52.529325,3,2
0,0,75,75,17,84,101,485,410,895,0.000333,1.986366,32,190691.1769,10593.95427,5959.099277,606.441532,41,2
0,0,5,5,7,7,14,19,13,32,0.000333,0.040612,3,365.506073,20.305893,121.835358,39.302969,1,2
0,0,5,5,8,9,17,23,16,39,0.000333,0.053137,4,637.644203,35.424678,159.411051,52.529325,1,2
0,0,5,5,10,10,20,29,17,46,0.000333,0.06627,5,994.043462,55.224637,198.808692,66.438562,1,2
0,0,17,17,15,27,42,131,75,206,0.000333,0.370272,14,15551.44345,863.96908,1110.817389,186.985321,5,2
0,0,18,18,17,24,41,103,65,168,0.000333,0.300023,16,14401.09979,800.061099,900.068737,179.525968,2,2
0,0,6,6,8,11,19,31,18,49,0.000333,0.069383,4,832.593793,46.255211,208.148448,62.053748,1,2
0,0,5,5,8,8,16,19,12,31,0.000333,0.041333,4,496,27.555556,124,48,1,2
0,0,3,3,8,6,14,11,9,20,0.000333,0.025382,4,304.588394,16.921577,76.147098,39.509775,1,2
0,0,20,20,15,26,41,153,88,241,0.000333,0.43039,21,27114.5707,1506.365039,1291.170033,180.814792,7,2
0,0,10,10,12,15,27,59,34,93,0.000333,0.147402,12,5306.454452,294.803025,442.204538,101.622909,2,2
0,0,3,3,8,7,15,15,9,24,0.000333,0.031255,4,375.061497,20.83675,93.765374,43.651484,3,2
0,0,5,5,7,7,14,16,11,27,0.000333,0.034266,3,308.395749,17.133097,102.798583,39.302969,1,2
0,0,4,4,11,9,20,21,12,33,0.000333,0.047541,5,713.118136,39.617674,142.623627,66.583073,3,2
0,0,5,5,9,10,19,26,17,43,0.000333,0.060887,4,730.643532,40.591307,182.660883,61.748606,1,2
0,0,5,5,9,9,18,29,17,46,0.000333,0.063939,4,767.2662,42.6259,191.81655,57.05865,1,2
0,0,18,18,17,24,41,103,65,168,0.000333,0.300023,16,14401.09979,800.061099,900.068737,179.525968,2,2
0,0,5,5,8,8,16,22,14,36,0.000333,0.048,4,576,32,144,48,1,2
0,0,4,4,5,10,15,17,15,32,0.000333,0.041673,2,250.040998,13.891167,125.020499,44.828921,1,2
0,0,18,18,16,22,38,89,59,148,0.000333,0.258898,16,12427.09235,690.39402,776.693272,162.107496,2,2
0,0,3,3,8,7,15,15,9,24,0.000333,0.031255,4,375.061497,20.83675,93.765374,43.651484,3,2
0,0,18,18,17,24,41,103,65,168,0.000333,0.300023,16,14401.09979,800.061099,900.068737,179.525968,2,2
0,0,6,6,10,12,22,31,24,55,0.000333,0.081756,10,2452.68739,136.260411,245.268739,76.238831,6,2
0,0,4,4,5,8,13,14,12,26,0.000333,0.03207,2,192.422865,10.690159,96.211433,35.60964,1,2
0,0,10,10,12,15,27,46,33,79,0.000333,0.125212,12,4507.633352,250.424075,375.636113,101.622909,1,2
0,0,9,9,16,17,33,54,35,89,0.000333,0.14965,16,7183.217226,399.067624,448.951077,133.486868,5,2
0,0,4,4,8,14,22,22,19,41,0.000333,0.060946,4,731.346785,40.630377,182.836696,77.302969,1,2
0,0,5,5,10,12,22,26,17,43,0.000333,0.063919,5,958.777798,53.265433,191.75556,76.238831,3,2
0,0,10,10,12,15,27,59,34,93,0.000333,0.147402,12,5306.454452,294.803025,442.204538,101.622909,2,2
0,0,14,14,17,20,37,81,54,135,0.000333,0.234425,16,11252.41927,625.134404,703.276204,155.92543,2,2
0,0,6,6,13,11,24,38,23,61,0.000333,0.093228,12,3356.192551,186.455142,279.682713,86.159464,4,2
0,0,3,3,8,7,15,15,9,24,0.000333,0.031255,4,375.061497,20.83675,93.765374,43.651484,3,2
0,0,6,6,7,10,17,21,16,37,0.000333,0.050412,3,453.708375,25.206021,151.236125,52.870765,1,2
0,0,8,8,11,11,22,31,18,49,0.000333,0.072837,5,1092.560747,60.697819,218.512149,76.107496,1,2
0,0,10,10,8,15,23,44,33,77,0.000333,0.116105,8,2786.514165,154.806342,348.314271,82.603359,1,2
0,0,3,3,8,6,14,11,9,20,0.000333,0.025382,4,304.588394,16.921577,76.147098,39.509775,1,2
0,0,5,5,8,8,16,20,14,34,0.000333,0.045333,4,544,30.222222,136,48,1,2
0,0,13,13,16,18,34,73,49,122,0.000333,0.20689,16,9930.727466,551.707081,620.670467,139.05865,6,2
0,0,5,5,10,10,20,33,18,51,0.000333,0.073473,5,1102.091664,61.227315,220.418333,66.438562,1,2
0,0,10,10,12,15,27,59,34,93,0.000333,0.147402,12,5306.454452,294.803025,442.204538,101.622909,2,2
0,0,4,4,11,11,22,22,14,36,0.000333,0.053513,5,802.697691,44.594316,160.539538,76.107496,3,2
0,0,10,10,12,15,27,59,34,93,0.000333,0.147402,12,5306.454452,294.803025,442.204538,101.622909,2,2
0,0,5,5,10,9,19,26,15,41,0.000333,0.058055,5,870.82514,48.379174,174.165028,61.748606,1,2
0,0,5,5,8,10,18,28,17,45,0.000333,0.062549,4,750.5865,41.69925,187.646625,57.219281,1,2
0,0,18,18,13,25,38,90,47,137,0.000333,0.239655,6,4313.796416,239.655356,718.966069,164.202121,2,2
0,0,5,5,10,9,19,26,15,41,0.000333,0.058055,5,870.82514,48.379174,174.165028,61.748606,1,2
0,0,17,17,16,25,41,125,67,192,0.000333,0.342883,16,16458.39976,914.355542,1028.649985,180.096405,5,2
0,0,3,3,8,10,18,21,16,37,0.000333,0.051429,4,617.1489,34.28605,154.287225,57.219281,1,2
0,0,5,5,8,12,20,32,23,55,0.000333,0.079235,4,950.824181,52.823566,237.706045,67.01955,1,2
0,0,3,3,8,6,14,11,9,20,0.000333,0.025382,4,304.588394,16.921577,76.147098,39.509775,1,2
0,0,5,5,11,14,25,30,25,55,0.000333,0.085137,5,1277.060452,70.947803,255.41209,91.356717,1,2
0,0,34,34,16,34,50,211,120,331,0.000333,0.622705,24,44834.79357,2490.821865,1868.116399,236.973737,4,2
0,0,3,3,8,7,15,20,12,32,0.000333,0.041673,4,500.081996,27.782333,125.020499,43.651484,1,2
0,0,5,5,8,10,18,28,17,45,0.000333,0.062549,4,750.5865,41.69925,187.646625,57.219281,1,2
0,0,5,5,7,9,16,23,14,37,0.000333,0.049333,3,444,24.666667,148,48.180809,1,2
0,0,4,4,11,10,21,24,14,38,0.000333,0.055636,5,834.54031,46.363351,166.908062,71.273029,4,2
0,0,4,4,7,6,13,14,9,23,0.000333,0.02837,3,255.330341,14.185019,85.110114,35.161259,1,2
0,0,5,5,8,11,19,27,17,44,0.000333,0.062303,4,747.635242,41.535291,186.908811,62.053748,1,2
0,0,7,7,9,14,23,24,24,48,0.000333,0.072377,4,868.523896,48.251328,217.130974,81.832294,1,2
0,0,8,8,11,15,26,45,29,74,0.000333,0.115944,5,1739.162696,96.62015,347.832539,96.657107,1,2
0,0,4,4,5,8,13,14,12,26,0.000333,0.03207,2,192.422865,10.690159,96.211433,35.60964,1,2
0,0,14,14,18,17,35,89,51,140,0.000333,0.239367,27,19388.6898,1077.149434,718.099622,144.545518,4,2
0,0,5,5,8,10,18,28,17,45,0.000333,0.062549,4,750.5865,41.69925,187.646625,57.219281,1,2
0,0,5,5,11,10,21,31,17,48,0.000333,0.070277,5,1054.156181,58.564232,210.831236,71.273029,1,2
0,0,5,5,7,13,20,18,18,36,0.000333,0.051863,3,466.768234,25.931569,155.589411,67.757201,1,2
0,0,4,4,11,10,21,24,14,38,0.000333,0.055636,5,834.54031,46.363351,166.908062,71.273029,4,2
0,0,5,5,7,8,15,17,12,29,0.000333,0.037767,3,339.899482,18.883305,113.299827,43.651484,1,2
0,0,5,5,7,8,15,17,12,29,0.000333,0.037767,3,339.899482,18.883305,113.299827,43.651484,1,2
0,0,4,4,5,10,15,15,14,29,0.000333,0.037767,2,226.599655,12.58887,113.299827,44.828921,1,2
0,0,4,4,12,11,23,32,19,51,0.000333,0.076901,6,1384.209959,76.900553,230.70166,81.073298,1,2
0,0,4,4,9,9,18,22,13,35,0.000333,0.048649,4,583.7895,32.43275,145.947375,57.05865,3,2
0,0,4,4,5,8,13,14,12,26,0.000333,0.03207,2,192.422865,10.690159,96.211433,35.60964,1,2
0,0,4,4,13,12,25,29,17,46,0.000333,0.071206,6,1281.704308,71.205795,213.617385,91.125266,4,2
0,0,4,4,4,7,11,13,11,24,0.000333,0.027675,2,166.052718,9.225151,83.026359,27.651484,2,2
0,0,6,6,10,11,21,27,18,45,0.000333,0.065885,5,988.27142,54.903968,197.654284,71.273029,1,2
0,0,4,4,7,11,18,24,17,41,0.000333,0.056989,3,512.900775,28.494488,170.966925,57.705232,1,2
0,0,5,5,7,7,14,16,11,27,0.000333,0.034266,3,308.395749,17.133097,102.798583,39.302969,1,2
0,0,3,3,11,12,23,16,16,32,0.000333,0.048251,5,723.769913,40.20944,144.753983,81.073298,1,2
0,0,4,4,10,8,18,20,11,31,0.000333,0.043089,5,646.338375,35.907688,129.267675,57.219281,3,2
0,0,14,14,17,20,37,81,54,135,0.000333,0.234425,16,11252.41927,625.134404,703.276204,155.92543,2,2
0,0,4,4,7,12,19,15,15,30,0.000333,0.042479,3,382.313476,21.239638,127.437825,62.671034,1,2
0,0,5,5,7,7,14,16,11,27,0.000333,0.034266,3,308.395749,17.133097,102.798583,39.302969,1,2
0,0,3,3,7,7,14,10,8,18,0.000333,0.022844,3,205.597166,11.422065,68.532389,39.302969,3,2
0,0,5,5,10,10,20,33,18,51,0.000333,0.073473,5,1102.091664,61.227315,220.418333,66.438562,1,2
0,0,5,5,8,10,18,28,17,45,0.000333,0.062549,4,750.5865,41.69925,187.646625,57.219281,1,2
0,0,9,9,14,19,33,48,38,86,0.000333,0.144606,14,6073.45052,337.413918,433.817894,134.013592,2,2
0,0,5,5,7,9,16,23,14,37,0.000333,0.049333,3,444,24.666667,148,48.180809,1,2
0,0,6,6,8,11,19,36,21,57,0.000333,0.080711,4,968.527473,53.807082,242.131868,62.053748,1,2
0,0,5,5,12,13,25,28,18,46,0.000333,0.071206,6,1281.704308,71.205795,213.617385,91.125266,4,2
0,0,10,10,11,17,28,58,28,86,0.000333,0.137811,5,2067.162616,114.842368,413.432523,107.540616,5,2
0,0,4,4,6,10,16,17,14,31,0.000333,0.041333,3,372,20.666667,124,48.729056,1,2
0,0,13,13,11,22,33,62,40,102,0.000333,0.171509,5,2572.641001,142.9245,514.5282,136.161243,3,2
0,0,4,4,8,12,20,24,17,41,0.000333,0.059066,4,708.796208,39.377567,177.199052,67.01955,1,2
0,0,12,12,16,18,34,68,45,113,0.000333,0.191628,16,9198.132817,511.007379,574.883301,139.05865,5,2
0,0,3,3,7,7,14,10,8,18,0.000333,0.022844,3,205.597166,11.422065,68.532389,39.302969,3,2
0,0,11,11,9,15,24,41,23,64,0.000333,0.097813,4,1173.7504,65.208356,293.4376,87.132684,2,2
0,0,4,4,7,13,20,17,16,33,0.000333,0.047541,3,427.870881,23.770605,142.623627,67.757201,1,2
0,0,5,5,7,9,16,23,14,37,0.000333,0.049333,3,444,24.666667,148,48.180809,1,2
0,0,5,5,8,8,16,19,12,31,0.000333,0.041333,4,496,27.555556,124,48,1,2
0,0,4,4,5,9,14,15,13,28,0.000333,0.035535,2,213.211876,11.845104,106.605938,40.138965,1,2
0,0,4,4,5,9,14,15,13,28,0.000333,0.035535,2,213.211876,11.845104,106.605938,40.138965,1,2
0,0,5,5,8,11,19,27,17,44,0.000333,0.062303,4,747.635242,41.535291,186.908811,62.053748,1,2
0,0,7,7,11,19,30,44,28,72,0.000333,0.117765,5,1766.480614,98.137812,353.296123,118.764371,2,2
0,0,7,7,11,19,30,44,28,72,0.000333,0.117765,5,1766.480614,98.137812,353.296123,118.764371,2,2
0,0,3,3,8,7,15,15,9,24,0.000333,0.031255,4,375.061497,20.83675,93.765374,43.651484,3,2
0,0,5,5,8,11,19,33,18,51,0.000333,0.072215,4,866.577213,48.143178,216.644303,62.053748,1,2
0,0,12,12,16,21,37,60,45,105,0.000333,0.182331,16,8751.881654,486.215647,546.992603,156.238666,5,2
0,0,4,4,11,9,20,21,12,33,0.000333,0.047541,5,713.118136,39.617674,142.623627,66.583073,3,2
0,0,4,4,7,9,16,21,14,35,0.000333,0.046667,3,420,23.333333,140,48.180809,1,2
0,0,5,5,7,8,15,17,12,29,0.000333,0.037767,3,339.899482,18.883305,113.299827,43.651484,1,2
0,0,3,3,8,6,14,11,9,20,0.000333,0.025382,4,304.588394,16.921577,76.147098,39.509775,1,2
0,0,5,5,10,9,19,24,16,40,0.000333,0.056639,5,849.585503,47.199195,169.917101,61.748606,1,2
0,0,10,10,12,16,28,61,37,98,0.000333,0.15704,12,5653.449388,314.080522,471.120782,107.01955,1,2
0,0,5,5,8,10,18,28,17,45,0.000333,0.062549,4,750.5865,41.69925,187.646625,57.219281,1,2
0,0,4,4,4,7,11,13,11,24,0.000333,0.027675,2,166.052718,9.225151,83.026359,27.651484,2,2
0,0,4,4,10,7,17,29,15,44,0.000333,0.059949,10,1798.48365,99.915758,179.848365,52.870765,2,2
0,0,3,3,8,7,15,15,9,24,0.000333,0.031255,4,375.061497,20.83675,93.765374,43.651484,3,2
0,0,4,4,7,7,14,15,10,25,0.000333,0.031728,3,285.551619,15.863979,95.183873,39.302969,1,2
0,0,5,5,8,10,18,28,17,45,0.000333,0.062549,4,750.5865,41.69925,187.646625,57.219281,1,2
0,0,4,4,7,11,18,21,16,37,0.000333,0.051429,3,462.861675,25.714538,154.287225,57.705232,1,2
0,0,3,3,8,7,15,15,9,24,0.000333,0.031255,4,375.061497,20.83675,93.765374,43.651484,3,2
0,0,6,6,13,12,25,41,26,67,0.000333,0.103713,12,3733.660377,207.425576,311.138365,91.125266,4,2
0,0,4,4,6,10,16,17,14,31,0.000333,0.041333,3,372,20.666667,124,48.729056,1,2
0,0,3,3,8,7,15,15,9,24,0.000333,0.031255,4,375.061497,20.83675,93.765374,43.651484,3,2
0,0,5,5,10,9,19,25,16,41,0.000333,0.058055,5,870.82514,48.379174,174.165028,61.748606,1,2
0,0,3,3,8,6,14,11,9,20,0.000333,0.025382,4,304.588394,16.921577,76.147098,39.509775,1,2
0,0,14,14,15,18,33,82,40,122,0.000333,0.205139,14,8615.825156,478.656953,615.416083,133.662009,7,2
0,0,19,19,16,22,38,95,63,158,0.000333,0.276391,16,13266.76075,737.042264,829.172547,162.107496,2,2
0,0,5,5,9,17,26,39,29,68,0.000333,0.106543,4,1278.519603,71.028867,319.629901,98.016193,1,2
0,0,5,5,11,11,22,24,15,39,0.000333,0.057973,5,869.589166,48.310509,173.917833,76.107496,3,2
0,0,14,14,14,21,35,68,47,115,0.000333,0.196623,14,8258.145657,458.78587,589.867547,145.541635,2,2
0,0,4,4,11,10,21,24,14,38,0.000333,0.055636,5,834.54031,46.363351,166.908062,71.273029,4,2
0,0,24,24,16,32,48,169,96,265,0.000333,0.493338,24,35520.36151,1973.353417,1480.015063,224,11,2
0,0,3,3,8,6,14,21,11,32,0.000333,0.040612,4,487.34143,27.074524,121.835358,39.509775,1,2
0,0,8,8,13,12,25,47,30,77,0.000333,0.119192,12,4290.923119,238.384618,357.576927,91.125266,5,2
0,0,3,3,8,7,15,20,12,32,0.000333,0.041673,4,500.081996,27.782333,125.020499,43.651484,1,2
0,0,5,5,8,11,19,27,17,44,0.000333,0.062303,4,747.635242,41.535291,186.908811,62.053748,1,2
0,0,6,6,12,11,23,33,18,51,0.000333,0.076901,6,1384.209959,76.900553,230.70166,81.073298,1,2
0,0,5,5,7,8,15,22,15,37,0.000333,0.048185,3,433.664856,24.092492,144.554952,43.651484,1,2
0,0,5,5,8,10,18,28,17,45,0.000333,0.062549,4,750.5865,41.69925,187.646625,57.219281,1,2
0,0,25,25,12,19,31,159,81,240,0.000333,0.396336,24,28536.17075,1585.342819,1189.007114,123.730173,25,2
0,0,18,18,16,22,38,89,59,148,0.000333,0.258898,16,12427.09235,690.39402,776.693272,162.107496,2,2
0,0,5,5,8,8,16,19,12,31,0.000333,0.041333,4,496,27.555556,124,48,1,2
0,0,4,4,9,9,18,22,13,35,0.000333,0.048649,4,583.7895,32.43275,145.947375,57.05865,3,2
0,0,6,6,13,11,24,38,23,61,0.000333,0.093228,12,3356.192551,186.455142,279.682713,86.159464,4,2
0,0,5,5,7,7,14,16,11,27,0.000333,0.034266,3,308.395749,17.133097,102.798583,39.302969,1,2
0,0,4,4,8,10,18,14,12,26,0.000333,0.036139,4,433.6722,24.0929,108.41805,57.219281,3,2
0,0,6,6,9,12,21,31,21,52,0.000333,0.076134,4,913.602024,50.755668,228.400506,71.548875,1,2
0,0,5,5,10,13,23,27,20,47,0.000333,0.070869,5,1063.03706,59.057614,212.607412,81.324997,1,2
0,0,4,4,6,9,15,17,13,30,0.000333,0.039069,3,351.620154,19.534453,117.206718,44.0391,1,2
0,0,5,5,9,16,25,33,27,60,0.000333,0.092877,4,1114.525486,61.918083,278.631371,92.529325,1,2
0,0,5,5,8,11,19,29,21,50,0.000333,0.070799,4,849.585503,47.199195,212.396376,62.053748,1,2
0,0,4,4,11,10,21,17,11,28,0.000333,0.040995,5,614.924439,34.162469,122.984888,71.273029,3,2
0,0,7,7,9,12,21,34,20,54,0.000333,0.079062,4,948.740563,52.707809,237.185141,71.548875,1,2
0,0,15,15,14,19,33,66,42,108,0.000333,0.181598,14,7627.123908,423.729106,544.794565,134.013592,3,2
0,0,26,26,20,34,54,164,95,259,0.000333,0.496839,20,29810.31726,1656.128737,1490.515863,259.412299,8,2
0,0,4,4,8,10,18,14,12,26,0.000333,0.036139,4,433.6722,24.0929,108.41805,57.219281,3,2
0,0,4,4,7,11,18,24,17,41,0.000333,0.056989,3,512.900775,28.494488,170.966925,57.705232,1,2
0,0,6,6,7,13,20,35,24,59,0.000333,0.084998,3,764.981273,42.49896,254.993758,67.757201,1,2
0,0,3,3,10,13,23,15,17,32,0.000333,0.048251,5,723.769913,40.20944,144.753983,81.324997,1,2
0,0,3,3,8,7,15,20,12,32,0.000333,0.041673,4,500.081996,27.782333,125.020499,43.651484,1,2
0,0,5,5,10,10,20,29,17,46,0.000333,0.06627,5,994.043462,55.224637,198.808692,66.438562,1,2
0,0,6,6,13,11,24,38,23,61,0.000333,0.093228,12,3356.192551,186.455142,279.682713,86.159464,4,2
0,0,5,5,8,10,18,28,17,45,0.000333,0.062549,4,750.5865,41.69925,187.646625,57.219281,1,2
0,0,5,5,7,7,14,16,11,27,0.000333,0.034266,3,308.395749,17.133097,102.798583,39.302969,1,2
0,0,8,8,12,16,28,42,26,68,0.000333,0.108967,6,1961.400808,108.966712,326.900135,107.01955,2,2
0,0,5,5,10,9,19,26,15,41,0.000333,0.058055,5,870.82514,48.379174,174.165028,61.748606,1,2
0,0,18,18,15,38,53,126,100,226,0.000333,0.431503,14,18123.14032,1006.841129,1294.510023,258.024604,3,2
0,0,5,5,8,11,19,27,17,44,0.000333,0.062303,4,747.635242,41.535291,186.908811,62.053748,1,2
0,0,5,5,10,8,18,37,19,56,0.000333,0.077839,10,2335.158001,129.731,233.5158,57.219281,6,2
0,0,18,18,15,25,40,112,63,175,0.000333,0.310446,14,13038.72383,724.373546,931.337417,174.699764,2,2
0,0,26,26,13,35,48,228,76,304,0.000333,0.565943,12,20373.9432,1131.885733,1697.8286,227.630622,12,2
0,0,5,5,8,10,18,28,17,45,0.000333,0.062549,4,750.5865,41.69925,187.646625,57.219281,1,2
0,0,7,7,8,15,23,37,28,65,0.000333,0.098011,4,1176.126109,65.340339,294.031527,82.603359,1,2
0,0,5,5,8,10,18,28,17,45,0.000333,0.062549,4,750.5865,41.69925,187.646625,57.219281,1,2
0,0,4,4,7,12,19,15,15,30,0.000333,0.042479,3,382.313476,21.239638,127.437825,62.671034,1,2
0,0,4,4,8,7,15,17,10,27,0.000333,0.035162,4,421.944184,23.441344,105.486046,43.651484,1,2
0,0,4,4,11,9,20,21,12,33,0.000333,0.047541,5,713.118136,39.617674,142.623627,66.583073,3,2
0,0,4,4,6,13,19,17,17,34,0.000333,0.048143,3,433.288606,24.071589,144.429535,63.615491,1,2
0,0,4,4,11,10,21,24,14,38,0.000333,0.055636,5,834.54031,46.363351,166.908062,71.273029,4,2
0,0,3,3,8,7,15,20,12,32,0.000333,0.041673,4,500.081996,27.782333,125.020499,43.651484,1,2
0,0,6,6,12,11,23,33,18,51,0.000333,0.076901,6,1384.209959,76.900553,230.70166,81.073298,1,2
0,0,8,8,13,13,26,48,31,79,0.000333,0.123778,12,4456.016853,247.556492,371.334738,96.211433,6,2
0,0,5,5,7,8,15,17,12,29,0.000333,0.037767,3,339.899482,18.883305,113.299827,43.651484,1,2
0,0,5,5,7,11,18,15,15,30,0.000333,0.041699,3,375.29325,20.849625,125.09775,57.705232,1,2
0,0,5,5,8,10,18,28,17,45,0.000333,0.062549,4,750.5865,41.69925,187.646625,57.219281,1,2
0,0,23,23,16,30,46,169,100,269,0.000333,0.495279,24,35660.11599,1981.117555,1485.838166,211.206718,5,2
0,0,4,4,7,13,20,16,16,32,0.000333,0.046101,3,414.905097,23.050283,138.301699,67.757201,1,2
0,0,4,4,10,8,18,20,11,31,0.000333,0.043089,5,646.338375,35.907688,129.267675,57.219281,3,2
0,0,11,11,13,17,30,64,38,102,0.000333,0.166834,12,6006.034089,333.668561,500.502841,117.592585,2,2
0,0,30,30,19,36,55,209,115,324,0.000333,0.624387,27,50575.33477,2809.740821,1873.160547,266.827923,6,2
0,0,43,43,18,44,62,294,174,468,0.000333,0.928855,27,75237.22458,4179.84581,2786.563873,315.273641,5,2
0,0,15,15,10,21,31,67,37,104,0.000333,0.171745,5,2576.182081,143.121227,515.236416,125.457947,2,2
0,0,8,8,15,15,30,37,24,61,0.000333,0.099773,7,2095.242284,116.402349,299.320326,117.206718,2,2
0,0,4,4,11,9,20,21,12,33,0.000333,0.047541,5,713.118136,39.617674,142.623627,66.583073,3,2
0,0,5,5,9,7,16,40,20,60,0.000333,0.08,8,1920,106.666667,240,48.180809,6,2
0,0,26,26,15,27,42,149,88,237,0.000333,0.425993,21,26837.56381,1490.975767,1277.979229,186.985321,2,2
0,0,35,35,19,38,57,250,144,394,0.000333,0.766053,27,62050.28397,3447.237998,2298.158666,280.131868,8,2
0,0,5,5,7,8,15,17,12,29,0.000333,0.037767,3,339.899482,18.883305,113.299827,43.651484,1,2
0,0,6,6,13,11,24,38,23,61,0.000333,0.093228,12,3356.192551,186.455142,279.682713,86.159464,4,2
0,0,17,17,15,24,39,124,64,188,0.000333,0.331219,14,13911.17864,772.843258,993.655617,168.642459,8,2
0,0,6,6,13,12,25,39,24,63,0.000333,0.097521,12,3510.755279,195.04196,292.56294,91.125266,5,2
0,0,4,4,5,9,14,15,13,28,0.000333,0.035535,2,213.211876,11.845104,106.605938,40.138965,1,2
0,0,5,5,8,11,19,33,18,51,0.000333,0.072215,4,866.577213,48.143178,216.644303,62.053748,1,2
0,0,10,10,12,15,27,59,34,93,0.000333,0.147402,12,5306.454452,294.803025,442.204538,101.622909,2,2
0,0,3,3,7,7,14,10,8,18,0.000333,0.022844,3,205.597166,11.422065,68.532389,39.302969,3,2
0,0,9,9,16,17,33,54,35,89,0.000333,0.14965,16,7183.217226,399.067624,448.951077,133.486868,5,2
0,0,5,5,8,10,18,28,17,45,0.000333,0.062549,4,750.5865,41.69925,187.646625,57.219281,1,2
0,0,6,6,10,12,22,27,20,47,0.000333,0.069864,5,1047.96643,58.220357,209.593286,76.238831,1,2
0,0,4,4,11,9,20,21,12,33,0.000333,0.047541,5,713.118136,39.617674,142.623627,66.583073,3,2
0,0,3,3,7,7,14,10,8,18,0.000333,0.022844,3,205.597166,11.422065,68.532389,39.302969,3,2
0,0,5,5,7,7,14,16,11,27,0.000333,0.034266,3,308.395749,17.133097,102.798583,39.302969,1,2
0,0,4,4,11,9,20,21,12,33,0.000333,0.047541,5,713.118136,39.617674,142.623627,66.583073,3,2
0,0,24,24,18,30,48,134,87,221,0.000333,0.411426,18,22216.98083,1234.276713,1234.276713,222.265368,3,2
0,0,5,5,8,8,16,19,12,31,0.000333,0.041333,4,496,27.555556,124,48,1,2
0,0,5,5,8,10,18,28,17,45,0.000333,0.062549,4,750.5865,41.69925,187.646625,57.219281,1,2
0,0,3,3,7,7,14,10,8,18,0.000333,0.022844,3,205.597166,11.422065,68.532389,39.302969,3,2
0,0,6,6,8,10,18,29,18,47,0.000333,0.065329,4,783.9459,43.55255,195.986475,57.219281,1,2
0,0,6,6,13,12,25,39,24,63,0.000333,0.097521,12,3510.755279,195.04196,292.56294,91.125266,5,2
0,0,3,3,7,7,14,10,8,18,0.000333,0.022844,3,205.597166,11.422065,68.532389,39.302969,3,2
0,0,5,5,6,8,14,17,13,30,0.000333,0.038074,3,342.661943,19.036775,114.220648,39.509775,1,2
0,0,33,33,19,39,58,181,109,290,0.000333,0.566271,18,30578.6608,1698.814489,1698.814489,286.841309,3,2
0,0,6,6,9,9,18,24,16,40,0.000333,0.055599,4,667.188,37.066,166.797,57.05865,1,2
0,0,10,10,13,13,26,47,30,77,0.000333,0.120645,12,4343.2063,241.289239,361.933858,96.211433,2,2
0,0,6,6,9,13,22,27,21,48,0.000333,0.071351,4,856.210871,47.567271,214.052718,76.635041,1,2
0,0,6,6,13,12,25,39,24,63,0.000333,0.097521,12,3510.755279,195.04196,292.56294,91.125266,5,2
0,0,4,4,6,12,18,14,15,29,0.000333,0.040309,3,362.783475,20.154638,120.927825,58.529325,1,2
0,0,3,3,8,6,14,11,9,20,0.000333,0.025382,4,304.588394,16.921577,76.147098,39.509775,1,2
0,0,15,15,15,20,35,71,44,115,0.000333,0.196623,14,8258.145657,458.78587,589.867547,145.041921,2,2
0,0,16,16,11,22,33,90,47,137,0.000333,0.230361,10,6910.819944,383.934441,691.081994,136.161243,5,2
0,0,8,8,15,15,30,48,32,80,0.000333,0.13085,14,5495.717467,305.317637,392.551248,117.206718,4,2
0,0,4,4,6,14,20,17,18,35,0.000333,0.050422,3,453.80245,25.211247,151.267483,68.812744,1,2
0,0,6,6,12,12,24,35,21,56,0.000333,0.085586,6,1540.5474,85.585967,256.7579,86.0391,3,2
0,0,4,4,10,10,20,20,13,33,0.000333,0.047541,5,713.118136,39.617674,142.623627,66.438562,3,2
0,0,9,9,16,17,33,54,35,89,0.000333,0.14965,16,7183.217226,399.067624,448.951077,133.486868,5,2
0,0,4,4,7,11,18,15,14,29,0.000333,0.040309,3,362.783475,20.154638,120.927825,57.705232,1,2
0,0,25,25,17,37,54,190,106,296,0.000333,0.567816,16,27255.14721,1514.174845,1703.446701,262.236643,5,2
0,0,6,6,10,10,20,43,23,66,0.000333,0.095082,10,2852.472543,158.470697,285.247254,66.438562,1,2
0,0,6,6,13,11,24,38,23,61,0.000333,0.093228,12,3356.192551,186.455142,279.682713,86.159464,4,2
0,0,8,8,8,12,20,35,24,59,0.000333,0.084998,8,2039.950061,113.330559,254.993758,67.01955,1,2
0,0,4,4,11,9,20,21,12,33,0.000333,0.047541,5,713.118136,39.617674,142.623627,66.583073,3,2
0,0,5,5,7,8,15,17,12,29,0.000333,0.037767,3,339.899482,18.883305,113.299827,43.651484,1,2
0,0,6,6,9,12,21,21,20,41,0.000333,0.060028,4,720.340057,40.018892,180.085014,71.548875,1,2
0,0,5,5,8,10,18,28,17,45,0.000333,0.062549,4,750.5865,41.69925,187.646625,57.219281,1,2
0,0,7,7,11,19,30,44,28,72,0.000333,0.117765,5,1766.480614,98.137812,353.296123,118.764371,2,2
0,0,5,5,8,8,16,24,16,40,0.000333,0.053333,8,1280,71.111111,160,48,1,2
0,0,8,8,12,16,28,42,26,68,0.000333,0.108967,6,1961.400808,108.966712,326.900135,107.01955,2,2
0,0,5,5,10,10,20,29,17,46,0.000333,0.06627,5,994.043462,55.224637,198.808692,66.438562,1,2
0,0,6,6,8,15,23,31,27,58,0.000333,0.087456,4,1049.466374,58.303687,262.366593,82.603359,1,2
0,0,4,4,5,8,13,14,12,26,0.000333,0.03207,2,192.422865,10.690159,96.211433,35.60964,1,2
0,0,4,4,9,9,18,22,13,35,0.000333,0.048649,4,583.7895,32.43275,145.947375,57.05865,3,2
0,0,4,4,9,13,22,22,17,39,0.000333,0.057973,4,695.671333,38.648407,173.917833,76.635041,2,2
0,0,4,4,9,9,18,22,13,35,0.000333,0.048649,4,583.7895,32.43275,145.947375,57.05865,3,2
0,0,28,28,19,35,54,243,100,343,0.000333,0.657975,18,35530.67544,1973.926413,1973.926413,260.235528,6,2
0,0,18,18,17,24,41,103,65,168,0.000333,0.300023,16,14401.09979,800.061099,900.068737,179.525968,2,2
0,0,16,16,15,20,35,76,47,123,0.000333,0.210301,14,8832.625355,490.701409,630.901811,145.041921,2,2
0,0,18,18,17,24,41,103,65,168,0.000333,0.300023,16,14401.09979,800.061099,900.068737,179.525968,2,2
0,0,4,4,5,9,14,15,13,28,0.000333,0.035535,2,213.211876,11.845104,106.605938,40.138965,1,2
0,0,18,18,17,24,41,103,65,168,0.000333,0.300023,16,14401.09979,800.061099,900.068737,179.525968,2,2
0,0,4,4,11,11,22,22,14,36,0.000333,0.053513,5,802.697691,44.594316,160.539538,76.107496,3,2
0,0,13,13,18,17,35,81,46,127,0.000333,0.21714,18,11725.54098,651.418943,651.418943,144.545518,4,2
0,0,4,4,4,7,11,13,11,24,0.000333,0.027675,2,166.052718,9.225151,83.026359,27.651484,2,2
0,0,5,5,12,12,24,25,16,41,0.000333,0.062661,6,1127.900775,62.661154,187.983463,86.0391,3,2
0,0,4,4,8,7,15,17,10,27,0.000333,0.035162,4,421.944184,23.441344,105.486046,43.651484,1,2
0,0,4,4,8,13,21,18,16,34,0.000333,0.04978,4,597.355169,33.186398,149.338792,72.105716,1,2
0,0,23,23,21,34,55,150,88,238,0.000333,0.458655,20,27519.27224,1528.848458,1375.963612,265.212402,6,2
0,0,23,23,15,28,43,163,98,261,0.000333,0.472085,21,29741.35712,1652.297618,1416.255101,193.209297,7,2
0,0,16,16,15,20,35,76,47,123,0.000333,0.210301,14,8832.625355,490.701409,630.901811,145.041921,2,2
0,0,4,4,6,13,19,14,16,30,0.000333,0.042479,3,382.313476,21.239638,127.437825,63.615491,1,2
0,0,4,4,7,14,21,17,17,34,0.000333,0.04978,3,448.016377,24.889799,149.338792,72.954453,1,2
0,0,6,6,8,9,17,21,16,37,0.000333,0.050412,4,604.944501,33.608028,151.236125,52.529325,1,2
0,0,21,21,21,36,57,128,88,216,0.000333,0.419968,20,25198.08486,1399.893603,1259.904243,278.355966,6,2
0,0,45,45,30,38,68,229,157,386,0.000333,0.783254,60,140985.6394,7832.535522,2349.760657,346.627963,19,2
0,0,20,20,26,34,60,111,76,187,0.000333,0.368196,26,28719.30208,1595.516782,1104.588541,295.185169,5,2
0,0,16,16,18,23,41,68,51,119,0.000333,0.212516,18,11475.87639,637.548689,637.548689,179.100575,4,2
0,0,25,25,19,46,65,126,84,210,0.000333,0.421566,9,11382.27517,632.34862,1264.697241,334.794473,14,2
0,0,33,33,23,43,66,183,132,315,0.000333,0.634661,33,62831.47687,3490.637604,1903.984148,337.371309,7,2
0,0,4,4,12,13,25,28,19,47,0.000333,0.072754,6,1309.567446,72.753747,218.261241,91.125266,2,2
0,0,5,5,12,12,24,21,16,37,0.000333,0.056548,6,1017.861675,56.547871,169.643613,86.0391,2,2
0,0,8,8,15,15,30,54,30,84,0.000333,0.137393,14,5770.50334,320.583519,412.17881,117.206718,2,2
0,0,73,73,33,122,155,388,275,663,0.000333,1.608023,32,154370.2554,8576.125299,4824.070481,1012.014961,26,2
0,0,10,10,18,27,45,66,47,113,0.000333,0.20686,9,5585.214599,310.2897,620.5794,203.440613,3,2
0,0,10,10,20,32,52,75,56,131,0.000333,0.248919,10,7467.576031,414.865335,746.757603,246.438562,4,2
0,0,17,17,22,38,60,97,79,176,0.000333,0.346538,22,22871.48039,1270.637799,1039.612745,297.528741,4,2
0,0,22,22,28,53,81,123,97,220,0.000333,0.464922,14,19526.73801,1084.818778,1394.767001,438.185722,5,2
0,0,8,8,13,18,31,41,33,74,0.000333,0.122204,6,2199.663162,122.203509,366.610527,123.164366,3,2
0,0,9,9,17,21,38,115,80,195,0.000333,0.341115,24,24560.30076,1364.461153,1023.345865,161.725534,6,2
0,0,5,5,11,12,23,35,30,65,0.000333,0.098011,10,2940.315271,163.350848,294.031527,81.073298,2,2
0,0,9,9,13,12,25,57,31,88,0.000333,0.13622,12,4903.912136,272.439563,408.659345,91.125266,3,2
0,0,15,15,12,27,39,59,60,119,0.000333,0.209654,12,7547.554369,419.308576,628.962864,171.401513,4,2
0,0,8,8,14,23,37,39,31,70,0.000333,0.121554,7,2552.632149,141.812897,364.661736,157.344894,2,2
0,0,5,5,14,25,39,33,28,61,0.000333,0.10747,7,2256.866747,125.381486,322.409535,169.399374,2,2
0,0,11,11,22,38,60,69,57,126,0.000333,0.248089,11,8186.950366,454.830576,744.268215,297.528741,3,2
0,0,19,19,25,46,71,95,79,174,0.000333,0.356685,12,12840.67199,713.370666,1070.055999,370.180255,3,2
0,0,17,17,25,46,71,95,79,174,0.000333,0.356685,12,12840.67199,713.370666,1070.055999,370.180255,3,2
0,0,11,11,14,25,39,38,32,70,0.000333,0.123326,7,2589.847087,143.880394,369.978155,169.399374,2,2
0,0,5,5,16,21,37,35,26,61,0.000333,0.105926,8,2542.213242,141.234069,317.776655,156.238666,3,2
0,0,8,8,16,23,39,45,34,79,0.000333,0.139182,8,3340.374202,185.576345,417.546775,168.041925,5,2
0,0,18,18,20,40,60,86,72,158,0.000333,0.311096,10,9332.887141,518.49373,933.288714,299.315686,3,2
0,0,7,7,19,21,40,41,35,76,0.000333,0.134822,9,3640.198817,202.233268,404.466535,172.949289,3,2
0,0,9,9,13,30,43,45,43,88,0.000333,0.15917,6,2865.06779,159.170433,477.511298,195.312434,1,2
0,0,14,14,15,30,45,51,43,94,0.000333,0.172078,7,3613.639337,200.757741,516.234191,205.810077,2,2
0,0,11,11,14,25,39,38,32,70,0.000333,0.123326,7,2589.847087,143.880394,369.978155,169.399374,2,2
0,0,10,10,16,24,40,45,32,77,0.000333,0.136596,8,3278.307706,182.128206,409.788463,174.0391,10,2
0,0,7,7,15,22,37,31,26,57,0.000333,0.09898,7,2078.571893,115.476216,296.938842,156.710855,3,2
0,0,12,12,15,27,42,43,34,77,0.000333,0.138403,7,2906.459091,161.469949,415.208442,186.985321,2,2
0,0,10,10,14,23,37,37,30,67,0.000333,0.116344,7,2443.233628,135.735202,349.033375,157.344894,2,2
0,0,10,10,18,36,54,55,49,104,0.000333,0.199503,9,5386.574702,299.25415,598.5083,261.17595,1,2
0,0,13,13,15,31,46,49,43,92,0.000333,0.169389,7,3557.1739,197.620772,508.1677,212.183445,3,2
0,0,12,12,17,28,45,47,39,86,0.000333,0.157433,8,3778.39493,209.910829,472.299366,204.092806,3,2
0,0,12,12,15,27,42,43,34,77,0.000333,0.138403,7,2906.459091,161.469949,415.208442,186.985321,2,2
0,0,12,12,15,30,45,56,43,99,0.000333,0.181231,7,3805.854196,211.436344,543.693457,205.810077,9,2
0,0,10,10,18,36,54,55,49,104,0.000333,0.199503,9,5386.574702,299.25415,598.5083,261.17595,1,2
0,0,14,14,15,30,45,51,43,94,0.000333,0.172078,7,3613.639337,200.757741,516.234191,205.810077,2,2
0,0,4,4,12,14,26,30,21,51,0.000333,0.079907,6,1438.334554,79.907475,239.722426,96.322519,6,2
0,0,4,4,12,15,27,32,23,55,0.000333,0.087173,6,1569.112876,87.172938,261.518813,101.622909,7,2
0,0,17,17,23,22,45,81,54,135,0.000333,0.247133,22,16310.8037,906.155761,741.400168,202.149421,7,2
0,0,20,20,29,37,66,118,74,192,0.000333,0.386841,28,32494.66279,1805.259044,1160.523671,333.631223,8,2
0,0,35,35,31,66,97,234,157,391,0.000333,0.860189,30,77416.97764,4300.943202,2580.565921,552.510097,19,2
0,0,25,25,26,44,70,136,92,228,0.000333,0.465826,26,36334.38972,2018.577207,1397.476528,362.426424,10,2
0,0,24,24,29,47,76,161,120,281,0.000333,0.585223,28,49158.69368,2731.038538,1755.667631,401.947125,10,2
0,0,22,22,26,55,81,179,106,285,0.000333,0.602286,13,23489.14426,1304.952459,1806.857251,440.186217,10,2
0,0,27,27,30,66,96,208,131,339,0.000333,0.744101,15,33484.53432,1860.251906,2232.302288,546.13673,11,2
0,0,17,17,23,32,55,95,68,163,0.000333,0.314121,22,20731.95593,1151.77533,942.361633,264.041925,13,2
0,0,13,13,13,40,53,80,79,159,0.000333,0.30358,6,5464.436114,303.579784,910.739352,260.98284,11,2
0,0,11,11,18,21,39,60,43,103,0.000333,0.181465,18,9799.135714,544.396429,544.396429,167.297316,5,2
0,0,18,18,16,25,41,104,64,168,0.000333,0.300023,16,14401.09979,800.061099,900.068737,180.096405,4,2
0,0,15,15,18,25,43,82,52,134,0.000333,0.242373,18,13088.15059,727.119477,727.119477,191.155055,5,2
0,0,9,9,15,24,39,41,33,74,0.000333,0.130373,7,2737.838349,152.102131,391.119764,168.642459,2,2
0,0,6,6,15,26,41,35,30,65,0.000333,0.11608,7,2437.686162,135.427009,348.24088,180.814792,2,2
0,0,12,12,22,39,61,71,59,130,0.000333,0.256999,11,8480.954393,471.164133,770.995854,304.238182,3,2
0,0,20,20,25,47,72,97,81,178,0.000333,0.366082,12,13178.9598,732.164434,1098.24665,377.162081,3,2
0,0,18,18,25,47,72,97,81,178,0.000333,0.366082,12,13178.9598,732.164434,1098.24665,377.162081,3,2
0,0,12,12,15,26,41,40,34,74,0.000333,0.132153,7,2775.211938,154.178441,396.458848,180.814792,2,2
0,0,7,7,16,22,38,41,31,72,0.000333,0.12595,8,3022.806248,167.93368,377.850781,162.107496,3,2
0,0,9,9,17,24,41,47,36,83,0.000333,0.148226,8,3557.414531,197.634141,444.676816,179.525968,5,2
0,0,19,19,20,41,61,88,74,162,0.000333,0.32026,10,9607.794487,533.76636,960.779449,306.098194,3,2
0,0,8,8,19,22,41,45,37,82,0.000333,0.14644,9,3953.873379,219.659632,439.319264,178.818118,3,2
0,0,10,10,13,31,44,47,45,92,0.000333,0.167423,6,3013.606253,167.42257,502.267709,201.685802,1,2
0,0,15,15,16,31,47,53,45,98,0.000333,0.18145,8,4354.79766,241.933203,544.349707,217.580086,2,2
0,0,12,12,15,26,41,40,34,74,0.000333,0.132153,7,2775.211938,154.178441,396.458848,180.814792,2,2
0,0,11,11,16,25,41,47,34,81,0.000333,0.144654,8,3471.693699,192.871872,433.961712,180.096405,10,2
0,0,8,8,15,23,38,35,28,63,0.000333,0.110206,7,2314.336033,128.574224,330.619433,162.645284,3,2
0,0,13,13,16,28,44,45,36,81,0.000333,0.147405,8,3537.711689,196.539538,442.213961,198.605938,2,2
0,0,11,11,15,24,39,39,32,71,0.000333,0.125088,7,2626.844903,145.935828,375.263558,168.642459,2,2
0,0,11,11,18,37,55,57,51,108,0.000333,0.208129,9,5619.481642,312.193425,624.386849,267.808425,1,2
0,0,14,14,16,32,48,51,45,96,0.000333,0.178719,8,4289.251201,238.291733,536.1564,224,3,2
0,0,13,13,18,29,47,49,41,90,0.000333,0.166638,9,4499.21697,249.956498,499.912997,215.940099,3,2
0,0,13,13,16,28,44,45,36,81,0.000333,0.147405,8,3537.711689,196.539538,442.213961,198.605938,2,2
0,0,13,13,15,31,46,58,45,103,0.000333,0.189642,7,3982.48817,221.249343,568.926881,212.183445,9,2
0,0,11,11,18,37,55,57,51,108,0.000333,0.208129,9,5619.481642,312.193425,624.386849,267.808425,1,2
0,0,15,15,16,31,47,53,45,98,0.000333,0.18145,8,4354.79766,241.933203,544.349707,217.580086,2,2
0,0,5,5,13,15,28,32,23,55,0.000333,0.088135,6,1586.427124,88.13484,264.404521,106.709075,6,2
0,0,5,5,12,16,28,34,25,59,0.000333,0.094545,6,1701.803642,94.544647,283.63394,107.01955,7,2
0,0,18,18,23,23,46,83,56,139,0.000333,0.255925,22,16891.05246,938.391803,767.775112,208.08385,7,2
0,0,21,21,29,38,67,120,76,196,0.000333,0.396318,28,33290.69748,1849.483193,1188.953481,340.302694,8,2
0,0,36,36,31,67,98,236,159,395,0.000333,0.870937,30,78384.31165,4354.683981,2612.810388,560.008061,19,2
0,0,26,26,26,45,71,139,94,233,0.000333,0.47763,26,37255.16805,2069.731558,1432.891079,369.344822,10,2
0,0,25,25,29,48,77,164,122,286,0.000333,0.597434,28,50184.42662,2788.023701,1792.300951,408.959649,10,2
0,0,28,28,30,67,97,210,133,343,0.000333,0.75459,15,33956.55157,1886.475087,2263.770105,553.634694,11,2
0,0,19,19,23,33,56,97,70,167,0.000333,0.323276,22,21336.22198,1185.345666,969.828272,270.506931,14,2
0,0,13,13,13,41,54,82,81,163,0.000333,0.312682,6,5628.279977,312.682221,938.046663,267.765349,11,2
0,0,12,12,18,22,40,62,45,107,0.000333,0.189815,18,10250.03351,569.446306,569.446306,173.166146,5,2
0,0,19,19,16,26,42,106,66,172,0.000333,0.30916,16,14839.65755,824.425419,927.478597,186.211433,4,2
0,0,16,16,18,27,45,84,54,138,0.000333,0.252625,18,13641.76309,757.875727,757.875727,203.440613,5,2
0,0,14,14,23,39,62,90,74,164,0.000333,0.325496,11,10741.37014,596.742786,976.488195,310.172612,3,2
0,0,20,20,26,47,73,108,90,198,0.000333,0.408528,13,15932.60842,885.144912,1225.585263,383.277109,3,2
0,0,21,21,20,41,61,106,82,188,0.000333,0.37166,20,22299.57239,1238.865133,1114.978619,306.098194,3,2
0,0,10,10,20,22,42,52,47,99,0.000333,0.177946,20,10676.7885,593.154917,533.839425,184.546058,3,2
0,0,12,12,14,31,45,64,59,123,0.000333,0.225166,7,4728.485516,262.69364,675.497931,206.883055,1,2
0,0,13,13,20,37,57,68,60,128,0.000333,0.24887,10,7466.099218,414.78329,746.609922,279.188336,1,2
0,0,15,15,18,31,49,70,55,125,0.000333,0.233946,9,6316.548575,350.919365,701.838731,228.638736,9,2
0,0,13,13,20,37,57,68,60,128,0.000333,0.24887,10,7466.099218,414.78329,746.609922,279.188336,1,2
0,0,20,20,23,23,46,94,65,159,0.000333,0.292749,22,19321.41972,1073.412207,878.246351,208.08385,7,2
0,0,23,23,30,38,68,139,90,229,0.000333,0.464676,30,41820.86972,2323.381651,1394.028991,346.627963,8,2
0,0,38,38,32,67,99,253,172,425,0.000333,0.939159,32,90159.25003,5008.847224,2817.476564,566.427976,19,2
0,0,28,28,27,45,72,155,107,262,0.000333,0.53884,26,42029.52911,2334.973839,1616.52035,375.515352,10,2
0,0,27,27,30,48,78,178,130,308,0.000333,0.645301,30,58077.1165,3226.506472,1935.903883,415.284918,10,2
0,0,30,30,30,67,97,223,141,364,0.000333,0.800789,30,72071.04824,4003.947124,2402.368275,553.634694,11,2
0,0,21,21,24,33,57,107,77,184,0.000333,0.357751,24,25758.0423,1431.00235,1073.251763,276.504106,14,2
0,0,15,15,14,41,55,95,89,184,0.000333,0.35459,14,14892.78262,827.376812,1063.770187,272.962601,11,2
0,0,14,14,20,22,42,82,56,138,0.000333,0.248047,20,14882.79609,826.822005,744.139804,184.546058,5,2
0,0,21,21,17,26,43,118,74,192,0.000333,0.347281,16,16669.48533,926.082518,1041.842833,191.698301,4,2
0,0,18,18,18,26,44,96,61,157,0.000333,0.28571,18,15428.35375,857.130764,857.130764,197.270083,5,2
0,0,16,16,23,42,65,99,82,181,0.000333,0.36335,11,11990.53432,666.140795,1090.048574,330.519257,3,2
0,0,25,25,25,50,75,118,102,220,0.000333,0.45678,24,32888.16269,1827.120149,1370.340112,398.289214,3,2
0,0,23,23,25,50,75,118,100,218,0.000333,0.452627,24,32589.17939,1810.509966,1357.882475,398.289214,3,2
0,0,24,24,20,45,65,112,93,205,0.000333,0.411528,20,24691.70803,1371.761557,1234.585402,333.571951,3,2
0,0,13,13,20,25,45,61,56,117,0.000333,0.214182,20,12850.93625,713.940903,642.546812,202.534967,3,2
0,0,17,17,14,34,48,78,74,152,0.000333,0.282971,14,11884.8002,660.266678,848.9143,226.276706,1,2
0,0,16,16,19,40,59,78,72,150,0.000333,0.294132,9,7941.568117,441.198229,882.396457,293.587747,1,2
0,0,16,16,19,40,59,78,72,150,0.000333,0.294132,9,7941.568117,441.198229,882.396457,293.587747,1,2
0,0,23,23,23,26,49,104,77,181,0.000333,0.338754,22,22357.7746,1242.098589,1016.262482,226.253358,7,2
0,0,26,26,30,41,71,152,102,254,0.000333,0.520679,30,46861.07305,2603.392947,1562.035768,366.86635,8,2
0,0,41,41,32,70,102,262,182,444,0.000333,0.987519,32,94801.81926,5266.767737,2962.556852,589.049811,19,2
0,0,31,31,27,48,75,162,117,279,0.000333,0.57928,26,45183.85078,2510.213932,1737.840415,396.460163,10,2
0,0,30,30,30,51,81,187,140,327,0.000333,0.691044,30,62193.92853,3455.218252,2073.130951,436.50041,10,2
0,0,33,33,30,71,101,239,154,393,0.000333,0.872226,30,78500.31338,4361.128521,2616.677113,583.838763,11,2
0,0,23,23,25,36,61,119,87,206,0.000333,0.407244,24,29321.5654,1628.975855,1221.731892,302.213705,14,2
0,0,19,19,14,44,58,102,99,201,0.000333,0.392485,14,16484.35852,915.797696,1177.45418,293.51796,11,2
0,0,24,24,19,28,47,125,85,210,0.000333,0.388821,27,31494.51879,1749.695488,1166.463659,215.316561,4,2
0,0,21,21,20,29,49,105,72,177,0.000333,0.331268,20,19876.07285,1104.226269,993.803642,227.320011,5,2
0,0,14,14,23,39,62,92,76,168,0.000333,0.333435,11,11003.35478,611.297488,1000.30498,310.172612,3,2
0,0,23,23,25,48,73,113,91,204,0.000333,0.420908,12,15152.69052,841.81614,1262.72421,384.174605,3,2
0,0,21,21,25,48,73,112,95,207,0.000333,0.427098,12,15375.5242,854.195789,1281.293684,384.174605,3,2
0,0,9,9,16,23,39,46,35,81,0.000333,0.142706,8,3424.940638,190.27448,428.11758,168.041925,3,2
0,0,22,22,20,42,62,109,86,195,0.000333,0.387023,20,23221.36561,1290.075867,1161.068281,312.915894,3,2
0,0,11,11,21,23,44,58,52,110,0.000333,0.200179,20,12010.74956,667.263865,600.537478,196.280591,3,2
0,0,13,13,14,32,46,69,66,135,0.000333,0.24856,14,10439.5321,579.974005,745.680864,213.302969,1,2
0,0,18,18,17,32,49,59,52,111,0.000333,0.207744,8,4985.862342,276.992352,623.232793,229.486868,2,2
0,0,14,14,17,26,43,57,41,98,0.000333,0.177258,8,4254.191568,236.343976,531.773946,191.698301,10,2
0,0,14,14,19,38,57,72,65,137,0.000333,0.266369,9,7191.953387,399.552966,799.105932,280.131868,1,2
0,0,17,17,17,33,50,58,52,110,0.000333,0.206941,8,4966.593447,275.921858,620.824181,235.951874,3,2
0,0,16,16,19,30,49,55,48,103,0.000333,0.192772,9,5204.836025,289.157557,578.315114,227.917341,3,2
0,0,16,16,16,32,48,75,60,135,0.000333,0.251323,8,6031.759501,335.09775,753.969938,224,9,2
0,0,14,14,19,38,57,72,65,137,0.000333,0.266369,9,7191.953387,399.552966,799.105932,280.131868,1,2
0,0,18,18,17,32,49,59,52,111,0.000333,0.207744,8,4985.862342,276.992352,623.232793,229.486868,2,2
0,0,21,21,23,24,47,97,71,168,0.000333,0.311057,22,20529.7604,1140.542244,933.170927,214.081025,7,2
0,0,24,24,30,39,69,146,97,243,0.000333,0.49479,30,44531.14329,2473.952405,1484.371443,353.337404,8,2
0,0,39,39,32,68,100,258,178,436,0.000333,0.965574,32,92695.08156,5149.726753,2896.721299,573.947473,19,2
0,0,29,29,27,46,73,160,113,273,0.000333,0.563274,26,43935.37472,2440.854151,1689.822105,382.465813,10,2
0,0,28,28,30,49,79,183,134,317,0.000333,0.666099,30,59948.95492,3330.497495,1998.298497,422.3275,10,2
0,0,31,31,30,68,98,228,145,373,0.000333,0.822429,30,74018.60316,4112.14462,2467.286772,561.154191,11,2
0,0,22,22,23,34,57,112,81,193,0.000333,0.375249,22,24766.451,1375.913944,1125.747773,277.015662,14,2
0,0,16,16,14,43,57,98,93,191,0.000333,0.371361,14,15597.1479,866.508217,1114.081993,286.632353,11,2
0,0,15,15,19,23,42,90,61,151,0.000333,0.271413,18,14656.31876,814.239931,814.239931,184.752548,5,2
0,0,22,22,17,27,44,121,79,200,0.000333,0.363962,16,17470.18118,970.565621,1091.886324,197.868831,4,2
0,0,19,19,18,27,45,99,65,164,0.000333,0.300221,18,16211.95034,900.663908,900.663908,203.440613,5,2
0,0,14,14,23,39,62,84,74,158,0.000333,0.313588,11,10348.39319,574.910733,940.763017,310.172612,3,2
0,0,22,22,25,47,72,105,87,192,0.000333,0.394875,12,14215.5072,789.7504,1184.6256,377.162081,3,2
0,0,20,20,25,47,72,105,90,195,0.000333,0.401045,12,14437.6245,802.09025,1203.135375,377.162081,3,2
0,0,8,8,16,22,38,40,32,72,0.000333,0.12595,8,3022.806248,167.93368,377.850781,162.107496,3,2
0,0,21,21,20,41,61,100,84,184,0.000333,0.363752,20,21825.1134,1212.5063,1091.25567,306.098194,3,2
0,0,10,10,20,22,42,51,47,98,0.000333,0.176149,20,10568.94215,587.163453,528.447107,184.546058,3,2
0,0,12,12,14,31,45,60,59,119,0.000333,0.217844,7,4574.713629,254.150757,653.530518,206.883055,1,2
0,0,17,17,17,31,48,54,49,103,0.000333,0.19175,8,4602.009101,255.667172,575.251138,223.066954,2,2
0,0,13,13,17,25,42,51,38,89,0.000333,0.159972,8,3839.330005,213.296111,479.916251,185.583273,10,2
0,0,13,13,19,37,56,65,60,125,0.000333,0.241973,9,6533.274287,362.959683,725.919365,273.460397,1,2
0,0,16,16,17,32,49,53,49,102,0.000333,0.1909,8,4581.603233,254.533513,572.700404,229.486868,3,2
0,0,15,15,19,29,48,50,45,95,0.000333,0.176857,9,4775.142938,265.285719,530.571438,221.592072,3,2
0,0,15,15,16,31,47,67,55,122,0.000333,0.225887,8,5421.278719,301.182151,677.65984,217.580086,9,2
0,0,13,13,19,37,56,65,60,125,0.000333,0.241973,9,6533.274287,362.959683,725.919365,273.460397,1,2
0,0,17,17,17,31,48,54,49,103,0.000333,0.19175,8,4602.009101,255.667172,575.251138,223.066954,2,2
0,0,20,20,23,23,46,90,65,155,0.000333,0.285384,22,18835.34627,1046.408126,856.152103,208.08385,7,2
0,0,23,23,30,38,68,135,90,225,0.000333,0.45656,30,41090.37418,2282.798565,1369.679139,346.627963,8,2
0,0,38,38,32,67,99,249,172,421,0.000333,0.93032,32,89310.69239,4961.705133,2790.959137,566.427976,19,2
0,0,28,28,27,45,72,151,107,258,0.000333,0.530614,26,41387.85691,2299.325384,1591.84065,375.515352,10,2
0,0,27,27,30,48,78,175,130,305,0.000333,0.639016,30,57511.4303,3195.079461,1917.047677,415.284918,10,2
0,0,30,30,30,67,97,220,141,361,0.000333,0.79419,30,71477.05608,3970.94756,2382.568536,553.634694,11,2
0,0,21,21,23,33,56,106,77,183,0.000333,0.354249,22,23380.41092,1298.911718,1062.745951,270.506931,14,2
0,0,15,15,14,41,55,91,89,180,0.000333,0.346882,14,14569.02648,809.39036,1040.644748,272.962601,11,2
0,0,14,14,19,22,41,78,56,134,0.000333,0.239304,18,12922.41544,717.911969,717.911969,178.818118,5,2
0,0,21,21,17,26,43,114,74,188,0.000333,0.340046,16,16322.20438,906.789132,1020.137774,191.698301,4,2
0,0,18,18,18,26,44,92,61,153,0.000333,0.278431,18,15035.27468,835.293038,835.293038,197.270083,5,2
0,0,10,10,15,24,39,45,37,82,0.000333,0.144468,7,3033.820874,168.545604,433.402982,168.642459,2,2
0,0,7,7,15,26,41,39,34,73,0.000333,0.130367,7,2737.709074,152.094949,391.101296,180.814792,2,2
0,0,13,13,22,39,61,74,62,136,0.000333,0.26886,11,8872.383057,492.91017,806.580278,304.238182,3,2
0,0,21,21,25,47,72,100,84,184,0.000333,0.378422,12,13623.1944,756.844134,1135.2662,377.162081,3,2
0,0,19,19,25,47,72,100,84,184,0.000333,0.378422,12,13623.1944,756.844134,1135.2662,377.162081,3,2
0,0,13,13,15,26,41,44,38,82,0.000333,0.14644,7,3075.234851,170.846381,439.319264,180.814792,2,2
0,0,7,7,16,22,38,41,32,73,0.000333,0.1277,8,3064.789668,170.266093,383.098708,162.107496,3,2
0,0,10,10,17,24,41,51,40,91,0.000333,0.162512,8,3900.297859,216.683214,487.537232,179.525968,5,2
0,0,20,20,20,41,61,92,77,169,0.000333,0.334098,10,10022.9461,556.830339,1002.29461,306.098194,3,2
0,0,9,9,20,22,42,46,40,86,0.000333,0.15458,10,4637.392984,257.632944,463.739298,184.546058,3,2
0,0,11,11,13,31,44,50,48,98,0.000333,0.178341,6,3210.145792,178.341433,535.024299,201.685802,1,2
0,0,16,16,16,31,47,57,49,106,0.000333,0.196262,8,4710.291346,261.682853,588.786418,217.580086,2,2
0,0,13,13,15,26,41,44,38,82,0.000333,0.14644,7,3075.234851,170.846381,439.319264,180.814792,2,2
0,0,12,12,16,25,41,51,38,89,0.000333,0.158941,8,3814.577027,211.920946,476.822128,180.096405,10,2
0,0,9,9,15,23,38,37,32,69,0.000333,0.120702,7,2534.748989,140.819388,362.106998,162.645284,3,2
0,0,14,14,16,28,44,49,40,89,0.000333,0.161963,8,3887.115312,215.950851,485.889414,198.605938,2,2
0,0,12,12,15,24,39,43,36,79,0.000333,0.139182,7,2922.827427,162.379302,417.546775,168.642459,2,2
0,0,12,12,18,37,55,61,55,116,0.000333,0.223546,9,6035.739541,335.318863,670.637727,267.808425,1,2
0,0,15,15,16,32,48,55,49,104,0.000333,0.193612,8,4646.688801,258.149378,580.8361,224,3,2
0,0,14,14,18,29,47,53,45,98,0.000333,0.18145,9,4899.147367,272.174854,544.349707,215.940099,3,2
0,0,14,14,16,28,44,49,40,89,0.000333,0.161963,8,3887.115312,215.950851,485.889414,198.605938,2,2
0,0,14,14,15,31,46,61,48,109,0.000333,0.200689,7,4214.477772,234.137654,602.068253,212.183445,11,2
0,0,12,12,18,37,55,60,54,114,0.000333,0.219692,9,5931.675066,329.537504,659.075007,267.808425,1,2
0,0,16,16,16,31,47,57,49,106,0.000333,0.196262,8,4710.291346,261.682853,588.786418,217.580086,2,2
0,0,6,6,13,15,28,36,27,63,0.000333,0.100954,6,1817.180161,100.954453,302.86336,106.709075,6,2
0,0,6,6,12,16,28,38,29,67,0.000333,0.107364,6,1932.556679,107.36426,322.09278,107.01955,7,2
0,0,19,19,23,24,47,88,62,150,0.000333,0.277729,22,18330.14321,1018.341289,833.188328,214.081025,7,2
0,0,22,22,29,38,67,123,79,202,0.000333,0.40845,28,34309.80046,1906.100026,1225.350016,340.302694,8,2
0,0,37,37,31,67,98,239,162,401,0.000333,0.884166,30,79574.95943,4420.831079,2652.498647,560.008061,20,2
0,0,27,27,26,45,71,143,98,241,0.000333,0.49403,26,38534.31545,2140.795303,1482.089056,369.344822,10,2
0,0,26,26,29,48,77,166,125,291,0.000333,0.607878,28,51061.77673,2836.765374,1823.634883,408.959649,10,2
0,0,24,24,26,56,82,186,111,297,0.000333,0.629398,13,24546.50829,1363.694905,1888.192945,447.423308,10,2
0,0,29,29,30,67,97,215,136,351,0.000333,0.77219,30,69497.08223,3860.949013,2316.569408,553.634694,11,2
0,0,19,19,23,33,56,100,74,174,0.000333,0.336827,22,22230.55464,1235.030813,1010.479756,270.506931,13,2
0,0,15,15,13,41,54,86,84,170,0.000333,0.32611,12,11739.9705,652.220584,978.330875,267.765349,11,2
0,0,13,13,18,23,41,65,48,113,0.000333,0.201801,18,10897.26078,605.403377,605.403377,179.100575,5,2
0,0,20,20,16,26,42,111,69,180,0.000333,0.323539,16,15529.87418,862.770788,970.617136,186.211433,4,2
0,0,17,17,18,26,44,89,57,146,0.000333,0.265692,18,14347.38629,797.077016,797.077016,197.270083,5,2
0,0,17,17,23,42,65,91,83,174,0.000333,0.349297,11,11526.81199,640.378444,1047.891999,330.519257,3,2
0,0,23,23,25,50,75,112,99,211,0.000333,0.438094,12,15771.36892,876.187162,1314.280744,398.289214,3,2
0,0,24,24,20,44,64,107,91,198,0.000333,0.396,20,23760,1320,1188,326.653553,3,2
0,0,13,13,20,25,45,58,56,114,0.000333,0.20869,20,12521.42506,695.634726,626.071253,202.534967,3,2
0,0,15,15,15,34,49,67,68,135,0.000333,0.252662,14,10611.80161,589.544534,757.985829,231.577096,1,2
0,0,16,16,19,40,59,72,69,141,0.000333,0.276484,9,7465.07403,414.726335,829.45267,293.587747,1,2
0,0,18,18,16,34,50,74,64,138,0.000333,0.259617,8,6230.817234,346.156513,778.852154,236.973737,9,2
0,0,16,16,19,40,59,72,69,141,0.000333,0.276484,9,7465.07403,414.726335,829.45267,293.587747,1,2
0,0,23,23,24,26,50,97,74,171,0.000333,0.3217,24,23162.3858,1286.799211,965.099408,232.250533,7,2
0,0,26,26,30,41,71,140,97,237,0.000333,0.48583,30,43724.70202,2429.150112,1457.490067,366.86635,8,2
0,0,41,41,32,70,102,256,181,437,0.000333,0.97195,32,93307.19598,5183.73311,2915.849874,589.049811,19,2
0,0,31,31,27,48,75,158,116,274,0.000333,0.568899,26,44374.10435,2465.22802,1706.696321,396.460163,10,2
0,0,30,30,30,51,81,183,139,322,0.000333,0.680477,30,61242.95103,3402.386168,2041.431701,436.50041,10,2
0,0,33,33,30,70,100,228,150,378,0.000333,0.837126,30,75341.32919,4185.6294,2511.37764,576.256529,11,2
0,0,24,24,24,36,60,114,86,200,0.000333,0.393793,24,28353.07486,1575.170825,1181.378119,296.1564,14,2
0,0,18,18,14,44,58,98,98,196,0.000333,0.382721,14,16074.29985,893.016658,1148.164275,293.51796,11,2
0,0,24,24,18,29,47,121,83,204,0.000333,0.377712,18,20396.45026,1133.136126,1133.136126,215.940099,4,2
0,0,21,21,19,29,48,99,70,169,0.000333,0.31462,18,16989.45593,943.858663,943.858663,221.592072,5,2
0,0,17,17,23,43,66,91,83,174,0.000333,0.350575,11,11568.97034,642.720575,1051.724577,337.371309,3,2
0,0,23,23,25,51,76,112,99,211,0.000333,0.439438,12,15819.75246,878.875137,1318.312705,405.390097,3,2
0,0,24,24,20,45,65,107,91,198,0.000333,0.397476,20,23848.57654,1324.920919,1192.428827,333.571951,3,2
0,0,13,13,20,26,46,58,56,114,0.000333,0.209895,20,12593.72126,699.651181,629.686063,208.649995,3,2
0,0,15,15,15,35,50,67,68,135,0.000333,0.253974,7,5333.444099,296.30245,761.920586,238.128265,1,2
0,0,16,16,19,41,60,72,69,141,0.000333,0.277624,9,7495.844166,416.435787,832.871574,300.370255,1,2
0,0,18,18,16,35,51,74,64,138,0.000333,0.260932,8,6262.357578,347.908754,782.794697,243.524906,9,2
0,0,16,16,19,41,60,72,69,141,0.000333,0.277624,9,7495.844166,416.435787,832.871574,300.370255,1,2
0,0,23,23,24,27,51,97,74,171,0.000333,0.323328,24,23279.6336,1293.312978,969.984733,238.421063,7,2
0,0,26,26,30,42,72,140,97,237,0.000333,0.487424,30,43868.16676,2437.120376,1462.272225,373.68405,8,2
0,0,41,41,32,71,103,256,181,437,0.000333,0.974,32,93504.02337,5194.667965,2922.00073,596.632045,19,2
0,0,31,31,27,49,76,158,116,274,0.000333,0.570644,26,44510.23561,2472.790867,1711.932139,403.502745,10,2
0,0,30,30,30,52,82,183,139,322,0.000333,0.682377,30,61413.95237,3411.886242,2047.131745,443.629583,10,2
0,0,33,33,30,71,101,228,150,378,0.000333,0.838935,30,75504.11821,4194.673234,2516.80394,583.838763,11,2
0,0,24,24,24,37,61,114,86,200,0.000333,0.395382,24,28467.53922,1581.529957,1186.147468,302.788875,14,2
0,0,18,18,14,44,58,98,98,196,0.000333,0.382721,14,16074.29985,893.016658,1148.164275,293.51796,11,2
0,0,24,24,18,30,48,121,83,204,0.000333,0.379777,18,20507.9823,1139.33235,1139.33235,222.265368,4,2
0,0,21,21,19,30,49,99,70,169,0.000333,0.316295,18,17079.94735,948.885964,948.885964,227.917341,5,2
0,0,11,11,22,38,60,69,57,126,0.000333,0.248089,11,8186.950366,454.830576,744.268215,297.528741,3,2
0,0,19,19,25,46,71,95,79,174,0.000333,0.356685,12,12840.67199,713.370666,1070.055999,370.180255,3,2
0,0,17,17,25,46,71,95,79,174,0.000333,0.356685,12,12840.67199,713.370666,1070.055999,370.180255,3,2
0,0,5,5,16,21,37,35,26,61,0.000333,0.105926,8,2542.213242,141.234069,317.776655,156.238666,3,2
0,0,18,18,20,40,60,86,72,158,0.000333,0.311096,10,9332.887141,518.49373,933.288714,299.315686,3,2
0,0,7,7,19,21,40,41,35,76,0.000333,0.134822,9,3640.198817,202.233268,404.466535,172.949289,3,2
0,0,9,9,13,30,43,45,43,88,0.000333,0.15917,6,2865.06779,159.170433,477.511298,195.312434,1,2
0,0,14,14,15,30,45,51,43,94,0.000333,0.172078,7,3613.639337,200.757741,516.234191,205.810077,2,2
0,0,10,10,18,36,54,55,49,104,0.000333,0.199503,9,5386.574702,299.25415,598.5083,261.17595,1,2
0,0,13,13,15,31,46,49,43,92,0.000333,0.169389,7,3557.1739,197.620772,508.1677,212.183445,3,2
0,0,12,12,17,28,45,47,39,86,0.000333,0.157433,8,3778.39493,209.910829,472.299366,204.092806,3,2
0,0,10,10,18,36,54,55,49,104,0.000333,0.199503,9,5386.574702,299.25415,598.5083,261.17595,1,2
0,0,14,14,15,30,45,51,43,94,0.000333,0.172078,7,3613.639337,200.757741,516.234191,205.810077,2,2
0,0,20,20,29,37,66,118,74,192,0.000333,0.386841,28,32494.66279,1805.259044,1160.523671,333.631223,8,2
0,0,35,35,31,66,97,234,157,391,0.000333,0.860189,30,77416.97764,4300.943202,2580.565921,552.510097,19,2
0,0,25,25,26,44,70,136,92,228,0.000333,0.465826,26,36334.38972,2018.577207,1397.476528,362.426424,10,2
0,0,24,24,29,47,76,161,120,281,0.000333,0.585223,28,49158.69368,2731.038538,1755.667631,401.947125,10,2
0,0,22,22,26,55,81,179,106,285,0.000333,0.602286,13,23489.14426,1304.952459,1806.857251,440.186217,10,2
0,0,27,27,30,66,96,208,131,339,0.000333,0.744101,15,33484.53432,1860.251906,2232.302288,546.13673,11,2
0,0,17,17,23,32,55,95,68,163,0.000333,0.314121,22,20731.95593,1151.77533,942.361633,264.041925,13,2
0,0,13,13,13,40,53,80,79,159,0.000333,0.30358,6,5464.436114,303.579784,910.739352,260.98284,11,2
0,0,18,18,16,25,41,104,64,168,0.000333,0.300023,16,14401.09979,800.061099,900.068737,180.096405,4,2
0,0,13,13,13,28,41,53,52,105,0.000333,0.187514,6,3375.257763,187.51432,562.54296,182.711654,1,2
0,0,12,12,13,14,27,47,26,73,0.000333,0.115702,6,2082.640726,115.702263,347.106788,101.408685,6,2
0,0,12,12,13,14,27,47,26,73,0.000333,0.115702,6,2082.640726,115.702263,347.106788,101.408685,6,2
0,0,9,9,9,11,20,21,21,42,0.000333,0.060507,4,726.08392,40.337996,181.52098,66.583073,2,2
0,0,18,18,15,22,37,55,51,106,0.000333,0.184067,14,7730.828795,429.490489,552.202057,156.710855,7,2
0,0,7,7,10,15,25,28,31,59,0.000333,0.091329,10,2739.875152,152.215286,273.987515,91.82264,1,2
0,0,13,13,10,30,40,57,68,125,0.000333,0.221747,10,6652.410119,369.57834,665.241012,180.425999,2,2
0,0,22,22,19,50,69,104,110,214,0.000333,0.435741,18,23530.03621,1307.224234,1307.224234,362.903432,2,2
0,0,22,22,21,34,55,112,89,201,0.000333,0.387351,20,23241.06605,1291.170336,1162.053302,265.212402,16,2
0,0,12,12,10,28,38,54,57,111,0.000333,0.194173,10,5825.19954,323.622197,582.519954,167.825219,1,2
0,0,12,12,10,28,38,54,57,111,0.000333,0.194173,10,5825.19954,323.622197,582.519954,167.825219,1,2
0,0,18,18,11,40,51,75,87,162,0.000333,0.306311,10,9189.329054,510.518281,918.932905,250.930872,1,2
0,0,34,34,16,62,78,181,191,372,0.000333,0.77939,24,56116.07101,3117.559501,2338.169625,433.160171,1,2
0,0,25,25,16,56,72,120,125,245,0.000333,0.503877,16,24186.10601,1343.672556,1511.631625,389.211876,1,2
0,0,25,25,24,37,61,144,99,243,0.000333,0.48039,24,34588.06015,1921.558897,1441.169173,302.788875,6,2
0,0,26,26,23,38,61,150,102,252,0.000333,0.498182,22,32880.0078,1826.6671,1494.545809,303.463171,6,2
0,0,24,24,21,39,60,141,98,239,0.000333,0.470582,20,28234.93705,1568.607614,1411.746852,298.369352,6,2
0,0,23,23,21,37,58,134,94,228,0.000333,0.445207,20,26712.39334,1484.021852,1335.619667,284.98844,6,2
0,0,22,22,21,37,58,130,90,220,0.000333,0.429585,20,25775.11638,1431.95091,1288.755819,284.98844,6,2
0,0,21,21,21,36,57,128,88,216,0.000333,0.419968,20,25198.08486,1399.893603,1259.904243,278.355966,6,2
0,0,27,27,22,41,63,148,105,253,0.000333,0.504084,22,33269.54005,1848.307781,1512.251821,317.767128,6,2
0,0,24,24,22,40,62,136,97,233,0.000333,0.462443,22,30521.21029,1695.622794,1387.32774,310.984619,6,2
0,0,27,27,23,41,64,143,105,248,0.000333,0.496,22,32736,1818.666667,1488,323.701557,6,2
0,0,49,49,31,40,71,245,168,413,0.000333,0.846615,60,152390.7336,8466.151868,2539.84556,366.457209,19,2
0,0,50,50,31,40,71,251,171,422,0.000333,0.865064,60,155711.5971,8650.644281,2595.193284,366.457209,19,2
0,0,48,48,30,41,71,242,167,409,0.000333,0.838416,60,150914.7943,8384.15524,2515.246572,366.86635,19,2
0,0,47,47,30,39,69,235,163,398,0.000333,0.810398,60,145871.564,8103.975779,2431.192734,353.337404,19,2
0,0,46,46,30,39,69,229,157,386,0.000333,0.785963,60,141473.4264,7859.634801,2357.89044,353.337404,19,2
0,0,45,45,30,38,68,229,157,386,0.000333,0.783254,60,140985.6394,7832.535522,2349.760657,346.627963,19,2
0,0,51,51,30,42,72,252,175,427,0.000333,0.878186,60,158073.4785,8781.859919,2634.557976,373.68405,19,2
0,0,48,48,30,42,72,237,166,403,0.000333,0.828827,45,111891.5899,6216.199439,2486.479776,373.68405,19,2
0,0,51,51,30,43,73,244,174,418,0.000333,0.862449,60,155240.7999,8624.488885,2587.346666,380.536102,19,2
0,0,24,24,28,36,64,127,87,214,0.000333,0.428,28,35952,1997.333333,1284,320.723238,5,2
0,0,25,25,28,37,65,133,90,223,0.000333,0.447663,28,37603.66463,2089.092479,1342.988022,327.355712,5,2
0,0,24,24,26,39,65,129,89,218,0.000333,0.437625,26,34134.78076,1896.376709,1312.876183,328.342119,5,2
0,0,25,25,26,39,65,130,92,222,0.000333,0.445655,26,34761.10702,1931.172612,1336.965654,328.342119,5,2
0,0,19,19,26,33,59,113,80,193,0.000333,0.37845,26,29519.10282,1639.950157,1135.350109,288.676439,5,2
0,0,20,20,26,34,60,111,76,187,0.000333,0.368196,26,28719.30208,1595.516782,1104.588541,295.185169,5,2
0,0,26,26,27,39,66,135,94,229,0.000333,0.461389,26,35988.32259,1999.351255,1384.166253,334.512649,5,2
0,0,23,23,26,39,65,119,85,204,0.000333,0.409521,26,31942.63888,1774.591049,1228.563034,328.342119,5,2
0,0,26,26,27,40,67,127,93,220,0.000333,0.444847,26,34698.03017,1927.668343,1334.539622,341.259086,5,2
0,0,20,20,20,25,45,84,62,146,0.000333,0.26727,20,16036.21104,890.900613,801.810552,202.534967,4,2
0,0,21,21,19,26,45,90,65,155,0.000333,0.283746,18,15322.27014,851.23723,851.23723,202.922055,4,2
0,0,19,19,18,26,44,78,60,138,0.000333,0.251134,18,13561.22814,753.401563,753.401563,197.270083,4,2
0,0,18,18,18,26,44,74,57,131,0.000333,0.238395,18,12873.33976,715.185542,715.185542,197.270083,4,2
0,0,17,17,18,24,42,70,53,123,0.000333,0.221085,18,11938.59077,663.255043,663.255043,185.09775,4,2
0,0,16,16,18,23,41,68,51,119,0.000333,0.212516,18,11475.87639,637.548689,637.548689,179.100575,4,2
0,0,22,22,18,28,46,91,69,160,0.000333,0.29459,18,15907.85843,883.769913,883.769913,209.664588,4,2
0,0,19,19,18,28,46,76,60,136,0.000333,0.250401,18,13521.67967,751.204426,751.204426,209.664588,4,2
0,0,22,22,18,28,46,84,68,152,0.000333,0.27986,18,15112.46551,839.581417,839.581417,209.664588,4,2
0,0,29,29,21,47,68,142,95,237,0.000333,0.48091,20,28854.57387,1603.031882,1442.728693,353.304342,14,2
0,0,30,30,20,48,68,148,98,246,0.000333,0.499172,20,29950.31718,1663.90651,1497.515859,354.516762,14,2
0,0,28,28,19,49,68,139,94,233,0.000333,0.472793,9,12765.40958,709.189421,1418.378842,355.831405,14,2
0,0,27,27,19,47,66,132,90,222,0.000333,0.447285,9,12076.69945,670.927747,1341.855494,341.776299,14,2
0,0,26,26,19,47,66,124,82,206,0.000333,0.415048,9,11206.3067,622.572594,1245.145189,341.776299,12,2
0,0,25,25,19,46,65,126,84,210,0.000333,0.421566,9,11382.27517,632.34862,1264.697241,334.794473,14,2
0,0,31,31,21,51,72,150,102,252,0.000333,0.518274,20,31096.42201,1727.579,1554.8211,381.532358,14,2
0,0,28,28,19,50,69,134,93,227,0.000333,0.462212,9,12479.71547,693.317526,1386.635052,362.903432,14,2
0,0,31,31,19,51,70,142,101,243,0.000333,0.496472,9,13404.74196,744.707887,1489.415773,370.004315,14,2
0,0,37,37,25,44,69,199,143,342,0.000333,0.696372,36,75208.15311,4178.230728,2089.115364,356.311396,7,2
0,0,38,38,24,45,69,205,146,351,0.000333,0.714697,36,77187.31504,4288.184169,2144.092084,357.172489,7,2
0,0,36,36,23,46,69,196,142,338,0.000333,0.688227,33,68134.48179,3785.248988,2064.681266,358.125775,7,2
0,0,35,35,23,44,67,189,138,327,0.000333,0.661204,33,65459.16845,3636.62047,1983.611165,344.256916,7,2
0,0,34,34,23,44,67,183,134,317,0.000333,0.640983,33,63457.35902,3525.408835,1922.950273,344.256916,7,2
0,0,33,33,23,43,66,183,132,315,0.000333,0.634661,33,62831.47687,3490.637604,1903.984148,337.371309,7,2
0,0,39,39,23,48,71,207,150,357,0.000333,0.73182,33,72450.17082,4025.00949,2195.459722,372.120125,7,2
0,0,36,36,24,47,71,191,141,332,0.000333,0.680572,36,73501.77757,4083.432087,2041.716044,371.104776,7,2
0,0,39,39,24,48,72,199,149,348,0.000333,0.715711,36,77296.82042,4294.267801,2147.133901,378.1173,7,2
0,0,8,8,15,14,29,44,30,74,0.000333,0.11983,14,5032.868311,279.603795,359.490594,111.906328,2,2
0,0,9,9,15,15,30,49,33,82,0.000333,0.134122,14,5633.110404,312.950578,402.365029,117.206718,2,2
0,0,7,7,12,16,28,42,29,71,0.000333,0.113774,6,2047.933197,113.774066,341.322199,107.01955,2,2
0,0,7,7,12,16,28,42,29,71,0.000333,0.113774,6,2047.933197,113.774066,341.322199,107.01955,2,2
0,0,10,10,13,17,30,52,37,89,0.000333,0.145571,12,5240.559156,291.142175,436.713263,117.592585,2,2
0,0,7,7,13,17,30,36,28,64,0.000333,0.10468,6,1884.245989,104.680333,314.040998,117.592585,2,2
0,0,10,10,14,18,32,44,36,80,0.000333,0.133333,14,5600,311.111111,400,128.361619,2,2
0,0,9,9,16,13,29,37,27,64,0.000333,0.103637,16,4974.572539,276.365141,310.910784,112.105716,2,2
0,0,10,10,15,14,29,43,30,73,0.000333,0.118211,14,4964.856577,275.825365,354.632613,111.906328,2,2
0,0,8,8,14,15,29,35,26,61,0.000333,0.098779,7,2074.357885,115.242105,296.336841,111.906328,2,2
0,0,7,7,14,13,27,27,22,49,0.000333,0.077663,7,1630.926413,90.607023,232.989488,101.408685,2,2
0,0,11,11,14,17,31,45,34,79,0.000333,0.130461,14,5479.341119,304.40784,391.381509,122.789837,2,2
0,0,8,8,15,16,31,29,25,54,0.000333,0.089176,7,1872.686205,104.038123,267.526601,122.603359,2,2
0,0,11,11,15,17,32,37,33,70,0.000333,0.116667,7,2450,136.111111,350,128.090227,2,2
0,0,12,12,19,16,35,70,41,111,0.000333,0.189783,18,10248.30747,569.350415,569.350415,144.710623,2,2
0,0,13,13,19,17,36,76,44,120,0.000333,0.206797,18,11167.038,620.391,620.391,150.197491,2,2
0,0,11,11,17,18,35,68,40,108,0.000333,0.184654,16,8863.401053,492.41117,553.962566,144.545518,2,2
0,0,10,10,17,17,34,60,36,96,0.000333,0.162799,16,7814.342924,434.130162,488.396433,138.973737,2,2
0,0,9,9,16,16,32,47,30,77,0.000333,0.128333,8,3080,171.111111,385,128,2,2
0,0,12,12,17,19,36,70,41,111,0.000333,0.191287,16,9181.786803,510.099267,573.861675,150.197491,2,2
0,0,11,11,17,19,36,62,39,101,0.000333,0.174054,16,8354.598802,464.144378,522.162425,150.197491,2,2
0,0,14,14,17,20,37,70,47,117,0.000333,0.203169,16,9752.0967,541.78315,609.506044,155.92543,2,2
0,0,77,77,35,123,158,404,286,690,0.000333,1.67987,34,171346.6964,9519.260908,5039.608716,1033.45419,26,2
0,0,78,78,35,124,159,410,289,699,0.000333,1.703902,34,173797.9763,9655.443129,5111.705186,1041.845248,26,2
0,0,76,76,33,125,158,402,285,687,0.000333,1.672566,32,160566.316,8920.350887,5017.697374,1037.188042,26,2
0,0,75,75,33,123,156,394,281,675,0.000333,1.639215,32,157364.6879,8742.482663,4917.646498,1020.39429,26,2
0,0,74,74,33,123,156,390,277,667,0.000333,1.619788,32,155499.625,8638.868053,4859.36328,1020.39429,26,2
0,0,73,73,33,122,155,388,275,663,0.000333,1.608023,32,154370.2554,8576.125299,4824.070481,1012.014961,26,2
0,0,79,79,36,127,163,412,293,705,0.000333,1.726951,36,186510.7206,10361.7067,5180.853349,1073.680255,26,2
0,0,76,76,33,126,159,396,284,680,0.000333,1.657587,32,159128.3331,8840.46295,4972.76041,1045.602276,26,2
0,0,79,79,34,127,161,403,292,695,0.000333,1.698329,34,173229.5658,9623.864768,5094.98723,1060.536692,26,2
0,0,14,14,20,28,48,82,58,140,0.000333,0.260632,20,15637.895,868.771945,781.89475,221.0445,3,2
0,0,15,15,21,29,50,88,61,149,0.000333,0.280312,20,16818.69145,934.371747,840.934572,233.120115,3,2
0,0,13,13,18,29,47,80,57,137,0.000333,0.25366,9,6848.808054,380.489336,760.978673,215.940099,3,2
0,0,12,12,18,28,46,72,53,125,0.000333,0.230148,9,6214.007201,345.222622,690.445245,209.664588,3,2
0,0,11,11,18,28,46,67,48,115,0.000333,0.211737,9,5716.886625,317.604812,635.209625,209.664588,3,2
0,0,10,10,18,27,45,66,47,113,0.000333,0.20686,9,5585.214599,310.2897,620.5794,203.440613,3,2
0,0,16,16,21,31,52,90,65,155,0.000333,0.294523,20,17671.36313,981.742396,883.568156,245.818752,3,2
0,0,13,13,18,31,49,74,56,130,0.000333,0.243304,9,6569.210518,364.95614,729.91228,228.638736,3,2
0,0,16,16,19,31,50,82,64,146,0.000333,0.274668,18,14832.05407,824.003004,824.003004,234.290708,3,2
0,0,14,14,24,33,57,91,67,158,0.000333,0.307199,24,22118.31893,1228.795496,921.596622,276.504106,4,2
0,0,15,15,23,34,57,97,70,167,0.000333,0.324698,22,21430.03791,1190.557662,974.092632,277.015662,4,2
0,0,13,13,21,35,56,89,66,155,0.000333,0.300047,10,9001.400129,500.077785,900.140013,271.763571,4,2
0,0,12,12,21,33,54,81,62,143,0.000333,0.274316,10,8229.489128,457.19384,822.948913,258.703672,4,2
0,0,11,11,20,33,53,77,58,135,0.000333,0.257756,10,7732.692614,429.594034,773.269261,252.903568,4,2
0,0,16,16,22,38,60,99,74,173,0.000333,0.340631,11,11240.8128,624.4896,1021.892073,297.528741,4,2
0,0,13,13,21,36,57,83,65,148,0.000333,0.287756,10,8632.677221,479.593179,863.267722,278.355966,4,2
0,0,16,16,22,37,59,91,73,164,0.000333,0.321584,11,10612.28806,589.571559,964.75346,290.85727,4,2
0,0,21,21,24,39,63,113,90,203,0.000333,0.404463,24,29121.30779,1617.850433,1213.387824,316.169787,4,2
0,0,22,22,24,40,64,119,93,212,0.000333,0.424,24,30528,1696,1272,322.916224,4,2
0,0,20,20,22,40,62,110,89,199,0.000333,0.394962,22,26067.47145,1448.192858,1184.885066,310.984619,4,2
0,0,19,19,22,39,61,103,85,188,0.000333,0.37166,22,24529.52963,1362.751646,1114.978619,304.238182,4,2
0,0,18,18,22,39,61,99,81,180,0.000333,0.355844,22,23485.71986,1304.762214,1067.532721,304.238182,4,2
0,0,17,17,22,38,60,97,79,176,0.000333,0.346538,22,22871.48039,1270.637799,1039.612745,297.528741,4,2
0,0,23,23,23,42,65,121,97,218,0.000333,0.437625,22,28883.27603,1604.626446,1312.876183,330.519257,4,2
0,0,20,20,22,42,64,105,88,193,0.000333,0.386,22,25476,1415.333333,1158,324.584827,4,2
0,0,23,23,23,42,65,113,96,209,0.000333,0.419558,22,27690.8472,1538.3804,1258.674873,330.519257,4,2
0,0,26,26,29,54,83,139,108,247,0.000333,0.524878,28,44089.77271,2449.431817,1574.63474,451.645374,5,2
0,0,27,27,28,55,83,145,111,256,0.000333,0.544003,28,45696.28264,2538.682369,1632.010094,452.580722,5,2
0,0,25,25,28,55,83,137,107,244,0.000333,0.518503,14,21777.1347,1209.840817,1555.509621,452.580722,5,2
0,0,24,24,28,54,82,129,103,232,0.000333,0.491651,14,20649.32891,1147.184939,1474.952065,445.369863,5,2
0,0,23,23,28,54,82,125,99,224,0.000333,0.474697,14,19937.28309,1107.626838,1424.091649,445.369863,5,2
0,0,22,22,28,53,81,123,97,220,0.000333,0.464922,14,19526.73801,1084.818778,1394.767001,438.185722,5,2
0,0,29,29,28,57,85,150,118,268,0.000333,0.572572,28,48096.06959,2672.003866,1717.716771,467.080669,5,2
0,0,25,25,28,57,85,131,106,237,0.000333,0.506342,14,21266.35913,1181.464396,1519.025652,467.080669,5,2
0,0,28,28,28,57,85,139,114,253,0.000333,0.540525,28,45404.12539,2522.451411,1621.575907,467.080669,5,2
0,0,12,12,14,19,33,56,44,100,0.000333,0.168146,14,7062.151767,392.341765,504.439412,134.013592,3,2
0,0,13,13,14,20,34,61,47,108,0.000333,0.183149,14,7692.243816,427.346879,549.445987,139.741531,3,2
0,0,11,11,13,20,33,54,43,97,0.000333,0.163102,12,5871.674755,326.204153,489.30623,134.544278,3,2
0,0,10,10,13,19,32,46,39,85,0.000333,0.141667,12,5100,283.333333,425,128.816339,3,2
0,0,9,9,13,20,33,44,36,80,0.000333,0.134517,6,2421.309177,134.517177,403.55153,134.544278,3,2
0,0,8,8,13,18,31,41,33,74,0.000333,0.122204,6,2199.663162,122.203509,366.610527,123.164366,3,2
0,0,14,14,15,22,37,61,51,112,0.000333,0.194486,14,8168.422877,453.801271,583.458777,156.710855,3,2
0,0,11,11,14,22,36,48,42,90,0.000333,0.155098,7,3257.052751,180.947375,465.29325,151.410465,3,2
0,0,13,13,14,22,36,51,46,97,0.000333,0.167161,14,7020.758152,390.04212,501.482725,151.410465,3,2
0,0,13,13,21,23,44,149,109,258,0.000333,0.469511,40,56341.3343,3130.074128,1408.533358,196.280591,6,2
0,0,14,14,20,24,44,153,112,265,0.000333,0.48225,40,57869.97516,3214.99862,1446.749379,196.477662,6,2
0,0,12,12,18,24,42,131,95,226,0.000333,0.406221,27,32903.92091,1827.995606,1218.663738,185.09775,6,2
0,0,11,11,18,24,42,127,92,219,0.000333,0.393639,27,31884.77292,1771.376273,1180.917516,185.09775,6,2
0,0,10,10,17,23,40,116,82,198,0.000333,0.351247,24,25289.80231,1404.989017,1053.741763,173.528793,6,2
0,0,9,9,17,21,38,115,80,195,0.000333,0.341115,24,24560.30076,1364.461153,1023.345865,161.725534,6,2
0,0,15,15,19,27,46,150,111,261,0.000333,0.48055,36,51899.38814,2883.299341,1441.649671,209.092585,6,2
0,0,12,12,18,26,44,129,95,224,0.000333,0.407638,27,33018.64243,1834.369024,1222.912683,197.270083,6,2
0,0,15,15,19,28,47,142,108,250,0.000333,0.462882,27,37493.47475,2082.970819,1388.647213,215.316561,6,2
0,0,9,9,14,14,28,54,47,101,0.000333,0.161848,21,10196.39979,566.466655,485.542847,106.605938,2,2
0,0,10,10,14,15,29,60,50,110,0.000333,0.178126,21,11221.9361,623.440894,534.377909,111.906328,2,2
0,0,8,8,11,16,27,47,42,89,0.000333,0.141062,10,4231.849877,235.102771,423.184988,102.053748,2,2
0,0,7,7,11,14,25,41,38,79,0.000333,0.122288,10,3668.64639,203.813688,366.864639,91.356717,2,2
0,0,6,6,11,14,25,38,34,72,0.000333,0.111453,10,3343.576457,185.754248,334.357646,91.356717,2,2
0,0,5,5,11,12,23,35,30,65,0.000333,0.098011,10,2940.315271,163.350848,294.031527,81.073298,2,2
0,0,11,11,14,18,32,58,52,110,0.000333,0.183333,14,7700,427.777778,550,128.361619,2,2
0,0,8,8,12,17,29,44,41,85,0.000333,0.137643,12,4955.140615,275.28559,412.928385,112.506418,2,2
0,0,10,10,12,17,29,51,49,100,0.000333,0.161933,12,5829.577194,323.8654,485.7981,112.506418,2,2
0,0,13,13,16,13,29,73,42,115,0.000333,0.186223,24,13408.02755,744.890419,558.667814,112.105716,3,2
0,0,14,14,17,15,32,80,45,125,0.000333,0.208333,24,15000,833.333333,625,128.090227,3,2
0,0,12,12,13,15,28,70,41,111,0.000333,0.177872,12,6403.396756,355.744264,533.616396,106.709075,3,2
0,0,11,11,13,13,26,63,37,100,0.000333,0.156681,12,5640.527662,313.362648,470.043972,96.211433,3,2
0,0,10,10,15,14,29,61,35,96,0.000333,0.155455,14,6529.126457,362.729248,466.366176,111.906328,3,2
0,0,9,9,13,12,25,57,31,88,0.000333,0.13622,12,4903.912136,272.439563,408.659345,91.125266,3,2
0,0,14,14,13,17,30,79,48,127,0.000333,0.207725,12,7478.101268,415.45007,623.175106,117.592585,3,2
0,0,12,12,14,17,31,65,40,105,0.000333,0.173397,14,7282.668576,404.592699,520.190613,122.789837,3,2
0,0,14,14,14,17,31,70,47,117,0.000333,0.193214,14,8114.973556,450.831864,579.640968,122.789837,3,2
0,0,19,19,15,28,43,75,71,146,0.000333,0.264078,14,11091.28516,616.182509,792.234654,193.209297,4,2
0,0,20,20,15,30,45,80,74,154,0.000333,0.281915,14,11840.43528,657.80196,845.745377,205.810077,4,2
0,0,18,18,12,30,42,72,70,142,0.000333,0.255236,12,9188.508888,510.472716,765.709074,190.226268,4,2
0,0,17,17,12,29,41,65,66,131,0.000333,0.233946,12,8422.071751,467.892875,701.839313,183.900999,4,2
0,0,16,16,12,27,39,56,57,113,0.000333,0.199083,12,7167.005409,398.166967,597.250451,171.401513,4,2
0,0,15,15,12,27,39,59,60,119,0.000333,0.209654,12,7547.554369,419.308576,628.962864,171.401513,4,2
0,0,21,21,14,33,47,82,79,161,0.000333,0.298096,14,12520.04327,695.55796,894.288805,219.767975,4,2
0,0,18,18,13,31,44,67,69,136,0.000333,0.247494,12,8909.792402,494.988467,742.4827,201.685802,4,2
0,0,21,21,14,32,46,75,77,152,0.000333,0.27986,14,11754.13984,653.007769,839.581417,213.302969,4,2
0,0,8,8,14,23,37,39,31,70,0.000333,0.121554,7,2552.632149,141.812897,364.661736,157.344894,2,2
0,0,5,5,14,25,39,33,28,61,0.000333,0.10747,7,2256.866747,125.381486,322.409535,169.399374,2,2
0,0,11,11,22,38,60,69,57,126,0.000333,0.248089,11,8186.950366,454.830576,744.268215,297.528741,3,2
0,0,19,19,25,46,71,95,79,174,0.000333,0.356685,12,12840.67199,713.370666,1070.055999,370.180255,3,2
0,0,17,17,25,46,71,95,79,174,0.000333,0.356685,12,12840.67199,713.370666,1070.055999,370.180255,3,2
0,0,11,11,14,25,39,38,32,70,0.000333,0.123326,7,2589.847087,143.880394,369.978155,169.399374,2,2
0,0,5,5,16,21,37,35,26,61,0.000333,0.105926,8,2542.213242,141.234069,317.776655,156.238666,3,2
0,0,8,8,16,23,39,45,34,79,0.000333,0.139182,8,3340.374202,185.576345,417.546775,168.041925,5,2
0,0,18,18,20,40,60,86,72,158,0.000333,0.311096,10,9332.887141,518.49373,933.288714,299.315686,3,2
0,0,7,7,19,21,40,41,35,76,0.000333,0.134822,9,3640.198817,202.233268,404.466535,172.949289,3,2
0,0,9,9,13,30,43,45,43,88,0.000333,0.15917,6,2865.06779,159.170433,477.511298,195.312434,1,2
0,0,14,14,15,30,45,51,43,94,0.000333,0.172078,7,3613.639337,200.757741,516.234191,205.810077,2,2
0,0,11,11,14,25,39,38,32,70,0.000333,0.123326,7,2589.847087,143.880394,369.978155,169.399374,2,2
0,0,10,10,16,24,40,45,32,77,0.000333,0.136596,8,3278.307706,182.128206,409.788463,174.0391,10,2
0,0,7,7,15,22,37,31,26,57,0.000333,0.09898,7,2078.571893,115.476216,296.938842,156.710855,3,2
0,0,12,12,15,27,42,43,34,77,0.000333,0.138403,7,2906.459091,161.469949,415.208442,186.985321,2,2
0,0,10,10,14,23,37,37,30,67,0.000333,0.116344,7,2443.233628,135.735202,349.033375,157.344894,2,2
0,0,10,10,18,36,54,55,49,104,0.000333,0.199503,9,5386.574702,299.25415,598.5083,261.17595,1,2
0,0,13,13,15,31,46,49,43,92,0.000333,0.169389,7,3557.1739,197.620772,508.1677,212.183445,3,2
0,0,12,12,17,28,45,47,39,86,0.000333,0.157433,8,3778.39493,209.910829,472.299366,204.092806,3,2
0,0,12,12,15,27,42,43,34,77,0.000333,0.138403,7,2906.459091,161.469949,415.208442,186.985321,2,2
0,0,12,12,15,30,45,56,43,99,0.000333,0.181231,7,3805.854196,211.436344,543.693457,205.810077,9,2
0,0,10,10,18,36,54,55,49,104,0.000333,0.199503,9,5386.574702,299.25415,598.5083,261.17595,1,2
0,0,14,14,15,30,45,51,43,94,0.000333,0.172078,7,3613.639337,200.757741,516.234191,205.810077,2,2
0,0,4,4,12,14,26,30,21,51,0.000333,0.079907,6,1438.334554,79.907475,239.722426,96.322519,6,2
0,0,4,4,12,15,27,32,23,55,0.000333,0.087173,6,1569.112876,87.172938,261.518813,101.622909,7,2
0,0,17,17,23,22,45,81,54,135,0.000333,0.247133,22,16310.8037,906.155761,741.400168,202.149421,7,2
0,0,20,20,29,37,66,118,74,192,0.000333,0.386841,28,32494.66279,1805.259044,1160.523671,333.631223,8,2
0,0,35,35,31,66,97,234,157,391,0.000333,0.860189,30,77416.97764,4300.943202,2580.565921,552.510097,19,2
0,0,25,25,26,44,70,136,92,228,0.000333,0.465826,26,36334.38972,2018.577207,1397.476528,362.426424,10,2
0,0,24,24,29,47,76,161,120,281,0.000333,0.585223,28,49158.69368,2731.038538,1755.667631,401.947125,10,2
0,0,22,22,26,55,81,179,106,285,0.000333,0.602286,13,23489.14426,1304.952459,1806.857251,440.186217,10,2
0,0,27,27,30,66,96,208,131,339,0.000333,0.744101,15,33484.53432,1860.251906,2232.302288,546.13673,11,2
0,0,17,17,23,32,55,95,68,163,0.000333,0.314121,22,20731.95593,1151.77533,942.361633,264.041925,13,2
0,0,13,13,13,40,53,80,79,159,0.000333,0.30358,6,5464.436114,303.579784,910.739352,260.98284,11,2
0,0,11,11,18,21,39,60,43,103,0.000333,0.181465,18,9799.135714,544.396429,544.396429,167.297316,5,2
0,0,18,18,16,25,41,104,64,168,0.000333,0.300023,16,14401.09979,800.061099,900.068737,180.096405,4,2
0,0,15,15,18,25,43,82,52,134,0.000333,0.242373,18,13088.15059,727.119477,727.119477,191.155055,5,2
0,0,14,14,13,29,42,55,54,109,0.000333,0.195921,6,3526.575594,195.920866,587.762599,188.987165,1,2
0,0,13,13,13,15,28,49,28,77,0.000333,0.123389,6,2220.997974,123.388776,370.166329,106.709075,6,2
0,0,13,13,13,15,28,49,28,77,0.000333,0.123389,6,2220.997974,123.388776,370.166329,106.709075,6,2
0,0,10,10,10,12,22,23,23,46,0.000333,0.068378,5,1025.669272,56.981626,205.133854,76.238831,2,2
0,0,18,18,15,23,38,56,51,107,0.000333,0.187176,14,7861.395415,436.74419,561.528244,162.645284,7,2
0,0,8,8,10,16,26,30,33,63,0.000333,0.098709,10,2961.277022,164.51539,296.127702,97.219281,1,2
0,0,14,14,10,31,41,59,70,129,0.000333,0.230375,10,6911.242086,383.957894,691.124209,186.799367,2,2
0,0,23,23,19,51,70,106,112,218,0.000333,0.445395,18,24051.30656,1336.183698,1336.183698,370.004315,2,2
0,0,23,23,20,35,55,114,91,205,0.000333,0.39506,20,23703.57483,1316.865268,1185.178741,265.963467,16,2
0,0,13,13,10,29,39,56,59,115,0.000333,0.202607,10,6078.212552,337.678475,607.821255,174.10073,1,2
0,0,13,13,10,29,39,56,59,115,0.000333,0.202607,10,6078.212552,337.678475,607.821255,174.10073,1,2
0,0,19,19,11,41,52,77,89,166,0.000333,0.315424,10,9462.729932,525.707218,946.272993,257.71338,1,2
0,0,35,35,16,63,79,183,193,376,0.000333,0.790074,24,56885.31747,3160.295415,2370.221561,440.568635,1,2
0,0,26,26,16,57,73,122,127,249,0.000333,0.513755,16,24660.26104,1370.014502,1541.266315,396.474731,1,2
0,0,18,18,16,30,46,70,69,139,0.000333,0.255925,16,12284.40179,682.466766,767.775112,211.206718,1,2
0,0,16,16,15,15,30,67,41,108,0.000333,0.176648,14,7419.218581,412.17881,529.944184,117.206718,6,2
0,0,16,16,15,15,30,67,41,108,0.000333,0.176648,14,7419.218581,412.17881,529.944184,117.206718,6,2
0,0,13,13,12,14,26,43,38,81,0.000333,0.126912,12,4568.827406,253.823745,380.735617,96.322519,2,2
0,0,21,21,18,26,44,75,62,137,0.000333,0.249314,18,13462.95837,747.942132,747.942132,197.270083,7,2
0,0,10,10,13,17,30,44,41,85,0.000333,0.139029,12,5005.028408,278.057134,417.085701,117.592585,1,2
0,0,16,16,12,32,44,73,78,151,0.000333,0.274791,12,9892.490093,549.582783,824.374174,203.01955,2,2
0,0,25,25,20,51,71,117,119,236,0.000333,0.48378,20,29026.8064,1612.600356,1451.34032,375.732254,2,2
0,0,24,24,23,37,60,128,100,228,0.000333,0.448924,22,29628.96323,1646.053513,1346.771056,296.7917,16,2
0,0,15,15,12,29,41,70,67,137,0.000333,0.244662,12,8807.815496,489.323083,733.984625,183.900999,1,2
0,0,15,15,12,29,41,70,67,137,0.000333,0.244662,12,8807.815496,489.323083,733.984625,183.900999,1,2
0,0,21,21,12,41,53,91,97,188,0.000333,0.35895,12,12922.18855,717.899364,1076.849045,262.679182,1,2
0,0,37,37,17,63,80,197,201,398,0.000333,0.838709,24,60387.05716,3354.836509,2516.127382,446.055503,1,2
0,0,28,28,17,57,74,136,135,271,0.000333,0.560921,16,26924.18979,1495.788322,1682.761862,401.961599,1,2
0,0,20,20,15,32,47,71,74,145,0.000333,0.268472,14,11275.81537,626.434187,805.415383,218.603359,1,2
0,0,19,19,15,18,33,73,50,123,0.000333,0.20682,14,8686.446674,482.580371,620.460477,133.662009,6,2
0,0,19,19,15,18,33,73,50,123,0.000333,0.20682,14,8686.446674,482.580371,620.460477,133.662009,6,2
0,0,16,16,12,17,29,42,47,89,0.000333,0.14412,12,5188.323703,288.240206,432.360309,112.506418,2,2
0,0,23,23,17,28,45,75,71,146,0.000333,0.26727,16,12828.96883,712.720491,801.810552,204.092806,7,2
0,0,13,13,12,20,32,45,50,95,0.000333,0.158333,12,5700,316.666667,475,129.458112,1,2
0,0,19,19,12,35,47,74,87,161,0.000333,0.298096,12,10731.46566,596.192537,894.288805,222.544456,2,2
0,0,27,27,20,54,74,120,125,245,0.000333,0.507105,20,30426.32149,1690.351194,1521.316075,397.202487,2,2
0,0,27,27,22,40,62,132,109,241,0.000333,0.47832,22,31569.14884,1753.841602,1434.961311,310.984619,16,2
0,0,18,18,11,32,43,71,76,147,0.000333,0.265887,10,7976.609189,443.144955,797.660919,198.053748,1,2
0,0,18,18,11,32,43,71,76,147,0.000333,0.265887,10,7976.609189,443.144955,797.660919,198.053748,1,2
0,0,24,24,11,44,55,92,106,198,0.000333,0.38157,10,11447.09223,635.949568,1144.709223,278.268739,1,2
0,0,40,40,17,66,83,198,210,408,0.000333,0.867005,24,62424.38611,3468.021451,2601.016088,468.41688,1,2
0,0,31,31,17,60,77,137,144,281,0.000333,0.586989,16,28175.47229,1565.304016,1760.967018,423.900304,1,2
0,0,20,20,15,33,48,72,74,146,0.000333,0.271802,14,11415.66335,634.20352,815.404525,225.068365,1,2
0,0,19,19,15,19,34,73,50,123,0.000333,0.208586,14,8760.611013,486.700612,625.757929,139.313982,6,2
0,0,19,19,15,19,34,73,50,123,0.000333,0.208586,14,8760.611013,486.700612,625.757929,139.313982,6,2
0,0,16,16,12,18,30,42,47,89,0.000333,0.145571,12,5240.559156,291.142175,436.713263,118.0782,2,2
0,0,24,24,17,29,46,73,70,143,0.000333,0.26329,16,12637.90976,702.106098,789.86936,210.368317,7,2
0,0,12,12,12,20,32,43,47,90,0.000333,0.15,12,5400,300,450,129.458112,1,2
0,0,19,19,12,36,48,75,87,162,0.000333,0.301588,12,10857.1671,603.17595,904.763925,229.13685,2,2
0,0,27,27,20,55,75,120,125,245,0.000333,0.508687,20,30521.21158,1695.622866,1526.060579,404.413346,2,2
0,0,27,27,22,41,63,132,109,241,0.000333,0.480175,22,31691.53815,1760.641009,1440.524462,317.767128,16,2
0,0,18,18,11,33,44,71,76,147,0.000333,0.267512,10,8025.364479,445.853582,802.536448,204.518754,1,2
0,0,18,18,11,33,44,71,76,147,0.000333,0.267512,10,8025.364479,445.853582,802.536448,204.518754,1,2
0,0,24,24,11,45,56,92,106,198,0.000333,0.383285,10,11498.56275,638.809041,1149.856275,285.187137,1,2
0,0,40,40,17,67,84,198,210,408,0.000333,0.869355,24,62593.5722,3477.420678,2608.065508,475.914844,1,2
0,0,31,31,17,61,78,137,144,281,0.000333,0.588733,16,28259.16838,1569.953799,1766.198024,431.261846,1,2
0,0,18,18,15,30,45,74,71,145,0.000333,0.26544,14,11148.46179,619.358988,796.318699,205.810077,1,2
0,0,17,17,14,16,30,78,46,124,0.000333,0.202818,14,8518.362074,473.242337,608.454434,117.302969,6,2
0,0,17,17,14,16,30,78,46,124,0.000333,0.202818,14,8518.362074,473.242337,608.454434,117.302969,6,2
0,0,14,14,11,15,26,44,43,87,0.000333,0.136313,10,4089.382555,227.18792,408.938255,96.657107,2,2
0,0,22,22,16,27,43,76,68,144,0.000333,0.260461,16,12502.114,694.561889,781.382125,192.381963,7,2
0,0,11,11,11,18,29,47,46,93,0.000333,0.150597,10,4517.922325,250.995685,451.792233,113.112398,1,2
0,0,17,17,11,33,44,76,83,159,0.000333,0.28935,10,8680.496274,482.249793,868.049627,204.518754,2,2
0,0,26,26,20,52,72,121,125,246,0.000333,0.505934,20,30356.03101,1686.446167,1517.80155,382.861427,2,2
0,0,25,25,22,38,60,134,105,239,0.000333,0.470582,22,31058.43075,1725.468375,1411.746852,297.528741,16,2
0,0,16,16,11,30,41,71,73,144,0.000333,0.257162,10,7714.874887,428.60416,771.487489,185.260466,1,2
0,0,16,16,11,30,41,71,73,144,0.000333,0.257162,10,7714.874887,428.60416,771.487489,185.260466,1,2
0,0,22,22,11,42,53,92,104,196,0.000333,0.374224,10,11226.72409,623.706894,1122.672409,264.53108,1,2
0,0,38,38,17,64,81,198,207,405,0.000333,0.85588,24,61623.34203,3423.519002,2567.639251,453.486868,1,2
0,0,29,29,17,58,75,137,141,278,0.000333,0.577204,16,27705.78554,1539.210308,1731.611596,409.249766,1,2
0,0,17,17,16,29,45,65,65,130,0.000333,0.23798,16,11423.05444,634.614136,713.940903,204.881449,1,2
0,0,16,16,14,15,29,66,41,107,0.000333,0.173268,14,7277.255531,404.291974,519.803966,111.906328,6,2
0,0,16,16,14,15,29,66,41,107,0.000333,0.173268,14,7277.255531,404.291974,519.803966,111.906328,6,2
0,0,13,13,11,14,25,35,38,73,0.000333,0.113001,10,3390.015019,188.334168,339.001502,91.356717,2,2
0,0,21,21,16,25,41,68,62,130,0.000333,0.232161,16,11143.70817,619.094898,696.481761,180.096405,7,2
0,0,10,10,11,17,28,39,41,80,0.000333,0.128196,10,3845.883938,213.660219,384.588394,107.540616,1,2
0,0,16,16,11,32,43,68,78,146,0.000333,0.264078,10,7922.346542,440.130363,792.234654,198.053748,2,2
0,0,25,25,20,51,71,114,119,233,0.000333,0.47763,20,28657.82158,1592.101199,1432.891079,375.732254,2,2
0,0,24,24,22,37,59,125,100,225,0.000333,0.441198,22,29119.08309,1617.726839,1323.594686,290.85727,16,2
0,0,15,15,11,29,40,64,67,131,0.000333,0.232391,10,6971.725804,387.3181,697.17258,178.935197,1,2
0,0,15,15,11,29,40,64,67,131,0.000333,0.232391,10,6971.725804,387.3181,697.17258,178.935197,1,2
0,0,21,21,11,41,52,85,97,182,0.000333,0.345827,10,10374.80029,576.377794,1037.480029,257.71338,1,2
0,0,37,37,17,63,80,191,201,392,0.000333,0.826065,24,59476.69952,3304.261084,2478.195813,446.055503,1,2
0,0,28,28,17,57,74,130,135,265,0.000333,0.548502,16,26328.08227,1462.671237,1645.505142,401.961599,1,2
0,0,14,14,13,29,42,56,56,112,0.000333,0.201313,6,3623.637308,201.313184,603.939551,188.987165,1,2
0,0,13,13,13,15,28,50,29,79,0.000333,0.126594,6,2278.686233,126.59368,379.781039,106.709075,6,2
0,0,13,13,13,15,28,50,29,79,0.000333,0.126594,6,2278.686233,126.59368,379.781039,106.709075,6,2
0,0,11,11,11,12,23,28,26,54,0.000333,0.081424,10,2442.723456,135.706859,244.272346,81.073298,2,2
0,0,18,18,16,23,39,59,52,111,0.000333,0.19556,16,9386.874341,521.493019,586.679646,168.041925,7,2
0,0,8,8,11,16,27,33,35,68,0.000333,0.107777,10,3233.323501,179.629083,323.33235,102.053748,1,2
0,0,15,15,10,31,41,62,73,135,0.000333,0.24109,10,7232.695206,401.8164,723.269521,186.799367,2,2
0,0,23,23,19,51,70,108,113,221,0.000333,0.451524,18,24382.28784,1354.571547,1354.571547,370.004315,2,2
0,0,23,23,21,35,56,118,94,212,0.000333,0.410386,20,24623.18487,1367.954715,1231.159243,271.763571,16,2
0,0,13,13,11,29,40,61,60,121,0.000333,0.214651,10,6439.532995,357.751833,643.953299,178.935197,1,2
0,0,13,13,11,29,40,61,60,121,0.000333,0.214651,10,6439.532995,357.751833,643.953299,178.935197,1,2
0,0,19,19,12,41,53,82,90,172,0.000333,0.328401,12,11822.42782,656.801545,985.202318,262.679182,1,2
0,0,35,35,16,63,79,188,194,382,0.000333,0.802681,24,57793.0619,3210.725661,2408.044246,440.568635,1,2
0,0,26,26,16,57,73,127,128,255,0.000333,0.526135,16,25254.4842,1403.0269,1578.405263,396.474731,1,2
0,0,20,20,15,31,46,83,75,158,0.000333,0.290908,14,12218.11905,678.784391,872.722789,212.183445,1,2
0,0,19,19,16,19,35,84,51,135,0.000333,0.230818,16,11079.25132,615.513962,692.453207,144.710623,6,2
0,0,19,19,16,19,35,84,51,135,0.000333,0.230818,16,11079.25132,615.513962,692.453207,144.710623,6,2
0,0,16,16,13,17,30,50,48,98,0.000333,0.160292,12,5770.50334,320.583519,480.875278,117.592585,2,2
0,0,24,24,16,28,44,81,72,153,0.000333,0.278431,16,13364.6886,742.4827,835.293038,198.605938,7,2
0,0,13,13,11,20,31,54,51,105,0.000333,0.173397,10,5201.906126,288.994785,520.190613,124.49231,1,2
0,0,19,19,13,35,48,83,88,171,0.000333,0.318343,12,11460.34305,636.685725,955.028588,227.630622,2,2
0,0,28,28,20,54,74,127,129,256,0.000333,0.529873,20,31792.40123,1766.244513,1589.620062,397.202487,2,2
0,0,27,27,24,40,64,142,110,252,0.000333,0.504,24,36288,2016,1512,322.916224,16,2
0,0,18,18,13,32,45,77,77,154,0.000333,0.281915,12,10148.94452,563.830251,845.745377,208.105716,1,2
0,0,18,18,13,33,46,77,77,154,0.000333,0.283543,12,10207.5425,567.085694,850.628541,214.570722,1,2
0,0,24,24,13,44,57,98,107,205,0.000333,0.398581,12,14348.90944,797.161635,1195.742453,288.320708,1,2
0,0,40,40,17,66,83,204,211,415,0.000333,0.88188,24,63495.39274,3527.521819,2645.641364,468.41688,1,2
0,0,31,31,17,60,77,143,145,288,0.000333,0.601612,16,28877.35238,1604.297354,1804.834524,423.900304,1,2
0,0,13,13,13,28,41,53,52,105,0.000333,0.187514,6,3375.257763,187.51432,562.54296,182.711654,1,2
0,0,17,17,15,22,37,54,49,103,0.000333,0.178858,14,7512.031753,417.335097,536.573697,156.710855,7,2
0,0,13,13,10,30,40,57,68,125,0.000333,0.221747,10,6652.410119,369.57834,665.241012,180.425999,2,2
0,0,21,21,19,50,69,103,107,210,0.000333,0.427597,18,23090.22245,1282.790136,1282.790136,362.903432,2,2
0,0,22,22,21,34,55,112,89,201,0.000333,0.387351,20,23241.06605,1291.170336,1162.053302,265.212402,16,2
0,0,12,12,10,28,38,54,57,111,0.000333,0.194173,10,5825.19954,323.622197,582.519954,167.825219,1,2
0,0,12,12,10,28,38,54,57,111,0.000333,0.194173,10,5825.19954,323.622197,582.519954,167.825219,1,2
0,0,18,18,11,40,51,75,87,162,0.000333,0.306311,10,9189.329054,510.518281,918.932905,250.930872,1,2
0,0,34,34,16,62,78,181,191,372,0.000333,0.77939,24,56116.07101,3117.559501,2338.169625,433.160171,1,2
0,0,25,25,16,56,72,120,125,245,0.000333,0.503877,16,24186.10601,1343.672556,1511.631625,389.211876,1,2
0,0,18,18,22,33,55,145,111,256,0.000333,0.493343,33,48840.92686,2713.384826,1480.028087,264.572502,22,2
0,0,21,21,16,30,46,98,73,171,0.000333,0.314843,16,15112.46551,839.581417,944.529094,211.206718,6,2
0,0,31,31,21,28,49,163,108,271,0.000333,0.507195,30,45647.59103,2535.97728,1521.586368,226.844604,10,2
0,0,48,48,29,54,83,256,201,457,0.000333,0.971131,42,122362.5068,6797.917047,2913.39302,451.645374,15,2
0,0,452,452,42,391,433,2799,1960,4759,0.000333,13.893461,105,4376440.349,243135.575,41680.38428,3593.388028,141,2
0,0,62,62,26,58,84,306,154,460,0.000333,0.980155,26,76452.11638,4247.339799,2940.466014,461.97433,24,2
0,0,18,18,18,19,37,68,52,120,0.000333,0.208378,18,11252.41927,625.134404,625.134404,155.769273,7,2
0,0,5,5,14,19,33,29,26,55,0.000333,0.092481,7,1942.091736,107.893985,277.441677,134.013592,1,2
0,0,71,71,27,54,81,391,236,627,0.000333,1.325029,52,206704.4695,11483.58164,3975.085952,439.145888,15,2
0,0,29,29,14,30,44,162,118,280,0.000333,0.509547,21,32101.45792,1783.414329,1528.640853,200.509687,9,2
0,0,7,7,15,15,30,45,32,77,0.000333,0.125944,14,5289.628062,293.868226,377.830576,117.206718,4,2
0,0,7,7,15,15,30,45,32,77,0.000333,0.125944,14,5289.628062,293.868226,377.830576,117.206718,4,2
0,0,7,7,15,15,30,45,32,77,0.000333,0.125944,14,5289.628062,293.868226,377.830576,117.206718,4,2
0,0,7,7,15,15,30,45,32,77,0.000333,0.125944,14,5289.628062,293.868226,377.830576,117.206718,4,2
0,0,7,7,15,15,30,45,32,77,0.000333,0.125944,14,5289.628062,293.868226,377.830576,117.206718,4,2
0,0,7,7,15,15,30,45,32,77,0.000333,0.125944,14,5289.628062,293.868226,377.830576,117.206718,4,2
0,0,7,7,15,15,30,45,32,77,0.000333,0.125944,14,5289.628062,293.868226,377.830576,117.206718,4,2
0,0,7,7,15,15,30,45,32,77,0.000333,0.125944,14,5289.628062,293.868226,377.830576,117.206718,4,2
0,0,7,7,15,15,30,45,32,77,0.000333,0.125944,14,5289.628062,293.868226,377.830576,117.206718,4,2
0,0,7,7,15,15,30,45,32,77,0.000333,0.125944,14,5289.628062,293.868226,377.830576,117.206718,4,2
0,0,7,7,15,15,30,45,32,77,0.000333,0.125944,14,5289.628062,293.868226,377.830576,117.206718,4,2
0,0,7,7,15,15,30,45,32,77,0.000333,0.125944,14,5289.628062,293.868226,377.830576,117.206718,4,2
0,0,7,7,15,16,31,42,31,73,0.000333,0.120552,7,2531.594315,140.644129,361.656331,122.603359,4,2
0,0,7,7,15,16,31,42,31,73,0.000333,0.120552,7,2531.594315,140.644129,361.656331,122.603359,4,2
0,0,7,7,15,16,31,42,31,73,0.000333,0.120552,7,2531.594315,140.644129,361.656331,122.603359,4,2
0,0,7,7,15,16,31,42,31,73,0.000333,0.120552,7,2531.594315,140.644129,361.656331,122.603359,4,2
0,0,7,7,15,16,31,42,31,73,0.000333,0.120552,7,2531.594315,140.644129,361.656331,122.603359,4,2
0,0,7,7,15,16,31,42,31,73,0.000333,0.120552,7,2531.594315,140.644129,361.656331,122.603359,4,2
0,0,7,7,15,16,31,42,31,73,0.000333,0.120552,7,2531.594315,140.644129,361.656331,122.603359,4,2
0,0,7,7,15,16,31,42,31,73,0.000333,0.120552,7,2531.594315,140.644129,361.656331,122.603359,4,2
0,0,7,7,15,16,31,42,31,73,0.000333,0.120552,7,2531.594315,140.644129,361.656331,122.603359,4,2
0,0,7,7,15,16,31,42,31,73,0.000333,0.120552,7,2531.594315,140.644129,361.656331,122.603359,4,2
0,0,7,7,15,16,31,42,31,73,0.000333,0.120552,7,2531.594315,140.644129,361.656331,122.603359,4,2
0,0,7,7,15,16,31,42,31,73,0.000333,0.120552,7,2531.594315,140.644129,361.656331,122.603359,4,2
0,0,7,7,15,16,31,42,31,73,0.000333,0.120552,7,2531.594315,140.644129,361.656331,122.603359,4,2
0,0,7,7,15,16,31,42,31,73,0.000333,0.120552,7,2531.594315,140.644129,361.656331,122.603359,4,2
0,0,7,7,15,16,31,42,31,73,0.000333,0.120552,7,2531.594315,140.644129,361.656331,122.603359,4,2
0,0,7,7,15,16,31,42,31,73,0.000333,0.120552,7,2531.594315,140.644129,361.656331,122.603359,4,2
0,0,7,7,15,16,31,42,31,73,0.000333,0.120552,7,2531.594315,140.644129,361.656331,122.603359,4,2
0,0,7,7,15,16,31,42,31,73,0.000333,0.120552,7,2531.594315,140.644129,361.656331,122.603359,4,2
0,0,7,7,15,16,31,42,31,73,0.000333,0.120552,7,2531.594315,140.644129,361.656331,122.603359,4,2
0,0,7,7,15,16,31,42,31,73,0.000333,0.120552,7,2531.594315,140.644129,361.656331,122.603359,4,2
0,0,7,7,15,16,31,42,31,73,0.000333,0.120552,7,2531.594315,140.644129,361.656331,122.603359,4,2
0,0,7,7,15,16,31,42,31,73,0.000333,0.120552,7,2531.594315,140.644129,361.656331,122.603359,4,2
0,0,7,7,15,16,31,42,31,73,0.000333,0.120552,7,2531.594315,140.644129,361.656331,122.603359,4,2
0,0,7,7,15,16,31,42,31,73,0.000333,0.120552,7,2531.594315,140.644129,361.656331,122.603359,4,2
0,0,7,7,15,16,31,42,31,73,0.000333,0.120552,7,2531.594315,140.644129,361.656331,122.603359,4,2
0,0,7,7,15,16,31,42,31,73,0.000333,0.120552,7,2531.594315,140.644129,361.656331,122.603359,4,2
0,0,7,7,15,16,31,42,31,73,0.000333,0.120552,7,2531.594315,140.644129,361.656331,122.603359,4,2
0,0,7,7,15,16,31,42,31,73,0.000333,0.120552,7,2531.594315,140.644129,361.656331,122.603359,4,2
0,0,7,7,15,16,31,42,31,73,0.000333,0.120552,7,2531.594315,140.644129,361.656331,122.603359,4,2
0,0,7,7,15,16,31,42,31,73,0.000333,0.120552,7,2531.594315,140.644129,361.656331,122.603359,4,2
0,0,7,7,15,16,31,42,31,73,0.000333,0.120552,7,2531.594315,140.644129,361.656331,122.603359,4,2
0,0,7,7,15,16,31,42,31,73,0.000333,0.120552,7,2531.594315,140.644129,361.656331,122.603359,4,2
0,0,7,7,15,16,31,42,31,73,0.000333,0.120552,7,2531.594315,140.644129,361.656331,122.603359,4,2
0,0,7,7,15,16,31,42,31,73,0.000333,0.120552,7,2531.594315,140.644129,361.656331,122.603359,4,2
0,0,7,7,15,16,31,42,31,73,0.000333,0.120552,7,2531.594315,140.644129,361.656331,122.603359,4,2
0,0,7,7,15,16,31,42,31,73,0.000333,0.120552,7,2531.594315,140.644129,361.656331,122.603359,4,2
0,0,7,7,15,16,31,42,31,73,0.000333,0.120552,7,2531.594315,140.644129,361.656331,122.603359,4,2
0,0,7,7,15,16,31,42,31,73,0.000333,0.120552,7,2531.594315,140.644129,361.656331,122.603359,4,2
0,0,7,7,15,16,31,42,31,73,0.000333,0.120552,7,2531.594315,140.644129,361.656331,122.603359,4,2
0,0,7,7,15,16,31,42,31,73,0.000333,0.120552,7,2531.594315,140.644129,361.656331,122.603359,4,2
0,0,7,7,15,16,31,42,31,73,0.000333,0.120552,7,2531.594315,140.644129,361.656331,122.603359,4,2
0,0,7,7,15,16,31,42,31,73,0.000333,0.120552,7,2531.594315,140.644129,361.656331,122.603359,4,2
0,0,7,7,15,16,31,42,31,73,0.000333,0.120552,7,2531.594315,140.644129,361.656331,122.603359,4,2
0,0,7,7,15,16,31,42,31,73,0.000333,0.120552,7,2531.594315,140.644129,361.656331,122.603359,4,2
0,0,7,7,15,16,31,42,31,73,0.000333,0.120552,7,2531.594315,140.644129,361.656331,122.603359,4,2
0,0,7,7,15,16,31,42,31,73,0.000333,0.120552,7,2531.594315,140.644129,361.656331,122.603359,4,2
0,0,7,7,15,16,31,42,31,73,0.000333,0.120552,7,2531.594315,140.644129,361.656331,122.603359,4,2
0,0,7,7,15,16,31,42,31,73,0.000333,0.120552,7,2531.594315,140.644129,361.656331,122.603359,4,2
0,0,7,7,15,16,31,42,31,73,0.000333,0.120552,7,2531.594315,140.644129,361.656331,122.603359,4,2
0,0,7,7,15,16,31,42,31,73,0.000333,0.120552,7,2531.594315,140.644129,361.656331,122.603359,4,2
0,0,7,7,15,16,31,42,31,73,0.000333,0.120552,7,2531.594315,140.644129,361.656331,122.603359,4,2
0,0,7,7,15,16,31,42,31,73,0.000333,0.120552,7,2531.594315,140.644129,361.656331,122.603359,4,2
0,0,7,7,15,16,31,42,31,73,0.000333,0.120552,7,2531.594315,140.644129,361.656331,122.603359,4,2
0,0,7,7,15,16,31,42,31,73,0.000333,0.120552,7,2531.594315,140.644129,361.656331,122.603359,4,2
0,0,7,7,15,16,31,42,31,73,0.000333,0.120552,7,2531.594315,140.644129,361.656331,122.603359,4,2
0,0,7,7,15,16,31,42,31,73,0.000333,0.120552,7,2531.594315,140.644129,361.656331,122.603359,4,2
0,0,7,7,15,16,31,42,31,73,0.000333,0.120552,7,2531.594315,140.644129,361.656331,122.603359,4,2
0,0,7,7,15,16,31,42,31,73,0.000333,0.120552,7,2531.594315,140.644129,361.656331,122.603359,4,2
0,0,7,7,15,16,31,42,31,73,0.000333,0.120552,7,2531.594315,140.644129,361.656331,122.603359,4,2
0,0,7,7,15,16,31,42,31,73,0.000333,0.120552,7,2531.594315,140.644129,361.656331,122.603359,4,2
0,0,7,7,15,16,31,42,31,73,0.000333,0.120552,7,2531.594315,140.644129,361.656331,122.603359,4,2
0,0,7,7,15,16,31,42,31,73,0.000333,0.120552,7,2531.594315,140.644129,361.656331,122.603359,4,2
0,0,7,7,15,16,31,42,31,73,0.000333,0.120552,7,2531.594315,140.644129,361.656331,122.603359,4,2
0,0,7,7,15,16,31,42,31,73,0.000333,0.120552,7,2531.594315,140.644129,361.656331,122.603359,4,2
0,0,7,7,15,16,31,42,31,73,0.000333,0.120552,7,2531.594315,140.644129,361.656331,122.603359,4,2
0,0,7,7,15,16,31,42,31,73,0.000333,0.120552,7,2531.594315,140.644129,361.656331,122.603359,4,2
0,0,7,7,15,16,31,42,31,73,0.000333,0.120552,7,2531.594315,140.644129,361.656331,122.603359,4,2
0,0,7,7,15,16,31,42,31,73,0.000333,0.120552,7,2531.594315,140.644129,361.656331,122.603359,4,2
0,0,7,7,15,16,31,42,31,73,0.000333,0.120552,7,2531.594315,140.644129,361.656331,122.603359,4,2
0,0,7,7,15,16,31,42,31,73,0.000333,0.120552,7,2531.594315,140.644129,361.656331,122.603359,4,2
0,0,7,7,15,16,31,42,31,73,0.000333,0.120552,7,2531.594315,140.644129,361.656331,122.603359,4,2
0,0,7,7,15,16,31,42,31,73,0.000333,0.120552,7,2531.594315,140.644129,361.656331,122.603359,4,2
0,0,7,7,15,16,31,42,31,73,0.000333,0.120552,7,2531.594315,140.644129,361.656331,122.603359,4,2
0,0,7,7,15,16,31,42,31,73,0.000333,0.120552,7,2531.594315,140.644129,361.656331,122.603359,4,2
0,0,7,7,15,16,31,42,31,73,0.000333,0.120552,7,2531.594315,140.644129,361.656331,122.603359,4,2
0,0,7,7,15,16,31,42,31,73,0.000333,0.120552,7,2531.594315,140.644129,361.656331,122.603359,4,2
0,0,7,7,15,16,31,42,31,73,0.000333,0.120552,7,2531.594315,140.644129,361.656331,122.603359,4,2
0,0,7,7,15,16,31,42,31,73,0.000333,0.120552,7,2531.594315,140.644129,361.656331,122.603359,4,2
0,0,7,7,15,16,31,42,31,73,0.000333,0.120552,7,2531.594315,140.644129,361.656331,122.603359,4,2
0,0,7,7,15,16,31,42,31,73,0.000333,0.120552,7,2531.594315,140.644129,361.656331,122.603359,4,2
0,0,7,7,15,16,31,42,31,73,0.000333,0.120552,7,2531.594315,140.644129,361.656331,122.603359,4,2
0,0,7,7,15,16,31,42,31,73,0.000333,0.120552,7,2531.594315,140.644129,361.656331,122.603359,4,2
0,0,7,7,15,16,31,42,31,73,0.000333,0.120552,7,2531.594315,140.644129,361.656331,122.603359,4,2
0,0,7,7,15,16,31,42,31,73,0.000333,0.120552,7,2531.594315,140.644129,361.656331,122.603359,4,2
0,0,7,7,15,16,31,42,31,73,0.000333,0.120552,7,2531.594315,140.644129,361.656331,122.603359,4,2
0,0,7,7,15,16,31,42,31,73,0.000333,0.120552,7,2531.594315,140.644129,361.656331,122.603359,4,2
0,0,7,7,15,16,31,42,31,73,0.000333,0.120552,7,2531.594315,140.644129,361.656331,122.603359,4,2
0,0,7,7,15,16,31,42,31,73,0.000333,0.120552,7,2531.594315,140.644129,361.656331,122.603359,4,2
0,0,6,6,11,11,22,28,21,49,0.000333,0.072837,5,1092.560747,60.697819,218.512149,76.107496,4,2
0,0,6,6,11,11,22,28,21,49,0.000333,0.072837,5,1092.560747,60.697819,218.512149,76.107496,4,2
0,0,6,6,11,11,22,28,21,49,0.000333,0.072837,5,1092.560747,60.697819,218.512149,76.107496,4,2
0,0,6,6,11,11,22,28,21,49,0.000333,0.072837,5,1092.560747,60.697819,218.512149,76.107496,4,2
0,0,6,6,11,11,22,28,21,49,0.000333,0.072837,5,1092.560747,60.697819,218.512149,76.107496,4,2
0,0,6,6,11,11,22,28,21,49,0.000333,0.072837,5,1092.560747,60.697819,218.512149,76.107496,4,2
0,0,6,6,11,11,22,28,21,49,0.000333,0.072837,5,1092.560747,60.697819,218.512149,76.107496,4,2
0,0,6,6,11,11,22,28,21,49,0.000333,0.072837,5,1092.560747,60.697819,218.512149,76.107496,4,2
0,0,6,6,11,11,22,28,21,49,0.000333,0.072837,5,1092.560747,60.697819,218.512149,76.107496,4,2
0,0,6,6,11,11,22,28,21,49,0.000333,0.072837,5,1092.560747,60.697819,218.512149,76.107496,4,2
0,0,6,6,11,11,22,28,21,49,0.000333,0.072837,5,1092.560747,60.697819,218.512149,76.107496,4,2
0,0,6,6,11,11,22,28,21,49,0.000333,0.072837,5,1092.560747,60.697819,218.512149,76.107496,4,2
0,0,5,5,12,8,20,29,19,48,0.000333,0.069151,12,2489.430583,138.301699,207.452549,67.01955,1,2
0,0,3,3,11,7,18,22,13,35,0.000333,0.048649,5,729.736875,40.540938,145.947375,57.705232,1,2
0,0,5,5,11,9,20,27,17,44,0.000333,0.063388,5,950.824181,52.823566,190.164836,66.583073,1,2
0,0,9,9,14,13,27,47,34,81,0.000333,0.128382,14,5392.042427,299.557913,385.145888,101.408685,1,2
0,0,6,6,12,9,21,31,21,52,0.000333,0.076134,12,2740.806072,152.267004,228.400506,71.548875,1,2
0,0,3,3,11,7,18,22,13,35,0.000333,0.048649,5,729.736875,40.540938,145.947375,57.705232,1,2
0,0,7,7,12,10,22,41,26,67,0.000333,0.099594,12,3585.383021,199.187946,298.781918,76.238831,1,2
0,0,10,10,14,16,30,63,46,109,0.000333,0.178284,14,7487.915049,415.99528,534.851075,117.302969,1,2
0,0,11,11,14,14,28,51,38,89,0.000333,0.142618,14,5989.964233,332.775791,427.854588,106.605938,1,2
0,0,11,11,13,14,27,54,40,94,0.000333,0.148986,12,5363.513102,297.97295,446.959425,101.408685,1,2
0,0,5,5,6,9,15,19,16,35,0.000333,0.04558,3,410.223513,22.790195,136.741171,44.0391,1,2
0,0,4,4,6,8,14,19,14,33,0.000333,0.041881,3,376.928137,20.940452,125.642712,39.509775,1,2
0,0,2,2,5,7,12,12,8,20,0.000333,0.0239,2,143.3985,7.966583,71.69925,31.261125,1,2
0,0,5,5,6,9,15,22,16,38,0.000333,0.049487,3,445.385528,24.74364,148.461843,44.0391,1,2
0,0,5,5,6,9,15,22,16,38,0.000333,0.049487,3,445.385528,24.74364,148.461843,44.0391,1,2
0,0,11,11,11,15,26,54,44,98,0.000333,0.153548,10,4606.430924,255.912829,460.643092,96.657107,1,2
0,0,12,12,12,18,30,69,54,123,0.000333,0.201183,18,10863.85578,603.547543,603.547543,118.0782,1,2
0,0,10,10,9,17,26,50,42,92,0.000333,0.144147,8,3459.523633,192.195757,432.440454,98.016193,1,2
0,0,12,12,10,17,27,59,45,104,0.000333,0.164836,10,4945.083002,274.726833,494.5083,102.706149,1,2
0,0,11,11,10,15,25,47,37,84,0.000333,0.130028,10,3900.839199,216.713289,390.08392,91.82264,1,2
0,0,13,13,11,18,29,65,49,114,0.000333,0.184603,10,5538.098334,307.67213,553.809833,113.112398,1,2
0,0,7,7,11,11,22,36,24,60,0.000333,0.089189,10,2675.658971,148.647721,267.565897,76.107496,1,2
0,0,11,11,13,17,30,64,48,112,0.000333,0.183191,12,6594.86096,366.381164,549.571747,117.592585,1,2
0,0,13,13,13,16,29,59,43,102,0.000333,0.165171,12,5946.168738,330.342708,495.514062,112.105716,1,2
0,0,12,12,12,16,28,59,43,102,0.000333,0.16345,12,5884.202425,326.900135,490.350202,107.01955,1,2
0,0,8,8,11,13,24,61,35,96,0.000333,0.146719,10,4401.564001,244.531333,440.1564,86.159464,1,2
0,0,13,13,13,19,32,91,61,152,0.000333,0.253333,18,13680,760,760,128.816339,1,2
0,0,13,13,13,18,31,81,52,133,0.000333,0.219636,12,7906.897311,439.272073,658.908109,123.164366,1,2
0,0,13,13,12,18,30,84,54,138,0.000333,0.225717,18,12188.71624,677.150902,677.150902,118.0782,1,2
0,0,8,8,11,13,24,61,35,96,0.000333,0.146719,10,4401.564001,244.531333,440.1564,86.159464,1,2
0,0,13,13,13,19,32,91,61,152,0.000333,0.253333,18,13680,760,760,128.816339,1,2
0,0,13,13,13,18,31,81,52,133,0.000333,0.219636,12,7906.897311,439.272073,658.908109,123.164366,1,2
0,0,13,13,12,18,30,84,54,138,0.000333,0.225717,18,12188.71624,677.150902,677.150902,118.0782,1,2
0,0,7,7,10,11,21,29,24,53,0.000333,0.077598,10,2327.928234,129.329346,232.792823,71.273029,1,2
0,0,8,8,11,13,24,55,34,89,0.000333,0.136021,10,4080.616626,226.700924,408.061663,86.159464,1,2
0,0,13,13,13,19,32,85,60,145,0.000333,0.241667,18,13050,725,725,128.816339,1,2
0,0,13,13,13,18,31,75,51,126,0.000333,0.208076,12,7490.744821,416.15249,624.228735,123.164366,1,2
0,0,13,13,12,18,30,78,53,131,0.000333,0.214268,12,7713.632016,428.535112,642.802668,118.0782,1,2
0,0,8,8,10,11,21,29,25,54,0.000333,0.079062,10,2371.851408,131.769523,237.185141,71.273029,1,2
0,0,13,13,12,17,29,59,51,110,0.000333,0.178126,18,9618.80237,534.377909,534.377909,112.506418,1,2
0,0,13,13,12,16,28,49,42,91,0.000333,0.145823,12,5249.631575,291.646199,437.469298,107.01955,1,2
0,0,13,13,11,16,27,52,44,96,0.000333,0.152156,10,4564.692002,253.594,456.4692,102.053748,1,2
0,0,13,13,13,17,30,59,46,105,0.000333,0.171741,12,6182.68215,343.482342,515.223513,117.592585,1,2
0,0,13,13,12,17,29,62,48,110,0.000333,0.178126,12,6412.534914,356.25194,534.377909,112.506418,1,2
0,0,8,8,11,12,23,39,29,68,0.000333,0.102534,10,3076.02213,170.890118,307.602213,81.073298,1,2
0,0,13,13,13,19,32,69,55,124,0.000333,0.206667,12,7440,413.333333,620,128.816339,1,2
0,0,13,13,13,17,30,59,46,105,0.000333,0.171741,12,6182.68215,343.482342,515.223513,117.592585,1,2
0,0,13,13,12,17,29,62,48,110,0.000333,0.178126,12,6412.534914,356.25194,534.377909,112.506418,1,2
0,0,13,13,12,19,31,63,54,117,0.000333,0.193214,12,6955.69162,386.427312,579.640968,123.730173,1,2
0,0,13,13,12,17,29,53,45,98,0.000333,0.158694,12,5712.98565,317.388092,476.082138,112.506418,1,2
0,0,13,13,11,17,28,56,47,103,0.000333,0.165053,10,4951.57557,275.087532,495.157557,107.540616,1,2
0,0,7,7,10,12,22,26,22,48,0.000333,0.071351,5,1070.263588,59.459088,214.052718,76.238831,1,2
0,0,13,13,12,19,31,59,51,110,0.000333,0.181654,12,6539.53913,363.307729,544.961594,123.730173,1,2
0,0,13,13,12,17,29,49,42,91,0.000333,0.147359,12,5304.915247,294.717514,442.076271,112.506418,1,2
0,0,13,13,11,17,28,52,44,96,0.000333,0.153835,10,4615.060725,256.392263,461.506073,107.540616,1,2
0,0,13,13,13,20,33,69,55,124,0.000333,0.208502,12,7506.05845,417.003247,625.504871,134.544278,1,2
0,0,13,13,13,18,31,59,46,105,0.000333,0.173397,12,6242.287351,346.793742,520.190613,123.164366,1,2
0,0,13,13,12,18,30,62,48,110,0.000333,0.179919,12,6477.095586,359.838644,539.757966,118.0782,1,2
0,0,7,7,11,12,23,57,33,90,0.000333,0.135707,10,4071.20576,226.178098,407.120576,81.073298,1,2
0,0,13,13,13,20,33,69,55,124,0.000333,0.208502,12,7506.05845,417.003247,625.504871,134.544278,1,2
0,0,13,13,13,18,31,59,46,105,0.000333,0.173397,12,6242.287351,346.793742,520.190613,123.164366,1,2
0,0,13,13,12,18,30,62,48,110,0.000333,0.179919,12,6477.095586,359.838644,539.757966,118.0782,1,2
0,0,7,7,10,13,23,30,25,55,0.000333,0.082932,5,1243.979538,69.109974,248.795908,81.324997,1,2
0,0,13,13,12,20,32,63,54,117,0.000333,0.195,12,7020,390,585,129.458112,1,2
0,0,13,13,12,18,30,53,45,98,0.000333,0.160292,12,5770.50334,320.583519,480.875278,118.0782,1,2
0,0,13,13,11,18,29,56,47,103,0.000333,0.166791,10,5003.720425,277.984468,500.372042,113.112398,1,2
0,0,7,7,10,12,22,26,22,48,0.000333,0.071351,5,1070.263588,59.459088,214.052718,76.238831,1,2
0,0,13,13,12,19,31,59,51,110,0.000333,0.181654,12,6539.53913,363.307729,544.961594,123.730173,1,2
0,0,13,13,12,17,29,49,42,91,0.000333,0.147359,12,5304.915247,294.717514,442.076271,112.506418,1,2
0,0,13,13,11,17,28,52,44,96,0.000333,0.153835,10,4615.060725,256.392263,461.506073,107.540616,1,2
0,0,7,7,11,13,24,36,26,62,0.000333,0.094756,10,2842.67675,157.926486,284.267675,86.159464,1,2
0,0,13,13,13,20,33,69,55,124,0.000333,0.208502,12,7506.05845,417.003247,625.504871,134.544278,1,2
0,0,13,13,13,18,31,59,46,105,0.000333,0.173397,12,6242.287351,346.793742,520.190613,123.164366,1,2
0,0,13,13,12,18,30,62,48,110,0.000333,0.179919,12,6477.095586,359.838644,539.757966,118.0782,1,2
0,0,7,7,11,13,24,36,26,62,0.000333,0.094756,10,2842.67675,157.926486,284.267675,86.159464,1,2
0,0,13,13,13,20,33,69,55,124,0.000333,0.208502,12,7506.05845,417.003247,625.504871,134.544278,1,2
0,0,13,13,13,18,31,59,46,105,0.000333,0.173397,12,6242.287351,346.793742,520.190613,123.164366,1,2
0,0,13,13,12,18,30,62,48,110,0.000333,0.179919,12,6477.095586,359.838644,539.757966,118.0782,1,2
0,0,8,8,10,11,21,31,28,59,0.000333,0.086382,10,2591.467279,143.970404,259.146728,71.273029,1,2
0,0,14,14,13,23,36,66,59,125,0.000333,0.215414,12,7754.887502,430.827083,646.240625,152.147641,1,2
0,0,14,14,13,22,35,56,50,106,0.000333,0.181235,12,6524.447998,362.469333,543.704,146.213212,1,2
0,0,14,14,12,22,34,59,52,111,0.000333,0.188236,12,6776.500505,376.47225,564.708375,141.127046,1,2
0,0,14,14,12,22,34,59,52,111,0.000333,0.188236,12,6776.500505,376.47225,564.708375,141.127046,1,2
0,0,14,14,15,25,40,86,65,151,0.000333,0.26787,14,11250.55599,625.030888,803.611142,174.699764,1,2
0,0,14,14,15,24,39,76,56,132,0.000333,0.232558,14,9767.4233,542.634628,697.673093,168.642459,1,2
0,0,13,13,12,17,29,74,49,123,0.000333,0.199177,12,7170.379949,398.354442,597.531662,112.506418,1,2
0,0,14,14,15,25,40,86,65,151,0.000333,0.26787,14,11250.55599,625.030888,803.611142,174.699764,1,2
0,0,14,14,15,24,39,76,56,132,0.000333,0.232558,14,9767.4233,542.634628,697.673093,168.642459,1,2
0,0,14,14,15,24,39,79,58,137,0.000333,0.241367,14,10137.40146,563.18897,724.100104,168.642459,1,2
0,0,8,8,11,11,22,45,29,74,0.000333,0.109999,10,3299.979398,183.332189,329.99794,76.107496,1,2
0,0,14,14,15,25,40,82,64,146,0.000333,0.259001,14,10878.02103,604.334501,777.001502,174.699764,1,2
0,0,14,14,15,24,39,72,55,127,0.000333,0.223749,14,9397.445145,522.080286,671.246082,168.642459,1,2
0,0,14,14,15,24,39,75,57,132,0.000333,0.232558,14,9767.4233,542.634628,697.673093,168.642459,1,2
0,0,8,8,11,11,22,46,30,76,0.000333,0.112972,10,3389.16803,188.287113,338.916803,76.107496,1,2
0,0,14,14,15,25,40,83,65,148,0.000333,0.262548,14,11027.03501,612.613056,787.645358,174.699764,1,2
0,0,14,14,15,24,39,73,56,129,0.000333,0.227272,14,9545.436407,530.302023,681.816886,168.642459,1,2
0,0,14,14,15,24,39,76,58,134,0.000333,0.236081,14,9915.414563,550.856365,708.243897,168.642459,1,2
0,0,14,14,15,24,39,68,59,127,0.000333,0.223749,14,9397.445145,522.080286,671.246082,168.642459,1,2
0,0,14,14,15,23,38,58,50,108,0.000333,0.188925,14,7934.8664,440.825911,566.776171,162.645284,1,2
0,0,14,14,15,23,38,61,52,113,0.000333,0.197672,14,8302.221326,461.234518,593.015809,162.645284,1,2
0,0,14,14,15,24,39,68,59,127,0.000333,0.223749,14,9397.445145,522.080286,671.246082,168.642459,1,2
0,0,14,14,15,23,38,58,50,108,0.000333,0.188925,14,7934.8664,440.825911,566.776171,162.645284,1,2
0,0,14,14,15,23,38,61,52,113,0.000333,0.197672,14,8302.221326,461.234518,593.015809,162.645284,1,2
0,0,8,8,10,10,20,27,23,50,0.000333,0.072032,10,2160.964047,120.053558,216.096405,66.438562,1,2
0,0,14,14,14,24,38,64,58,122,0.000333,0.213416,14,8963.460193,497.970011,640.247157,163.342069,1,2
0,0,14,14,14,23,37,54,49,103,0.000333,0.178858,14,7512.031753,417.335097,536.573697,157.344894,1,2
0,0,14,14,14,23,37,57,51,108,0.000333,0.18754,14,7876.693489,437.594083,562.620963,157.344894,1,2
0,0,8,8,10,10,20,28,24,52,0.000333,0.074913,10,2247.402609,124.855701,224.740261,66.438562,1,2
0,0,14,14,14,24,38,65,59,124,0.000333,0.216914,14,9110.402163,506.133454,650.743012,163.342069,1,2
0,0,14,14,14,23,37,55,50,105,0.000333,0.182331,14,7657.896447,425.438692,546.992603,157.344894,1,2
0,0,14,14,14,23,37,55,50,105,0.000333,0.182331,14,7657.896447,425.438692,546.992603,157.344894,1,2
0,0,14,14,14,23,37,58,52,110,0.000333,0.191013,14,8022.558183,445.697677,573.03987,157.344894,1,2
0,0,8,8,12,12,24,50,42,92,0.000333,0.140606,18,7592.697901,421.81655,421.81655,86.0391,1,2
0,0,13,13,16,26,42,83,76,159,0.000333,0.285793,16,13718.05552,762.114196,857.37847,186.211433,1,2
0,0,13,13,16,24,40,73,67,140,0.000333,0.248357,16,11921.11893,662.284385,745.069933,174.0391,1,2
0,0,13,13,16,25,41,76,69,145,0.000333,0.258948,16,12429.52065,690.528925,776.845041,180.096405,1,2
0,0,8,8,12,12,24,50,42,92,0.000333,0.140606,18,7592.697901,421.81655,421.81655,86.0391,1,2
0,0,13,13,16,26,42,83,76,159,0.000333,0.285793,16,13718.05552,762.114196,857.37847,186.211433,1,2
0,0,13,13,16,24,40,73,67,140,0.000333,0.248357,16,11921.11893,662.284385,745.069933,174.0391,1,2
0,0,13,13,16,25,41,76,69,145,0.000333,0.258948,16,12429.52065,690.528925,776.845041,180.096405,1,2
0,0,8,8,12,11,23,32,32,64,0.000333,0.096503,12,3474.095582,193.00531,289.507965,81.073298,1,2
0,0,13,13,16,25,41,65,66,131,0.000333,0.233946,16,11229.429,623.857167,701.839313,180.096405,1,2
0,0,13,13,16,23,39,55,57,112,0.000333,0.197322,16,9471.440776,526.191154,591.965049,168.041925,1,2
0,0,13,13,16,24,40,58,59,117,0.000333,0.207555,16,9962.649394,553.480522,622.665587,174.0391,1,2
0,0,8,8,12,11,23,32,32,64,0.000333,0.096503,12,3474.095582,193.00531,289.507965,81.073298,1,2
0,0,13,13,16,25,41,65,66,131,0.000333,0.233946,16,11229.429,623.857167,701.839313,180.096405,1,2
0,0,13,13,16,23,39,55,57,112,0.000333,0.197322,16,9471.440776,526.191154,591.965049,168.041925,1,2
0,0,13,13,16,24,40,58,59,117,0.000333,0.207555,16,9962.649394,553.480522,622.665587,174.0391,1,2
0,0,8,8,12,11,23,50,31,81,0.000333,0.122136,12,4396.902221,244.272346,366.408518,81.073298,1,2
0,0,13,13,16,25,41,83,64,147,0.000333,0.26252,16,12600.96232,700.053462,787.560145,180.096405,1,2
0,0,13,13,16,23,39,73,55,128,0.000333,0.22551,16,10824.50374,601.361319,676.531484,168.041925,1,2
0,0,13,13,16,23,39,76,57,133,0.000333,0.234319,16,11247.33592,624.851996,702.958495,168.041925,1,2
0,0,8,8,12,11,23,50,31,81,0.000333,0.122136,12,4396.902221,244.272346,366.408518,81.073298,1,2
0,0,12,12,14,18,32,78,55,133,0.000333,0.221667,21,13965,775.833333,665,128.361619,1,2
0,0,12,12,14,16,30,68,46,114,0.000333,0.186462,14,7831.397391,435.077633,559.385528,117.302969,1,2
0,0,13,13,16,23,39,76,57,133,0.000333,0.234319,16,11247.33592,624.851996,702.958495,168.041925,1,2
0,0,8,8,12,10,22,32,25,57,0.000333,0.084729,12,3050.251227,169.458402,254.187602,76.238831,1,2
0,0,11,11,14,15,29,57,46,103,0.000333,0.166791,21,10507.81289,583.767383,500.372042,111.906328,1,2
0,0,11,11,14,13,27,47,37,84,0.000333,0.133137,14,5591.747703,310.65265,399.41055,101.408685,1,2
0,0,13,13,16,22,38,58,51,109,0.000333,0.190675,16,9152.385583,508.465866,572.024099,162.107496,1,2
0,0,8,8,12,10,22,32,25,57,0.000333,0.084729,12,3050.251227,169.458402,254.187602,76.238831,1,2
0,0,11,11,14,15,29,57,46,103,0.000333,0.166791,21,10507.81289,583.767383,500.372042,111.906328,1,2
0,0,12,12,14,15,29,50,40,90,0.000333,0.145739,14,6121.056054,340.05867,437.21829,111.906328,1,2
0,0,13,13,16,22,38,58,51,109,0.000333,0.190675,16,9152.385583,508.465866,572.024099,162.107496,1,2
0,0,9,9,11,13,24,52,34,86,0.000333,0.131436,10,3943.067751,219.059319,394.306775,86.159464,1,2
0,0,14,14,14,27,41,85,67,152,0.000333,0.271449,14,11400.87067,633.381704,814.347905,181.684931,1,2
0,0,14,14,14,29,43,84,67,151,0.000333,0.273122,14,11471.12369,637.28465,819.365978,194.184418,1,2
0,0,14,14,14,26,40,78,60,138,0.000333,0.244809,14,10281.96508,571.220282,734.426077,175.514402,1,2
0,0,8,8,11,13,24,49,31,80,0.000333,0.122266,10,3667.970001,203.776111,366.797,86.159464,1,2
0,0,14,14,14,27,41,85,67,152,0.000333,0.271449,14,11400.87067,633.381704,814.347905,181.684931,1,2
0,0,14,14,14,25,39,75,58,133,0.000333,0.234319,14,9841.418932,546.745496,702.958495,169.399374,1,2
0,0,14,14,14,26,40,78,60,138,0.000333,0.244809,14,10281.96508,571.220282,734.426077,175.514402,1,2
0,0,8,8,11,12,23,31,25,56,0.000333,0.08444,10,2533.194695,140.733039,253.31947,81.073298,1,2
0,0,14,14,14,26,40,67,61,128,0.000333,0.227069,14,9536.895146,529.827508,681.206796,175.514402,1,2
0,0,14,14,14,24,38,57,52,109,0.000333,0.190675,14,8008.337386,444.907633,572.024099,163.342069,1,2
0,0,14,14,14,25,39,60,54,114,0.000333,0.200845,14,8435.501941,468.638997,602.535853,169.399374,1,2
0,0,8,8,11,11,22,31,25,56,0.000333,0.083243,10,2497.281706,138.737873,249.728171,76.107496,1,2
0,0,14,14,14,26,40,67,61,128,0.000333,0.227069,14,9536.895146,529.827508,681.206796,175.514402,1,2
0,0,14,14,14,24,38,57,52,109,0.000333,0.190675,14,8008.337386,444.907633,572.024099,163.342069,1,2
0,0,14,14,14,25,39,60,54,114,0.000333,0.200845,14,8435.501941,468.638997,602.535853,169.399374,1,2
0,0,13,13,13,18,31,81,56,137,0.000333,0.226242,18,12217.0481,678.724895,678.724895,123.164366,1,2
0,0,14,14,15,24,39,76,56,132,0.000333,0.232558,14,9767.4233,542.634628,697.673093,168.642459,1,2
0,0,14,14,15,24,39,79,58,137,0.000333,0.241367,14,10137.40146,563.18897,724.100104,168.642459,1,2
0,0,8,8,11,11,22,45,29,74,0.000333,0.109999,10,3299.979398,183.332189,329.99794,76.107496,1,2
0,0,13,13,13,18,31,77,55,132,0.000333,0.217985,18,11771.17043,653.953913,653.953913,123.164366,1,2
0,0,13,13,13,18,31,77,55,132,0.000333,0.217985,18,11771.17043,653.953913,653.953913,123.164366,1,2
0,0,13,13,13,20,33,76,55,131,0.000333,0.220272,12,7929.787556,440.543753,660.81563,134.544278,1,2
0,0,13,13,12,17,29,70,48,118,0.000333,0.191081,12,6878.901089,382.161172,573.241757,112.506418,1,2
0,0,8,8,11,11,22,46,30,76,0.000333,0.112972,10,3389.16803,188.287113,338.916803,76.107496,1,2
0,0,13,13,13,18,31,78,56,134,0.000333,0.221287,18,11949.5215,663.862306,663.862306,123.164366,1,2
0,0,13,13,13,17,30,68,47,115,0.000333,0.188097,12,6771.509022,376.194946,564.292418,117.592585,1,2
0,0,13,13,12,17,29,71,49,120,0.000333,0.194319,12,6995.492633,388.63848,582.957719,112.506418,1,2
0,0,13,13,13,17,30,63,50,113,0.000333,0.184826,12,6653.743648,369.652425,554.478637,117.592585,1,2
0,0,13,13,13,16,29,53,41,94,0.000333,0.152217,12,5479.802563,304.433476,456.650214,112.105716,1,2
0,0,13,13,12,16,28,56,43,99,0.000333,0.158643,12,5711.137647,317.285425,475.928137,107.01955,1,2
0,0,8,8,11,10,21,31,24,55,0.000333,0.080526,10,2415.774583,134.209699,241.577458,71.273029,1,2
0,0,13,13,13,17,30,63,50,113,0.000333,0.184826,12,6653.743648,369.652425,554.478637,117.592585,1,2
0,0,13,13,13,16,29,53,41,94,0.000333,0.152217,12,5479.802563,304.433476,456.650214,112.105716,1,2
0,0,13,13,12,16,28,56,43,99,0.000333,0.158643,12,5711.137647,317.285425,475.928137,107.01955,1,2
0,0,8,8,10,10,20,27,23,50,0.000333,0.072032,10,2160.964047,120.053558,216.096405,66.438562,1,2
0,0,13,13,12,17,29,59,49,108,0.000333,0.174887,12,6295.94337,349.774632,524.661947,112.506418,1,2
0,0,13,13,12,16,28,49,40,89,0.000333,0.142618,12,5134.255057,285.236392,427.854588,107.01955,1,2
0,0,13,13,11,16,27,52,42,94,0.000333,0.148986,10,4469.594252,248.310792,446.959425,102.053748,1,2
0,0,8,8,10,10,20,28,24,52,0.000333,0.074913,10,2247.402609,124.855701,224.740261,66.438562,1,2
0,0,13,13,12,17,29,60,50,110,0.000333,0.178126,12,6412.534914,356.25194,534.377909,112.506418,1,2
0,0,13,13,12,16,28,50,41,91,0.000333,0.145823,12,5249.631575,291.646199,437.469298,107.01955,1,2
0,0,12,12,10,13,23,47,38,85,0.000333,0.128168,10,3845.027663,213.612648,384.502766,81.324997,1,2
0,0,14,14,10,14,24,53,44,97,0.000333,0.148247,15,6671.120439,370.617802,444.741363,86.52225,1,2
0,0,9,9,11,10,21,39,28,67,0.000333,0.098095,10,2942.852673,163.491815,294.285267,71.273029,1,2
0,0,8,8,11,11,22,36,26,62,0.000333,0.092162,10,2764.847604,153.602645,276.48476,76.107496,1,2
0,0,9,9,11,12,23,41,29,70,0.000333,0.10555,10,3166.493369,175.916298,316.649337,81.073298,1,2
0,0,10,10,11,13,24,50,33,83,0.000333,0.126851,10,3805.518876,211.417715,380.551888,86.159464,1,2
0,0,9,9,10,12,22,43,30,73,0.000333,0.108513,10,3255.385082,180.854727,325.538508,76.238831,1,2
0,0,11,11,10,14,24,50,36,86,0.000333,0.131436,10,3943.067751,219.059319,394.306775,86.52225,1,2
0,0,11,11,11,14,25,42,35,77,0.000333,0.119192,10,3575.769266,198.653848,357.576927,91.356717,1,2
0,0,10,10,10,15,25,35,34,69,0.000333,0.106809,10,3204.260771,178.014487,320.426077,91.82264,1,2
0,0,13,13,13,16,29,67,52,119,0.000333,0.1927,18,10405.79529,578.099738,578.099738,112.105716,1,2
0,0,13,13,13,15,28,57,43,100,0.000333,0.160245,12,5768.825906,320.490328,480.735492,106.709075,1,2
0,0,13,13,12,16,28,60,45,105,0.000333,0.168257,12,6057.267202,336.514845,504.772267,107.01955,1,2
0,0,6,6,11,9,20,31,20,51,0.000333,0.073473,10,2204.183328,122.454629,220.418333,66.583073,1,2
0,0,7,7,12,9,21,34,21,55,0.000333,0.080526,12,2898.929499,161.051639,241.577458,71.548875,2,2
0,0,7,7,12,10,22,34,22,56,0.000333,0.083243,12,2996.738048,166.485447,249.728171,76.238831,2,2
0,0,7,7,12,10,22,34,21,55,0.000333,0.081756,12,2943.224868,163.512493,245.268739,76.238831,2,2
0,0,7,7,12,10,22,34,21,55,0.000333,0.081756,12,2943.224868,163.512493,245.268739,76.238831,2,2
0,0,7,7,12,11,23,34,22,56,0.000333,0.08444,12,3039.833634,168.879646,253.31947,81.073298,2,2
0,0,7,7,12,11,23,34,22,56,0.000333,0.08444,12,3039.833634,168.879646,253.31947,81.073298,2,2
0,0,7,7,12,10,22,34,21,55,0.000333,0.081756,12,2943.224868,163.512493,245.268739,76.238831,2,2
0,0,7,7,12,10,22,34,21,55,0.000333,0.081756,12,2943.224868,163.512493,245.268739,76.238831,2,2
0,0,7,7,12,10,22,34,21,55,0.000333,0.081756,12,2943.224868,163.512493,245.268739,76.238831,2,2
0,0,7,7,12,10,22,34,21,55,0.000333,0.081756,12,2943.224868,163.512493,245.268739,76.238831,2,2
0,0,10,10,13,10,23,46,28,74,0.000333,0.111581,12,4016.923017,223.16239,334.743585,81.324997,2,2
0,0,7,7,12,11,23,34,22,56,0.000333,0.08444,12,3039.833634,168.879646,253.31947,81.073298,2,2
0,0,7,7,12,11,23,34,22,56,0.000333,0.08444,12,3039.833634,168.879646,253.31947,81.073298,2,2
0,0,8,8,14,10,24,36,22,58,0.000333,0.088643,14,3722.989551,206.832753,265.927825,86.52225,2,2
0,0,7,7,12,9,21,34,21,55,0.000333,0.080526,12,2898.929499,161.051639,241.577458,71.548875,2,2
0,0,7,7,14,11,25,39,25,64,0.000333,0.099069,14,4160.895146,231.160841,297.206796,91.356717,2,2
0,0,8,8,13,10,23,34,22,56,0.000333,0.08444,12,3039.833634,168.879646,253.31947,81.324997,1,2
0,0,11,11,14,11,25,47,31,78,0.000333,0.12074,14,5071.090959,281.727276,362.220783,91.356717,2,2
0,0,11,11,13,11,24,46,31,77,0.000333,0.117681,12,4236.505351,235.361408,353.042113,86.159464,2,2
0,0,8,8,11,10,21,37,26,63,0.000333,0.092239,10,2767.159976,153.73111,276.715998,71.273029,1,2
0,0,11,11,12,11,23,52,34,86,0.000333,0.129675,18,7002.473908,389.026328,389.026328,81.073298,1,2
0,0,8,8,12,10,22,38,26,64,0.000333,0.095135,12,3424.843483,190.269082,285.403624,76.238831,1,2
0,0,9,9,12,13,25,39,29,68,0.000333,0.105261,12,3789.386651,210.521481,315.782221,91.125266,1,2
0,0,8,8,11,11,22,37,26,63,0.000333,0.093648,10,2809.44192,156.080107,280.944192,76.107496,1,2
0,0,9,9,13,10,23,42,28,70,0.000333,0.10555,12,3799.792043,211.099558,316.649337,81.324997,1,2
0,0,8,8,12,11,23,38,26,64,0.000333,0.096503,12,3474.095582,193.00531,289.507965,81.073298,1,2
0,0,9,9,12,12,24,46,30,76,0.000333,0.116152,12,4181.485801,232.304767,348.45715,86.0391,1,2
0,0,10,10,12,12,24,38,28,66,0.000333,0.100869,12,3631.290301,201.73835,302.607525,86.0391,1,2
0,0,8,8,11,11,22,37,26,63,0.000333,0.093648,10,2809.44192,156.080107,280.944192,76.107496,1,2
0,0,10,10,11,12,23,43,32,75,0.000333,0.113089,10,3392.671467,188.481748,339.267147,81.073298,1,2
0,0,12,12,11,13,24,49,38,87,0.000333,0.132964,10,3988.917376,221.606521,398.891738,86.159464,1,2
0,0,14,14,11,14,25,55,44,99,0.000333,0.153247,15,6896.126442,383.118136,459.741763,91.356717,1,2
0,0,9,9,12,10,22,41,28,69,0.000333,0.102567,12,3692.40938,205.133854,307.700782,76.238831,1,2
0,0,8,8,12,11,23,38,26,64,0.000333,0.096503,12,3474.095582,193.00531,289.507965,81.073298,1,2
0,0,9,9,12,12,24,43,29,72,0.000333,0.110039,12,3961.407601,220.0782,330.1173,86.0391,1,2
0,0,10,10,12,13,25,50,33,83,0.000333,0.12848,12,4625.280765,256.960043,385.440064,91.125266,1,2
0,0,9,9,11,12,23,45,30,75,0.000333,0.113089,10,3392.671467,188.481748,339.267147,81.073298,1,2
0,0,11,11,11,14,25,52,36,88,0.000333,0.13622,10,4086.593447,227.032969,408.659345,91.356717,1,2
0,0,11,11,12,14,26,44,35,79,0.000333,0.123778,12,4456.016853,247.556492,371.334738,96.322519,1,2
0,0,9,9,11,14,25,37,32,69,0.000333,0.106809,10,3204.260771,178.014487,320.426077,91.356717,1,2
0,0,13,13,14,16,30,69,52,121,0.000333,0.197911,21,12468.409,692.689389,593.733762,117.302969,1,2
0,0,13,13,14,15,29,59,43,102,0.000333,0.165171,14,6937.196861,385.399826,495.514062,111.906328,1,2
0,0,13,13,13,16,29,62,45,107,0.000333,0.173268,12,6237.647598,346.535978,519.803966,112.105716,1,2
0,0,6,6,11,9,20,33,21,54,0.000333,0.077795,10,2333.841171,129.657843,233.384117,66.583073,1,2
0,0,7,7,12,9,21,36,22,58,0.000333,0.084918,12,3057.052926,169.836274,254.754411,71.548875,2,2
0,0,7,7,12,10,22,36,23,59,0.000333,0.087702,12,3157.277586,175.40431,263.106465,76.238831,2,2
0,0,7,7,12,10,22,36,22,58,0.000333,0.086216,12,3103.764407,172.431356,258.647034,76.238831,2,2
0,0,7,7,12,10,22,36,22,58,0.000333,0.086216,12,3103.764407,172.431356,258.647034,76.238831,2,2
0,0,7,7,12,11,23,36,23,59,0.000333,0.088963,12,3202.681865,177.92677,266.890155,81.073298,2,2
0,0,7,7,12,11,23,36,23,59,0.000333,0.088963,12,3202.681865,177.92677,266.890155,81.073298,2,2
0,0,7,7,12,10,22,36,22,58,0.000333,0.086216,12,3103.764407,172.431356,258.647034,76.238831,2,2
0,0,7,7,12,10,22,36,22,58,0.000333,0.086216,12,3103.764407,172.431356,258.647034,76.238831,2,2
0,0,7,7,12,10,22,36,22,58,0.000333,0.086216,12,3103.764407,172.431356,258.647034,76.238831,2,2
0,0,7,7,12,10,22,36,22,58,0.000333,0.086216,12,3103.764407,172.431356,258.647034,76.238831,2,2
0,0,10,10,13,10,23,48,29,77,0.000333,0.116105,12,4179.771247,232.209514,348.314271,81.324997,2,2
0,0,7,7,12,11,23,36,23,59,0.000333,0.088963,12,3202.681865,177.92677,266.890155,81.073298,2,2
0,0,7,7,12,11,23,36,23,59,0.000333,0.088963,12,3202.681865,177.92677,266.890155,81.073298,2,2
0,0,8,8,14,10,24,38,23,61,0.000333,0.093228,14,3915.557976,217.530999,279.682713,86.52225,2,2
0,0,7,7,12,9,21,36,22,58,0.000333,0.084918,12,3057.052926,169.836274,254.754411,71.548875,2,2
0,0,7,7,14,11,25,41,26,67,0.000333,0.103713,14,4355.937106,241.996506,311.138365,91.356717,2,2
0,0,8,8,13,10,23,36,23,59,0.000333,0.088963,12,3202.681865,177.92677,266.890155,81.324997,1,2
0,0,11,11,14,11,25,49,32,81,0.000333,0.125384,14,5266.132919,292.56294,376.152351,91.356717,2,2
0,0,11,11,13,12,25,48,32,80,0.000333,0.123836,12,4458.101942,247.67233,371.508495,91.125266,2,2
0,0,8,8,11,10,21,39,27,66,0.000333,0.096631,10,2898.929499,161.051639,289.89295,71.273029,1,2
0,0,11,11,12,11,23,54,35,89,0.000333,0.134199,18,7246.746254,402.597014,402.597014,81.073298,1,2
0,0,8,8,12,10,22,40,27,67,0.000333,0.099594,12,3585.383021,199.187946,298.781918,76.238831,1,2
0,0,9,9,12,13,25,41,30,71,0.000333,0.109905,12,3956.565474,219.809193,329.713789,91.125266,1,2
0,0,8,8,11,11,22,39,27,66,0.000333,0.098107,10,2943.224868,163.512493,294.322487,76.107496,1,2
0,0,9,9,13,10,23,44,29,73,0.000333,0.110073,12,3962.640274,220.146682,330.220023,81.324997,1,2
0,0,8,8,12,11,23,40,27,67,0.000333,0.101026,12,3636.943813,202.052434,303.078651,81.073298,1,2
0,0,9,9,12,12,24,48,31,79,0.000333,0.120737,12,4346.544451,241.474692,362.212038,86.0391,1,2
0,0,10,10,12,12,24,40,29,69,0.000333,0.105454,12,3796.348951,210.908275,316.362413,86.0391,1,2
0,0,8,8,11,11,22,39,27,66,0.000333,0.098107,10,2943.224868,163.512493,294.322487,76.107496,1,2
0,0,10,10,11,12,23,45,33,78,0.000333,0.117613,10,3528.378326,196.021018,352.837833,81.073298,1,2
0,0,12,12,11,13,24,51,39,90,0.000333,0.137549,15,6189.699376,343.872188,412.646625,86.159464,1,2
0,0,14,14,11,14,25,57,45,102,0.000333,0.157891,15,7105.09997,394.727776,473.673331,91.356717,1,2
0,0,9,9,12,10,22,43,29,72,0.000333,0.107026,12,3852.948919,214.052718,321.079077,76.238831,1,2
0,0,8,8,12,11,23,40,27,67,0.000333,0.101026,12,3636.943813,202.052434,303.078651,81.073298,1,2
0,0,9,9,12,12,24,45,30,75,0.000333,0.114624,12,4126.466251,229.248125,343.872188,86.0391,1,2
0,0,10,10,12,13,25,54,34,88,0.000333,0.13622,12,4903.912136,272.439563,408.659345,91.125266,1,2
0,0,9,9,11,12,23,47,31,78,0.000333,0.117613,10,3528.378326,196.021018,352.837833,81.073298,1,2
0,0,11,11,11,14,25,54,37,91,0.000333,0.140864,10,4225.909133,234.77273,422.590913,91.356717,1,2
0,0,11,11,12,14,26,46,36,82,0.000333,0.128479,12,4625.232683,256.957371,385.436057,96.322519,1,2
0,0,10,10,11,15,26,39,35,74,0.000333,0.115944,10,3478.325391,193.2403,347.832539,96.657107,1,2
0,0,13,13,14,16,30,71,53,124,0.000333,0.202818,21,12777.54311,709.863506,608.454434,117.302969,1,2
0,0,13,13,14,15,29,61,44,105,0.000333,0.170029,14,7141.232063,396.735115,510.088004,111.906328,1,2
0,0,13,13,13,16,29,64,46,110,0.000333,0.178126,12,6412.534914,356.25194,534.377909,112.105716,1,2
0,0,6,6,11,9,20,33,21,54,0.000333,0.077795,10,2333.841171,129.657843,233.384117,66.583073,1,2
0,0,7,7,12,9,21,36,22,58,0.000333,0.084918,12,3057.052926,169.836274,254.754411,71.548875,2,2
0,0,7,7,12,10,22,36,23,59,0.000333,0.087702,12,3157.277586,175.40431,263.106465,76.238831,2,2
0,0,7,7,12,10,22,36,22,58,0.000333,0.086216,12,3103.764407,172.431356,258.647034,76.238831,2,2
0,0,7,7,12,10,22,36,22,58,0.000333,0.086216,12,3103.764407,172.431356,258.647034,76.238831,2,2
0,0,7,7,12,11,23,36,23,59,0.000333,0.088963,12,3202.681865,177.92677,266.890155,81.073298,2,2
0,0,7,7,12,11,23,36,23,59,0.000333,0.088963,12,3202.681865,177.92677,266.890155,81.073298,2,2
0,0,7,7,12,10,22,36,22,58,0.000333,0.086216,12,3103.764407,172.431356,258.647034,76.238831,2,2
0,0,7,7,12,10,22,36,22,58,0.000333,0.086216,12,3103.764407,172.431356,258.647034,76.238831,2,2
0,0,7,7,12,10,22,36,22,58,0.000333,0.086216,12,3103.764407,172.431356,258.647034,76.238831,2,2
0,0,7,7,12,10,22,36,22,58,0.000333,0.086216,12,3103.764407,172.431356,258.647034,76.238831,2,2
0,0,10,10,13,10,23,48,29,77,0.000333,0.116105,12,4179.771247,232.209514,348.314271,81.324997,2,2
0,0,7,7,12,11,23,36,23,59,0.000333,0.088963,12,3202.681865,177.92677,266.890155,81.073298,2,2
0,0,7,7,12,11,23,36,23,59,0.000333,0.088963,12,3202.681865,177.92677,266.890155,81.073298,2,2
0,0,8,8,14,10,24,38,23,61,0.000333,0.093228,14,3915.557976,217.530999,279.682713,86.52225,2,2
0,0,7,7,12,9,21,36,22,58,0.000333,0.084918,12,3057.052926,169.836274,254.754411,71.548875,2,2
0,0,7,7,14,11,25,41,26,67,0.000333,0.103713,14,4355.937106,241.996506,311.138365,91.356717,2,2
0,0,8,8,13,10,23,36,23,59,0.000333,0.088963,12,3202.681865,177.92677,266.890155,81.324997,1,2
0,0,11,11,14,11,25,49,32,81,0.000333,0.125384,14,5266.132919,292.56294,376.152351,91.356717,2,2
0,0,11,11,13,11,24,48,32,80,0.000333,0.122266,12,4401.564001,244.531333,366.797,86.159464,2,2
0,0,8,8,11,10,21,39,27,66,0.000333,0.096631,10,2898.929499,161.051639,289.89295,71.273029,1,2
0,0,11,11,12,11,23,54,35,89,0.000333,0.134199,18,7246.746254,402.597014,402.597014,81.073298,1,2
0,0,8,8,12,10,22,40,27,67,0.000333,0.099594,12,3585.383021,199.187946,298.781918,76.238831,1,2
0,0,9,9,12,13,25,41,30,71,0.000333,0.109905,12,3956.565474,219.809193,329.713789,91.125266,1,2
0,0,8,8,11,11,22,39,27,66,0.000333,0.098107,10,2943.224868,163.512493,294.322487,76.107496,1,2
0,0,9,9,13,10,23,44,29,73,0.000333,0.110073,12,3962.640274,220.146682,330.220023,81.324997,1,2
0,0,8,8,12,11,23,40,27,67,0.000333,0.101026,12,3636.943813,202.052434,303.078651,81.073298,1,2
0,0,9,9,12,12,24,48,31,79,0.000333,0.120737,12,4346.544451,241.474692,362.212038,86.0391,1,2
0,0,10,10,12,12,24,40,29,69,0.000333,0.105454,12,3796.348951,210.908275,316.362413,86.0391,1,2
0,0,8,8,11,11,22,39,27,66,0.000333,0.098107,10,2943.224868,163.512493,294.322487,76.107496,1,2
0,0,8,8,11,12,23,39,27,66,0.000333,0.099518,10,2985.550891,165.863938,298.555089,81.073298,1,2
0,0,8,8,11,12,23,37,27,64,0.000333,0.096503,10,2895.079652,160.837758,289.507965,81.073298,1,2
0,0,8,8,11,12,23,39,27,66,0.000333,0.099518,10,2985.550891,165.863938,298.555089,81.073298,1,2
0,0,10,10,12,10,22,47,32,79,0.000333,0.117432,18,6341.311762,352.295098,352.295098,76.238831,1,2
0,0,8,8,12,11,23,40,27,67,0.000333,0.101026,12,3636.943813,202.052434,303.078651,81.073298,1,2
0,0,9,9,12,12,24,45,30,75,0.000333,0.114624,12,4126.466251,229.248125,343.872188,86.0391,1,2
0,0,10,10,12,13,25,54,34,88,0.000333,0.13622,12,4903.912136,272.439563,408.659345,91.125266,1,2
0,0,9,9,11,12,23,47,31,78,0.000333,0.117613,10,3528.378326,196.021018,352.837833,81.073298,1,2
0,0,11,11,11,14,25,54,37,91,0.000333,0.140864,10,4225.909133,234.77273,422.590913,91.356717,1,2
0,0,11,11,12,14,26,46,36,82,0.000333,0.128479,12,4625.232683,256.957371,385.436057,96.322519,1,2
0,0,10,10,11,15,26,39,35,74,0.000333,0.115944,10,3478.325391,193.2403,347.832539,96.657107,1,2
0,0,13,13,14,16,30,71,53,124,0.000333,0.202818,21,12777.54311,709.863506,608.454434,117.302969,1,2
0,0,13,13,14,15,29,61,44,105,0.000333,0.170029,14,7141.232063,396.735115,510.088004,111.906328,1,2
0,0,13,13,13,16,29,64,46,110,0.000333,0.178126,12,6412.534914,356.25194,534.377909,112.105716,1,2
0,0,6,6,10,9,19,29,20,49,0.000333,0.069383,10,2081.484482,115.638027,208.148448,61.748606,1,2
0,0,6,6,10,9,19,29,20,49,0.000333,0.069383,10,2081.484482,115.638027,208.148448,61.748606,1,2
0,0,6,6,10,9,19,29,20,49,0.000333,0.069383,10,2081.484482,115.638027,208.148448,61.748606,1,2
0,0,6,6,10,9,19,29,20,49,0.000333,0.069383,10,2081.484482,115.638027,208.148448,61.748606,1,2
0,0,6,6,10,9,19,29,20,49,0.000333,0.069383,10,2081.484482,115.638027,208.148448,61.748606,1,2
0,0,6,6,10,9,19,29,20,49,0.000333,0.069383,10,2081.484482,115.638027,208.148448,61.748606,1,2
0,0,6,6,10,9,19,29,20,49,0.000333,0.069383,10,2081.484482,115.638027,208.148448,61.748606,1,2
0,0,6,6,10,9,19,29,20,49,0.000333,0.069383,10,2081.484482,115.638027,208.148448,61.748606,1,2
0,0,6,6,10,9,19,29,20,49,0.000333,0.069383,10,2081.484482,115.638027,208.148448,61.748606,1,2
0,0,6,6,10,9,19,29,20,49,0.000333,0.069383,10,2081.484482,115.638027,208.148448,61.748606,1,2
0,0,6,6,10,9,19,29,20,49,0.000333,0.069383,10,2081.484482,115.638027,208.148448,61.748606,1,2
0,0,6,6,10,9,19,29,20,49,0.000333,0.069383,10,2081.484482,115.638027,208.148448,61.748606,1,2
0,0,6,6,10,9,19,29,20,49,0.000333,0.069383,10,2081.484482,115.638027,208.148448,61.748606,1,2
0,0,6,6,10,9,19,29,20,49,0.000333,0.069383,10,2081.484482,115.638027,208.148448,61.748606,1,2
0,0,6,6,10,9,19,29,20,49,0.000333,0.069383,10,2081.484482,115.638027,208.148448,61.748606,1,2
0,0,6,6,10,9,19,29,20,49,0.000333,0.069383,10,2081.484482,115.638027,208.148448,61.748606,1,2
0,0,6,6,10,9,19,29,20,49,0.000333,0.069383,10,2081.484482,115.638027,208.148448,61.748606,1,2
0,0,6,6,10,9,19,29,20,49,0.000333,0.069383,10,2081.484482,115.638027,208.148448,61.748606,1,2
0,0,10,10,12,10,22,44,31,75,0.000333,0.111486,18,6020.232685,334.457371,334.457371,76.238831,1,2
0,0,10,10,11,10,21,43,31,74,0.000333,0.108344,15,4875.472339,270.859574,325.031489,71.273029,1,2
0,0,8,8,10,10,20,35,26,61,0.000333,0.087879,10,2636.376138,146.465341,263.637614,66.438562,1,2
0,0,7,7,11,10,21,36,24,60,0.000333,0.087846,10,2635.390454,146.410581,263.539045,71.273029,1,2
0,0,8,8,11,10,21,36,26,62,0.000333,0.090775,10,2723.236802,151.290933,272.32368,71.273029,1,2
0,0,9,9,11,13,24,37,29,66,0.000333,0.100869,10,3026.07525,168.115292,302.607525,86.159464,1,2
0,0,8,8,10,11,21,35,26,61,0.000333,0.08931,10,2679.313628,148.850757,267.931363,71.273029,1,2
0,0,10,10,12,10,22,44,31,75,0.000333,0.111486,18,6020.232685,334.457371,334.457371,76.238831,1,2
0,0,10,10,11,11,22,44,31,75,0.000333,0.111486,10,3344.573714,185.809651,334.457371,76.107496,1,2
0,0,9,9,11,12,23,44,30,74,0.000333,0.111581,10,3347.435847,185.968658,334.743585,81.073298,1,2
0,0,10,10,11,12,23,36,28,64,0.000333,0.096503,10,2895.079652,160.837758,289.507965,81.073298,1,2
0,0,8,8,10,11,21,35,26,61,0.000333,0.08931,10,2679.313628,148.850757,267.931363,71.273029,1,2
0,0,8,8,10,12,22,35,26,61,0.000333,0.090675,10,2720.253287,151.125183,272.025329,76.238831,1,2
0,0,8,8,10,12,22,35,26,61,0.000333,0.090675,10,2720.253287,151.125183,272.025329,76.238831,1,2
0,0,8,8,10,12,22,35,26,61,0.000333,0.090675,10,2720.253287,151.125183,272.025329,76.238831,1,2
0,0,10,10,11,10,21,43,31,74,0.000333,0.108344,15,4875.472339,270.859574,325.031489,71.273029,1,2
0,0,9,9,11,11,22,40,28,68,0.000333,0.10108,10,3032.413501,168.467417,303.24135,76.107496,1,2
0,0,9,9,11,12,23,41,29,70,0.000333,0.10555,10,3166.493369,175.916298,316.649337,81.073298,1,2
0,0,10,10,11,13,24,50,33,83,0.000333,0.126851,10,3805.518876,211.417715,380.551888,86.159464,1,2
0,0,9,9,10,12,22,43,30,73,0.000333,0.108513,10,3255.385082,180.854727,325.538508,76.238831,1,2
0,0,11,11,10,14,24,50,36,86,0.000333,0.131436,10,3943.067751,219.059319,394.306775,86.52225,1,2
0,0,11,11,11,14,25,42,35,77,0.000333,0.119192,10,3575.769266,198.653848,357.576927,91.356717,1,2
0,0,10,10,10,15,25,35,34,69,0.000333,0.106809,10,3204.260771,178.014487,320.426077,91.82264,1,2
0,0,13,13,13,16,29,67,52,119,0.000333,0.1927,18,10405.79529,578.099738,578.099738,112.105716,1,2
0,0,13,13,13,18,31,59,44,103,0.000333,0.170094,12,6123.38664,340.188147,510.28222,123.164366,1,2
0,0,13,13,13,18,31,59,44,103,0.000333,0.170094,12,6123.38664,340.188147,510.28222,123.164366,1,2
0,0,7,7,12,9,21,33,23,56,0.000333,0.08199,12,2951.637308,163.97985,245.969776,71.548875,1,2
0,0,8,8,13,10,23,37,25,62,0.000333,0.093487,12,3365.530095,186.973894,280.460841,81.324997,1,2
0,0,8,8,12,10,22,36,25,61,0.000333,0.090675,12,3264.303945,181.350219,272.025329,76.238831,1,2
0,0,12,12,14,16,30,64,49,113,0.000333,0.184826,21,11644.05138,646.891744,554.478637,117.302969,1,2
0,0,12,12,14,14,28,54,40,94,0.000333,0.15063,14,6326.479077,351.47106,451.891363,106.605938,1,2
0,0,12,12,13,14,27,57,42,99,0.000333,0.156911,18,8473.209529,470.733863,470.733863,101.408685,1,2
0,0,6,6,10,9,19,29,20,49,0.000333,0.069383,10,2081.484482,115.638027,208.148448,61.748606,1,2
0,0,6,6,10,9,19,29,20,49,0.000333,0.069383,10,2081.484482,115.638027,208.148448,61.748606,1,2
0,0,6,6,10,9,19,29,20,49,0.000333,0.069383,10,2081.484482,115.638027,208.148448,61.748606,1,2
0,0,6,6,10,9,19,29,20,49,0.000333,0.069383,10,2081.484482,115.638027,208.148448,61.748606,1,2
0,0,6,6,10,9,19,29,20,49,0.000333,0.069383,10,2081.484482,115.638027,208.148448,61.748606,1,2
0,0,6,6,10,9,19,29,20,49,0.000333,0.069383,10,2081.484482,115.638027,208.148448,61.748606,1,2
0,0,7,7,11,11,22,32,22,54,0.000333,0.08027,10,2408.093074,133.782949,240.809307,76.107496,2,2
0,0,6,6,10,9,19,29,20,49,0.000333,0.069383,10,2081.484482,115.638027,208.148448,61.748606,1,2
0,0,6,6,11,10,21,31,21,52,0.000333,0.076134,10,2284.00506,126.88917,228.400506,71.273029,1,2
0,0,6,6,10,9,19,29,20,49,0.000333,0.069383,10,2081.484482,115.638027,208.148448,61.748606,1,2
0,0,6,6,10,9,19,29,20,49,0.000333,0.069383,10,2081.484482,115.638027,208.148448,61.748606,1,2
0,0,6,6,10,9,19,29,20,49,0.000333,0.069383,10,2081.484482,115.638027,208.148448,61.748606,1,2
0,0,6,6,10,9,19,29,20,49,0.000333,0.069383,10,2081.484482,115.638027,208.148448,61.748606,1,2
0,0,6,6,10,9,19,29,20,49,0.000333,0.069383,10,2081.484482,115.638027,208.148448,61.748606,1,2
0,0,6,6,10,9,19,29,20,49,0.000333,0.069383,10,2081.484482,115.638027,208.148448,61.748606,1,2
0,0,6,6,10,9,19,29,20,49,0.000333,0.069383,10,2081.484482,115.638027,208.148448,61.748606,1,2
0,0,6,6,10,9,19,29,20,49,0.000333,0.069383,10,2081.484482,115.638027,208.148448,61.748606,1,2
0,0,6,6,10,9,19,29,20,49,0.000333,0.069383,10,2081.484482,115.638027,208.148448,61.748606,1,2
0,0,10,10,12,10,22,44,31,75,0.000333,0.111486,18,6020.232685,334.457371,334.457371,76.238831,1,2
0,0,10,10,12,10,22,44,31,75,0.000333,0.111486,18,6020.232685,334.457371,334.457371,76.238831,1,2
0,0,8,8,10,10,20,35,26,61,0.000333,0.087879,10,2636.376138,146.465341,263.637614,66.438562,1,2
0,0,7,7,11,10,21,36,24,60,0.000333,0.087846,10,2635.390454,146.410581,263.539045,71.273029,1,2
0,0,7,7,11,10,21,34,24,58,0.000333,0.084918,10,2547.544105,141.530228,254.754411,71.273029,1,2
0,0,9,9,11,13,24,36,29,65,0.000333,0.099341,10,2980.225625,165.56809,298.022563,86.159464,1,2
0,0,8,8,10,11,21,35,26,61,0.000333,0.08931,10,2679.313628,148.850757,267.931363,71.273029,1,2
0,0,10,10,12,10,22,44,31,75,0.000333,0.111486,18,6020.232685,334.457371,334.457371,76.238831,1,2
0,0,9,9,11,11,22,39,28,67,0.000333,0.099594,10,2987.819184,165.989955,298.781918,76.107496,1,2
0,0,9,9,12,12,24,45,30,75,0.000333,0.114624,12,4126.466251,229.248125,343.872188,86.0391,1,2
0,0,10,10,11,12,23,36,28,64,0.000333,0.096503,10,2895.079652,160.837758,289.507965,81.073298,1,2
0,0,8,8,10,11,21,35,26,61,0.000333,0.08931,10,2679.313628,148.850757,267.931363,71.273029,1,2
0,0,8,8,10,12,22,35,26,61,0.000333,0.090675,10,2720.253287,151.125183,272.025329,76.238831,1,2
0,0,8,8,10,12,22,35,26,61,0.000333,0.090675,10,2720.253287,151.125183,272.025329,76.238831,1,2
0,0,8,8,10,12,22,35,26,61,0.000333,0.090675,10,2720.253287,151.125183,272.025329,76.238831,1,2
0,0,10,10,11,10,21,43,31,74,0.000333,0.108344,15,4875.472339,270.859574,325.031489,71.273029,1,2
0,0,9,9,11,11,22,40,28,68,0.000333,0.10108,10,3032.413501,168.467417,303.24135,76.107496,1,2
0,0,9,9,11,12,23,41,29,70,0.000333,0.10555,10,3166.493369,175.916298,316.649337,81.073298,1,2
0,0,10,10,11,13,24,50,33,83,0.000333,0.126851,10,3805.518876,211.417715,380.551888,86.159464,1,2
0,0,9,9,10,12,22,43,30,73,0.000333,0.108513,10,3255.385082,180.854727,325.538508,76.238831,1,2
0,0,11,11,10,14,24,50,36,86,0.000333,0.131436,10,3943.067751,219.059319,394.306775,86.52225,1,2
0,0,11,11,11,14,25,42,35,77,0.000333,0.119192,10,3575.769266,198.653848,357.576927,91.356717,1,2
0,0,10,10,10,15,25,36,34,70,0.000333,0.108357,10,3250.699333,180.594407,325.069933,91.82264,1,2
0,0,13,13,13,16,29,67,52,119,0.000333,0.1927,18,10405.79529,578.099738,578.099738,112.105716,1,2
0,0,13,13,13,15,28,57,43,100,0.000333,0.160245,12,5768.825906,320.490328,480.735492,106.709075,1,2
0,0,13,13,12,16,28,60,45,105,0.000333,0.168257,12,6057.267202,336.514845,504.772267,107.01955,1,2
0,0,6,6,11,9,20,31,20,51,0.000333,0.073473,10,2204.183328,122.454629,220.418333,66.583073,1,2
0,0,6,6,11,9,20,31,20,51,0.000333,0.073473,10,2204.183328,122.454629,220.418333,66.583073,1,2
0,0,6,6,11,9,20,31,20,51,0.000333,0.073473,10,2204.183328,122.454629,220.418333,66.583073,1,2
0,0,6,6,11,9,20,31,20,51,0.000333,0.073473,10,2204.183328,122.454629,220.418333,66.583073,1,2
0,0,6,6,11,9,20,31,20,51,0.000333,0.073473,10,2204.183328,122.454629,220.418333,66.583073,1,2
0,0,6,6,11,9,20,31,20,51,0.000333,0.073473,10,2204.183328,122.454629,220.418333,66.583073,1,2
0,0,6,6,11,9,20,31,20,51,0.000333,0.073473,10,2204.183328,122.454629,220.418333,66.583073,1,2
0,0,6,6,11,9,20,31,20,51,0.000333,0.073473,10,2204.183328,122.454629,220.418333,66.583073,1,2
0,0,6,6,11,9,20,31,20,51,0.000333,0.073473,10,2204.183328,122.454629,220.418333,66.583073,1,2
0,0,6,6,11,9,20,31,20,51,0.000333,0.073473,10,2204.183328,122.454629,220.418333,66.583073,1,2
0,0,6,6,11,9,20,31,20,51,0.000333,0.073473,10,2204.183328,122.454629,220.418333,66.583073,1,2
0,0,6,6,11,9,20,31,20,51,0.000333,0.073473,10,2204.183328,122.454629,220.418333,66.583073,1,2
0,0,8,8,13,14,27,35,27,62,0.000333,0.098268,6,1768.818151,98.267675,294.803025,101.408685,4,2
0,0,8,8,12,14,26,34,27,61,0.000333,0.095576,6,1720.360937,95.575608,286.726823,96.322519,4,2
0,0,9,9,13,17,30,39,32,71,0.000333,0.11613,6,2090.335394,116.129744,348.389232,117.592585,4,2
0,0,8,8,13,16,29,35,28,63,0.000333,0.102018,6,1836.316816,102.017601,306.052803,112.105716,4,2
0,0,9,9,13,17,30,40,33,73,0.000333,0.119401,6,2149.218081,119.401004,358.203013,117.592585,4,2
0,0,5,5,11,9,20,27,19,46,0.000333,0.06627,10,1988.086924,110.449274,198.808692,66.583073,1,2
0,0,5,5,12,10,22,28,19,47,0.000333,0.069864,6,1257.559716,69.864429,209.593286,76.238831,1,2
0,0,6,6,11,11,22,29,21,50,0.000333,0.074324,5,1114.857905,61.93655,222.971581,76.107496,1,2
0,0,10,10,13,15,28,58,45,103,0.000333,0.165053,18,8912.836025,495.157557,495.157557,106.709075,1,2
0,0,10,10,13,14,27,48,36,84,0.000333,0.133137,12,4792.926602,266.2737,399.41055,101.408685,1,2
0,0,10,10,12,15,27,51,38,89,0.000333,0.141062,12,5078.219852,282.123325,423.184988,101.622909,1,2
0,0,5,5,11,10,21,37,23,60,0.000333,0.087846,10,2635.390454,146.410581,263.539045,71.273029,1,2
0,0,5,5,12,11,23,38,23,61,0.000333,0.091979,12,3311.247352,183.958186,275.937279,81.073298,1,2
0,0,5,5,11,11,22,37,23,60,0.000333,0.089189,10,2675.658971,148.647721,267.565897,76.107496,1,2
0,0,10,10,13,16,29,68,49,117,0.000333,0.189461,18,10230.90798,568.383776,568.383776,112.105716,1,2
0,0,10,10,13,15,28,58,40,98,0.000333,0.15704,12,5653.449388,314.080522,471.120782,106.709075,1,2
0,0,10,10,12,16,28,61,42,103,0.000333,0.165053,12,5941.890684,330.105038,495.157557,107.01955,1,2
0,0,5,5,11,10,21,37,23,60,0.000333,0.087846,10,2635.390454,146.410581,263.539045,71.273029,1,2
0,0,5,5,12,11,23,38,23,61,0.000333,0.091979,12,3311.247352,183.958186,275.937279,81.073298,1,2
0,0,5,5,11,11,22,38,23,61,0.000333,0.090675,10,2720.253287,151.125183,272.025329,76.107496,1,2
0,0,10,10,13,16,29,68,49,117,0.000333,0.189461,18,10230.90798,568.383776,568.383776,112.105716,1,2
0,0,10,10,13,15,28,58,40,98,0.000333,0.15704,12,5653.449388,314.080522,471.120782,106.709075,1,2
0,0,10,10,12,16,28,61,42,103,0.000333,0.165053,12,5941.890684,330.105038,495.157557,107.01955,1,2
0,0,5,5,11,10,21,31,22,53,0.000333,0.077598,10,2327.928234,129.329346,232.792823,71.273029,1,2
0,0,5,5,12,11,23,32,22,54,0.000333,0.081424,12,2931.268148,162.84823,244.272346,81.073298,1,2
0,0,5,5,11,11,22,31,22,53,0.000333,0.078783,10,2363.498758,131.305487,236.349876,76.107496,1,2
0,0,10,10,13,16,29,62,48,110,0.000333,0.178126,18,9618.80237,534.377909,534.377909,112.105716,1,2
0,0,10,10,13,15,28,52,39,91,0.000333,0.145823,12,5249.631575,291.646199,437.469298,106.709075,1,2
0,0,10,10,12,16,28,55,41,96,0.000333,0.153835,12,5538.07287,307.670715,461.506073,107.01955,1,2
0,0,5,5,11,9,20,27,19,46,0.000333,0.06627,10,1988.086924,110.449274,198.808692,66.583073,1,2
0,0,5,5,12,10,22,28,19,47,0.000333,0.069864,6,1257.559716,69.864429,209.593286,76.238831,1,2
0,0,5,5,11,10,21,27,19,46,0.000333,0.067349,5,1010.233007,56.124056,202.046601,71.273029,1,2
0,0,10,10,13,15,28,58,45,103,0.000333,0.165053,18,8912.836025,495.157557,495.157557,106.709075,1,2
0,0,10,10,13,14,27,48,36,84,0.000333,0.133137,12,4792.926602,266.2737,399.41055,101.408685,1,2
0,0,10,10,12,15,27,51,38,89,0.000333,0.141062,12,5078.219852,282.123325,423.184988,101.622909,1,2
0,0,5,5,11,10,21,37,23,60,0.000333,0.087846,10,2635.390454,146.410581,263.539045,71.273029,1,2
0,0,5,5,12,11,23,38,23,61,0.000333,0.091979,12,3311.247352,183.958186,275.937279,81.073298,1,2
0,0,5,5,11,11,22,38,23,61,0.000333,0.090675,10,2720.253287,151.125183,272.025329,76.107496,1,2
0,0,10,10,13,16,29,68,49,117,0.000333,0.189461,18,10230.90798,568.383776,568.383776,112.105716,1,2
0,0,10,10,13,15,28,58,40,98,0.000333,0.15704,12,5653.449388,314.080522,471.120782,106.709075,1,2
0,0,10,10,12,16,28,61,42,103,0.000333,0.165053,12,5941.890684,330.105038,495.157557,107.01955,1,2
0,0,5,5,11,10,21,37,23,60,0.000333,0.087846,10,2635.390454,146.410581,263.539045,71.273029,1,2
0,0,5,5,12,11,23,38,23,61,0.000333,0.091979,12,3311.247352,183.958186,275.937279,81.073298,1,2
0,0,5,5,11,11,22,38,23,61,0.000333,0.090675,10,2720.253287,151.125183,272.025329,76.107496,1,2
0,0,10,10,13,16,29,68,49,117,0.000333,0.189461,18,10230.90798,568.383776,568.383776,112.105716,1,2
0,0,10,10,13,15,28,58,40,98,0.000333,0.15704,12,5653.449388,314.080522,471.120782,106.709075,1,2
0,0,10,10,12,16,28,61,42,103,0.000333,0.165053,12,5941.890684,330.105038,495.157557,107.01955,1,2
0,0,5,5,11,10,21,31,22,53,0.000333,0.077598,10,2327.928234,129.329346,232.792823,71.273029,1,2
0,0,5,5,12,11,23,32,22,54,0.000333,0.081424,12,2931.268148,162.84823,244.272346,81.073298,1,2
0,0,5,5,11,11,22,32,22,54,0.000333,0.08027,10,2408.093074,133.782949,240.809307,76.107496,1,2
0,0,10,10,13,16,29,62,48,110,0.000333,0.178126,18,9618.80237,534.377909,534.377909,112.105716,1,2
0,0,10,10,13,15,28,52,39,91,0.000333,0.145823,12,5249.631575,291.646199,437.469298,106.709075,1,2
0,0,10,10,12,16,28,55,41,96,0.000333,0.153835,12,5538.07287,307.670715,461.506073,107.01955,1,2
0,0,7,7,11,10,21,41,26,67,0.000333,0.098095,10,2942.852673,163.491815,294.285267,71.273029,1,2
0,0,8,8,12,12,24,46,30,76,0.000333,0.116152,12,4181.485801,232.304767,348.45715,86.0391,1,2
0,0,8,8,11,12,23,45,28,73,0.000333,0.110073,10,3302.200228,183.455568,330.220023,81.073298,1,2
0,0,12,12,13,16,29,72,52,124,0.000333,0.200797,18,10843.01358,602.389643,602.389643,112.105716,1,2
0,0,13,13,13,16,29,66,45,111,0.000333,0.179745,12,6470.830686,359.490594,539.23589,112.105716,1,2
0,0,13,13,12,16,28,69,47,116,0.000333,0.185884,12,6691.838052,371.768781,557.653171,107.01955,1,2
0,0,7,7,11,10,21,41,26,67,0.000333,0.098095,10,2942.852673,163.491815,294.285267,71.273029,1,2
0,0,8,8,12,12,24,46,28,74,0.000333,0.113096,12,4071.446701,226.191483,339.287225,86.0391,1,2
0,0,8,8,11,12,23,45,28,73,0.000333,0.110073,10,3302.200228,183.455568,330.220023,81.073298,1,2
0,0,13,13,13,17,30,76,54,130,0.000333,0.212632,18,11482.12399,637.895777,637.895777,117.592585,1,2
0,0,13,13,13,16,29,66,45,111,0.000333,0.179745,12,6470.830686,359.490594,539.23589,112.105716,1,2
0,0,13,13,12,16,28,69,47,116,0.000333,0.185884,12,6691.838052,371.768781,557.653171,107.01955,1,2
0,0,7,7,11,10,21,37,25,62,0.000333,0.090775,10,2723.236802,151.290933,272.32368,71.273029,1,2
0,0,8,8,12,12,24,42,27,69,0.000333,0.105454,12,3796.348951,210.908275,316.362413,86.0391,1,2
0,0,8,8,11,12,23,41,27,68,0.000333,0.102534,10,3076.02213,170.890118,307.602213,81.073298,1,2
0,0,13,13,13,17,30,72,53,125,0.000333,0.204454,18,11040.50384,613.361324,613.361324,117.592585,1,2
0,0,13,13,13,16,29,62,44,106,0.000333,0.171649,12,6179.351826,343.297324,514.945985,112.105716,1,2
0,0,13,13,12,16,28,65,46,111,0.000333,0.177872,12,6403.396756,355.744264,533.616396,107.01955,1,2
0,0,7,7,11,10,21,38,26,64,0.000333,0.093703,10,2811.083151,156.171286,281.108315,71.273029,1,2
0,0,8,8,12,12,24,43,28,71,0.000333,0.108511,12,3906.388051,217.021558,325.532338,86.0391,1,2
0,0,8,8,11,12,23,42,28,70,0.000333,0.10555,10,3166.493369,175.916298,316.649337,81.073298,1,2
0,0,13,13,13,17,30,73,54,127,0.000333,0.207725,18,11217.1519,623.175106,623.175106,117.592585,1,2
0,0,13,13,13,16,29,63,45,108,0.000333,0.174887,12,6295.94337,349.774632,524.661947,112.105716,1,2
0,0,13,13,12,16,28,66,47,113,0.000333,0.181077,12,6518.773274,362.154071,543.231106,107.01955,1,2
0,0,7,7,12,10,22,39,25,64,0.000333,0.095135,12,3424.843483,190.269082,285.403624,76.238831,1,2
0,0,8,8,13,12,25,44,27,71,0.000333,0.109905,12,3956.565474,219.809193,329.713789,91.125266,1,2
0,0,8,8,12,12,24,43,27,70,0.000333,0.106982,12,3851.368501,213.964917,320.947375,86.0391,1,2
0,0,13,13,14,17,31,74,53,127,0.000333,0.209728,21,13212.84156,734.046753,629.182931,122.789837,1,2
0,0,13,13,14,16,30,64,44,108,0.000333,0.176648,14,7419.218581,412.17881,529.944184,117.302969,1,2
0,0,13,13,13,16,29,67,46,113,0.000333,0.182984,12,6587.422229,365.967902,548.951852,112.105716,1,2
0,0,5,5,12,10,22,33,26,59,0.000333,0.087702,12,3157.277586,175.40431,263.106465,76.238831,1,2
0,0,5,5,13,11,24,34,25,59,0.000333,0.090171,12,3246.153451,180.341858,270.512788,86.159464,1,2
0,0,5,5,12,11,23,33,25,58,0.000333,0.087456,12,3148.399121,174.911062,262.366593,81.073298,1,2
0,0,10,10,14,17,31,64,53,117,0.000333,0.193214,21,12172.46034,676.247796,579.640968,122.789837,1,2
0,0,10,10,14,15,29,54,44,98,0.000333,0.158694,14,6665.149925,370.286107,476.082138,111.906328,1,2
0,0,10,10,13,16,29,57,46,103,0.000333,0.166791,12,6004.46451,333.581362,500.372042,112.105716,1,2
0,0,5,5,12,10,22,33,26,59,0.000333,0.087702,12,3157.277586,175.40431,263.106465,76.238831,1,2
0,0,5,5,13,11,24,34,25,59,0.000333,0.090171,12,3246.153451,180.341858,270.512788,86.159464,1,2
0,0,5,5,12,11,23,34,25,59,0.000333,0.088963,12,3202.681865,177.92677,266.890155,81.073298,1,2
0,0,10,10,14,17,31,64,53,117,0.000333,0.193214,21,12172.46034,676.247796,579.640968,122.789837,1,2
0,0,10,10,14,15,29,54,44,98,0.000333,0.158694,14,6665.149925,370.286107,476.082138,111.906328,1,2
0,0,10,10,13,16,29,57,46,103,0.000333,0.166791,12,6004.46451,333.581362,500.372042,112.105716,1,2
0,0,5,5,12,9,21,33,20,53,0.000333,0.077598,12,2793.513881,155.195216,232.792823,71.548875,1,2
0,0,5,5,13,10,23,34,20,54,0.000333,0.081424,12,2931.268148,162.84823,244.272346,81.324997,1,2
0,0,6,6,12,10,22,36,22,58,0.000333,0.086216,12,3103.764407,172.431356,258.647034,76.238831,1,2
0,0,10,10,14,16,30,64,46,110,0.000333,0.179919,14,7556.611517,419.811751,539.757966,117.302969,1,2
0,0,10,10,14,14,28,54,37,91,0.000333,0.145823,14,6124.570171,340.253898,437.469298,106.605938,1,2
0,0,10,10,13,14,27,57,39,96,0.000333,0.152156,12,5477.630402,304.3128,456.4692,101.408685,1,2
0,0,5,5,12,9,21,33,20,53,0.000333,0.077598,12,2793.513881,155.195216,232.792823,71.548875,1,2
0,0,5,5,13,10,23,34,20,54,0.000333,0.081424,12,2931.268148,162.84823,244.272346,81.324997,1,2
0,0,5,5,12,10,22,33,20,53,0.000333,0.078783,12,2836.198509,157.566584,236.349876,76.238831,1,2
0,0,10,10,14,16,30,64,46,110,0.000333,0.179919,14,7556.611517,419.811751,539.757966,117.302969,1,2
0,0,10,10,14,14,28,54,37,91,0.000333,0.145823,14,6124.570171,340.253898,437.469298,106.605938,1,2
0,0,10,10,13,14,27,57,39,96,0.000333,0.152156,12,5477.630402,304.3128,456.4692,101.408685,1,2
0,0,8,8,14,12,26,48,32,80,0.000333,0.125345,14,5264.492484,292.471805,376.035177,96.322519,2,2
0,0,8,8,15,13,28,49,32,81,0.000333,0.129799,14,5451.540482,302.86336,389.395749,106.709075,2,2
0,0,8,8,14,13,27,48,32,80,0.000333,0.126797,14,5325.474002,295.859667,380.391,101.408685,2,2
0,0,13,13,14,19,33,79,58,137,0.000333,0.230361,21,14512.72188,806.262327,691.081994,134.013592,2,2
0,0,13,13,14,17,31,69,49,118,0.000333,0.194865,14,8184.332305,454.685128,584.595165,122.789837,2,2
0,0,13,13,14,18,32,72,51,123,0.000333,0.205,14,8610,478.333333,615,128.361619,2,2
0,0,8,8,14,12,26,48,32,80,0.000333,0.125345,14,5264.492484,292.471805,376.035177,96.322519,2,2
0,0,8,8,15,13,28,49,32,81,0.000333,0.129799,14,5451.540482,302.86336,389.395749,106.709075,2,2
0,0,8,8,14,13,27,48,32,80,0.000333,0.126797,14,5325.474002,295.859667,380.391,101.408685,2,2
0,0,13,13,14,19,33,79,58,137,0.000333,0.230361,21,14512.72188,806.262327,691.081994,134.013592,2,2
0,0,13,13,14,17,31,69,49,118,0.000333,0.194865,14,8184.332305,454.685128,584.595165,122.789837,2,2
0,0,13,13,14,18,32,72,51,123,0.000333,0.205,14,8610,478.333333,615,128.361619,2,2
0,0,7,7,11,10,21,41,26,67,0.000333,0.098095,10,2942.852673,163.491815,294.285267,71.273029,1,2
0,0,8,8,12,12,24,46,28,74,0.000333,0.113096,12,4071.446701,226.191483,339.287225,86.0391,1,2
0,0,8,8,11,12,23,45,28,73,0.000333,0.110073,10,3302.200228,183.455568,330.220023,81.073298,1,2
0,0,13,13,13,17,30,76,54,130,0.000333,0.212632,18,11482.12399,637.895777,637.895777,117.592585,1,2
0,0,13,13,13,16,29,66,45,111,0.000333,0.179745,12,6470.830686,359.490594,539.23589,112.105716,1,2
0,0,13,13,12,15,27,69,47,116,0.000333,0.183856,18,9928.205105,551.56695,551.56695,101.622909,1,2
0,0,7,7,11,10,21,41,26,67,0.000333,0.098095,10,2942.852673,163.491815,294.285267,71.273029,1,2
0,0,8,8,12,12,24,46,28,74,0.000333,0.113096,12,4071.446701,226.191483,339.287225,86.0391,1,2
0,0,8,8,11,12,23,45,28,73,0.000333,0.110073,10,3302.200228,183.455568,330.220023,81.073298,1,2
0,0,13,13,13,17,30,76,54,130,0.000333,0.212632,18,11482.12399,637.895777,637.895777,117.592585,1,2
0,0,13,13,13,16,29,66,45,111,0.000333,0.179745,12,6470.830686,359.490594,539.23589,112.105716,1,2
0,0,13,13,12,16,28,69,47,116,0.000333,0.185884,12,6691.838052,371.768781,557.653171,107.01955,1,2
0,0,7,7,11,10,21,37,25,62,0.000333,0.090775,10,2723.236802,151.290933,272.32368,71.273029,1,2
0,0,8,8,12,12,24,42,27,69,0.000333,0.105454,12,3796.348951,210.908275,316.362413,86.0391,1,2
0,0,8,8,11,12,23,41,27,68,0.000333,0.102534,10,3076.02213,170.890118,307.602213,81.073298,1,2
0,0,13,13,13,17,30,72,53,125,0.000333,0.204454,18,11040.50384,613.361324,613.361324,117.592585,1,2
0,0,13,13,13,16,29,62,44,106,0.000333,0.171649,12,6179.351826,343.297324,514.945985,112.105716,1,2
0,0,13,13,12,16,28,65,46,111,0.000333,0.177872,12,6403.396756,355.744264,533.616396,107.01955,1,2
0,0,7,7,11,10,21,38,26,64,0.000333,0.093703,10,2811.083151,156.171286,281.108315,71.273029,1,2
0,0,8,8,12,12,24,43,28,71,0.000333,0.108511,12,3906.388051,217.021558,325.532338,86.0391,1,2
0,0,8,8,11,12,23,42,28,70,0.000333,0.10555,10,3166.493369,175.916298,316.649337,81.073298,1,2
0,0,13,13,13,17,30,73,54,127,0.000333,0.207725,18,11217.1519,623.175106,623.175106,117.592585,1,2
0,0,13,13,13,16,29,63,45,108,0.000333,0.174887,12,6295.94337,349.774632,524.661947,112.105716,1,2
0,0,13,13,12,16,28,66,47,113,0.000333,0.181077,12,6518.773274,362.154071,543.231106,107.01955,1,2
0,0,7,7,12,10,22,39,25,64,0.000333,0.095135,12,3424.843483,190.269082,285.403624,76.238831,1,2
0,0,8,8,13,12,25,44,27,71,0.000333,0.109905,12,3956.565474,219.809193,329.713789,91.125266,1,2
0,0,8,8,12,12,24,43,27,70,0.000333,0.106982,12,3851.368501,213.964917,320.947375,86.0391,1,2
0,0,8,8,12,12,24,43,29,72,0.000333,0.110039,12,3961.407601,220.0782,330.1173,86.0391,1,2
0,0,13,13,14,17,31,74,53,127,0.000333,0.209728,21,13212.84156,734.046753,629.182931,122.789837,1,2
0,0,13,13,14,16,30,64,44,108,0.000333,0.176648,14,7419.218581,412.17881,529.944184,117.302969,1,2
0,0,13,13,13,16,29,67,46,113,0.000333,0.182984,12,6587.422229,365.967902,548.951852,112.105716,1,2
0,0,7,7,11,11,22,44,27,71,0.000333,0.10554,10,3166.196449,175.899803,316.619645,76.107496,1,2
0,0,7,7,12,12,24,45,27,72,0.000333,0.110039,12,3961.407601,220.0782,330.1173,86.0391,1,2
0,0,7,7,11,12,23,45,27,72,0.000333,0.108565,10,3256.964608,180.942478,325.696461,81.073298,1,2
0,0,12,12,13,17,30,75,53,128,0.000333,0.209361,18,11305.47593,628.081996,628.081996,117.592585,1,2
0,0,12,12,13,16,29,65,44,109,0.000333,0.176507,12,6354.239142,353.013286,529.519928,112.105716,1,2
0,0,12,12,12,17,29,68,46,114,0.000333,0.184603,12,6645.718001,369.206556,553.809833,112.506418,1,2
0,0,7,7,11,11,22,44,27,71,0.000333,0.10554,10,3166.196449,175.899803,316.619645,76.107496,1,2
0,0,7,7,12,12,24,45,27,72,0.000333,0.110039,12,3961.407601,220.0782,330.1173,86.0391,1,2
0,0,7,7,11,12,23,45,27,72,0.000333,0.108565,10,3256.964608,180.942478,325.696461,81.073298,1,2
0,0,12,12,13,17,30,75,53,128,0.000333,0.209361,18,11305.47593,628.081996,628.081996,117.592585,1,2
0,0,12,12,13,17,30,65,44,109,0.000333,0.178284,12,6418.212899,356.567383,534.851075,117.592585,1,2
0,0,12,12,12,17,29,68,46,114,0.000333,0.184603,12,6645.718001,369.206556,553.809833,112.506418,1,2
0,0,7,7,11,11,22,40,26,66,0.000333,0.098107,10,2943.224868,163.512493,294.322487,76.107496,1,2
0,0,7,7,12,12,24,41,26,67,0.000333,0.102397,12,3686.309851,204.794992,307.192488,86.0391,1,2
0,0,7,7,11,12,23,41,26,67,0.000333,0.101026,10,3030.786511,168.377028,303.078651,81.073298,1,2
0,0,12,12,13,17,30,71,52,123,0.000333,0.201183,18,10863.85578,603.547543,603.547543,117.592585,1,2
0,0,12,12,13,16,29,61,43,104,0.000333,0.16841,12,6062.760282,336.820016,505.230023,112.105716,1,2
0,0,12,12,12,17,29,64,45,109,0.000333,0.176507,12,6354.239142,353.013286,529.519928,112.506418,1,2
0,0,7,7,11,11,22,40,26,66,0.000333,0.098107,10,2943.224868,163.512493,294.322487,76.107496,1,2
0,0,7,7,12,12,24,41,26,67,0.000333,0.102397,12,3686.309851,204.794992,307.192488,86.0391,1,2
0,0,7,7,11,12,23,40,26,66,0.000333,0.099518,10,2985.550891,165.863938,298.555089,81.073298,1,2
0,0,12,12,13,17,30,71,52,123,0.000333,0.201183,18,10863.85578,603.547543,603.547543,117.592585,1,2
0,0,12,12,13,16,29,61,43,104,0.000333,0.16841,12,6062.760282,336.820016,505.230023,112.105716,1,2
0,0,12,12,12,17,29,64,45,109,0.000333,0.176507,12,6354.239142,353.013286,529.519928,112.506418,1,2
0,0,7,7,12,11,23,42,26,68,0.000333,0.102534,12,3691.226556,205.068142,307.602213,81.073298,1,2
0,0,7,7,13,12,25,43,26,69,0.000333,0.106809,12,3845.112925,213.617385,320.426077,91.125266,1,2
0,0,7,7,12,12,24,42,26,68,0.000333,0.103926,12,3741.329401,207.851633,311.77745,86.0391,1,2
0,0,12,12,14,17,31,73,52,125,0.000333,0.206425,21,13004.76532,722.486962,619.274539,122.789837,1,2
0,0,12,12,14,16,30,63,43,106,0.000333,0.173377,14,7281.825644,404.545869,520.130403,117.302969,1,2
0,0,12,12,13,17,30,66,45,111,0.000333,0.181555,12,6535.978273,363.109904,544.664856,117.592585,1,2
0,0,7,7,11,11,22,44,27,71,0.000333,0.10554,10,3166.196449,175.899803,316.619645,76.107496,1,2
0,0,7,7,12,12,24,45,27,72,0.000333,0.110039,12,3961.407601,220.0782,330.1173,86.0391,1,2
0,0,7,7,11,12,23,44,27,71,0.000333,0.107058,10,3211.728989,178.429388,321.172899,81.073298,1,2
0,0,12,12,13,17,30,75,53,128,0.000333,0.209361,18,11305.47593,628.081996,628.081996,117.592585,1,2
0,0,12,12,13,16,29,65,44,109,0.000333,0.176507,12,6354.239142,353.013286,529.519928,112.105716,1,2
0,0,12,12,12,17,29,68,46,114,0.000333,0.184603,12,6645.718001,369.206556,553.809833,112.506418,1,2
0,0,7,7,11,11,22,44,27,71,0.000333,0.10554,10,3166.196449,175.899803,316.619645,76.107496,1,2
0,0,7,7,12,12,24,45,27,72,0.000333,0.110039,12,3961.407601,220.0782,330.1173,86.0391,1,2
0,0,7,7,11,12,23,44,27,71,0.000333,0.107058,10,3211.728989,178.429388,321.172899,81.073298,1,2
0,0,12,12,13,17,30,75,53,128,0.000333,0.209361,18,11305.47593,628.081996,628.081996,117.592585,1,2
0,0,12,12,13,16,29,65,44,109,0.000333,0.176507,12,6354.239142,353.013286,529.519928,112.105716,1,2
0,0,12,12,12,17,29,68,46,114,0.000333,0.184603,12,6645.718001,369.206556,553.809833,112.506418,1,2
0,0,7,7,11,11,22,40,26,66,0.000333,0.098107,10,2943.224868,163.512493,294.322487,76.107496,1,2
0,0,7,7,12,12,24,41,26,67,0.000333,0.102397,12,3686.309851,204.794992,307.192488,86.0391,1,2
0,0,7,7,11,12,23,40,26,66,0.000333,0.099518,10,2985.550891,165.863938,298.555089,81.073298,1,2
0,0,12,12,13,17,30,71,52,123,0.000333,0.201183,18,10863.85578,603.547543,603.547543,117.592585,1,2
0,0,12,12,13,16,29,61,43,104,0.000333,0.16841,12,6062.760282,336.820016,505.230023,112.105716,1,2
0,0,12,12,12,17,29,64,45,109,0.000333,0.176507,12,6354.239142,353.013286,529.519928,112.506418,1,2
0,0,7,7,11,11,22,40,26,66,0.000333,0.098107,10,2943.224868,163.512493,294.322487,76.107496,1,2
0,0,7,7,12,12,24,41,26,67,0.000333,0.102397,12,3686.309851,204.794992,307.192488,86.0391,1,2
0,0,7,7,11,12,23,40,26,66,0.000333,0.099518,10,2985.550891,165.863938,298.555089,81.073298,1,2
0,0,12,12,13,17,30,71,52,123,0.000333,0.201183,18,10863.85578,603.547543,603.547543,117.592585,1,2
0,0,12,12,13,16,29,61,43,104,0.000333,0.16841,12,6062.760282,336.820016,505.230023,112.105716,1,2
0,0,12,12,12,17,29,64,45,109,0.000333,0.176507,12,6354.239142,353.013286,529.519928,112.506418,1,2
0,0,7,7,12,11,23,42,26,68,0.000333,0.102534,12,3691.226556,205.068142,307.602213,81.073298,1,2
0,0,7,7,13,12,25,43,26,69,0.000333,0.106809,12,3845.112925,213.617385,320.426077,91.125266,1,2
0,0,7,7,12,12,24,42,26,68,0.000333,0.103926,12,3741.329401,207.851633,311.77745,86.0391,1,2
0,0,12,12,14,17,31,73,52,125,0.000333,0.206425,21,13004.76532,722.486962,619.274539,122.789837,1,2
0,0,12,12,14,16,30,63,43,106,0.000333,0.173377,14,7281.825644,404.545869,520.130403,117.302969,1,2
0,0,12,12,13,17,30,66,45,111,0.000333,0.181555,12,6535.978273,363.109904,544.664856,117.592585,1,2
0,0,7,7,11,10,21,36,24,60,0.000333,0.087846,10,2635.390454,146.410581,263.539045,71.273029,1,2
0,0,8,8,12,12,24,41,26,67,0.000333,0.102397,12,3686.309851,204.794992,307.192488,86.0391,1,2
0,0,8,8,11,12,23,40,26,66,0.000333,0.099518,10,2985.550891,165.863938,298.555089,81.073298,1,2
0,0,13,13,13,17,30,71,52,123,0.000333,0.201183,18,10863.85578,603.547543,603.547543,117.592585,1,2
0,0,13,13,13,16,29,61,43,104,0.000333,0.16841,12,6062.760282,336.820016,505.230023,112.105716,1,2
0,0,13,13,12,16,28,64,45,109,0.000333,0.174667,12,6288.020238,349.334458,524.001687,107.01955,1,2
0,0,8,8,11,11,22,40,26,66,0.000333,0.098107,10,2943.224868,163.512493,294.322487,76.107496,1,2
0,0,8,8,12,12,24,41,26,67,0.000333,0.102397,12,3686.309851,204.794992,307.192488,86.0391,1,2
0,0,8,8,11,12,23,40,26,66,0.000333,0.099518,10,2985.550891,165.863938,298.555089,81.073298,1,2
0,0,13,13,13,17,30,71,52,123,0.000333,0.201183,18,10863.85578,603.547543,603.547543,117.592585,1,2
0,0,13,13,13,16,29,61,43,104,0.000333,0.16841,12,6062.760282,336.820016,505.230023,112.105716,1,2
0,0,13,13,12,16,28,64,45,109,0.000333,0.174667,12,6288.020238,349.334458,524.001687,107.01955,1,2
0,0,8,8,11,11,22,40,26,66,0.000333,0.098107,10,2943.224868,163.512493,294.322487,76.107496,1,2
0,0,8,8,12,12,24,41,26,67,0.000333,0.102397,12,3686.309851,204.794992,307.192488,86.0391,1,2
0,0,8,8,11,12,23,40,26,66,0.000333,0.099518,10,2985.550891,165.863938,298.555089,81.073298,1,2
0,0,13,13,13,17,30,71,52,123,0.000333,0.201183,18,10863.85578,603.547543,603.547543,117.592585,1,2
0,0,13,13,13,16,29,61,43,104,0.000333,0.16841,12,6062.760282,336.820016,505.230023,112.105716,1,2
0,0,13,13,12,16,28,64,45,109,0.000333,0.174667,12,6288.020238,349.334458,524.001687,107.01955,1,2
0,0,7,7,11,10,21,37,24,61,0.000333,0.08931,10,2679.313628,148.850757,267.931363,71.273029,1,2
0,0,7,7,12,11,23,38,24,62,0.000333,0.093487,12,3365.530095,186.973894,280.460841,81.073298,1,2
0,0,7,7,11,11,22,37,24,61,0.000333,0.090675,10,2720.253287,151.125183,272.025329,76.107496,1,2
0,0,12,12,13,16,29,68,50,118,0.000333,0.191081,18,10318.35163,573.241757,573.241757,112.105716,1,2
0,0,12,12,13,15,28,58,41,99,0.000333,0.158643,12,5711.137647,317.285425,475.928137,106.709075,1,2
0,0,12,12,12,16,28,61,43,104,0.000333,0.166655,12,5999.578943,333.309941,499.964912,107.01955,1,2
0,0,7,7,11,10,21,37,24,61,0.000333,0.08931,10,2679.313628,148.850757,267.931363,71.273029,1,2
0,0,7,7,12,11,23,38,24,62,0.000333,0.093487,12,3365.530095,186.973894,280.460841,81.073298,1,2
0,0,7,7,11,11,22,37,24,61,0.000333,0.090675,10,2720.253287,151.125183,272.025329,76.107496,1,2
0,0,12,12,13,16,29,68,50,118,0.000333,0.191081,18,10318.35163,573.241757,573.241757,112.105716,1,2
0,0,12,12,13,15,28,58,41,99,0.000333,0.158643,12,5711.137647,317.285425,475.928137,106.709075,1,2
0,0,12,12,12,16,28,61,43,104,0.000333,0.166655,12,5999.578943,333.309941,499.964912,107.01955,1,2
0,0,7,7,11,10,21,36,24,60,0.000333,0.087846,10,2635.390454,146.410581,263.539045,71.273029,1,2
0,0,7,7,12,11,23,38,24,62,0.000333,0.093487,12,3365.530095,186.973894,280.460841,81.073298,1,2
0,0,7,7,11,11,22,37,24,61,0.000333,0.090675,10,2720.253287,151.125183,272.025329,76.107496,1,2
0,0,12,12,13,16,29,68,50,118,0.000333,0.191081,18,10318.35163,573.241757,573.241757,112.105716,1,2
0,0,12,12,13,15,28,58,41,99,0.000333,0.158643,12,5711.137647,317.285425,475.928137,106.709075,1,2
0,0,12,12,12,16,28,61,43,104,0.000333,0.166655,12,5999.578943,333.309941,499.964912,107.01955,1,2
0,0,5,5,6,7,13,22,13,35,0.000333,0.043172,3,388.54617,21.585898,129.51539,35.161259,3,2
0,0,6,6,8,8,16,27,16,43,0.000333,0.057333,8,1376,76.444444,172,48,3,2
0,0,6,6,7,8,15,26,16,42,0.000333,0.054696,6,984.53643,54.696468,164.089405,43.651484,3,2
0,0,11,11,12,14,26,57,42,99,0.000333,0.155115,18,8376.183578,465.343532,465.343532,96.322519,5,2
0,0,11,11,9,12,21,47,33,80,0.000333,0.117128,8,2811.083151,156.171286,351.385394,71.548875,5,2
0,0,11,11,11,14,25,50,35,85,0.000333,0.131576,10,3947.277761,219.293209,394.727776,91.356717,5,2
0,0,5,5,6,9,15,22,16,38,0.000333,0.049487,3,445.385528,24.74364,148.461843,44.0391,1,2
0,0,6,6,8,10,18,27,19,46,0.000333,0.063939,4,767.2662,42.6259,191.81655,57.219281,1,2
0,0,6,6,7,10,17,26,19,45,0.000333,0.061312,3,551.807484,30.655971,183.935828,52.870765,1,2
0,0,11,11,12,16,28,57,47,104,0.000333,0.166655,12,5999.578943,333.309941,499.964912,107.01955,1,2
0,0,11,11,9,14,23,47,38,85,0.000333,0.128168,8,3076.02213,170.890118,384.502766,81.832294,1,2
0,0,11,11,11,16,27,50,40,90,0.000333,0.142647,10,4279.398752,237.744375,427.939875,102.053748,1,2
0,0,4,4,6,6,12,18,11,29,0.000333,0.034655,3,311.891738,17.327319,103.963913,31.01955,1,2
0,0,5,5,8,7,15,23,14,37,0.000333,0.048185,8,1156.439616,64.246645,144.554952,43.651484,1,2
0,0,5,5,7,7,14,22,14,36,0.000333,0.045688,6,822.388663,45.688259,137.064777,39.302969,1,2
0,0,10,10,12,13,25,53,40,93,0.000333,0.14396,18,7773.815262,431.878626,431.878626,91.125266,1,2
0,0,10,10,9,11,20,43,31,74,0.000333,0.106608,8,2558.581432,142.143413,319.822679,66.583073,1,2
0,0,10,10,11,13,24,46,33,79,0.000333,0.120737,10,3622.120376,201.22891,362.212038,86.159464,1,2
0,0,12,12,10,20,30,65,51,116,0.000333,0.189733,10,5691.993091,316.221838,569.199309,119.657843,1,2
0,0,12,12,11,17,28,64,49,113,0.000333,0.181077,10,5432.311062,301.795059,543.231106,107.540616,1,2
0,0,12,12,10,17,27,63,49,112,0.000333,0.177516,10,5325.474002,295.859667,532.5474,102.706149,1,2
0,0,16,16,14,23,37,89,72,161,0.000333,0.279574,21,17613.16183,978.508991,838.721992,157.344894,1,2
0,0,16,16,12,20,32,79,63,142,0.000333,0.236667,18,12780,710,710,129.458112,1,2
0,0,16,16,14,22,36,81,64,145,0.000333,0.24988,14,10494.94775,583.052653,749.639125,151.410465,1,2
0,0,10,10,13,12,25,55,42,97,0.000333,0.150151,18,8108.172907,450.45405,450.45405,91.125266,2,2
0,0,11,11,12,14,26,55,44,99,0.000333,0.155115,18,8376.183578,465.343532,465.343532,96.322519,2,2
0,0,11,11,11,14,25,54,44,98,0.000333,0.151699,15,6826.468599,379.248255,455.097907,91.356717,2,2
0,0,18,18,17,21,38,91,76,167,0.000333,0.292135,24,21033.69347,1168.538526,876.403895,161.725534,2,2
0,0,18,18,15,18,33,81,67,148,0.000333,0.248857,21,15677.97692,870.998718,746.57033,133.662009,2,2
0,0,18,18,17,21,38,84,69,153,0.000333,0.267644,24,19270.38983,1070.577213,802.93291,161.725534,2,2
0,0,10,10,10,14,24,57,43,100,0.000333,0.152832,15,6877.443751,382.080208,458.49625,86.52225,1,2
0,0,12,12,11,17,28,64,49,113,0.000333,0.181077,10,5432.311062,301.795059,543.231106,107.540616,1,2
0,0,12,12,10,17,27,63,49,112,0.000333,0.177516,10,5325.474002,295.859667,532.5474,102.706149,1,2
0,0,17,17,14,23,37,92,75,167,0.000333,0.289993,21,18269.55295,1014.975164,869.978712,157.344894,1,2
0,0,17,17,12,20,32,82,66,148,0.000333,0.246667,18,13320,740,740,129.458112,1,2
0,0,17,17,14,22,36,85,68,153,0.000333,0.263666,21,16610.96903,922.831613,790.998525,151.410465,1,2
0,0,6,6,11,12,23,28,21,49,0.000333,0.073885,5,1108.272679,61.570704,221.654536,81.073298,4,2
0,0,8,8,13,15,28,35,27,62,0.000333,0.099352,6,1788.336031,99.352002,298.056005,106.709075,4,2
0,0,8,8,12,15,27,34,27,61,0.000333,0.096683,6,1740.288826,96.682713,290.048138,101.622909,4,2
0,0,13,13,13,20,33,63,53,116,0.000333,0.19505,12,7021.796614,390.099812,585.149718,134.544278,4,2
0,0,13,13,13,19,32,53,44,97,0.000333,0.161667,12,5820,323.333333,485,128.816339,4,2
0,0,13,13,12,18,30,56,46,102,0.000333,0.166834,12,6006.034089,333.668561,500.502841,118.0782,4,2
0,0,6,6,11,11,22,27,18,45,0.000333,0.066891,5,1003.372114,55.742895,200.674423,76.107496,3,2
0,0,8,8,13,14,27,34,24,58,0.000333,0.091928,6,1654.700851,91.927825,275.783475,101.408685,3,2
0,0,7,7,11,14,25,30,22,52,0.000333,0.080494,5,1207.402609,67.077923,241.480522,91.356717,3,2
0,0,13,13,13,19,32,62,50,112,0.000333,0.186667,12,6720,373.333333,560,128.816339,3,2
0,0,12,12,13,18,31,49,38,87,0.000333,0.143672,12,5172.180948,287.343386,431.015079,123.164366,3,2
0,0,13,13,12,18,30,55,43,98,0.000333,0.160292,12,5770.50334,320.583519,480.875278,118.0782,3,2
0,0,3,3,11,6,17,15,8,23,0.000333,0.031337,5,470.058227,26.114346,94.011645,53.563523,2,2
0,0,5,5,12,9,21,22,14,36,0.000333,0.052708,6,948.740563,52.707809,158.123427,71.548875,2,2
0,0,5,5,11,9,20,21,14,35,0.000333,0.050422,5,756.337417,42.018745,151.267483,66.583073,2,2
0,0,10,10,13,14,27,50,40,90,0.000333,0.142647,12,5135.278502,285.29325,427.939875,101.408685,2,2
0,0,10,10,13,13,26,40,31,71,0.000333,0.111244,12,4004.77464,222.48748,333.73122,96.211433,2,2
0,0,10,10,12,13,25,43,33,76,0.000333,0.117644,12,4235.196845,235.288714,352.93307,91.125266,2,2
0,0,6,6,13,12,25,32,23,55,0.000333,0.085137,6,1532.472543,85.137363,255.41209,91.125266,5,2
0,0,8,8,13,15,28,35,27,62,0.000333,0.099352,6,1788.336031,99.352002,298.056005,106.709075,4,2
0,0,8,8,12,15,27,34,27,61,0.000333,0.096683,6,1740.288826,96.682713,290.048138,101.622909,4,2
0,0,13,13,13,20,33,63,53,116,0.000333,0.19505,12,7021.796614,390.099812,585.149718,134.544278,4,2
0,0,13,13,13,19,32,53,44,97,0.000333,0.161667,12,5820,323.333333,485,128.816339,4,2
0,0,13,13,12,18,30,56,46,102,0.000333,0.166834,12,6006.034089,333.668561,500.502841,118.0782,4,2
0,0,10,10,11,11,22,51,35,86,0.000333,0.127837,15,5752.666788,319.592599,383.511119,76.107496,1,2
0,0,15,15,13,17,30,82,61,143,0.000333,0.233895,18,12630.33639,701.685355,701.685355,117.592585,1,2
0,0,15,15,13,16,29,72,52,124,0.000333,0.200797,18,10843.01358,602.389643,602.389643,112.105716,1,2
0,0,15,15,12,17,29,75,54,129,0.000333,0.208893,18,11280.23187,626.679548,626.679548,112.506418,1,2
0,0,10,10,11,11,22,56,37,93,0.000333,0.138242,15,6220.907108,345.60595,414.727141,76.107496,1,2
0,0,15,15,13,17,30,87,63,150,0.000333,0.245345,18,13248.60461,736.033589,736.033589,117.592585,1,2
0,0,15,15,13,16,29,77,54,131,0.000333,0.212132,18,11455.11919,636.39551,636.39551,112.105716,1,2
0,0,15,15,12,17,29,80,56,136,0.000333,0.220228,18,11892.33748,660.685415,660.685415,112.506418,1,2
0,0,10,10,11,11,22,56,37,93,0.000333,0.138242,15,6220.907108,345.60595,414.727141,76.107496,1,2
0,0,15,15,13,17,30,87,63,150,0.000333,0.245345,18,13248.60461,736.033589,736.033589,117.592585,1,2
0,0,15,15,13,16,29,77,54,131,0.000333,0.212132,18,11455.11919,636.39551,636.39551,112.105716,1,2
0,0,15,15,12,17,29,80,56,136,0.000333,0.220228,18,11892.33748,660.685415,660.685415,112.506418,1,2
0,0,10,10,11,11,22,53,37,90,0.000333,0.133783,15,6020.232685,334.457371,401.348846,76.107496,1,2
0,0,15,15,13,17,30,84,63,147,0.000333,0.240438,18,12983.63252,721.312918,721.312918,117.592585,1,2
0,0,15,15,13,16,29,74,54,128,0.000333,0.207274,18,11192.78821,621.821567,621.821567,112.105716,1,2
0,0,15,15,12,17,29,77,56,133,0.000333,0.21537,18,11630.0065,646.111472,646.111472,112.506418,1,2
0,0,10,10,10,10,20,42,32,74,0.000333,0.106608,15,4797.340185,266.518899,319.822679,66.438562,1,2
0,0,15,15,12,16,28,73,58,131,0.000333,0.209921,18,11335.74291,629.763495,629.763495,107.01955,1,2
0,0,15,15,12,15,27,63,49,112,0.000333,0.177516,18,9585.853204,532.5474,532.5474,101.622909,1,2
0,0,15,15,11,16,27,66,51,117,0.000333,0.185441,15,8344.827566,463.601531,556.321838,102.053748,1,2
0,0,10,10,11,10,21,47,34,81,0.000333,0.118593,15,5336.665669,296.481426,355.777711,71.273029,1,2
0,0,15,15,13,16,29,78,60,138,0.000333,0.223467,18,12067.22479,670.401377,670.401377,112.105716,1,2
0,0,15,15,13,15,28,68,51,119,0.000333,0.190692,18,10297.35424,572.075236,572.075236,106.709075,1,2
0,0,15,15,12,16,28,71,53,124,0.000333,0.198704,18,10730.01619,596.11201,596.11201,107.01955,1,2
0,0,10,10,11,10,21,47,34,81,0.000333,0.118593,15,5336.665669,296.481426,355.777711,71.273029,1,2
0,0,15,15,13,16,29,78,60,138,0.000333,0.223467,18,12067.22479,670.401377,670.401377,112.105716,1,2
0,0,15,15,13,15,28,68,51,119,0.000333,0.190692,18,10297.35424,572.075236,572.075236,106.709075,1,2
0,0,15,15,12,16,28,71,53,124,0.000333,0.198704,18,10730.01619,596.11201,596.11201,107.01955,1,2
0,0,10,10,10,10,20,44,34,78,0.000333,0.11237,15,5056.655871,280.925326,337.110391,66.438562,1,2
0,0,15,15,12,16,28,75,60,135,0.000333,0.216331,18,11681.87246,648.992914,648.992914,107.01955,1,2
0,0,14,14,14,23,37,58,52,110,0.000333,0.191013,14,8022.558183,445.697677,573.03987,157.344894,1,2
0,0,11,11,14,18,32,41,37,78,0.000333,0.13,14,5460,303.333333,390,128.361619,1,2
0,0,15,15,15,24,39,69,61,130,0.000333,0.229034,14,9619.432038,534.412891,687.102288,168.642459,1,2
0,0,15,15,15,23,38,59,52,111,0.000333,0.194173,14,8155.279356,453.071075,582.519954,162.645284,1,2
0,0,15,15,15,23,38,62,54,116,0.000333,0.20292,14,8522.634282,473.479682,608.759592,162.645284,1,2
0,0,10,10,13,15,28,49,34,83,0.000333,0.133003,12,4788.125502,266.006972,399.010459,106.709075,2,2
0,0,10,10,13,15,28,49,34,83,0.000333,0.133003,12,4788.125502,266.006972,399.010459,106.709075,2,2
0,0,9,9,11,12,23,49,32,81,0.000333,0.122136,10,3664.085184,203.560288,366.408518,81.073298,1,2
0,0,6,6,10,10,20,29,19,48,0.000333,0.069151,5,1037.262743,57.625708,207.452549,66.438562,1,2
0,0,7,7,10,12,22,40,25,65,0.000333,0.096621,10,2898.630552,161.035031,289.863055,76.238831,1,2
0,0,13,13,13,18,31,77,56,133,0.000333,0.219636,18,11860.34597,658.908109,658.908109,123.164366,1,2
0,0,12,12,13,17,30,67,47,114,0.000333,0.186462,12,6712.626335,372.923685,559.385528,117.592585,1,2
0,0,13,13,12,18,30,70,49,119,0.000333,0.19464,12,7007.039771,389.279987,583.919981,118.0782,1,2
0,0,9,9,11,12,23,49,32,81,0.000333,0.122136,10,3664.085184,203.560288,366.408518,81.073298,1,2
0,0,7,7,10,12,22,40,25,65,0.000333,0.096621,10,2898.630552,161.035031,289.863055,76.238831,1,2
0,0,7,7,10,12,22,40,25,65,0.000333,0.096621,10,2898.630552,161.035031,289.863055,76.238831,1,2
0,0,13,13,13,18,31,77,56,133,0.000333,0.219636,18,11860.34597,658.908109,658.908109,123.164366,1,2
0,0,13,13,13,17,30,67,47,114,0.000333,0.186462,12,6712.626335,372.923685,559.385528,117.592585,1,2
0,0,13,13,12,18,30,70,49,119,0.000333,0.19464,12,7007.039771,389.279987,583.919981,118.0782,1,2
0,0,8,8,11,12,23,40,28,68,0.000333,0.102534,10,3076.02213,170.890118,307.602213,81.073298,1,2
0,0,8,8,12,13,25,41,28,69,0.000333,0.106809,12,3845.112925,213.617385,320.426077,91.125266,1,2
0,0,7,7,10,12,22,36,24,60,0.000333,0.089189,10,2675.658971,148.647721,267.565897,76.238831,1,2
0,0,13,13,13,18,31,73,55,128,0.000333,0.211379,18,11414.4683,634.137128,634.137128,123.164366,1,2
0,0,13,13,13,17,30,63,46,109,0.000333,0.178284,12,6418.212899,356.567383,534.851075,117.592585,1,2
0,0,13,13,12,18,30,66,48,114,0.000333,0.186462,12,6712.626335,372.923685,559.385528,118.0782,1,2
0,0,9,9,11,12,23,45,31,76,0.000333,0.114597,10,3437.907087,190.994838,343.790709,81.073298,1,2
0,0,8,8,12,13,25,41,28,69,0.000333,0.106809,12,3845.112925,213.617385,320.426077,91.125266,1,2
0,0,7,7,10,12,22,36,24,60,0.000333,0.089189,10,2675.658971,148.647721,267.565897,76.238831,1,2
0,0,13,13,13,18,31,73,55,128,0.000333,0.211379,18,11414.4683,634.137128,634.137128,123.164366,1,2
0,0,13,13,13,17,30,63,46,109,0.000333,0.178284,12,6418.212899,356.567383,534.851075,117.592585,1,2
0,0,13,13,12,18,30,66,48,114,0.000333,0.186462,12,6712.626335,372.923685,559.385528,118.0782,1,2
0,0,8,8,12,12,24,42,28,70,0.000333,0.106982,12,3851.368501,213.964917,320.947375,86.0391,1,2
0,0,8,8,13,13,26,42,28,70,0.000333,0.109677,12,3948.369363,219.353854,329.03078,96.211433,1,2
0,0,9,9,12,13,25,52,33,85,0.000333,0.131576,12,4736.733314,263.151851,394.727776,91.125266,1,2
0,0,13,13,14,18,32,75,55,130,0.000333,0.216667,21,13650,758.333333,650,128.361619,1,2
0,0,13,13,14,17,31,65,46,111,0.000333,0.183305,14,7698.821066,427.712281,549.91579,122.789837,1,2
0,0,13,13,13,18,31,68,48,116,0.000333,0.191562,12,6896.241264,383.124515,574.686772,123.164366,1,2
0,0,9,9,14,13,27,39,29,68,0.000333,0.107777,14,4526.652902,251.480717,323.33235,101.408685,2,2
0,0,10,10,13,15,28,41,33,74,0.000333,0.118581,12,4268.931171,237.162843,355.744264,106.709075,2,2
0,0,17,17,14,22,36,80,65,145,0.000333,0.24988,14,10494.94775,583.052653,749.639125,151.410465,2,2
0,0,17,17,13,19,32,74,58,132,0.000333,0.22,18,11880,660,660,128.816339,2,2
0,0,8,8,11,11,22,35,26,61,0.000333,0.090675,10,2720.253287,151.125183,272.025329,76.107496,1,2
0,0,8,8,12,12,24,36,26,62,0.000333,0.094756,12,3411.212101,189.511783,284.267675,86.0391,1,2
0,0,8,8,11,12,23,36,26,62,0.000333,0.093487,10,2804.608413,155.811578,280.460841,81.073298,1,2
0,0,13,13,13,17,30,68,53,121,0.000333,0.197911,18,10687.20772,593.733762,593.733762,117.592585,1,2
0,0,13,13,13,16,29,58,44,102,0.000333,0.165171,12,5946.168738,330.342708,495.514062,112.105716,1,2
0,0,13,13,12,17,29,61,46,107,0.000333,0.173268,12,6237.647598,346.535978,519.803966,112.506418,1,2
0,0,9,9,11,11,22,40,29,69,0.000333,0.102567,10,3077.007817,170.944879,307.700782,76.107496,1,2
0,0,8,8,12,12,24,36,26,62,0.000333,0.094756,12,3411.212101,189.511783,284.267675,86.0391,1,2
0,0,8,8,11,12,23,36,26,62,0.000333,0.093487,10,2804.608413,155.811578,280.460841,81.073298,1,2
0,0,13,13,13,17,30,68,53,121,0.000333,0.197911,18,10687.20772,593.733762,593.733762,117.592585,1,2
0,0,13,13,13,16,29,58,44,102,0.000333,0.165171,12,5946.168738,330.342708,495.514062,112.105716,1,2
0,0,13,13,12,17,29,61,46,107,0.000333,0.173268,12,6237.647598,346.535978,519.803966,112.506418,1,2
0,0,9,9,10,11,21,36,28,64,0.000333,0.093703,10,2811.083151,156.171286,281.108315,71.273029,1,2
0,0,16,16,12,16,28,77,62,139,0.000333,0.222741,18,12028.00202,668.222334,668.222334,107.01955,1,2
0,0,16,16,12,15,27,67,53,120,0.000333,0.190196,18,10270.55701,570.5865,570.5865,101.622909,1,2
0,0,16,16,11,16,27,70,55,125,0.000333,0.19812,15,8915.414067,495.300781,594.360938,102.053748,1,2
0,0,12,12,11,12,23,55,39,94,0.000333,0.141738,15,6378.222358,354.345687,425.214824,81.073298,1,2
0,0,13,13,12,13,25,59,41,100,0.000333,0.154795,18,8358.941142,464.385619,464.385619,91.125266,1,2
0,0,13,13,11,14,25,58,41,99,0.000333,0.153247,10,4597.417628,255.41209,459.741763,91.356717,1,2
0,0,17,17,13,18,31,86,65,151,0.000333,0.249361,18,13465.50557,748.083643,748.083643,123.164366,1,2
0,0,17,17,13,17,30,76,56,132,0.000333,0.215903,18,11658.77206,647.709559,647.709559,117.592585,1,2
0,0,17,17,12,18,30,79,58,137,0.000333,0.224081,18,12100.39221,672.244012,672.244012,118.0782,1,2
0,0,14,14,14,14,28,66,47,113,0.000333,0.181077,21,11407.85323,633.769624,543.231106,106.605938,2,2
0,0,14,14,15,15,30,67,47,114,0.000333,0.186462,21,11747.09609,652.616449,559.385528,117.206718,2,2
0,0,15,15,14,15,29,69,49,118,0.000333,0.191081,21,12038.07691,668.78205,573.241757,111.906328,2,2
0,0,18,18,15,19,34,96,71,167,0.000333,0.283202,21,17841.73218,991.207344,849.606294,139.313982,2,2
0,0,18,18,15,18,33,86,62,148,0.000333,0.248857,21,15677.97692,870.998718,746.57033,133.662009,2,2
0,0,18,18,14,18,32,89,64,153,0.000333,0.255,21,16065,892.5,765,128.361619,2,2
0,0,12,12,11,12,23,60,41,101,0.000333,0.152293,15,6853.196363,380.733131,456.879758,81.073298,1,2
0,0,13,13,12,13,25,64,43,107,0.000333,0.165631,18,8944.067022,496.892612,496.892612,91.125266,1,2
0,0,13,13,11,13,24,63,43,106,0.000333,0.162002,15,7290.090376,405.005021,486.006025,86.159464,1,2
0,0,17,17,13,18,31,91,67,158,0.000333,0.260921,18,14089.73431,782.763017,782.763017,123.164366,1,2
0,0,17,17,13,17,30,81,58,139,0.000333,0.227353,18,12277.04027,682.057793,682.057793,117.592585,1,2
0,0,17,17,12,18,30,84,60,144,0.000333,0.235531,18,12718.66042,706.592246,706.592246,118.0782,1,2
0,0,12,12,11,12,23,60,41,101,0.000333,0.152293,15,6853.196363,380.733131,456.879758,81.073298,1,2
0,0,13,13,12,13,25,64,43,107,0.000333,0.165631,18,8944.067022,496.892612,496.892612,91.125266,1,2
0,0,13,13,11,13,24,63,43,106,0.000333,0.162002,15,7290.090376,405.005021,486.006025,86.159464,1,2
0,0,17,17,13,18,31,91,67,158,0.000333,0.260921,18,14089.73431,782.763017,782.763017,123.164366,1,2
0,0,17,17,13,17,30,81,58,139,0.000333,0.227353,18,12277.04027,682.057793,682.057793,117.592585,1,2
0,0,17,17,12,18,30,84,60,144,0.000333,0.235531,18,12718.66042,706.592246,706.592246,118.0782,1,2
0,0,12,12,11,12,23,57,41,98,0.000333,0.14777,15,6649.636075,369.424226,443.309072,81.073298,1,2
0,0,12,12,12,13,25,58,41,99,0.000333,0.153247,18,8275.35173,459.741763,459.741763,91.125266,1,2
0,0,13,13,11,13,24,60,43,103,0.000333,0.157417,15,7083.767064,393.542615,472.251138,86.159464,1,2
0,0,17,17,13,18,31,88,67,155,0.000333,0.255967,18,13822.20771,767.900428,767.900428,123.164366,1,2
0,0,17,17,13,17,30,78,58,136,0.000333,0.222446,18,12012.06818,667.337121,667.337121,117.592585,1,2
0,0,17,17,12,18,30,81,60,141,0.000333,0.230624,18,12453.68833,691.871574,691.871574,118.0782,1,2
0,0,12,12,11,12,23,55,39,94,0.000333,0.141738,15,6378.222358,354.345687,425.214824,81.073298,1,2
0,0,13,13,12,13,25,59,41,100,0.000333,0.154795,18,8358.941142,464.385619,464.385619,91.125266,1,2
0,0,13,13,11,13,24,58,41,99,0.000333,0.151304,15,6808.669314,378.259406,453.911288,86.159464,1,2
0,0,17,17,13,18,31,86,65,151,0.000333,0.249361,18,13465.50557,748.083643,748.083643,123.164366,1,2
0,0,17,17,13,17,30,76,56,132,0.000333,0.215903,18,11658.77206,647.709559,647.709559,117.592585,1,2
0,0,17,17,12,18,30,79,58,137,0.000333,0.224081,18,12100.39221,672.244012,672.244012,118.0782,1,2
0,0,14,14,14,14,28,66,47,113,0.000333,0.181077,21,11407.85323,633.769624,543.231106,106.605938,2,2
0,0,14,14,15,14,29,69,47,116,0.000333,0.187842,21,11834.0417,657.446761,563.525795,111.906328,2,2
0,0,15,15,14,15,29,69,49,118,0.000333,0.191081,21,12038.07691,668.78205,573.241757,111.906328,2,2
0,0,18,18,15,19,34,96,71,167,0.000333,0.283202,21,17841.73218,991.207344,849.606294,139.313982,2,2
0,0,18,18,15,18,33,86,62,148,0.000333,0.248857,21,15677.97692,870.998718,746.57033,133.662009,2,2
0,0,18,18,14,18,32,89,64,153,0.000333,0.255,21,16065,892.5,765,128.361619,2,2
0,0,12,12,11,12,23,60,41,101,0.000333,0.152293,15,6853.196363,380.733131,456.879758,81.073298,1,2
0,0,13,13,12,13,25,64,43,107,0.000333,0.165631,18,8944.067022,496.892612,496.892612,91.125266,1,2
0,0,12,12,11,13,24,60,41,101,0.000333,0.15436,15,6946.218189,385.90101,463.081213,86.159464,1,2
0,0,17,17,13,18,31,91,67,158,0.000333,0.260921,18,14089.73431,782.763017,782.763017,123.164366,1,2
0,0,17,17,13,17,30,81,58,139,0.000333,0.227353,18,12277.04027,682.057793,682.057793,117.592585,1,2
0,0,17,17,12,18,30,84,60,144,0.000333,0.235531,18,12718.66042,706.592246,706.592246,118.0782,1,2
0,0,12,12,11,12,23,60,41,101,0.000333,0.152293,15,6853.196363,380.733131,456.879758,81.073298,1,2
0,0,13,13,12,13,25,64,43,107,0.000333,0.165631,18,8944.067022,496.892612,496.892612,91.125266,1,2
0,0,13,13,11,13,24,62,43,105,0.000333,0.160474,15,7221.315939,401.184219,481.421063,86.159464,1,2
0,0,17,17,13,18,31,91,67,158,0.000333,0.260921,18,14089.73431,782.763017,782.763017,123.164366,1,2
0,0,17,17,13,17,30,81,58,139,0.000333,0.227353,18,12277.04027,682.057793,682.057793,117.592585,1,2
0,0,17,17,12,18,30,84,60,144,0.000333,0.235531,18,12718.66042,706.592246,706.592246,118.0782,1,2
0,0,12,12,11,12,23,57,41,98,0.000333,0.14777,15,6649.636075,369.424226,443.309072,81.073298,1,2
0,0,13,13,12,13,25,61,43,104,0.000333,0.160987,18,8693.298787,482.961044,482.961044,91.125266,1,2
0,0,13,13,11,13,24,60,43,103,0.000333,0.157417,15,7083.767064,393.542615,472.251138,86.159464,1,2
0,0,17,17,13,18,31,88,67,155,0.000333,0.255967,18,13822.20771,767.900428,767.900428,123.164366,1,2
0,0,17,17,13,17,30,78,58,136,0.000333,0.222446,18,12012.06818,667.337121,667.337121,117.592585,1,2
0,0,17,17,12,18,30,81,60,141,0.000333,0.230624,18,12453.68833,691.871574,691.871574,118.0782,1,2
0,0,10,10,10,10,20,42,31,73,0.000333,0.105167,15,4732.511264,262.917292,315.500751,66.438562,1,2
0,0,10,10,10,10,20,42,31,73,0.000333,0.105167,15,4732.511264,262.917292,315.500751,66.438562,1,2
0,0,10,10,10,10,20,42,31,73,0.000333,0.105167,15,4732.511264,262.917292,315.500751,66.438562,1,2
0,0,10,10,10,10,20,42,31,73,0.000333,0.105167,15,4732.511264,262.917292,315.500751,66.438562,1,2
0,0,10,10,10,10,20,42,31,73,0.000333,0.105167,15,4732.511264,262.917292,315.500751,66.438562,1,2
0,0,10,10,10,10,20,42,31,73,0.000333,0.105167,15,4732.511264,262.917292,315.500751,66.438562,1,2
0,0,10,10,10,10,20,42,31,73,0.000333,0.105167,15,4732.511264,262.917292,315.500751,66.438562,1,2
0,0,10,10,10,10,20,42,31,73,0.000333,0.105167,15,4732.511264,262.917292,315.500751,66.438562,1,2
0,0,10,10,10,10,20,42,31,73,0.000333,0.105167,15,4732.511264,262.917292,315.500751,66.438562,1,2
0,0,10,10,10,10,20,42,31,73,0.000333,0.105167,15,4732.511264,262.917292,315.500751,66.438562,1,2
0,0,10,10,10,10,20,42,31,73,0.000333,0.105167,15,4732.511264,262.917292,315.500751,66.438562,1,2
0,0,10,10,10,10,20,42,31,73,0.000333,0.105167,15,4732.511264,262.917292,315.500751,66.438562,1,2
0,0,10,10,10,10,20,42,31,73,0.000333,0.105167,15,4732.511264,262.917292,315.500751,66.438562,1,2
0,0,10,10,10,10,20,42,31,73,0.000333,0.105167,15,4732.511264,262.917292,315.500751,66.438562,1,2
0,0,10,10,10,10,20,42,31,73,0.000333,0.105167,15,4732.511264,262.917292,315.500751,66.438562,1,2
0,0,10,10,10,10,20,42,31,73,0.000333,0.105167,15,4732.511264,262.917292,315.500751,66.438562,1,2
0,0,10,10,10,10,20,42,31,73,0.000333,0.105167,15,4732.511264,262.917292,315.500751,66.438562,1,2
0,0,10,10,10,10,20,42,31,73,0.000333,0.105167,15,4732.511264,262.917292,315.500751,66.438562,1,2
0,0,14,14,12,11,23,57,42,99,0.000333,0.149278,18,8060.987406,447.832634,447.832634,81.073298,1,2
0,0,14,14,11,11,22,56,42,98,0.000333,0.145675,15,6555.364479,364.186916,437.024299,76.107496,1,2
0,0,12,12,10,11,21,48,37,85,0.000333,0.124449,15,5600.204714,311.122484,373.346981,71.273029,1,2
0,0,15,15,11,12,23,63,45,108,0.000333,0.162848,15,7328.170369,407.120576,488.544691,81.073298,1,2
0,0,12,12,11,11,22,49,37,86,0.000333,0.127837,15,5752.666788,319.592599,383.511119,76.107496,1,2
0,0,13,13,11,14,25,50,40,90,0.000333,0.139316,10,4179.470571,232.192809,417.947057,91.356717,1,2
0,0,12,12,10,12,22,48,37,85,0.000333,0.126351,15,5685.775314,315.876406,379.051688,76.238831,1,2
0,0,14,14,12,11,23,57,42,99,0.000333,0.149278,18,8060.987406,447.832634,447.832634,81.073298,1,2
0,0,13,13,11,12,23,52,39,91,0.000333,0.137215,15,6174.66207,343.036782,411.644138,81.073298,1,2
0,0,13,13,11,13,24,57,41,98,0.000333,0.149775,15,6739.894876,374.438604,449.326325,86.159464,1,2
0,0,14,14,11,13,24,49,39,88,0.000333,0.134492,15,6052.150501,336.230583,403.4767,86.159464,1,2
0,0,12,12,10,12,22,48,37,85,0.000333,0.126351,15,5685.775314,315.876406,379.051688,76.238831,1,2
0,0,12,12,10,13,23,48,37,85,0.000333,0.128168,10,3845.027663,213.612648,384.502766,81.324997,1,2
0,0,12,12,10,13,23,48,37,85,0.000333,0.128168,10,3845.027663,213.612648,384.502766,81.324997,1,2
0,0,12,12,10,13,23,48,37,85,0.000333,0.128168,10,3845.027663,213.612648,384.502766,81.324997,1,2
0,0,14,14,11,11,22,56,42,98,0.000333,0.145675,15,6555.364479,364.186916,437.024299,76.107496,1,2
0,0,13,13,11,12,23,52,39,91,0.000333,0.137215,15,6174.66207,343.036782,411.644138,81.073298,1,2
0,0,13,13,11,13,24,54,40,94,0.000333,0.143662,15,6464.797126,359.155396,430.986475,86.159464,1,2
0,0,14,14,11,14,25,63,44,107,0.000333,0.165631,15,7453.389185,414.077177,496.892612,91.356717,1,2
0,0,13,13,10,13,23,56,41,97,0.000333,0.146262,15,6581.782646,365.654591,438.78551,81.324997,1,2
0,0,15,15,10,15,25,63,47,110,0.000333,0.170275,15,7662.362713,425.686817,510.824181,91.82264,1,2
0,0,15,15,11,15,26,55,46,101,0.000333,0.158248,15,7121.166173,395.620343,474.744412,96.657107,1,2
0,0,14,14,10,15,25,48,43,91,0.000333,0.140864,10,4225.909133,234.77273,422.590913,91.82264,1,2
0,0,17,17,13,17,30,80,63,143,0.000333,0.233895,18,12630.33639,701.685355,701.685355,117.592585,1,2
0,0,17,17,13,16,29,70,54,124,0.000333,0.200797,18,10843.01358,602.389643,602.389643,112.105716,1,2
0,0,17,17,12,17,29,73,56,129,0.000333,0.208893,18,11280.23187,626.679548,626.679548,112.506418,1,2
0,0,12,12,13,12,25,53,39,92,0.000333,0.142412,18,7690.22585,427.234769,427.234769,91.125266,2,2
0,0,12,12,13,12,25,53,39,92,0.000333,0.142412,18,7690.22585,427.234769,427.234769,91.125266,2,2
0,0,12,12,13,12,25,53,39,92,0.000333,0.142412,18,7690.22585,427.234769,427.234769,91.125266,2,2
0,0,12,12,13,12,25,53,39,92,0.000333,0.142412,18,7690.22585,427.234769,427.234769,91.125266,2,2
0,0,12,12,13,12,25,53,39,92,0.000333,0.142412,18,7690.22585,427.234769,427.234769,91.125266,2,2
0,0,12,12,13,12,25,53,39,92,0.000333,0.142412,18,7690.22585,427.234769,427.234769,91.125266,2,2
0,0,12,12,13,12,25,53,39,92,0.000333,0.142412,18,7690.22585,427.234769,427.234769,91.125266,2,2
0,0,12,12,13,12,25,53,39,92,0.000333,0.142412,18,7690.22585,427.234769,427.234769,91.125266,2,2
0,0,12,12,13,12,25,53,39,92,0.000333,0.142412,18,7690.22585,427.234769,427.234769,91.125266,2,2
0,0,12,12,13,12,25,53,39,92,0.000333,0.142412,18,7690.22585,427.234769,427.234769,91.125266,2,2
0,0,12,12,13,12,25,53,39,92,0.000333,0.142412,18,7690.22585,427.234769,427.234769,91.125266,2,2
0,0,12,12,13,12,25,53,39,92,0.000333,0.142412,18,7690.22585,427.234769,427.234769,91.125266,2,2
0,0,12,12,13,12,25,53,39,92,0.000333,0.142412,18,7690.22585,427.234769,427.234769,91.125266,2,2
0,0,12,12,13,12,25,53,39,92,0.000333,0.142412,18,7690.22585,427.234769,427.234769,91.125266,2,2
0,0,12,12,13,12,25,53,39,92,0.000333,0.142412,18,7690.22585,427.234769,427.234769,91.125266,2,2
0,0,12,12,13,12,25,53,39,92,0.000333,0.142412,18,7690.22585,427.234769,427.234769,91.125266,2,2
0,0,12,12,13,12,25,53,39,92,0.000333,0.142412,18,7690.22585,427.234769,427.234769,91.125266,2,2
0,0,12,12,13,12,25,53,39,92,0.000333,0.142412,18,7690.22585,427.234769,427.234769,91.125266,2,2
0,0,16,16,15,13,28,68,50,118,0.000333,0.189089,21,11912.6255,661.812528,567.267881,106.709075,2,2
0,0,16,16,14,13,27,67,50,117,0.000333,0.185441,21,11682.75859,649.042144,556.321838,101.408685,2,2
0,0,14,14,13,13,26,59,45,104,0.000333,0.162949,18,8799.223152,488.845731,488.845731,96.211433,2,2
0,0,17,17,14,14,28,74,53,127,0.000333,0.203511,21,12821.21558,712.289754,610.534075,106.605938,2,2
0,0,14,14,14,13,27,60,45,105,0.000333,0.166421,21,10484.52694,582.473719,499.263188,101.408685,2,2
0,0,15,15,14,16,30,61,48,109,0.000333,0.178284,21,11231.87257,623.992921,534.851075,117.302969,2,2
0,0,14,14,13,14,27,59,45,104,0.000333,0.164836,18,8901.149404,494.5083,494.5083,101.408685,2,2
0,0,16,16,15,13,28,68,50,118,0.000333,0.189089,21,11912.6255,661.812528,567.267881,106.709075,2,2
0,0,15,15,14,14,28,63,47,110,0.000333,0.17627,21,11104.98987,616.943882,528.809041,106.605938,2,2
0,0,15,15,14,15,29,68,49,117,0.000333,0.189461,21,11936.05931,663.114406,568.383776,111.906328,2,2
0,0,14,14,13,14,27,59,45,104,0.000333,0.164836,18,8901.149404,494.5083,494.5083,101.408685,2,2
0,0,14,14,13,15,28,59,45,104,0.000333,0.166655,18,8999.368414,499.964912,499.964912,106.709075,2,2
0,0,14,14,13,13,26,59,45,104,0.000333,0.162949,18,8799.223152,488.845731,488.845731,96.211433,2,2
0,0,14,14,13,15,28,59,45,104,0.000333,0.166655,18,8999.368414,499.964912,499.964912,106.709075,2,2
0,0,14,14,13,15,28,59,45,104,0.000333,0.166655,18,8999.368414,499.964912,499.964912,106.709075,2,2
0,0,15,15,14,12,26,64,47,111,0.000333,0.173916,21,10956.72498,608.706943,521.748809,96.322519,2,2
0,0,15,15,14,14,28,63,47,110,0.000333,0.17627,21,11104.98987,616.943882,528.809041,106.605938,2,2
0,0,15,15,14,15,29,65,48,113,0.000333,0.182984,21,11527.9889,640.443828,548.951852,111.906328,2,2
0,0,16,16,14,16,30,74,52,126,0.000333,0.206089,21,12983.63252,721.312918,618.268215,117.302969,2,2
0,0,15,15,13,15,28,67,49,116,0.000333,0.185884,18,10037.75708,557.653171,557.653171,106.709075,2,2
0,0,17,17,13,17,30,74,55,129,0.000333,0.210996,18,11393.79996,632.988887,632.988887,117.592585,2,2
0,0,16,16,14,16,30,64,50,114,0.000333,0.186462,21,11747.09609,652.616449,559.385528,117.302969,2,2
0,0,16,16,13,17,30,59,51,110,0.000333,0.179919,18,9715.643379,539.757966,539.757966,117.592585,2,2
0,0,19,19,15,19,34,91,71,162,0.000333,0.274723,21,17307.54859,961.530477,824.16898,139.313982,2,2
0,0,19,19,15,18,33,81,62,143,0.000333,0.240449,21,15148.31554,841.573086,721.348359,133.662009,2,2
0,0,19,19,14,18,32,84,64,148,0.000333,0.246667,21,15540,863.333333,740,128.361619,2,2
0,0,10,10,11,10,21,47,33,80,0.000333,0.117128,15,5270.780907,292.821162,351.385394,71.273029,1,2
0,0,10,10,11,10,21,47,33,80,0.000333,0.117128,15,5270.780907,292.821162,351.385394,71.273029,1,2
0,0,10,10,11,10,21,47,33,80,0.000333,0.117128,15,5270.780907,292.821162,351.385394,71.273029,1,2
0,0,10,10,11,10,21,47,33,80,0.000333,0.117128,15,5270.780907,292.821162,351.385394,71.273029,1,2
0,0,10,10,11,10,21,47,33,80,0.000333,0.117128,15,5270.780907,292.821162,351.385394,71.273029,1,2
0,0,10,10,11,10,21,47,33,80,0.000333,0.117128,15,5270.780907,292.821162,351.385394,71.273029,1,2
0,0,10,10,11,10,21,47,33,80,0.000333,0.117128,15,5270.780907,292.821162,351.385394,71.273029,1,2
0,0,10,10,11,10,21,47,33,80,0.000333,0.117128,15,5270.780907,292.821162,351.385394,71.273029,1,2
0,0,10,10,11,10,21,47,33,80,0.000333,0.117128,15,5270.780907,292.821162,351.385394,71.273029,1,2
0,0,10,10,12,11,23,48,32,80,0.000333,0.120628,12,4342.619478,241.256638,361.884956,81.073298,2,2
0,0,10,10,12,11,23,48,32,80,0.000333,0.120628,12,4342.619478,241.256638,361.884956,81.073298,2,2
0,0,10,10,12,11,23,48,32,80,0.000333,0.120628,12,4342.619478,241.256638,361.884956,81.073298,2,2
0,0,15,15,13,11,24,68,45,113,0.000333,0.1727,24,12434.4183,690.801017,518.100763,86.159464,2,2
0,0,10,10,12,12,24,48,33,81,0.000333,0.123794,12,4456.583551,247.587975,371.381963,86.0391,2,2
0,0,10,10,12,12,24,48,33,81,0.000333,0.123794,12,4456.583551,247.587975,371.381963,86.0391,2,2
0,0,11,11,14,11,25,50,33,83,0.000333,0.12848,21,8094.241339,449.680074,385.440064,91.356717,2,2
0,0,10,10,12,10,22,48,32,80,0.000333,0.118918,18,6421.581531,356.754529,356.754529,76.238831,2,2
0,0,10,10,14,12,26,53,36,89,0.000333,0.139446,21,8785.121833,488.062324,418.339135,96.322519,2,2
0,0,11,11,13,10,23,48,33,81,0.000333,0.122136,18,6595.353332,366.408518,366.408518,81.324997,1,2
0,0,14,14,14,12,26,61,42,103,0.000333,0.161382,21,10167.05111,564.836173,484.145291,96.322519,2,2
0,0,14,14,13,12,25,60,42,102,0.000333,0.157891,18,8526.119964,473.673331,473.673331,91.125266,2,2
0,0,10,10,11,10,21,49,35,84,0.000333,0.122985,15,5534.319953,307.46222,368.954664,71.273029,1,2
0,0,14,14,12,12,24,66,45,111,0.000333,0.169644,18,9160.755076,508.930838,508.930838,86.0391,1,2
0,0,11,11,12,11,23,52,37,89,0.000333,0.134199,18,7246.746254,402.597014,402.597014,81.073298,1,2
0,0,11,11,12,13,25,51,38,89,0.000333,0.137768,12,4959.638411,275.535467,413.303201,91.125266,1,2
0,0,10,10,11,11,22,49,35,84,0.000333,0.124864,15,5618.883839,312.160213,374.592256,76.107496,1,2
0,0,12,12,13,11,24,56,39,95,0.000333,0.14519,18,7840.285876,435.571438,435.571438,86.159464,1,2
0,0,11,11,12,12,24,52,37,89,0.000333,0.136021,18,7345.109926,408.061663,408.061663,86.0391,1,2
0,0,12,12,12,13,25,60,41,101,0.000333,0.156343,18,8442.530553,469.029475,469.029475,91.125266,1,2
0,0,12,12,12,12,24,50,37,87,0.000333,0.132964,18,7180.051276,398.891738,398.891738,86.0391,1,2
0,0,10,10,11,11,22,49,35,84,0.000333,0.124864,15,5618.883839,312.160213,374.592256,76.107496,1,2
0,0,12,12,11,12,23,55,41,96,0.000333,0.144754,15,6513.929217,361.884956,434.261948,81.073298,1,2
0,0,14,14,11,13,24,61,47,108,0.000333,0.165059,15,7427.639251,412.646625,495.17595,86.159464,1,2
0,0,16,16,11,14,25,67,53,120,0.000333,0.185754,15,8358.941142,464.385619,557.262743,91.356717,1,2
0,0,11,11,12,10,22,53,37,90,0.000333,0.133783,18,7224.279222,401.348846,401.348846,76.238831,1,2
0,0,11,11,12,12,24,52,37,89,0.000333,0.136021,18,7345.109926,408.061663,408.061663,86.0391,1,2
0,0,11,11,12,12,24,55,38,93,0.000333,0.142134,18,7675.227226,426.401513,426.401513,86.0391,1,2
0,0,12,12,12,13,25,64,42,106,0.000333,0.164083,18,8860.47761,492.248756,492.248756,91.125266,1,2
0,0,12,12,11,13,24,59,41,100,0.000333,0.152832,15,6877.443751,382.080208,458.49625,86.159464,1,2
0,0,13,13,11,14,25,64,45,109,0.000333,0.168727,15,7592.70487,421.816937,506.180325,91.356717,1,2
0,0,13,13,12,14,26,56,44,100,0.000333,0.156681,18,8460.791493,470.043972,470.043972,96.322519,1,2
0,0,12,12,11,14,25,49,41,90,0.000333,0.139316,10,4179.470571,232.192809,417.947057,91.356717,1,2
0,0,15,15,14,16,30,81,61,142,0.000333,0.232259,21,14632.34776,812.908209,696.778465,117.302969,1,2
0,0,15,15,14,15,29,71,52,123,0.000333,0.199177,21,12548.16491,697.120273,597.531662,111.906328,1,2
0,0,15,15,13,16,29,74,54,128,0.000333,0.207274,18,11192.78821,621.821567,621.821567,112.105716,1,2
0,0,8,8,11,9,20,43,29,72,0.000333,0.103726,15,4667.682342,259.315686,311.178823,66.583073,1,2
0,0,10,10,12,10,22,48,32,80,0.000333,0.118918,18,6421.581531,356.754529,356.754529,76.238831,2,2
0,0,10,10,12,11,23,48,33,81,0.000333,0.122136,18,6595.353332,366.408518,366.408518,81.073298,2,2
0,0,10,10,12,11,23,48,32,80,0.000333,0.120628,12,4342.619478,241.256638,361.884956,81.073298,2,2
0,0,10,10,12,11,23,48,32,80,0.000333,0.120628,12,4342.619478,241.256638,361.884956,81.073298,2,2
0,0,10,10,12,12,24,48,33,81,0.000333,0.123794,12,4456.583551,247.587975,371.381963,86.0391,2,2
0,0,10,10,12,12,24,48,33,81,0.000333,0.123794,12,4456.583551,247.587975,371.381963,86.0391,2,2
0,0,10,10,12,11,23,48,32,80,0.000333,0.120628,12,4342.619478,241.256638,361.884956,81.073298,2,2
0,0,10,10,12,11,23,48,32,80,0.000333,0.120628,12,4342.619478,241.256638,361.884956,81.073298,2,2
0,0,10,10,12,11,23,48,32,80,0.000333,0.120628,12,4342.619478,241.256638,361.884956,81.073298,2,2
0,0,10,10,12,11,23,48,32,80,0.000333,0.120628,12,4342.619478,241.256638,361.884956,81.073298,2,2
0,0,15,15,13,11,24,68,45,113,0.000333,0.1727,24,12434.4183,690.801017,518.100763,86.159464,2,2
0,0,10,10,12,12,24,48,33,81,0.000333,0.123794,12,4456.583551,247.587975,371.381963,86.0391,2,2
0,0,10,10,12,12,24,48,33,81,0.000333,0.123794,12,4456.583551,247.587975,371.381963,86.0391,2,2
0,0,11,11,14,11,25,50,33,83,0.000333,0.12848,21,8094.241339,449.680074,385.440064,91.356717,2,2
0,0,10,10,12,10,22,48,32,80,0.000333,0.118918,18,6421.581531,356.754529,356.754529,76.238831,2,2
0,0,10,10,14,12,26,53,36,89,0.000333,0.139446,21,8785.121833,488.062324,418.339135,96.322519,2,2
0,0,11,11,13,10,23,48,33,81,0.000333,0.122136,18,6595.353332,366.408518,366.408518,81.324997,1,2
0,0,14,14,14,12,26,61,42,103,0.000333,0.161382,21,10167.05111,564.836173,484.145291,96.322519,2,2
0,0,14,14,13,12,25,60,42,102,0.000333,0.157891,18,8526.119964,473.673331,473.673331,91.125266,2,2
0,0,11,11,11,11,22,51,37,88,0.000333,0.13081,15,5886.449737,327.024985,392.429982,76.107496,1,2
0,0,12,12,11,12,23,56,39,95,0.000333,0.143246,15,6446.075787,358.115322,429.738386,81.073298,1,2
0,0,11,11,11,12,23,52,37,89,0.000333,0.134199,15,6038.955211,335.497512,402.597014,81.073298,1,2
0,0,12,12,12,14,26,53,40,93,0.000333,0.145714,12,5245.690725,291.427263,437.140894,96.322519,1,2
0,0,11,11,11,12,23,51,37,88,0.000333,0.132691,15,5971.101782,331.727877,398.073452,81.073298,1,2
0,0,12,12,13,11,24,56,39,95,0.000333,0.14519,18,7840.285876,435.571438,435.571438,86.159464,1,2
0,0,11,11,12,12,24,52,37,89,0.000333,0.136021,18,7345.109926,408.061663,408.061663,86.0391,1,2
0,0,12,12,12,13,25,60,41,101,0.000333,0.156343,18,8442.530553,469.029475,469.029475,91.125266,1,2
0,0,13,13,12,13,25,52,39,91,0.000333,0.140864,18,7606.636439,422.590913,422.590913,91.125266,1,2
0,0,11,11,11,12,23,51,37,88,0.000333,0.132691,15,5971.101782,331.727877,398.073452,81.073298,1,2
0,0,13,13,11,13,24,57,43,100,0.000333,0.152832,15,6877.443751,382.080208,458.49625,86.159464,1,2
0,0,15,15,11,14,25,63,49,112,0.000333,0.173371,15,7801.678399,433.426578,520.111893,91.356717,1,2
0,0,17,17,11,15,26,69,55,124,0.000333,0.194285,15,8742.817876,485.712104,582.854525,96.657107,1,2
0,0,12,12,12,11,23,55,39,94,0.000333,0.141738,18,7653.86683,425.214824,425.214824,81.073298,1,2
0,0,11,11,12,12,24,52,37,89,0.000333,0.136021,18,7345.109926,408.061663,408.061663,86.0391,1,2
0,0,12,12,12,13,25,57,40,97,0.000333,0.150151,18,8108.172907,450.45405,450.45405,91.125266,1,2
0,0,13,13,12,14,26,66,44,110,0.000333,0.172349,18,9306.870642,517.048369,517.048369,96.322519,1,2
0,0,12,12,11,13,24,59,41,100,0.000333,0.152832,15,6877.443751,382.080208,458.49625,86.159464,1,2
0,0,13,13,11,15,26,62,44,106,0.000333,0.166082,10,4982.466101,276.803672,498.24661,96.657107,1,2
0,0,14,14,12,15,27,58,46,104,0.000333,0.164836,18,8901.149404,494.5083,494.5083,101.622909,1,2
0,0,12,12,11,15,26,49,39,88,0.000333,0.13788,10,4136.386952,229.799275,413.638695,96.657107,1,2
0,0,16,16,14,17,31,83,63,146,0.000333,0.241104,21,15189.56589,843.864772,723.312661,122.789837,1,2
0,0,16,16,14,16,30,73,54,127,0.000333,0.207725,21,13086.67722,727.037623,623.175106,117.302969,1,2
0,0,16,16,13,17,30,76,56,132,0.000333,0.215903,18,11658.77206,647.709559,647.709559,117.592585,1,2
0,0,9,9,10,10,20,42,31,73,0.000333,0.105167,15,4732.511264,262.917292,315.500751,66.438562,1,2
0,0,10,10,11,10,21,45,32,77,0.000333,0.112736,15,5073.126623,281.840368,338.208442,71.273029,2,2
0,0,10,10,11,11,22,45,33,78,0.000333,0.115945,15,5217.534994,289.863055,347.835666,76.107496,2,2
0,0,10,10,11,11,22,45,32,77,0.000333,0.114459,10,3433.762346,190.764575,343.376235,76.107496,2,2
0,0,10,10,11,11,22,45,32,77,0.000333,0.114459,10,3433.762346,190.764575,343.376235,76.107496,2,2
0,0,10,10,11,12,23,45,33,78,0.000333,0.117613,10,3528.378326,196.021018,352.837833,81.073298,2,2
0,0,10,10,11,12,23,45,33,78,0.000333,0.117613,10,3528.378326,196.021018,352.837833,81.073298,2,2
0,0,10,10,11,11,22,45,32,77,0.000333,0.114459,10,3433.762346,190.764575,343.376235,76.107496,2,2
0,0,10,10,11,11,22,45,32,77,0.000333,0.114459,10,3433.762346,190.764575,343.376235,76.107496,2,2
0,0,10,10,11,11,22,45,32,77,0.000333,0.114459,10,3433.762346,190.764575,343.376235,76.107496,2,2
0,0,10,10,11,11,22,45,32,77,0.000333,0.114459,10,3433.762346,190.764575,343.376235,76.107496,2,2
0,0,15,15,12,11,23,65,45,110,0.000333,0.165864,24,11942.20356,663.455754,497.591815,81.073298,2,2
0,0,10,10,11,12,23,45,33,78,0.000333,0.117613,10,3528.378326,196.021018,352.837833,81.073298,2,2
0,0,10,10,11,12,23,45,33,78,0.000333,0.117613,10,3528.378326,196.021018,352.837833,81.073298,2,2
0,0,11,11,13,11,24,47,33,80,0.000333,0.122266,18,6602.346001,366.797,366.797,86.159464,2,2
0,0,10,10,11,10,21,45,32,77,0.000333,0.112736,15,5073.126623,281.840368,338.208442,71.273029,2,2
0,0,10,10,13,12,25,50,36,86,0.000333,0.133124,18,7188.689382,399.371632,399.371632,91.125266,2,2
0,0,11,11,12,10,22,45,33,78,0.000333,0.115945,18,6261.041993,347.835666,347.835666,76.238831,1,2
0,0,14,14,13,12,25,58,42,100,0.000333,0.154795,18,8358.941142,464.385619,464.385619,91.125266,2,2
0,0,14,14,12,12,24,57,42,99,0.000333,0.151304,18,8170.403176,453.911288,453.911288,86.0391,2,2
0,0,11,11,10,11,21,48,37,85,0.000333,0.124449,15,5600.204714,311.122484,373.346981,71.273029,1,2
0,0,12,12,10,12,22,53,39,92,0.000333,0.136756,15,6154.015634,341.889757,410.267709,76.238831,1,2
0,0,10,10,10,11,21,45,34,79,0.000333,0.115664,15,5204.896146,289.160897,346.993076,71.273029,1,2
0,0,12,12,11,14,25,50,40,90,0.000333,0.139316,10,4179.470571,232.192809,417.947057,91.356717,1,2
0,0,11,11,10,12,22,48,37,85,0.000333,0.126351,15,5685.775314,315.876406,379.051688,76.238831,1,2
0,0,12,12,12,11,23,53,39,92,0.000333,0.138723,18,7491.018599,416.1677,416.1677,81.073298,1,2
0,0,11,11,12,12,24,50,37,87,0.000333,0.132964,18,7180.051276,398.891738,398.891738,86.0391,1,2
0,0,12,12,11,13,24,57,41,98,0.000333,0.149775,15,6739.894876,374.438604,449.326325,86.159464,1,2
0,0,13,13,11,13,24,49,39,88,0.000333,0.134492,15,6052.150501,336.230583,403.4767,86.159464,1,2
0,0,11,11,10,12,22,48,37,85,0.000333,0.126351,15,5685.775314,315.876406,379.051688,76.238831,1,2
0,0,13,13,10,13,23,54,43,97,0.000333,0.146262,15,6581.782646,365.654591,438.78551,81.324997,1,2
0,0,15,15,10,14,24,60,49,109,0.000333,0.166587,15,7496.413689,416.467427,499.760913,86.52225,1,2
0,0,17,17,10,15,25,66,55,121,0.000333,0.187302,15,8428.598984,468.255499,561.906599,91.82264,1,2
0,0,12,12,11,11,22,52,39,91,0.000333,0.135269,15,6087.124159,338.173564,405.808277,76.107496,1,2
0,0,11,11,11,12,23,49,37,86,0.000333,0.129675,15,5835.394923,324.188607,389.026328,81.073298,1,2
0,0,12,12,11,13,24,54,40,94,0.000333,0.143662,15,6464.797126,359.155396,430.986475,86.159464,1,2
0,0,13,13,11,14,25,63,44,107,0.000333,0.165631,15,7453.389185,414.077177,496.892612,91.356717,1,2
0,0,12,12,10,13,23,56,41,97,0.000333,0.146262,15,6581.782646,365.654591,438.78551,81.324997,1,2
0,0,7,7,10,10,20,28,22,50,0.000333,0.072032,10,2160.964047,120.053558,216.096405,66.438562,1,2
0,0,3,3,8,8,16,16,11,27,0.000333,0.036,4,432,24,108,48,1,2
0,0,7,7,9,10,19,31,24,55,0.000333,0.077879,8,1869.088106,103.838228,233.636013,61.748606,1,2
0,0,13,13,12,17,29,64,52,116,0.000333,0.187842,18,10143.46432,563.525795,563.525795,112.506418,1,2
0,0,13,13,12,16,28,54,43,97,0.000333,0.155438,12,5595.761129,310.875618,466.313427,107.01955,1,2
0,0,5,5,10,9,19,23,17,40,0.000333,0.056639,5,849.585503,47.199195,169.917101,61.748606,1,2
0,0,3,3,8,8,16,16,11,27,0.000333,0.036,4,432,24,108,48,1,2
0,0,7,7,9,10,19,31,24,55,0.000333,0.077879,8,1869.088106,103.838228,233.636013,61.748606,1,2
0,0,13,13,12,17,29,64,52,116,0.000333,0.187842,18,10143.46432,563.525795,563.525795,112.506418,1,2
0,0,13,13,12,16,28,54,43,97,0.000333,0.155438,12,5595.761129,310.875618,466.313427,107.01955,1,2
0,0,13,13,11,17,28,57,45,102,0.000333,0.16345,10,4903.50202,272.416779,490.350202,107.540616,1,2
0,0,8,8,11,11,22,36,26,62,0.000333,0.092162,10,2764.847604,153.602645,276.48476,76.107496,1,2
0,0,3,3,9,8,17,18,11,29,0.000333,0.039512,4,474.14569,26.341427,118.536422,52.529325,1,2
0,0,7,7,10,10,20,35,24,59,0.000333,0.084998,10,2549.937576,141.663199,254.993758,66.438562,1,2
0,0,13,13,13,17,30,66,52,118,0.000333,0.193004,18,10422.23563,579.01309,579.01309,117.592585,1,2
0,0,13,13,13,16,29,56,43,99,0.000333,0.160313,12,5771.281422,320.626746,480.940119,112.105716,1,2
0,0,13,13,12,17,29,59,45,104,0.000333,0.16841,12,6062.760282,336.820016,505.230023,112.506418,1,2
0,0,8,8,11,12,23,47,30,77,0.000333,0.116105,10,3483.142706,193.507928,348.314271,81.073298,1,2
0,0,4,4,10,10,20,32,18,50,0.000333,0.072032,5,1080.482024,60.026779,216.096405,66.438562,1,2
0,0,9,9,11,13,24,59,36,95,0.000333,0.14519,10,4355.714376,241.984132,435.571438,86.159464,1,2
0,0,13,13,13,18,31,77,56,133,0.000333,0.219636,18,11860.34597,658.908109,658.908109,123.164366,1,2
0,0,13,13,13,17,30,67,47,114,0.000333,0.186462,12,6712.626335,372.923685,559.385528,117.592585,1,2
0,0,13,13,12,18,30,70,49,119,0.000333,0.19464,12,7007.039771,389.279987,583.919981,118.0782,1,2
0,0,7,7,11,12,23,45,28,73,0.000333,0.110073,10,3302.200228,183.455568,330.220023,81.073298,1,2
0,0,7,7,10,11,21,45,27,72,0.000333,0.105416,10,3162.468544,175.692697,316.246854,71.273029,1,2
0,0,9,9,11,13,24,59,36,95,0.000333,0.14519,10,4355.714376,241.984132,435.571438,86.159464,1,2
0,0,13,13,13,18,31,77,56,133,0.000333,0.219636,18,11860.34597,658.908109,658.908109,123.164366,1,2
0,0,13,13,13,17,30,67,47,114,0.000333,0.186462,12,6712.626335,372.923685,559.385528,117.592585,1,2
0,0,13,13,12,18,30,70,49,119,0.000333,0.19464,12,7007.039771,389.279987,583.919981,118.0782,1,2
0,0,8,8,11,12,23,43,29,72,0.000333,0.108565,10,3256.964608,180.942478,325.696461,81.073298,1,2
0,0,7,7,10,12,22,39,25,64,0.000333,0.095135,10,2854.036236,158.557569,285.403624,76.238831,1,2
0,0,9,9,11,13,24,51,34,85,0.000333,0.129907,10,3897.218126,216.512118,389.721813,86.159464,1,2
0,0,13,13,13,18,31,73,55,128,0.000333,0.211379,18,11414.4683,634.137128,634.137128,123.164366,1,2
0,0,13,13,12,18,30,66,48,114,0.000333,0.186462,12,6712.626335,372.923685,559.385528,118.0782,1,2
0,0,8,8,11,12,23,43,29,72,0.000333,0.108565,10,3256.964608,180.942478,325.696461,81.073298,1,2
0,0,8,8,10,12,22,41,27,68,0.000333,0.10108,10,3032.413501,168.467417,303.24135,76.238831,1,2
0,0,9,9,11,13,24,51,34,85,0.000333,0.129907,10,3897.218126,216.512118,389.721813,86.159464,1,2
0,0,13,13,13,18,31,73,55,128,0.000333,0.211379,18,11414.4683,634.137128,634.137128,123.164366,1,2
0,0,13,13,13,17,30,63,46,109,0.000333,0.178284,12,6418.212899,356.567383,534.851075,117.592585,1,2
0,0,13,13,12,18,30,66,48,114,0.000333,0.186462,12,6712.626335,372.923685,559.385528,118.0782,1,2
0,0,8,8,12,12,24,45,29,74,0.000333,0.113096,12,4071.446701,226.191483,339.287225,86.0391,1,2
0,0,3,3,9,8,17,18,11,29,0.000333,0.039512,4,474.14569,26.341427,118.536422,52.529325,1,2
0,0,9,9,12,13,25,55,34,89,0.000333,0.137768,12,4959.638411,275.535467,413.303201,91.125266,1,2
0,0,13,13,14,18,32,75,55,130,0.000333,0.216667,21,13650,758.333333,650,128.361619,1,2
0,0,13,13,14,17,31,65,46,111,0.000333,0.183305,14,7698.821066,427.712281,549.91579,122.789837,1,2
0,0,13,13,13,18,31,68,48,116,0.000333,0.191562,12,6896.241264,383.124515,574.686772,123.164366,1,2
0,0,8,8,11,11,22,38,27,65,0.000333,0.096621,10,2898.630552,161.035031,289.863055,76.107496,1,2
0,0,8,8,10,11,21,36,25,61,0.000333,0.08931,10,2679.313628,148.850757,267.931363,71.273029,1,2
0,0,9,9,11,12,23,50,33,83,0.000333,0.125152,10,3754.556424,208.586468,375.455642,81.073298,1,2
0,0,13,13,13,17,30,68,53,121,0.000333,0.197911,18,10687.20772,593.733762,593.733762,117.592585,1,2
0,0,13,13,13,16,29,58,44,102,0.000333,0.165171,12,5946.168738,330.342708,495.514062,112.105716,1,2
0,0,13,13,12,17,29,61,46,107,0.000333,0.173268,12,6237.647598,346.535978,519.803966,112.506418,1,2
0,0,8,8,11,11,22,38,27,65,0.000333,0.096621,10,2898.630552,161.035031,289.863055,76.107496,1,2
0,0,8,8,10,11,21,36,25,61,0.000333,0.08931,10,2679.313628,148.850757,267.931363,71.273029,1,2
0,0,9,9,11,12,23,50,33,83,0.000333,0.125152,10,3754.556424,208.586468,375.455642,81.073298,1,2
0,0,13,13,13,17,30,68,53,121,0.000333,0.197911,18,10687.20772,593.733762,593.733762,117.592585,1,2
0,0,13,13,13,16,29,58,44,102,0.000333,0.165171,12,5946.168738,330.342708,495.514062,112.105716,1,2
0,0,13,13,12,17,29,61,46,107,0.000333,0.173268,12,6237.647598,346.535978,519.803966,112.506418,1,2
0,0,8,8,10,11,21,34,26,60,0.000333,0.087846,10,2635.390454,146.410581,263.539045,71.273029,1,2
0,0,8,8,9,11,20,32,24,56,0.000333,0.080676,8,1936.223787,107.567988,242.027973,66.583073,1,2
0,0,9,9,10,12,22,42,31,73,0.000333,0.108513,10,3255.385082,180.854727,325.538508,76.238831,1,2
0,0,13,13,12,17,29,64,52,116,0.000333,0.187842,18,10143.46432,563.525795,563.525795,112.506418,1,2
0,0,13,13,12,16,28,54,43,97,0.000333,0.155438,12,5595.761129,310.875618,466.313427,107.01955,1,2
0,0,13,13,11,17,28,57,45,102,0.000333,0.16345,10,4903.50202,272.416779,490.350202,107.540616,1,2
0,0,8,8,10,11,21,34,26,60,0.000333,0.087846,10,2635.390454,146.410581,263.539045,71.273029,1,2
0,0,3,3,8,8,16,16,11,27,0.000333,0.036,4,432,24,108,48,1,2
0,0,9,9,10,12,22,42,31,73,0.000333,0.108513,10,3255.385082,180.854727,325.538508,76.238831,1,2
0,0,9,9,12,15,27,51,41,92,0.000333,0.145817,12,5249.395802,291.6331,437.44965,101.622909,1,2
0,0,9,9,12,14,26,41,32,73,0.000333,0.114377,12,4117.585193,228.754733,343.132099,96.322519,1,2
0,0,13,13,11,17,28,57,45,102,0.000333,0.16345,10,4903.50202,272.416779,490.350202,107.540616,1,2
0,0,6,6,11,10,21,31,21,52,0.000333,0.076134,10,2284.00506,126.88917,228.400506,71.273029,1,2
0,0,3,3,9,8,17,18,11,29,0.000333,0.039512,4,474.14569,26.341427,118.536422,52.529325,1,2
0,0,9,9,11,12,23,46,31,77,0.000333,0.116105,10,3483.142706,193.507928,348.314271,81.073298,1,2
0,0,9,9,13,15,28,53,41,94,0.000333,0.15063,12,5422.696352,301.260908,451.891363,106.709075,1,2
0,0,10,10,13,16,29,46,35,81,0.000333,0.131165,12,4721.957527,262.330974,393.496461,112.105716,1,2
0,0,13,13,12,17,29,59,45,104,0.000333,0.16841,12,6062.760282,336.820016,505.230023,112.506418,1,2
0,0,7,7,11,10,21,34,22,56,0.000333,0.08199,10,2459.697757,136.649875,245.969776,71.273029,1,2
0,0,13,13,13,18,31,76,54,130,0.000333,0.214682,18,11592.81937,644.04552,644.04552,123.164366,1,2
0,0,13,13,13,17,30,66,45,111,0.000333,0.181555,12,6535.978273,363.109904,544.664856,117.592585,1,2
0,0,13,13,12,17,29,69,47,116,0.000333,0.187842,12,6762.309545,375.683864,563.525795,112.506418,1,2
0,0,8,8,11,12,23,46,28,74,0.000333,0.111581,10,3347.435847,185.968658,334.743585,81.073298,1,2
0,0,13,13,13,18,31,76,54,130,0.000333,0.214682,18,11592.81937,644.04552,644.04552,123.164366,1,2
0,0,14,14,15,24,39,71,54,125,0.000333,0.220225,14,9249.453883,513.858549,660.675277,168.642459,1,2
0,0,14,14,15,24,39,74,56,130,0.000333,0.229034,14,9619.432038,534.412891,687.102288,168.642459,1,2
0,0,8,8,10,11,21,28,22,50,0.000333,0.073205,10,2196.158711,122.008817,219.615871,71.273029,1,2
0,0,13,13,12,17,29,58,48,106,0.000333,0.171649,12,6179.351826,343.297324,514.945985,112.506418,1,2
0,0,13,13,12,16,28,48,39,87,0.000333,0.139413,12,5018.878539,278.826585,418.239878,107.01955,1,2
0,0,13,13,11,16,27,51,41,92,0.000333,0.145817,10,4374.496502,243.027583,437.44965,102.053748,1,2
0,0,8,8,10,11,21,28,22,50,0.000333,0.073205,10,2196.158711,122.008817,219.615871,71.273029,1,2
0,0,13,13,12,17,29,58,48,106,0.000333,0.171649,12,6179.351826,343.297324,514.945985,112.506418,1,2
0,0,13,13,12,16,28,48,39,87,0.000333,0.139413,12,5018.878539,278.826585,418.239878,107.01955,1,2
0,0,13,13,11,16,27,51,41,92,0.000333,0.145817,10,4374.496502,243.027583,437.44965,102.053748,1,2
0,0,7,7,11,11,22,42,26,68,0.000333,0.10108,10,3032.413501,168.467417,303.24135,76.107496,1,2
0,0,14,14,15,25,40,81,63,144,0.000333,0.255453,14,10729.00704,596.055947,766.357646,174.699764,1,2
0,0,14,14,15,24,39,71,54,125,0.000333,0.220225,14,9249.453883,513.858549,660.675277,168.642459,1,2
0,0,14,14,15,24,39,74,56,130,0.000333,0.229034,14,9619.432038,534.412891,687.102288,168.642459,1,2
0,0,8,8,13,17,30,29,29,58,0.000333,0.094867,6,1707.597927,94.866552,284.599655,117.592585,1,2
0,0,13,13,12,17,29,58,48,106,0.000333,0.171649,12,6179.351826,343.297324,514.945985,112.506418,1,2
0,0,13,13,12,16,28,48,39,87,0.000333,0.139413,12,5018.878539,278.826585,418.239878,107.01955,1,2
0,0,13,13,11,16,27,51,41,92,0.000333,0.145817,10,4374.496502,243.027583,437.44965,102.053748,1,2
0,0,8,8,11,11,22,40,27,67,0.000333,0.099594,10,2987.819184,165.989955,298.781918,76.107496,1,2
0,0,6,6,10,10,20,33,21,54,0.000333,0.077795,10,2333.841171,129.657843,233.384117,66.438562,1,2
0,0,9,9,11,12,23,45,30,75,0.000333,0.113089,10,3392.671467,188.481748,339.267147,81.073298,1,2
0,0,13,13,13,17,30,70,53,123,0.000333,0.201183,18,10863.85578,603.547543,603.547543,117.592585,1,2
0,0,13,13,13,16,29,60,44,104,0.000333,0.16841,12,6062.760282,336.820016,505.230023,112.105716,1,2
0,0,13,13,12,17,29,63,46,109,0.000333,0.176507,12,6354.239142,353.013286,529.519928,112.506418,1,2
0,0,8,8,11,11,22,40,27,67,0.000333,0.099594,10,2987.819184,165.989955,298.781918,76.107496,1,2
0,0,7,7,10,11,21,36,23,59,0.000333,0.086382,10,2591.467279,143.970404,259.146728,71.273029,1,2
0,0,9,9,11,12,23,45,30,75,0.000333,0.113089,10,3392.671467,188.481748,339.267147,81.073298,1,2
0,0,13,13,13,17,30,70,53,123,0.000333,0.201183,18,10863.85578,603.547543,603.547543,117.592585,1,2
0,0,13,13,13,16,29,60,44,104,0.000333,0.16841,12,6062.760282,336.820016,505.230023,112.105716,1,2
0,0,13,13,12,17,29,63,46,109,0.000333,0.176507,12,6354.239142,353.013286,529.519928,112.506418,1,2
0,0,8,8,10,10,20,31,24,55,0.000333,0.079235,10,2377.060452,132.058914,237.706045,66.438562,1,2
0,0,8,8,9,10,19,29,22,51,0.000333,0.072215,8,1733.154425,96.286357,216.644303,61.748606,1,2
0,0,9,9,10,11,21,36,27,63,0.000333,0.092239,10,2767.159976,153.73111,276.715998,71.273029,1,2
0,0,13,13,12,16,28,61,50,111,0.000333,0.177872,18,9605.095134,533.616396,533.616396,107.01955,1,2
0,0,13,13,12,15,27,51,41,92,0.000333,0.145817,12,5249.395802,291.6331,437.44965,101.622909,1,2
0,0,13,13,11,16,27,54,43,97,0.000333,0.153741,10,4612.240877,256.235604,461.224088,102.053748,1,2
0,0,8,8,10,10,20,31,24,55,0.000333,0.079235,10,2377.060452,132.058914,237.706045,66.438562,1,2
0,0,3,3,8,7,15,13,9,22,0.000333,0.028651,4,343.806372,19.100354,85.951593,43.651484,1,2
0,0,9,9,10,11,21,36,27,63,0.000333,0.092239,10,2767.159976,153.73111,276.715998,71.273029,1,2
0,0,13,13,12,16,28,61,50,111,0.000333,0.177872,18,9605.095134,533.616396,533.616396,107.01955,1,2
0,0,13,13,12,15,27,51,41,92,0.000333,0.145817,12,5249.395802,291.6331,437.44965,101.622909,1,2
0,0,13,13,11,16,27,54,43,97,0.000333,0.153741,10,4612.240877,256.235604,461.224088,102.053748,1,2
0,0,7,7,11,11,22,35,24,59,0.000333,0.087702,10,2631.064655,146.170259,263.106465,76.107496,1,2
0,0,8,8,10,11,21,38,25,63,0.000333,0.092239,10,2767.159976,153.73111,276.715998,71.273029,1,2
0,0,9,9,11,12,23,45,30,75,0.000333,0.113089,10,3392.671467,188.481748,339.267147,81.073298,1,2
0,0,13,13,13,17,30,70,53,123,0.000333,0.201183,18,10863.85578,603.547543,603.547543,117.592585,1,2
0,0,13,13,13,16,29,60,44,104,0.000333,0.16841,12,6062.760282,336.820016,505.230023,112.105716,1,2
0,0,13,13,12,17,29,63,46,109,0.000333,0.176507,12,6354.239142,353.013286,529.519928,112.506418,1,2
0,0,8,8,10,10,20,31,24,55,0.000333,0.079235,10,2377.060452,132.058914,237.706045,66.438562,1,2
0,0,3,3,8,7,15,13,9,22,0.000333,0.028651,4,343.806372,19.100354,85.951593,43.651484,1,2
0,0,9,9,10,11,21,36,27,63,0.000333,0.092239,10,2767.159976,153.73111,276.715998,71.273029,1,2
0,0,13,13,12,16,28,61,50,111,0.000333,0.177872,18,9605.095134,533.616396,533.616396,107.01955,1,2
0,0,13,13,12,15,27,51,41,92,0.000333,0.145817,12,5249.395802,291.6331,437.44965,101.622909,1,2
0,0,13,13,11,16,27,54,43,97,0.000333,0.153741,10,4612.240877,256.235604,461.224088,102.053748,1,2
0,0,6,6,11,11,22,28,21,49,0.000333,0.072837,5,1092.560747,60.697819,218.512149,76.107496,4,2
0,0,6,6,11,11,22,28,21,49,0.000333,0.072837,5,1092.560747,60.697819,218.512149,76.107496,4,2
0,0,6,6,11,11,22,28,21,49,0.000333,0.072837,5,1092.560747,60.697819,218.512149,76.107496,4,2
0,0,6,6,11,11,22,28,21,49,0.000333,0.072837,5,1092.560747,60.697819,218.512149,76.107496,4,2
0,0,6,6,11,11,22,28,21,49,0.000333,0.072837,5,1092.560747,60.697819,218.512149,76.107496,4,2
0,0,6,6,11,11,22,28,21,49,0.000333,0.072837,5,1092.560747,60.697819,218.512149,76.107496,4,2
0,0,6,6,11,11,22,28,21,49,0.000333,0.072837,5,1092.560747,60.697819,218.512149,76.107496,4,2
0,0,6,6,11,11,22,28,21,49,0.000333,0.072837,5,1092.560747,60.697819,218.512149,76.107496,4,2
0,0,6,6,11,11,22,28,21,49,0.000333,0.072837,5,1092.560747,60.697819,218.512149,76.107496,4,2
0,0,6,6,11,11,22,28,21,49,0.000333,0.072837,5,1092.560747,60.697819,218.512149,76.107496,4,2
0,0,6,6,11,11,22,28,21,49,0.000333,0.072837,5,1092.560747,60.697819,218.512149,76.107496,4,2
0,0,6,6,11,11,22,28,21,49,0.000333,0.072837,5,1092.560747,60.697819,218.512149,76.107496,4,2
0,0,6,6,11,11,22,28,21,49,0.000333,0.072837,5,1092.560747,60.697819,218.512149,76.107496,4,2
0,0,6,6,11,11,22,28,21,49,0.000333,0.072837,5,1092.560747,60.697819,218.512149,76.107496,4,2
0,0,6,6,11,11,22,28,21,49,0.000333,0.072837,5,1092.560747,60.697819,218.512149,76.107496,4,2
0,0,6,6,11,11,22,28,21,49,0.000333,0.072837,5,1092.560747,60.697819,218.512149,76.107496,4,2
0,0,6,6,11,11,22,28,21,49,0.000333,0.072837,5,1092.560747,60.697819,218.512149,76.107496,4,2
0,0,6,6,11,11,22,28,21,49,0.000333,0.072837,5,1092.560747,60.697819,218.512149,76.107496,4,2
0,0,6,6,11,11,22,28,21,49,0.000333,0.072837,5,1092.560747,60.697819,218.512149,76.107496,4,2
0,0,6,6,11,11,22,28,21,49,0.000333,0.072837,5,1092.560747,60.697819,218.512149,76.107496,4,2
0,0,6,6,11,11,22,28,21,49,0.000333,0.072837,5,1092.560747,60.697819,218.512149,76.107496,4,2
0,0,6,6,11,11,22,28,21,49,0.000333,0.072837,5,1092.560747,60.697819,218.512149,76.107496,4,2
0,0,6,6,11,11,22,28,21,49,0.000333,0.072837,5,1092.560747,60.697819,218.512149,76.107496,4,2
0,0,6,6,11,11,22,28,21,49,0.000333,0.072837,5,1092.560747,60.697819,218.512149,76.107496,4,2
0,0,6,6,11,11,22,28,21,49,0.000333,0.072837,5,1092.560747,60.697819,218.512149,76.107496,4,2
0,0,6,6,11,11,22,28,21,49,0.000333,0.072837,5,1092.560747,60.697819,218.512149,76.107496,4,2
0,0,6,6,11,11,22,28,21,49,0.000333,0.072837,5,1092.560747,60.697819,218.512149,76.107496,4,2
0,0,6,6,11,11,22,28,21,49,0.000333,0.072837,5,1092.560747,60.697819,218.512149,76.107496,4,2
0,0,6,6,11,11,22,28,21,49,0.000333,0.072837,5,1092.560747,60.697819,218.512149,76.107496,4,2
0,0,6,6,11,11,22,28,21,49,0.000333,0.072837,5,1092.560747,60.697819,218.512149,76.107496,4,2
0,0,6,6,11,11,22,28,21,49,0.000333,0.072837,5,1092.560747,60.697819,218.512149,76.107496,4,2
0,0,6,6,11,11,22,28,21,49,0.000333,0.072837,5,1092.560747,60.697819,218.512149,76.107496,4,2
0,0,6,6,11,11,22,28,21,49,0.000333,0.072837,5,1092.560747,60.697819,218.512149,76.107496,4,2
0,0,6,6,11,11,22,28,21,49,0.000333,0.072837,5,1092.560747,60.697819,218.512149,76.107496,4,2
0,0,6,6,11,11,22,28,21,49,0.000333,0.072837,5,1092.560747,60.697819,218.512149,76.107496,4,2
0,0,6,6,11,11,22,28,21,49,0.000333,0.072837,5,1092.560747,60.697819,218.512149,76.107496,4,2
0,0,6,6,11,11,22,28,21,49,0.000333,0.072837,5,1092.560747,60.697819,218.512149,76.107496,4,2
0,0,6,6,11,11,22,28,21,49,0.000333,0.072837,5,1092.560747,60.697819,218.512149,76.107496,4,2
0,0,6,6,11,11,22,28,21,49,0.000333,0.072837,5,1092.560747,60.697819,218.512149,76.107496,4,2
0,0,6,6,11,11,22,28,21,49,0.000333,0.072837,5,1092.560747,60.697819,218.512149,76.107496,4,2
0,0,6,6,11,11,22,28,21,49,0.000333,0.072837,5,1092.560747,60.697819,218.512149,76.107496,4,2
0,0,6,6,11,11,22,28,21,49,0.000333,0.072837,5,1092.560747,60.697819,218.512149,76.107496,4,2
0,0,6,6,11,11,22,28,21,49,0.000333,0.072837,5,1092.560747,60.697819,218.512149,76.107496,4,2
0,0,6,6,11,11,22,28,21,49,0.000333,0.072837,5,1092.560747,60.697819,218.512149,76.107496,4,2
0,0,6,6,11,11,22,28,21,49,0.000333,0.072837,5,1092.560747,60.697819,218.512149,76.107496,4,2
0,0,6,6,11,11,22,28,21,49,0.000333,0.072837,5,1092.560747,60.697819,218.512149,76.107496,4,2
0,0,6,6,11,11,22,28,21,49,0.000333,0.072837,5,1092.560747,60.697819,218.512149,76.107496,4,2
0,0,6,6,11,11,22,28,21,49,0.000333,0.072837,5,1092.560747,60.697819,218.512149,76.107496,4,2
0,0,6,6,11,11,22,28,21,49,0.000333,0.072837,5,1092.560747,60.697819,218.512149,76.107496,4,2
0,0,6,6,11,11,22,28,21,49,0.000333,0.072837,5,1092.560747,60.697819,218.512149,76.107496,4,2
0,0,6,6,11,11,22,28,21,49,0.000333,0.072837,5,1092.560747,60.697819,218.512149,76.107496,4,2
0,0,6,6,11,11,22,28,21,49,0.000333,0.072837,5,1092.560747,60.697819,218.512149,76.107496,4,2
0,0,6,6,11,11,22,28,21,49,0.000333,0.072837,5,1092.560747,60.697819,218.512149,76.107496,4,2
0,0,6,6,11,11,22,28,21,49,0.000333,0.072837,5,1092.560747,60.697819,218.512149,76.107496,4,2
0,0,6,6,11,11,22,28,21,49,0.000333,0.072837,5,1092.560747,60.697819,218.512149,76.107496,4,2
0,0,6,6,11,11,22,28,21,49,0.000333,0.072837,5,1092.560747,60.697819,218.512149,76.107496,4,2
0,0,6,6,11,11,22,28,21,49,0.000333,0.072837,5,1092.560747,60.697819,218.512149,76.107496,4,2
0,0,6,6,11,11,22,28,21,49,0.000333,0.072837,5,1092.560747,60.697819,218.512149,76.107496,4,2
0,0,6,6,11,11,22,28,21,49,0.000333,0.072837,5,1092.560747,60.697819,218.512149,76.107496,4,2
0,0,6,6,11,11,22,28,21,49,0.000333,0.072837,5,1092.560747,60.697819,218.512149,76.107496,4,2
0,0,6,6,11,11,22,28,21,49,0.000333,0.072837,5,1092.560747,60.697819,218.512149,76.107496,4,2
0,0,6,6,11,11,22,28,21,49,0.000333,0.072837,5,1092.560747,60.697819,218.512149,76.107496,4,2
0,0,6,6,11,11,22,28,21,49,0.000333,0.072837,5,1092.560747,60.697819,218.512149,76.107496,4,2
0,0,6,6,11,11,22,28,21,49,0.000333,0.072837,5,1092.560747,60.697819,218.512149,76.107496,4,2
0,0,6,6,11,11,22,28,21,49,0.000333,0.072837,5,1092.560747,60.697819,218.512149,76.107496,4,2
0,0,6,6,11,11,22,28,21,49,0.000333,0.072837,5,1092.560747,60.697819,218.512149,76.107496,4,2
0,0,6,6,11,11,22,28,21,49,0.000333,0.072837,5,1092.560747,60.697819,218.512149,76.107496,4,2
0,0,6,6,11,11,22,28,21,49,0.000333,0.072837,5,1092.560747,60.697819,218.512149,76.107496,4,2
0,0,6,6,11,11,22,28,21,49,0.000333,0.072837,5,1092.560747,60.697819,218.512149,76.107496,4,2
0,0,6,6,11,11,22,28,21,49,0.000333,0.072837,5,1092.560747,60.697819,218.512149,76.107496,4,2
0,0,6,6,11,11,22,28,21,49,0.000333,0.072837,5,1092.560747,60.697819,218.512149,76.107496,4,2
0,0,6,6,11,11,22,28,21,49,0.000333,0.072837,5,1092.560747,60.697819,218.512149,76.107496,4,2
0,0,6,6,11,11,22,28,21,49,0.000333,0.072837,5,1092.560747,60.697819,218.512149,76.107496,4,2
0,0,6,6,11,11,22,28,21,49,0.000333,0.072837,5,1092.560747,60.697819,218.512149,76.107496,4,2
0,0,6,6,11,11,22,28,21,49,0.000333,0.072837,5,1092.560747,60.697819,218.512149,76.107496,4,2
0,0,6,6,11,11,22,28,21,49,0.000333,0.072837,5,1092.560747,60.697819,218.512149,76.107496,4,2
0,0,6,6,11,11,22,28,21,49,0.000333,0.072837,5,1092.560747,60.697819,218.512149,76.107496,4,2
0,0,6,6,11,11,22,28,21,49,0.000333,0.072837,5,1092.560747,60.697819,218.512149,76.107496,4,2
0,0,6,6,11,11,22,28,21,49,0.000333,0.072837,5,1092.560747,60.697819,218.512149,76.107496,4,2
0,0,6,6,11,11,22,28,21,49,0.000333,0.072837,5,1092.560747,60.697819,218.512149,76.107496,4,2
0,0,6,6,11,11,22,28,21,49,0.000333,0.072837,5,1092.560747,60.697819,218.512149,76.107496,4,2
0,0,6,6,11,11,22,28,21,49,0.000333,0.072837,5,1092.560747,60.697819,218.512149,76.107496,4,2
0,0,6,6,11,11,22,28,21,49,0.000333,0.072837,5,1092.560747,60.697819,218.512149,76.107496,4,2
0,0,6,6,11,11,22,28,21,49,0.000333,0.072837,5,1092.560747,60.697819,218.512149,76.107496,4,2
0,0,6,6,11,11,22,28,21,49,0.000333,0.072837,5,1092.560747,60.697819,218.512149,76.107496,4,2
0,0,6,6,11,11,22,28,21,49,0.000333,0.072837,5,1092.560747,60.697819,218.512149,76.107496,4,2
0,0,6,6,11,11,22,28,21,49,0.000333,0.072837,5,1092.560747,60.697819,218.512149,76.107496,4,2
0,0,6,6,11,11,22,28,21,49,0.000333,0.072837,5,1092.560747,60.697819,218.512149,76.107496,4,2
0,0,6,6,11,11,22,28,21,49,0.000333,0.072837,5,1092.560747,60.697819,218.512149,76.107496,4,2
0,0,5,5,10,8,18,19,14,33,0.000333,0.045869,5,688.037625,38.224313,137.607525,57.219281,2,2
0,0,5,5,10,9,19,19,15,34,0.000333,0.048143,5,722.147677,40.119315,144.429535,61.748606,2,2
0,0,5,5,10,9,19,19,14,33,0.000333,0.046727,5,700.90804,38.939336,140.181608,61.748606,2,2
0,0,5,5,10,9,19,19,14,33,0.000333,0.046727,5,700.90804,38.939336,140.181608,61.748606,2,2
0,0,5,5,10,10,20,19,15,34,0.000333,0.048982,5,734.727776,40.81821,146.945555,66.438562,2,2
0,0,5,5,10,10,20,19,15,34,0.000333,0.048982,5,734.727776,40.81821,146.945555,66.438562,2,2
0,0,5,5,10,9,19,19,14,33,0.000333,0.046727,5,700.90804,38.939336,140.181608,61.748606,2,2
0,0,5,5,10,9,19,19,14,33,0.000333,0.046727,5,700.90804,38.939336,140.181608,61.748606,2,2
0,0,5,5,10,9,19,19,14,33,0.000333,0.046727,5,700.90804,38.939336,140.181608,61.748606,2,2
0,0,5,5,10,9,19,19,14,33,0.000333,0.046727,5,700.90804,38.939336,140.181608,61.748606,2,2
0,0,3,3,9,7,16,15,12,27,0.000333,0.036,4,432,24,108,48.180809,1,2
0,0,5,5,10,10,20,19,15,34,0.000333,0.048982,5,734.727776,40.81821,146.945555,66.438562,2,2
0,0,5,5,10,10,20,19,15,34,0.000333,0.048982,5,734.727776,40.81821,146.945555,66.438562,2,2
0,0,6,6,12,9,21,21,15,36,0.000333,0.052708,6,948.740563,52.707809,158.123427,71.548875,2,2
0,0,4,4,9,8,17,16,13,29,0.000333,0.039512,4,474.14569,26.341427,118.536422,52.529325,1,2
0,0,4,4,9,8,17,16,13,29,0.000333,0.039512,4,474.14569,26.341427,118.536422,52.529325,1,2
0,0,3,3,9,7,16,14,11,25,0.000333,0.033333,4,400,22.222222,100,48.180809,1,2
0,0,8,8,12,8,20,33,25,58,0.000333,0.083557,18,4512.092931,250.67183,250.67183,67.01955,1,2
0,0,5,5,10,9,19,21,15,36,0.000333,0.050975,5,764.626952,42.479275,152.92539,61.748606,2,2
0,0,5,5,10,8,18,20,17,37,0.000333,0.051429,10,1542.872251,85.715125,154.287225,57.219281,1,2
0,0,5,5,11,8,19,23,17,40,0.000333,0.056639,10,1699.171005,94.398389,169.917101,62.053748,1,2
0,0,5,5,11,8,19,21,17,38,0.000333,0.053807,10,1614.212455,89.67847,161.421246,62.053748,1,2
0,0,5,5,11,10,21,19,17,36,0.000333,0.052708,5,790.617136,43.923174,158.123427,71.273029,1,2
0,0,6,6,10,9,19,24,20,44,0.000333,0.062303,10,1869.088106,103.838228,186.908811,61.748606,1,2
0,0,4,4,9,8,17,18,14,32,0.000333,0.0436,4,523.195244,29.066402,130.798811,52.529325,1,2
0,0,3,3,9,7,16,14,11,25,0.000333,0.033333,4,400,22.222222,100,48.180809,1,2
0,0,4,4,11,9,20,18,15,33,0.000333,0.047541,5,713.118136,39.617674,142.623627,66.583073,1,2
0,0,6,6,10,9,19,20,17,37,0.000333,0.052391,5,785.86659,43.659255,157.173318,61.748606,1,2
0,0,4,4,10,9,19,17,15,32,0.000333,0.045311,5,679.668402,37.759356,135.93368,61.748606,1,2
0,0,4,4,10,9,19,17,15,32,0.000333,0.045311,5,679.668402,37.759356,135.93368,61.748606,1,2
0,0,4,4,10,9,19,17,15,32,0.000333,0.045311,5,679.668402,37.759356,135.93368,61.748606,1,2
0,0,4,4,10,9,19,17,15,32,0.000333,0.045311,5,679.668402,37.759356,135.93368,61.748606,1,2
0,0,4,4,9,8,17,18,14,32,0.000333,0.0436,4,523.195244,29.066402,130.798811,52.529325,1,2
0,0,7,7,11,10,21,28,22,50,0.000333,0.073205,10,2196.158711,122.008817,219.615871,71.273029,1,2
0,0,5,5,10,10,20,22,18,40,0.000333,0.057626,5,864.385619,48.021423,172.877124,66.438562,1,2
0,0,6,6,10,11,21,31,22,53,0.000333,0.077598,10,2327.928234,129.329346,232.792823,71.273029,1,2
0,0,4,4,10,9,19,17,15,32,0.000333,0.045311,5,679.668402,37.759356,135.93368,61.748606,1,2
0,0,7,7,10,12,22,32,25,57,0.000333,0.084729,10,2541.876023,141.215335,254.187602,76.238831,1,2
0,0,6,6,11,12,23,23,22,45,0.000333,0.067853,5,1017.80144,56.544524,203.560288,81.073298,1,2
0,0,4,4,9,11,20,16,16,32,0.000333,0.046101,4,553.206796,30.733711,138.301699,66.583073,1,2
0,0,11,11,13,15,28,53,45,98,0.000333,0.15704,18,8480.174083,471.120782,471.120782,106.709075,1,2
0,0,11,11,13,14,27,43,36,79,0.000333,0.125212,12,4507.633352,250.424075,375.636113,101.408685,1,2
0,0,11,11,12,15,27,46,38,84,0.000333,0.133137,12,4792.926602,266.2737,399.41055,101.622909,1,2
0,0,3,3,11,8,19,24,15,39,0.000333,0.055223,5,828.345865,46.019215,165.669173,62.053748,1,2
0,0,4,4,12,8,20,27,16,43,0.000333,0.061948,12,2230.114897,123.895272,185.842908,67.01955,2,2
0,0,4,4,12,9,21,27,17,44,0.000333,0.064421,6,1159.5718,64.420656,193.261967,71.548875,2,2
0,0,4,4,12,9,21,27,16,43,0.000333,0.062957,6,1133.217895,62.95655,188.869649,71.548875,2,2
0,0,4,4,12,9,21,27,16,43,0.000333,0.062957,6,1133.217895,62.95655,188.869649,71.548875,2,2
0,0,4,4,12,10,22,27,17,44,0.000333,0.065405,6,1177.289947,65.404997,196.214991,76.238831,2,2
0,0,4,4,12,10,22,27,17,44,0.000333,0.065405,6,1177.289947,65.404997,196.214991,76.238831,2,2
0,0,4,4,12,9,21,27,16,43,0.000333,0.062957,6,1133.217895,62.95655,188.869649,71.548875,2,2
0,0,4,4,12,9,21,27,16,43,0.000333,0.062957,6,1133.217895,62.95655,188.869649,71.548875,2,2
0,0,4,4,12,9,21,27,16,43,0.000333,0.062957,6,1133.217895,62.95655,188.869649,71.548875,2,2
0,0,4,4,12,9,21,27,16,43,0.000333,0.062957,6,1133.217895,62.95655,188.869649,71.548875,2,2
0,0,6,6,13,9,22,34,20,54,0.000333,0.08027,12,2889.711689,160.539538,240.809307,76.635041,2,2
0,0,4,4,12,10,22,27,17,44,0.000333,0.065405,6,1177.289947,65.404997,196.214991,76.238831,2,2
0,0,4,4,12,10,22,27,17,44,0.000333,0.065405,6,1177.289947,65.404997,196.214991,76.238831,2,2
0,0,4,4,12,9,21,26,16,42,0.000333,0.061492,6,1106.863991,61.492444,184.477332,71.548875,2,2
0,0,4,4,12,8,20,27,16,43,0.000333,0.061948,12,2230.114897,123.895272,185.842908,67.01955,2,2
0,0,4,4,14,10,24,32,20,52,0.000333,0.079473,14,3337.852701,185.436261,238.41805,86.52225,2,2
0,0,3,3,11,8,19,24,15,39,0.000333,0.055223,5,828.345865,46.019215,165.669173,62.053748,1,2
0,0,5,5,12,12,24,31,21,52,0.000333,0.079473,6,1430.5083,79.472683,238.41805,86.0391,2,2
0,0,5,5,12,10,22,31,19,50,0.000333,0.074324,6,1337.829486,74.32386,222.971581,76.238831,2,2
0,0,5,5,11,9,20,30,21,51,0.000333,0.073473,10,2204.183328,122.454629,220.418333,66.583073,1,2
0,0,6,6,12,10,22,36,23,59,0.000333,0.087702,12,3157.277586,175.40431,263.106465,76.238831,1,2
0,0,5,5,12,9,21,31,21,52,0.000333,0.076134,12,2740.806072,152.267004,228.400506,71.548875,1,2
0,0,5,5,12,11,23,29,21,50,0.000333,0.075393,6,1357.068587,75.392699,226.178098,81.073298,1,2
0,0,4,4,11,9,20,27,17,44,0.000333,0.063388,5,950.824181,52.823566,190.164836,66.583073,1,2
0,0,4,4,11,9,20,28,18,46,0.000333,0.06627,10,1988.086924,110.449274,198.808692,66.583073,1,2
0,0,3,3,11,8,19,24,15,39,0.000333,0.055223,5,828.345865,46.019215,165.669173,62.053748,1,2
0,0,4,4,12,10,22,28,19,47,0.000333,0.069864,6,1257.559716,69.864429,209.593286,76.238831,1,2
0,0,6,6,11,10,21,30,21,51,0.000333,0.074669,10,2240.081886,124.448994,224.008189,71.273029,1,2
0,0,4,4,11,10,21,27,19,46,0.000333,0.067349,5,1010.233007,56.124056,202.046601,71.273029,1,2
0,0,4,4,11,10,21,27,19,46,0.000333,0.067349,5,1010.233007,56.124056,202.046601,71.273029,1,2
0,0,4,4,11,10,21,27,19,46,0.000333,0.067349,5,1010.233007,56.124056,202.046601,71.273029,1,2
0,0,4,4,11,10,21,27,19,46,0.000333,0.067349,5,1010.233007,56.124056,202.046601,71.273029,1,2
0,0,4,4,11,9,20,28,18,46,0.000333,0.06627,10,1988.086924,110.449274,198.808692,66.583073,1,2
0,0,5,5,11,10,21,29,19,48,0.000333,0.070277,5,1054.156181,58.564232,210.831236,71.273029,1,2
0,0,5,5,11,11,22,32,22,54,0.000333,0.08027,10,2408.093074,133.782949,240.809307,76.107496,1,2
0,0,6,6,11,12,23,41,26,67,0.000333,0.101026,10,3030.786511,168.377028,303.078651,81.073298,1,2
0,0,4,4,11,10,21,27,19,46,0.000333,0.067349,5,1010.233007,56.124056,202.046601,71.273029,1,2
0,0,6,6,11,12,23,38,26,64,0.000333,0.096503,10,2895.079652,160.837758,289.507965,81.073298,1,2
0,0,7,7,12,13,25,34,28,62,0.000333,0.095973,12,3455.029005,191.946056,287.919084,91.125266,1,2
0,0,4,4,11,12,23,27,21,48,0.000333,0.072377,5,1085.654869,60.314159,217.130974,81.073298,1,2
0,0,11,11,14,16,30,63,49,112,0.000333,0.183191,21,11541.00668,641.167038,549.571747,117.302969,1,2
0,0,9,9,14,14,28,49,36,85,0.000333,0.136208,14,5720.752357,317.819575,408.625168,106.605938,1,2
0,0,11,11,13,16,29,56,42,98,0.000333,0.158694,12,5712.98565,317.388092,476.082138,112.105716,1,2
0,0,3,3,11,8,19,24,15,39,0.000333,0.055223,5,828.345865,46.019215,165.669173,62.053748,1,2
0,0,5,5,12,9,21,29,18,47,0.000333,0.068813,12,2477.267026,137.625946,206.438919,71.548875,2,2
0,0,5,5,12,10,22,29,19,48,0.000333,0.071351,6,1284.316306,71.350906,214.052718,76.238831,2,2
0,0,5,5,12,10,22,29,18,47,0.000333,0.069864,6,1257.559716,69.864429,209.593286,76.238831,2,2
0,0,5,5,12,10,22,29,18,47,0.000333,0.069864,6,1257.559716,69.864429,209.593286,76.238831,2,2
0,0,5,5,12,11,23,29,19,48,0.000333,0.072377,6,1302.785843,72.376991,217.130974,81.073298,2,2
0,0,5,5,12,11,23,29,19,48,0.000333,0.072377,6,1302.785843,72.376991,217.130974,81.073298,2,2
0,0,5,5,12,10,22,29,18,47,0.000333,0.069864,6,1257.559716,69.864429,209.593286,76.238831,2,2
0,0,5,5,12,10,22,29,18,47,0.000333,0.069864,6,1257.559716,69.864429,209.593286,76.238831,2,2
0,0,5,5,12,10,22,29,18,47,0.000333,0.069864,6,1257.559716,69.864429,209.593286,76.238831,2,2
0,0,5,5,12,10,22,29,18,47,0.000333,0.069864,6,1257.559716,69.864429,209.593286,76.238831,2,2
0,0,4,4,11,8,19,30,19,49,0.000333,0.069383,10,2081.484482,115.638027,208.148448,62.053748,1,2
0,0,5,5,12,11,23,29,19,48,0.000333,0.072377,6,1302.785843,72.376991,217.130974,81.073298,2,2
0,0,5,5,12,11,23,29,19,48,0.000333,0.072377,6,1302.785843,72.376991,217.130974,81.073298,2,2
0,0,7,7,14,10,24,33,21,54,0.000333,0.082529,14,3466.231651,192.568425,247.587975,86.52225,2,2
0,0,5,5,12,9,21,29,18,47,0.000333,0.068813,12,2477.267026,137.625946,206.438919,71.548875,2,2
0,0,4,4,14,10,24,32,20,52,0.000333,0.079473,14,3337.852701,185.436261,238.41805,86.52225,2,2
0,0,3,3,11,8,19,24,15,39,0.000333,0.055223,5,828.345865,46.019215,165.669173,62.053748,1,2
0,0,5,5,11,10,21,30,20,50,0.000333,0.073205,10,2196.158711,122.008817,219.615871,71.273029,1,2
0,0,5,5,12,12,24,31,21,52,0.000333,0.079473,6,1430.5083,79.472683,238.41805,86.0391,2,2
0,0,5,5,11,9,20,30,21,51,0.000333,0.073473,10,2204.183328,122.454629,220.418333,66.583073,1,2
0,0,10,10,12,11,23,49,33,82,0.000333,0.123644,18,6676.777447,370.93208,370.93208,81.073298,1,2
0,0,7,7,12,10,22,35,25,60,0.000333,0.089189,12,3210.790765,178.377265,267.565897,76.238831,1,2
0,0,8,8,12,13,25,36,28,64,0.000333,0.099069,12,3566.481554,198.137864,297.206796,91.125266,1,2
0,0,4,4,11,9,20,27,17,44,0.000333,0.063388,5,950.824181,52.823566,190.164836,66.583073,1,2
0,0,4,4,11,9,20,28,18,46,0.000333,0.06627,10,1988.086924,110.449274,198.808692,66.583073,1,2
0,0,4,4,11,9,20,26,17,43,0.000333,0.061948,5,929.21454,51.62303,185.842908,66.583073,1,2
0,0,4,4,12,10,22,28,19,47,0.000333,0.069864,6,1257.559716,69.864429,209.593286,76.238831,1,2
0,0,6,6,11,10,21,30,21,51,0.000333,0.074669,10,2240.081886,124.448994,224.008189,71.273029,1,2
0,0,4,4,11,10,21,27,19,46,0.000333,0.067349,5,1010.233007,56.124056,202.046601,71.273029,1,2
0,0,4,4,11,10,21,27,19,46,0.000333,0.067349,5,1010.233007,56.124056,202.046601,71.273029,1,2
0,0,4,4,11,10,21,27,19,46,0.000333,0.067349,5,1010.233007,56.124056,202.046601,71.273029,1,2
0,0,4,4,11,10,21,27,19,46,0.000333,0.067349,5,1010.233007,56.124056,202.046601,71.273029,1,2
0,0,4,4,11,9,20,28,18,46,0.000333,0.06627,10,1988.086924,110.449274,198.808692,66.583073,1,2
0,0,5,5,11,10,21,29,19,48,0.000333,0.070277,5,1054.156181,58.564232,210.831236,71.273029,1,2
0,0,5,5,11,11,22,32,22,54,0.000333,0.08027,10,2408.093074,133.782949,240.809307,76.107496,1,2
0,0,6,6,11,12,23,41,26,67,0.000333,0.101026,10,3030.786511,168.377028,303.078651,81.073298,1,2
0,0,4,4,11,10,21,27,19,46,0.000333,0.067349,5,1010.233007,56.124056,202.046601,71.273029,1,2
0,0,5,5,11,12,23,34,23,57,0.000333,0.085948,5,1289.215157,71.623064,257.843031,81.073298,1,2
0,0,9,9,12,14,26,38,32,70,0.000333,0.109677,12,3948.369363,219.353854,329.03078,96.322519,1,2
0,0,4,4,11,13,24,27,22,49,0.000333,0.074888,5,1123.315813,62.406434,224.663163,86.159464,1,2
0,0,9,9,14,15,29,59,45,104,0.000333,0.16841,21,10609.83049,589.435027,505.230023,111.906328,1,2
0,0,9,9,14,14,28,50,37,87,0.000333,0.139413,14,5855.358295,325.297683,418.239878,106.605938,1,2
0,0,11,11,13,16,29,56,42,98,0.000333,0.158694,12,5712.98565,317.388092,476.082138,112.105716,1,2
0,0,3,3,9,8,17,18,14,32,0.000333,0.0436,4,523.195244,29.066402,130.798811,52.529325,1,2
0,0,5,5,10,9,19,23,17,40,0.000333,0.056639,5,849.585503,47.199195,169.917101,61.748606,2,2
0,0,5,5,10,10,20,23,18,41,0.000333,0.059066,5,885.995259,49.221959,177.199052,66.438562,2,2
0,0,5,5,10,10,20,23,17,40,0.000333,0.057626,5,864.385619,48.021423,172.877124,66.438562,2,2
0,0,5,5,10,10,20,23,17,40,0.000333,0.057626,5,864.385619,48.021423,172.877124,66.438562,2,2
0,0,5,5,10,11,21,23,18,41,0.000333,0.060028,5,900.425072,50.023615,180.085014,71.273029,2,2
0,0,5,5,10,11,21,23,18,41,0.000333,0.060028,5,900.425072,50.023615,180.085014,71.273029,2,2
0,0,5,5,10,10,20,23,17,40,0.000333,0.057626,5,864.385619,48.021423,172.877124,66.438562,2,2
0,0,5,5,10,10,20,23,17,40,0.000333,0.057626,5,864.385619,48.021423,172.877124,66.438562,2,2
0,0,5,5,10,10,20,23,17,40,0.000333,0.057626,5,864.385619,48.021423,172.877124,66.438562,2,2
0,0,5,5,10,10,20,23,17,40,0.000333,0.057626,5,864.385619,48.021423,172.877124,66.438562,2,2
0,0,6,6,11,9,20,28,19,47,0.000333,0.06771,10,2031.306205,112.850345,203.13062,66.583073,2,2
0,0,5,5,10,11,21,23,18,41,0.000333,0.060028,5,900.425072,50.023615,180.085014,71.273029,2,2
0,0,5,5,10,11,21,23,18,41,0.000333,0.060028,5,900.425072,50.023615,180.085014,71.273029,2,2
0,0,6,6,12,10,22,25,18,43,0.000333,0.063919,6,1150.533358,63.91852,191.75556,76.238831,2,2
0,0,5,5,10,9,19,23,17,40,0.000333,0.056639,5,849.585503,47.199195,169.917101,61.748606,2,2
0,0,5,5,12,11,23,28,21,49,0.000333,0.073885,6,1329.927215,73.884845,221.654536,81.073298,2,2
0,0,3,3,9,8,17,18,14,32,0.000333,0.0436,4,523.195244,29.066402,130.798811,52.529325,1,2
0,0,5,5,10,10,20,25,18,43,0.000333,0.061948,5,929.21454,51.62303,185.842908,66.438562,2,2
0,0,5,5,10,10,20,25,18,43,0.000333,0.061948,5,929.21454,51.62303,185.842908,66.438562,2,2
0,0,5,5,10,9,19,24,20,44,0.000333,0.062303,10,1869.088106,103.838228,186.908811,61.748606,1,2
0,0,8,8,11,11,22,36,27,63,0.000333,0.093648,10,2809.44192,156.080107,280.944192,76.107496,1,2
0,0,5,5,11,9,20,25,20,45,0.000333,0.064829,10,1944.867643,108.048202,194.486764,66.583073,1,2
0,0,8,8,11,13,24,30,27,57,0.000333,0.087114,10,2613.428625,145.190479,261.342863,86.159464,1,2
0,0,4,4,10,9,19,19,15,34,0.000333,0.048143,5,722.147677,40.119315,144.429535,61.748606,1,2
0,0,4,4,9,9,18,22,17,39,0.000333,0.054209,4,650.5083,36.13935,162.627075,57.05865,1,2
0,0,3,3,9,8,17,18,14,32,0.000333,0.0436,4,523.195244,29.066402,130.798811,52.529325,1,2
0,0,4,4,11,10,21,22,18,40,0.000333,0.058564,5,878.463485,48.803527,175.692697,71.273029,1,2
0,0,6,6,10,10,20,24,20,44,0.000333,0.063388,10,1901.648362,105.647131,190.164836,66.438562,1,2
0,0,4,4,10,10,20,21,18,39,0.000333,0.056185,5,842.775979,46.820888,168.555196,66.438562,1,2
0,0,4,4,10,10,20,21,18,39,0.000333,0.056185,5,842.775979,46.820888,168.555196,66.438562,1,2
0,0,4,4,10,10,20,21,18,39,0.000333,0.056185,5,842.775979,46.820888,168.555196,66.438562,1,2
0,0,4,4,10,10,20,21,18,39,0.000333,0.056185,5,842.775979,46.820888,168.555196,66.438562,1,2
0,0,4,4,9,9,18,22,17,39,0.000333,0.054209,4,650.5083,36.13935,162.627075,57.05865,1,2
0,0,5,5,9,10,19,23,18,41,0.000333,0.058055,4,696.660112,38.70334,174.165028,61.748606,1,2
0,0,5,5,10,11,21,26,21,47,0.000333,0.068813,5,1032.194594,57.344144,206.438919,71.273029,1,2
0,0,6,6,10,12,22,35,25,60,0.000333,0.089189,10,2675.658971,148.647721,267.565897,76.238831,1,2
0,0,4,4,10,10,20,21,18,39,0.000333,0.056185,5,842.775979,46.820888,168.555196,66.438562,1,2
0,0,9,9,10,14,24,40,32,72,0.000333,0.110039,10,3301.173001,183.3985,330.1173,86.52225,1,2
0,0,9,9,11,14,25,32,31,63,0.000333,0.097521,10,2925.6294,162.534967,292.56294,91.356717,1,2
0,0,4,4,10,13,23,21,21,42,0.000333,0.06333,5,949.948011,52.774889,189.989602,81.324997,1,2
0,0,10,10,13,16,29,55,46,101,0.000333,0.163552,12,5887.872966,327.104054,490.656081,112.105716,1,2
0,0,9,9,13,14,27,43,35,78,0.000333,0.123627,12,4450.574702,247.25415,370.881225,101.408685,1,2
0,0,6,6,12,14,26,33,27,60,0.000333,0.094009,6,1692.158299,94.008794,282.026383,96.322519,1,2
0,0,3,3,9,7,16,15,12,27,0.000333,0.036,4,432,24,108,48.180809,1,2
0,0,5,5,10,8,18,19,14,33,0.000333,0.045869,5,688.037625,38.224313,137.607525,57.219281,2,2
0,0,5,5,10,9,19,19,15,34,0.000333,0.048143,5,722.147677,40.119315,144.429535,61.748606,2,2
0,0,5,5,10,9,19,19,14,33,0.000333,0.046727,5,700.90804,38.939336,140.181608,61.748606,2,2
0,0,5,5,10,9,19,19,14,33,0.000333,0.046727,5,700.90804,38.939336,140.181608,61.748606,2,2
0,0,5,5,9,11,20,18,16,34,0.000333,0.048982,4,587.782221,32.654568,146.945555,66.583073,1,2
0,0,5,5,10,10,20,19,15,34,0.000333,0.048982,5,734.727776,40.81821,146.945555,66.438562,2,2
0,0,5,5,10,9,19,19,14,33,0.000333,0.046727,5,700.90804,38.939336,140.181608,61.748606,2,2
0,0,5,5,10,9,19,19,14,33,0.000333,0.046727,5,700.90804,38.939336,140.181608,61.748606,2,2
0,0,5,5,10,9,19,19,14,33,0.000333,0.046727,5,700.90804,38.939336,140.181608,61.748606,2,2
0,0,5,5,10,9,19,19,14,33,0.000333,0.046727,5,700.90804,38.939336,140.181608,61.748606,2,2
0,0,6,6,11,8,19,24,16,40,0.000333,0.056639,10,1699.171005,94.398389,169.917101,62.053748,2,2
0,0,5,5,10,10,20,19,15,34,0.000333,0.048982,5,734.727776,40.81821,146.945555,66.438562,2,2
0,0,5,5,10,10,20,19,15,34,0.000333,0.048982,5,734.727776,40.81821,146.945555,66.438562,2,2
0,0,6,6,12,9,21,21,15,36,0.000333,0.052708,6,948.740563,52.707809,158.123427,71.548875,2,2
0,0,5,5,10,8,18,19,14,33,0.000333,0.045869,5,688.037625,38.224313,137.607525,57.219281,2,2
0,0,5,5,12,10,22,24,18,42,0.000333,0.062432,6,1123.776768,62.432043,187.296128,76.238831,2,2
0,0,3,3,9,7,16,14,11,25,0.000333,0.033333,4,400,22.222222,100,48.180809,1,2
0,0,5,5,10,9,19,21,15,36,0.000333,0.050975,5,764.626952,42.479275,152.92539,61.748606,2,2
0,0,5,5,10,9,19,21,15,36,0.000333,0.050975,5,764.626952,42.479275,152.92539,61.748606,2,2
0,0,5,5,10,8,18,20,17,37,0.000333,0.051429,10,1542.872251,85.715125,154.287225,57.219281,1,2
0,0,5,5,11,8,19,23,17,40,0.000333,0.056639,10,1699.171005,94.398389,169.917101,62.053748,1,2
0,0,5,5,11,8,19,21,17,38,0.000333,0.053807,10,1614.212455,89.67847,161.421246,62.053748,1,2
0,0,8,8,11,12,23,26,24,50,0.000333,0.075393,10,2261.780978,125.654499,226.178098,81.073298,1,2
0,0,6,6,10,9,19,24,20,44,0.000333,0.062303,10,1869.088106,103.838228,186.908811,61.748606,1,2
0,0,5,5,10,8,18,20,15,35,0.000333,0.048649,5,729.736875,40.540938,145.947375,57.219281,1,2
0,0,3,3,9,7,16,14,11,25,0.000333,0.033333,4,400,22.222222,100,48.180809,1,2
0,0,4,4,11,9,20,18,15,33,0.000333,0.047541,5,713.118136,39.617674,142.623627,66.583073,1,2
0,0,6,6,10,9,19,20,17,37,0.000333,0.052391,5,785.86659,43.659255,157.173318,61.748606,1,2
0,0,4,4,10,9,19,17,15,32,0.000333,0.045311,5,679.668402,37.759356,135.93368,61.748606,1,2
0,0,4,4,10,9,19,17,15,32,0.000333,0.045311,5,679.668402,37.759356,135.93368,61.748606,1,2
0,0,4,4,10,9,19,17,15,32,0.000333,0.045311,5,679.668402,37.759356,135.93368,61.748606,1,2
0,0,4,4,10,9,19,17,15,32,0.000333,0.045311,5,679.668402,37.759356,135.93368,61.748606,1,2
0,0,4,4,9,8,17,18,14,32,0.000333,0.0436,4,523.195244,29.066402,130.798811,52.529325,1,2
0,0,4,4,9,8,17,17,13,30,0.000333,0.040875,4,490.495541,27.249752,122.623885,52.529325,1,2
0,0,5,5,10,10,20,22,18,40,0.000333,0.057626,5,864.385619,48.021423,172.877124,66.438562,1,2
0,0,6,6,10,11,21,31,22,53,0.000333,0.077598,10,2327.928234,129.329346,232.792823,71.273029,1,2
0,0,4,4,10,9,19,17,15,32,0.000333,0.045311,5,679.668402,37.759356,135.93368,61.748606,1,2
0,0,9,9,10,13,23,36,29,65,0.000333,0.098011,10,2940.315271,163.350848,294.031527,81.324997,1,2
0,0,9,9,11,13,24,28,28,56,0.000333,0.085586,10,2567.579,142.643278,256.7579,86.159464,1,2
0,0,4,4,10,11,21,17,17,34,0.000333,0.04978,5,746.693962,41.482998,149.338792,71.273029,1,2
0,0,11,11,13,15,28,53,45,98,0.000333,0.15704,18,8480.174083,471.120782,471.120782,106.709075,1,2
0,0,11,11,13,14,27,43,36,79,0.000333,0.125212,12,4507.633352,250.424075,375.636113,101.408685,1,2
0,0,11,11,12,15,27,46,38,84,0.000333,0.133137,12,4792.926602,266.2737,399.41055,101.622909,1,2
0,0,3,3,11,8,19,24,15,39,0.000333,0.055223,5,828.345865,46.019215,165.669173,62.053748,1,2
0,0,5,5,12,9,21,29,18,47,0.000333,0.068813,12,2477.267026,137.625946,206.438919,71.548875,2,2
0,0,5,5,12,10,22,29,19,48,0.000333,0.071351,6,1284.316306,71.350906,214.052718,76.238831,2,2
0,0,5,5,12,10,22,29,18,47,0.000333,0.069864,6,1257.559716,69.864429,209.593286,76.238831,2,2
0,0,5,5,12,10,22,29,18,47,0.000333,0.069864,6,1257.559716,69.864429,209.593286,76.238831,2,2
0,0,5,5,12,11,23,29,19,48,0.000333,0.072377,6,1302.785843,72.376991,217.130974,81.073298,2,2
0,0,5,5,12,11,23,29,19,48,0.000333,0.072377,6,1302.785843,72.376991,217.130974,81.073298,2,2
0,0,5,5,12,10,22,29,18,47,0.000333,0.069864,6,1257.559716,69.864429,209.593286,76.238831,2,2
0,0,5,5,12,10,22,29,18,47,0.000333,0.069864,6,1257.559716,69.864429,209.593286,76.238831,2,2
0,0,5,5,12,10,22,29,18,47,0.000333,0.069864,6,1257.559716,69.864429,209.593286,76.238831,2,2
0,0,5,5,12,10,22,29,18,47,0.000333,0.069864,6,1257.559716,69.864429,209.593286,76.238831,2,2
0,0,6,6,13,9,22,34,20,54,0.000333,0.08027,12,2889.711689,160.539538,240.809307,76.635041,2,2
0,0,5,5,12,11,23,29,19,48,0.000333,0.072377,6,1302.785843,72.376991,217.130974,81.073298,2,2
0,0,5,5,12,11,23,29,19,48,0.000333,0.072377,6,1302.785843,72.376991,217.130974,81.073298,2,2
0,0,6,6,14,10,24,31,19,50,0.000333,0.076416,7,1604.736875,89.152049,229.248125,86.52225,2,2
0,0,5,5,12,9,21,29,18,47,0.000333,0.068813,12,2477.267026,137.625946,206.438919,71.548875,2,2
0,0,5,5,14,11,25,34,22,56,0.000333,0.086685,14,3640.783253,202.265736,260.055947,91.356717,2,2
0,0,3,3,11,8,19,24,15,39,0.000333,0.055223,5,828.345865,46.019215,165.669173,62.053748,1,2
0,0,5,5,12,10,22,31,19,50,0.000333,0.074324,6,1337.829486,74.32386,222.971581,76.238831,2,2
0,0,5,5,12,10,22,31,19,50,0.000333,0.074324,6,1337.829486,74.32386,222.971581,76.238831,2,2
0,0,5,5,11,9,20,30,21,51,0.000333,0.073473,10,2204.183328,122.454629,220.418333,66.583073,1,2
0,0,5,5,12,9,21,33,21,54,0.000333,0.079062,12,2846.22169,158.123427,237.185141,71.548875,1,2
0,0,5,5,12,9,21,31,21,52,0.000333,0.076134,12,2740.806072,152.267004,228.400506,71.548875,1,2
0,0,8,8,12,13,25,36,28,64,0.000333,0.099069,12,3566.481554,198.137864,297.206796,91.125266,1,2
0,0,4,4,11,9,20,25,16,41,0.000333,0.059066,5,885.995259,49.221959,177.199052,66.583073,1,2
0,0,4,4,11,9,20,28,18,46,0.000333,0.06627,10,1988.086924,110.449274,198.808692,66.583073,1,2
0,0,3,3,11,8,19,24,15,39,0.000333,0.055223,5,828.345865,46.019215,165.669173,62.053748,1,2
0,0,4,4,12,10,22,28,19,47,0.000333,0.069864,6,1257.559716,69.864429,209.593286,76.238831,1,2
0,0,5,5,11,10,21,27,18,45,0.000333,0.065885,5,988.27142,54.903968,197.654284,71.273029,1,2
0,0,4,4,11,10,21,27,19,46,0.000333,0.067349,5,1010.233007,56.124056,202.046601,71.273029,1,2
0,0,4,4,11,10,21,27,19,46,0.000333,0.067349,5,1010.233007,56.124056,202.046601,71.273029,1,2
0,0,4,4,11,10,21,27,19,46,0.000333,0.067349,5,1010.233007,56.124056,202.046601,71.273029,1,2
0,0,4,4,11,10,21,27,19,46,0.000333,0.067349,5,1010.233007,56.124056,202.046601,71.273029,1,2
0,0,4,4,11,9,20,28,18,46,0.000333,0.06627,10,1988.086924,110.449274,198.808692,66.583073,1,2
0,0,5,5,11,10,21,29,19,48,0.000333,0.070277,5,1054.156181,58.564232,210.831236,71.273029,1,2
0,0,5,5,11,11,22,32,22,54,0.000333,0.08027,10,2408.093074,133.782949,240.809307,76.107496,1,2
0,0,6,6,11,12,23,41,26,67,0.000333,0.101026,10,3030.786511,168.377028,303.078651,81.073298,1,2
0,0,4,4,11,10,21,27,19,46,0.000333,0.067349,5,1010.233007,56.124056,202.046601,71.273029,1,2
0,0,9,9,11,14,25,46,33,79,0.000333,0.122288,10,3668.64639,203.813688,366.864639,91.356717,1,2
0,0,9,9,12,14,26,38,32,70,0.000333,0.109677,12,3948.369363,219.353854,329.03078,96.322519,1,2
0,0,4,4,11,13,24,27,22,49,0.000333,0.074888,5,1123.315813,62.406434,224.663163,86.159464,1,2
0,0,11,11,14,16,30,63,49,112,0.000333,0.183191,21,11541.00668,641.167038,549.571747,117.302969,1,2
0,0,9,9,14,14,28,49,36,85,0.000333,0.136208,14,5720.752357,317.819575,408.625168,106.605938,1,2
0,0,11,11,13,16,29,56,42,98,0.000333,0.158694,12,5712.98565,317.388092,476.082138,112.105716,1,2
0,0,3,3,11,8,19,24,15,39,0.000333,0.055223,5,828.345865,46.019215,165.669173,62.053748,1,2
0,0,5,5,12,9,21,29,18,47,0.000333,0.068813,12,2477.267026,137.625946,206.438919,71.548875,2,2
0,0,5,5,12,10,22,29,19,48,0.000333,0.071351,6,1284.316306,71.350906,214.052718,76.238831,2,2
0,0,5,5,12,10,22,29,18,47,0.000333,0.069864,6,1257.559716,69.864429,209.593286,76.238831,2,2
0,0,5,5,12,10,22,29,18,47,0.000333,0.069864,6,1257.559716,69.864429,209.593286,76.238831,2,2
0,0,5,5,12,11,23,29,19,48,0.000333,0.072377,6,1302.785843,72.376991,217.130974,81.073298,2,2
0,0,5,5,12,11,23,29,19,48,0.000333,0.072377,6,1302.785843,72.376991,217.130974,81.073298,2,2
0,0,5,5,12,10,22,29,18,47,0.000333,0.069864,6,1257.559716,69.864429,209.593286,76.238831,2,2
0,0,5,5,12,10,22,29,18,47,0.000333,0.069864,6,1257.559716,69.864429,209.593286,76.238831,2,2
0,0,5,5,12,10,22,29,18,47,0.000333,0.069864,6,1257.559716,69.864429,209.593286,76.238831,2,2
0,0,5,5,12,10,22,29,18,47,0.000333,0.069864,6,1257.559716,69.864429,209.593286,76.238831,2,2
0,0,6,6,13,9,22,34,20,54,0.000333,0.08027,12,2889.711689,160.539538,240.809307,76.635041,2,2
0,0,5,5,12,11,23,29,19,48,0.000333,0.072377,6,1302.785843,72.376991,217.130974,81.073298,2,2
0,0,5,5,12,11,23,29,19,48,0.000333,0.072377,6,1302.785843,72.376991,217.130974,81.073298,2,2
0,0,6,6,14,10,24,31,19,50,0.000333,0.076416,7,1604.736875,89.152049,229.248125,86.52225,2,2
0,0,5,5,12,9,21,29,18,47,0.000333,0.068813,12,2477.267026,137.625946,206.438919,71.548875,2,2
0,0,5,5,14,11,25,34,22,56,0.000333,0.086685,14,3640.783253,202.265736,260.055947,91.356717,2,2
0,0,3,3,11,8,19,24,15,39,0.000333,0.055223,5,828.345865,46.019215,165.669173,62.053748,1,2
0,0,6,6,12,10,22,32,21,53,0.000333,0.078783,12,2836.198509,157.566584,236.349876,76.238831,1,2
0,0,5,5,12,10,22,31,19,50,0.000333,0.074324,6,1337.829486,74.32386,222.971581,76.238831,2,2
0,0,5,5,11,9,20,30,21,51,0.000333,0.073473,10,2204.183328,122.454629,220.418333,66.583073,1,2
0,0,5,5,12,9,21,33,21,54,0.000333,0.079062,12,2846.22169,158.123427,237.185141,71.548875,1,2
0,0,5,5,12,9,21,31,21,52,0.000333,0.076134,12,2740.806072,152.267004,228.400506,71.548875,1,2
0,0,8,8,12,13,25,36,28,64,0.000333,0.099069,12,3566.481554,198.137864,297.206796,91.125266,1,2
0,0,4,4,11,9,20,25,16,41,0.000333,0.059066,5,885.995259,49.221959,177.199052,66.583073,1,2
0,0,4,4,11,9,20,28,18,46,0.000333,0.06627,10,1988.086924,110.449274,198.808692,66.583073,1,2
0,0,6,6,11,11,22,29,21,50,0.000333,0.074324,5,1114.857905,61.93655,222.971581,76.107496,1,2
0,0,6,6,11,11,22,29,21,50,0.000333,0.074324,5,1114.857905,61.93655,222.971581,76.107496,1,2
0,0,6,6,11,11,22,29,21,50,0.000333,0.074324,5,1114.857905,61.93655,222.971581,76.107496,1,2
0,0,6,6,11,11,22,29,21,50,0.000333,0.074324,5,1114.857905,61.93655,222.971581,76.107496,1,2
0,0,6,6,11,11,22,29,21,50,0.000333,0.074324,5,1114.857905,61.93655,222.971581,76.107496,1,2
0,0,6,6,11,11,22,29,21,50,0.000333,0.074324,5,1114.857905,61.93655,222.971581,76.107496,1,2
0,0,6,6,11,11,22,29,21,50,0.000333,0.074324,5,1114.857905,61.93655,222.971581,76.107496,1,2
0,0,6,6,11,11,22,29,21,50,0.000333,0.074324,5,1114.857905,61.93655,222.971581,76.107496,1,2
0,0,6,6,11,11,22,29,21,50,0.000333,0.074324,5,1114.857905,61.93655,222.971581,76.107496,1,2
0,0,6,6,11,11,22,29,21,50,0.000333,0.074324,5,1114.857905,61.93655,222.971581,76.107496,1,2
0,0,6,6,11,11,22,29,21,50,0.000333,0.074324,5,1114.857905,61.93655,222.971581,76.107496,1,2
0,0,6,6,11,11,22,29,21,50,0.000333,0.074324,5,1114.857905,61.93655,222.971581,76.107496,1,2
0,0,6,6,11,11,22,29,21,50,0.000333,0.074324,5,1114.857905,61.93655,222.971581,76.107496,1,2
0,0,6,6,11,11,22,29,21,50,0.000333,0.074324,5,1114.857905,61.93655,222.971581,76.107496,1,2
0,0,6,6,11,11,22,29,21,50,0.000333,0.074324,5,1114.857905,61.93655,222.971581,76.107496,1,2
0,0,8,8,12,8,20,34,24,58,0.000333,0.083557,18,4512.092931,250.67183,250.67183,67.01955,1,2
0,0,8,8,11,8,19,33,24,57,0.000333,0.080711,15,3631.978024,201.776557,242.131868,62.053748,1,2
0,0,7,7,11,11,22,33,25,58,0.000333,0.086216,10,2586.470339,143.692797,258.647034,76.107496,1,2
0,0,7,7,12,11,23,36,25,61,0.000333,0.091979,12,3311.247352,183.958186,275.937279,81.073298,1,2
0,0,7,7,12,12,24,34,25,59,0.000333,0.090171,12,3246.153451,180.341858,270.512788,86.0391,1,2
0,0,9,9,11,15,26,37,30,67,0.000333,0.104976,10,3149.294611,174.960812,314.929461,96.657107,1,2
0,0,6,6,10,9,19,25,19,44,0.000333,0.062303,10,1869.088106,103.838228,186.908811,61.748606,1,2
0,0,9,9,12,12,24,39,28,67,0.000333,0.102397,12,3686.309851,204.794992,307.192488,86.0391,1,2
0,0,7,7,11,9,20,29,21,50,0.000333,0.072032,10,2160.964047,120.053558,216.096405,66.583073,1,2
0,0,9,9,12,14,26,44,31,75,0.000333,0.117511,12,4230.395746,235.021986,352.532979,96.322519,1,2
0,0,10,10,12,14,26,36,29,65,0.000333,0.101843,12,3666.34298,203.685721,305.528582,96.322519,1,2
0,0,6,6,10,9,19,25,19,44,0.000333,0.062303,10,1869.088106,103.838228,186.908811,61.748606,1,2
0,0,8,8,11,14,25,35,27,62,0.000333,0.095973,5,1439.595419,79.977523,287.919084,91.356717,1,2
0,0,8,8,11,14,25,35,27,62,0.000333,0.095973,5,1439.595419,79.977523,287.919084,91.356717,1,2
0,0,8,8,11,14,25,35,27,62,0.000333,0.095973,5,1439.595419,79.977523,287.919084,91.356717,1,2
0,0,10,10,12,12,24,43,32,75,0.000333,0.114624,12,4126.466251,229.248125,343.872188,86.0391,1,2
0,0,9,9,12,13,25,40,29,69,0.000333,0.106809,12,3845.112925,213.617385,320.426077,91.125266,1,2
0,0,9,9,12,14,26,41,30,71,0.000333,0.111244,12,4004.77464,222.48748,333.73122,96.322519,1,2
0,0,10,10,12,15,27,50,34,84,0.000333,0.133137,12,4792.926602,266.2737,399.41055,101.622909,1,2
0,0,9,9,11,14,25,43,31,74,0.000333,0.114548,10,3436.45358,190.914088,343.645358,91.356717,1,2
0,0,11,11,11,16,27,50,37,87,0.000333,0.137892,10,4136.752127,229.819563,413.675213,102.053748,1,2
0,0,11,11,11,16,27,42,36,78,0.000333,0.123627,10,3708.812252,206.045125,370.881225,102.053748,1,2
0,0,10,10,11,17,28,36,35,71,0.000333,0.113774,10,3413.221995,189.623444,341.322199,107.540616,1,2
0,0,13,13,13,19,32,67,53,120,0.000333,0.2,12,7200,400,600,128.816339,1,2
0,0,13,13,13,17,30,57,44,101,0.000333,0.165199,12,5947.151402,330.3973,495.59595,117.592585,1,2
0,0,13,13,13,18,31,60,46,106,0.000333,0.175048,12,6301.737707,350.096539,525.144809,123.164366,1,2
0,0,6,6,11,11,22,29,21,50,0.000333,0.074324,5,1114.857905,61.93655,222.971581,76.107496,1,2
0,0,6,6,11,11,22,29,21,50,0.000333,0.074324,5,1114.857905,61.93655,222.971581,76.107496,1,2
0,0,6,6,11,11,22,29,21,50,0.000333,0.074324,5,1114.857905,61.93655,222.971581,76.107496,1,2
0,0,6,6,11,11,22,29,21,50,0.000333,0.074324,5,1114.857905,61.93655,222.971581,76.107496,1,2
0,0,6,6,11,11,22,29,21,50,0.000333,0.074324,5,1114.857905,61.93655,222.971581,76.107496,1,2
0,0,6,6,11,11,22,29,21,50,0.000333,0.074324,5,1114.857905,61.93655,222.971581,76.107496,1,2
0,0,6,6,11,11,22,29,21,50,0.000333,0.074324,5,1114.857905,61.93655,222.971581,76.107496,1,2
0,0,6,6,11,11,22,29,21,50,0.000333,0.074324,5,1114.857905,61.93655,222.971581,76.107496,1,2
0,0,6,6,11,11,22,29,21,50,0.000333,0.074324,5,1114.857905,61.93655,222.971581,76.107496,1,2
0,0,6,6,11,11,22,29,21,50,0.000333,0.074324,5,1114.857905,61.93655,222.971581,76.107496,1,2
0,0,6,6,11,11,22,29,21,50,0.000333,0.074324,5,1114.857905,61.93655,222.971581,76.107496,1,2
0,0,6,6,11,11,22,29,21,50,0.000333,0.074324,5,1114.857905,61.93655,222.971581,76.107496,1,2
0,0,6,6,11,11,22,29,21,50,0.000333,0.074324,5,1114.857905,61.93655,222.971581,76.107496,1,2
0,0,6,6,11,11,22,29,21,50,0.000333,0.074324,5,1114.857905,61.93655,222.971581,76.107496,1,2
0,0,6,6,11,11,22,29,21,50,0.000333,0.074324,5,1114.857905,61.93655,222.971581,76.107496,1,2
0,0,6,6,11,11,22,29,21,50,0.000333,0.074324,5,1114.857905,61.93655,222.971581,76.107496,1,2
0,0,6,6,11,11,22,29,21,50,0.000333,0.074324,5,1114.857905,61.93655,222.971581,76.107496,1,2
0,0,6,6,11,11,22,29,21,50,0.000333,0.074324,5,1114.857905,61.93655,222.971581,76.107496,1,2
0,0,10,10,13,12,25,44,32,76,0.000333,0.117644,12,4235.196845,235.288714,352.93307,91.125266,1,2
0,0,10,10,12,12,24,43,32,75,0.000333,0.114624,12,4126.466251,229.248125,343.872188,86.0391,1,2
0,0,8,8,11,12,23,35,27,62,0.000333,0.093487,10,2804.608413,155.811578,280.460841,81.073298,1,2
0,0,8,8,12,12,24,38,27,65,0.000333,0.099341,12,3576.270751,198.681708,298.022563,86.0391,1,2
0,0,8,8,12,12,24,36,27,63,0.000333,0.096284,12,3466.231651,192.568425,288.852638,86.0391,1,2
0,0,8,8,11,14,25,34,27,61,0.000333,0.094425,5,1416.376138,78.687563,283.275228,91.356717,1,2
0,0,8,8,11,13,24,35,27,62,0.000333,0.094756,10,2842.67675,157.926486,284.267675,86.159464,1,2
0,0,10,10,13,12,25,44,32,76,0.000333,0.117644,12,4235.196845,235.288714,352.93307,91.125266,1,2
0,0,10,10,13,12,25,44,32,76,0.000333,0.117644,12,4235.196845,235.288714,352.93307,91.125266,1,2
0,0,9,9,12,14,26,44,31,75,0.000333,0.117511,12,4230.395746,235.021986,352.532979,96.322519,1,2
0,0,10,10,12,14,26,36,29,65,0.000333,0.101843,12,3666.34298,203.685721,305.528582,96.322519,1,2
0,0,8,8,11,13,24,35,27,62,0.000333,0.094756,10,2842.67675,157.926486,284.267675,86.159464,1,2
0,0,8,8,11,14,25,35,27,62,0.000333,0.095973,5,1439.595419,79.977523,287.919084,91.356717,1,2
0,0,8,8,11,14,25,35,27,62,0.000333,0.095973,5,1439.595419,79.977523,287.919084,91.356717,1,2
0,0,8,8,11,14,25,35,27,62,0.000333,0.095973,5,1439.595419,79.977523,287.919084,91.356717,1,2
0,0,10,10,12,12,24,43,32,75,0.000333,0.114624,12,4126.466251,229.248125,343.872188,86.0391,1,2
0,0,9,9,12,13,25,40,29,69,0.000333,0.106809,12,3845.112925,213.617385,320.426077,91.125266,1,2
0,0,8,8,12,13,25,39,28,67,0.000333,0.103713,12,3733.660377,207.425576,311.138365,91.125266,1,2
0,0,10,10,12,15,27,50,34,84,0.000333,0.133137,12,4792.926602,266.2737,399.41055,101.622909,1,2
0,0,9,9,11,14,25,43,31,74,0.000333,0.114548,10,3436.45358,190.914088,343.645358,91.356717,1,2
0,0,11,11,11,16,27,50,37,87,0.000333,0.137892,10,4136.752127,229.819563,413.675213,102.053748,1,2
0,0,11,11,11,16,27,42,36,78,0.000333,0.123627,10,3708.812252,206.045125,370.881225,102.053748,1,2
0,0,10,10,11,17,28,35,35,70,0.000333,0.112172,10,3365.148445,186.952691,336.514845,107.540616,1,2
0,0,13,13,13,19,32,67,53,120,0.000333,0.2,12,7200,400,600,128.816339,1,2
0,0,13,13,13,17,30,57,44,101,0.000333,0.165199,12,5947.151402,330.3973,495.59595,117.592585,1,2
0,0,13,13,13,18,31,60,46,106,0.000333,0.175048,12,6301.737707,350.096539,525.144809,123.164366,1,2
0,0,5,5,12,9,21,24,20,44,0.000333,0.064421,12,2319.143599,128.841311,193.261967,71.548875,1,2
0,0,5,5,12,9,21,24,20,44,0.000333,0.064421,12,2319.143599,128.841311,193.261967,71.548875,1,2
0,0,5,5,12,9,21,24,20,44,0.000333,0.064421,12,2319.143599,128.841311,193.261967,71.548875,1,2
0,0,5,5,12,9,21,24,20,44,0.000333,0.064421,12,2319.143599,128.841311,193.261967,71.548875,1,2
0,0,5,5,12,9,21,24,20,44,0.000333,0.064421,12,2319.143599,128.841311,193.261967,71.548875,1,2
0,0,5,5,12,9,21,24,20,44,0.000333,0.064421,12,2319.143599,128.841311,193.261967,71.548875,1,2
0,0,5,5,12,9,21,24,20,44,0.000333,0.064421,12,2319.143599,128.841311,193.261967,71.548875,1,2
0,0,5,5,12,9,21,24,20,44,0.000333,0.064421,12,2319.143599,128.841311,193.261967,71.548875,1,2
0,0,5,5,12,9,21,24,20,44,0.000333,0.064421,12,2319.143599,128.841311,193.261967,71.548875,1,2
0,0,5,5,12,9,21,24,20,44,0.000333,0.064421,12,2319.143599,128.841311,193.261967,71.548875,1,2
0,0,5,5,12,9,21,24,20,44,0.000333,0.064421,12,2319.143599,128.841311,193.261967,71.548875,1,2
0,0,5,5,12,9,21,24,20,44,0.000333,0.064421,12,2319.143599,128.841311,193.261967,71.548875,1,2
0,0,5,5,12,9,21,24,20,44,0.000333,0.064421,12,2319.143599,128.841311,193.261967,71.548875,1,2
0,0,5,5,12,9,21,24,20,44,0.000333,0.064421,12,2319.143599,128.841311,193.261967,71.548875,1,2
0,0,5,5,12,9,21,24,20,44,0.000333,0.064421,12,2319.143599,128.841311,193.261967,71.548875,1,2
0,0,5,5,12,9,21,24,20,44,0.000333,0.064421,12,2319.143599,128.841311,193.261967,71.548875,1,2
0,0,5,5,12,9,21,24,20,44,0.000333,0.064421,12,2319.143599,128.841311,193.261967,71.548875,1,2
0,0,5,5,12,9,21,24,20,44,0.000333,0.064421,12,2319.143599,128.841311,193.261967,71.548875,1,2
0,0,9,9,14,12,26,39,32,71,0.000333,0.111244,14,4672.23708,259.568727,333.73122,96.322519,1,2
0,0,9,9,13,12,25,38,32,70,0.000333,0.108357,12,3900.839199,216.713289,325.069933,91.125266,1,2
0,0,6,6,12,10,22,28,25,53,0.000333,0.078783,12,2836.198509,157.566584,236.349876,76.238831,1,2
0,0,6,6,13,10,23,31,25,56,0.000333,0.08444,12,3039.833634,168.879646,253.31947,81.324997,1,2
0,0,6,6,13,10,23,29,25,54,0.000333,0.081424,12,2931.268148,162.84823,244.272346,81.324997,1,2
0,0,7,7,13,13,26,30,27,57,0.000333,0.089308,12,3215.100767,178.616709,267.925064,96.211433,1,2
0,0,6,6,12,11,23,28,24,52,0.000333,0.078408,12,2822.702661,156.816814,235.225222,81.073298,1,2
0,0,9,9,14,10,24,41,33,74,0.000333,0.113096,21,7125.031726,395.835096,339.287225,86.52225,1,2
0,0,6,6,13,11,24,29,24,53,0.000333,0.081001,12,2916.03615,162.002008,243.003013,86.159464,1,2
0,0,7,7,13,12,25,37,29,66,0.000333,0.102165,12,3677.934102,204.329672,306.494509,91.125266,1,2
0,0,7,7,12,11,23,28,24,52,0.000333,0.078408,12,2822.702661,156.816814,235.225222,81.073298,1,2
0,0,6,6,12,11,23,28,24,52,0.000333,0.078408,12,2822.702661,156.816814,235.225222,81.073298,1,2
0,0,6,6,12,12,24,28,24,52,0.000333,0.079473,12,2861.0166,158.945367,238.41805,86.0391,1,2
0,0,6,6,12,12,24,28,24,52,0.000333,0.079473,12,2861.0166,158.945367,238.41805,86.0391,1,2
0,0,6,6,12,12,24,28,24,52,0.000333,0.079473,12,2861.0166,158.945367,238.41805,86.0391,1,2
0,0,8,8,13,10,23,36,30,66,0.000333,0.099518,18,5373.991604,298.555089,298.555089,81.324997,1,2
0,0,6,6,13,11,24,30,24,54,0.000333,0.082529,12,2971.0557,165.05865,247.587975,86.159464,1,2
0,0,7,7,13,12,25,34,28,62,0.000333,0.095973,12,3455.029005,191.946056,287.919084,91.125266,1,2
0,0,8,8,13,13,26,43,33,76,0.000333,0.119078,12,4286.801023,238.155612,357.233419,96.211433,1,2
0,0,7,7,12,12,24,36,29,65,0.000333,0.099341,12,3576.270751,198.681708,298.022563,86.0391,1,2
0,0,9,9,12,14,26,43,36,79,0.000333,0.123778,12,4456.016853,247.556492,371.334738,96.322519,1,2
0,0,9,9,13,14,27,35,33,68,0.000333,0.107777,12,3879.988202,215.5549,323.33235,101.408685,1,2
0,0,8,8,12,16,28,28,34,62,0.000333,0.099352,12,3576.672062,198.704003,298.056005,107.01955,1,2
0,0,11,11,15,17,32,60,52,112,0.000333,0.186667,21,11760,653.333333,560,128.090227,1,2
0,0,11,11,15,15,30,50,43,93,0.000333,0.152114,14,6388.771555,354.931753,456.340825,117.206718,1,2
0,0,11,11,14,16,30,53,45,98,0.000333,0.160292,14,6732.253897,374.014105,480.875278,117.302969,1,2
0,0,5,5,12,9,21,24,20,44,0.000333,0.064421,12,2319.143599,128.841311,193.261967,71.548875,1,2
0,0,5,5,12,9,21,24,20,44,0.000333,0.064421,12,2319.143599,128.841311,193.261967,71.548875,1,2
0,0,5,5,12,9,21,24,20,44,0.000333,0.064421,12,2319.143599,128.841311,193.261967,71.548875,1,2
0,0,5,5,12,9,21,24,20,44,0.000333,0.064421,12,2319.143599,128.841311,193.261967,71.548875,1,2
0,0,5,5,12,9,21,24,20,44,0.000333,0.064421,12,2319.143599,128.841311,193.261967,71.548875,1,2
0,0,5,5,12,9,21,24,20,44,0.000333,0.064421,12,2319.143599,128.841311,193.261967,71.548875,1,2
0,0,5,5,12,9,21,24,20,44,0.000333,0.064421,12,2319.143599,128.841311,193.261967,71.548875,1,2
0,0,5,5,12,9,21,24,20,44,0.000333,0.064421,12,2319.143599,128.841311,193.261967,71.548875,1,2
0,0,5,5,12,9,21,24,20,44,0.000333,0.064421,12,2319.143599,128.841311,193.261967,71.548875,1,2
0,0,5,5,12,9,21,24,20,44,0.000333,0.064421,12,2319.143599,128.841311,193.261967,71.548875,1,2
0,0,5,5,12,9,21,24,20,44,0.000333,0.064421,12,2319.143599,128.841311,193.261967,71.548875,1,2
0,0,5,5,12,9,21,24,20,44,0.000333,0.064421,12,2319.143599,128.841311,193.261967,71.548875,1,2
0,0,5,5,12,9,21,24,20,44,0.000333,0.064421,12,2319.143599,128.841311,193.261967,71.548875,1,2
0,0,5,5,12,9,21,24,20,44,0.000333,0.064421,12,2319.143599,128.841311,193.261967,71.548875,1,2
0,0,5,5,12,9,21,24,20,44,0.000333,0.064421,12,2319.143599,128.841311,193.261967,71.548875,1,2
0,0,5,5,12,9,21,24,20,44,0.000333,0.064421,12,2319.143599,128.841311,193.261967,71.548875,1,2
0,0,5,5,12,9,21,24,20,44,0.000333,0.064421,12,2319.143599,128.841311,193.261967,71.548875,1,2
0,0,5,5,12,9,21,24,20,44,0.000333,0.064421,12,2319.143599,128.841311,193.261967,71.548875,1,2
0,0,8,8,13,10,23,36,30,66,0.000333,0.099518,18,5373.991604,298.555089,298.555089,81.324997,1,2
0,0,8,8,13,10,23,36,30,66,0.000333,0.099518,18,5373.991604,298.555089,298.555089,81.324997,1,2
0,0,6,6,12,10,22,28,25,53,0.000333,0.078783,12,2836.198509,157.566584,236.349876,76.238831,1,2
0,0,6,6,13,10,23,31,25,56,0.000333,0.08444,12,3039.833634,168.879646,253.31947,81.324997,1,2
0,0,6,6,13,10,23,29,25,54,0.000333,0.081424,12,2931.268148,162.84823,244.272346,81.324997,1,2
0,0,7,7,13,13,26,30,27,57,0.000333,0.089308,12,3215.100767,178.616709,267.925064,96.211433,1,2
0,0,6,6,12,11,23,28,24,52,0.000333,0.078408,12,2822.702661,156.816814,235.225222,81.073298,1,2
0,0,8,8,14,10,24,37,30,67,0.000333,0.102397,21,6451.042239,358.391235,307.192488,86.52225,1,2
0,0,7,7,13,11,24,32,26,58,0.000333,0.088643,12,3191.133901,177.285217,265.927825,86.159464,1,2
0,0,7,7,13,12,25,37,29,66,0.000333,0.102165,12,3677.934102,204.329672,306.494509,91.125266,1,2
0,0,7,7,12,11,23,28,24,52,0.000333,0.078408,12,2822.702661,156.816814,235.225222,81.073298,1,2
0,0,6,6,12,11,23,28,24,52,0.000333,0.078408,12,2822.702661,156.816814,235.225222,81.073298,1,2
0,0,6,6,12,12,24,28,24,52,0.000333,0.079473,12,2861.0166,158.945367,238.41805,86.0391,1,2
0,0,6,6,12,12,24,28,24,52,0.000333,0.079473,12,2861.0166,158.945367,238.41805,86.0391,1,2
0,0,6,6,12,12,24,28,24,52,0.000333,0.079473,12,2861.0166,158.945367,238.41805,86.0391,1,2
0,0,8,8,13,10,23,36,30,66,0.000333,0.099518,18,5373.991604,298.555089,298.555089,81.324997,1,2
0,0,6,6,13,11,24,29,24,53,0.000333,0.081001,12,2916.03615,162.002008,243.003013,86.159464,1,2
0,0,7,7,13,12,25,34,28,62,0.000333,0.095973,12,3455.029005,191.946056,287.919084,91.125266,1,2
0,0,8,8,13,13,26,43,33,76,0.000333,0.119078,12,4286.801023,238.155612,357.233419,96.211433,1,2
0,0,7,7,12,12,24,36,29,65,0.000333,0.099341,12,3576.270751,198.681708,298.022563,86.0391,1,2
0,0,9,9,12,14,26,43,36,79,0.000333,0.123778,12,4456.016853,247.556492,371.334738,96.322519,1,2
0,0,9,9,13,14,27,35,33,68,0.000333,0.107777,12,3879.988202,215.5549,323.33235,101.408685,1,2
0,0,8,8,12,16,28,28,34,62,0.000333,0.099352,12,3576.672062,198.704003,298.056005,107.01955,1,2
0,0,11,11,15,17,32,60,52,112,0.000333,0.186667,21,11760,653.333333,560,128.090227,1,2
0,0,11,11,15,15,30,50,43,93,0.000333,0.152114,14,6388.771555,354.931753,456.340825,117.206718,1,2
0,0,11,11,14,16,30,53,45,98,0.000333,0.160292,14,6732.253897,374.014105,480.875278,117.302969,1,2
0,0,4,4,12,8,20,22,14,36,0.000333,0.051863,6,933.536468,51.863137,155.589411,67.01955,1,2
0,0,4,4,12,8,20,22,14,36,0.000333,0.051863,6,933.536468,51.863137,155.589411,67.01955,1,2
0,0,4,4,12,8,20,22,14,36,0.000333,0.051863,6,933.536468,51.863137,155.589411,67.01955,1,2
0,0,4,4,12,8,20,22,14,36,0.000333,0.051863,6,933.536468,51.863137,155.589411,67.01955,1,2
0,0,4,4,12,8,20,22,14,36,0.000333,0.051863,6,933.536468,51.863137,155.589411,67.01955,1,2
0,0,4,4,12,8,20,22,14,36,0.000333,0.051863,6,933.536468,51.863137,155.589411,67.01955,1,2
0,0,4,4,12,8,20,22,14,36,0.000333,0.051863,6,933.536468,51.863137,155.589411,67.01955,1,2
0,0,4,4,12,8,20,22,14,36,0.000333,0.051863,6,933.536468,51.863137,155.589411,67.01955,1,2
0,0,4,4,12,8,20,22,14,36,0.000333,0.051863,6,933.536468,51.863137,155.589411,67.01955,1,2
0,0,4,4,12,8,20,22,14,36,0.000333,0.051863,6,933.536468,51.863137,155.589411,67.01955,1,2
0,0,4,4,12,8,20,22,14,36,0.000333,0.051863,6,933.536468,51.863137,155.589411,67.01955,1,2
0,0,4,4,12,8,20,22,14,36,0.000333,0.051863,6,933.536468,51.863137,155.589411,67.01955,1,2
0,0,4,4,12,8,20,22,14,36,0.000333,0.051863,6,933.536468,51.863137,155.589411,67.01955,1,2
0,0,4,4,12,8,20,22,14,36,0.000333,0.051863,6,933.536468,51.863137,155.589411,67.01955,1,2
0,0,4,4,12,8,20,22,14,36,0.000333,0.051863,6,933.536468,51.863137,155.589411,67.01955,1,2
0,0,4,4,12,8,20,22,14,36,0.000333,0.051863,6,933.536468,51.863137,155.589411,67.01955,1,2
0,0,4,4,12,8,20,22,14,36,0.000333,0.051863,6,933.536468,51.863137,155.589411,67.01955,1,2
0,0,4,4,12,8,20,22,14,36,0.000333,0.051863,6,933.536468,51.863137,155.589411,67.01955,1,2
0,0,8,8,14,9,23,37,25,62,0.000333,0.093487,14,3926.451778,218.13621,280.460841,81.832294,1,2
0,0,8,8,13,9,22,36,25,61,0.000333,0.090675,12,3264.303945,181.350219,272.025329,76.635041,1,2
0,0,6,6,12,9,21,28,20,48,0.000333,0.070277,12,2529.974836,140.554158,210.831236,71.548875,1,2
0,0,6,6,13,9,22,31,20,51,0.000333,0.07581,12,2729.172151,151.620675,227.431013,76.635041,1,2
0,0,6,6,13,9,22,29,20,49,0.000333,0.072837,12,2622.145792,145.674766,218.512149,76.635041,1,2
0,0,7,7,13,12,25,30,23,53,0.000333,0.082041,6,1476.746268,82.041459,246.124378,91.125266,1,2
0,0,7,7,12,10,22,33,23,56,0.000333,0.083243,12,2996.738048,166.485447,249.728171,76.238831,1,2
0,0,8,8,14,9,23,37,25,62,0.000333,0.093487,14,3926.451778,218.13621,280.460841,81.832294,1,2
0,0,6,6,12,9,21,28,18,46,0.000333,0.067349,12,2424.559217,134.697734,202.046601,71.548875,1,2
0,0,7,7,13,11,24,37,24,61,0.000333,0.093228,12,3356.192551,186.455142,279.682713,86.159464,1,2
0,0,8,8,13,11,24,29,22,51,0.000333,0.077944,12,2805.99705,155.888725,233.833088,86.159464,1,2
0,0,6,6,12,10,22,28,20,48,0.000333,0.071351,12,2568.632612,142.701812,214.052718,76.238831,1,2
0,0,6,6,12,11,23,28,20,48,0.000333,0.072377,6,1302.785843,72.376991,217.130974,81.073298,1,2
0,0,6,6,12,11,23,28,20,48,0.000333,0.072377,6,1302.785843,72.376991,217.130974,81.073298,1,2
0,0,6,6,12,11,23,28,20,48,0.000333,0.072377,6,1302.785843,72.376991,217.130974,81.073298,1,2
0,0,8,8,13,9,22,36,25,61,0.000333,0.090675,12,3264.303945,181.350219,272.025329,76.635041,1,2
0,0,7,7,13,10,23,33,22,55,0.000333,0.082932,12,2985.550891,165.863938,248.795908,81.324997,1,2
0,0,7,7,13,11,24,34,23,57,0.000333,0.087114,12,3136.11435,174.228575,261.342863,86.159464,1,2
0,0,8,8,13,12,25,43,27,70,0.000333,0.108357,12,3900.839199,216.713289,325.069933,91.125266,1,2
0,0,7,7,12,11,23,36,24,60,0.000333,0.090471,12,3256.964608,180.942478,271.413717,81.073298,1,2
0,0,9,9,12,13,25,43,30,73,0.000333,0.113001,12,4068.018022,226.001001,339.001502,91.125266,1,2
0,0,9,9,13,13,26,35,29,64,0.000333,0.100276,12,3609.937704,200.552095,300.828142,96.211433,1,2
0,0,8,8,12,14,26,28,28,56,0.000333,0.087742,12,3158.695491,175.483083,263.224624,96.322519,1,2
0,0,11,11,15,16,31,60,46,106,0.000333,0.175048,14,7352.027325,408.445962,525.144809,122.603359,1,2
0,0,11,11,15,14,29,50,37,87,0.000333,0.140881,14,5917.020852,328.723381,422.644347,111.906328,1,2
0,0,11,11,14,14,28,53,39,92,0.000333,0.147426,14,6191.87314,343.992952,442.276653,106.605938,1,2
0,0,4,4,12,8,20,22,14,36,0.000333,0.051863,6,933.536468,51.863137,155.589411,67.01955,1,2
0,0,4,4,12,8,20,22,14,36,0.000333,0.051863,6,933.536468,51.863137,155.589411,67.01955,1,2
0,0,4,4,12,8,20,22,14,36,0.000333,0.051863,6,933.536468,51.863137,155.589411,67.01955,1,2
0,0,4,4,12,8,20,22,14,36,0.000333,0.051863,6,933.536468,51.863137,155.589411,67.01955,1,2
0,0,4,4,12,8,20,22,14,36,0.000333,0.051863,6,933.536468,51.863137,155.589411,67.01955,1,2
0,0,4,4,12,8,20,22,14,36,0.000333,0.051863,6,933.536468,51.863137,155.589411,67.01955,1,2
0,0,4,4,12,8,20,22,14,36,0.000333,0.051863,6,933.536468,51.863137,155.589411,67.01955,1,2
0,0,4,4,12,8,20,22,14,36,0.000333,0.051863,6,933.536468,51.863137,155.589411,67.01955,1,2
0,0,4,4,12,8,20,22,14,36,0.000333,0.051863,6,933.536468,51.863137,155.589411,67.01955,1,2
0,0,4,4,12,8,20,22,14,36,0.000333,0.051863,6,933.536468,51.863137,155.589411,67.01955,1,2
0,0,4,4,12,8,20,22,14,36,0.000333,0.051863,6,933.536468,51.863137,155.589411,67.01955,1,2
0,0,4,4,12,8,20,22,14,36,0.000333,0.051863,6,933.536468,51.863137,155.589411,67.01955,1,2
0,0,4,4,12,8,20,22,14,36,0.000333,0.051863,6,933.536468,51.863137,155.589411,67.01955,1,2
0,0,4,4,12,8,20,22,14,36,0.000333,0.051863,6,933.536468,51.863137,155.589411,67.01955,1,2
0,0,4,4,12,8,20,22,14,36,0.000333,0.051863,6,933.536468,51.863137,155.589411,67.01955,1,2
0,0,4,4,12,8,20,22,14,36,0.000333,0.051863,6,933.536468,51.863137,155.589411,67.01955,1,2
0,0,4,4,12,8,20,22,14,36,0.000333,0.051863,6,933.536468,51.863137,155.589411,67.01955,1,2
0,0,4,4,12,8,20,22,14,36,0.000333,0.051863,6,933.536468,51.863137,155.589411,67.01955,1,2
0,0,8,8,14,9,23,37,25,62,0.000333,0.093487,14,3926.451778,218.13621,280.460841,81.832294,1,2
0,0,8,8,13,9,22,37,25,62,0.000333,0.092162,12,3317.817124,184.323174,276.48476,76.635041,1,2
0,0,6,6,12,9,21,28,20,48,0.000333,0.070277,12,2529.974836,140.554158,210.831236,71.548875,1,2
0,0,6,6,13,9,22,31,20,51,0.000333,0.07581,12,2729.172151,151.620675,227.431013,76.635041,1,2
0,0,6,6,13,9,22,29,20,49,0.000333,0.072837,12,2622.145792,145.674766,218.512149,76.635041,1,2
0,0,7,7,13,12,25,30,23,53,0.000333,0.082041,6,1476.746268,82.041459,246.124378,91.125266,1,2
0,0,6,6,12,10,22,28,20,48,0.000333,0.071351,12,2568.632612,142.701812,214.052718,76.238831,1,2
0,0,8,8,14,9,23,37,25,62,0.000333,0.093487,14,3926.451778,218.13621,280.460841,81.832294,1,2
0,0,7,7,13,10,23,32,22,54,0.000333,0.081424,12,2931.268148,162.84823,244.272346,81.324997,1,2
0,0,7,7,13,11,24,37,24,61,0.000333,0.093228,12,3356.192551,186.455142,279.682713,86.159464,1,2
0,0,8,8,13,11,24,29,22,51,0.000333,0.077944,12,2805.99705,155.888725,233.833088,86.159464,1,2
0,0,6,6,12,10,22,28,20,48,0.000333,0.071351,12,2568.632612,142.701812,214.052718,76.238831,1,2
0,0,6,6,12,11,23,28,20,48,0.000333,0.072377,6,1302.785843,72.376991,217.130974,81.073298,1,2
0,0,6,6,12,11,23,28,20,48,0.000333,0.072377,6,1302.785843,72.376991,217.130974,81.073298,1,2
0,0,6,6,12,11,23,28,20,48,0.000333,0.072377,6,1302.785843,72.376991,217.130974,81.073298,1,2
0,0,8,8,13,9,22,37,25,62,0.000333,0.092162,12,3317.817124,184.323174,276.48476,76.635041,1,2
0,0,6,6,13,10,23,30,20,50,0.000333,0.075393,12,2714.137174,150.785399,226.178098,81.324997,1,2
0,0,7,7,13,11,24,34,23,57,0.000333,0.087114,12,3136.11435,174.228575,261.342863,86.159464,1,2
0,0,8,8,13,12,25,43,27,70,0.000333,0.108357,12,3900.839199,216.713289,325.069933,91.125266,1,2
0,0,7,7,12,11,23,36,24,60,0.000333,0.090471,12,3256.964608,180.942478,271.413717,81.073298,1,2
0,0,9,9,12,13,25,43,30,73,0.000333,0.113001,12,4068.018022,226.001001,339.001502,91.125266,1,2
0,0,9,9,13,13,26,35,29,64,0.000333,0.100276,12,3609.937704,200.552095,300.828142,96.211433,1,2
0,0,8,8,12,14,26,29,28,57,0.000333,0.089308,12,3215.100767,178.616709,267.925064,96.322519,1,2
0,0,11,11,15,16,31,60,46,106,0.000333,0.175048,14,7352.027325,408.445962,525.144809,122.603359,1,2
0,0,11,11,15,14,29,50,37,87,0.000333,0.140881,14,5917.020852,328.723381,422.644347,111.906328,1,2
0,0,11,11,14,14,28,53,39,92,0.000333,0.147426,14,6191.87314,343.992952,442.276653,106.605938,1,2
0,0,7,7,11,10,21,34,22,56,0.000333,0.08199,10,2459.697757,136.649875,245.969776,71.273029,1,2
0,0,7,7,11,10,21,34,22,56,0.000333,0.08199,10,2459.697757,136.649875,245.969776,71.273029,1,2
0,0,7,7,11,10,21,34,22,56,0.000333,0.08199,10,2459.697757,136.649875,245.969776,71.273029,1,2
0,0,7,7,11,10,21,34,22,56,0.000333,0.08199,10,2459.697757,136.649875,245.969776,71.273029,1,2
0,0,7,7,11,10,21,34,22,56,0.000333,0.08199,10,2459.697757,136.649875,245.969776,71.273029,1,2
0,0,7,7,11,10,21,34,22,56,0.000333,0.08199,10,2459.697757,136.649875,245.969776,71.273029,1,2
0,0,7,7,11,10,21,34,22,56,0.000333,0.08199,10,2459.697757,136.649875,245.969776,71.273029,1,2
0,0,7,7,11,10,21,34,22,56,0.000333,0.08199,10,2459.697757,136.649875,245.969776,71.273029,1,2
0,0,7,7,11,10,21,34,22,56,0.000333,0.08199,10,2459.697757,136.649875,245.969776,71.273029,1,2
0,0,7,7,11,10,21,34,22,56,0.000333,0.08199,10,2459.697757,136.649875,245.969776,71.273029,1,2
0,0,7,7,11,10,21,34,22,56,0.000333,0.08199,10,2459.697757,136.649875,245.969776,71.273029,1,2
0,0,7,7,11,10,21,34,22,56,0.000333,0.08199,10,2459.697757,136.649875,245.969776,71.273029,1,2
0,0,7,7,11,10,21,34,22,56,0.000333,0.08199,10,2459.697757,136.649875,245.969776,71.273029,1,2
0,0,7,7,11,10,21,34,22,56,0.000333,0.08199,10,2459.697757,136.649875,245.969776,71.273029,1,2
0,0,7,7,11,10,21,34,22,56,0.000333,0.08199,10,2459.697757,136.649875,245.969776,71.273029,1,2
0,0,7,7,11,10,21,34,22,56,0.000333,0.08199,10,2459.697757,136.649875,245.969776,71.273029,1,2
0,0,7,7,11,10,21,34,22,56,0.000333,0.08199,10,2459.697757,136.649875,245.969776,71.273029,1,2
0,0,7,7,11,10,21,34,22,56,0.000333,0.08199,10,2459.697757,136.649875,245.969776,71.273029,1,2
0,0,11,11,13,11,24,51,34,85,0.000333,0.129907,18,7014.992626,389.721813,389.721813,86.159464,1,2
0,0,11,11,12,11,23,48,33,81,0.000333,0.122136,18,6595.353332,366.408518,366.408518,81.073298,1,2
0,0,9,9,11,11,22,40,28,68,0.000333,0.10108,10,3032.413501,168.467417,303.24135,76.107496,1,2
0,0,13,13,12,12,24,60,39,99,0.000333,0.151304,18,8170.403176,453.911288,453.911288,86.0391,1,2
0,0,9,9,12,11,23,41,28,69,0.000333,0.104042,12,3745.5093,208.08385,312.125775,81.073298,1,2
0,0,10,10,12,14,26,42,31,73,0.000333,0.114377,12,4117.585193,228.754733,343.132099,96.322519,1,2
0,0,9,9,11,12,23,40,28,68,0.000333,0.102534,10,3076.02213,170.890118,307.602213,81.073298,1,2
0,0,11,11,13,11,24,49,33,82,0.000333,0.125322,18,6767.404651,375.966925,375.966925,86.159464,1,2
0,0,10,10,12,12,24,44,30,74,0.000333,0.113096,12,4071.446701,226.191483,339.287225,86.0391,1,2
0,0,10,10,12,13,25,49,32,81,0.000333,0.125384,12,4513.828216,250.768234,376.152351,91.125266,1,2
0,0,11,11,12,13,25,41,30,71,0.000333,0.109905,12,3956.565474,219.809193,329.713789,91.125266,1,2
0,0,9,9,11,12,23,40,28,68,0.000333,0.102534,10,3076.02213,170.890118,307.602213,81.073298,1,2
0,0,9,9,11,13,24,40,28,68,0.000333,0.103926,10,3117.7745,173.209694,311.77745,86.159464,1,2
0,0,9,9,11,13,24,40,28,68,0.000333,0.103926,10,3117.7745,173.209694,311.77745,86.159464,1,2
0,0,9,9,11,13,24,40,28,68,0.000333,0.103926,10,3117.7745,173.209694,311.77745,86.159464,1,2
0,0,11,11,12,11,23,48,33,81,0.000333,0.122136,18,6595.353332,366.408518,366.408518,81.073298,1,2
0,0,10,10,12,12,24,45,30,75,0.000333,0.114624,12,4126.466251,229.248125,343.872188,86.0391,1,2
0,0,10,10,12,13,25,46,31,77,0.000333,0.119192,12,4290.923119,238.384618,357.576927,91.125266,1,2
0,0,11,11,12,14,26,55,35,90,0.000333,0.141013,12,5076.474896,282.026383,423.039575,96.322519,1,2
0,0,10,10,11,13,24,48,32,80,0.000333,0.122266,10,3667.970001,203.776111,366.797,86.159464,1,2
0,0,12,12,11,15,26,55,38,93,0.000333,0.145714,10,4371.408938,242.856052,437.140894,96.657107,1,2
0,0,12,12,12,15,27,47,37,84,0.000333,0.133137,12,4792.926602,266.2737,399.41055,101.622909,1,2
0,0,11,11,11,16,27,40,36,76,0.000333,0.120457,10,3613.714502,200.761917,361.37145,102.053748,1,2
0,0,14,14,14,17,31,72,54,126,0.000333,0.208076,21,13108.80344,728.266858,624.228735,122.789837,1,2
0,0,14,14,14,16,30,62,45,107,0.000333,0.175012,14,7350.522112,408.36234,525.037294,117.302969,1,2
0,0,14,14,14,19,33,64,46,110,0.000333,0.184961,14,7768.366944,431.575941,554.883353,134.013592,1,2
0,0,7,7,11,10,21,34,22,56,0.000333,0.08199,10,2459.697757,136.649875,245.969776,71.273029,1,2
0,0,7,7,11,10,21,34,22,56,0.000333,0.08199,10,2459.697757,136.649875,245.969776,71.273029,1,2
0,0,7,7,11,10,21,34,22,56,0.000333,0.08199,10,2459.697757,136.649875,245.969776,71.273029,1,2
0,0,7,7,11,10,21,34,22,56,0.000333,0.08199,10,2459.697757,136.649875,245.969776,71.273029,1,2
0,0,7,7,11,10,21,34,22,56,0.000333,0.08199,10,2459.697757,136.649875,245.969776,71.273029,1,2
0,0,7,7,11,10,21,34,22,56,0.000333,0.08199,10,2459.697757,136.649875,245.969776,71.273029,1,2
0,0,7,7,11,10,21,34,22,56,0.000333,0.08199,10,2459.697757,136.649875,245.969776,71.273029,1,2
0,0,7,7,11,10,21,34,22,56,0.000333,0.08199,10,2459.697757,136.649875,245.969776,71.273029,1,2
0,0,7,7,11,10,21,34,22,56,0.000333,0.08199,10,2459.697757,136.649875,245.969776,71.273029,1,2
0,0,7,7,11,10,21,34,22,56,0.000333,0.08199,10,2459.697757,136.649875,245.969776,71.273029,1,2
0,0,7,7,11,10,21,34,22,56,0.000333,0.08199,10,2459.697757,136.649875,245.969776,71.273029,1,2
0,0,7,7,11,10,21,34,22,56,0.000333,0.08199,10,2459.697757,136.649875,245.969776,71.273029,1,2
0,0,7,7,11,10,21,34,22,56,0.000333,0.08199,10,2459.697757,136.649875,245.969776,71.273029,1,2
0,0,7,7,11,10,21,34,22,56,0.000333,0.08199,10,2459.697757,136.649875,245.969776,71.273029,1,2
0,0,7,7,11,10,21,34,22,56,0.000333,0.08199,10,2459.697757,136.649875,245.969776,71.273029,1,2
0,0,7,7,11,10,21,34,22,56,0.000333,0.08199,10,2459.697757,136.649875,245.969776,71.273029,1,2
0,0,7,7,11,10,21,34,22,56,0.000333,0.08199,10,2459.697757,136.649875,245.969776,71.273029,1,2
0,0,7,7,11,10,21,34,22,56,0.000333,0.08199,10,2459.697757,136.649875,245.969776,71.273029,1,2
0,0,10,10,12,11,23,47,32,79,0.000333,0.11912,12,4288.336734,238.24093,357.361395,81.073298,1,2
0,0,11,11,12,11,23,48,33,81,0.000333,0.122136,18,6595.353332,366.408518,366.408518,81.073298,1,2
0,0,9,9,11,11,22,40,28,68,0.000333,0.10108,10,3032.413501,168.467417,303.24135,76.107496,1,2
0,0,9,9,12,11,23,43,28,71,0.000333,0.107058,12,3854.074787,214.115266,321.172899,81.073298,1,2
0,0,9,9,12,11,23,41,28,69,0.000333,0.104042,12,3745.5093,208.08385,312.125775,81.073298,1,2
0,0,10,10,12,14,26,42,31,73,0.000333,0.114377,12,4117.585193,228.754733,343.132099,96.322519,1,2
0,0,9,9,11,12,23,40,28,68,0.000333,0.102534,10,3076.02213,170.890118,307.602213,81.073298,1,2
0,0,11,11,13,11,24,49,33,82,0.000333,0.125322,18,6767.404651,375.966925,375.966925,86.159464,1,2
0,0,10,10,12,12,24,44,30,74,0.000333,0.113096,12,4071.446701,226.191483,339.287225,86.0391,1,2
0,0,10,10,12,13,25,49,32,81,0.000333,0.125384,12,4513.828216,250.768234,376.152351,91.125266,1,2
0,0,11,11,12,13,25,41,30,71,0.000333,0.109905,12,3956.565474,219.809193,329.713789,91.125266,1,2
0,0,9,9,11,12,23,40,28,68,0.000333,0.102534,10,3076.02213,170.890118,307.602213,81.073298,1,2
0,0,9,9,11,13,24,40,28,68,0.000333,0.103926,10,3117.7745,173.209694,311.77745,86.159464,1,2
0,0,9,9,11,13,24,40,28,68,0.000333,0.103926,10,3117.7745,173.209694,311.77745,86.159464,1,2
0,0,9,9,11,13,24,40,28,68,0.000333,0.103926,10,3117.7745,173.209694,311.77745,86.159464,1,2
0,0,11,11,12,11,23,49,33,82,0.000333,0.123644,18,6676.777447,370.93208,370.93208,81.073298,1,2
0,0,11,11,12,12,24,49,34,83,0.000333,0.126851,12,4566.622651,253.701258,380.551888,86.0391,1,2
0,0,10,10,12,13,25,46,31,77,0.000333,0.119192,12,4290.923119,238.384618,357.576927,91.125266,1,2
0,0,11,11,12,14,26,55,35,90,0.000333,0.141013,12,5076.474896,282.026383,423.039575,96.322519,1,2
0,0,10,10,11,13,24,48,32,80,0.000333,0.122266,10,3667.970001,203.776111,366.797,86.159464,1,2
0,0,12,12,11,15,26,55,38,93,0.000333,0.145714,10,4371.408938,242.856052,437.140894,96.657107,1,2
0,0,12,12,12,15,27,47,37,84,0.000333,0.133137,12,4792.926602,266.2737,399.41055,101.622909,1,2
0,0,11,11,11,18,29,41,37,78,0.000333,0.126308,10,3789.225176,210.51251,378.922518,113.112398,1,2
0,0,14,14,14,17,31,72,54,126,0.000333,0.208076,21,13108.80344,728.266858,624.228735,122.789837,1,2
0,0,14,14,14,16,30,62,45,107,0.000333,0.175012,14,7350.522112,408.36234,525.037294,117.302969,1,2
0,0,14,14,13,16,29,65,47,112,0.000333,0.181365,12,6529.126457,362.729248,544.093871,112.105716,1,2
0,0,7,7,9,10,19,30,21,51,0.000333,0.072215,8,1733.154425,96.286357,216.644303,61.748606,1,2
0,0,7,7,9,10,19,30,21,51,0.000333,0.072215,8,1733.154425,96.286357,216.644303,61.748606,1,2
0,0,7,7,9,10,19,30,21,51,0.000333,0.072215,8,1733.154425,96.286357,216.644303,61.748606,1,2
0,0,7,7,9,10,19,30,21,51,0.000333,0.072215,8,1733.154425,96.286357,216.644303,61.748606,1,2
0,0,7,7,9,10,19,30,21,51,0.000333,0.072215,8,1733.154425,96.286357,216.644303,61.748606,1,2
0,0,7,7,9,10,19,30,21,51,0.000333,0.072215,8,1733.154425,96.286357,216.644303,61.748606,1,2
0,0,7,7,9,10,19,30,21,51,0.000333,0.072215,8,1733.154425,96.286357,216.644303,61.748606,1,2
0,0,7,7,9,10,19,30,21,51,0.000333,0.072215,8,1733.154425,96.286357,216.644303,61.748606,1,2
0,0,7,7,9,10,19,30,21,51,0.000333,0.072215,8,1733.154425,96.286357,216.644303,61.748606,1,2
0,0,7,7,9,10,19,30,21,51,0.000333,0.072215,8,1733.154425,96.286357,216.644303,61.748606,1,2
0,0,7,7,9,10,19,30,21,51,0.000333,0.072215,8,1733.154425,96.286357,216.644303,61.748606,1,2
0,0,7,7,9,10,19,30,21,51,0.000333,0.072215,8,1733.154425,96.286357,216.644303,61.748606,1,2
0,0,7,7,9,10,19,30,21,51,0.000333,0.072215,8,1733.154425,96.286357,216.644303,61.748606,1,2
0,0,7,7,9,10,19,30,21,51,0.000333,0.072215,8,1733.154425,96.286357,216.644303,61.748606,1,2
0,0,7,7,9,10,19,30,21,51,0.000333,0.072215,8,1733.154425,96.286357,216.644303,61.748606,1,2
0,0,7,7,9,10,19,30,21,51,0.000333,0.072215,8,1733.154425,96.286357,216.644303,61.748606,1,2
0,0,7,7,9,10,19,30,21,51,0.000333,0.072215,8,1733.154425,96.286357,216.644303,61.748606,1,2
0,0,7,7,9,10,19,30,21,51,0.000333,0.072215,8,1733.154425,96.286357,216.644303,61.748606,1,2
0,0,11,11,12,11,23,45,32,77,0.000333,0.116105,12,4179.771247,232.209514,348.314271,81.073298,1,2
0,0,11,11,11,11,22,44,32,76,0.000333,0.112972,10,3389.16803,188.287113,338.916803,76.107496,1,2
0,0,9,9,10,11,21,36,27,63,0.000333,0.092239,10,2767.159976,153.73111,276.715998,71.273029,1,2
0,0,8,8,11,10,21,37,25,62,0.000333,0.090775,10,2723.236802,151.290933,272.32368,71.273029,1,2
0,0,9,9,11,11,22,37,27,64,0.000333,0.095135,10,2854.036236,158.557569,285.403624,76.107496,1,2
0,0,10,10,11,14,25,38,30,68,0.000333,0.105261,10,3157.822209,175.434567,315.782221,91.356717,1,2
0,0,9,9,10,12,22,36,27,63,0.000333,0.093648,10,2809.44192,156.080107,280.944192,76.238831,1,2
0,0,11,11,12,11,23,45,32,77,0.000333,0.116105,12,4179.771247,232.209514,348.314271,81.073298,1,2
0,0,10,10,11,12,23,40,29,69,0.000333,0.104042,10,3121.25775,173.403208,312.125775,81.073298,1,2
0,0,10,10,11,13,24,45,31,76,0.000333,0.116152,10,3484.571501,193.587306,348.45715,86.159464,1,2
0,0,12,12,11,13,24,40,32,72,0.000333,0.110039,10,3301.173001,183.3985,330.1173,86.159464,1,2
0,0,9,9,10,12,22,36,27,63,0.000333,0.093648,10,2809.44192,156.080107,280.944192,76.238831,1,2
0,0,9,9,10,13,23,36,27,63,0.000333,0.094995,10,2849.844032,158.324668,284.984403,81.324997,1,2
0,0,9,9,10,13,23,36,27,63,0.000333,0.094995,10,2849.844032,158.324668,284.984403,81.324997,1,2
0,0,9,9,10,13,23,36,27,63,0.000333,0.094995,10,2849.844032,158.324668,284.984403,81.324997,1,2
0,0,11,11,11,11,22,44,32,76,0.000333,0.112972,10,3389.16803,188.287113,338.916803,76.107496,1,2
0,0,10,10,11,12,23,41,29,70,0.000333,0.10555,10,3166.493369,175.916298,316.649337,81.073298,1,2
0,0,10,10,11,13,24,42,30,72,0.000333,0.110039,10,3301.173001,183.3985,330.1173,86.159464,1,2
0,0,11,11,11,14,25,51,34,85,0.000333,0.131576,10,3947.277761,219.293209,394.727776,91.356717,1,2
0,0,11,11,10,15,25,44,33,77,0.000333,0.119192,10,3575.769266,198.653848,357.576927,91.82264,1,2
0,0,12,12,10,15,25,51,37,88,0.000333,0.13622,10,4086.593447,227.032969,408.659345,91.82264,1,2
0,0,12,12,11,15,26,43,36,79,0.000333,0.123778,10,3713.347377,206.297077,371.334738,96.657107,1,2
0,0,11,11,10,16,26,36,35,71,0.000333,0.111244,10,3337.3122,185.406233,333.73122,97.219281,1,2
0,0,14,14,13,17,30,68,53,121,0.000333,0.197911,18,10687.20772,593.733762,593.733762,117.592585,1,2
0,0,14,14,13,18,31,59,44,103,0.000333,0.170094,12,6123.38664,340.188147,510.28222,123.164366,1,2
0,0,14,14,12,16,28,61,46,107,0.000333,0.171462,12,6172.64372,342.924651,514.386977,107.01955,1,2
0,0,7,7,9,10,19,31,22,53,0.000333,0.075047,8,1801.121266,100.062293,225.140158,61.748606,1,2
0,0,7,7,9,10,19,31,22,53,0.000333,0.075047,8,1801.121266,100.062293,225.140158,61.748606,1,2
0,0,7,7,9,10,19,31,22,53,0.000333,0.075047,8,1801.121266,100.062293,225.140158,61.748606,1,2
0,0,7,7,9,10,19,31,22,53,0.000333,0.075047,8,1801.121266,100.062293,225.140158,61.748606,1,2
0,0,7,7,9,10,19,31,22,53,0.000333,0.075047,8,1801.121266,100.062293,225.140158,61.748606,1,2
0,0,7,7,9,10,19,31,22,53,0.000333,0.075047,8,1801.121266,100.062293,225.140158,61.748606,1,2
0,0,7,7,9,10,19,31,22,53,0.000333,0.075047,8,1801.121266,100.062293,225.140158,61.748606,1,2
0,0,7,7,9,10,19,31,22,53,0.000333,0.075047,8,1801.121266,100.062293,225.140158,61.748606,1,2
0,0,7,7,9,10,19,31,22,53,0.000333,0.075047,8,1801.121266,100.062293,225.140158,61.748606,1,2
0,0,7,7,9,10,19,31,22,53,0.000333,0.075047,8,1801.121266,100.062293,225.140158,61.748606,1,2
0,0,7,7,9,10,19,31,22,53,0.000333,0.075047,8,1801.121266,100.062293,225.140158,61.748606,1,2
0,0,7,7,9,10,19,31,22,53,0.000333,0.075047,8,1801.121266,100.062293,225.140158,61.748606,1,2
0,0,7,7,9,10,19,31,22,53,0.000333,0.075047,8,1801.121266,100.062293,225.140158,61.748606,1,2
0,0,7,7,9,10,19,31,22,53,0.000333,0.075047,8,1801.121266,100.062293,225.140158,61.748606,1,2
0,0,7,7,9,10,19,31,22,53,0.000333,0.075047,8,1801.121266,100.062293,225.140158,61.748606,1,2
0,0,7,7,9,10,19,31,22,53,0.000333,0.075047,8,1801.121266,100.062293,225.140158,61.748606,1,2
0,0,7,7,9,10,19,31,22,53,0.000333,0.075047,8,1801.121266,100.062293,225.140158,61.748606,1,2
0,0,7,7,9,10,19,31,22,53,0.000333,0.075047,8,1801.121266,100.062293,225.140158,61.748606,1,2
0,0,11,11,12,11,23,46,33,79,0.000333,0.11912,18,6432.505102,357.361395,357.361395,81.073298,1,2
0,0,11,11,11,11,22,45,33,78,0.000333,0.115945,15,5217.534994,289.863055,347.835666,76.107496,1,2
0,0,9,9,10,11,21,37,28,65,0.000333,0.095167,10,2855.006325,158.611462,285.500632,71.273029,1,2
0,0,9,9,10,12,22,38,27,65,0.000333,0.096621,10,2898.630552,161.035031,289.863055,76.238831,1,2
0,0,9,9,11,11,22,38,28,66,0.000333,0.098107,10,2943.224868,163.512493,294.322487,76.107496,1,2
0,0,10,10,11,14,25,39,31,70,0.000333,0.108357,10,3250.699333,180.594407,325.069933,91.356717,1,2
0,0,9,9,10,12,22,37,28,65,0.000333,0.096621,10,2898.630552,161.035031,289.863055,76.238831,1,2
0,0,11,11,12,11,23,46,33,79,0.000333,0.11912,18,6432.505102,357.361395,357.361395,81.073298,1,2
0,0,10,10,11,12,23,41,30,71,0.000333,0.107058,10,3211.728989,178.429388,321.172899,81.073298,1,2
0,0,10,10,11,13,24,46,32,78,0.000333,0.119209,10,3576.270751,198.681708,357.627075,86.159464,1,2
0,0,11,11,11,13,24,38,30,68,0.000333,0.103926,10,3117.7745,173.209694,311.77745,86.159464,1,2
0,0,9,9,10,12,22,37,28,65,0.000333,0.096621,10,2898.630552,161.035031,289.863055,76.238831,1,2
0,0,9,9,10,13,23,37,28,65,0.000333,0.098011,10,2940.315271,163.350848,294.031527,81.324997,1,2
0,0,9,9,10,13,23,37,28,65,0.000333,0.098011,10,2940.315271,163.350848,294.031527,81.324997,1,2
0,0,9,9,10,13,23,37,28,65,0.000333,0.098011,10,2940.315271,163.350848,294.031527,81.324997,1,2
0,0,10,10,11,10,21,40,29,69,0.000333,0.101023,10,3030.699022,168.372168,303.069902,71.273029,1,2
0,0,10,10,11,12,23,41,30,71,0.000333,0.107058,10,3211.728989,178.429388,321.172899,81.073298,1,2
0,0,10,10,11,13,24,43,31,74,0.000333,0.113096,10,3392.872251,188.492903,339.287225,86.159464,1,2
0,0,12,12,10,15,25,59,39,98,0.000333,0.151699,10,4550.979066,252.83217,455.097907,91.82264,1,2
0,0,10,10,10,13,23,45,32,77,0.000333,0.116105,10,3483.142706,193.507928,348.314271,81.324997,1,2
0,0,12,12,10,15,25,52,38,90,0.000333,0.139316,10,4179.470571,232.192809,417.947057,91.82264,1,2
0,0,12,12,11,15,26,44,37,81,0.000333,0.126912,10,3807.356172,211.519787,380.735617,96.657107,1,2
0,0,11,11,10,16,26,37,36,73,0.000333,0.114377,10,3431.320994,190.628944,343.132099,97.219281,1,2
0,0,14,14,13,17,30,69,54,123,0.000333,0.201183,18,10863.85578,603.547543,603.547543,117.592585,1,2
0,0,14,14,13,16,29,59,45,104,0.000333,0.16841,12,6062.760282,336.820016,505.230023,112.105716,1,2
0,0,14,14,12,16,28,62,47,109,0.000333,0.174667,12,6288.020238,349.334458,524.001687,107.01955,1,2
0,0,7,7,10,10,20,32,21,53,0.000333,0.076354,10,2290.62189,127.256772,229.062189,66.438562,1,2
0,0,7,7,10,10,20,32,21,53,0.000333,0.076354,10,2290.62189,127.256772,229.062189,66.438562,1,2
0,0,7,7,10,10,20,32,21,53,0.000333,0.076354,10,2290.62189,127.256772,229.062189,66.438562,1,2
0,0,7,7,10,10,20,32,21,53,0.000333,0.076354,10,2290.62189,127.256772,229.062189,66.438562,1,2
0,0,7,7,10,10,20,32,21,53,0.000333,0.076354,10,2290.62189,127.256772,229.062189,66.438562,1,2
0,0,7,7,10,10,20,32,21,53,0.000333,0.076354,10,2290.62189,127.256772,229.062189,66.438562,1,2
0,0,8,8,13,20,33,57,34,91,0.000333,0.153013,6,2754.239189,153.013288,459.039865,134.544278,1,2
0,0,39,39,20,71,91,249,158,407,0.000333,0.882891,20,52973.44837,2942.969354,2648.672419,523.070607,10,2
0,0,33,33,20,42,62,185,101,286,0.000333,0.567633,20,34058.0029,1892.111272,1702.900145,312.915894,13,2
0,0,16,16,11,23,34,109,69,178,0.000333,0.301856,15,13583.52579,754.640321,905.568386,142.095673,1,2
0,0,20,20,10,24,34,138,76,214,0.000333,0.362906,15,16330.75572,907.264207,1088.717048,143.258381,3,2
0,0,17,17,8,23,31,110,66,176,0.000333,0.290646,8,6975.508405,387.528245,871.938551,128.041925,3,2
0,0,29,29,19,40,59,169,87,256,0.000333,0.501986,18,27107.21917,1505.956621,1505.956621,293.587747,10,2
0,0,19,19,14,30,44,107,65,172,0.000333,0.313007,14,13146.31134,730.35063,939.022238,200.509687,1,2
0,0,4,4,8,9,17,17,12,29,0.000333,0.039512,4,474.14569,26.341427,118.536422,52.529325,1,2
0,0,20,20,19,26,45,131,76,207,0.000333,0.378938,18,20462.64464,1136.813591,1136.813591,202.922055,6,2
0,0,17,17,18,26,44,92,58,150,0.000333,0.272972,18,14740.46537,818.914743,818.914743,197.270083,7,2
0,0,5,5,10,15,25,75,25,100,0.000333,0.154795,5,2321.928095,128.996005,464.385619,91.82264,8,2
0,0,6,6,13,11,24,51,27,78,0.000333,0.119209,12,4291.524901,238.41805,357.627075,86.159464,2,2
0,0,17,17,15,34,49,120,72,192,0.000333,0.359341,14,15092.34006,838.463337,1078.02429,231.577096,4,2
0,0,3,3,10,8,18,26,14,40,0.000333,0.055599,5,833.985,46.3325,166.797,57.219281,1,2
0,0,5,5,10,12,22,34,21,55,0.000333,0.081756,5,1226.343695,68.130205,245.268739,76.238831,1,2
0,0,8,8,8,15,23,36,34,70,0.000333,0.10555,8,2533.194695,140.733039,316.649337,82.603359,1,2
0,0,17,17,14,22,36,104,63,167,0.000333,0.287792,14,12087.28465,671.515814,863.377475,151.410465,2,2
0,0,31,31,19,37,56,164,86,250,0.000333,0.483946,18,26133.09715,1451.838731,1451.838731,273.460397,12,2
0,0,32,32,20,40,60,182,99,281,0.000333,0.553279,20,33196.72515,1844.262508,1659.836257,299.315686,13,2
0,0,32,32,19,40,59,168,91,259,0.000333,0.507868,18,27424.8819,1523.60455,1523.60455,293.587747,11,2
0,0,28,28,19,37,56,153,80,233,0.000333,0.451038,18,24356.04654,1353.113697,1353.113697,273.460397,11,2
0,0,19,19,12,30,42,134,79,213,0.000333,0.382855,12,13782.76333,765.709074,1148.563611,190.226268,6,2
0,0,37,37,15,36,51,228,140,368,0.000333,0.695818,21,43836.50304,2435.36128,2087.452526,244.720659,6,2
0,0,5,5,14,18,32,46,28,74,0.000333,0.123333,7,2590,143.888889,370,128.361619,1,2
0,0,35,35,19,39,58,200,108,308,0.000333,0.601419,18,32476.64664,1804.258146,1804.258146,286.841309,12,2
0,0,23,23,22,28,50,154,81,235,0.000333,0.442102,22,29178.7365,1621.040917,1326.306205,232.713433,6,2
0,0,25,25,20,40,60,172,92,264,0.000333,0.519806,20,31188.38235,1732.687908,1559.419117,299.315686,8,2
0,0,28,28,19,38,57,165,84,249,0.000333,0.48413,18,26143.01304,1452.389614,1452.389614,280.131868,10,2
0,0,32,32,23,40,63,213,107,320,0.000333,0.637577,22,42080.05066,2337.780592,1912.729576,316.919049,10,2
0,0,7,7,9,16,25,47,31,78,0.000333,0.12074,4,1448.883131,80.493507,362.220783,92.529325,6,2
0,0,5,5,9,13,22,36,20,56,0.000333,0.083243,4,998.912683,55.495149,249.728171,76.635041,1,2
0,0,6,6,14,11,25,54,31,85,0.000333,0.131576,14,5526.188866,307.010493,394.727776,91.356717,2,2
0,0,27,27,17,34,51,136,74,210,0.000333,0.39707,16,19059.34915,1058.852731,1191.209322,242.460605,12,2
0,0,6,6,13,11,24,51,27,78,0.000333,0.119209,12,4291.524901,238.41805,357.627075,86.159464,2,2
0,0,34,34,20,44,64,188,105,293,0.000333,0.586,20,35160,1953.333333,1758,326.653553,17,2
0,0,32,32,16,37,53,183,114,297,0.000333,0.567064,24,40828.617,2268.2565,1701.192375,256.749775,2,2
0,0,6,6,13,11,24,51,27,78,0.000333,0.119209,12,4291.524901,238.41805,357.627075,86.159464,2,2
0,0,27,27,17,34,51,136,74,210,0.000333,0.39707,16,19059.34915,1058.852731,1191.209322,242.460605,10,2
0,0,22,22,15,29,44,703,73,776,0.000333,1.412173,14,59311.26511,3295.070284,4236.518936,199.484808,2,2
0,0,7,7,11,17,28,42,30,72,0.000333,0.115377,5,1730.647772,96.147098,346.129554,107.540616,1,2
0,0,17,17,14,25,39,87,50,137,0.000333,0.241367,14,10137.40146,563.18897,724.100104,169.399374,8,2
0,0,27,27,15,31,46,139,91,230,0.000333,0.423473,14,17785.8695,988.103861,1270.41925,212.183445,11,2
0,0,7,7,14,11,25,63,36,99,0.000333,0.153247,21,9654.577019,536.36539,459.741763,91.356717,2,2
0,0,32,32,19,40,59,182,99,281,0.000333,0.551008,18,29754.40854,1653.022697,1653.022697,293.587747,11,2
0,0,15,15,16,25,41,92,57,149,0.000333,0.266092,16,12772.40398,709.577999,798.275249,180.096405,2,2
0,0,6,6,14,11,25,54,31,85,0.000333,0.131576,14,5526.188866,307.010493,394.727776,91.356717,2,2
0,0,5,5,11,15,26,74,26,100,0.000333,0.156681,5,2350.219859,130.56777,470.043972,96.657107,1,2
0,0,7,7,12,15,27,55,26,81,0.000333,0.128382,6,2310.875326,128.381963,385.145888,101.622909,2,2
0,0,7,7,10,16,26,60,29,89,0.000333,0.139446,5,2091.695675,116.205315,418.339135,97.219281,1,2
0,0,7,7,14,11,25,63,36,99,0.000333,0.153247,21,9654.577019,536.36539,459.741763,91.356717,2,2
0,0,20,20,11,27,38,194,84,278,0.000333,0.486308,15,21883.85773,1215.769874,1458.923849,166.43571,10,2
0,0,19,19,11,22,33,103,62,165,0.000333,0.277442,10,8323.250297,462.402794,832.32503,136.161243,11,2
0,0,30,30,13,33,46,226,130,356,0.000333,0.655463,18,35394.98501,1966.388056,1966.388056,214.570722,1,2
0,0,9,9,11,18,29,63,41,104,0.000333,0.16841,10,5052.300235,280.683346,505.230023,113.112398,1,2
0,0,18,18,19,23,42,152,58,210,0.000333,0.377462,18,20382.95986,1132.386659,1132.386659,184.752548,6,2
0,0,17,17,18,18,36,71,49,120,0.000333,0.206797,18,11167.038,620.391,620.391,150.1173,2,2
0,0,16,16,16,21,37,66,47,113,0.000333,0.196223,16,9418.691685,523.260649,588.66823,156.238666,1,2
0,0,8,8,12,15,27,58,29,87,0.000333,0.137892,6,2482.051276,137.891738,413.675213,101.622909,8,2
0,0,7,7,11,15,26,46,27,73,0.000333,0.114377,5,1715.660497,95.314472,343.132099,96.657107,6,2
0,0,19,19,14,31,45,128,64,192,0.000333,0.351479,14,14762.10112,820.116729,1054.435794,206.883055,6,2
0,0,20,20,13,31,44,137,80,217,0.000333,0.394899,12,14216.35994,789.797774,1184.696661,201.685802,1,2
0,0,1,1,3,2,5,3,2,5,0.000333,0.00387,1,11.60964,0.64498,11.60964,6.754888,1,2
0,0,37,37,19,43,62,207,113,320,0.000333,0.635114,18,34296.17075,1905.342819,1905.342819,314.040007,12,2
0,0,28,28,17,35,52,138,75,213,0.000333,0.404731,16,19427.09856,1079.283253,1214.19366,249.011774,10,2
0,0,27,27,20,41,61,206,97,303,0.000333,0.599004,20,35940.26827,1996.68157,1797.013413,306.098194,14,2
0,0,3,3,9,6,15,19,9,28,0.000333,0.036464,4,437.571747,24.309541,109.392937,44.0391,3,2
0,0,31,31,20,37,57,165,87,252,0.000333,0.489963,20,29397.76567,1633.209204,1469.888284,279.188336,11,2
0,0,23,23,21,37,58,148,75,223,0.000333,0.435443,20,26126.59524,1451.477513,1306.329762,284.98844,8,2
0,0,28,28,19,38,57,151,79,230,0.000333,0.447188,18,24148.16466,1341.564703,1341.564703,280.131868,11,2
0,0,6,6,10,16,26,43,28,71,0.000333,0.111244,5,1668.6561,92.703117,333.73122,97.219281,1,2
0,0,33,33,23,40,63,212,113,325,0.000333,0.647539,22,42737.55145,2374.308414,1942.615975,316.919049,11,2
0,0,27,27,17,35,52,145,75,220,0.000333,0.418032,16,20065.54781,1114.752656,1254.096738,249.011774,10,2
0,0,20,20,15,31,46,120,61,181,0.000333,0.333255,7,6998.352998,388.797389,999.764714,212.183445,7,2
0,0,28,28,19,37,56,148,78,226,0.000333,0.437487,18,23624.31982,1312.462212,1312.462212,273.460397,11,2
0,0,32,32,20,39,59,181,98,279,0.000333,0.547086,20,32825.14822,1823.619345,1641.257411,292.569248,13,2
0,0,31,31,24,42,66,211,114,325,0.000333,0.654809,24,47146.27413,2619.237452,1964.428089,336.516432,12,2
0,0,66,66,19,69,88,449,303,752,0.000333,1.619164,36,174869.7328,9714.985154,4857.492577,502.19881,4,2
0,0,6,6,8,13,21,39,21,60,0.000333,0.087846,4,1054.156181,58.564232,263.539045,72.105716,1,2
0,0,6,6,12,10,22,22,17,39,0.000333,0.057973,6,1043.506999,57.972611,173.917833,76.238831,2,2
0,0,28,28,19,37,56,151,80,231,0.000333,0.447166,18,24146.98177,1341.498987,1341.498987,273.460397,11,2
0,0,5,5,10,12,22,31,18,49,0.000333,0.072837,5,1092.560747,60.697819,218.512149,76.238831,2,2
0,0,14,14,17,19,36,72,54,126,0.000333,0.217137,16,10422.5688,579.0316,651.41055,150.197491,3,2
0,0,13,13,12,19,31,64,54,118,0.000333,0.194865,12,7015.141976,389.73011,584.595165,123.730173,1,2
0,0,5,5,10,12,22,31,18,49,0.000333,0.072837,5,1092.560747,60.697819,218.512149,76.238831,1,2
0,0,26,26,17,33,50,140,73,213,0.000333,0.400714,16,19234.2619,1068.570105,1202.141368,235.951874,10,2
0,0,7,7,12,13,25,40,20,60,0.000333,0.092877,6,1671.788228,92.877124,278.631371,91.125266,3,2
0,0,6,6,10,20,30,50,28,78,0.000333,0.127579,5,1913.687332,106.315963,382.737466,119.657843,2,2
0,0,37,37,19,44,63,209,113,322,0.000333,0.641561,18,34644.31444,1924.684135,1924.684135,320.925614,12,2
0,0,6,6,9,15,24,47,29,76,0.000333,0.116152,4,1393.8286,77.434922,348.45715,87.132684,3,2
0,0,30,30,14,30,44,178,113,291,0.000333,0.529565,21,33362.58662,1853.477035,1588.694601,200.509687,2,2
0,0,33,33,19,42,61,178,97,275,0.000333,0.543651,18,29357.14982,1630.952768,1630.952768,307.187955,11,2
0,0,35,35,20,42,62,185,103,288,0.000333,0.571603,20,34296.17075,1905.342819,1714.808537,312.915894,12,2
0,0,6,6,14,11,25,54,31,85,0.000333,0.131576,14,5526.188866,307.010493,394.727776,91.356717,2,2
0,0,3,3,8,7,15,13,10,23,0.000333,0.029953,4,359.433935,19.968552,89.858484,43.651484,1,2
0,0,27,27,19,36,55,160,82,242,0.000333,0.466363,18,25183.60291,1399.089051,1399.089051,266.827923,10,2
0,0,19,19,22,24,46,133,66,199,0.000333,0.366396,22,24182.15424,1343.453014,1099.188829,208.146596,9,2
0,0,31,31,20,37,57,168,91,259,0.000333,0.503573,20,30214.37027,1678.576126,1510.718514,279.188336,11,2
0,0,9,9,9,17,26,41,29,70,0.000333,0.109677,4,1316.123121,73.117951,329.03078,98.016193,1,2
0,0,34,34,19,44,63,189,104,293,0.000333,0.583781,18,31524.17432,1751.343018,1751.343018,320.925614,11,2
0,0,8,8,10,18,28,41,29,70,0.000333,0.112172,5,1682.574223,93.476346,336.514845,108.277931,5,2
0,0,3,3,12,10,22,28,16,44,0.000333,0.065405,6,1177.289947,65.404997,196.214991,76.238831,3,2
0,0,17,17,14,22,36,104,63,167,0.000333,0.287792,14,12087.28465,671.515814,863.377475,151.410465,2,2
0,0,27,27,17,34,51,136,74,210,0.000333,0.39707,16,19059.34915,1058.852731,1191.209322,242.460605,10,2
0,0,20,20,23,27,50,130,78,208,0.000333,0.391307,22,25826.28592,1434.793662,1173.922087,232.423888,7,2
0,0,7,7,11,17,28,48,27,75,0.000333,0.120184,5,1802.758096,100.153228,360.551619,107.540616,1,2
0,0,9,9,16,17,33,43,27,70,0.000333,0.117703,8,2824.860707,156.936706,353.107588,133.486868,3,2
0,0,7,7,14,16,30,33,24,57,0.000333,0.093231,7,1957.849348,108.769408,279.692764,117.302969,2,2
0,0,4,4,10,14,24,45,23,68,0.000333,0.103926,5,1558.88725,86.604847,311.77745,86.52225,1,2
0,0,29,29,23,42,65,186,106,292,0.000333,0.586177,22,38687.69083,2149.316157,1758.531401,330.519257,14,2
0,0,31,31,19,38,57,167,91,258,0.000333,0.501629,18,27087.94123,1504.885624,1504.885624,280.131868,11,2
0,0,6,6,14,11,25,54,31,85,0.000333,0.131576,14,5526.188866,307.010493,394.727776,91.356717,2,2
0,0,5,5,11,17,28,44,27,71,0.000333,0.113774,5,1706.610997,94.811722,341.322199,107.540616,1,2
0,0,11,11,15,22,37,62,45,107,0.000333,0.185804,14,7803.761142,433.542286,557.41151,156.710855,3,2
0,0,10,10,14,22,36,51,40,91,0.000333,0.156821,7,3293.242226,182.957901,470.463175,151.410465,2,2
0,0,31,31,19,37,56,165,87,252,0.000333,0.487818,18,26342.16193,1463.45344,1463.45344,273.460397,11,2
0,0,22,22,21,37,58,145,73,218,0.000333,0.42568,10,12770.39857,709.466587,1277.039857,284.98844,8,2
0,0,6,6,10,14,24,204,21,225,0.000333,0.343872,5,5158.082813,286.560156,1031.616563,86.52225,1,2
0,0,25,25,16,38,54,166,81,247,0.000333,0.473819,16,22743.31541,1263.517523,1421.457213,263.421246,7,2
0,0,8,8,14,17,31,53,25,78,0.000333,0.128809,7,2704.991185,150.277288,386.427312,122.789837,3,2
0,0,31,31,19,37,56,168,91,259,0.000333,0.501368,18,27073.88865,1504.104925,1504.104925,273.460397,11,2
0,0,3,3,8,7,15,11,10,21,0.000333,0.027348,4,328.17881,18.232156,82.044703,43.651484,1,2
0,0,7,7,10,10,20,55,34,89,0.000333,0.128217,15,5769.774007,320.543,384.6516,66.438562,6,2
0,0,6,6,14,11,25,54,31,85,0.000333,0.131576,14,5526.188866,307.010493,394.727776,91.356717,2,2
0,0,5,5,9,13,22,39,20,59,0.000333,0.087702,4,1052.425862,58.468103,263.106465,76.635041,1,2
0,0,18,18,14,22,36,111,67,178,0.000333,0.306749,21,19325.17966,1073.621092,920.24665,151.410465,2,2
0,0,27,27,25,37,62,204,109,313,0.000333,0.621221,24,44727.92268,2484.884594,1863.663445,308.846179,8,2
0,0,13,13,13,27,40,104,54,158,0.000333,0.280288,12,10090.37567,560.576426,840.864639,176.487679,1,2
0,0,4,4,9,10,19,23,16,39,0.000333,0.055223,4,662.676692,36.815372,165.669173,61.748606,2,2
0,0,17,17,12,28,40,143,77,220,0.000333,0.390275,12,14049.89017,780.549454,1170.824181,177.625488,2,2
0,0,6,6,14,11,25,54,31,85,0.000333,0.131576,14,5526.188866,307.010493,394.727776,91.356717,2,2
0,0,9,9,11,17,28,53,34,87,0.000333,0.139413,10,4182.398782,232.355488,418.239878,107.540616,1,2
0,0,33,33,14,42,56,318,130,448,0.000333,0.867232,21,54635.59511,3035.310839,2601.695005,279.780301,9,2
0,0,6,6,11,19,30,50,28,78,0.000333,0.127579,5,1913.687332,106.315963,382.737466,118.764371,1,2
0,0,17,17,18,18,36,71,49,120,0.000333,0.206797,18,11167.038,620.391,620.391,150.1173,2,2
0,0,8,8,10,17,27,53,35,88,0.000333,0.139477,10,4184.301002,232.461167,418.4301,102.706149,1,2
0,0,3,3,9,12,21,29,18,47,0.000333,0.068813,4,825.755675,45.875315,206.438919,71.548875,6,2
0,0,11,11,14,24,38,74,47,121,0.000333,0.211666,7,4444.994604,246.944145,634.999229,163.342069,5,2
0,0,7,7,13,10,23,39,24,63,0.000333,0.094995,12,3419.812839,189.989602,284.984403,81.324997,1,2
0,0,3,3,7,6,13,18,11,29,0.000333,0.035771,3,321.938255,17.885459,107.312752,35.161259,1,2
0,0,6,6,14,11,25,54,31,85,0.000333,0.131576,14,5526.188866,307.010493,394.727776,91.356717,2,2
0,0,8,8,10,17,27,48,34,82,0.000333,0.129967,10,3899.007752,216.611542,389.900775,102.706149,1,2
0,0,4,4,10,11,21,24,18,42,0.000333,0.061492,5,922.386659,51.243703,184.477332,71.273029,2,2
0,0,3,3,9,7,16,23,13,36,0.000333,0.048,4,576,32,144,48.180809,1,2
0,0,9,9,13,15,28,48,24,72,0.000333,0.115377,6,2076.777326,115.376518,346.129554,106.709075,7,2
0,0,6,6,10,9,19,23,14,37,0.000333,0.052391,5,785.86659,43.659255,157.173318,61.748606,1,2
0,0,3,3,8,7,15,13,10,23,0.000333,0.029953,4,359.433935,19.968552,89.858484,43.651484,1,2
0,0,38,38,15,36,51,221,136,357,0.000333,0.675019,21,42526.17279,2362.565155,2025.055847,244.720659,6,2
0,0,13,13,13,27,40,96,50,146,0.000333,0.259001,6,4662.009011,259.000501,777.001502,176.487679,7,2
0,0,6,6,13,10,23,49,27,76,0.000333,0.114597,12,4125.488504,229.193806,343.790709,81.324997,2,2
0,0,6,6,9,12,21,21,19,40,0.000333,0.058564,4,702.770788,39.042822,175.692697,71.548875,1,2
0,0,7,7,12,15,27,29,25,54,0.000333,0.085588,6,1540.583551,85.587975,256.763925,101.622909,1,2
0,0,8,8,11,13,24,30,25,55,0.000333,0.084058,5,1260.864688,70.048038,252.172938,86.159464,2,2
0,0,6,6,13,10,23,49,27,76,0.000333,0.114597,12,4125.488504,229.193806,343.790709,81.324997,2,2
0,0,8,8,14,15,29,35,27,62,0.000333,0.100398,7,2108.363752,117.13132,301.194822,111.906328,2,2
0,0,6,6,10,14,24,43,24,67,0.000333,0.102397,5,1535.962438,85.331247,307.192488,86.52225,1,2
0,0,19,19,14,30,44,126,77,203,0.000333,0.369422,14,15515.70466,861.983592,1108.264619,200.509687,1,2
0,0,10,10,17,15,32,48,32,80,0.000333,0.133333,16,6400,355.555556,400,128.090227,3,2
0,0,21,21,16,31,47,146,88,234,0.000333,0.433258,16,20796.38066,1155.354481,1299.773791,217.580086,10,2
0,0,6,6,14,11,25,54,31,85,0.000333,0.131576,14,5526.188866,307.010493,394.727776,91.356717,2,2
0,0,4,4,9,7,16,22,11,33,0.000333,0.044,4,528,29.333333,132,48.180809,3,2
0,0,10,10,9,20,29,52,33,85,0.000333,0.137643,4,1651.713538,91.761863,412.928385,114.967887,3,2
0,0,5,5,9,13,22,36,20,56,0.000333,0.083243,4,998.912683,55.495149,249.728171,76.635041,1,2
0,0,10,10,18,20,38,68,34,102,0.000333,0.17843,9,4817.597457,267.644303,535.288606,161.497212,7,2
0,0,8,8,10,19,29,51,32,83,0.000333,0.134404,5,2016.062113,112.003451,403.212423,113.929904,3,2
0,0,6,6,12,11,23,23,18,41,0.000333,0.061822,6,1112.796241,61.822013,185.46604,81.073298,2,2
0,0,8,8,13,14,27,46,22,68,0.000333,0.107777,6,1939.994101,107.77745,323.33235,101.408685,6,2
0,0,16,16,15,28,43,105,62,167,0.000333,0.302062,14,12686.607,704.8115,906.186214,193.209297,7,2
0,0,6,6,14,11,25,54,31,85,0.000333,0.131576,14,5526.188866,307.010493,394.727776,91.356717,2,2
0,0,6,6,14,11,25,54,31,85,0.000333,0.131576,14,5526.188866,307.010493,394.727776,91.356717,2,2
0,0,24,24,22,27,49,112,75,187,0.000333,0.349984,22,23098.9163,1283.273128,1049.950741,226.489458,11,2
0,0,36,36,17,40,57,190,129,319,0.000333,0.620231,24,44656.60595,2480.922553,1860.691915,282.363992,3,2
0,0,6,6,13,11,24,51,27,78,0.000333,0.119209,12,4291.524901,238.41805,357.627075,86.159464,2,2
0,0,6,6,13,11,24,51,27,78,0.000333,0.119209,12,4291.524901,238.41805,357.627075,86.159464,2,2
0,0,25,25,14,35,49,153,93,246,0.000333,0.460406,14,19337.0607,1074.28115,1381.218622,232.827875,4,2
0,0,6,6,14,11,25,54,31,85,0.000333,0.131576,14,5526.188866,307.010493,394.727776,91.356717,2,2
0,0,11,11,19,18,37,58,37,95,0.000333,0.164966,18,8908.165255,494.89807,494.89807,155.769273,3,2
0,0,7,7,15,13,28,33,21,54,0.000333,0.086532,7,1817.180161,100.954453,259.597166,106.709075,2,2
0,0,3,3,8,9,17,15,11,26,0.000333,0.035425,4,425.096135,23.616452,106.274034,52.529325,1,2
0,0,6,6,14,11,25,54,31,85,0.000333,0.131576,14,5526.188866,307.010493,394.727776,91.356717,2,2
0,0,6,6,14,11,25,54,31,85,0.000333,0.131576,14,5526.188866,307.010493,394.727776,91.356717,2,2
0,0,16,16,16,28,44,121,72,193,0.000333,0.351223,16,16858.72484,936.595824,1053.670302,198.605938,2,2
0,0,10,10,14,18,32,61,35,96,0.000333,0.16,7,3360,186.666667,480,128.361619,1,2
0,0,6,6,13,10,23,49,27,76,0.000333,0.114597,12,4125.488504,229.193806,343.790709,81.324997,2,2
0,0,18,18,10,25,35,127,74,201,0.000333,0.343662,10,10309.85886,572.769937,1030.985886,149.315686,1,2
0,0,5,5,9,14,23,42,21,63,0.000333,0.094995,4,1139.937613,63.329867,284.984403,81.832294,1,2
0,0,28,28,14,45,59,193,96,289,0.000333,0.566695,14,23801.17378,1322.287432,1700.083841,300.436358,7,2
0,0,26,26,14,39,53,149,93,242,0.000333,0.462052,14,19406.1945,1078.121917,1386.15675,259.433655,2,2
0,0,9,9,14,15,29,36,25,61,0.000333,0.098779,7,2074.357885,115.242105,296.336841,111.906328,2,2
0,0,11,11,13,24,37,63,43,106,0.000333,0.184067,6,3313.212341,184.067352,552.202057,158.144816,3,2
0,0,9,9,13,21,34,59,34,93,0.000333,0.157711,6,2838.804265,157.711348,473.134044,140.344382,1,2
0,0,25,25,14,34,48,163,90,253,0.000333,0.470999,14,19781.93718,1098.99651,1412.995513,226.276706,4,2
0,0,4,4,12,14,26,47,22,69,0.000333,0.10811,6,1945.982043,108.110114,324.330341,96.322519,1,2
0,0,8,8,11,11,22,54,31,85,0.000333,0.126351,10,3790.516876,210.584271,379.051688,76.107496,1,2
0,0,6,6,9,10,19,24,19,43,0.000333,0.060887,4,730.643532,40.591307,182.660883,61.748606,1,2
0,0,6,6,13,10,23,49,27,76,0.000333,0.114597,12,4125.488504,229.193806,343.790709,81.324997,2,2
0,0,6,6,14,11,25,54,31,85,0.000333,0.131576,14,5526.188866,307.010493,394.727776,91.356717,2,2
0,0,19,19,18,36,54,137,80,217,0.000333,0.41627,18,22478.59058,1248.810588,1248.810588,261.17595,10,2
0,0,20,20,17,38,55,131,82,213,0.000333,0.410477,16,19702.8739,1094.604106,1231.429619,268.908114,6,2
0,0,6,6,13,11,24,51,27,78,0.000333,0.119209,12,4291.524901,238.41805,357.627075,86.159464,2,2
0,0,4,4,8,9,17,17,12,29,0.000333,0.039512,4,474.14569,26.341427,118.536422,52.529325,1,2
0,0,16,16,17,20,37,66,47,113,0.000333,0.196223,16,9418.691685,523.260649,588.66823,155.92543,1,2
0,0,2,2,6,4,10,7,5,12,0.000333,0.013288,3,119.589411,6.643856,39.863137,23.509775,1,2
0,0,4,4,9,9,18,16,13,29,0.000333,0.040309,4,483.7113,26.87285,120.927825,57.05865,1,2
0,0,4,4,11,13,24,37,21,58,0.000333,0.088643,5,1329.639125,73.86884,265.927825,86.159464,1,2
0,0,18,18,13,30,43,125,76,201,0.000333,0.36356,12,13088.15059,727.119477,1090.679216,195.312434,1,2
0,0,2,2,6,6,12,9,7,16,0.000333,0.01912,3,172.0782,9.5599,57.3594,31.01955,1,2
0,0,12,12,10,23,33,77,50,127,0.000333,0.213546,10,6406.380532,355.91003,640.638053,137.261206,1,2
0,0,6,6,8,13,21,28,18,46,0.000333,0.067349,4,808.186406,44.899245,202.046601,72.105716,4,2
0,0,6,6,9,10,19,24,19,43,0.000333,0.060887,4,730.643532,40.591307,182.660883,61.748606,1,2
0,0,6,6,14,11,25,54,31,85,0.000333,0.131576,14,5526.188866,307.010493,394.727776,91.356717,2,2
0,0,8,8,15,15,30,39,24,63,0.000333,0.103045,7,2163.938753,120.21882,309.134108,117.206718,3,2
0,0,18,18,13,23,36,106,68,174,0.000333,0.299856,12,10794.8034,599.7113,899.56695,152.147641,4,2
0,0,22,22,16,31,47,120,77,197,0.000333,0.364751,16,17508.06406,972.670226,1094.254004,217.580086,2,2
0,0,38,38,16,41,57,324,134,458,0.000333,0.890488,24,64115.12704,3561.951502,2671.463626,283.659632,6,2
0,0,5,5,12,16,28,45,23,68,0.000333,0.108967,6,1961.400808,108.966712,326.900135,107.01955,1,2
0,0,8,8,13,21,34,53,35,88,0.000333,0.149232,6,2686.18038,149.232243,447.69673,140.344382,3,2
0,0,6,6,13,10,23,49,27,76,0.000333,0.114597,12,4125.488504,229.193806,343.790709,81.324997,2,2
0,0,7,7,11,15,26,42,27,69,0.000333,0.10811,5,1621.651703,90.091761,324.330341,96.657107,1,2
0,0,17,17,11,24,35,131,77,208,0.000333,0.35563,15,16003.36301,889.075723,1066.890868,148.092848,1,2
0,0,6,6,13,11,24,51,27,78,0.000333,0.119209,12,4291.524901,238.41805,357.627075,86.159464,2,2
0,0,17,17,9,23,32,128,76,204,0.000333,0.34,12,12240,680,1020,132.57125,1,2
0,0,12,12,18,15,33,49,30,79,0.000333,0.132836,18,7173.128438,398.507135,398.507135,133.662009,4,2
0,0,8,8,16,15,31,37,25,62,0.000333,0.102387,8,2457.28137,136.515632,307.160171,122.603359,2,2
0,0,16,16,13,26,39,99,59,158,0.000333,0.278365,12,10021.12261,556.729034,835.093551,170.317149,6,2
0,0,9,9,12,19,31,63,36,99,0.000333,0.163488,6,2942.792608,163.488478,490.465435,123.730173,1,2
0,0,4,4,9,12,21,32,19,51,0.000333,0.074669,4,896.032754,49.779597,224.008189,71.548875,1,2
0,0,10,10,16,16,32,45,28,73,0.000333,0.121667,8,2920,162.222222,365,128,3,2
1,0,5,6,11,10,21,29,14,43,0.000333,0.062957,5,944.348246,52.463791,188.869649,71.273029,6,2
0,0,33,33,18,44,62,480,117,597,0.000333,1.184885,18,63983.79355,3554.655197,3554.655197,315.273641,2,2
0,0,6,6,13,11,24,51,27,78,0.000333,0.119209,12,4291.524901,238.41805,357.627075,86.159464,2,2
0,0,5,5,9,14,23,42,21,63,0.000333,0.094995,4,1139.937613,63.329867,284.984403,81.832294,1,2
0,0,6,6,13,10,23,49,27,76,0.000333,0.114597,12,4125.488504,229.193806,343.790709,81.324997,2,2
0,0,6,6,14,15,29,50,25,75,0.000333,0.12145,7,2550.440022,141.691112,364.348575,111.906328,2,2
0,0,8,8,16,15,31,39,24,63,0.000333,0.104038,8,2496.91494,138.717497,312.114368,122.603359,3,2
0,0,6,6,13,11,24,51,27,78,0.000333,0.119209,12,4291.524901,238.41805,357.627075,86.159464,2,2
0,0,6,6,11,13,24,39,22,61,0.000333,0.093228,5,1398.413563,77.689642,279.682713,86.159464,1,2
1,0,14,15,23,20,43,72,43,115,0.000333,0.208007,22,13728.44983,762.691657,624.020447,190.480487,6,2
0,0,6,6,14,11,25,54,31,85,0.000333,0.131576,14,5526.188866,307.010493,394.727776,91.356717,2,2
0,0,9,9,14,14,28,35,23,58,0.000333,0.092942,7,1951.786098,108.432561,278.826585,106.605938,3,2
1,0,14,15,23,20,43,69,44,113,0.000333,0.204389,22,13489.69418,749.427454,613.167917,190.480487,6,2
0,0,10,10,10,22,32,76,46,122,0.000333,0.203333,10,6100,338.888889,610,131.326777,1,2
0,0,5,5,11,13,24,33,19,52,0.000333,0.079473,5,1192.09025,66.227236,238.41805,86.159464,1,2
0,0,5,5,11,15,26,44,22,66,0.000333,0.10341,5,1551.145107,86.174728,310.229021,96.657107,1,2
0,0,20,20,16,31,47,114,72,186,0.000333,0.344385,16,16530.45642,918.35869,1033.153526,217.580086,2,2
0,0,13,13,12,19,31,59,42,101,0.000333,0.166791,12,6004.485928,333.582552,500.373827,123.730173,5,2
0,0,6,6,15,11,26,42,17,59,0.000333,0.092442,7,1941.281604,107.848978,277.325943,96.657107,3,2
0,0,12,12,14,20,34,57,47,104,0.000333,0.176365,14,7407.345897,411.519216,529.096135,139.741531,2,2
0,0,11,11,10,20,30,78,41,119,0.000333,0.19464,10,5839.199809,324.399989,583.919981,119.657843,1,2
0,0,21,21,20,35,55,131,71,202,0.000333,0.389278,20,23356.69324,1297.594069,1167.834662,265.963467,6,2
0,0,7,7,12,12,24,40,19,59,0.000333,0.090171,6,1623.076725,90.170929,270.512788,86.0391,3,2
0,0,6,6,13,10,23,49,27,76,0.000333,0.114597,12,4125.488504,229.193806,343.790709,81.324997,2,2
0,0,7,7,16,11,27,58,26,84,0.000333,0.133137,16,6390.568803,355.0316,399.41055,102.053748,4,2
0,0,6,6,16,12,28,47,24,71,0.000333,0.113774,16,5461.155191,303.397511,341.322199,107.01955,4,2
0,0,6,6,12,15,27,27,21,48,0.000333,0.076078,6,1369.407601,76.0782,228.2346,101.622909,1,2
0,0,5,5,10,10,20,22,17,39,0.000333,0.056185,5,842.775979,46.820888,168.555196,66.438562,1,2
0,0,9,9,15,17,32,54,27,81,0.000333,0.135,7,2835,157.5,405,128.090227,5,2
0,0,7,7,13,11,24,34,21,55,0.000333,0.084058,6,1513.037625,84.057646,252.172938,86.159464,5,2
0,0,6,6,13,11,24,51,27,78,0.000333,0.119209,12,4291.524901,238.41805,357.627075,86.159464,2,2
0,0,26,26,19,42,61,144,84,228,0.000333,0.450736,18,24339.74603,1352.208113,1352.208113,307.187955,9,2
0,0,5,5,14,9,23,39,20,59,0.000333,0.088963,14,3736.462176,207.581232,266.890155,81.832294,4,2
0,0,6,6,15,11,26,56,26,82,0.000333,0.128479,14,5396.104796,299.7836,385.436057,96.657107,4,2
0,0,4,4,8,7,15,15,12,27,0.000333,0.035162,4,421.944184,23.441344,105.486046,43.651484,1,2
0,0,12,12,19,25,44,95,44,139,0.000333,0.252954,9,6829.748955,379.430497,758.860995,196.807027,4,2
0,0,28,28,15,39,54,185,96,281,0.000333,0.539041,14,22639.72743,1257.762635,1617.123388,264.734045,13,2
0,0,7,7,10,11,21,37,18,55,0.000333,0.080526,5,1207.887291,67.10485,241.577458,71.273029,3,2
0,0,4,4,12,10,22,31,19,50,0.000333,0.074324,6,1337.829486,74.32386,222.971581,76.238831,3,2
0,0,6,6,16,12,28,47,24,71,0.000333,0.113774,16,5461.155191,303.397511,341.322199,107.01955,4,2
0,0,25,25,25,36,61,154,93,247,0.000333,0.488297,24,35157.41094,1953.189497,1464.892122,302.213705,11,2
0,0,5,5,10,12,22,26,20,46,0.000333,0.068378,5,1025.669272,56.981626,205.133854,76.238831,2,2
0,0,8,8,17,17,34,59,28,87,0.000333,0.147536,8,3540.874138,196.71523,442.609267,138.973737,3,2
0,0,6,6,14,11,25,54,31,85,0.000333,0.131576,14,5526.188866,307.010493,394.727776,91.356717,2,2
0,0,2,2,6,4,10,7,5,12,0.000333,0.013288,3,119.589411,6.643856,39.863137,23.509775,1,2
0,0,6,6,14,11,25,54,31,85,0.000333,0.131576,14,5526.188866,307.010493,394.727776,91.356717,2,2
0,0,16,16,18,32,50,90,61,151,0.000333,0.284074,9,7670.000562,426.111142,852.222285,235.05865,4,2
0,0,10,10,19,19,38,86,43,129,0.000333,0.225661,18,12185.68769,676.982649,676.982649,161.421246,8,2
0,0,6,6,15,11,26,56,26,82,0.000333,0.128479,14,5396.104796,299.7836,385.436057,96.657107,4,2
0,0,6,6,8,16,24,44,26,70,0.000333,0.106982,4,1283.7895,71.321639,320.947375,88,3,2
0,0,6,6,16,12,28,47,24,71,0.000333,0.113774,16,5461.155191,303.397511,341.322199,107.01955,4,2
0,0,17,17,18,25,43,420,64,484,0.000333,0.875437,18,47273.61854,2626.312141,2626.312141,191.155055,9,2
0,0,6,6,14,11,25,54,31,85,0.000333,0.131576,14,5526.188866,307.010493,394.727776,91.356717,2,2
0,0,29,29,20,40,60,201,100,301,0.000333,0.592658,20,35559.48139,1975.526744,1777.974069,299.315686,11,2
0,0,21,21,14,36,50,127,73,200,0.000333,0.376257,14,15802.79733,877.933185,1128.771238,239.420269,5,2
0,0,13,13,16,17,33,74,39,113,0.000333,0.190006,16,9120.264568,506.681365,570.016535,133.486868,7,2
0,0,6,6,14,11,25,54,31,85,0.000333,0.131576,14,5526.188866,307.010493,394.727776,91.356717,2,2
0,0,6,6,13,11,24,51,27,78,0.000333,0.119209,12,4291.524901,238.41805,357.627075,86.159464,2,2
0,0,6,6,13,10,23,49,27,76,0.000333,0.114597,12,4125.488504,229.193806,343.790709,81.324997,2,2
0,0,24,24,19,37,56,148,81,229,0.000333,0.443295,18,23937.91699,1329.884277,1329.884277,273.460397,10,2
0,0,17,17,15,21,36,93,54,147,0.000333,0.253326,14,10639.70565,591.094758,759.978975,150.842025,3,2
0,0,6,6,14,11,25,54,31,85,0.000333,0.131576,14,5526.188866,307.010493,394.727776,91.356717,2,2
0,0,6,6,13,10,23,49,27,76,0.000333,0.114597,12,4125.488504,229.193806,343.790709,81.324997,2,2
0,0,20,20,20,40,60,115,75,190,0.000333,0.374103,10,11223.09213,623.505118,1122.309213,299.315686,7,2
0,0,5,5,14,9,23,39,20,59,0.000333,0.088963,14,3736.462176,207.581232,266.890155,81.832294,4,2
0,0,25,25,20,42,62,191,98,289,0.000333,0.573588,20,34415.25467,1911.958593,1720.762734,312.915894,13,2
0,0,6,6,16,12,28,47,24,71,0.000333,0.113774,16,5461.155191,303.397511,341.322199,107.01955,4,2
1,0,14,15,14,22,36,86,60,146,0.000333,0.251603,14,10567.3267,587.073706,754.80905,151.410465,3,2
0,0,7,7,12,13,25,27,21,48,0.000333,0.074302,6,1337.430583,74.301699,222.905097,91.125266,2,2
0,0,11,11,12,24,36,76,42,118,0.000333,0.20335,6,3660.306901,203.350383,610.05115,153.05865,4,2
0,0,10,10,16,19,35,50,37,87,0.000333,0.148749,8,3569.98098,198.332277,446.247622,144.710623,3,2
0,0,2,2,7,3,10,11,4,15,0.000333,0.01661,3,149.486764,8.30482,49.828921,24.406372,2,2
0,0,22,22,20,35,55,142,73,215,0.000333,0.414331,20,24859.84677,1381.102598,1242.992338,265.963467,10,2
0,0,7,7,9,10,19,29,24,53,0.000333,0.075047,8,1801.121266,100.062293,225.140158,61.748606,1,2
0,0,15,15,12,28,40,93,60,153,0.000333,0.271418,12,9771.059982,542.836666,814.254999,177.625488,1,2
0,0,6,6,13,10,23,49,27,76,0.000333,0.114597,12,4125.488504,229.193806,343.790709,81.324997,2,2
0,0,6,6,16,12,28,47,24,71,0.000333,0.113774,16,5461.155191,303.397511,341.322199,107.01955,4,2
0,0,31,31,20,40,60,178,100,278,0.000333,0.547372,20,32842.31171,1824.572873,1642.115586,299.315686,9,2
0,0,8,8,16,15,31,56,32,88,0.000333,0.145323,16,6975.508405,387.528245,435.969275,122.603359,6,2
0,0,35,35,20,45,65,208,118,326,0.000333,0.654431,20,39265.83814,2181.435452,1963.291907,333.571951,11,2
0,0,14,14,12,21,33,125,43,168,0.000333,0.282486,12,10169.49855,564.972141,847.458212,135.258216,2,2
0,0,4,4,8,7,15,15,12,27,0.000333,0.035162,4,421.944184,23.441344,105.486046,43.651484,1,2
0,0,15,15,14,24,38,79,44,123,0.000333,0.215165,7,4518.465589,251.025866,645.495084,163.342069,11,2
0,0,12,12,17,22,39,65,47,112,0.000333,0.197322,16,9471.440776,526.191154,591.965049,167.594364,4,2
0,0,4,4,12,14,26,33,22,55,0.000333,0.086175,6,1551.145107,86.174728,258.524184,96.322519,1,2
0,0,4,4,8,9,17,18,14,32,0.000333,0.0436,4,523.195244,29.066402,130.798811,52.529325,1,2
0,0,28,28,20,34,54,160,89,249,0.000333,0.477656,20,28659.33976,1592.185542,1432.966988,259.412299,9,2
0,0,10,10,10,24,34,64,40,104,0.000333,0.176365,5,2645.480677,146.971149,529.096135,143.258381,8,2
0,0,3,3,8,10,18,16,13,29,0.000333,0.040309,4,483.7113,26.87285,120.927825,57.219281,1,2
0,0,2,2,6,4,10,7,5,12,0.000333,0.013288,3,119.589411,6.643856,39.863137,23.509775,1,2
0,0,6,6,14,11,25,54,31,85,0.000333,0.131576,14,5526.188866,307.010493,394.727776,91.356717,2,2
0,0,18,18,18,23,41,128,66,194,0.000333,0.346455,18,18708.5716,1039.365089,1039.365089,179.100575,7,2
0,0,6,6,15,11,26,56,26,82,0.000333,0.128479,14,5396.104796,299.7836,385.436057,96.657107,4,2
0,0,30,30,25,40,65,202,113,315,0.000333,0.632349,24,45529.10067,2529.394481,1897.045861,328.973529,19,2
0,0,19,19,16,32,48,120,67,187,0.000333,0.348129,16,16710.2078,928.344878,1044.387988,224,4,2
0,0,5,5,8,9,17,22,17,39,0.000333,0.053137,4,637.644203,35.424678,159.411051,52.529325,1,2
0,0,6,6,10,15,25,44,23,67,0.000333,0.103713,5,1555.691824,86.427324,311.138365,91.82264,3,2
0,0,5,5,10,11,21,22,17,39,0.000333,0.0571,5,856.501897,47.583439,171.300379,71.273029,1,2
0,0,6,6,13,10,23,49,27,76,0.000333,0.114597,12,4125.488504,229.193806,343.790709,81.324997,2,2
0,0,5,5,14,9,23,39,20,59,0.000333,0.088963,14,3736.462176,207.581232,266.890155,81.832294,4,2
0,0,9,9,18,18,36,72,36,108,0.000333,0.186117,18,10050.3342,558.3519,558.3519,150.1173,4,2
0,0,6,6,14,11,25,54,31,85,0.000333,0.131576,14,5526.188866,307.010493,394.727776,91.356717,2,2
0,0,19,19,15,29,44,116,61,177,0.000333,0.322106,14,13528.47155,751.581753,966.319396,199.484808,7,2
0,0,12,12,11,20,31,78,51,129,0.000333,0.21303,10,6390.91324,355.050736,639.091324,124.49231,1,2
0,0,8,8,13,18,31,62,31,93,0.000333,0.15358,6,2764.441541,153.580086,460.740257,123.164366,3,2
0,0,10,10,16,25,41,71,46,117,0.000333,0.208945,8,5014.668676,278.592704,626.833585,180.096405,5,2
0,0,6,6,14,11,25,54,31,85,0.000333,0.131576,14,5526.188866,307.010493,394.727776,91.356717,2,2
0,0,10,10,13,15,28,68,42,110,0.000333,0.17627,12,6345.708497,352.539361,528.809041,106.709075,2,2
0,0,6,6,16,12,28,47,24,71,0.000333,0.113774,16,5461.155191,303.397511,341.322199,107.01955,4,2
0,0,18,18,18,26,44,145,69,214,0.000333,0.389439,18,21029.7306,1168.318366,1168.318366,197.270083,5,2
0,0,23,23,19,36,55,159,78,237,0.000333,0.456727,18,24663.28054,1370.182252,1370.182252,266.827923,11,2
0,0,6,6,13,11,24,51,27,78,0.000333,0.119209,12,4291.524901,238.41805,357.627075,86.159464,2,2
0,0,13,13,14,20,34,67,37,104,0.000333,0.176365,7,3703.672948,205.759608,529.096135,139.741531,7,2
0,0,6,6,15,11,26,56,26,82,0.000333,0.128479,14,5396.104796,299.7836,385.436057,96.657107,4,2
0,0,7,7,10,17,27,52,29,81,0.000333,0.128382,5,1925.729438,106.984969,385.145888,102.706149,3,2
0,0,2,2,6,3,9,10,4,14,0.000333,0.014793,3,133.13685,7.396492,44.37895,20.264663,2,2
0,0,5,5,11,10,21,41,20,61,0.000333,0.08931,10,2679.313628,148.850757,267.931363,71.273029,1,2
0,0,5,5,14,9,23,46,23,69,0.000333,0.104042,14,4369.76085,242.764492,312.125775,81.832294,2,2
0,0,2,2,6,7,13,9,8,17,0.000333,0.020969,3,188.722426,10.484579,62.907475,35.161259,2,2
0,0,10,10,10,14,24,38,33,71,0.000333,0.108511,10,3255.323376,180.851299,325.532338,86.52225,7,2
0,0,17,17,17,26,43,81,49,130,0.000333,0.235138,8,5643.315345,313.517519,705.414418,191.698301,9,2
0,0,4,4,11,13,24,36,21,57,0.000333,0.087114,5,1306.714313,72.59524,261.342863,86.159464,1,2
0,0,23,23,17,36,53,133,73,206,0.000333,0.393317,16,18879.22582,1048.845879,1179.951614,255.604168,7,2
0,0,5,5,12,14,26,43,25,68,0.000333,0.106543,6,1917.779405,106.5433,319.629901,96.322519,1,2
0,0,6,6,13,10,23,49,27,76,0.000333,0.114597,12,4125.488504,229.193806,343.790709,81.324997,2,2
0,0,7,7,10,16,26,53,32,85,0.000333,0.133179,10,3995.37376,221.965209,399.537376,97.219281,1,2
0,0,8,8,15,13,28,42,26,68,0.000333,0.108967,14,4576.601886,254.25566,326.900135,106.709075,3,2
0,0,5,5,8,11,19,26,19,45,0.000333,0.063719,4,764.626952,42.479275,191.156738,62.053748,1,2
0,0,5,5,9,7,16,20,11,31,0.000333,0.041333,4,496,27.555556,124,48.180809,3,2
0,0,19,19,14,31,45,137,80,217,0.000333,0.397244,14,16684.24971,926.902761,1191.732122,206.883055,1,2
0,0,26,26,14,36,50,166,102,268,0.000333,0.504184,14,21175.74842,1176.430468,1512.553459,239.420269,1,2
0,0,11,11,16,18,34,62,42,104,0.000333,0.176365,16,8465.538168,470.307676,529.096135,139.05865,1,2
0,0,3,3,8,7,15,13,10,23,0.000333,0.029953,4,359.433935,19.968552,89.858484,43.651484,1,2
0,0,18,18,21,25,46,131,73,204,0.000333,0.375602,20,22536.13278,1252.007377,1126.806639,208.335071,8,2
0,0,6,6,14,11,25,54,31,85,0.000333,0.131576,14,5526.188866,307.010493,394.727776,91.356717,2,2
0,0,23,23,17,33,50,148,92,240,0.000333,0.451508,16,21672.40777,1204.022654,1354.525486,235.951874,2,2
0,0,6,6,14,11,25,54,31,85,0.000333,0.131576,14,5526.188866,307.010493,394.727776,91.356717,2,2
0,0,13,13,16,26,42,71,47,118,0.000333,0.212098,8,5090.347647,282.797092,636.293456,186.211433,1,2
0,0,3,3,8,7,15,12,9,21,0.000333,0.027348,4,328.17881,18.232156,82.044703,43.651484,1,2
0,0,18,18,15,26,41,116,65,181,0.000333,0.323239,14,13576.03678,754.224266,969.716913,180.814792,2,2
0,0,6,6,13,11,24,51,27,78,0.000333,0.119209,12,4291.524901,238.41805,357.627075,86.159464,2,2
0,0,3,3,9,10,19,17,14,31,0.000333,0.043895,4,526.743012,29.263501,131.685753,61.748606,1,2
0,0,3,3,10,10,20,19,15,34,0.000333,0.048982,5,734.727776,40.81821,146.945555,66.438562,1,2
0,0,5,5,11,12,23,25,24,49,0.000333,0.073885,10,2216.545358,123.141409,221.654536,81.073298,1,2
0,0,5,5,9,13,22,42,23,65,0.000333,0.096621,4,1159.452221,64.414012,289.863055,76.635041,6,2
0,0,4,4,10,14,24,45,23,68,0.000333,0.103926,5,1558.88725,86.604847,311.77745,86.52225,1,2
0,0,15,15,10,23,33,80,53,133,0.000333,0.223635,10,6709.044179,372.724677,670.904418,137.261206,1,2
0,0,4,4,8,8,16,15,12,27,0.000333,0.036,4,432,24,108,48,1,2
0,0,22,22,24,32,56,147,86,233,0.000333,0.451038,24,32474.72872,1804.151596,1353.113697,270.0391,7,2
0,0,11,11,14,23,37,71,40,111,0.000333,0.19275,7,4047.745265,224.874737,578.249324,157.344894,1,2
0,0,8,8,9,17,26,50,30,80,0.000333,0.125345,4,1504.14071,83.563373,376.035177,98.016193,1,2
0,0,6,6,14,11,25,54,31,85,0.000333,0.131576,14,5526.188866,307.010493,394.727776,91.356717,2,2
0,0,5,5,9,12,21,21,19,40,0.000333,0.058564,4,702.770788,39.042822,175.692697,71.548875,1,2
0,0,5,5,9,13,22,32,19,51,0.000333,0.07581,4,909.72405,50.540225,227.431013,76.635041,1,2
0,0,6,6,14,11,25,54,31,85,0.000333,0.131576,14,5526.188866,307.010493,394.727776,91.356717,2,2
0,0,7,7,11,16,27,41,30,71,0.000333,0.112532,5,1687.985063,93.776948,337.597013,102.053748,1,2
0,0,5,5,9,18,27,48,28,76,0.000333,0.120457,4,1445.485801,80.304767,361.37145,103.587975,1,2
0,0,6,6,14,11,25,54,31,85,0.000333,0.131576,14,5526.188866,307.010493,394.727776,91.356717,2,2
0,0,6,6,13,10,23,49,27,76,0.000333,0.114597,12,4125.488504,229.193806,343.790709,81.324997,2,2
0,0,6,6,13,10,23,49,27,76,0.000333,0.114597,12,4125.488504,229.193806,343.790709,81.324997,2,2
0,0,10,10,11,19,30,51,38,89,0.000333,0.145571,10,4367.13263,242.618479,436.713263,118.764371,1,2
0,0,6,6,14,11,25,54,31,85,0.000333,0.131576,14,5526.188866,307.010493,394.727776,91.356717,2,2
0,0,6,6,14,11,25,54,31,85,0.000333,0.131576,14,5526.188866,307.010493,394.727776,91.356717,2,2
0,0,4,4,10,12,22,28,17,45,0.000333,0.066891,5,1003.372114,55.742895,200.674423,76.238831,1,2
0,0,15,15,15,26,41,109,68,177,0.000333,0.316096,14,13276.01387,737.556326,948.286705,180.814792,12,2
0,0,6,6,13,10,23,49,27,76,0.000333,0.114597,12,4125.488504,229.193806,343.790709,81.324997,2,2
0,0,19,19,12,30,42,115,67,182,0.000333,0.327134,12,11776.82125,654.267847,981.401771,190.226268,1,2
0,0,4,4,8,8,16,15,12,27,0.000333,0.036,4,432,24,108,48,1,2
0,0,5,5,11,14,25,35,24,59,0.000333,0.091329,5,1369.937576,76.107643,273.987515,91.356717,13,2
0,0,6,6,13,11,24,51,27,78,0.000333,0.119209,12,4291.524901,238.41805,357.627075,86.159464,2,2
0,0,7,7,14,11,25,63,36,99,0.000333,0.153247,21,9654.577019,536.36539,459.741763,91.356717,2,2
0,0,17,17,13,20,33,129,62,191,0.000333,0.32116,18,17342.62698,963.479277,963.479277,134.544278,2,2
0,0,6,6,14,11,25,54,31,85,0.000333,0.131576,14,5526.188866,307.010493,394.727776,91.356717,2,2
0,0,12,12,12,19,31,62,52,114,0.000333,0.188259,12,6777.340553,376.51892,564.778379,123.730173,1,2
0,0,22,22,14,24,38,112,74,186,0.000333,0.325372,21,20498.40487,1138.80027,976.114518,163.342069,2,2
0,0,6,6,9,10,19,26,21,47,0.000333,0.066551,8,1597.220745,88.734486,199.652593,61.748606,1,2
0,0,6,6,13,10,23,49,27,76,0.000333,0.114597,12,4125.488504,229.193806,343.790709,81.324997,2,2
0,0,26,26,15,36,51,139,85,224,0.000333,0.423541,14,17788.72587,988.262548,1270.623277,244.720659,1,2
0,0,18,18,15,30,45,108,65,173,0.000333,0.316697,14,13301.2682,738.959344,950.090586,205.810077,1,2
0,0,4,4,8,9,17,17,12,29,0.000333,0.039512,4,474.14569,26.341427,118.536422,52.529325,1,2
0,0,6,6,9,13,22,22,20,42,0.000333,0.062432,4,749.184512,41.621362,187.296128,76.635041,1,2
0,0,6,6,9,10,19,26,21,47,0.000333,0.066551,8,1597.220745,88.734486,199.652593,61.748606,1,2
0,0,16,16,14,27,41,118,71,189,0.000333,0.337526,14,14176.0826,787.560145,1012.577329,181.684931,2,2
0,0,6,6,12,14,26,26,21,47,0.000333,0.07364,6,1325.524001,73.640222,220.920667,96.322519,1,2
0,0,4,4,10,13,23,189,22,211,0.000333,0.318157,5,4772.357864,265.130992,954.471573,81.324997,1,2
0,0,6,6,13,10,23,49,27,76,0.000333,0.114597,12,4125.488504,229.193806,343.790709,81.324997,2,2
0,0,9,9,10,17,27,61,40,101,0.000333,0.160081,10,4802.436377,266.802021,480.243638,102.706149,1,2
0,0,7,7,14,15,29,32,23,55,0.000333,0.089063,7,1870.322683,103.906816,267.188955,111.906328,1,2
0,0,6,6,13,10,23,49,27,76,0.000333,0.114597,12,4125.488504,229.193806,343.790709,81.324997,2,2
0,0,3,3,9,7,16,16,9,25,0.000333,0.033333,4,400,22.222222,100,48.180809,2,2
0,0,4,4,8,8,16,15,12,27,0.000333,0.036,4,432,24,108,48,1,2
0,0,23,23,16,26,42,132,83,215,0.000333,0.386449,24,27824.3579,1545.797661,1159.348246,186.211433,4,2
0,0,29,29,17,33,50,167,106,273,0.000333,0.513591,24,36978.54576,2054.363653,1540.77274,235.951874,3,2
0,0,8,8,12,12,24,29,24,53,0.000333,0.081001,12,2916.03615,162.002008,243.003013,86.0391,2,2
0,0,8,8,13,14,27,33,24,57,0.000333,0.090343,6,1626.171526,90.342863,271.028588,101.408685,2,2
0,0,7,7,11,13,24,27,22,49,0.000333,0.074888,5,1123.315813,62.406434,224.663163,86.159464,2,2
0,0,8,8,14,15,29,35,24,59,0.000333,0.09554,7,2006.346151,111.463675,286.620879,111.906328,2,2
0,0,7,7,12,14,26,29,22,51,0.000333,0.079907,6,1438.334554,79.907475,239.722426,96.322519,2,2
0,0,6,6,9,13,22,23,20,43,0.000333,0.063919,4,767.022238,42.612347,191.75556,76.635041,1,2
0,0,6,6,12,12,24,24,19,43,0.000333,0.065718,6,1182.920325,65.717796,197.153388,86.0391,2,2
0,0,6,6,9,13,22,23,20,43,0.000333,0.063919,4,767.022238,42.612347,191.75556,76.635041,1,2
0,0,14,14,16,20,36,52,45,97,0.000333,0.167161,16,8023.723602,445.762422,501.482725,150.438562,2,2
0,0,11,11,16,16,32,57,39,96,0.000333,0.16,16,7680,426.666667,480,128,3,2
0,0,12,12,17,15,32,60,41,101,0.000333,0.168333,16,8080,448.888889,505,128.090227,3,2
0,0,12,12,16,17,33,64,43,107,0.000333,0.179917,16,8636.002732,479.77793,539.750171,133.486868,3,2
0,0,13,13,16,20,36,57,47,104,0.000333,0.179224,16,8602.755202,477.930845,537.6722,150.438562,3,2
0,0,11,11,15,19,34,56,45,101,0.000333,0.171278,14,7193.672458,399.64847,513.833747,139.313982,3,2
0,0,13,13,15,20,35,61,57,118,0.000333,0.201752,14,8473.575544,470.754197,605.255396,145.041921,3,2
0,0,15,15,15,21,36,66,69,135,0.000333,0.232647,21,14656.73738,814.263188,697.939875,150.842025,3,2
0,0,17,17,15,22,37,71,81,152,0.000333,0.263946,21,16628.57514,923.80973,791.836912,156.710855,3,2
0,0,12,12,16,18,34,59,47,106,0.000333,0.179757,16,8628.336979,479.352054,539.271061,139.05865,3,2
0,0,12,12,16,20,36,61,48,109,0.000333,0.187841,16,9016.349203,500.908289,563.521825,150.438562,3,2
0,0,13,13,16,21,37,69,52,121,0.000333,0.210115,16,10085.50172,560.305651,630.343857,156.238666,3,2
0,0,12,12,15,20,35,63,49,112,0.000333,0.191493,14,8042.715771,446.817543,574.479698,145.041921,3,2
0,0,15,15,15,22,37,70,57,127,0.000333,0.220534,14,9262.408084,514.578227,661.600577,156.710855,3,2
0,0,18,18,19,23,42,69,72,141,0.000333,0.253439,27,20528.55243,1140.475135,760.316757,184.752548,3,2
0,0,13,13,15,20,35,56,53,109,0.000333,0.186364,14,7827.285884,434.849216,559.091849,145.041921,3,2
0,0,9,9,16,15,31,51,32,83,0.000333,0.137066,16,6579.1727,365.509594,411.198294,122.603359,4,2
0,0,11,11,16,15,31,57,34,91,0.000333,0.150277,16,7213.309828,400.739435,450.831864,122.603359,6,2
0,0,11,11,16,16,32,57,36,93,0.000333,0.155,16,7440,413.333333,465,128,6,2
0,0,13,13,18,17,35,65,40,105,0.000333,0.179525,18,9694.344902,538.574717,538.574717,144.545518,6,2
0,0,13,13,17,17,34,63,40,103,0.000333,0.17467,16,8384.138762,465.785487,524.008673,138.973737,6,2
0,0,12,12,18,17,35,61,39,100,0.000333,0.170976,18,9232.709431,512.928302,512.928302,144.545518,6,2
0,0,12,12,17,17,34,60,39,99,0.000333,0.167886,16,8058.541141,447.69673,503.658821,138.973737,6,2
0,0,16,16,19,17,36,64,40,104,0.000333,0.179224,18,9678.099603,537.6722,537.6722,150.197491,6,2
0,0,13,13,17,17,34,63,40,103,0.000333,0.17467,16,8384.138762,465.785487,524.008673,138.973737,6,2
0,0,13,13,16,17,33,61,40,101,0.000333,0.169828,16,8151.740897,452.874494,509.483806,133.486868,6,2
0,0,15,15,18,17,35,65,42,107,0.000333,0.182944,18,9878.999091,548.833283,548.833283,144.545518,7,2
0,0,12,12,18,17,35,64,41,105,0.000333,0.179525,18,9694.344902,538.574717,538.574717,144.545518,7,2
0,0,12,12,17,17,34,63,41,104,0.000333,0.176365,16,8465.538168,470.307676,529.096135,138.973737,7,2
0,0,16,16,22,17,39,71,38,109,0.000333,0.192036,22,12674.39452,704.133029,576.108842,167.594364,7,2
0,0,12,12,19,15,34,63,36,99,0.000333,0.167886,18,9065.858783,503.658821,503.658821,139.313982,7,2
0,0,11,11,17,16,33,71,44,115,0.000333,0.193368,16,9281.68518,515.649177,580.105324,133.486868,7,2
0,0,13,13,19,17,36,61,38,99,0.000333,0.170608,18,9212.806353,511.822575,511.822575,150.197491,5,2
0,0,13,13,18,18,36,66,43,109,0.000333,0.187841,18,10143.39285,563.521825,563.521825,150.1173,6,2
0,0,13,13,18,21,39,66,55,121,0.000333,0.213178,18,11511.60603,639.533668,639.533668,167.297316,6,2
0,0,11,11,17,16,33,59,40,99,0.000333,0.166465,16,7990.320285,443.906683,499.395018,133.486868,5,2
0,0,14,14,18,17,35,72,48,120,0.000333,0.205171,18,11079.25132,615.513962,615.513962,144.545518,5,2
0,0,16,16,21,22,43,68,54,122,0.000333,0.220668,20,13240.086,735.560333,662.0043,190.346161,5,2
0,0,11,11,18,17,35,61,40,101,0.000333,0.172686,18,9325.036525,518.057585,518.057585,144.545518,5,2
0,0,12,12,19,16,35,64,42,106,0.000333,0.181235,18,9786.671996,543.704,543.704,144.710623,5,2
0,0,12,12,18,18,36,68,44,112,0.000333,0.193011,18,10422.5688,579.0316,579.0316,150.1173,5,2
0,0,13,13,18,21,39,61,48,109,0.000333,0.192036,18,10369.95915,576.108842,576.108842,167.297316,5,2
0,0,11,11,17,20,37,60,46,106,0.000333,0.184067,16,8835.232908,490.846273,552.202057,155.92543,5,2
0,0,13,13,17,21,38,65,58,123,0.000333,0.215165,16,10327.92135,573.773408,645.495084,161.725534,5,2
0,0,15,15,17,22,39,70,70,140,0.000333,0.246652,24,17758.95146,986.608414,739.956311,167.594364,5,2
0,0,12,12,18,19,37,63,48,111,0.000333,0.19275,18,10408.48783,578.249324,578.249324,155.769273,5,2
0,0,12,12,18,21,39,65,49,114,0.000333,0.200845,18,10845.64535,602.535853,602.535853,167.297316,5,2
0,0,13,13,18,22,40,73,53,126,0.000333,0.223521,18,12070.13292,670.56294,670.56294,173.166146,5,2
0,0,12,12,17,21,38,67,50,117,0.000333,0.204669,16,9824.120305,545.784461,614.007519,161.725534,5,2
0,0,14,14,17,23,40,73,56,129,0.000333,0.228843,16,10984.45959,610.247755,686.528724,173.528793,5,2
0,0,16,16,20,24,44,67,64,131,0.000333,0.238395,20,14303.71084,794.650602,715.185542,196.477662,4,2
0,0,13,13,16,21,37,56,52,108,0.000333,0.18754,16,9001.935416,500.107523,562.620963,156.238666,4,2
0,0,12,12,20,23,43,63,51,114,0.000333,0.206198,20,12371.88364,687.326869,618.594182,190.480487,4,2
0,0,13,13,20,23,43,64,53,117,0.000333,0.211624,20,12697.45953,705.414418,634.872976,190.480487,4,2
0,0,8,8,15,14,29,51,33,84,0.000333,0.136023,14,5712.98565,317.388092,408.070404,111.906328,3,2
0,0,11,11,15,14,29,57,35,92,0.000333,0.148978,14,6257.079522,347.615529,446.934252,111.906328,5,2
0,0,11,11,15,15,30,57,37,94,0.000333,0.153749,14,6457.468024,358.748224,461.247716,117.206718,5,2
0,0,15,15,19,17,36,71,45,116,0.000333,0.199904,18,10794.8034,599.7113,599.7113,150.197491,7,2
0,0,15,15,18,17,35,69,45,114,0.000333,0.194913,18,10525.28875,584.738264,584.738264,144.545518,7,2
0,0,14,14,19,17,36,67,44,111,0.000333,0.191287,18,10329.51015,573.861675,573.861675,150.197491,7,2
0,0,14,14,18,17,35,66,44,110,0.000333,0.188074,18,10155.98037,564.221132,564.221132,144.545518,7,2
0,0,17,17,19,17,36,69,45,114,0.000333,0.196457,18,10608.6861,589.37145,589.37145,150.197491,7,2
0,0,15,15,18,17,35,69,45,114,0.000333,0.194913,18,10525.28875,584.738264,584.738264,144.545518,7,2
0,0,15,15,17,17,34,67,45,112,0.000333,0.189932,16,9116.733412,506.48519,569.795838,138.973737,7,2
0,0,18,18,19,17,36,68,45,113,0.000333,0.194734,18,10515.62745,584.201525,584.201525,150.197491,7,2
0,0,14,14,18,17,35,66,44,110,0.000333,0.188074,18,10155.98037,564.221132,564.221132,144.545518,7,2
0,0,14,14,17,17,34,65,44,109,0.000333,0.184844,16,8872.535195,492.918622,554.53345,138.973737,7,2
0,0,18,18,21,17,38,73,41,114,0.000333,0.199421,20,11965.27473,664.737485,598.263737,161.725534,7,2
0,0,15,15,18,15,33,67,39,106,0.000333,0.178235,18,9624.70398,534.705777,534.705777,133.662009,7,2
0,0,13,13,17,16,33,73,47,120,0.000333,0.201776,16,9685.236709,538.068706,605.327294,133.486868,7,2
0,0,15,15,19,17,36,63,41,104,0.000333,0.179224,18,9678.099603,537.6722,537.6722,150.197491,5,2
0,0,15,15,18,18,36,68,46,114,0.000333,0.196457,18,10608.6861,589.37145,589.37145,150.1173,6,2
0,0,15,15,17,21,38,67,58,125,0.000333,0.218664,16,10495.85503,583.103057,655.990939,161.725534,6,2
0,0,13,13,17,16,33,61,43,104,0.000333,0.174872,16,8393.871815,466.326212,524.616988,133.486868,5,2
0,0,16,16,18,17,35,74,51,125,0.000333,0.21372,27,17311.33018,961.740566,641.160377,144.545518,5,2
0,0,19,19,21,22,43,71,59,130,0.000333,0.235138,20,14108.28836,783.793798,705.414418,190.346161,5,2
0,0,14,14,18,17,35,64,45,109,0.000333,0.186364,18,10063.65328,559.091849,559.091849,144.545518,5,2
0,0,15,15,19,16,35,67,47,114,0.000333,0.194913,18,10525.28875,584.738264,584.738264,144.710623,5,2
0,0,15,15,18,18,36,71,49,120,0.000333,0.206797,18,11167.038,620.391,620.391,150.1173,5,2
0,0,16,16,18,21,39,64,53,117,0.000333,0.206131,18,11131.05707,618.39206,618.39206,167.297316,5,2
0,0,14,14,17,20,37,63,51,114,0.000333,0.197959,16,9502.042939,527.891274,593.877684,155.92543,5,2
0,0,16,16,17,21,38,68,63,131,0.000333,0.22916,24,16499.4841,916.638006,687.478504,161.725534,5,2
0,0,18,18,17,22,39,73,75,148,0.000333,0.260747,24,18773.74868,1042.986038,782.239528,167.594364,5,2
0,0,20,20,17,23,40,78,87,165,0.000333,0.292706,24,21074.83526,1170.824181,878.118136,173.528793,5,2
0,0,15,15,18,19,37,66,53,119,0.000333,0.206642,18,11158.64911,619.924951,619.924951,155.769273,5,2
0,0,15,15,18,21,39,68,54,122,0.000333,0.21494,18,11606.74327,644.819071,644.819071,167.297316,5,2
0,0,16,16,18,22,40,76,58,134,0.000333,0.237713,18,12836.49057,713.138365,713.138365,173.166146,5,2
0,0,15,15,17,21,38,70,55,125,0.000333,0.218664,16,10495.85503,583.103057,655.990939,161.725534,5,2
0,0,17,17,17,23,40,76,61,137,0.000333,0.243035,16,11665.66638,648.092577,729.104149,173.528793,5,2
0,0,20,20,21,24,45,75,76,151,0.000333,0.276423,30,24878.09453,1382.116363,829.269818,202.277766,5,2
0,0,16,16,17,21,38,63,59,122,0.000333,0.213416,16,10243.95451,569.108584,640.247157,161.725534,5,2
0,0,4,4,10,9,19,20,15,35,0.000333,0.049559,5,743.387315,41.299295,148.677463,61.748606,1,2
0,0,7,7,11,10,21,27,20,47,0.000333,0.068813,10,2064.389189,114.688288,206.438919,71.273029,2,2
0,0,7,7,11,11,22,27,21,48,0.000333,0.071351,5,1070.263588,59.459088,214.052718,76.107496,2,2
0,0,9,9,13,14,27,35,26,61,0.000333,0.096683,6,1740.288826,96.682713,290.048138,101.408685,2,2
0,0,9,9,12,14,26,33,26,59,0.000333,0.092442,6,1663.95566,92.441981,277.325943,96.322519,2,2
0,0,8,8,13,13,26,31,24,55,0.000333,0.086175,6,1551.145107,86.174728,258.524184,96.211433,2,2
0,0,8,8,12,13,25,30,24,54,0.000333,0.083589,6,1504.609405,83.589411,250.768234,91.125266,2,2
0,0,11,11,13,14,27,33,26,59,0.000333,0.093513,6,1683.230176,93.512788,280.538363,101.408685,2,2
0,0,9,9,12,14,26,33,26,59,0.000333,0.092442,6,1663.95566,92.441981,277.325943,96.322519,2,2
0,0,9,9,11,14,25,31,26,57,0.000333,0.088233,5,1323.499014,73.527723,264.699803,91.356717,2,2
0,0,11,11,12,14,26,31,26,57,0.000333,0.089308,6,1607.550384,89.308355,267.925064,96.322519,2,2
0,0,8,8,12,13,25,30,24,54,0.000333,0.083589,6,1504.609405,83.589411,250.768234,91.125266,2,2
0,0,8,8,11,13,24,29,24,53,0.000333,0.081001,5,1215.015063,67.500837,243.003013,86.159464,2,2
0,0,11,11,15,11,26,35,21,56,0.000333,0.087742,7,1842.57237,102.365132,263.224624,96.657107,2,2
0,0,8,8,12,10,22,29,20,49,0.000333,0.072837,12,2622.145792,145.674766,218.512149,76.238831,2,2
0,0,7,7,13,12,25,32,24,56,0.000333,0.086685,12,3120.67136,173.370631,260.055947,91.125266,2,2
0,0,8,8,12,10,22,27,21,48,0.000333,0.071351,12,2568.632612,142.701812,214.052718,76.238831,1,2
0,0,10,10,13,12,25,38,28,66,0.000333,0.102165,12,3677.934102,204.329672,306.494509,91.125266,2,2
0,0,11,11,12,15,27,39,42,81,0.000333,0.128382,12,4621.750652,256.763925,385.145888,101.622909,2,2
0,0,8,8,10,11,21,30,25,55,0.000333,0.080526,10,2415.774583,134.209699,241.577458,71.273029,1,2
0,0,11,11,11,12,23,45,33,78,0.000333,0.117613,10,3528.378326,196.021018,352.837833,81.073298,1,2
0,0,13,13,14,17,31,40,39,79,0.000333,0.130461,14,5479.341119,304.40784,391.381509,122.789837,1,2
0,0,8,8,10,15,25,30,31,61,0.000333,0.094425,10,2832.752276,157.375126,283.275228,91.82264,1,2
0,0,9,9,12,11,23,35,27,62,0.000333,0.093487,12,3365.530095,186.973894,280.460841,81.073298,1,2
0,0,9,9,11,13,24,39,29,68,0.000333,0.103926,10,3117.7745,173.209694,311.77745,86.159464,1,2
0,0,10,10,11,16,27,31,33,64,0.000333,0.101438,10,3043.128001,169.062667,304.3128,102.053748,1,2
0,0,7,7,10,15,25,28,29,57,0.000333,0.088233,5,1323.499014,73.527723,264.699803,91.82264,1,2
0,0,10,10,10,16,26,36,43,79,0.000333,0.123778,10,3713.347377,206.297077,371.334738,97.219281,1,2
0,0,12,12,10,17,27,42,55,97,0.000333,0.153741,15,6918.361316,384.353406,461.224088,102.706149,1,2
0,0,14,14,10,18,28,48,67,115,0.000333,0.184282,15,8292.687241,460.704847,552.845816,108.277931,1,2
0,0,9,9,11,14,25,34,33,67,0.000333,0.103713,10,3111.383647,172.854647,311.138365,91.356717,1,2
0,0,9,9,11,16,27,36,34,70,0.000333,0.110947,10,3328.421252,184.912292,332.842125,102.053748,1,2
0,0,10,10,11,17,28,45,38,83,0.000333,0.133003,10,3990.104585,221.672477,399.010459,107.540616,1,2
0,0,9,9,10,16,26,38,35,73,0.000333,0.114377,10,3431.320994,190.628944,343.132099,97.219281,1,2
0,0,11,11,10,18,28,45,41,86,0.000333,0.137811,10,4134.325233,229.684735,413.432523,108.277931,1,2
0,0,14,14,14,19,33,43,56,99,0.000333,0.166465,14,6991.530249,388.418347,499.395018,134.013592,1,2
0,0,10,10,10,16,26,30,39,69,0.000333,0.10811,10,3243.303406,180.183523,324.330341,97.219281,1,2
0,0,6,6,10,11,21,34,23,57,0.000333,0.083454,10,2503.620931,139.090052,250.362093,71.273029,1,2
0,0,7,7,11,11,22,37,24,61,0.000333,0.090675,10,2720.253287,151.125183,272.025329,76.107496,2,2
0,0,7,7,11,12,23,37,25,62,0.000333,0.093487,10,2804.608413,155.811578,280.460841,81.073298,2,2
0,0,9,9,13,15,28,45,30,75,0.000333,0.120184,12,4326.61943,240.367746,360.551619,106.709075,2,2
0,0,9,9,12,15,27,43,30,73,0.000333,0.115702,12,4165.281452,231.404525,347.106788,101.622909,2,2
0,0,8,8,13,14,27,41,28,69,0.000333,0.109362,12,3937.046852,218.724825,328.087238,101.408685,2,2
0,0,8,8,12,14,26,40,28,68,0.000333,0.106543,12,3835.55881,213.086601,319.629901,96.322519,2,2
0,0,11,11,13,15,28,43,30,73,0.000333,0.116979,12,4211.242912,233.95794,350.936909,106.709075,2,2
0,0,9,9,12,15,27,43,30,73,0.000333,0.115702,12,4165.281452,231.404525,347.106788,101.622909,2,2
0,0,9,9,11,15,26,41,30,71,0.000333,0.111244,10,3337.3122,185.406233,333.73122,96.657107,2,2
0,0,11,11,12,15,27,41,30,71,0.000333,0.112532,12,4051.164152,225.064675,337.597013,101.622909,2,2
0,0,8,8,12,14,26,40,28,68,0.000333,0.106543,12,3835.55881,213.086601,319.629901,96.322519,2,2
0,0,8,8,11,14,25,39,28,67,0.000333,0.103713,10,3111.383647,172.854647,311.138365,91.356717,2,2
0,0,11,11,15,12,27,45,25,70,0.000333,0.110947,14,4659.789752,258.877208,332.842125,101.622909,2,2
0,0,8,8,12,11,23,39,24,63,0.000333,0.094995,12,3419.812839,189.989602,284.984403,81.073298,2,2
0,0,7,7,13,13,26,42,28,70,0.000333,0.109677,12,3948.369363,219.353854,329.03078,96.211433,2,2
0,0,8,8,12,11,23,37,25,62,0.000333,0.093487,12,3365.530095,186.973894,280.460841,81.073298,1,2
0,0,11,11,13,13,26,50,34,84,0.000333,0.131612,12,4738.043236,263.224624,394.836936,96.211433,2,2
0,0,11,11,12,16,28,49,46,95,0.000333,0.152233,12,5480.384611,304.465812,456.698718,107.01955,2,2
0,0,8,8,10,12,22,40,29,69,0.000333,0.102567,10,3077.007817,170.944879,307.700782,76.238831,1,2
0,0,11,11,11,13,24,55,37,92,0.000333,0.140606,10,4218.165501,234.342528,421.81655,86.159464,1,2
0,0,13,13,14,18,32,50,43,93,0.000333,0.155,14,6510,361.666667,465,128.361619,1,2
0,0,8,8,10,16,26,40,35,75,0.000333,0.117511,10,3525.329789,195.851655,352.532979,97.219281,1,2
0,0,9,9,12,12,24,45,31,76,0.000333,0.116152,12,4181.485801,232.304767,348.45715,86.0391,1,2
0,0,9,9,11,14,25,49,33,82,0.000333,0.126932,10,3807.962076,211.553449,380.796208,91.356717,1,2
0,0,10,10,11,17,28,41,37,78,0.000333,0.124991,10,3749.736839,208.318713,374.973684,107.540616,1,2
0,0,8,8,10,16,26,40,35,75,0.000333,0.117511,10,3525.329789,195.851655,352.532979,97.219281,1,2
0,0,10,10,10,17,27,46,47,93,0.000333,0.147402,10,4422.045377,245.669188,442.204538,102.706149,1,2
0,0,12,12,10,18,28,52,59,111,0.000333,0.177872,15,8004.245945,444.68033,533.616396,108.277931,1,2
0,0,14,14,10,19,29,58,71,129,0.000333,0.208893,15,9400.193226,522.232957,626.679548,113.929904,1,2
0,0,9,9,11,15,26,44,37,81,0.000333,0.126912,10,3807.356172,211.519787,380.735617,96.657107,1,2
0,0,9,9,11,17,28,46,38,84,0.000333,0.134606,10,4038.178135,224.34323,403.817813,107.540616,1,2
0,0,10,10,11,18,29,55,42,97,0.000333,0.157075,10,4712.241565,261.791198,471.224157,113.112398,1,2
0,0,9,9,10,17,27,48,39,87,0.000333,0.137892,10,4136.752127,229.819563,413.675213,102.706149,1,2
0,0,11,11,10,19,29,55,45,100,0.000333,0.161933,10,4857.980995,269.887833,485.7981,113.929904,1,2
0,0,14,14,14,20,34,53,60,113,0.000333,0.191628,21,12072.54932,670.697185,574.883301,139.741531,1,2
0,0,10,10,10,17,27,40,43,83,0.000333,0.131552,10,3946.556627,219.253146,394.655663,102.706149,1,2
0,0,6,6,10,11,21,34,23,57,0.000333,0.083454,10,2503.620931,139.090052,250.362093,71.273029,1,2
0,0,7,7,11,11,22,37,24,61,0.000333,0.090675,10,2720.253287,151.125183,272.025329,76.107496,2,2
0,0,7,7,11,12,23,37,25,62,0.000333,0.093487,10,2804.608413,155.811578,280.460841,81.073298,2,2
0,0,9,9,13,15,28,45,30,75,0.000333,0.120184,12,4326.61943,240.367746,360.551619,106.709075,2,2
0,0,9,9,12,15,27,43,30,73,0.000333,0.115702,12,4165.281452,231.404525,347.106788,101.622909,2,2
0,0,8,8,13,14,27,41,28,69,0.000333,0.109362,12,3937.046852,218.724825,328.087238,101.408685,2,2
0,0,8,8,12,14,26,40,28,68,0.000333,0.106543,12,3835.55881,213.086601,319.629901,96.322519,2,2
0,0,11,11,13,15,28,43,30,73,0.000333,0.116979,12,4211.242912,233.95794,350.936909,106.709075,2,2
0,0,9,9,12,15,27,43,30,73,0.000333,0.115702,12,4165.281452,231.404525,347.106788,101.622909,2,2
0,0,9,9,11,15,26,41,30,71,0.000333,0.111244,10,3337.3122,185.406233,333.73122,96.657107,2,2
0,0,11,11,12,15,27,41,30,71,0.000333,0.112532,12,4051.164152,225.064675,337.597013,101.622909,2,2
0,0,8,8,12,14,26,40,28,68,0.000333,0.106543,12,3835.55881,213.086601,319.629901,96.322519,2,2
0,0,8,8,11,14,25,39,28,67,0.000333,0.103713,10,3111.383647,172.854647,311.138365,91.356717,2,2
0,0,11,11,15,12,27,45,25,70,0.000333,0.110947,14,4659.789752,258.877208,332.842125,101.622909,2,2
0,0,8,8,12,11,23,39,24,63,0.000333,0.094995,12,3419.812839,189.989602,284.984403,81.073298,2,2
0,0,7,7,13,13,26,42,28,70,0.000333,0.109677,12,3948.369363,219.353854,329.03078,96.211433,2,2
0,0,8,8,12,11,23,37,25,62,0.000333,0.093487,12,3365.530095,186.973894,280.460841,81.073298,1,2
0,0,11,11,13,13,26,50,34,84,0.000333,0.131612,12,4738.043236,263.224624,394.836936,96.211433,2,2
0,0,11,11,12,16,28,49,46,95,0.000333,0.152233,12,5480.384611,304.465812,456.698718,107.01955,2,2
0,0,8,8,10,12,22,40,29,69,0.000333,0.102567,10,3077.007817,170.944879,307.700782,76.238831,1,2
0,0,11,11,11,13,24,55,37,92,0.000333,0.140606,10,4218.165501,234.342528,421.81655,86.159464,1,2
0,0,13,13,14,18,32,50,43,93,0.000333,0.155,14,6510,361.666667,465,128.361619,1,2
0,0,8,8,10,16,26,40,35,75,0.000333,0.117511,10,3525.329789,195.851655,352.532979,97.219281,1,2
0,0,9,9,12,12,24,45,31,76,0.000333,0.116152,12,4181.485801,232.304767,348.45715,86.0391,1,2
0,0,9,9,11,14,25,49,33,82,0.000333,0.126932,10,3807.962076,211.553449,380.796208,91.356717,1,2
0,0,10,10,11,17,28,41,37,78,0.000333,0.124991,10,3749.736839,208.318713,374.973684,107.540616,1,2
0,0,8,8,10,16,26,40,35,75,0.000333,0.117511,10,3525.329789,195.851655,352.532979,97.219281,1,2
0,0,10,10,10,17,27,46,47,93,0.000333,0.147402,10,4422.045377,245.669188,442.204538,102.706149,1,2
0,0,12,12,10,18,28,52,59,111,0.000333,0.177872,15,8004.245945,444.68033,533.616396,108.277931,1,2
0,0,14,14,10,19,29,58,71,129,0.000333,0.208893,15,9400.193226,522.232957,626.679548,113.929904,1,2
0,0,9,9,11,15,26,44,37,81,0.000333,0.126912,10,3807.356172,211.519787,380.735617,96.657107,1,2
0,0,9,9,11,17,28,46,38,84,0.000333,0.134606,10,4038.178135,224.34323,403.817813,107.540616,1,2
0,0,10,10,11,18,29,55,42,97,0.000333,0.157075,10,4712.241565,261.791198,471.224157,113.112398,1,2
0,0,9,9,10,17,27,48,39,87,0.000333,0.137892,10,4136.752127,229.819563,413.675213,102.706149,1,2
0,0,11,11,10,19,29,55,45,100,0.000333,0.161933,10,4857.980995,269.887833,485.7981,113.929904,1,2
0,0,14,14,14,20,34,53,60,113,0.000333,0.191628,21,12072.54932,670.697185,574.883301,139.741531,1,2
0,0,10,10,10,17,27,40,43,83,0.000333,0.131552,10,3946.556627,219.253146,394.655663,102.706149,1,2
0,0,6,6,10,11,21,28,22,50,0.000333,0.073205,10,2196.158711,122.008817,219.615871,71.273029,1,2
0,0,7,7,11,11,22,31,23,54,0.000333,0.08027,10,2408.093074,133.782949,240.809307,76.107496,2,2
0,0,7,7,11,12,23,31,24,55,0.000333,0.082932,10,2487.959076,138.219949,248.795908,81.073298,2,2
0,0,9,9,13,15,28,39,29,68,0.000333,0.108967,6,1961.400808,108.966712,326.900135,106.709075,2,2
0,0,9,9,12,15,27,37,29,66,0.000333,0.104608,6,1882.935451,104.607525,313.822575,101.622909,2,2
0,0,8,8,13,14,27,35,27,62,0.000333,0.098268,6,1768.818151,98.267675,294.803025,101.408685,2,2
0,0,8,8,12,14,26,34,27,61,0.000333,0.095576,6,1720.360937,95.575608,286.726823,96.322519,2,2
0,0,11,11,13,15,28,37,29,66,0.000333,0.105762,6,1903.712549,105.761808,317.285425,106.709075,2,2
0,0,9,9,12,15,27,37,29,66,0.000333,0.104608,6,1882.935451,104.607525,313.822575,101.622909,2,2
0,0,9,9,11,15,26,35,29,64,0.000333,0.100276,5,1504.14071,83.563373,300.828142,96.657107,2,2
0,0,11,11,12,15,27,35,29,64,0.000333,0.101438,6,1825.876801,101.4376,304.3128,101.622909,2,2
0,0,8,8,12,14,26,34,27,61,0.000333,0.095576,6,1720.360937,95.575608,286.726823,96.322519,2,2
0,0,8,8,11,14,25,33,27,60,0.000333,0.092877,5,1393.156857,77.397603,278.631371,91.356717,2,2
0,0,11,11,15,12,27,39,24,63,0.000333,0.099853,14,4193.810777,232.989488,299.557913,101.622909,2,2
0,0,8,8,12,11,23,33,23,56,0.000333,0.08444,12,3039.833634,168.879646,253.31947,81.073298,2,2
0,0,7,7,13,13,26,36,27,63,0.000333,0.098709,12,3553.532427,197.418468,296.127702,96.211433,2,2
0,0,8,8,12,11,23,31,24,55,0.000333,0.082932,12,2985.550891,165.863938,248.795908,81.073298,1,2
0,0,11,11,13,13,26,44,33,77,0.000333,0.120645,12,4343.2063,241.289239,361.933858,96.211433,2,2
0,0,11,11,12,16,28,43,45,88,0.000333,0.141016,12,5076.566798,282.031489,423.047233,107.01955,2,2
0,0,8,8,10,12,22,34,28,62,0.000333,0.092162,10,2764.847604,153.602645,276.48476,76.238831,1,2
0,0,11,11,11,13,24,49,36,85,0.000333,0.129907,10,3897.218126,216.512118,389.721813,86.159464,1,2
0,0,13,13,14,18,32,44,42,86,0.000333,0.143333,14,6020,334.444444,430,128.361619,1,2
0,0,8,8,10,16,26,34,34,68,0.000333,0.106543,10,3196.299008,177.572167,319.629901,97.219281,1,2
0,0,9,9,12,12,24,39,30,69,0.000333,0.105454,12,3796.348951,210.908275,316.362413,86.0391,1,2
0,0,9,9,11,14,25,43,32,75,0.000333,0.116096,10,3482.892142,193.494008,348.289214,91.356717,1,2
0,0,10,10,11,17,28,35,36,71,0.000333,0.113774,10,3413.221995,189.623444,341.322199,107.540616,1,2
0,0,8,8,10,16,26,34,34,68,0.000333,0.106543,10,3196.299008,177.572167,319.629901,97.219281,1,2
0,0,10,10,10,17,27,40,46,86,0.000333,0.136307,10,4089.203252,227.177958,408.920325,102.706149,1,2
0,0,12,12,10,18,28,46,58,104,0.000333,0.166655,15,7499.473678,416.637427,499.964912,108.277931,1,2
0,0,14,14,10,19,29,52,70,122,0.000333,0.197558,15,8890.105221,493.894735,592.673681,113.929904,1,2
0,0,9,9,11,15,26,38,36,74,0.000333,0.115944,10,3478.325391,193.2403,347.832539,96.657107,1,2
0,0,9,9,11,17,28,40,37,77,0.000333,0.123389,10,3701.66329,205.647961,370.166329,107.540616,1,2
0,0,10,10,11,18,29,49,41,90,0.000333,0.145739,10,4372.182896,242.89905,437.21829,113.112398,1,2
0,0,9,9,10,17,27,42,38,80,0.000333,0.126797,10,3803.910002,211.328333,380.391,102.706149,1,2
0,0,11,11,10,19,29,49,44,93,0.000333,0.150597,10,4517.922325,250.995685,451.792233,113.929904,1,2
0,0,14,14,14,20,34,47,59,106,0.000333,0.179757,14,7549.794856,419.433048,539.271061,139.741531,1,2
0,0,10,10,10,17,27,34,42,76,0.000333,0.120457,10,3613.714502,200.761917,361.37145,102.706149,1,2
0,0,9,9,14,19,33,41,42,83,0.000333,0.139562,14,5861.585967,325.643665,418.684712,134.013592,1,2
0,0,10,10,14,19,33,42,43,85,0.000333,0.142925,14,6002.829002,333.4905,428.7735,134.013592,1,2
0,0,6,6,10,10,20,24,19,43,0.000333,0.061948,5,929.21454,51.62303,185.842908,66.438562,1,2
0,0,7,7,11,10,21,27,20,47,0.000333,0.068813,10,2064.389189,114.688288,206.438919,71.273029,2,2
0,0,7,7,11,11,22,27,21,48,0.000333,0.071351,5,1070.263588,59.459088,214.052718,76.107496,2,2
0,0,9,9,13,14,27,35,26,61,0.000333,0.096683,6,1740.288826,96.682713,290.048138,101.408685,2,2
0,0,9,9,12,14,26,33,26,59,0.000333,0.092442,6,1663.95566,92.441981,277.325943,96.322519,2,2
0,0,8,8,13,13,26,31,24,55,0.000333,0.086175,6,1551.145107,86.174728,258.524184,96.211433,2,2
0,0,8,8,12,13,25,30,24,54,0.000333,0.083589,6,1504.609405,83.589411,250.768234,91.125266,2,2
0,0,11,11,13,14,27,33,26,59,0.000333,0.093513,6,1683.230176,93.512788,280.538363,101.408685,2,2
0,0,8,8,12,14,26,30,23,53,0.000333,0.083041,6,1494.73983,83.041102,249.123305,96.322519,2,2
0,0,9,9,11,14,25,31,26,57,0.000333,0.088233,5,1323.499014,73.527723,264.699803,91.356717,2,2
0,0,11,11,12,14,26,31,26,57,0.000333,0.089308,6,1607.550384,89.308355,267.925064,96.322519,2,2
0,0,8,8,12,13,25,30,24,54,0.000333,0.083589,6,1504.609405,83.589411,250.768234,91.125266,2,2
0,0,8,8,11,13,24,29,24,53,0.000333,0.081001,5,1215.015063,67.500837,243.003013,86.159464,2,2
0,0,11,11,15,11,26,35,21,56,0.000333,0.087742,7,1842.57237,102.365132,263.224624,96.657107,2,2
0,0,8,8,12,10,22,29,20,49,0.000333,0.072837,12,2622.145792,145.674766,218.512149,76.238831,2,2
0,0,7,7,13,12,25,32,24,56,0.000333,0.086685,12,3120.67136,173.370631,260.055947,91.125266,2,2
0,0,8,8,12,10,22,27,21,48,0.000333,0.071351,12,2568.632612,142.701812,214.052718,76.238831,1,2
0,0,11,11,13,12,25,40,30,70,0.000333,0.108357,12,3900.839199,216.713289,325.069933,91.125266,2,2
0,0,11,11,12,15,27,39,42,81,0.000333,0.128382,12,4621.750652,256.763925,385.145888,101.622909,2,2
0,0,8,8,10,11,21,30,25,55,0.000333,0.080526,10,2415.774583,134.209699,241.577458,71.273029,1,2
0,0,11,11,11,12,23,45,33,78,0.000333,0.117613,10,3528.378326,196.021018,352.837833,81.073298,1,2
0,0,13,13,14,17,31,40,39,79,0.000333,0.130461,14,5479.341119,304.40784,391.381509,122.789837,1,2
0,0,8,8,10,15,25,30,31,61,0.000333,0.094425,10,2832.752276,157.375126,283.275228,91.82264,1,2
0,0,9,9,12,11,23,35,27,62,0.000333,0.093487,12,3365.530095,186.973894,280.460841,81.073298,1,2
0,0,9,9,11,13,24,39,29,68,0.000333,0.103926,10,3117.7745,173.209694,311.77745,86.159464,1,2
0,0,10,10,11,16,27,31,33,64,0.000333,0.101438,10,3043.128001,169.062667,304.3128,102.053748,1,2
0,0,8,8,10,15,25,30,31,61,0.000333,0.094425,10,2832.752276,157.375126,283.275228,91.82264,1,2
0,0,10,10,10,16,26,36,43,79,0.000333,0.123778,10,3713.347377,206.297077,371.334738,97.219281,1,2
0,0,12,12,10,17,27,42,55,97,0.000333,0.153741,15,6918.361316,384.353406,461.224088,102.706149,1,2
0,0,14,14,10,18,28,48,67,115,0.000333,0.184282,15,8292.687241,460.704847,552.845816,108.277931,1,2
0,0,9,9,11,14,25,34,33,67,0.000333,0.103713,10,3111.383647,172.854647,311.138365,91.356717,1,2
0,0,9,9,11,16,27,36,34,70,0.000333,0.110947,10,3328.421252,184.912292,332.842125,102.053748,1,2
0,0,10,10,11,17,28,45,38,83,0.000333,0.133003,10,3990.104585,221.672477,399.010459,107.540616,1,2
0,0,9,9,10,16,26,38,35,73,0.000333,0.114377,10,3431.320994,190.628944,343.132099,97.219281,1,2
0,0,11,11,10,18,28,45,41,86,0.000333,0.137811,10,4134.325233,229.684735,413.432523,108.277931,1,2
0,0,14,14,14,19,33,43,56,99,0.000333,0.166465,14,6991.530249,388.418347,499.395018,134.013592,1,2
0,0,10,10,10,16,26,30,39,69,0.000333,0.10811,10,3243.303406,180.183523,324.330341,97.219281,1,2
0,0,9,9,14,18,32,37,39,76,0.000333,0.126667,14,5320,295.555556,380,128.361619,1,2
0,0,10,10,14,18,32,38,40,78,0.000333,0.13,14,5460,303.333333,390,128.361619,1,2
0,0,6,6,10,11,21,28,22,50,0.000333,0.073205,10,2196.158711,122.008817,219.615871,71.273029,1,2
0,0,7,7,11,11,22,31,23,54,0.000333,0.08027,10,2408.093074,133.782949,240.809307,76.107496,2,2
0,0,7,7,11,12,23,31,24,55,0.000333,0.082932,10,2487.959076,138.219949,248.795908,81.073298,2,2
0,0,9,9,13,15,28,39,29,68,0.000333,0.108967,6,1961.400808,108.966712,326.900135,106.709075,2,2
0,0,9,9,12,15,27,37,29,66,0.000333,0.104608,6,1882.935451,104.607525,313.822575,101.622909,2,2
0,0,8,8,13,14,27,35,27,62,0.000333,0.098268,6,1768.818151,98.267675,294.803025,101.408685,2,2
0,0,8,8,12,14,26,34,27,61,0.000333,0.095576,6,1720.360937,95.575608,286.726823,96.322519,2,2
0,0,11,11,13,15,28,37,29,66,0.000333,0.105762,6,1903.712549,105.761808,317.285425,106.709075,2,2
0,0,9,9,12,15,27,37,29,66,0.000333,0.104608,6,1882.935451,104.607525,313.822575,101.622909,2,2
0,0,9,9,11,15,26,35,29,64,0.000333,0.100276,5,1504.14071,83.563373,300.828142,96.657107,2,2
0,0,11,11,12,15,27,35,29,64,0.000333,0.101438,6,1825.876801,101.4376,304.3128,101.622909,2,2
0,0,8,8,12,14,26,34,27,61,0.000333,0.095576,6,1720.360937,95.575608,286.726823,96.322519,2,2
0,0,8,8,11,14,25,33,27,60,0.000333,0.092877,5,1393.156857,77.397603,278.631371,91.356717,2,2
0,0,11,11,15,12,27,39,24,63,0.000333,0.099853,14,4193.810777,232.989488,299.557913,101.622909,2,2
0,0,8,8,12,11,23,33,23,56,0.000333,0.08444,12,3039.833634,168.879646,253.31947,81.073298,2,2
0,0,7,7,13,13,26,36,27,63,0.000333,0.098709,12,3553.532427,197.418468,296.127702,96.211433,2,2
0,0,8,8,12,11,23,31,24,55,0.000333,0.082932,12,2985.550891,165.863938,248.795908,81.073298,1,2
0,0,11,11,13,13,26,44,33,77,0.000333,0.120645,12,4343.2063,241.289239,361.933858,96.211433,2,2
0,0,11,11,12,16,28,43,45,88,0.000333,0.141016,12,5076.566798,282.031489,423.047233,107.01955,2,2
0,0,8,8,10,12,22,34,28,62,0.000333,0.092162,10,2764.847604,153.602645,276.48476,76.238831,1,2
0,0,11,11,11,13,24,49,36,85,0.000333,0.129907,10,3897.218126,216.512118,389.721813,86.159464,1,2
0,0,13,13,14,18,32,44,42,86,0.000333,0.143333,14,6020,334.444444,430,128.361619,1,2
0,0,8,8,10,16,26,34,34,68,0.000333,0.106543,10,3196.299008,177.572167,319.629901,97.219281,1,2
0,0,9,9,12,12,24,39,30,69,0.000333,0.105454,12,3796.348951,210.908275,316.362413,86.0391,1,2
0,0,9,9,11,14,25,43,32,75,0.000333,0.116096,10,3482.892142,193.494008,348.289214,91.356717,1,2
0,0,10,10,11,17,28,35,36,71,0.000333,0.113774,10,3413.221995,189.623444,341.322199,107.540616,1,2
0,0,8,8,10,16,26,34,34,68,0.000333,0.106543,10,3196.299008,177.572167,319.629901,97.219281,1,2
0,0,10,10,10,17,27,40,46,86,0.000333,0.136307,10,4089.203252,227.177958,408.920325,102.706149,1,2
0,0,12,12,10,18,28,46,58,104,0.000333,0.166655,15,7499.473678,416.637427,499.964912,108.277931,1,2
0,0,14,14,10,19,29,52,70,122,0.000333,0.197558,15,8890.105221,493.894735,592.673681,113.929904,1,2
0,0,6,6,9,14,23,21,23,44,0.000333,0.066346,4,796.146904,44.230384,199.036726,81.832294,1,2
0,0,9,9,11,17,28,40,37,77,0.000333,0.123389,10,3701.66329,205.647961,370.166329,107.540616,1,2
0,0,10,10,11,18,29,49,41,90,0.000333,0.145739,10,4372.182896,242.89905,437.21829,113.112398,1,2
0,0,9,9,10,17,27,42,38,80,0.000333,0.126797,10,3803.910002,211.328333,380.391,102.706149,1,2
0,0,11,11,10,19,29,49,44,93,0.000333,0.150597,10,4517.922325,250.995685,451.792233,113.929904,1,2
0,0,14,14,14,20,34,47,59,106,0.000333,0.179757,14,7549.794856,419.433048,539.271061,139.741531,1,2
0,0,10,10,10,17,27,34,42,76,0.000333,0.120457,10,3613.714502,200.761917,361.37145,102.706149,1,2
0,0,9,9,14,19,33,41,42,83,0.000333,0.139562,14,5861.585967,325.643665,418.684712,134.013592,1,2
0,0,10,10,14,19,33,42,43,85,0.000333,0.142925,14,6002.829002,333.4905,428.7735,134.013592,1,2
0,0,8,8,10,11,21,38,25,63,0.000333,0.092239,10,2767.159976,153.73111,276.715998,71.273029,1,2
0,0,9,9,11,11,22,41,26,67,0.000333,0.099594,10,2987.819184,165.989955,298.781918,76.107496,2,2
0,0,9,9,11,12,23,41,27,68,0.000333,0.102534,10,3076.02213,170.890118,307.602213,81.073298,2,2
0,0,11,11,13,14,27,49,32,81,0.000333,0.128382,12,4621.750652,256.763925,385.145888,101.408685,2,2
0,0,11,11,12,14,26,47,32,79,0.000333,0.123778,12,4456.016853,247.556492,371.334738,96.322519,2,2
0,0,10,10,13,14,27,45,30,75,0.000333,0.118872,12,4279.398752,237.744375,356.616563,101.408685,2,2
0,0,10,10,12,14,26,44,30,74,0.000333,0.115944,12,4173.99047,231.888359,347.832539,96.322519,2,2
0,0,13,13,13,14,27,47,32,79,0.000333,0.125212,12,4507.633352,250.424075,375.636113,101.408685,2,2
0,0,11,11,12,14,26,47,32,79,0.000333,0.123778,12,4456.016853,247.556492,371.334738,96.322519,2,2
0,0,11,11,11,14,25,45,32,77,0.000333,0.119192,10,3575.769266,198.653848,357.576927,91.356717,2,2
0,0,13,13,12,14,26,45,32,77,0.000333,0.120645,12,4343.2063,241.289239,361.933858,96.322519,2,2
0,0,10,10,12,14,26,44,30,74,0.000333,0.115944,12,4173.99047,231.888359,347.832539,96.322519,2,2
0,0,10,10,11,14,25,43,30,73,0.000333,0.113001,10,3390.015019,188.334168,339.001502,91.356717,2,2
0,0,13,13,15,12,27,49,27,76,0.000333,0.120457,14,5059.200302,281.066683,361.37145,101.622909,2,2
0,0,10,10,12,11,23,43,26,69,0.000333,0.104042,12,3745.5093,208.08385,312.125775,81.073298,2,2
0,0,9,9,13,12,25,46,30,76,0.000333,0.117644,12,4235.196845,235.288714,352.93307,91.125266,2,2
0,0,10,10,12,11,23,41,27,68,0.000333,0.102534,12,3691.226556,205.068142,307.602213,81.073298,1,2
0,0,13,13,13,13,26,54,36,90,0.000333,0.141013,12,5076.474896,282.026383,423.039575,96.211433,2,2
0,0,13,13,12,16,28,53,48,101,0.000333,0.161848,18,8739.771248,485.542847,485.542847,107.01955,2,2
0,0,10,10,10,12,22,44,31,75,0.000333,0.111486,10,3344.573714,185.809651,334.457371,76.238831,1,2
0,0,13,13,11,13,24,59,39,98,0.000333,0.149775,15,6739.894876,374.438604,449.326325,86.159464,1,2
0,0,15,15,14,18,32,54,45,99,0.000333,0.165,14,6930,385,495,128.361619,1,2
0,0,10,10,10,16,26,44,37,81,0.000333,0.126912,10,3807.356172,211.519787,380.735617,97.219281,1,2
0,0,11,11,12,12,24,49,33,82,0.000333,0.125322,12,4511.603101,250.644617,375.966925,86.0391,1,2
0,0,11,11,11,14,25,53,35,88,0.000333,0.13622,10,4086.593447,227.032969,408.659345,91.356717,1,2
0,0,12,12,11,17,28,45,39,84,0.000333,0.134606,10,4038.178135,224.34323,403.817813,107.540616,1,2
0,0,10,10,10,16,26,44,37,81,0.000333,0.126912,10,3807.356172,211.519787,380.735617,97.219281,1,2
0,0,12,12,10,17,27,50,49,99,0.000333,0.156911,10,4707.338627,261.518813,470.733863,102.706149,1,2
0,0,14,14,10,18,28,56,61,117,0.000333,0.187487,15,8436.907888,468.717105,562.460526,108.277931,1,2
0,0,16,16,10,19,29,62,73,135,0.000333,0.218609,15,9837.411515,546.522862,655.827434,113.929904,1,2
0,0,11,11,11,16,27,48,40,88,0.000333,0.139477,10,4184.301002,232.461167,418.4301,102.053748,1,2
0,0,11,11,11,17,28,50,40,90,0.000333,0.144221,10,4326.61943,240.367746,432.661943,107.540616,1,2
0,0,12,12,11,18,29,59,44,103,0.000333,0.166791,10,5003.720425,277.984468,500.372042,113.112398,1,2
0,0,11,11,10,17,27,52,41,93,0.000333,0.147402,10,4422.045377,245.669188,442.204538,102.706149,1,2
0,0,13,13,10,19,29,59,47,106,0.000333,0.171649,10,5149.459855,286.081103,514.945985,113.929904,1,2
0,0,16,16,14,20,34,57,62,119,0.000333,0.201803,21,12713.56964,706.309424,605.408078,139.741531,1,2
0,0,12,12,10,17,27,44,45,89,0.000333,0.141062,10,4231.849877,235.102771,423.184988,102.706149,1,2
0,0,11,11,14,19,33,51,45,96,0.000333,0.161421,14,6779.665696,376.648094,484.261835,134.013592,1,2
0,0,12,12,14,19,33,52,46,98,0.000333,0.164784,14,6920.908732,384.49493,494.350624,134.013592,1,2
0,0,8,8,10,11,21,39,26,65,0.000333,0.095167,10,2855.006325,158.611462,285.500632,71.273029,1,2
0,0,9,9,11,11,22,42,27,69,0.000333,0.102567,10,3077.007817,170.944879,307.700782,76.107496,2,2
0,0,9,9,11,12,23,42,28,70,0.000333,0.10555,10,3166.493369,175.916298,316.649337,81.073298,2,2
0,0,11,11,13,14,27,50,33,83,0.000333,0.131552,12,4735.867952,263.103775,394.655663,101.408685,2,2
0,0,11,11,12,14,26,48,33,81,0.000333,0.126912,12,4568.827406,253.823745,380.735617,96.322519,2,2
0,0,10,10,13,14,27,46,31,77,0.000333,0.122042,12,4393.516052,244.084225,366.126338,101.408685,2,2
0,0,10,10,12,14,26,45,31,76,0.000333,0.119078,12,4286.801023,238.155612,357.233419,96.322519,2,2
0,0,13,13,13,14,27,48,33,81,0.000333,0.128382,12,4621.750652,256.763925,385.145888,101.408685,2,2
0,0,11,11,12,14,26,48,33,81,0.000333,0.126912,12,4568.827406,253.823745,380.735617,96.322519,2,2
0,0,11,11,11,14,25,46,33,79,0.000333,0.122288,10,3668.64639,203.813688,366.864639,91.356717,2,2
0,0,9,9,11,12,23,42,27,69,0.000333,0.104042,10,3121.25775,173.403208,312.125775,81.073298,2,2
0,0,10,10,12,14,26,45,31,76,0.000333,0.119078,12,4286.801023,238.155612,357.233419,96.322519,2,2
0,0,10,10,11,14,25,44,31,75,0.000333,0.116096,10,3482.892142,193.494008,348.289214,91.356717,2,2
0,0,13,13,15,12,27,50,28,78,0.000333,0.123627,14,5192.337152,288.463175,370.881225,101.622909,2,2
0,0,10,10,12,11,23,44,27,71,0.000333,0.107058,12,3854.074787,214.115266,321.172899,81.073298,2,2
0,0,9,9,13,12,25,47,31,78,0.000333,0.12074,12,4346.649394,241.480522,362.220783,91.125266,2,2
0,0,10,10,12,11,23,42,28,70,0.000333,0.10555,12,3799.792043,211.099558,316.649337,81.073298,1,2
0,0,13,13,13,13,26,55,37,92,0.000333,0.144147,12,5189.285449,288.293636,432.440454,96.211433,2,2
0,0,13,13,12,16,28,54,49,103,0.000333,0.165053,18,8912.836025,495.157557,495.157557,107.01955,2,2
0,0,10,10,10,12,22,45,32,77,0.000333,0.114459,10,3433.762346,190.764575,343.376235,76.238831,1,2
0,0,13,13,11,13,24,60,40,100,0.000333,0.152832,15,6877.443751,382.080208,458.49625,86.159464,1,2
0,0,15,15,14,18,32,55,46,101,0.000333,0.168333,14,7070,392.777778,505,128.361619,1,2
0,0,11,11,10,16,26,50,41,91,0.000333,0.14258,10,4277.400144,237.633341,427.740014,97.219281,1,2
0,0,11,11,12,12,24,50,34,84,0.000333,0.128379,12,4621.642201,256.7579,385.13685,86.0391,1,2
0,0,12,12,11,14,25,59,39,98,0.000333,0.151699,10,4550.979066,252.83217,455.097907,91.356717,1,2
0,0,13,13,11,17,28,51,43,94,0.000333,0.15063,10,4518.913627,251.050757,451.891363,107.540616,1,2
0,0,11,11,10,16,26,50,41,91,0.000333,0.14258,10,4277.400144,237.633341,427.740014,97.219281,1,2
0,0,13,13,10,17,27,56,53,109,0.000333,0.172761,15,7774.241066,431.902281,518.282738,102.706149,1,2
0,0,15,15,10,18,28,62,65,127,0.000333,0.203511,15,9158.011127,508.778396,610.534075,108.277931,1,2
0,0,17,17,10,19,29,68,77,145,0.000333,0.234802,20,14088.14489,782.674716,704.407244,113.929904,1,2
0,0,11,11,11,15,26,49,40,89,0.000333,0.139446,10,4183.391349,232.410631,418.339135,96.657107,1,2
0,0,12,12,11,17,28,56,44,100,0.000333,0.160245,10,4807.354922,267.075273,480.735492,107.540616,1,2
0,0,13,13,11,18,29,65,48,113,0.000333,0.182984,10,5489.518524,304.973251,548.951852,113.112398,1,2
0,0,12,12,10,17,27,58,45,103,0.000333,0.163251,10,4897.534127,272.085229,489.753413,102.706149,1,2
0,0,14,14,10,19,29,65,51,116,0.000333,0.187842,10,5635.257954,313.069886,563.525795,113.929904,1,2
0,0,17,17,14,20,34,63,66,129,0.000333,0.218761,21,13781.93684,765.663158,656.282707,139.741531,1,2
0,0,13,13,10,17,27,50,49,99,0.000333,0.156911,10,4707.338627,261.518813,470.733863,102.706149,1,2
0,0,12,12,14,19,33,57,49,106,0.000333,0.178235,14,7485.880873,415.882271,534.705777,134.013592,1,2
0,0,13,13,14,19,33,58,50,108,0.000333,0.181598,14,7627.123908,423.729106,544.794565,134.013592,1,2
0,0,13,13,12,17,29,41,34,75,0.000333,0.12145,12,4372.182896,242.89905,364.348575,112.506418,3,2
0,0,14,14,13,17,30,44,35,79,0.000333,0.129215,12,4651.732285,258.429571,387.644357,117.592585,4,2
0,0,14,14,13,18,31,44,36,80,0.000333,0.132112,12,4756.028458,264.223803,396.335705,123.164366,4,2
0,0,16,16,15,20,35,52,41,93,0.000333,0.159008,14,6678.326488,371.018138,477.023321,145.041921,4,2
0,0,16,16,14,20,34,50,41,91,0.000333,0.15432,14,6481.42766,360.079314,462.959119,139.741531,4,2
0,0,15,15,15,20,35,48,39,87,0.000333,0.148749,7,3123.733357,173.540742,446.247622,145.041921,4,2
0,0,15,15,14,20,34,47,39,86,0.000333,0.145841,7,3062.65263,170.147368,437.521804,139.741531,4,2
0,0,18,18,15,20,35,50,41,91,0.000333,0.155588,14,6534.706564,363.039254,466.764755,145.041921,4,2
0,0,16,16,14,20,34,50,41,91,0.000333,0.15432,14,6481.42766,360.079314,462.959119,139.741531,4,2
0,0,16,16,13,20,33,48,41,89,0.000333,0.14965,12,5387.412919,299.300718,448.951077,134.544278,4,2
0,0,18,18,14,20,34,48,41,89,0.000333,0.150928,14,6338.9787,352.165483,452.784193,139.741531,4,2
0,0,15,15,14,20,34,47,39,86,0.000333,0.145841,7,3062.65263,170.147368,437.521804,139.741531,4,2
0,0,15,15,13,20,33,46,39,85,0.000333,0.142925,6,2572.641001,142.9245,428.7735,134.544278,4,2
0,0,18,18,17,18,35,52,36,88,0.000333,0.150459,16,7222.030488,401.223916,451.376905,144.545518,4,2
0,0,15,15,14,17,31,46,35,81,0.000333,0.133763,14,5618.058616,312.114368,401.289901,122.789837,4,2
0,0,14,14,15,18,33,49,39,88,0.000333,0.147969,14,6214.693555,345.260753,443.906683,133.662009,4,2
0,0,15,15,14,17,31,44,36,80,0.000333,0.132112,14,5548.699868,308.261104,396.335705,122.789837,3,2
0,0,18,18,15,19,34,57,45,102,0.000333,0.172974,14,7264.896937,403.605385,518.92121,139.313982,4,2
0,0,18,18,14,22,36,56,57,113,0.000333,0.194734,14,8178.821352,454.378964,584.201525,151.410465,4,2
0,0,15,15,12,18,30,47,40,87,0.000333,0.1423,12,5122.793782,284.599655,426.899482,118.0782,3,2
0,0,18,18,13,19,32,62,48,110,0.000333,0.183333,12,6600,366.666667,550,128.816339,3,2
0,0,20,20,16,24,40,57,54,111,0.000333,0.196911,16,9451.744297,525.096905,590.734019,174.0391,3,2
0,0,15,15,12,22,34,47,46,93,0.000333,0.157711,12,5677.608531,315.422696,473.134044,141.127046,3,2
0,0,16,16,14,18,32,52,42,94,0.000333,0.156667,14,6580,365.555556,470,128.361619,3,2
0,0,4,4,10,9,19,27,16,43,0.000333,0.060887,5,913.304415,50.739134,182.660883,61.748606,1,2
0,0,4,4,10,9,19,27,16,43,0.000333,0.060887,5,913.304415,50.739134,182.660883,61.748606,1,2
0,0,4,4,10,9,19,27,16,43,0.000333,0.060887,5,913.304415,50.739134,182.660883,61.748606,1,2
0,0,4,4,10,9,19,27,16,43,0.000333,0.060887,5,913.304415,50.739134,182.660883,61.748606,1,2
0,0,4,4,10,9,19,27,16,43,0.000333,0.060887,5,913.304415,50.739134,182.660883,61.748606,1,2
0,0,4,4,10,9,19,27,16,43,0.000333,0.060887,5,913.304415,50.739134,182.660883,61.748606,1,2
0,0,4,4,10,9,19,27,16,43,0.000333,0.060887,5,913.304415,50.739134,182.660883,61.748606,1,2
0,0,4,4,10,9,19,27,16,43,0.000333,0.060887,5,913.304415,50.739134,182.660883,61.748606,1,2
0,0,8,8,12,10,22,42,27,69,0.000333,0.102567,12,3692.40938,205.133854,307.700782,76.238831,1,2
0,0,8,8,11,13,24,41,36,77,0.000333,0.117681,10,3530.421126,196.134507,353.042113,86.159464,1,2
0,0,6,6,10,10,20,33,22,55,0.000333,0.079235,10,2377.060452,132.058914,237.706045,66.438562,1,2
0,0,9,9,11,11,22,48,30,78,0.000333,0.115945,10,3478.356663,193.242037,347.835666,76.107496,1,2
0,0,7,7,11,16,27,35,28,63,0.000333,0.099853,5,1497.789563,83.210531,299.557913,102.053748,1,2
0,0,6,6,10,14,24,33,28,61,0.000333,0.093228,10,2796.827125,155.379285,279.682713,86.52225,1,2
0,0,8,8,12,10,22,42,27,69,0.000333,0.102567,12,3692.40938,205.133854,307.700782,76.238831,1,2
0,0,7,7,11,12,23,42,26,68,0.000333,0.102534,10,3076.02213,170.890118,307.602213,81.073298,1,2
0,0,8,8,11,15,26,34,30,64,0.000333,0.100276,10,3008.28142,167.126746,300.828142,96.657107,1,2
0,0,6,6,10,14,24,33,28,61,0.000333,0.093228,10,2796.827125,155.379285,279.682713,86.52225,1,2
0,0,8,8,10,15,25,39,40,79,0.000333,0.122288,10,3668.64639,203.813688,366.864639,91.82264,1,2
0,0,10,10,10,16,26,45,52,97,0.000333,0.151981,15,6839.13979,379.952211,455.942653,97.219281,1,2
0,0,12,12,10,17,27,51,64,115,0.000333,0.182271,15,8202.180941,455.676719,546.812063,102.706149,1,2
0,0,8,8,11,13,24,41,36,77,0.000333,0.117681,10,3530.421126,196.134507,353.042113,86.159464,1,2
0,0,7,7,11,15,26,39,31,70,0.000333,0.109677,10,3290.307803,182.794878,329.03078,96.657107,1,2
0,0,8,8,11,16,27,48,35,83,0.000333,0.131552,10,3946.556627,219.253146,394.655663,102.053748,1,2
0,0,7,7,10,15,25,41,32,73,0.000333,0.113001,10,3390.015019,188.334168,339.001502,91.82264,1,2
0,0,9,9,10,17,27,48,38,86,0.000333,0.136307,10,4089.203252,227.177958,408.920325,102.706149,1,2
0,0,9,9,11,17,28,40,43,83,0.000333,0.133003,10,3990.104585,221.672477,399.010459,107.540616,1,2
0,0,8,8,10,15,25,33,36,69,0.000333,0.106809,10,3204.260771,178.014487,320.426077,91.82264,1,2
0,0,7,7,14,17,31,40,36,76,0.000333,0.125506,14,5271.264874,292.848049,376.51892,122.789837,1,2
0,0,7,7,13,17,30,39,36,75,0.000333,0.122672,12,4416.201536,245.34453,368.016795,117.592585,1,2
0,0,4,4,10,9,19,27,16,43,0.000333,0.060887,5,913.304415,50.739134,182.660883,61.748606,1,2
0,0,4,4,10,9,19,27,16,43,0.000333,0.060887,5,913.304415,50.739134,182.660883,61.748606,1,2
0,0,4,4,10,9,19,27,16,43,0.000333,0.060887,5,913.304415,50.739134,182.660883,61.748606,1,2
0,0,4,4,10,9,19,27,16,43,0.000333,0.060887,5,913.304415,50.739134,182.660883,61.748606,1,2
0,0,4,4,10,9,19,27,16,43,0.000333,0.060887,5,913.304415,50.739134,182.660883,61.748606,1,2
0,0,4,4,10,9,19,27,16,43,0.000333,0.060887,5,913.304415,50.739134,182.660883,61.748606,1,2
0,0,4,4,10,9,19,27,16,43,0.000333,0.060887,5,913.304415,50.739134,182.660883,61.748606,1,2
0,0,4,4,10,9,19,27,16,43,0.000333,0.060887,5,913.304415,50.739134,182.660883,61.748606,1,2
0,0,4,4,10,9,19,27,16,43,0.000333,0.060887,5,913.304415,50.739134,182.660883,61.748606,1,2
0,0,4,4,10,9,19,27,16,43,0.000333,0.060887,5,913.304415,50.739134,182.660883,61.748606,1,2
0,0,4,4,10,9,19,27,16,43,0.000333,0.060887,5,913.304415,50.739134,182.660883,61.748606,1,2
0,0,4,4,10,9,19,27,16,43,0.000333,0.060887,5,913.304415,50.739134,182.660883,61.748606,1,2
0,0,4,4,10,9,19,27,16,43,0.000333,0.060887,5,913.304415,50.739134,182.660883,61.748606,1,2
0,0,4,4,10,9,19,27,16,43,0.000333,0.060887,5,913.304415,50.739134,182.660883,61.748606,1,2
0,0,4,4,10,9,19,27,16,43,0.000333,0.060887,5,913.304415,50.739134,182.660883,61.748606,1,2
0,0,4,4,10,9,19,27,16,43,0.000333,0.060887,5,913.304415,50.739134,182.660883,61.748606,1,2
0,0,4,4,10,9,19,27,16,43,0.000333,0.060887,5,913.304415,50.739134,182.660883,61.748606,1,2
0,0,4,4,10,9,19,27,16,43,0.000333,0.060887,5,913.304415,50.739134,182.660883,61.748606,1,2
0,0,8,8,12,10,22,42,27,69,0.000333,0.102567,12,3692.40938,205.133854,307.700782,76.238831,1,2
0,0,8,8,11,13,24,41,36,77,0.000333,0.117681,10,3530.421126,196.134507,353.042113,86.159464,1,2
0,0,6,6,10,10,20,33,22,55,0.000333,0.079235,10,2377.060452,132.058914,237.706045,66.438562,1,2
0,0,9,9,11,11,22,48,30,78,0.000333,0.115945,10,3478.356663,193.242037,347.835666,76.107496,1,2
0,0,7,7,11,16,27,35,28,63,0.000333,0.099853,5,1497.789563,83.210531,299.557913,102.053748,1,2
0,0,6,6,10,14,24,33,28,61,0.000333,0.093228,10,2796.827125,155.379285,279.682713,86.52225,1,2
0,0,8,8,12,10,22,42,27,69,0.000333,0.102567,12,3692.40938,205.133854,307.700782,76.238831,1,2
0,0,7,7,11,12,23,42,26,68,0.000333,0.102534,10,3076.02213,170.890118,307.602213,81.073298,1,2
0,0,8,8,11,15,26,34,30,64,0.000333,0.100276,10,3008.28142,167.126746,300.828142,96.657107,1,2
0,0,6,6,10,14,24,33,28,61,0.000333,0.093228,10,2796.827125,155.379285,279.682713,86.52225,1,2
0,0,8,8,10,15,25,39,40,79,0.000333,0.122288,10,3668.64639,203.813688,366.864639,91.82264,1,2
0,0,10,10,10,16,26,45,52,97,0.000333,0.151981,15,6839.13979,379.952211,455.942653,97.219281,1,2
0,0,12,12,10,17,27,51,64,115,0.000333,0.182271,15,8202.180941,455.676719,546.812063,102.706149,1,2
0,0,8,8,11,13,24,41,36,77,0.000333,0.117681,10,3530.421126,196.134507,353.042113,86.159464,1,2
0,0,7,7,11,15,26,39,31,70,0.000333,0.109677,10,3290.307803,182.794878,329.03078,96.657107,1,2
0,0,8,8,11,16,27,48,35,83,0.000333,0.131552,10,3946.556627,219.253146,394.655663,102.053748,1,2
0,0,7,7,10,15,25,41,32,73,0.000333,0.113001,10,3390.015019,188.334168,339.001502,91.82264,1,2
0,0,9,9,10,17,27,48,38,86,0.000333,0.136307,10,4089.203252,227.177958,408.920325,102.706149,1,2
0,0,9,9,11,17,28,40,43,83,0.000333,0.133003,10,3990.104585,221.672477,399.010459,107.540616,1,2
0,0,8,8,10,15,25,33,36,69,0.000333,0.106809,10,3204.260771,178.014487,320.426077,91.82264,1,2
0,0,7,7,14,17,31,40,36,76,0.000333,0.125506,14,5271.264874,292.848049,376.51892,122.789837,1,2
0,0,7,7,13,17,30,39,36,75,0.000333,0.122672,12,4416.201536,245.34453,368.016795,117.592585,1,2
0,0,4,4,11,9,20,29,16,45,0.000333,0.064829,5,972.433821,54.024101,194.486764,66.583073,1,2
0,0,4,4,11,9,20,29,16,45,0.000333,0.064829,5,972.433821,54.024101,194.486764,66.583073,1,2
0,0,11,11,13,14,27,44,29,73,0.000333,0.115702,12,4165.281452,231.404525,347.106788,101.408685,2,2
0,0,9,9,12,14,26,44,29,73,0.000333,0.114377,12,4117.585193,228.754733,343.132099,96.322519,2,2
0,0,9,9,11,14,25,42,29,71,0.000333,0.109905,10,3297.137895,183.174327,329.713789,91.356717,2,2
0,0,7,7,11,11,22,38,23,61,0.000333,0.090675,10,2720.253287,151.125183,272.025329,76.107496,2,2
0,0,8,8,12,13,25,41,27,68,0.000333,0.105261,12,3789.386651,210.521481,315.782221,91.125266,2,2
0,0,8,8,11,13,24,40,27,67,0.000333,0.102397,10,3071.924875,170.662493,307.192488,86.159464,2,2
0,0,11,11,15,11,26,46,24,70,0.000333,0.109677,14,4606.430924,255.912829,329.03078,96.657107,2,2
0,0,8,8,12,10,22,40,23,63,0.000333,0.093648,12,3371.330304,187.296128,280.944192,76.238831,2,2
0,0,7,7,13,12,25,43,27,70,0.000333,0.108357,12,3900.839199,216.713289,325.069933,91.125266,2,2
0,0,8,8,12,11,23,38,24,62,0.000333,0.093487,12,3365.530095,186.973894,280.460841,81.073298,1,2
0,0,11,11,13,12,25,51,33,84,0.000333,0.130028,12,4681.007039,260.055947,390.08392,91.125266,2,2
0,0,11,11,12,15,27,50,45,95,0.000333,0.150571,18,8130.857629,451.714313,451.714313,101.622909,2,2
0,0,8,8,10,11,21,41,28,69,0.000333,0.101023,10,3030.699022,168.372168,303.069902,71.273029,1,2
0,0,11,11,11,12,23,56,36,92,0.000333,0.138723,15,6242.515499,346.806417,416.1677,81.073298,1,2
0,0,13,13,14,17,31,51,42,93,0.000333,0.15358,14,6450.363596,358.353533,460.740257,122.789837,1,2
0,0,8,8,10,15,25,41,34,75,0.000333,0.116096,10,3482.892142,193.494008,348.289214,91.82264,1,2
0,0,9,9,12,11,23,46,30,76,0.000333,0.114597,12,4125.488504,229.193806,343.790709,81.073298,1,2
0,0,9,9,11,13,24,50,32,82,0.000333,0.125322,10,3759.669251,208.870514,375.966925,86.159464,1,2
0,0,10,10,11,16,27,42,36,78,0.000333,0.123627,10,3708.812252,206.045125,370.881225,102.053748,1,2
0,0,8,8,10,15,25,41,34,75,0.000333,0.116096,10,3482.892142,193.494008,348.289214,91.82264,1,2
0,0,10,10,10,16,26,47,46,93,0.000333,0.145714,10,4371.408938,242.856052,437.140894,97.219281,1,2
0,0,12,12,10,17,27,53,58,111,0.000333,0.175931,15,7916.887691,439.827094,527.792513,102.706149,1,2
0,0,14,14,10,18,28,59,70,129,0.000333,0.206716,15,9302.231774,516.790654,620.148785,108.277931,1,2
0,0,9,9,11,14,25,45,36,81,0.000333,0.125384,10,3761.523514,208.973529,376.152351,91.356717,1,2
0,0,9,9,11,16,27,47,37,84,0.000333,0.133137,10,3994.105502,221.89475,399.41055,102.053748,1,2
0,0,10,10,11,17,28,56,41,97,0.000333,0.155438,10,4663.134274,259.063015,466.313427,107.540616,1,2
0,0,9,9,10,16,26,49,38,87,0.000333,0.136313,10,4089.382555,227.18792,408.938255,97.219281,1,2
0,0,11,11,10,18,28,56,44,100,0.000333,0.160245,10,4807.354922,267.075273,480.735492,108.277931,1,2
0,0,14,14,14,19,33,54,59,113,0.000333,0.190006,21,11970.34725,665.019291,570.016535,134.013592,1,2
0,0,10,10,10,16,26,41,42,83,0.000333,0.130045,10,3901.364966,216.742498,390.136497,97.219281,1,2
0,0,9,9,14,18,32,48,42,90,0.000333,0.15,14,6300,350,450,128.361619,1,2
0,0,10,10,14,18,32,49,43,92,0.000333,0.153333,14,6440,357.777778,460,128.361619,1,2
0,0,11,11,12,16,28,38,31,69,0.000333,0.110569,6,1990.244938,110.569163,331.70749,107.01955,3,2
0,0,12,12,13,16,29,41,32,73,0.000333,0.118211,12,4255.591352,236.421742,354.632613,112.105716,4,2
0,0,12,12,13,17,30,41,33,74,0.000333,0.121037,6,2178.659424,121.036635,363.109904,117.592585,4,2
0,0,14,14,15,20,35,49,38,87,0.000333,0.148749,7,3123.733357,173.540742,446.247622,145.041921,4,2
0,0,14,14,14,20,34,47,38,85,0.000333,0.144145,7,3027.040391,168.168911,432.434342,139.741531,4,2
0,0,13,13,15,19,34,45,36,81,0.000333,0.137361,7,2884.591431,160.255079,412.08449,139.313982,4,2
0,0,13,13,14,19,33,44,36,80,0.000333,0.134517,7,2824.860707,156.936706,403.55153,134.013592,4,2
0,0,16,16,15,20,35,47,38,85,0.000333,0.14533,7,3051.923395,169.5513,435.989056,145.041921,4,2
0,0,14,14,14,20,34,47,38,85,0.000333,0.144145,7,3027.040391,168.168911,432.434342,139.741531,4,2
0,0,14,14,13,20,33,45,38,83,0.000333,0.139562,6,2512.108271,139.561571,418.684712,134.544278,4,2
0,0,16,16,14,20,34,45,38,83,0.000333,0.140753,7,2955.815911,164.211995,422.259416,139.741531,4,2
0,0,13,13,14,19,33,44,36,80,0.000333,0.134517,7,2824.860707,156.936706,403.55153,134.013592,4,2
0,0,13,13,13,19,32,43,36,79,0.000333,0.131667,6,2370,131.666667,395,128.816339,4,2
0,0,16,16,17,17,34,49,33,82,0.000333,0.139057,8,3337.375624,185.409757,417.171953,138.973737,4,2
0,0,13,13,14,16,30,43,32,75,0.000333,0.122672,14,5152.235125,286.235285,368.016795,117.302969,4,2
0,0,12,12,15,18,33,46,36,82,0.000333,0.13788,14,5790.964449,321.720247,413.640318,133.662009,4,2
0,0,13,13,14,17,31,41,33,74,0.000333,0.122204,7,2566.273689,142.57076,366.610527,122.789837,3,2
0,0,16,16,15,18,33,54,42,96,0.000333,0.161421,14,6779.665696,376.648094,484.261835,133.662009,4,2
0,0,16,16,14,21,35,53,54,107,0.000333,0.182944,14,7683.665959,426.870331,548.833283,145.541635,4,2
0,0,13,13,12,17,29,44,37,81,0.000333,0.131165,12,4721.957527,262.330974,393.496461,112.506418,3,2
0,0,16,16,13,18,31,59,45,104,0.000333,0.171745,12,6182.836995,343.490944,515.236416,123.164366,3,2
0,0,18,18,16,23,39,54,51,105,0.000333,0.184989,16,8879.475728,493.304207,554.967233,168.041925,3,2
0,0,13,13,12,21,33,44,43,87,0.000333,0.146287,12,5266.347461,292.574859,438.862288,135.258216,3,2
0,0,14,14,14,17,31,49,39,88,0.000333,0.145323,14,6103.569854,339.087214,435.969275,122.789837,3,2
0,0,14,14,13,19,32,53,41,94,0.000333,0.156667,12,5640,313.333333,470,128.816339,3,2
0,0,15,15,13,22,35,45,45,90,0.000333,0.153878,12,5539.625658,307.756981,461.635472,146.213212,3,2
0,0,13,13,12,21,33,44,43,87,0.000333,0.146287,12,5266.347461,292.574859,438.862288,135.258216,3,2
0,0,15,15,12,22,34,50,55,105,0.000333,0.178061,12,6410.20318,356.122399,534.183598,141.127046,3,2
0,0,17,17,12,23,35,56,67,123,0.000333,0.210301,12,7570.821733,420.601207,630.901811,147.061475,3,2
0,0,19,19,12,24,36,62,79,141,0.000333,0.242986,18,13121.26965,728.959425,728.959425,153.05865,3,2
0,0,14,14,13,20,33,48,45,93,0.000333,0.156376,12,5629.543837,312.752435,469.128653,134.544278,3,2
0,0,14,14,13,22,35,50,46,96,0.000333,0.164137,12,5908.934036,328.274113,492.41117,146.213212,3,2
0,0,15,15,13,23,36,59,50,109,0.000333,0.187841,12,6762.261902,375.681217,563.521825,152.147641,3,2
0,0,14,14,12,22,34,52,47,99,0.000333,0.167886,12,6043.905855,335.772548,503.658821,141.127046,3,2
0,0,16,16,12,24,36,59,53,112,0.000333,0.193011,12,6948.379202,386.021067,579.0316,153.05865,3,2
0,0,19,19,16,25,41,57,68,125,0.000333,0.223231,16,10715.10401,595.283556,669.694001,180.096405,3,2
0,0,15,15,12,22,34,44,51,95,0.000333,0.161103,12,5799.707639,322.20598,483.30897,141.127046,3,2
0,0,14,14,16,24,40,51,51,102,0.000333,0.180946,16,8685.386651,482.521481,542.836666,174.0391,3,2
0,0,15,15,16,24,40,52,52,104,0.000333,0.184494,16,8855.68835,491.982686,553.480522,174.0391,3,2
0,0,8,8,10,11,21,37,24,61,0.000333,0.08931,10,2679.313628,148.850757,267.931363,71.273029,1,2
0,0,9,9,11,11,22,40,25,65,0.000333,0.096621,10,2898.630552,161.035031,289.863055,76.107496,2,2
0,0,9,9,11,12,23,40,26,66,0.000333,0.099518,10,2985.550891,165.863938,298.555089,81.073298,2,2
0,0,11,11,13,14,27,48,31,79,0.000333,0.125212,12,4507.633352,250.424075,375.636113,101.408685,2,2
0,0,11,11,12,14,26,46,31,77,0.000333,0.120645,12,4343.2063,241.289239,361.933858,96.322519,2,2
0,0,10,10,13,14,27,44,29,73,0.000333,0.115702,12,4165.281452,231.404525,347.106788,101.408685,2,2
0,0,10,10,12,14,26,43,29,72,0.000333,0.112811,12,4061.179916,225.621106,338.43166,96.322519,2,2
0,0,13,13,13,14,27,46,31,77,0.000333,0.122042,12,4393.516052,244.084225,366.126338,101.408685,2,2
0,0,11,11,12,14,26,46,31,77,0.000333,0.120645,12,4343.2063,241.289239,361.933858,96.322519,2,2
0,0,11,11,11,14,25,44,31,75,0.000333,0.116096,10,3482.892142,193.494008,348.289214,91.356717,2,2
0,0,13,13,12,14,26,44,31,75,0.000333,0.117511,12,4230.395746,235.021986,352.532979,96.322519,2,2
0,0,10,10,12,14,26,43,29,72,0.000333,0.112811,12,4061.179916,225.621106,338.43166,96.322519,2,2
0,0,10,10,11,14,25,42,29,71,0.000333,0.109905,10,3297.137895,183.174327,329.713789,91.356717,2,2
0,0,13,13,15,12,27,48,26,74,0.000333,0.117287,14,4926.063452,273.670192,351.861675,101.622909,2,2
0,0,10,10,12,11,23,42,25,67,0.000333,0.101026,12,3636.943813,202.052434,303.078651,81.073298,2,2
0,0,9,9,13,12,25,45,29,74,0.000333,0.114548,12,4123.744297,229.096905,343.645358,91.125266,2,2
0,0,10,10,12,11,23,40,26,66,0.000333,0.099518,12,3582.661069,199.036726,298.555089,81.073298,1,2
0,0,13,13,13,13,26,53,35,88,0.000333,0.13788,12,4963.664342,275.75913,413.638695,96.211433,2,2
0,0,13,13,12,15,27,52,43,95,0.000333,0.150571,12,5420.571752,301.142875,451.714313,101.622909,2,2
0,0,10,10,10,12,22,43,30,73,0.000333,0.108513,10,3255.385082,180.854727,325.538508,76.238831,1,2
0,0,13,13,11,13,24,58,38,96,0.000333,0.146719,10,4401.564001,244.531333,440.1564,86.159464,1,2
0,0,15,15,14,17,31,53,42,95,0.000333,0.156883,14,6589.081093,366.060061,470.648649,122.789837,1,2
0,0,10,10,10,15,25,43,34,77,0.000333,0.119192,10,3575.769266,198.653848,357.576927,91.82264,1,2
0,0,11,11,12,12,24,48,32,80,0.000333,0.122266,12,4401.564001,244.531333,366.797,86.0391,1,2
0,0,11,11,11,14,25,52,34,86,0.000333,0.133124,10,3993.716323,221.873129,399.371632,91.356717,1,2
0,0,12,12,11,16,27,44,36,80,0.000333,0.126797,10,3803.910002,211.328333,380.391,102.053748,1,2
0,0,10,10,10,15,25,43,34,77,0.000333,0.119192,10,3575.769266,198.653848,357.576927,91.82264,1,2
0,0,12,12,10,17,27,49,44,93,0.000333,0.147402,10,4422.045377,245.669188,442.204538,102.706149,1,2
0,0,14,14,10,17,27,55,54,109,0.000333,0.172761,15,7774.241066,431.902281,518.282738,102.706149,1,2
0,0,16,16,10,18,28,61,64,125,0.000333,0.200306,15,9013.790479,500.766138,600.919365,108.277931,1,2
0,0,11,11,11,14,25,47,36,83,0.000333,0.12848,10,3854.400638,214.133369,385.440064,91.356717,1,2
0,0,11,11,11,16,27,49,37,86,0.000333,0.136307,10,4089.203252,227.177958,408.920325,102.053748,1,2
0,0,12,12,11,17,28,58,41,99,0.000333,0.158643,10,4759.281373,264.404521,475.928137,107.540616,1,2
0,0,11,11,10,16,26,51,38,89,0.000333,0.139446,10,4183.391349,232.410631,418.339135,97.219281,1,2
0,0,13,13,10,18,28,58,44,102,0.000333,0.16345,10,4903.50202,272.416779,490.350202,108.277931,1,2
0,0,16,16,14,19,33,56,55,111,0.000333,0.186643,14,7838.988461,435.499359,559.927747,134.013592,1,2
0,0,12,12,10,16,26,43,40,83,0.000333,0.130045,10,3901.364966,216.742498,390.136497,97.219281,1,2
0,0,11,11,14,18,32,50,41,91,0.000333,0.151667,14,6370,353.888889,455,128.361619,1,2
0,0,12,12,14,18,32,51,42,93,0.000333,0.155,14,6510,361.666667,465,128.361619,1,2
0,0,8,8,10,11,21,37,24,61,0.000333,0.08931,10,2679.313628,148.850757,267.931363,71.273029,1,2
0,0,9,9,11,11,22,40,25,65,0.000333,0.096621,10,2898.630552,161.035031,289.863055,76.107496,2,2
0,0,9,9,11,12,23,40,26,66,0.000333,0.099518,10,2985.550891,165.863938,298.555089,81.073298,2,2
0,0,11,11,13,14,27,48,31,79,0.000333,0.125212,12,4507.633352,250.424075,375.636113,101.408685,2,2
0,0,11,11,12,14,26,46,31,77,0.000333,0.120645,12,4343.2063,241.289239,361.933858,96.322519,2,2
0,0,10,10,13,14,27,44,29,73,0.000333,0.115702,12,4165.281452,231.404525,347.106788,101.408685,2,2
0,0,10,10,12,14,26,43,29,72,0.000333,0.112811,12,4061.179916,225.621106,338.43166,96.322519,2,2
0,0,13,13,13,14,27,46,31,77,0.000333,0.122042,12,4393.516052,244.084225,366.126338,101.408685,2,2
0,0,11,11,12,14,26,46,31,77,0.000333,0.120645,12,4343.2063,241.289239,361.933858,96.322519,2,2
0,0,11,11,11,14,25,44,31,75,0.000333,0.116096,10,3482.892142,193.494008,348.289214,91.356717,2,2
0,0,13,13,12,14,26,44,31,75,0.000333,0.117511,12,4230.395746,235.021986,352.532979,96.322519,2,2
0,0,10,10,12,14,26,43,29,72,0.000333,0.112811,12,4061.179916,225.621106,338.43166,96.322519,2,2
0,0,10,10,11,14,25,42,29,71,0.000333,0.109905,10,3297.137895,183.174327,329.713789,91.356717,2,2
0,0,13,13,15,12,27,48,26,74,0.000333,0.117287,14,4926.063452,273.670192,351.861675,101.622909,2,2
0,0,10,10,12,11,23,42,25,67,0.000333,0.101026,12,3636.943813,202.052434,303.078651,81.073298,2,2
0,0,9,9,13,12,25,45,29,74,0.000333,0.114548,12,4123.744297,229.096905,343.645358,91.125266,2,2
0,0,10,10,12,11,23,40,26,66,0.000333,0.099518,12,3582.661069,199.036726,298.555089,81.073298,1,2
0,0,13,13,13,13,26,53,35,88,0.000333,0.13788,12,4963.664342,275.75913,413.638695,96.211433,2,2
0,0,13,13,12,15,27,52,43,95,0.000333,0.150571,12,5420.571752,301.142875,451.714313,101.622909,2,2
0,0,10,10,10,12,22,43,30,73,0.000333,0.108513,10,3255.385082,180.854727,325.538508,76.238831,1,2
0,0,13,13,11,13,24,58,38,96,0.000333,0.146719,10,4401.564001,244.531333,440.1564,86.159464,1,2
0,0,15,15,14,17,31,53,42,95,0.000333,0.156883,14,6589.081093,366.060061,470.648649,122.789837,1,2
0,0,10,10,10,15,25,43,34,77,0.000333,0.119192,10,3575.769266,198.653848,357.576927,91.82264,1,2
0,0,11,11,12,12,24,48,32,80,0.000333,0.122266,12,4401.564001,244.531333,366.797,86.0391,1,2
0,0,11,11,11,14,25,52,34,86,0.000333,0.133124,10,3993.716323,221.873129,399.371632,91.356717,1,2
0,0,12,12,11,16,27,44,36,80,0.000333,0.126797,10,3803.910002,211.328333,380.391,102.053748,1,2
0,0,10,10,10,15,25,43,34,77,0.000333,0.119192,10,3575.769266,198.653848,357.576927,91.82264,1,2
0,0,12,12,10,16,26,49,44,93,0.000333,0.145714,10,4371.408938,242.856052,437.140894,97.219281,1,2
0,0,14,14,10,17,27,55,54,109,0.000333,0.172761,15,7774.241066,431.902281,518.282738,102.706149,1,2
0,0,16,16,10,18,28,61,64,125,0.000333,0.200306,15,9013.790479,500.766138,600.919365,108.277931,1,2
0,0,11,11,11,14,25,47,36,83,0.000333,0.12848,10,3854.400638,214.133369,385.440064,91.356717,1,2
0,0,11,11,11,16,27,49,37,86,0.000333,0.136307,10,4089.203252,227.177958,408.920325,102.053748,1,2
0,0,12,12,11,17,28,58,41,99,0.000333,0.158643,10,4759.281373,264.404521,475.928137,107.540616,1,2
0,0,11,11,10,16,26,51,38,89,0.000333,0.139446,10,4183.391349,232.410631,418.339135,97.219281,1,2
0,0,13,13,10,18,28,58,44,102,0.000333,0.16345,10,4903.50202,272.416779,490.350202,108.277931,1,2
0,0,16,16,14,19,33,56,55,111,0.000333,0.186643,14,7838.988461,435.499359,559.927747,134.013592,1,2
0,0,12,12,10,16,26,43,40,83,0.000333,0.130045,10,3901.364966,216.742498,390.136497,97.219281,1,2
0,0,11,11,14,18,32,50,41,91,0.000333,0.151667,14,6370,353.888889,455,128.361619,1,2
0,0,12,12,14,18,32,51,42,93,0.000333,0.155,14,6510,361.666667,465,128.361619,1,2
0,0,8,8,10,11,21,37,24,61,0.000333,0.08931,10,2679.313628,148.850757,267.931363,71.273029,1,2
0,0,9,9,11,11,22,40,25,65,0.000333,0.096621,10,2898.630552,161.035031,289.863055,76.107496,2,2
0,0,9,9,11,12,23,40,26,66,0.000333,0.099518,10,2985.550891,165.863938,298.555089,81.073298,2,2
0,0,11,11,13,14,27,48,31,79,0.000333,0.125212,12,4507.633352,250.424075,375.636113,101.408685,2,2
0,0,11,11,12,14,26,46,31,77,0.000333,0.120645,12,4343.2063,241.289239,361.933858,96.322519,2,2
0,0,10,10,13,14,27,44,29,73,0.000333,0.115702,12,4165.281452,231.404525,347.106788,101.408685,2,2
0,0,10,10,12,14,26,43,29,72,0.000333,0.112811,12,4061.179916,225.621106,338.43166,96.322519,2,2
0,0,13,13,13,14,27,46,31,77,0.000333,0.122042,12,4393.516052,244.084225,366.126338,101.408685,2,2
0,0,11,11,12,14,26,46,31,77,0.000333,0.120645,12,4343.2063,241.289239,361.933858,96.322519,2,2
0,0,11,11,11,14,25,44,31,75,0.000333,0.116096,10,3482.892142,193.494008,348.289214,91.356717,2,2
0,0,13,13,12,14,26,44,31,75,0.000333,0.117511,12,4230.395746,235.021986,352.532979,96.322519,2,2
0,0,10,10,12,14,26,43,29,72,0.000333,0.112811,12,4061.179916,225.621106,338.43166,96.322519,2,2
0,0,10,10,11,14,25,42,29,71,0.000333,0.109905,10,3297.137895,183.174327,329.713789,91.356717,2,2
0,0,13,13,15,12,27,48,26,74,0.000333,0.117287,14,4926.063452,273.670192,351.861675,101.622909,2,2
0,0,10,10,12,11,23,42,25,67,0.000333,0.101026,12,3636.943813,202.052434,303.078651,81.073298,2,2
0,0,9,9,13,12,25,45,29,74,0.000333,0.114548,12,4123.744297,229.096905,343.645358,91.125266,2,2
0,0,10,10,12,11,23,40,26,66,0.000333,0.099518,12,3582.661069,199.036726,298.555089,81.073298,1,2
0,0,13,13,13,13,26,53,35,88,0.000333,0.13788,12,4963.664342,275.75913,413.638695,96.211433,2,2
0,0,13,13,12,15,27,52,43,95,0.000333,0.150571,12,5420.571752,301.142875,451.714313,101.622909,2,2
0,0,10,10,10,12,22,43,30,73,0.000333,0.108513,10,3255.385082,180.854727,325.538508,76.238831,1,2
0,0,13,13,11,13,24,58,38,96,0.000333,0.146719,10,4401.564001,244.531333,440.1564,86.159464,1,2
0,0,15,15,14,17,31,53,42,95,0.000333,0.156883,14,6589.081093,366.060061,470.648649,122.789837,1,2
0,0,10,10,10,15,25,43,34,77,0.000333,0.119192,10,3575.769266,198.653848,357.576927,91.82264,1,2
0,0,11,11,12,12,24,48,32,80,0.000333,0.122266,12,4401.564001,244.531333,366.797,86.0391,1,2
0,0,11,11,11,14,25,52,34,86,0.000333,0.133124,10,3993.716323,221.873129,399.371632,91.356717,1,2
0,0,12,12,11,16,27,44,36,80,0.000333,0.126797,10,3803.910002,211.328333,380.391,102.053748,1,2
0,0,10,10,10,15,25,43,34,77,0.000333,0.119192,10,3575.769266,198.653848,357.576927,91.82264,1,2
0,0,12,12,10,16,26,49,44,93,0.000333,0.145714,10,4371.408938,242.856052,437.140894,97.219281,1,2
0,0,14,14,10,17,27,55,54,109,0.000333,0.172761,15,7774.241066,431.902281,518.282738,102.706149,1,2
0,0,16,16,10,18,28,61,64,125,0.000333,0.200306,15,9013.790479,500.766138,600.919365,108.277931,1,2
0,0,11,11,11,14,25,47,36,83,0.000333,0.12848,10,3854.400638,214.133369,385.440064,91.356717,1,2
0,0,11,11,11,16,27,49,37,86,0.000333,0.136307,10,4089.203252,227.177958,408.920325,102.053748,1,2
0,0,12,12,11,17,28,58,41,99,0.000333,0.158643,10,4759.281373,264.404521,475.928137,107.540616,1,2
0,0,11,11,10,16,26,51,38,89,0.000333,0.139446,10,4183.391349,232.410631,418.339135,97.219281,1,2
0,0,13,13,10,18,28,58,44,102,0.000333,0.16345,10,4903.50202,272.416779,490.350202,108.277931,1,2
0,0,16,16,14,19,33,56,55,111,0.000333,0.186643,14,7838.988461,435.499359,559.927747,134.013592,1,2
0,0,12,12,10,16,26,43,40,83,0.000333,0.130045,10,3901.364966,216.742498,390.136497,97.219281,1,2
0,0,11,11,14,18,32,50,41,91,0.000333,0.151667,14,6370,353.888889,455,128.361619,1,2
0,0,12,12,14,18,32,51,42,93,0.000333,0.155,14,6510,361.666667,465,128.361619,1,2
0,0,6,6,10,9,19,32,20,52,0.000333,0.073631,10,2208.922307,122.717906,220.892231,61.748606,1,2
0,0,7,7,11,9,20,35,21,56,0.000333,0.080676,10,2420.279733,134.459985,242.027973,66.583073,2,2
0,0,7,7,11,10,21,35,22,57,0.000333,0.083454,10,2503.620931,139.090052,250.362093,71.273029,2,2
0,0,9,9,13,13,26,43,27,70,0.000333,0.109677,12,3948.369363,219.353854,329.03078,96.211433,2,2
0,0,9,9,12,13,25,41,27,68,0.000333,0.105261,12,3789.386651,210.521481,315.782221,91.125266,2,2
0,0,8,8,13,12,25,39,25,64,0.000333,0.099069,12,3566.481554,198.137864,297.206796,91.125266,2,2
0,0,8,8,12,12,24,38,25,63,0.000333,0.096284,12,3466.231651,192.568425,288.852638,86.0391,2,2
0,0,11,11,13,13,26,41,27,68,0.000333,0.106543,12,3835.55881,213.086601,319.629901,96.211433,2,2
0,0,9,9,12,13,25,41,27,68,0.000333,0.105261,12,3789.386651,210.521481,315.782221,91.125266,2,2
0,0,9,9,11,13,24,39,27,66,0.000333,0.100869,10,3026.07525,168.115292,302.607525,86.159464,2,2
0,0,11,11,12,13,25,39,27,66,0.000333,0.102165,12,3677.934102,204.329672,306.494509,91.125266,2,2
0,0,8,8,12,12,24,38,25,63,0.000333,0.096284,12,3466.231651,192.568425,288.852638,86.0391,2,2
0,0,8,8,11,12,23,37,25,62,0.000333,0.093487,10,2804.608413,155.811578,280.460841,81.073298,2,2
0,0,11,11,15,10,25,43,22,65,0.000333,0.100617,14,4225.909133,234.77273,301.850652,91.82264,2,2
0,0,8,8,12,9,21,37,21,58,0.000333,0.084918,12,3057.052926,169.836274,254.754411,71.548875,2,2
0,0,7,7,13,11,24,40,25,65,0.000333,0.099341,12,3576.270751,198.681708,298.022563,86.159464,2,2
0,0,8,8,12,10,22,35,22,57,0.000333,0.084729,12,3050.251227,169.458402,254.187602,76.238831,1,2
0,0,11,11,13,11,24,48,31,79,0.000333,0.120737,12,4346.544451,241.474692,362.212038,86.159464,2,2
0,0,11,11,12,13,25,47,39,86,0.000333,0.133124,18,7188.689382,399.371632,399.371632,91.125266,2,2
0,0,8,8,10,10,20,38,26,64,0.000333,0.092201,10,2766.033981,153.668554,276.603398,66.438562,1,2
0,0,11,11,11,11,22,53,34,87,0.000333,0.129324,15,5819.558262,323.308792,387.970551,76.107496,1,2
0,0,13,13,14,15,29,48,38,86,0.000333,0.139262,14,5849.009118,324.944951,417.786366,111.906328,1,2
0,0,8,8,10,13,23,38,30,68,0.000333,0.102534,10,3076.02213,170.890118,307.602213,81.324997,1,2
0,0,9,9,12,10,22,43,28,71,0.000333,0.10554,12,3799.435739,211.079763,316.619645,76.238831,1,2
0,0,9,9,11,12,23,47,30,77,0.000333,0.116105,10,3483.142706,193.507928,348.314271,81.073298,1,2
0,0,10,10,11,14,25,39,32,71,0.000333,0.109905,10,3297.137895,183.174327,329.713789,91.356717,1,2
0,0,8,8,10,13,23,38,30,68,0.000333,0.102534,10,3076.02213,170.890118,307.602213,81.324997,1,2
0,0,10,10,10,14,24,44,40,84,0.000333,0.128379,10,3851.368501,213.964917,385.13685,86.52225,1,2
0,0,12,12,10,15,25,50,50,100,0.000333,0.154795,15,6965.784285,386.988016,464.385619,91.82264,1,2
0,0,14,14,10,16,26,56,60,116,0.000333,0.18175,15,8178.76511,454.375839,545.251007,97.219281,1,2
0,0,9,9,11,12,23,42,32,74,0.000333,0.111581,10,3347.435847,185.968658,334.743585,81.073298,1,2
0,0,9,9,11,14,25,44,33,77,0.000333,0.119192,10,3575.769266,198.653848,357.576927,91.356717,1,2
0,0,10,10,11,15,26,53,37,90,0.000333,0.141013,10,4230.395746,235.021986,423.039575,96.657107,1,2
0,0,9,9,10,14,24,46,34,80,0.000333,0.122266,10,3667.970001,203.776111,366.797,86.52225,1,2
0,0,11,11,10,16,26,53,40,93,0.000333,0.145714,10,4371.408938,242.856052,437.140894,97.219281,1,2
0,0,14,14,14,17,31,51,51,102,0.000333,0.168443,21,10611.8885,589.549361,505.328024,122.789837,1,2
0,0,10,10,10,14,24,38,36,74,0.000333,0.113096,10,3392.872251,188.492903,339.287225,86.52225,1,2
0,0,9,9,14,16,30,45,37,82,0.000333,0.134122,14,5633.110404,312.950578,402.365029,117.302969,1,2
0,0,10,10,14,16,30,46,38,84,0.000333,0.137393,14,5770.50334,320.583519,412.17881,117.302969,1,2
0,0,6,6,10,9,19,32,20,52,0.000333,0.073631,10,2208.922307,122.717906,220.892231,61.748606,1,2
0,0,7,7,11,9,20,35,21,56,0.000333,0.080676,10,2420.279733,134.459985,242.027973,66.583073,2,2
0,0,7,7,11,10,21,35,22,57,0.000333,0.083454,10,2503.620931,139.090052,250.362093,71.273029,2,2
0,0,9,9,13,13,26,43,27,70,0.000333,0.109677,12,3948.369363,219.353854,329.03078,96.211433,2,2
0,0,9,9,12,13,25,41,27,68,0.000333,0.105261,12,3789.386651,210.521481,315.782221,91.125266,2,2
0,0,8,8,13,12,25,39,25,64,0.000333,0.099069,12,3566.481554,198.137864,297.206796,91.125266,2,2
0,0,8,8,12,12,24,38,25,63,0.000333,0.096284,12,3466.231651,192.568425,288.852638,86.0391,2,2
0,0,11,11,13,13,26,41,27,68,0.000333,0.106543,12,3835.55881,213.086601,319.629901,96.211433,2,2
0,0,9,9,12,13,25,41,27,68,0.000333,0.105261,12,3789.386651,210.521481,315.782221,91.125266,2,2
0,0,9,9,11,13,24,39,27,66,0.000333,0.100869,10,3026.07525,168.115292,302.607525,86.159464,2,2
0,0,11,11,12,13,25,39,27,66,0.000333,0.102165,12,3677.934102,204.329672,306.494509,91.125266,2,2
0,0,8,8,12,12,24,38,25,63,0.000333,0.096284,12,3466.231651,192.568425,288.852638,86.0391,2,2
0,0,8,8,11,12,23,37,25,62,0.000333,0.093487,10,2804.608413,155.811578,280.460841,81.073298,2,2
0,0,11,11,15,10,25,43,22,65,0.000333,0.100617,14,4225.909133,234.77273,301.850652,91.82264,2,2
0,0,8,8,12,9,21,37,21,58,0.000333,0.084918,12,3057.052926,169.836274,254.754411,71.548875,2,2
0,0,7,7,13,11,24,40,25,65,0.000333,0.099341,12,3576.270751,198.681708,298.022563,86.159464,2,2
0,0,8,8,12,10,22,35,22,57,0.000333,0.084729,12,3050.251227,169.458402,254.187602,76.238831,1,2
0,0,11,11,13,11,24,48,31,79,0.000333,0.120737,12,4346.544451,241.474692,362.212038,86.159464,2,2
0,0,11,11,12,13,25,47,39,86,0.000333,0.133124,18,7188.689382,399.371632,399.371632,91.125266,2,2
0,0,8,8,10,10,20,38,26,64,0.000333,0.092201,10,2766.033981,153.668554,276.603398,66.438562,1,2
0,0,11,11,11,11,22,53,34,87,0.000333,0.129324,15,5819.558262,323.308792,387.970551,76.107496,1,2
0,0,13,13,14,15,29,48,38,86,0.000333,0.139262,14,5849.009118,324.944951,417.786366,111.906328,1,2
0,0,8,8,10,13,23,38,30,68,0.000333,0.102534,10,3076.02213,170.890118,307.602213,81.324997,1,2
0,0,9,9,12,10,22,43,28,71,0.000333,0.10554,12,3799.435739,211.079763,316.619645,76.238831,1,2
0,0,9,9,11,12,23,47,30,77,0.000333,0.116105,10,3483.142706,193.507928,348.314271,81.073298,1,2
0,0,10,10,11,14,25,39,32,71,0.000333,0.109905,10,3297.137895,183.174327,329.713789,91.356717,1,2
0,0,8,8,10,13,23,38,30,68,0.000333,0.102534,10,3076.02213,170.890118,307.602213,81.324997,1,2
0,0,10,10,10,14,24,44,40,84,0.000333,0.128379,10,3851.368501,213.964917,385.13685,86.52225,1,2
0,0,12,12,10,15,25,50,50,100,0.000333,0.154795,15,6965.784285,386.988016,464.385619,91.82264,1,2
0,0,14,14,10,16,26,56,60,116,0.000333,0.18175,15,8178.76511,454.375839,545.251007,97.219281,1,2
0,0,9,9,11,12,23,42,32,74,0.000333,0.111581,10,3347.435847,185.968658,334.743585,81.073298,1,2
0,0,9,9,11,14,25,44,33,77,0.000333,0.119192,10,3575.769266,198.653848,357.576927,91.356717,1,2
0,0,10,10,11,15,26,53,37,90,0.000333,0.141013,10,4230.395746,235.021986,423.039575,96.657107,1,2
0,0,9,9,10,14,24,46,34,80,0.000333,0.122266,10,3667.970001,203.776111,366.797,86.52225,1,2
0,0,11,11,10,16,26,53,40,93,0.000333,0.145714,10,4371.408938,242.856052,437.140894,97.219281,1,2
0,0,14,14,14,17,31,51,51,102,0.000333,0.168443,21,10611.8885,589.549361,505.328024,122.789837,1,2
0,0,10,10,10,14,24,38,36,74,0.000333,0.113096,10,3392.872251,188.492903,339.287225,86.52225,1,2
0,0,9,9,14,13,27,39,27,66,0.000333,0.104608,14,4393.516052,244.084225,313.822575,101.408685,4,2
0,0,11,11,14,13,27,45,29,74,0.000333,0.117287,14,4926.063452,273.670192,351.861675,101.408685,6,2
0,0,11,11,14,14,28,45,31,76,0.000333,0.121786,14,5115.025637,284.168091,365.358974,106.605938,6,2
0,0,13,13,16,15,31,53,35,88,0.000333,0.145323,16,6975.508405,387.528245,435.969275,122.603359,6,2
0,0,13,13,15,15,30,51,35,86,0.000333,0.140664,14,5907.896277,328.21646,421.992591,117.206718,6,2
0,0,12,12,16,15,31,49,34,83,0.000333,0.137066,16,6579.1727,365.509594,411.198294,122.603359,6,2
0,0,12,12,15,15,30,48,34,82,0.000333,0.134122,14,5633.110404,312.950578,402.365029,117.206718,6,2
0,0,15,15,16,15,31,51,35,86,0.000333,0.14202,16,6816.974123,378.720785,426.060883,122.603359,6,2
0,0,13,13,15,15,30,51,35,86,0.000333,0.140664,14,5907.896277,328.21646,421.992591,117.206718,6,2
0,0,13,13,14,15,29,49,35,84,0.000333,0.136023,14,5712.98565,317.388092,408.070404,111.906328,6,2
0,0,15,15,15,15,30,49,35,84,0.000333,0.137393,14,5770.50334,320.583519,412.17881,117.206718,6,2
0,0,12,12,15,15,30,48,34,82,0.000333,0.134122,14,5633.110404,312.950578,402.365029,117.206718,6,2
0,0,12,12,14,15,29,47,34,81,0.000333,0.131165,14,5508.950448,306.052803,393.496461,111.906328,6,2
0,0,16,16,18,15,33,55,31,86,0.000333,0.144606,18,7808.722097,433.817894,433.817894,133.662009,6,2
0,0,13,13,15,13,28,49,29,78,0.000333,0.124991,14,5249.631575,291.646199,374.973684,106.709075,6,2
0,0,11,11,16,15,31,55,37,92,0.000333,0.151929,16,7292.576969,405.143165,455.786061,122.603359,6,2
0,0,13,13,16,15,31,45,31,76,0.000333,0.125506,16,6024.302713,334.683484,376.51892,122.603359,4,2
0,0,13,13,15,16,31,50,36,86,0.000333,0.14202,14,5964.852358,331.380687,426.060883,122.603359,5,2
0,0,13,13,14,19,33,49,48,97,0.000333,0.163102,14,6850.287214,380.571512,489.30623,134.013592,5,2
0,0,11,11,14,14,28,43,33,76,0.000333,0.121786,14,5115.025637,284.168091,365.358974,106.605938,4,2
0,0,14,14,16,15,31,56,41,97,0.000333,0.160186,16,7688.912674,427.161815,480.557042,122.603359,4,2
0,0,16,16,17,20,37,52,47,99,0.000333,0.171912,16,8251.774131,458.431896,515.735883,155.92543,4,2
0,0,11,11,15,15,30,45,33,78,0.000333,0.127579,14,5358.32453,297.684696,382.737466,117.206718,4,2
0,0,12,12,16,14,30,48,35,83,0.000333,0.135757,16,6516.350711,362.019484,407.271919,117.302969,4,2
0,0,12,12,16,16,32,52,37,89,0.000333,0.148333,16,7120,395.555556,445,128,4,2
0,0,13,13,15,19,34,45,41,86,0.000333,0.145841,14,6125.305261,340.294737,437.521804,139.313982,4,2
0,0,11,11,14,18,32,44,39,83,0.000333,0.138333,14,5810,322.777778,415,128.361619,4,2
0,0,13,13,14,19,33,49,51,100,0.000333,0.168146,14,7062.151767,392.341765,504.439412,134.013592,4,2
0,0,15,15,14,20,34,54,63,117,0.000333,0.198411,21,12499.8962,694.438678,595.233152,139.741531,4,2
0,0,17,17,14,21,35,59,75,134,0.000333,0.229108,21,14433.80241,801.877912,687.323924,145.541635,4,2
0,0,12,12,15,17,32,47,41,88,0.000333,0.146667,14,6160,342.222222,440,128.090227,4,2
0,0,12,12,16,19,35,49,42,91,0.000333,0.155588,16,7468.236073,414.902004,466.764755,144.710623,4,2
0,0,13,13,16,20,36,57,46,103,0.000333,0.177501,16,8520.036402,473.335356,532.502275,150.438562,4,2
0,0,13,13,15,19,34,52,45,97,0.000333,0.164495,14,6908.774538,383.820808,493.483896,139.313982,4,2
0,0,14,14,14,21,35,57,49,106,0.000333,0.181235,14,7611.855997,422.880889,543.704,145.541635,4,2
0,0,17,17,17,22,39,56,64,120,0.000333,0.211416,16,10147.97226,563.776237,634.248266,167.594364,4,2
0,0,13,13,14,19,33,44,47,91,0.000333,0.153013,14,6426.558108,357.031006,459.039865,134.013592,4,2
0,0,12,12,18,21,39,51,47,98,0.000333,0.172656,18,9323.449514,517.969417,517.969417,167.297316,4,2
0,0,13,13,19,21,40,52,48,100,0.000333,0.177398,18,9579.470571,532.192809,532.192809,172.949289,4,2
0,0,8,8,10,10,20,44,29,73,0.000333,0.105167,10,3155.007509,175.278195,315.500751,66.438562,1,2
0,0,9,9,11,10,21,47,30,77,0.000333,0.112736,15,5073.126623,281.840368,338.208442,71.273029,2,2
0,0,9,9,11,11,22,47,31,78,0.000333,0.115945,10,3478.356663,193.242037,347.835666,76.107496,2,2
0,0,11,11,13,14,27,55,36,91,0.000333,0.144232,12,5192.337152,288.463175,432.694763,101.408685,2,2
0,0,11,11,12,14,26,53,36,89,0.000333,0.139446,12,5020.069619,278.892757,418.339135,96.322519,2,2
0,0,10,10,13,13,26,51,34,85,0.000333,0.133179,12,4794.448513,266.358251,399.537376,96.211433,2,2
0,0,10,10,12,13,25,50,34,84,0.000333,0.130028,12,4681.007039,260.055947,390.08392,91.125266,2,2
0,0,13,13,13,14,27,53,36,89,0.000333,0.141062,12,5078.219852,282.123325,423.184988,101.408685,2,2
0,0,11,11,12,14,26,53,36,89,0.000333,0.139446,12,5020.069619,278.892757,418.339135,96.322519,2,2
0,0,11,11,11,14,25,51,36,87,0.000333,0.134672,10,4040.154885,224.453049,404.015489,91.356717,2,2
0,0,13,13,12,14,26,51,36,87,0.000333,0.136313,12,4907.259066,272.625504,408.938255,96.322519,2,2
0,0,10,10,12,13,25,50,34,84,0.000333,0.130028,12,4681.007039,260.055947,390.08392,91.125266,2,2
0,0,9,9,11,12,23,47,31,78,0.000333,0.117613,10,3528.378326,196.021018,352.837833,81.073298,2,2
0,0,13,13,15,11,26,55,31,86,0.000333,0.134746,14,5659.329421,314.40719,404.237816,96.657107,2,2
0,0,10,10,12,10,22,49,30,79,0.000333,0.117432,18,6341.311762,352.295098,352.295098,76.238831,2,2
0,0,9,9,13,12,25,52,34,86,0.000333,0.133124,12,4792.459588,266.247755,399.371632,91.125266,2,2
0,0,10,10,12,10,22,47,31,78,0.000333,0.115945,18,6261.041993,347.835666,347.835666,76.238831,1,2
0,0,10,10,10,11,21,50,35,85,0.000333,0.124449,15,5600.204714,311.122484,373.346981,71.273029,1,2
0,0,13,13,11,12,23,65,43,108,0.000333,0.162848,15,7328.170369,407.120576,488.544691,81.073298,1,2
0,0,15,15,14,16,30,60,47,107,0.000333,0.175012,14,7350.522112,408.36234,525.037294,117.302969,1,2
0,0,11,11,10,14,24,52,41,93,0.000333,0.142134,10,4264.015126,236.889729,426.401513,86.52225,1,2
0,0,12,12,11,13,24,61,41,102,0.000333,0.155889,15,7014.992626,389.721813,467.666175,86.159464,1,2
0,0,13,13,11,15,26,53,43,96,0.000333,0.150414,10,4512.422129,250.690118,451.242213,96.657107,1,2
0,0,11,11,10,14,24,52,41,93,0.000333,0.142134,10,4264.015126,236.889729,426.401513,86.52225,1,2
0,0,13,13,10,15,25,58,51,109,0.000333,0.168727,15,7592.70487,421.816937,506.180325,91.82264,1,2
0,0,15,15,10,16,26,64,61,125,0.000333,0.195852,15,8813.324472,489.629137,587.554965,97.219281,1,2
0,0,17,17,10,17,27,70,71,141,0.000333,0.22348,20,13408.78276,744.932375,670.439138,102.706149,1,2
0,0,12,12,11,15,26,58,44,102,0.000333,0.159815,10,4794.448513,266.358251,479.444851,96.657107,1,2
0,0,13,13,11,16,27,67,48,115,0.000333,0.182271,15,8202.180941,455.676719,546.812063,102.053748,1,2
0,0,12,12,10,15,25,60,45,105,0.000333,0.162535,15,7314.073499,406.337417,487.6049,91.82264,1,2
0,0,13,13,10,17,27,67,51,118,0.000333,0.187026,15,8416.150879,467.563938,561.076725,102.706149,1,2
0,0,17,17,14,18,32,65,62,127,0.000333,0.211667,21,13335,740.833333,635,128.361619,1,2
0,0,13,13,10,15,25,52,47,99,0.000333,0.153247,15,6896.126442,383.118136,459.741763,91.82264,1,2
0,0,12,12,14,17,31,59,48,107,0.000333,0.1767,14,7421.386073,412.299226,530.099005,122.789837,1,2
0,0,13,13,14,17,31,60,49,109,0.000333,0.180002,14,7560.10357,420.005754,540.007398,122.789837,1,2
0,0,9,9,10,10,20,48,33,81,0.000333,0.116692,15,5251.142635,291.730146,350.076176,66.438562,1,2
0,0,9,9,11,10,21,49,32,81,0.000333,0.118593,15,5336.665669,296.481426,355.777711,71.273029,2,2
0,0,9,9,11,11,22,49,33,82,0.000333,0.121891,15,5485.100891,304.727827,365.673393,76.107496,2,2
0,0,11,11,13,14,27,57,38,95,0.000333,0.150571,12,5420.571752,301.142875,451.714313,101.408685,2,2
0,0,11,11,12,14,26,55,38,93,0.000333,0.145714,12,5245.690725,291.427263,437.140894,96.322519,2,2
0,0,9,9,11,12,23,49,33,82,0.000333,0.123644,10,3709.320804,206.073378,370.93208,81.073298,2,2
0,0,10,10,12,13,25,52,36,88,0.000333,0.13622,12,4903.912136,272.439563,408.659345,91.125266,2,2
0,0,13,13,13,14,27,55,38,93,0.000333,0.147402,12,5306.454452,294.803025,442.204538,101.408685,2,2
0,0,11,11,12,14,26,55,38,93,0.000333,0.145714,12,5245.690725,291.427263,437.140894,96.322519,2,2
0,0,10,10,11,14,25,51,35,86,0.000333,0.133124,10,3993.716323,221.873129,399.371632,91.356717,2,2
0,0,13,13,12,14,26,53,38,91,0.000333,0.14258,12,5132.880172,285.16001,427.740014,96.322519,2,2
0,0,10,10,12,13,25,52,36,88,0.000333,0.13622,12,4903.912136,272.439563,408.659345,91.125266,2,2
0,0,10,10,11,13,24,51,36,87,0.000333,0.132964,10,3988.917376,221.606521,398.891738,86.159464,2,2
0,0,13,13,15,11,26,57,33,90,0.000333,0.141013,21,8883.831067,493.54617,423.039575,96.657107,2,2
0,0,10,10,12,10,22,51,32,83,0.000333,0.123378,18,6662.390838,370.132824,370.132824,76.238831,2,2
0,0,9,9,13,12,25,54,36,90,0.000333,0.139316,18,7523.047027,417.947057,417.947057,91.125266,2,2
0,0,10,10,12,10,22,49,33,82,0.000333,0.121891,18,6582.121069,365.673393,365.673393,76.238831,1,2
0,0,10,10,10,11,21,52,37,89,0.000333,0.130305,15,5863.743759,325.763542,390.916251,71.273029,1,2
0,0,13,13,11,12,23,67,45,112,0.000333,0.16888,15,7599.584086,422.199116,506.638939,81.073298,1,2
0,0,15,15,14,16,30,62,49,111,0.000333,0.181555,21,11437.96198,635.442332,544.664856,117.302969,1,2
0,0,11,11,10,14,24,54,43,97,0.000333,0.148247,15,6671.120439,370.617802,444.741363,86.52225,1,2
0,0,11,11,11,13,24,63,43,106,0.000333,0.162002,15,7290.090376,405.005021,486.006025,86.159464,1,2
0,0,13,13,11,15,26,55,45,100,0.000333,0.156681,15,7050.659577,391.70331,470.043972,96.657107,1,2
0,0,11,11,10,14,24,54,43,97,0.000333,0.148247,15,6671.120439,370.617802,444.741363,86.52225,1,2
0,0,13,13,10,15,25,60,53,113,0.000333,0.174919,15,7871.336242,437.296458,524.755749,91.82264,1,2
0,0,15,15,10,16,26,66,63,129,0.000333,0.202119,15,9095.350855,505.29727,606.356724,97.219281,1,2
0,0,17,17,10,17,27,72,73,145,0.000333,0.22982,20,13789.17376,766.065209,689.458688,102.706149,1,2
0,0,12,12,11,15,26,60,46,106,0.000333,0.166082,15,7473.699152,415.205508,498.24661,96.657107,1,2
0,0,13,13,11,16,27,69,50,119,0.000333,0.188611,15,8487.474191,471.526344,565.831613,102.053748,1,2
0,0,11,11,10,15,25,62,47,109,0.000333,0.168727,15,7592.70487,421.816937,506.180325,91.82264,1,2
0,0,13,13,10,17,27,69,53,122,0.000333,0.193365,15,8701.444129,483.413563,580.096275,102.706149,1,2
0,0,17,17,14,18,32,67,64,131,0.000333,0.218333,21,13755,764.166667,655,128.361619,1,2
0,0,13,13,10,15,25,54,49,103,0.000333,0.159439,15,7174.757813,398.597656,478.317188,91.82264,1,2
0,0,12,12,14,17,31,61,50,111,0.000333,0.183305,14,7698.821066,427.712281,549.91579,122.789837,1,2
0,0,13,13,14,17,31,62,51,113,0.000333,0.186608,21,11756.30785,653.128214,559.824183,122.789837,1,2
0,0,8,8,8,9,17,35,26,61,0.000333,0.083112,8,1994.681867,110.815659,249.335233,52.529325,1,2
0,0,9,9,9,9,18,38,27,65,0.000333,0.090348,12,3252.541501,180.69675,271.045125,57.05865,2,2
0,0,9,9,9,10,19,38,28,66,0.000333,0.093454,8,2242.905727,124.605874,280.363216,61.748606,2,2
0,0,11,11,11,13,24,46,33,79,0.000333,0.120737,10,3622.120376,201.22891,362.212038,86.159464,2,2
0,0,11,11,10,13,23,44,33,77,0.000333,0.116105,10,3483.142706,193.507928,348.314271,81.324997,2,2
0,0,10,10,11,12,23,42,31,73,0.000333,0.110073,10,3302.200228,183.455568,330.220023,81.073298,2,2
0,0,10,10,10,12,22,41,31,72,0.000333,0.107026,10,3210.790765,178.377265,321.079077,76.238831,2,2
0,0,13,13,11,13,24,44,33,77,0.000333,0.117681,10,3530.421126,196.134507,353.042113,86.159464,2,2
0,0,11,11,10,13,23,44,33,77,0.000333,0.116105,10,3483.142706,193.507928,348.314271,81.324997,2,2
0,0,11,11,9,13,22,42,33,75,0.000333,0.111486,8,2675.658971,148.647721,334.457371,76.635041,2,2
0,0,13,13,10,13,23,42,33,75,0.000333,0.113089,10,3392.671467,188.481748,339.267147,81.324997,2,2
0,0,10,10,10,12,22,41,31,72,0.000333,0.107026,10,3210.790765,178.377265,321.079077,76.238831,2,2
0,0,10,10,9,12,21,40,31,71,0.000333,0.103952,8,2494.836296,138.602016,311.854537,71.548875,2,2
0,0,13,13,13,10,23,46,28,74,0.000333,0.111581,12,4016.923017,223.16239,334.743585,81.324997,2,2
0,0,10,10,10,9,19,40,27,67,0.000333,0.09487,15,4269.167151,237.175953,284.611143,61.748606,2,2
0,0,9,9,11,11,22,43,31,74,0.000333,0.109999,10,3299.979398,183.332189,329.99794,76.107496,2,2
0,0,10,10,10,9,19,38,28,66,0.000333,0.093454,15,4205.448238,233.636013,280.363216,61.748606,1,2
0,0,10,10,9,10,19,41,32,73,0.000333,0.103366,12,3721.184502,206.732472,310.098708,61.748606,1,2
0,0,13,13,10,11,21,56,40,96,0.000333,0.140554,15,6324.937089,351.385394,421.662473,71.273029,1,2
0,0,15,15,13,15,28,51,44,95,0.000333,0.152233,12,5480.384611,304.465812,456.698718,106.709075,1,2
0,0,10,10,9,13,22,41,36,77,0.000333,0.114459,8,2747.009877,152.61166,343.376235,76.635041,1,2
0,0,11,11,10,12,22,52,38,90,0.000333,0.133783,15,6020.232685,334.457371,401.348846,76.238831,1,2
0,0,13,13,10,14,24,44,40,84,0.000333,0.128379,10,3851.368501,213.964917,385.13685,86.52225,1,2
0,0,11,11,9,13,22,43,38,81,0.000333,0.120405,8,2889.711689,160.539538,361.213961,76.635041,1,2
0,0,13,13,9,14,23,49,48,97,0.000333,0.146262,12,5265.426117,292.523673,438.78551,81.832294,1,2
0,0,15,15,9,15,24,55,58,113,0.000333,0.1727,12,6217.209151,345.400508,518.100763,87.132684,1,2
0,0,17,17,9,16,25,61,68,129,0.000333,0.199686,16,9584.919176,532.49551,599.057448,92.529325,1,2
0,0,12,12,10,14,24,49,41,90,0.000333,0.137549,10,4126.466251,229.248125,412.646625,86.52225,1,2
0,0,13,13,10,15,25,58,45,103,0.000333,0.159439,15,7174.757813,398.597656,478.317188,91.82264,1,2
0,0,11,11,9,14,23,51,42,93,0.000333,0.14023,12,5048.295143,280.460841,420.691262,81.832294,1,2
0,0,13,13,9,16,25,58,48,106,0.000333,0.164083,12,5906.985073,328.165837,492.248756,92.529325,1,2
0,0,17,17,13,17,30,56,59,115,0.000333,0.188097,18,10157.26353,564.292418,564.292418,117.592585,1,2
0,0,13,13,9,14,23,43,44,87,0.000333,0.131183,12,4722.598682,262.366593,393.54989,81.832294,1,2
0,0,12,12,13,16,29,50,45,95,0.000333,0.153836,12,5538.098334,307.67213,461.508195,112.105716,1,2
0,0,13,13,13,16,29,51,46,97,0.000333,0.157075,12,5654.689878,314.149438,471.224157,112.105716,1,2
0,0,8,8,8,9,17,37,28,65,0.000333,0.088562,12,3188.221016,177.12339,265.685085,52.529325,1,2
0,0,9,9,9,9,18,40,29,69,0.000333,0.095908,12,3452.697901,191.81655,287.724825,57.05865,2,2
0,0,9,9,9,10,19,40,30,70,0.000333,0.099118,12,3568.259111,198.236617,297.354926,61.748606,2,2
0,0,11,11,11,13,24,48,35,83,0.000333,0.126851,10,3805.518876,211.417715,380.551888,86.159464,2,2
0,0,11,11,10,13,23,46,35,81,0.000333,0.122136,10,3664.085184,203.560288,366.408518,81.324997,2,2
0,0,10,10,11,12,23,44,33,77,0.000333,0.116105,10,3483.142706,193.507928,348.314271,81.073298,2,2
0,0,10,10,10,12,22,43,33,76,0.000333,0.112972,10,3389.16803,188.287113,338.916803,76.238831,2,2
0,0,13,13,11,13,24,46,35,81,0.000333,0.123794,10,3713.819626,206.323313,371.381963,86.159464,2,2
0,0,11,11,10,13,23,46,35,81,0.000333,0.122136,10,3664.085184,203.560288,366.408518,81.324997,2,2
0,0,11,11,9,13,22,44,35,79,0.000333,0.117432,8,2818.360783,156.575599,352.295098,76.635041,2,2
0,0,13,13,10,13,23,44,35,79,0.000333,0.11912,10,3573.613945,198.534108,357.361395,81.324997,2,2
0,0,11,11,11,12,23,45,35,80,0.000333,0.120628,10,3618.849565,201.047198,361.884956,81.073298,2,2
0,0,11,11,10,12,22,44,35,79,0.000333,0.117432,10,3522.950979,195.719499,352.295098,76.238831,2,2
0,0,14,14,14,10,24,50,32,82,0.000333,0.125322,21,7895.305426,438.628079,375.966925,86.52225,2,2
0,0,11,11,11,9,20,44,31,75,0.000333,0.108048,15,4862.169107,270.120506,324.144607,66.583073,2,2
0,0,10,10,12,11,23,47,35,82,0.000333,0.123644,18,6676.777447,370.93208,370.93208,81.073298,2,2
0,0,11,11,11,9,20,42,32,74,0.000333,0.106608,15,4797.340185,266.518899,319.822679,66.583073,1,2
0,0,11,11,9,10,19,45,36,81,0.000333,0.114694,12,4128.985543,229.388086,344.082129,61.748606,1,2
0,0,14,14,10,11,21,60,44,104,0.000333,0.152267,20,9136.020239,507.55668,456.801012,71.273029,1,2
0,0,15,15,13,15,28,53,46,99,0.000333,0.158643,18,8566.706471,475.928137,475.928137,106.709075,1,2
0,0,11,11,9,13,22,45,40,85,0.000333,0.126351,12,4548.620251,252.701125,379.051688,76.635041,1,2
0,0,11,11,10,12,22,54,40,94,0.000333,0.139729,15,6287.798582,349.322143,419.186572,76.238831,1,2
0,0,13,13,10,14,24,46,42,88,0.000333,0.134492,15,6052.150501,336.230583,403.4767,86.52225,1,2
0,0,11,11,9,13,22,45,40,85,0.000333,0.126351,12,4548.620251,252.701125,379.051688,76.635041,1,2
0,0,13,13,9,14,23,51,50,101,0.000333,0.152293,12,5482.557091,304.586505,456.879758,81.832294,1,2
0,0,15,15,9,15,24,57,60,117,0.000333,0.178814,16,8583.049801,476.8361,536.440613,87.132684,1,2
0,0,17,17,9,16,25,63,70,133,0.000333,0.205878,16,9882.125972,549.006998,617.632873,92.529325,1,2
0,0,12,12,10,14,24,51,43,94,0.000333,0.143662,15,6464.797126,359.155396,430.986475,86.52225,1,2
0,0,13,13,10,15,25,60,47,107,0.000333,0.165631,15,7453.389185,414.077177,496.892612,91.82264,1,2
0,0,11,11,9,14,23,53,44,97,0.000333,0.146262,12,5265.426117,292.523673,438.78551,81.832294,1,2
0,0,13,13,9,16,25,60,50,110,0.000333,0.170275,12,6129.890171,340.549454,510.824181,92.529325,1,2
0,0,17,17,13,17,30,58,61,119,0.000333,0.19464,18,10510.55966,583.919981,583.919981,117.592585,1,2
0,0,13,13,9,14,23,45,46,91,0.000333,0.137215,12,4939.729656,274.429425,411.644138,81.832294,1,2
0,0,12,12,13,16,29,52,47,99,0.000333,0.160313,12,5771.281422,320.626746,480.940119,112.105716,1,2
0,0,13,13,13,16,29,53,48,101,0.000333,0.163552,18,8831.809449,490.656081,490.656081,112.105716,1,2
0,0,10,10,10,11,21,48,33,81,0.000333,0.118593,15,5336.665669,296.481426,355.777711,71.273029,1,2
0,0,11,11,11,11,22,51,34,85,0.000333,0.126351,15,5685.775314,315.876406,379.051688,76.107496,2,2
0,0,11,11,11,12,23,51,35,86,0.000333,0.129675,10,3890.263282,216.125738,389.026328,81.073298,2,2
0,0,13,13,13,15,28,59,40,99,0.000333,0.158643,12,5711.137647,317.285425,475.928137,106.709075,2,2
0,0,13,13,12,15,27,57,40,97,0.000333,0.153741,12,5534.689053,307.482725,461.224088,101.622909,2,2
0,0,12,12,13,14,27,55,38,93,0.000333,0.147402,12,5306.454452,294.803025,442.204538,101.408685,2,2
0,0,12,12,12,14,26,54,38,92,0.000333,0.144147,12,5189.285449,288.293636,432.440454,96.322519,2,2
0,0,15,15,13,15,28,57,40,97,0.000333,0.155438,12,5595.761129,310.875618,466.313427,106.709075,2,2
0,0,13,13,12,15,27,57,40,97,0.000333,0.153741,12,5534.689053,307.482725,461.224088,101.622909,2,2
0,0,13,13,11,15,26,55,40,95,0.000333,0.148847,10,4465.417732,248.078763,446.541773,96.657107,2,2
0,0,15,15,12,15,27,55,40,95,0.000333,0.150571,12,5420.571752,301.142875,451.714313,101.622909,2,2
0,0,12,12,12,14,26,54,38,92,0.000333,0.144147,12,5189.285449,288.293636,432.440454,96.322519,2,2
0,0,12,12,11,14,25,53,38,91,0.000333,0.140864,10,4225.909133,234.77273,422.590913,91.356717,2,2
0,0,15,15,15,12,27,59,35,94,0.000333,0.148986,14,6257.431953,347.635108,446.959425,101.622909,2,2
0,0,12,12,12,11,23,53,34,87,0.000333,0.131183,18,7083.898023,393.54989,393.54989,81.073298,2,2
0,0,11,11,13,13,26,56,38,94,0.000333,0.14728,12,5302.096002,294.560889,441.841334,96.211433,2,2
0,0,12,12,12,11,23,51,35,86,0.000333,0.129675,18,7002.473908,389.026328,389.026328,81.073298,1,2
0,0,15,15,13,13,26,64,44,108,0.000333,0.169216,18,9137.654812,507.64749,507.64749,96.211433,2,2
0,0,15,15,12,15,27,63,52,115,0.000333,0.182271,18,9842.617129,546.812063,546.812063,101.622909,2,2
0,0,12,12,10,12,22,54,39,93,0.000333,0.138242,15,6220.907108,345.60595,414.727141,76.238831,1,2
0,0,15,15,11,13,24,69,47,116,0.000333,0.177285,15,7977.834751,443.213042,531.85565,86.159464,1,2
0,0,17,17,14,17,31,64,51,115,0.000333,0.189911,21,11964.38409,664.688005,569.732576,122.789837,1,2
0,0,12,12,10,15,25,54,43,97,0.000333,0.150151,10,4504.540504,250.25225,450.45405,91.82264,1,2
0,0,13,13,12,12,24,59,41,100,0.000333,0.152832,18,8252.932501,458.49625,458.49625,86.0391,1,2
0,0,13,13,11,14,25,63,43,106,0.000333,0.164083,15,7383.731342,410.207297,492.248756,91.356717,1,2
0,0,14,14,11,16,27,55,45,100,0.000333,0.158496,10,4754.887502,264.160417,475.48875,102.053748,1,2
0,0,12,12,10,15,25,54,43,97,0.000333,0.150151,10,4504.540504,250.25225,450.45405,91.82264,1,2
0,0,14,14,10,16,26,60,53,113,0.000333,0.17705,15,7967.245322,442.62474,531.149688,97.219281,1,2
0,0,16,16,10,17,27,66,63,129,0.000333,0.20446,15,9200.707317,511.150406,613.380488,102.706149,1,2
0,0,18,18,10,18,28,72,73,145,0.000333,0.232355,20,13941.32927,774.518293,697.066464,108.277931,1,2
0,0,13,13,11,14,25,58,45,103,0.000333,0.159439,15,7174.757813,398.597656,478.317188,91.356717,1,2
0,0,13,13,11,16,27,60,46,106,0.000333,0.168006,10,5040.180752,280.010042,504.018075,102.053748,1,2
0,0,14,14,11,17,28,69,50,119,0.000333,0.190692,10,5720.752357,317.819575,572.075236,107.540616,1,2
0,0,13,13,10,16,26,62,47,109,0.000333,0.170783,10,5123.479293,284.637738,512.347929,97.219281,1,2
0,0,15,15,10,18,28,69,53,122,0.000333,0.195499,10,5864.973005,325.831834,586.4973,108.277931,1,2
0,0,18,18,14,19,33,67,64,131,0.000333,0.220272,21,13877.12822,770.951568,660.81563,134.013592,1,2
0,0,14,14,10,16,26,54,49,103,0.000333,0.161382,15,7262.179365,403.454409,484.145291,97.219281,1,2
0,0,13,13,14,18,32,61,50,111,0.000333,0.185,14,7770,431.666667,555,128.361619,1,2
0,0,14,14,14,18,32,62,51,113,0.000333,0.188333,14,7910,439.444444,565,128.361619,1,2
0,0,10,10,10,11,21,50,35,85,0.000333,0.124449,15,5600.204714,311.122484,373.346981,71.273029,1,2
0,0,11,11,11,11,22,53,36,89,0.000333,0.132296,15,5953.341211,330.741178,396.889414,76.107496,2,2
0,0,11,11,11,12,23,53,37,90,0.000333,0.135707,15,6106.808641,339.267147,407.120576,81.073298,2,2
0,0,13,13,13,15,28,61,42,103,0.000333,0.165053,12,5941.890684,330.105038,495.157557,106.709075,2,2
0,0,13,13,12,15,27,59,42,101,0.000333,0.160081,12,5762.923653,320.162425,480.243638,101.622909,2,2
0,0,12,12,13,14,27,57,40,97,0.000333,0.153741,12,5534.689053,307.482725,461.224088,101.408685,2,2
0,0,12,12,12,14,26,56,40,96,0.000333,0.150414,12,5414.906555,300.828142,451.242213,96.322519,2,2
0,0,15,15,13,15,28,59,42,101,0.000333,0.161848,12,5826.514166,323.695231,485.542847,106.709075,2,2
0,0,13,13,12,15,27,59,42,101,0.000333,0.160081,12,5762.923653,320.162425,480.243638,101.622909,2,2
0,0,13,13,11,15,26,57,42,99,0.000333,0.155115,10,4653.435321,258.524184,465.343532,96.657107,2,2
0,0,15,15,12,15,27,57,42,99,0.000333,0.156911,12,5648.806353,313.822575,470.733863,101.622909,2,2
0,0,12,12,12,14,26,56,40,96,0.000333,0.150414,12,5414.906555,300.828142,451.242213,96.322519,2,2
0,0,12,12,11,14,25,55,40,95,0.000333,0.147055,10,4411.66338,245.09241,441.166338,91.356717,2,2
0,0,15,15,15,12,27,61,37,98,0.000333,0.155326,21,9785.558479,543.642138,465.978975,101.622909,2,2
0,0,12,12,12,11,23,55,36,91,0.000333,0.137215,18,7409.594484,411.644138,411.644138,81.073298,2,2
0,0,11,11,13,13,26,58,40,98,0.000333,0.153548,18,8291.575663,460.643092,460.643092,96.211433,2,2
0,0,12,12,12,11,23,53,37,90,0.000333,0.135707,18,7328.170369,407.120576,407.120576,81.073298,1,2
0,0,15,15,13,13,26,66,46,112,0.000333,0.175483,18,9476.086472,526.449248,526.449248,96.211433,2,2
0,0,15,15,12,15,27,65,54,119,0.000333,0.188611,18,10184.96903,565.831613,565.831613,101.622909,2,2
0,0,12,12,10,12,22,56,41,97,0.000333,0.144188,15,6488.473005,360.470723,432.564867,76.238831,1,2
0,0,15,15,11,13,24,71,49,120,0.000333,0.183399,15,8252.932501,458.49625,550.1955,86.159464,1,2
0,0,17,17,14,17,31,66,53,119,0.000333,0.196516,21,12380.53658,687.807588,589.549361,122.789837,1,2
0,0,12,12,10,15,25,56,45,101,0.000333,0.156343,15,7035.442128,390.857896,469.029475,91.82264,1,2
0,0,13,13,12,12,24,61,43,104,0.000333,0.158945,18,8583.049801,476.8361,476.8361,86.0391,1,2
0,0,13,13,11,14,25,65,45,110,0.000333,0.170275,15,7662.362713,425.686817,510.824181,91.356717,1,2
0,0,14,14,11,16,27,57,47,104,0.000333,0.164836,10,4945.083002,274.726833,494.5083,102.053748,1,2
0,0,12,12,10,15,25,56,45,101,0.000333,0.156343,15,7035.442128,390.857896,469.029475,91.82264,1,2
0,0,14,14,10,16,26,62,55,117,0.000333,0.183317,15,8249.271705,458.292873,549.951447,97.219281,1,2
0,0,16,16,10,17,27,68,65,133,0.000333,0.2108,15,9486.000567,527.000031,632.400038,102.706149,1,2
0,0,18,18,10,18,28,74,75,149,0.000333,0.238765,20,14325.91767,795.884315,716.295883,108.277931,1,2
0,0,13,13,11,14,25,60,47,107,0.000333,0.165631,15,7453.389185,414.077177,496.892612,91.356717,1,2
0,0,13,13,11,16,27,62,48,110,0.000333,0.174346,15,7845.564379,435.864688,523.037625,102.053748,1,2
0,0,14,14,11,17,28,71,52,123,0.000333,0.197102,15,8869.569831,492.75388,591.304655,107.540616,1,2
0,0,13,13,10,16,26,64,49,113,0.000333,0.17705,15,7967.245322,442.62474,531.149688,97.219281,1,2
0,0,15,15,10,18,28,71,55,126,0.000333,0.201909,15,9085.900803,504.772267,605.72672,108.277931,1,2
0,0,18,18,14,19,33,69,66,135,0.000333,0.226998,21,14300.85733,794.492074,680.993206,134.013592,1,2
0,0,14,14,10,16,26,56,51,107,0.000333,0.167649,15,7544.205748,419.122542,502.94705,97.219281,1,2
0,0,13,13,14,18,32,63,52,115,0.000333,0.191667,14,8050,447.222222,575,128.361619,1,2
0,0,14,14,14,18,32,64,53,117,0.000333,0.195,14,8190,455,585,128.361619,1,2
0,0,10,10,10,11,21,48,33,81,0.000333,0.118593,15,5336.665669,296.481426,355.777711,71.273029,1,2
0,0,11,11,11,11,22,51,34,85,0.000333,0.126351,15,5685.775314,315.876406,379.051688,76.107496,2,2
0,0,11,11,11,12,23,51,35,86,0.000333,0.129675,10,3890.263282,216.125738,389.026328,81.073298,2,2
0,0,13,13,13,15,28,59,40,99,0.000333,0.158643,12,5711.137647,317.285425,475.928137,106.709075,2,2
0,0,13,13,12,15,27,57,40,97,0.000333,0.153741,12,5534.689053,307.482725,461.224088,101.622909,2,2
0,0,12,12,13,14,27,55,38,93,0.000333,0.147402,12,5306.454452,294.803025,442.204538,101.408685,2,2
0,0,12,12,12,14,26,54,38,92,0.000333,0.144147,12,5189.285449,288.293636,432.440454,96.322519,2,2
0,0,15,15,13,15,28,57,40,97,0.000333,0.155438,12,5595.761129,310.875618,466.313427,106.709075,2,2
0,0,13,13,12,15,27,57,40,97,0.000333,0.153741,12,5534.689053,307.482725,461.224088,101.622909,2,2
0,0,13,13,11,15,26,55,40,95,0.000333,0.148847,10,4465.417732,248.078763,446.541773,96.657107,2,2
0,0,15,15,12,15,27,55,40,95,0.000333,0.150571,12,5420.571752,301.142875,451.714313,101.622909,2,2
0,0,12,12,12,14,26,54,38,92,0.000333,0.144147,12,5189.285449,288.293636,432.440454,96.322519,2,2
0,0,12,12,11,14,25,53,38,91,0.000333,0.140864,10,4225.909133,234.77273,422.590913,91.356717,2,2
0,0,15,15,15,12,27,59,35,94,0.000333,0.148986,14,6257.431953,347.635108,446.959425,101.622909,2,2
0,0,12,12,12,11,23,53,34,87,0.000333,0.131183,18,7083.898023,393.54989,393.54989,81.073298,2,2
0,0,11,11,13,13,26,56,38,94,0.000333,0.14728,12,5302.096002,294.560889,441.841334,96.211433,2,2
0,0,12,12,12,11,23,51,35,86,0.000333,0.129675,18,7002.473908,389.026328,389.026328,81.073298,1,2
0,0,15,15,13,13,26,64,44,108,0.000333,0.169216,18,9137.654812,507.64749,507.64749,96.211433,2,2
0,0,15,15,12,15,27,63,52,115,0.000333,0.182271,18,9842.617129,546.812063,546.812063,101.622909,2,2
0,0,12,12,10,12,22,54,39,93,0.000333,0.138242,15,6220.907108,345.60595,414.727141,76.238831,1,2
0,0,15,15,11,13,24,69,47,116,0.000333,0.177285,15,7977.834751,443.213042,531.85565,86.159464,1,2
0,0,17,17,14,17,31,64,51,115,0.000333,0.189911,21,11964.38409,664.688005,569.732576,122.789837,1,2
0,0,12,12,10,15,25,54,43,97,0.000333,0.150151,10,4504.540504,250.25225,450.45405,91.82264,1,2
0,0,13,13,12,12,24,59,41,100,0.000333,0.152832,18,8252.932501,458.49625,458.49625,86.0391,1,2
0,0,13,13,11,14,25,63,43,106,0.000333,0.164083,15,7383.731342,410.207297,492.248756,91.356717,1,2
0,0,14,14,11,16,27,55,45,100,0.000333,0.158496,10,4754.887502,264.160417,475.48875,102.053748,1,2
0,0,12,12,10,15,25,54,43,97,0.000333,0.150151,10,4504.540504,250.25225,450.45405,91.82264,1,2
0,0,14,14,10,16,26,60,53,113,0.000333,0.17705,15,7967.245322,442.62474,531.149688,97.219281,1,2
0,0,16,16,10,17,27,66,63,129,0.000333,0.20446,15,9200.707317,511.150406,613.380488,102.706149,1,2
0,0,18,18,10,18,28,72,73,145,0.000333,0.232355,20,13941.32927,774.518293,697.066464,108.277931,1,2
0,0,13,13,11,14,25,58,45,103,0.000333,0.159439,15,7174.757813,398.597656,478.317188,91.356717,1,2
0,0,13,13,11,16,27,60,46,106,0.000333,0.168006,10,5040.180752,280.010042,504.018075,102.053748,1,2
0,0,14,14,11,17,28,69,50,119,0.000333,0.190692,10,5720.752357,317.819575,572.075236,107.540616,1,2
0,0,13,13,10,16,26,62,47,109,0.000333,0.170783,10,5123.479293,284.637738,512.347929,97.219281,1,2
0,0,15,15,10,18,28,69,53,122,0.000333,0.195499,10,5864.973005,325.831834,586.4973,108.277931,1,2
0,0,18,18,14,19,33,67,64,131,0.000333,0.220272,21,13877.12822,770.951568,660.81563,134.013592,1,2
0,0,14,14,10,16,26,54,49,103,0.000333,0.161382,15,7262.179365,403.454409,484.145291,97.219281,1,2
0,0,13,13,14,18,32,61,50,111,0.000333,0.185,14,7770,431.666667,555,128.361619,1,2
0,0,14,14,14,18,32,62,51,113,0.000333,0.188333,14,7910,439.444444,565,128.361619,1,2
0,0,10,10,10,11,21,50,35,85,0.000333,0.124449,15,5600.204714,311.122484,373.346981,71.273029,1,2
0,0,11,11,11,11,22,53,36,89,0.000333,0.132296,15,5953.341211,330.741178,396.889414,76.107496,2,2
0,0,11,11,11,12,23,53,37,90,0.000333,0.135707,15,6106.808641,339.267147,407.120576,81.073298,2,2
0,0,13,13,13,15,28,61,42,103,0.000333,0.165053,12,5941.890684,330.105038,495.157557,106.709075,2,2
0,0,13,13,12,15,27,59,42,101,0.000333,0.160081,12,5762.923653,320.162425,480.243638,101.622909,2,2
0,0,12,12,13,14,27,57,40,97,0.000333,0.153741,12,5534.689053,307.482725,461.224088,101.408685,2,2
0,0,12,12,12,14,26,56,40,96,0.000333,0.150414,12,5414.906555,300.828142,451.242213,96.322519,2,2
0,0,15,15,13,15,28,59,42,101,0.000333,0.161848,12,5826.514166,323.695231,485.542847,106.709075,2,2
0,0,13,13,12,15,27,59,42,101,0.000333,0.160081,12,5762.923653,320.162425,480.243638,101.622909,2,2
0,0,13,13,11,15,26,57,42,99,0.000333,0.155115,10,4653.435321,258.524184,465.343532,96.657107,2,2
0,0,15,15,12,15,27,57,42,99,0.000333,0.156911,12,5648.806353,313.822575,470.733863,101.622909,2,2
0,0,12,12,12,14,26,56,40,96,0.000333,0.150414,12,5414.906555,300.828142,451.242213,96.322519,2,2
0,0,12,12,11,14,25,55,40,95,0.000333,0.147055,10,4411.66338,245.09241,441.166338,91.356717,2,2
0,0,15,15,15,12,27,61,37,98,0.000333,0.155326,21,9785.558479,543.642138,465.978975,101.622909,2,2
0,0,12,12,12,11,23,55,36,91,0.000333,0.137215,18,7409.594484,411.644138,411.644138,81.073298,2,2
0,0,11,11,13,13,26,58,40,98,0.000333,0.153548,18,8291.575663,460.643092,460.643092,96.211433,2,2
0,0,12,12,12,11,23,53,37,90,0.000333,0.135707,18,7328.170369,407.120576,407.120576,81.073298,1,2
0,0,15,15,13,13,26,66,46,112,0.000333,0.175483,18,9476.086472,526.449248,526.449248,96.211433,2,2
0,0,15,15,12,15,27,65,54,119,0.000333,0.188611,18,10184.96903,565.831613,565.831613,101.622909,2,2
0,0,12,12,10,12,22,56,41,97,0.000333,0.144188,15,6488.473005,360.470723,432.564867,76.238831,1,2
0,0,15,15,11,13,24,71,49,120,0.000333,0.183399,15,8252.932501,458.49625,550.1955,86.159464,1,2
0,0,17,17,14,17,31,66,53,119,0.000333,0.196516,21,12380.53658,687.807588,589.549361,122.789837,1,2
0,0,12,12,10,15,25,56,45,101,0.000333,0.156343,15,7035.442128,390.857896,469.029475,91.82264,1,2
0,0,13,13,12,12,24,61,43,104,0.000333,0.158945,18,8583.049801,476.8361,476.8361,86.0391,1,2
0,0,13,13,11,14,25,65,45,110,0.000333,0.170275,15,7662.362713,425.686817,510.824181,91.356717,1,2
0,0,14,14,11,16,27,57,47,104,0.000333,0.164836,10,4945.083002,274.726833,494.5083,102.053748,1,2
0,0,12,12,10,15,25,56,45,101,0.000333,0.156343,15,7035.442128,390.857896,469.029475,91.82264,1,2
0,0,14,14,10,16,26,62,55,117,0.000333,0.183317,15,8249.271705,458.292873,549.951447,97.219281,1,2
0,0,16,16,10,17,27,68,65,133,0.000333,0.2108,15,9486.000567,527.000031,632.400038,102.706149,1,2
0,0,18,18,10,18,28,74,75,149,0.000333,0.238765,20,14325.91767,795.884315,716.295883,108.277931,1,2
0,0,13,13,11,14,25,60,47,107,0.000333,0.165631,15,7453.389185,414.077177,496.892612,91.356717,1,2
0,0,13,13,11,16,27,62,48,110,0.000333,0.174346,15,7845.564379,435.864688,523.037625,102.053748,1,2
0,0,14,14,11,17,28,71,52,123,0.000333,0.197102,15,8869.569831,492.75388,591.304655,107.540616,1,2
0,0,13,13,10,16,26,64,49,113,0.000333,0.17705,15,7967.245322,442.62474,531.149688,97.219281,1,2
0,0,15,15,10,18,28,71,55,126,0.000333,0.201909,15,9085.900803,504.772267,605.72672,108.277931,1,2
0,0,18,18,14,19,33,69,66,135,0.000333,0.226998,21,14300.85733,794.492074,680.993206,134.013592,1,2
0,0,14,14,10,16,26,56,51,107,0.000333,0.167649,15,7544.205748,419.122542,502.94705,97.219281,1,2
0,0,13,13,14,18,32,63,52,115,0.000333,0.191667,14,8050,447.222222,575,128.361619,1,2
0,0,14,14,14,18,32,64,53,117,0.000333,0.195,14,8190,455,585,128.361619,1,2
0,0,13,13,14,17,31,55,48,103,0.000333,0.170094,14,7143.95108,396.886171,510.28222,122.789837,1,2
0,0,14,14,13,17,30,56,49,105,0.000333,0.171741,12,6182.68215,343.482342,515.223513,117.592585,1,2
0,0,13,13,14,17,31,57,50,107,0.000333,0.1767,14,7421.386073,412.299226,530.099005,122.789837,1,2
0,0,14,14,13,17,30,58,51,109,0.000333,0.178284,18,9627.319349,534.851075,534.851075,117.592585,1,2
0,0,13,13,14,17,31,55,48,103,0.000333,0.170094,14,7143.95108,396.886171,510.28222,122.789837,1,2
0,0,14,14,13,17,30,56,49,105,0.000333,0.171741,12,6182.68215,343.482342,515.223513,117.592585,1,2
0,0,13,13,14,17,31,57,50,107,0.000333,0.1767,14,7421.386073,412.299226,530.099005,122.789837,1,2
0,0,14,14,13,17,30,58,51,109,0.000333,0.178284,18,9627.319349,534.851075,534.851075,117.592585,1,2
0,0,9,9,10,10,20,46,31,77,0.000333,0.110929,15,4991.82695,277.323719,332.788463,66.438562,1,2
0,0,10,10,11,10,21,49,32,81,0.000333,0.118593,15,5336.665669,296.481426,355.777711,71.273029,2,2
0,0,10,10,11,11,22,49,33,82,0.000333,0.121891,15,5485.100891,304.727827,365.673393,76.107496,2,2
0,0,12,12,13,14,27,57,38,95,0.000333,0.150571,12,5420.571752,301.142875,451.714313,101.408685,2,2
0,0,12,12,12,14,26,55,38,93,0.000333,0.145714,12,5245.690725,291.427263,437.140894,96.322519,2,2
0,0,11,11,13,13,26,53,36,89,0.000333,0.139446,12,5020.069619,278.892757,418.339135,96.211433,2,2
0,0,11,11,12,13,25,52,36,88,0.000333,0.13622,12,4903.912136,272.439563,408.659345,91.125266,2,2
0,0,14,14,13,14,27,55,38,93,0.000333,0.147402,12,5306.454452,294.803025,442.204538,101.408685,2,2
0,0,12,12,12,14,26,55,38,93,0.000333,0.145714,12,5245.690725,291.427263,437.140894,96.322519,2,2
0,0,12,12,11,14,25,53,38,91,0.000333,0.140864,10,4225.909133,234.77273,422.590913,91.356717,2,2
0,0,14,14,12,14,26,53,38,91,0.000333,0.14258,12,5132.880172,285.16001,427.740014,96.322519,2,2
0,0,11,11,12,13,25,52,36,88,0.000333,0.13622,12,4903.912136,272.439563,408.659345,91.125266,2,2
0,0,11,11,11,13,24,51,36,87,0.000333,0.132964,10,3988.917376,221.606521,398.891738,86.159464,2,2
0,0,14,14,15,11,26,57,33,90,0.000333,0.141013,21,8883.831067,493.54617,423.039575,96.657107,2,2
0,0,11,11,12,10,22,51,32,83,0.000333,0.123378,18,6662.390838,370.132824,370.132824,76.238831,2,2
0,0,10,10,13,12,25,54,36,90,0.000333,0.139316,18,7523.047027,417.947057,417.947057,91.125266,2,2
0,0,11,11,12,10,22,49,33,82,0.000333,0.121891,18,6582.121069,365.673393,365.673393,76.238831,1,2
0,0,11,11,10,11,21,52,37,89,0.000333,0.130305,15,5863.743759,325.763542,390.916251,71.273029,1,2
0,0,14,14,11,12,23,67,45,112,0.000333,0.16888,15,7599.584086,422.199116,506.638939,81.073298,1,2
0,0,16,16,14,16,30,62,49,111,0.000333,0.181555,21,11437.96198,635.442332,544.664856,117.302969,1,2
0,0,11,11,10,14,24,52,41,93,0.000333,0.142134,10,4264.015126,236.889729,426.401513,86.52225,1,2
0,0,11,11,11,13,24,61,41,102,0.000333,0.155889,15,7014.992626,389.721813,467.666175,86.159464,1,2
0,0,13,13,11,15,26,53,43,96,0.000333,0.150414,10,4512.422129,250.690118,451.242213,96.657107,1,2
0,0,11,11,10,14,24,52,41,93,0.000333,0.142134,10,4264.015126,236.889729,426.401513,86.52225,1,2
0,0,13,13,10,15,25,58,51,109,0.000333,0.168727,15,7592.70487,421.816937,506.180325,91.82264,1,2
0,0,15,15,10,16,26,64,61,125,0.000333,0.195852,15,8813.324472,489.629137,587.554965,97.219281,1,2
0,0,17,17,10,17,27,70,71,141,0.000333,0.22348,20,13408.78276,744.932375,670.439138,102.706149,1,2
0,0,12,12,11,15,26,58,44,102,0.000333,0.159815,10,4794.448513,266.358251,479.444851,96.657107,1,2
0,0,13,13,11,16,27,67,48,115,0.000333,0.182271,15,8202.180941,455.676719,546.812063,102.053748,1,2
0,0,11,11,10,15,25,60,45,105,0.000333,0.162535,15,7314.073499,406.337417,487.6049,91.82264,1,2
0,0,13,13,10,17,27,67,51,118,0.000333,0.187026,15,8416.150879,467.563938,561.076725,102.706149,1,2
0,0,17,17,14,18,32,65,62,127,0.000333,0.211667,21,13335,740.833333,635,128.361619,1,2
0,0,13,13,10,15,25,52,47,99,0.000333,0.153247,15,6896.126442,383.118136,459.741763,91.82264,1,2
0,0,12,12,14,17,31,59,48,107,0.000333,0.1767,14,7421.386073,412.299226,530.099005,122.789837,1,2
0,0,13,13,14,17,31,60,49,109,0.000333,0.180002,14,7560.10357,420.005754,540.007398,122.789837,1,2
0,0,9,9,10,10,20,48,33,81,0.000333,0.116692,15,5251.142635,291.730146,350.076176,66.438562,1,2
0,0,10,10,11,10,21,51,34,85,0.000333,0.124449,15,5600.204714,311.122484,373.346981,71.273029,2,2
0,0,10,10,11,11,22,51,35,86,0.000333,0.127837,15,5752.666788,319.592599,383.511119,76.107496,2,2
0,0,12,12,13,14,27,59,40,99,0.000333,0.156911,12,5648.806353,313.822575,470.733863,101.408685,2,2
0,0,12,12,12,14,26,57,40,97,0.000333,0.151981,12,5471.311832,303.961768,455.942653,96.322519,2,2
0,0,11,11,13,13,26,55,38,93,0.000333,0.145714,12,5245.690725,291.427263,437.140894,96.211433,2,2
0,0,11,11,12,13,25,54,38,92,0.000333,0.142412,12,5126.817234,284.82318,427.234769,91.125266,2,2
0,0,14,14,13,14,27,57,40,97,0.000333,0.153741,12,5534.689053,307.482725,461.224088,101.408685,2,2
0,0,12,12,12,14,26,57,40,97,0.000333,0.151981,12,5471.311832,303.961768,455.942653,96.322519,2,2
0,0,12,12,11,14,25,55,40,95,0.000333,0.147055,10,4411.66338,245.09241,441.166338,91.356717,2,2
0,0,14,14,12,14,26,55,40,95,0.000333,0.148847,12,5358.501279,297.694515,446.541773,96.322519,2,2
0,0,11,11,12,13,25,54,38,92,0.000333,0.142412,12,5126.817234,284.82318,427.234769,91.125266,2,2
0,0,11,11,11,13,24,53,38,91,0.000333,0.139077,10,4172.315876,231.795326,417.231588,86.159464,2,2
0,0,14,14,15,11,26,59,35,94,0.000333,0.14728,21,9278.668004,515.481556,441.841334,96.657107,2,2
0,0,11,11,12,10,22,53,34,87,0.000333,0.129324,18,6983.469915,387.970551,387.970551,76.238831,2,2
0,0,10,10,13,12,25,56,38,94,0.000333,0.145507,18,7857.404673,436.522482,436.522482,91.125266,2,2
0,0,11,11,12,10,22,51,35,86,0.000333,0.127837,18,6903.200146,383.511119,383.511119,76.238831,1,2
0,0,11,11,10,11,21,54,39,93,0.000333,0.136162,15,6127.282805,340.4046,408.48552,71.273029,1,2
0,0,14,14,11,12,23,69,47,116,0.000333,0.174911,15,7870.997804,437.277656,524.733187,81.073298,1,2
0,0,16,16,14,16,30,64,51,115,0.000333,0.188097,21,11850.14079,658.341155,564.292418,117.302969,1,2
0,0,11,11,10,14,24,54,43,97,0.000333,0.148247,15,6671.120439,370.617802,444.741363,86.52225,1,2
0,0,11,11,11,13,24,63,43,106,0.000333,0.162002,15,7290.090376,405.005021,486.006025,86.159464,1,2
0,0,13,13,11,15,26,55,45,100,0.000333,0.156681,15,7050.659577,391.70331,470.043972,96.657107,1,2
0,0,11,11,10,14,24,54,43,97,0.000333,0.148247,15,6671.120439,370.617802,444.741363,86.52225,1,2
0,0,13,13,10,15,25,60,53,113,0.000333,0.174919,15,7871.336242,437.296458,524.755749,91.82264,1,2
0,0,15,15,10,16,26,66,63,129,0.000333,0.202119,15,9095.350855,505.29727,606.356724,97.219281,1,2
0,0,17,17,10,17,27,72,73,145,0.000333,0.22982,20,13789.17376,766.065209,689.458688,102.706149,1,2
0,0,12,12,11,15,26,60,46,106,0.000333,0.166082,15,7473.699152,415.205508,498.24661,96.657107,1,2
0,0,13,13,11,16,27,69,50,119,0.000333,0.188611,15,8487.474191,471.526344,565.831613,102.053748,1,2
0,0,11,11,10,15,25,62,47,109,0.000333,0.168727,15,7592.70487,421.816937,506.180325,91.82264,1,2
0,0,13,13,10,17,27,69,53,122,0.000333,0.193365,15,8701.444129,483.413563,580.096275,102.706149,1,2
0,0,17,17,14,18,32,67,64,131,0.000333,0.218333,21,13755,764.166667,655,128.361619,1,2
0,0,13,13,10,15,25,54,49,103,0.000333,0.159439,15,7174.757813,398.597656,478.317188,91.82264,1,2
0,0,13,13,10,15,25,54,49,103,0.000333,0.159439,15,7174.757813,398.597656,478.317188,91.82264,1,2
0,0,13,13,14,17,31,62,51,113,0.000333,0.186608,21,11756.30785,653.128214,559.824183,122.789837,1,2
0,0,9,9,9,9,18,37,28,65,0.000333,0.090348,12,3252.541501,180.69675,271.045125,57.05865,1,2
0,0,10,10,10,9,19,40,29,69,0.000333,0.097702,15,4396.604976,244.255832,293.106998,61.748606,2,2
0,0,10,10,10,10,20,40,30,70,0.000333,0.100845,15,4538.0245,252.112472,302.534967,66.438562,2,2
0,0,12,12,12,13,25,48,35,83,0.000333,0.12848,12,4625.280765,256.960043,385.440064,91.125266,2,2
0,0,12,12,11,13,24,46,35,81,0.000333,0.123794,10,3713.819626,206.323313,371.381963,86.159464,2,2
0,0,11,11,12,12,24,44,33,77,0.000333,0.117681,12,4236.505351,235.361408,353.042113,86.0391,2,2
0,0,11,11,11,12,23,43,33,76,0.000333,0.114597,10,3437.907087,190.994838,343.790709,81.073298,2,2
0,0,14,14,12,13,25,46,35,81,0.000333,0.125384,12,4513.828216,250.768234,376.152351,91.125266,2,2
0,0,12,12,11,13,24,46,35,81,0.000333,0.123794,10,3713.819626,206.323313,371.381963,86.159464,2,2
0,0,12,12,10,13,23,44,35,79,0.000333,0.11912,10,3573.613945,198.534108,357.361395,81.324997,2,2
0,0,14,14,11,13,24,44,35,79,0.000333,0.120737,10,3622.120376,201.22891,362.212038,86.159464,2,2
0,0,11,11,11,12,23,43,33,76,0.000333,0.114597,10,3437.907087,190.994838,343.790709,81.073298,2,2
0,0,11,11,10,12,22,42,33,75,0.000333,0.111486,10,3344.573714,185.809651,334.457371,76.238831,2,2
0,0,14,14,14,10,24,48,30,78,0.000333,0.119209,21,7510.168576,417.231588,357.627075,86.52225,2,2
0,0,11,11,11,9,20,42,29,71,0.000333,0.102286,15,4602.853421,255.714079,306.856895,66.583073,2,2
0,0,10,10,12,11,23,45,33,78,0.000333,0.117613,18,6351.080986,352.837833,352.837833,81.073298,2,2
0,0,11,11,11,9,20,40,30,70,0.000333,0.100845,15,4538.0245,252.112472,302.534967,66.583073,1,2
0,0,11,11,9,10,19,43,34,77,0.000333,0.10903,12,3925.085022,218.060279,327.090419,61.748606,1,2
0,0,14,14,10,11,21,58,42,100,0.000333,0.146411,15,6588.476134,366.026452,439.231742,71.273029,1,2
0,0,16,16,13,15,28,53,46,99,0.000333,0.158643,18,8566.706471,475.928137,475.928137,106.709075,1,2
0,0,11,11,9,13,22,43,38,81,0.000333,0.120405,8,2889.711689,160.539538,361.213961,76.635041,1,2
0,0,11,11,10,12,22,52,38,90,0.000333,0.133783,15,6020.232685,334.457371,401.348846,76.238831,1,2
0,0,13,13,10,14,24,44,40,84,0.000333,0.128379,10,3851.368501,213.964917,385.13685,86.52225,1,2
0,0,11,11,9,13,22,43,38,81,0.000333,0.120405,8,2889.711689,160.539538,361.213961,76.635041,1,2
0,0,13,13,9,14,23,49,48,97,0.000333,0.146262,12,5265.426117,292.523673,438.78551,81.832294,1,2
0,0,15,15,9,15,24,55,58,113,0.000333,0.1727,12,6217.209151,345.400508,518.100763,87.132684,1,2
0,0,17,17,9,16,25,61,68,129,0.000333,0.199686,16,9584.919176,532.49551,599.057448,92.529325,1,2
0,0,12,12,10,14,24,49,41,90,0.000333,0.137549,10,4126.466251,229.248125,412.646625,86.52225,1,2
0,0,13,13,10,15,25,58,45,103,0.000333,0.159439,15,7174.757813,398.597656,478.317188,91.82264,1,2
0,0,11,11,9,14,23,51,42,93,0.000333,0.14023,12,5048.295143,280.460841,420.691262,81.832294,1,2
0,0,13,13,9,16,25,58,48,106,0.000333,0.164083,12,5906.985073,328.165837,492.248756,92.529325,1,2
0,0,17,17,13,17,30,56,59,115,0.000333,0.188097,18,10157.26353,564.292418,564.292418,117.592585,1,2
0,0,13,13,9,14,23,43,44,87,0.000333,0.131183,12,4722.598682,262.366593,393.54989,81.832294,1,2
0,0,12,12,13,16,29,50,45,95,0.000333,0.153836,12,5538.098334,307.67213,461.508195,112.105716,1,2
0,0,13,13,13,16,29,51,46,97,0.000333,0.157075,12,5654.689878,314.149438,471.224157,112.105716,1,2
0,0,9,9,9,9,18,39,30,69,0.000333,0.095908,12,3452.697901,191.81655,287.724825,57.05865,1,2
0,0,10,10,10,9,19,42,31,73,0.000333,0.103366,15,4651.480627,258.41559,310.098708,61.748606,2,2
0,0,10,10,10,10,20,42,32,74,0.000333,0.106608,15,4797.340185,266.518899,319.822679,66.438562,2,2
0,0,12,12,12,13,25,50,37,87,0.000333,0.134672,12,4848.185862,269.343659,404.015489,91.125266,2,2
0,0,12,12,11,13,24,48,37,85,0.000333,0.129907,10,3897.218126,216.512118,389.721813,86.159464,2,2
0,0,11,11,12,12,24,46,35,81,0.000333,0.123794,12,4456.583551,247.587975,371.381963,86.0391,2,2
0,0,11,11,11,12,23,45,35,80,0.000333,0.120628,10,3618.849565,201.047198,361.884956,81.073298,2,2
0,0,14,14,12,13,25,48,37,85,0.000333,0.131576,12,4736.733314,263.151851,394.727776,91.125266,2,2
0,0,12,12,11,13,24,48,37,85,0.000333,0.129907,10,3897.218126,216.512118,389.721813,86.159464,2,2
0,0,12,12,10,13,23,46,37,83,0.000333,0.125152,10,3754.556424,208.586468,375.455642,81.324997,2,2
0,0,14,14,11,13,24,46,37,83,0.000333,0.126851,10,3805.518876,211.417715,380.551888,86.159464,2,2
0,0,11,11,11,12,23,45,35,80,0.000333,0.120628,10,3618.849565,201.047198,361.884956,81.073298,2,2
0,0,11,11,10,12,22,44,35,79,0.000333,0.117432,10,3522.950979,195.719499,352.295098,76.238831,2,2
0,0,14,14,14,10,24,50,32,82,0.000333,0.125322,21,7895.305426,438.628079,375.966925,86.52225,2,2
0,0,11,11,11,9,20,44,31,75,0.000333,0.108048,15,4862.169107,270.120506,324.144607,66.583073,2,2
0,0,10,10,12,11,23,47,35,82,0.000333,0.123644,18,6676.777447,370.93208,370.93208,81.073298,2,2
0,0,11,11,11,9,20,42,32,74,0.000333,0.106608,15,4797.340185,266.518899,319.822679,66.583073,1,2
0,0,11,11,9,10,19,45,36,81,0.000333,0.114694,12,4128.985543,229.388086,344.082129,61.748606,1,2
0,0,14,14,10,11,21,60,44,104,0.000333,0.152267,20,9136.020239,507.55668,456.801012,71.273029,1,2
0,0,16,16,13,15,28,55,48,103,0.000333,0.165053,18,8912.836025,495.157557,495.157557,106.709075,1,2
0,0,11,11,9,13,22,45,40,85,0.000333,0.126351,12,4548.620251,252.701125,379.051688,76.635041,1,2
0,0,11,11,10,12,22,54,40,94,0.000333,0.139729,15,6287.798582,349.322143,419.186572,76.238831,1,2
0,0,13,13,10,14,24,46,42,88,0.000333,0.134492,15,6052.150501,336.230583,403.4767,86.52225,1,2
0,0,11,11,9,13,22,45,40,85,0.000333,0.126351,12,4548.620251,252.701125,379.051688,76.635041,1,2
0,0,13,13,9,14,23,51,50,101,0.000333,0.152293,12,5482.557091,304.586505,456.879758,81.832294,1,2
0,0,15,15,9,15,24,57,60,117,0.000333,0.178814,16,8583.049801,476.8361,536.440613,87.132684,1,2
0,0,17,17,9,16,25,63,70,133,0.000333,0.205878,16,9882.125972,549.006998,617.632873,92.529325,1,2
0,0,12,12,10,14,24,51,43,94,0.000333,0.143662,15,6464.797126,359.155396,430.986475,86.52225,1,2
0,0,13,13,10,15,25,60,47,107,0.000333,0.165631,15,7453.389185,414.077177,496.892612,91.82264,1,2
0,0,11,11,9,14,23,53,44,97,0.000333,0.146262,12,5265.426117,292.523673,438.78551,81.832294,1,2
0,0,13,13,9,16,25,60,50,110,0.000333,0.170275,12,6129.890171,340.549454,510.824181,92.529325,1,2
0,0,17,17,13,17,30,58,61,119,0.000333,0.19464,18,10510.55966,583.919981,583.919981,117.592585,1,2
0,0,13,13,9,14,23,45,46,91,0.000333,0.137215,12,4939.729656,274.429425,411.644138,81.832294,1,2
0,0,12,12,13,16,29,52,47,99,0.000333,0.160313,12,5771.281422,320.626746,480.940119,112.105716,1,2
0,0,13,13,13,16,29,53,48,101,0.000333,0.163552,18,8831.809449,490.656081,490.656081,112.105716,1,2
0,0,10,10,14,14,28,41,29,70,0.000333,0.112172,14,4711.207824,261.733768,336.514845,106.605938,4,2
0,0,12,12,14,14,28,47,31,78,0.000333,0.124991,14,5249.631575,291.646199,374.973684,106.605938,6,2
0,0,12,12,14,15,29,47,33,80,0.000333,0.129546,14,5440.938715,302.274373,388.63848,111.906328,6,2
0,0,14,14,16,16,32,55,37,92,0.000333,0.153333,16,7360,408.888889,460,128,6,2
0,0,14,14,15,16,31,53,37,90,0.000333,0.148626,14,6242.287351,346.793742,445.877668,122.603359,6,2
0,0,13,13,16,16,32,51,36,87,0.000333,0.145,16,6960,386.666667,435,128,6,2
0,0,13,13,15,16,31,50,36,86,0.000333,0.14202,14,5964.852358,331.380687,426.060883,122.603359,6,2
0,0,16,16,16,16,32,53,37,90,0.000333,0.15,16,7200,400,450,128,6,2
0,0,14,14,15,16,31,53,37,90,0.000333,0.148626,14,6242.287351,346.793742,445.877668,122.603359,6,2
0,0,14,14,14,16,30,51,37,88,0.000333,0.143935,14,6045.289214,335.849401,431.806372,117.302969,6,2
0,0,16,16,15,16,31,51,37,88,0.000333,0.145323,14,6103.569854,339.087214,435.969275,122.603359,6,2
0,0,13,13,15,16,31,50,36,86,0.000333,0.14202,14,5964.852358,331.380687,426.060883,122.603359,6,2
0,0,13,13,14,16,30,49,36,85,0.000333,0.139029,14,5839.199809,324.399989,417.085701,117.302969,6,2
0,0,20,20,18,16,34,63,33,96,0.000333,0.162799,18,8791.13579,488.396433,488.396433,139.05865,6,2
0,0,14,14,15,14,29,51,31,82,0.000333,0.132785,14,5576.962182,309.831232,398.354442,111.906328,6,2
0,0,12,12,17,16,33,57,39,96,0.000333,0.161421,16,7748.189367,430.454965,484.261835,133.486868,6,2
0,0,14,14,16,16,32,47,33,80,0.000333,0.133333,16,6400,355.555556,400,128,4,2
0,0,14,14,15,17,32,52,38,90,0.000333,0.15,14,6300,350,450,128.090227,5,2
0,0,14,14,14,20,34,51,50,101,0.000333,0.171278,14,7193.672458,399.64847,513.833747,139.741531,5,2
0,0,12,12,14,15,29,45,35,80,0.000333,0.129546,14,5440.938715,302.274373,388.63848,111.906328,4,2
0,0,15,15,16,16,32,58,43,101,0.000333,0.168333,16,8080,448.888889,505,128,4,2
0,0,17,17,17,21,38,54,49,103,0.000333,0.180179,16,8648.584542,480.476919,540.536534,161.725534,4,2
0,0,12,12,15,16,31,47,35,82,0.000333,0.135415,14,5687.417364,315.967631,406.244097,122.603359,4,2
0,0,12,12,15,15,30,48,36,84,0.000333,0.137393,14,5770.50334,320.583519,412.17881,117.206718,4,2
0,0,13,13,16,17,33,54,39,93,0.000333,0.156376,16,7506.05845,417.003247,469.128653,133.486868,4,2
0,0,14,14,15,20,35,47,43,90,0.000333,0.153878,14,6462.896601,359.049811,461.635472,145.041921,4,2
0,0,12,12,14,19,33,46,41,87,0.000333,0.146287,14,6144.072037,341.337335,438.862288,134.013592,4,2
0,0,14,14,14,20,34,51,53,104,0.000333,0.176365,14,7407.345897,411.519216,529.096135,139.741531,4,2
0,0,16,16,14,21,35,56,65,121,0.000333,0.206881,21,13033.50815,724.083786,620.643245,145.541635,4,2
0,0,18,18,14,22,36,61,77,138,0.000333,0.237817,21,14982.44265,832.357925,713.44965,151.410465,4,2
0,0,12,12,14,18,32,47,42,89,0.000333,0.148333,14,6230,346.111111,445,128.361619,4,2
0,0,13,13,16,20,36,51,44,95,0.000333,0.163714,16,7858.286002,436.571445,491.142875,150.438562,4,2
0,0,14,14,16,21,37,59,48,107,0.000333,0.185804,16,8918.584162,495.476898,557.41151,156.238666,4,2
0,0,13,13,15,20,35,53,45,98,0.000333,0.167557,14,7037.376299,390.96535,502.669736,145.041921,4,2
0,0,15,15,14,22,36,59,51,110,0.000333,0.189564,14,7961.684502,442.315806,568.69175,151.410465,4,2
0,0,18,18,17,23,40,58,66,124,0.000333,0.219973,16,10558.70534,586.594741,659.919084,173.528793,4,2
0,0,14,14,14,20,34,46,49,95,0.000333,0.161103,14,6766.325579,375.906977,483.30897,139.741531,4,2
0,0,13,13,18,22,40,53,49,102,0.000333,0.180946,18,9771.059982,542.836666,542.836666,173.166146,4,2
0,0,14,14,19,22,41,54,50,104,0.000333,0.185728,18,10029.33735,557.185408,557.185408,178.818118,4,2
0,0,7,7,15,15,30,45,30,75,0.000333,0.122672,14,5152.235125,286.235285,368.016795,117.206718,4,2
0,0,7,7,15,15,30,45,30,75,0.000333,0.122672,14,5152.235125,286.235285,368.016795,117.206718,4,2
0,0,7,7,15,15,30,45,30,75,0.000333,0.122672,14,5152.235125,286.235285,368.016795,117.206718,4,2
0,0,7,7,15,15,30,45,30,75,0.000333,0.122672,14,5152.235125,286.235285,368.016795,117.206718,4,2
0,0,7,7,15,15,30,45,30,75,0.000333,0.122672,14,5152.235125,286.235285,368.016795,117.206718,4,2
0,0,7,7,15,15,30,45,30,75,0.000333,0.122672,14,5152.235125,286.235285,368.016795,117.206718,4,2
0,0,7,7,15,15,30,45,30,75,0.000333,0.122672,14,5152.235125,286.235285,368.016795,117.206718,4,2
0,0,7,7,15,15,30,45,30,75,0.000333,0.122672,14,5152.235125,286.235285,368.016795,117.206718,4,2
0,0,7,7,15,15,30,45,30,75,0.000333,0.122672,14,5152.235125,286.235285,368.016795,117.206718,4,2
0,0,7,7,15,15,30,45,30,75,0.000333,0.122672,14,5152.235125,286.235285,368.016795,117.206718,4,2
0,0,7,7,15,15,30,45,30,75,0.000333,0.122672,14,5152.235125,286.235285,368.016795,117.206718,4,2
0,0,7,7,15,15,30,45,30,75,0.000333,0.122672,14,5152.235125,286.235285,368.016795,117.206718,4,2
0,0,7,7,15,15,30,45,30,75,0.000333,0.122672,14,5152.235125,286.235285,368.016795,117.206718,4,2
0,0,7,7,15,15,30,45,30,75,0.000333,0.122672,14,5152.235125,286.235285,368.016795,117.206718,4,2
0,0,7,7,15,15,30,45,30,75,0.000333,0.122672,14,5152.235125,286.235285,368.016795,117.206718,4,2
0,0,7,7,15,15,30,45,30,75,0.000333,0.122672,14,5152.235125,286.235285,368.016795,117.206718,4,2
0,0,7,7,15,15,30,45,30,75,0.000333,0.122672,14,5152.235125,286.235285,368.016795,117.206718,4,2
0,0,7,7,15,15,30,45,30,75,0.000333,0.122672,14,5152.235125,286.235285,368.016795,117.206718,4,2
0,0,10,10,17,16,33,54,38,92,0.000333,0.154695,16,7425.348144,412.519341,464.084259,133.486868,4,2
0,0,7,7,15,15,30,45,30,75,0.000333,0.122672,14,5152.235125,286.235285,368.016795,117.206718,4,2
0,0,7,7,15,15,30,45,30,75,0.000333,0.122672,14,5152.235125,286.235285,368.016795,117.206718,4,2
0,0,7,7,15,15,30,45,30,75,0.000333,0.122672,14,5152.235125,286.235285,368.016795,117.206718,4,2
0,0,14,14,19,20,39,56,47,103,0.000333,0.181465,18,9799.135714,544.396429,544.396429,167.149185,4,2
0,0,9,9,15,18,33,48,39,87,0.000333,0.146287,14,6144.072037,341.337335,438.862288,133.662009,4,2
0,0,10,10,17,16,33,54,38,92,0.000333,0.154695,16,7425.348144,412.519341,464.084259,133.486868,4,2
0,0,10,10,16,18,34,58,40,98,0.000333,0.16619,16,7977.141735,443.174541,498.571358,139.05865,4,2
0,0,10,10,15,19,34,50,40,90,0.000333,0.152624,14,6410.20318,356.122399,457.871656,139.313982,4,2
0,0,9,9,15,19,34,50,40,90,0.000333,0.152624,14,6410.20318,356.122399,457.871656,139.313982,4,2
0,0,11,11,15,20,35,56,50,106,0.000333,0.181235,14,7611.855997,422.880889,543.704,145.041921,4,2
0,0,13,13,15,21,36,60,60,120,0.000333,0.206797,14,8685.474002,482.526333,620.391,150.842025,4,2
0,0,15,15,15,22,37,65,70,135,0.000333,0.234425,21,14768.80029,820.488905,703.276204,156.710855,4,2
0,0,10,10,16,18,34,53,42,95,0.000333,0.161103,16,7732.943519,429.607973,483.30897,139.05865,4,2
0,0,10,10,16,20,36,55,43,98,0.000333,0.168884,16,8106.442402,450.357911,506.65265,150.438562,4,2
0,0,11,11,16,21,37,63,47,110,0.000333,0.191013,16,9168.637924,509.368774,573.03987,156.238666,4,2
0,0,10,10,15,20,35,57,44,101,0.000333,0.172686,14,7252.806186,402.933677,518.057585,145.041921,4,2
2,0,30,32,21,37,58,146,123,269,0.000333,0.525266,30,47273.90663,2626.328146,1575.796888,284.98844,7,2
0,0,11,11,15,20,35,50,46,96,0.000333,0.164137,14,6893.756375,382.986465,492.41117,145.041921,4,2
0,0,11,11,20,22,42,58,49,107,0.000333,0.192326,20,11539.55929,641.086627,576.977964,184.546058,4,2
0,0,8,8,15,15,30,46,29,75,0.000333,0.122672,7,2576.117563,143.117642,368.016795,117.206718,3,2
0,0,8,8,18,12,30,44,26,70,0.000333,0.114494,18,6182.68215,343.482342,343.482342,118.0782,3,2
0,0,9,9,15,15,30,49,30,79,0.000333,0.129215,14,5427.020999,301.501167,387.644357,117.206718,4,2
0,0,11,11,17,17,34,57,36,93,0.000333,0.157711,16,7570.144708,420.563595,473.134044,138.973737,4,2
0,0,11,11,16,17,33,55,36,91,0.000333,0.153013,16,7344.637838,408.035435,459.039865,133.486868,4,2
0,0,9,9,17,16,33,49,31,80,0.000333,0.134517,8,3228.412236,179.356235,403.55153,133.486868,4,2
0,0,10,10,16,17,33,52,34,86,0.000333,0.144606,16,6941.086308,385.615906,433.817894,133.486868,4,2
0,0,14,14,19,17,36,57,36,93,0.000333,0.160268,18,8654.454452,480.803025,480.803025,150.197491,4,2
0,0,11,11,17,17,34,56,36,92,0.000333,0.156016,16,7488.745302,416.041406,468.046581,138.973737,4,2
0,0,11,11,15,17,32,53,36,89,0.000333,0.148333,14,6230,346.111111,445,128.090227,4,2
0,0,14,14,17,17,34,54,36,90,0.000333,0.152624,16,7325.946491,406.997027,457.871656,138.973737,4,2
0,0,11,11,17,18,35,54,34,88,0.000333,0.150459,8,3611.015244,200.611958,451.376905,144.545518,4,2
0,0,11,11,17,19,36,56,36,92,0.000333,0.158544,8,3805.064801,211.392489,475.6331,150.197491,4,2
0,0,10,10,15,17,32,51,34,85,0.000333,0.141667,14,5950,330.555556,425,128.090227,4,2
0,0,13,13,20,16,36,57,31,88,0.000333,0.151651,10,4549.534001,252.751889,454.9534,150.438562,4,2
0,0,10,10,17,15,32,51,30,81,0.000333,0.135,16,6480,360,405,128.090227,4,2
0,0,9,9,15,15,30,54,34,88,0.000333,0.143935,14,6045.289214,335.849401,431.806372,117.206718,4,2
0,0,10,10,17,16,33,49,31,80,0.000333,0.134517,8,3228.412236,179.356235,403.55153,133.486868,3,2
0,0,14,14,17,17,34,63,43,106,0.000333,0.179757,16,8628.336979,479.352054,539.271061,138.973737,4,2
0,0,13,13,16,19,35,59,48,107,0.000333,0.182944,16,8781.332525,487.851807,548.833283,144.710623,4,2
0,0,13,13,16,17,33,63,43,106,0.000333,0.178235,16,8555.292426,475.294024,534.705777,133.486868,3,2
0,0,15,15,19,21,40,59,47,106,0.000333,0.188041,18,10154.23881,564.124378,564.124378,172.949289,3,2
0,0,10,10,15,19,34,51,39,90,0.000333,0.152624,14,6410.20318,356.122399,457.871656,139.313982,3,2
0,0,11,11,17,16,33,55,37,92,0.000333,0.154695,16,7425.348144,412.519341,464.084259,133.486868,3,2
0,0,11,11,16,18,34,59,39,98,0.000333,0.16619,16,7977.141735,443.174541,498.571358,139.05865,3,2
0,0,12,12,16,20,36,52,41,93,0.000333,0.160268,16,7692.848402,427.380467,480.803025,150.438562,3,2
0,0,10,10,15,19,34,51,39,90,0.000333,0.152624,14,6410.20318,356.122399,457.871656,139.313982,3,2
0,0,12,12,15,20,35,56,49,105,0.000333,0.179525,14,7540.046035,418.891446,538.574717,145.041921,3,2
0,0,14,14,15,21,36,61,59,120,0.000333,0.206797,14,8685.474002,482.526333,620.391,150.842025,3,2
0,0,16,16,15,22,37,66,69,135,0.000333,0.234425,21,14768.80029,820.488905,703.276204,156.710855,3,2
0,0,11,11,16,18,34,54,41,95,0.000333,0.161103,16,7732.943519,429.607973,483.30897,139.05865,3,2
0,0,11,11,16,20,36,56,42,98,0.000333,0.168884,16,8106.442402,450.357911,506.65265,150.438562,3,2
0,0,12,12,16,21,37,64,46,110,0.000333,0.191013,16,9168.637924,509.368774,573.03987,156.238666,3,2
0,0,11,11,15,20,35,58,43,101,0.000333,0.172686,14,7252.806186,402.933677,518.057585,145.041921,3,2
0,0,13,13,15,22,37,64,49,113,0.000333,0.196223,14,8241.355224,457.853068,588.66823,156.710855,3,2
0,0,16,16,19,23,42,63,60,123,0.000333,0.221085,18,11938.59077,663.255043,663.255043,184.752548,3,2
0,0,12,12,15,20,35,51,45,96,0.000333,0.164137,14,6893.756375,382.986465,492.41117,145.041921,3,2
0,0,6,6,15,10,25,37,21,58,0.000333,0.089781,14,3770.811226,209.489513,269.343659,91.82264,2,2
0,0,7,7,16,10,26,40,22,62,0.000333,0.097142,16,4662.8362,259.046456,291.427263,97.219281,3,2
0,0,7,7,16,11,27,40,23,63,0.000333,0.099853,16,4792.926602,266.2737,299.557913,102.053748,3,2
0,0,9,9,18,12,30,48,28,76,0.000333,0.124308,18,6712.626335,372.923685,372.923685,118.0782,3,2
0,0,9,9,17,12,29,46,28,74,0.000333,0.11983,16,5751.849498,319.547194,359.490594,112.506418,3,2
0,0,8,8,18,12,30,44,26,70,0.000333,0.114494,18,6182.68215,343.482342,343.482342,118.0782,3,2
0,0,8,8,17,12,29,43,26,69,0.000333,0.111734,16,5363.211019,297.956168,335.200689,112.506418,3,2
0,0,11,11,18,12,30,46,28,74,0.000333,0.121037,18,6535.978273,363.109904,363.109904,118.0782,3,2
0,0,9,9,17,12,29,46,28,74,0.000333,0.11983,16,5751.849498,319.547194,359.490594,112.506418,3,2
0,0,9,9,16,12,28,44,28,72,0.000333,0.115377,16,5538.07287,307.670715,346.129554,107.01955,3,2
0,0,8,8,17,12,29,43,26,69,0.000333,0.111734,16,5363.211019,297.956168,335.200689,112.506418,3,2
0,0,8,8,16,12,28,42,26,68,0.000333,0.108967,16,5230.402155,290.577898,326.900135,107.01955,3,2
0,0,11,11,20,11,31,48,23,71,0.000333,0.117249,20,7034.958761,390.831042,351.747938,124.49231,3,2
0,0,8,8,17,10,27,42,22,64,0.000333,0.101438,16,4869.004802,270.500267,304.3128,102.706149,3,2
0,0,7,7,15,10,25,45,26,71,0.000333,0.109905,14,4615.993053,256.444058,329.713789,91.82264,3,2
0,0,8,8,17,11,28,40,23,63,0.000333,0.100954,16,4845.813761,269.211876,302.86336,107.540616,2,2
0,0,11,11,17,14,31,50,40,90,0.000333,0.148626,16,7134.042687,396.335705,445.877668,122.789837,3,2
0,0,7,7,15,11,26,39,25,64,0.000333,0.100276,14,4211.593987,233.977444,300.828142,96.657107,2,2
0,0,10,10,15,12,27,52,33,85,0.000333,0.134722,14,5658.316128,314.350896,404.165438,101.622909,2,2
0,0,11,11,19,16,35,45,33,78,0.000333,0.133361,18,7201.513356,400.084075,400.084075,144.710623,2,2
0,0,7,7,15,14,29,40,29,69,0.000333,0.111734,14,4692.809641,260.711647,335.200689,111.906328,2,2
0,0,8,8,17,11,28,44,27,71,0.000333,0.113774,16,5461.155191,303.397511,341.322199,107.540616,2,2
0,0,8,8,16,13,29,48,29,77,0.000333,0.124688,16,5985.032586,332.50181,374.064537,112.105716,2,2
0,0,9,9,16,15,31,41,31,72,0.000333,0.118901,16,5707.23415,317.068564,356.702134,122.603359,2,2
0,0,7,7,15,14,29,40,29,69,0.000333,0.111734,14,4692.809641,260.711647,335.200689,111.906328,2,2
0,0,9,9,15,15,30,45,39,84,0.000333,0.137393,14,5770.50334,320.583519,412.17881,117.206718,2,2
0,0,11,11,15,16,31,50,49,99,0.000333,0.163488,21,10299.77413,572.209674,490.465435,122.603359,2,2
0,0,13,13,15,17,32,55,59,114,0.000333,0.19,21,11970,665,570,128.090227,2,2
0,0,8,8,16,13,29,43,31,74,0.000333,0.11983,16,5751.849498,319.547194,359.490594,112.105716,2,2
0,0,8,8,15,15,30,45,32,77,0.000333,0.125944,14,5289.628062,293.868226,377.830576,117.206718,2,2
0,0,9,9,15,16,31,53,36,89,0.000333,0.146974,14,6172.928603,342.940478,440.923472,122.603359,2,2
0,0,8,8,15,15,30,47,33,80,0.000333,0.13085,14,5495.717467,305.317637,392.551248,117.206718,2,2
0,0,10,10,15,17,32,53,39,92,0.000333,0.153333,14,6440,357.777778,460,128.090227,2,2
0,0,9,9,15,15,30,40,35,75,0.000333,0.122672,14,5152.235125,286.235285,368.016795,117.206718,2,2
0,0,8,8,13,14,27,46,30,76,0.000333,0.120457,12,4336.457402,240.9143,361.37145,101.408685,2,2
0,0,10,10,17,14,31,53,30,83,0.000333,0.137066,16,6579.1727,365.509594,411.198294,122.789837,5,2
0,0,10,10,18,15,33,55,31,86,0.000333,0.144606,18,7808.722097,433.817894,433.817894,133.662009,5,2
0,0,10,10,17,16,33,56,35,91,0.000333,0.153013,16,7344.637838,408.035435,459.039865,133.486868,3,2
0,0,12,12,18,16,34,59,36,95,0.000333,0.161103,18,8699.561459,483.30897,483.30897,139.05865,5,2
0,0,9,9,16,16,32,51,33,84,0.000333,0.14,16,6720,373.333333,420,128,3,2
0,0,9,9,16,16,32,51,33,84,0.000333,0.14,16,6720,373.333333,420,128,3,2
0,0,12,12,17,16,33,54,35,89,0.000333,0.14965,16,7183.217226,399.067624,448.951077,133.486868,3,2
0,0,10,10,15,16,31,53,35,88,0.000333,0.145323,14,6103.569854,339.087214,435.969275,122.603359,3,2
0,0,10,10,15,16,31,52,35,87,0.000333,0.143672,14,6034.211106,335.23395,431.015079,122.603359,3,2
0,0,12,12,15,16,31,51,35,86,0.000333,0.14202,14,5964.852358,331.380687,426.060883,122.603359,3,2
0,0,9,9,16,16,32,51,33,84,0.000333,0.14,16,6720,373.333333,420,128,3,2
0,0,9,9,14,16,30,49,33,82,0.000333,0.134122,14,5633.110404,312.950578,402.365029,117.302969,3,2
0,0,12,12,18,15,33,55,30,85,0.000333,0.142925,18,7717.923003,428.7735,428.7735,133.662009,3,2
0,0,9,9,15,14,29,49,29,78,0.000333,0.126308,14,5304.915247,294.717514,378.922518,111.906328,3,2
0,0,8,8,13,14,27,52,33,85,0.000333,0.134722,12,4849.985252,269.443625,404.165438,101.408685,3,2
0,0,9,9,15,15,30,47,30,77,0.000333,0.125944,14,5289.628062,293.868226,377.830576,117.206718,2,2
0,0,13,13,17,16,33,62,42,104,0.000333,0.174872,16,8393.871815,466.326212,524.616988,133.486868,3,2
0,0,12,12,15,18,33,57,47,104,0.000333,0.174872,14,7344.637838,408.035435,524.616988,133.662009,3,2
0,0,9,9,13,15,28,48,34,82,0.000333,0.131401,12,4730.437243,262.802069,394.203104,106.709075,2,2
0,0,12,12,14,16,30,61,42,103,0.000333,0.16847,14,7075.736239,393.096458,505.409731,117.302969,2,2
0,0,14,14,17,20,37,57,46,103,0.000333,0.178858,16,8585.179147,476.954397,536.573697,155.92543,2,2
0,0,9,9,13,18,31,49,38,87,0.000333,0.143672,12,5172.180948,287.343386,431.015079,123.164366,2,2
0,0,10,10,15,15,30,53,36,89,0.000333,0.145571,14,6113.985682,339.665871,436.713263,117.206718,2,2
0,0,10,10,14,17,31,57,38,95,0.000333,0.156883,14,6589.081093,366.060061,470.648649,122.789837,2,2
0,0,11,11,14,19,33,50,40,90,0.000333,0.151332,14,6355.93659,353.107588,453.995471,134.013592,2,2
0,0,9,9,13,18,31,49,38,87,0.000333,0.143672,12,5172.180948,287.343386,431.015079,123.164366,2,2
0,0,11,11,13,19,32,54,48,102,0.000333,0.17,12,6120,340,510,128.816339,2,2
0,0,13,13,13,20,33,59,58,117,0.000333,0.196731,12,7082.329344,393.462741,590.194112,134.544278,2,2
0,0,15,15,13,21,34,64,68,132,0.000333,0.223848,18,12087.81171,671.545095,671.545095,140.344382,2,2
0,0,10,10,14,17,31,52,40,92,0.000333,0.151929,14,6381.004848,354.500269,455.786061,122.789837,2,2
0,0,10,10,14,19,33,54,41,95,0.000333,0.159739,14,6709.044179,372.724677,479.217441,134.013592,2,2
0,0,11,11,14,20,34,62,45,107,0.000333,0.181453,14,7621.019336,423.389963,544.358524,139.741531,2,2
0,0,10,10,13,19,32,56,42,98,0.000333,0.163333,12,5880,326.666667,490,128.816339,2,2
0,0,12,12,13,21,34,62,48,110,0.000333,0.18654,12,6715.45095,373.080608,559.620913,140.344382,2,2
0,0,15,15,17,22,39,61,59,120,0.000333,0.211416,16,10147.97226,563.776237,634.248266,167.594364,2,2
0,0,11,11,13,19,32,49,44,93,0.000333,0.155,12,5580,310,465,128.816339,2,2
0,0,10,10,17,21,38,56,45,101,0.000333,0.17668,16,8480.650862,471.14727,530.040679,161.725534,2,2
0,0,11,11,17,21,38,57,46,103,0.000333,0.180179,16,8648.584542,480.476919,540.536534,161.725534,2,2
0,0,11,11,18,22,40,59,47,106,0.000333,0.188041,18,10154.23881,564.124378,564.124378,173.166146,2,2
0,0,12,12,17,22,39,60,48,108,0.000333,0.190274,16,9133.175034,507.398613,570.82344,167.594364,2,2
0,0,11,11,20,22,42,59,46,105,0.000333,0.188731,20,11323.86659,629.103699,566.193329,184.546058,3,2
0,0,12,12,19,22,41,60,47,107,0.000333,0.191086,18,10318.64516,573.258064,573.258064,178.818118,3,2
0,0,11,11,18,22,40,59,47,106,0.000333,0.188041,18,10154.23881,564.124378,564.124378,173.166146,2,2
0,0,12,12,17,22,39,60,48,108,0.000333,0.190274,16,9133.175034,507.398613,570.82344,167.594364,2,2
0,0,7,7,12,12,24,33,23,56,0.000333,0.085586,6,1540.5474,85.585967,256.7579,86.0391,2,2
0,0,9,9,12,12,24,41,25,66,0.000333,0.100869,12,3631.290301,201.73835,302.607525,86.0391,4,2
0,0,9,9,12,13,25,39,27,66,0.000333,0.102165,12,3677.934102,204.329672,306.494509,91.125266,4,2
0,0,11,11,14,14,28,47,31,78,0.000333,0.124991,14,5249.631575,291.646199,374.973684,106.605938,4,2
0,0,11,11,13,14,27,45,31,76,0.000333,0.120457,12,4336.457402,240.9143,361.37145,101.408685,4,2
0,0,12,12,16,15,31,49,34,83,0.000333,0.137066,16,6579.1727,365.509594,411.198294,122.603359,6,2
0,0,10,10,13,14,27,42,30,72,0.000333,0.114117,12,4108.222802,228.2346,342.3519,101.408685,4,2
0,0,13,13,14,14,28,45,31,76,0.000333,0.121786,14,5115.025637,284.168091,365.358974,106.605938,4,2
0,0,11,11,13,14,27,45,31,76,0.000333,0.120457,12,4336.457402,240.9143,361.37145,101.408685,4,2
0,0,11,11,12,14,26,43,31,74,0.000333,0.115944,12,4173.99047,231.888359,347.832539,96.322519,4,2
0,0,14,14,13,14,27,44,31,75,0.000333,0.118872,12,4279.398752,237.744375,356.616563,101.408685,4,2
0,0,10,10,13,14,27,42,30,72,0.000333,0.114117,12,4108.222802,228.2346,342.3519,101.408685,4,2
0,0,10,10,12,14,26,41,30,71,0.000333,0.111244,12,4004.77464,222.48748,333.73122,96.322519,4,2
0,0,17,17,17,14,31,55,27,82,0.000333,0.135415,8,3249.95278,180.552932,406.244097,122.789837,4,2
0,0,11,11,14,12,26,43,25,68,0.000333,0.106543,14,4474.818612,248.601034,319.629901,96.322519,4,2
0,0,9,9,15,14,29,49,33,82,0.000333,0.132785,14,5576.962182,309.831232,398.354442,111.906328,4,2
0,0,11,11,14,14,28,39,27,66,0.000333,0.105762,7,2220.997974,123.388776,317.285425,106.605938,2,2
0,0,12,12,13,15,28,47,35,82,0.000333,0.131401,12,4730.437243,262.802069,394.203104,106.709075,3,2
0,0,11,11,12,18,30,43,44,87,0.000333,0.1423,12,5122.793782,284.599655,426.899482,118.0782,3,2
0,0,9,9,12,13,25,37,29,66,0.000333,0.102165,12,3677.934102,204.329672,306.494509,91.125266,2,2
0,0,12,12,14,14,28,50,37,87,0.000333,0.139413,14,5855.358295,325.297683,418.239878,106.605938,2,2
0,0,14,14,15,19,34,46,43,89,0.000333,0.150928,14,6338.9787,352.165483,452.784193,139.313982,2,2
0,0,9,9,13,14,27,39,29,68,0.000333,0.107777,12,3879.988202,215.5549,323.33235,101.408685,2,2
0,0,10,10,14,13,27,42,31,73,0.000333,0.115702,14,4859.495027,269.971946,347.106788,101.408685,2,2
0,0,10,10,14,15,29,46,33,79,0.000333,0.127927,14,5372.926981,298.495943,383.780499,111.906328,2,2
0,0,11,11,13,18,31,39,37,76,0.000333,0.125506,12,4518.227035,251.012613,376.51892,123.164366,2,2
0,0,9,9,12,17,29,38,35,73,0.000333,0.118211,12,4255.591352,236.421742,354.632613,112.506418,2,2
0,0,11,11,12,18,30,43,47,90,0.000333,0.147207,12,5299.441843,294.413436,441.620154,118.0782,2,2
0,0,13,13,12,19,31,48,59,107,0.000333,0.1767,18,9541.782094,530.099005,530.099005,123.730173,2,2
0,0,15,15,12,20,32,53,71,124,0.000333,0.206667,18,11160,620,620,129.458112,2,2
0,0,10,10,13,16,29,41,37,78,0.000333,0.126308,12,4547.070211,252.615012,378.922518,112.105716,2,2
0,0,10,10,14,18,32,43,38,81,0.000333,0.135,14,5670,315,405,128.361619,2,2
0,0,11,11,14,19,33,51,42,93,0.000333,0.156376,14,6567.801143,364.877841,469.128653,134.013592,2,2
0,0,10,10,13,18,31,45,39,84,0.000333,0.138717,12,4993.829881,277.434993,416.15249,123.164366,2,2
0,0,12,12,12,20,32,51,45,96,0.000333,0.16,12,5760,320,480,129.458112,2,2
0,0,15,15,15,21,36,50,60,110,0.000333,0.189564,14,7961.684502,442.315806,568.69175,150.842025,2,2
0,0,11,11,12,18,30,38,43,81,0.000333,0.132486,12,4769.497659,264.972092,397.458138,118.0782,2,2
0,0,10,10,16,20,36,45,43,88,0.000333,0.151651,16,7279.254402,404.403022,454.9534,150.438562,2,2
0,0,11,11,17,20,37,46,44,90,0.000333,0.156284,16,7501.612847,416.756269,468.850803,155.92543,2,2
0,0,7,7,13,13,26,33,22,55,0.000333,0.086175,6,1551.145107,86.174728,258.524184,96.211433,3,2
0,0,10,10,16,13,29,48,26,74,0.000333,0.11983,16,5751.849498,319.547194,359.490594,112.105716,6,2
0,0,9,9,13,14,27,41,26,67,0.000333,0.106192,6,1911.464776,106.192488,318.577463,101.408685,5,2
0,0,11,11,15,15,30,49,30,79,0.000333,0.129215,14,5427.020999,301.501167,387.644357,117.206718,5,2
0,0,11,11,14,15,29,45,30,75,0.000333,0.12145,14,5100.880045,283.382225,364.348575,111.906328,5,2
0,0,10,10,15,15,30,43,29,72,0.000333,0.117765,7,2473.07286,137.392937,353.296123,117.206718,5,2
0,0,10,10,14,15,29,42,29,71,0.000333,0.114972,7,2414.416555,134.134253,344.916651,111.906328,5,2
0,0,13,13,15,15,30,45,30,75,0.000333,0.122672,14,5152.235125,286.235285,368.016795,117.206718,5,2
0,0,11,11,14,15,29,45,30,75,0.000333,0.12145,14,5100.880045,283.382225,364.348575,111.906328,5,2
0,0,11,11,13,15,28,43,30,73,0.000333,0.116979,12,4211.242912,233.95794,350.936909,106.709075,5,2
0,0,13,13,14,15,29,43,30,73,0.000333,0.118211,14,4964.856577,275.825365,354.632613,111.906328,5,2
0,0,10,10,14,15,29,42,29,71,0.000333,0.114972,7,2414.416555,134.134253,344.916651,111.906328,5,2
0,0,10,10,13,15,28,41,29,70,0.000333,0.112172,6,2019.089067,112.171615,336.514845,106.709075,5,2
0,0,17,17,18,15,33,55,26,81,0.000333,0.136199,9,3677.363313,204.297962,408.595924,133.662009,5,2
0,0,12,12,15,14,29,44,26,70,0.000333,0.113353,7,2380.410688,132.245038,340.05867,111.906328,5,2
0,0,9,9,16,15,31,49,32,81,0.000333,0.133763,16,6420.638418,356.702134,401.289901,122.603359,5,2
0,0,11,11,15,15,30,39,26,65,0.000333,0.106316,7,2232.635221,124.03529,318.947889,117.206718,3,2
0,0,11,11,14,16,30,44,31,75,0.000333,0.122672,7,2576.117563,143.117642,368.016795,117.302969,4,2
0,0,10,10,10,18,28,34,39,73,0.000333,0.116979,10,3509.369093,194.96495,350.936909,108.277931,3,2
0,0,9,9,13,14,27,37,28,65,0.000333,0.103023,12,3708.812252,206.045125,309.067688,101.408685,3,2
0,0,12,12,15,15,30,50,36,86,0.000333,0.140664,14,5907.896277,328.21646,421.992591,117.206718,3,2
0,0,14,14,16,20,36,46,42,88,0.000333,0.151651,16,7279.254402,404.403022,454.9534,150.438562,3,2
0,0,9,9,14,15,29,39,28,67,0.000333,0.108495,7,2278.393087,126.577394,325.484727,111.906328,3,2
0,0,10,10,15,14,29,42,30,72,0.000333,0.116592,14,4896.844843,272.046936,349.774632,111.906328,3,2
0,0,10,10,15,16,31,46,32,78,0.000333,0.128809,14,5409.982371,300.554576,386.427312,122.603359,3,2
0,0,11,11,14,19,33,39,36,75,0.000333,0.12611,7,2648.306913,147.128162,378.329559,134.013592,3,2
0,0,9,9,13,20,33,38,35,73,0.000333,0.122747,6,2209.444624,122.746924,368.240771,134.544278,3,2
0,0,11,11,13,19,32,43,46,89,0.000333,0.148333,12,5340,296.666667,445,128.816339,3,2
0,0,13,13,13,20,33,48,58,106,0.000333,0.178235,12,6416.46932,356.470518,534.705777,134.544278,3,2
0,0,15,15,13,21,34,53,70,123,0.000333,0.208586,18,11263.64273,625.757929,625.757929,140.344382,3,2
0,0,10,10,14,17,31,41,36,77,0.000333,0.127158,14,5340.623623,296.701312,381.473116,122.789837,3,2
0,0,10,10,15,19,34,43,37,80,0.000333,0.135666,7,2848.979191,158.276622,406.997027,139.313982,3,2
0,0,10,10,14,19,33,45,38,83,0.000333,0.139562,14,5861.585967,325.643665,418.684712,134.013592,3,2
0,0,12,12,13,21,34,51,44,95,0.000333,0.161103,12,5799.707639,322.20598,483.30897,140.344382,3,2
0,0,15,15,16,22,38,50,59,109,0.000333,0.190675,16,9152.385583,508.465866,572.024099,162.107496,3,2
0,0,7,7,12,12,24,33,23,56,0.000333,0.085586,6,1540.5474,85.585967,256.7579,86.0391,2,2
0,0,9,9,12,12,24,39,25,64,0.000333,0.097813,12,3521.251201,195.625067,293.4376,86.0391,4,2
0,0,9,9,12,13,25,39,27,66,0.000333,0.102165,12,3677.934102,204.329672,306.494509,91.125266,4,2
0,0,11,11,14,14,28,47,31,78,0.000333,0.124991,14,5249.631575,291.646199,374.973684,106.605938,4,2
0,0,11,11,13,14,27,45,31,76,0.000333,0.120457,12,4336.457402,240.9143,361.37145,101.408685,4,2
0,0,10,10,14,14,28,43,30,73,0.000333,0.116979,14,4913.11673,272.950929,350.936909,106.605938,4,2
0,0,12,12,15,15,30,48,34,82,0.000333,0.134122,14,5633.110404,312.950578,402.365029,117.206718,6,2
0,0,14,14,14,14,28,46,31,77,0.000333,0.123389,14,5182.328606,287.907145,370.166329,106.605938,4,2
0,0,11,11,13,14,27,45,31,76,0.000333,0.120457,12,4336.457402,240.9143,361.37145,101.408685,4,2
0,0,11,11,12,14,26,43,31,74,0.000333,0.115944,12,4173.99047,231.888359,347.832539,96.322519,4,2
0,0,13,13,13,14,27,43,31,74,0.000333,0.117287,12,4222.340102,234.57445,351.861675,101.408685,4,2
0,0,10,10,13,14,27,42,30,72,0.000333,0.114117,12,4108.222802,228.2346,342.3519,101.408685,4,2
0,0,10,10,12,14,26,41,30,71,0.000333,0.111244,12,4004.77464,222.48748,333.73122,96.322519,4,2
0,0,17,17,17,14,31,55,27,82,0.000333,0.135415,8,3249.95278,180.552932,406.244097,122.789837,4,2
0,0,11,11,14,12,26,43,25,68,0.000333,0.106543,14,4474.818612,248.601034,319.629901,96.322519,4,2
0,0,9,9,15,14,29,49,33,82,0.000333,0.132785,14,5576.962182,309.831232,398.354442,111.906328,4,2
0,0,11,11,14,14,28,39,27,66,0.000333,0.105762,7,2220.997974,123.388776,317.285425,106.605938,2,2
0,0,11,11,13,15,28,44,32,76,0.000333,0.121786,12,4384.307689,243.572649,365.358974,106.709075,3,2
0,0,11,11,12,18,30,43,44,87,0.000333,0.1423,12,5122.793782,284.599655,426.899482,118.0782,3,2
0,0,9,9,12,13,25,37,29,66,0.000333,0.102165,12,3677.934102,204.329672,306.494509,91.125266,2,2
0,0,11,11,14,14,28,47,34,81,0.000333,0.129799,14,5451.540482,302.86336,389.395749,106.605938,2,2
0,0,14,14,15,19,34,46,43,89,0.000333,0.150928,14,6338.9787,352.165483,452.784193,139.313982,2,2
0,0,9,9,13,14,27,39,29,68,0.000333,0.107777,12,3879.988202,215.5549,323.33235,101.408685,2,2
0,0,10,10,14,13,27,42,31,73,0.000333,0.115702,14,4859.495027,269.971946,347.106788,101.408685,2,2
0,0,10,10,14,15,29,46,33,79,0.000333,0.127927,14,5372.926981,298.495943,383.780499,111.906328,2,2
0,0,11,11,13,18,31,39,37,76,0.000333,0.125506,12,4518.227035,251.012613,376.51892,123.164366,2,2
0,0,9,9,12,17,29,38,35,73,0.000333,0.118211,12,4255.591352,236.421742,354.632613,112.506418,2,2
0,0,11,11,12,18,30,43,47,90,0.000333,0.147207,12,5299.441843,294.413436,441.620154,118.0782,2,2
0,0,13,13,12,19,31,48,59,107,0.000333,0.1767,18,9541.782094,530.099005,530.099005,123.730173,2,2
0,0,15,15,12,20,32,53,71,124,0.000333,0.206667,18,11160,620,620,129.458112,2,2
0,0,10,10,13,16,29,41,37,78,0.000333,0.126308,12,4547.070211,252.615012,378.922518,112.105716,2,2
0,0,10,10,14,18,32,43,38,81,0.000333,0.135,14,5670,315,405,128.361619,2,2
0,0,11,11,14,19,33,51,42,93,0.000333,0.156376,14,6567.801143,364.877841,469.128653,134.013592,2,2
0,0,10,10,13,18,31,45,39,84,0.000333,0.138717,12,4993.829881,277.434993,416.15249,123.164366,2,2
0,0,12,12,12,20,32,51,45,96,0.000333,0.16,12,5760,320,480,129.458112,2,2
0,0,15,15,15,21,36,50,60,110,0.000333,0.189564,14,7961.684502,442.315806,568.69175,150.842025,2,2
0,0,11,11,12,18,30,38,43,81,0.000333,0.132486,12,4769.497659,264.972092,397.458138,118.0782,2,2
0,0,10,10,16,20,36,45,43,88,0.000333,0.151651,16,7279.254402,404.403022,454.9534,150.438562,2,2
0,0,11,11,17,20,37,46,44,90,0.000333,0.156284,16,7501.612847,416.756269,468.850803,155.92543,2,2
0,0,5,5,7,12,19,30,22,52,0.000333,0.073631,3,662.676692,36.815372,220.892231,62.671034,1,2
0,0,6,6,7,13,20,32,24,56,0.000333,0.080676,3,726.08392,40.337996,242.027973,67.757201,1,2
0,0,6,6,7,13,20,32,24,56,0.000333,0.080676,3,726.08392,40.337996,242.027973,67.757201,1,2
0,0,9,9,10,15,25,42,29,71,0.000333,0.109905,5,1648.568947,91.587164,329.713789,91.82264,3,2
0,0,11,11,9,18,27,44,34,78,0.000333,0.123627,4,1483.524901,82.41805,370.881225,103.587975,3,2
0,0,10,10,10,17,27,42,33,75,0.000333,0.118872,5,1783.082813,99.060156,356.616563,102.706149,3,2
0,0,10,10,9,17,26,41,33,74,0.000333,0.115944,4,1391.330157,77.29612,347.832539,98.016193,3,2
0,0,13,13,10,18,28,44,34,78,0.000333,0.124991,5,1874.86842,104.159357,374.973684,108.277931,3,2
0,0,11,11,9,18,27,44,34,78,0.000333,0.123627,4,1483.524901,82.41805,370.881225,103.587975,3,2
0,0,11,11,8,18,26,42,34,76,0.000333,0.119078,4,1428.933674,79.385204,357.233419,99.05865,3,2
0,0,13,13,9,18,27,42,34,76,0.000333,0.120457,4,1445.485801,80.304767,361.37145,103.587975,3,2
0,0,10,10,9,17,26,41,33,74,0.000333,0.115944,4,1391.330157,77.29612,347.832539,98.016193,3,2
0,0,10,10,8,17,25,40,33,73,0.000333,0.113001,4,1356.006007,75.333667,339.001502,93.486868,3,2
0,0,14,14,12,16,28,48,30,78,0.000333,0.124991,6,2249.842104,124.991228,374.973684,107.01955,3,2
0,0,10,10,9,14,23,40,28,68,0.000333,0.102534,8,2460.817704,136.712095,307.602213,81.832294,3,2
0,0,9,9,10,17,27,48,36,84,0.000333,0.133137,10,3994.105502,221.89475,399.41055,102.706149,3,2
0,0,9,9,9,14,23,38,26,64,0.000333,0.096503,4,1158.031861,64.335103,289.507965,81.832294,1,2
0,0,12,12,9,18,27,47,38,85,0.000333,0.134722,8,3233.323501,179.629083,404.165438,103.587975,2,2
0,0,11,11,8,19,27,43,47,90,0.000333,0.142647,8,3423.519002,190.1955,427.939875,104.710623,2,2
0,0,9,9,7,15,22,38,32,70,0.000333,0.104053,6,1872.96128,104.053404,312.160213,78.254843,1,2
0,0,10,10,8,14,22,53,36,89,0.000333,0.132296,8,3175.115312,176.395295,396.889414,77.302969,1,2
0,0,12,12,11,19,30,48,42,90,0.000333,0.147207,10,4416.201536,245.34453,441.620154,118.764371,1,2
0,0,9,9,8,15,23,39,32,71,0.000333,0.107058,8,2569.383191,142.743511,321.172899,82.603359,1,2
0,0,8,8,9,13,22,43,30,73,0.000333,0.108513,8,2604.308065,144.683781,325.538508,76.635041,1,2
0,0,10,10,8,16,24,47,36,83,0.000333,0.126851,8,3044.4151,169.134172,380.551888,88,1,2
0,0,11,11,8,19,27,39,40,79,0.000333,0.125212,8,3005.088901,166.949383,375.636113,104.710623,1,2
0,0,9,9,7,18,25,38,38,76,0.000333,0.117644,6,2117.598423,117.644357,352.93307,94.710134,1,2
0,0,11,11,7,19,26,44,50,94,0.000333,0.14728,6,2651.048001,147.280445,441.841334,100.362107,1,2
0,0,13,13,7,20,27,50,62,112,0.000333,0.177516,9,4792.926602,266.2737,532.5474,106.090046,1,2
0,0,15,15,7,21,28,56,74,130,0.000333,0.208319,9,5624.605259,312.47807,624.95614,111.89015,1,2
0,0,10,10,8,18,26,42,40,82,0.000333,0.128479,8,3083.488455,171.304914,385.436057,99.05865,1,2
0,0,10,10,8,19,27,44,41,85,0.000333,0.134722,8,3233.323501,179.629083,404.165438,104.710623,1,2
0,0,11,11,8,20,28,53,45,98,0.000333,0.15704,8,3768.966259,209.387014,471.120782,110.438562,1,2
0,0,10,10,7,19,26,46,42,88,0.000333,0.13788,6,2481.832171,137.879565,413.638695,100.362107,1,2
0,0,10,10,9,19,28,53,44,97,0.000333,0.155438,8,3730.50742,207.250412,466.313427,109.239948,1,2
0,0,15,15,11,22,33,51,63,114,0.000333,0.191687,10,5750.609296,319.478294,575.06093,136.161243,1,2
0,0,11,11,7,19,26,38,46,84,0.000333,0.131612,6,2369.021618,131.612312,394.836936,100.362107,1,2
0,0,10,10,11,21,32,45,46,91,0.000333,0.151667,10,4550,252.777778,455,130.292414,1,2
0,0,7,7,10,12,22,44,27,71,0.000333,0.10554,10,3166.196449,175.899803,316.619645,76.238831,1,2
0,0,8,8,11,12,23,47,28,75,0.000333,0.113089,10,3392.671467,188.481748,339.267147,81.073298,2,2
0,0,9,9,11,13,24,49,31,80,0.000333,0.122266,10,3667.970001,203.776111,366.797,86.159464,2,2
0,0,11,11,13,15,28,57,36,93,0.000333,0.149028,12,5365.008093,298.056005,447.084008,106.709075,2,2
0,0,11,11,12,15,27,55,36,91,0.000333,0.144232,12,5192.337152,288.463175,432.694763,101.622909,2,2
0,0,10,10,13,15,28,53,34,87,0.000333,0.139413,12,5018.878539,278.826585,418.239878,106.709075,2,2
0,0,10,10,12,15,27,52,34,86,0.000333,0.136307,12,4907.043902,272.61355,408.920325,101.622909,2,2
0,0,13,13,13,15,28,55,36,91,0.000333,0.145823,12,5249.631575,291.646199,437.469298,106.709075,2,2
0,0,11,11,12,15,27,55,36,91,0.000333,0.144232,12,5192.337152,288.463175,432.694763,101.622909,2,2
0,0,11,11,11,15,26,53,36,89,0.000333,0.139446,10,4183.391349,232.410631,418.339135,96.657107,2,2
0,0,13,13,12,15,27,53,36,89,0.000333,0.141062,12,5078.219852,282.123325,423.184988,101.622909,2,2
0,0,10,10,12,15,27,52,34,86,0.000333,0.136307,12,4907.043902,272.61355,408.920325,101.622909,2,2
0,0,10,10,11,15,26,51,34,85,0.000333,0.133179,10,3995.37376,221.965209,399.537376,96.657107,2,2
0,0,14,14,15,15,30,61,33,94,0.000333,0.153749,14,6457.468024,358.748224,461.247716,117.206718,2,2
0,0,10,10,12,12,24,51,30,81,0.000333,0.123794,12,4456.583551,247.587975,371.381963,86.0391,2,2
0,0,9,9,13,13,26,54,34,88,0.000333,0.13788,12,4963.664342,275.75913,413.638695,96.211433,2,2
0,0,10,10,12,12,24,49,31,80,0.000333,0.122266,12,4401.564001,244.531333,366.797,86.0391,1,2
0,0,9,9,10,13,23,50,33,83,0.000333,0.125152,10,3754.556424,208.586468,375.455642,81.324997,1,2
0,0,11,11,11,14,25,60,38,98,0.000333,0.151699,10,4550.979066,252.83217,455.097907,91.356717,1,2
0,0,14,14,14,19,33,60,47,107,0.000333,0.179917,14,7556.502391,419.805688,539.750171,134.013592,1,2
0,0,9,9,10,17,27,50,39,89,0.000333,0.141062,10,4231.849877,235.102771,423.184988,102.706149,1,2
0,0,10,10,11,15,26,59,37,96,0.000333,0.150414,10,4512.422129,250.690118,451.242213,96.657107,1,2
0,0,12,12,11,18,29,53,43,96,0.000333,0.155455,10,4663.661755,259.09232,466.366176,113.112398,1,2
0,0,9,9,10,17,27,50,39,89,0.000333,0.141062,10,4231.849877,235.102771,423.184988,102.706149,1,2
0,0,11,11,10,18,28,56,51,107,0.000333,0.171462,10,5143.869767,285.770543,514.386977,108.277931,1,2
0,0,14,14,10,19,29,64,65,129,0.000333,0.208893,15,9400.193226,522.232957,626.679548,113.929904,1,2
0,0,16,16,10,20,30,70,77,147,0.000333,0.240438,15,10819.69376,601.094098,721.312918,119.657843,1,2
0,0,11,11,11,18,29,58,44,102,0.000333,0.165171,10,4955.140615,275.28559,495.514062,113.112398,1,2
0,0,12,12,11,19,30,67,48,115,0.000333,0.188097,10,5642.924185,313.495788,564.292418,118.764371,1,2
0,0,11,11,10,18,28,60,45,105,0.000333,0.168257,10,5047.722668,280.429037,504.772267,108.277931,1,2
0,0,13,13,10,20,30,67,51,118,0.000333,0.193004,10,5790.130903,321.673939,579.01309,119.657843,1,2
0,0,16,16,14,21,35,65,66,131,0.000333,0.223979,21,14110.65758,783.925421,671.936075,145.541635,1,2
0,0,12,12,10,18,28,52,49,101,0.000333,0.161848,10,4855.428471,269.746026,485.542847,108.277931,1,2
0,0,11,11,14,20,34,59,49,108,0.000333,0.183149,14,7692.243816,427.346879,549.445987,139.741531,1,2
0,0,12,12,14,20,34,60,50,110,0.000333,0.18654,14,7834.692776,435.26071,559.620913,139.741531,1,2
0,0,8,8,10,13,23,56,33,89,0.000333,0.134199,10,4025.970141,223.665008,402.597014,81.324997,1,2
0,0,9,9,11,13,24,59,34,93,0.000333,0.142134,10,4264.015126,236.889729,426.401513,86.159464,2,2
0,0,9,9,11,14,25,59,35,94,0.000333,0.145507,10,4365.224818,242.51249,436.522482,91.356717,2,2
0,0,11,11,13,16,29,67,40,107,0.000333,0.173268,12,6237.647598,346.535978,519.803966,112.105716,2,2
0,0,11,11,12,16,28,65,40,105,0.000333,0.168257,12,6057.267202,336.514845,504.772267,107.01955,2,2
0,0,10,10,13,16,29,63,38,101,0.000333,0.163552,12,5887.872966,327.104054,490.656081,112.105716,2,2
0,0,10,10,12,16,28,62,38,100,0.000333,0.160245,12,5768.825906,320.490328,480.735492,107.01955,2,2
0,0,13,13,13,16,29,65,40,105,0.000333,0.170029,12,6121.056054,340.05867,510.088004,112.105716,2,2
0,0,11,11,12,16,28,65,40,105,0.000333,0.168257,12,6057.267202,336.514845,504.772267,107.01955,2,2
0,0,11,11,11,16,27,63,40,103,0.000333,0.163251,10,4897.534127,272.085229,489.753413,102.053748,2,2
0,0,13,13,12,16,28,63,40,103,0.000333,0.165053,12,5941.890684,330.105038,495.157557,107.01955,2,2
0,0,10,10,12,16,28,62,38,100,0.000333,0.160245,12,5768.825906,320.490328,480.735492,107.01955,2,2
0,0,10,10,11,16,27,61,38,99,0.000333,0.156911,10,4707.338627,261.518813,470.733863,102.053748,2,2
0,0,14,14,15,16,31,71,37,108,0.000333,0.178351,14,7490.744821,416.15249,535.053202,122.603359,2,2
0,0,10,10,12,13,25,61,34,95,0.000333,0.147055,12,5293.996056,294.110892,441.166338,91.125266,2,2
0,0,9,9,13,14,27,64,38,102,0.000333,0.161666,12,5819.982303,323.33235,484.998525,101.408685,2,2
0,0,10,10,12,13,25,59,35,94,0.000333,0.145507,12,5238.269782,291.014988,436.522482,91.125266,1,2
0,0,10,10,10,14,24,62,39,101,0.000333,0.15436,10,4630.812126,257.26734,463.081213,86.52225,1,2
0,0,13,13,11,15,26,77,47,124,0.000333,0.194285,15,8742.817876,485.712104,582.854525,96.657107,1,2
0,0,15,15,14,20,34,72,53,125,0.000333,0.211978,14,8903.059972,494.614443,635.932855,139.741531,1,2
0,0,10,10,10,18,28,62,45,107,0.000333,0.171462,10,5143.869767,285.770543,514.386977,108.277931,1,2
0,0,11,11,11,16,27,71,43,114,0.000333,0.180686,10,5420.571752,301.142875,542.057175,102.053748,1,2
0,0,12,12,11,19,30,63,47,110,0.000333,0.179919,10,5397.579655,299.865536,539.757966,118.764371,1,2
0,0,10,10,10,18,28,62,45,107,0.000333,0.171462,10,5143.869767,285.770543,514.386977,108.277931,1,2
0,0,12,12,10,19,29,68,57,125,0.000333,0.202416,15,9108.714366,506.039687,607.247624,113.929904,1,2
0,0,14,14,10,20,30,74,69,143,0.000333,0.233895,15,10525.28033,584.737796,701.685355,119.657843,1,2
0,0,11,11,11,19,30,68,48,116,0.000333,0.189733,10,5691.993091,316.221838,569.199309,118.764371,1,2
0,0,12,12,11,20,31,77,52,129,0.000333,0.21303,10,6390.91324,355.050736,639.091324,124.49231,1,2
0,0,11,11,10,19,29,70,49,119,0.000333,0.1927,10,5780.997384,321.166521,578.099738,113.929904,1,2
0,0,13,13,10,21,31,77,55,132,0.000333,0.217985,10,6539.53913,363.307729,653.953913,125.457947,1,2
0,0,16,16,14,22,36,75,70,145,0.000333,0.24988,21,15742.42163,874.578979,749.639125,151.410465,1,2
0,0,12,12,10,19,29,62,53,115,0.000333,0.186223,10,5586.678144,310.371008,558.667814,113.929904,1,2
0,0,8,8,10,13,23,56,33,89,0.000333,0.134199,10,4025.970141,223.665008,402.597014,81.324997,1,2
0,0,9,9,11,13,24,59,34,93,0.000333,0.142134,10,4264.015126,236.889729,426.401513,86.159464,2,2
0,0,9,9,11,14,25,59,35,94,0.000333,0.145507,10,4365.224818,242.51249,436.522482,91.356717,2,2
0,0,11,11,13,16,29,67,40,107,0.000333,0.173268,12,6237.647598,346.535978,519.803966,112.105716,2,2
0,0,11,11,12,16,28,65,40,105,0.000333,0.168257,12,6057.267202,336.514845,504.772267,107.01955,2,2
0,0,10,10,13,16,29,63,38,101,0.000333,0.163552,12,5887.872966,327.104054,490.656081,112.105716,2,2
0,0,10,10,12,16,28,62,38,100,0.000333,0.160245,12,5768.825906,320.490328,480.735492,107.01955,2,2
0,0,13,13,13,16,29,65,40,105,0.000333,0.170029,12,6121.056054,340.05867,510.088004,112.105716,2,2
0,0,11,11,12,16,28,65,40,105,0.000333,0.168257,12,6057.267202,336.514845,504.772267,107.01955,2,2
0,0,11,11,11,16,27,63,40,103,0.000333,0.163251,10,4897.534127,272.085229,489.753413,102.053748,2,2
0,0,14,14,13,16,29,64,40,104,0.000333,0.16841,12,6062.760282,336.820016,505.230023,112.105716,2,2
0,0,10,10,12,16,28,62,38,100,0.000333,0.160245,12,5768.825906,320.490328,480.735492,107.01955,2,2
0,0,10,10,11,16,27,61,38,99,0.000333,0.156911,10,4707.338627,261.518813,470.733863,102.053748,2,2
0,0,14,14,15,16,31,71,37,108,0.000333,0.178351,14,7490.744821,416.15249,535.053202,122.603359,2,2
0,0,10,10,12,13,25,61,34,95,0.000333,0.147055,12,5293.996056,294.110892,441.166338,91.125266,2,2
0,0,9,9,13,14,27,64,38,102,0.000333,0.161666,12,5819.982303,323.33235,484.998525,101.408685,2,2
0,0,10,10,12,13,25,59,35,94,0.000333,0.145507,12,5238.269782,291.014988,436.522482,91.125266,1,2
0,0,10,10,10,14,24,62,39,101,0.000333,0.15436,10,4630.812126,257.26734,463.081213,86.52225,1,2
0,0,13,13,11,15,26,77,47,124,0.000333,0.194285,15,8742.817876,485.712104,582.854525,96.657107,1,2
0,0,15,15,14,20,34,72,53,125,0.000333,0.211978,14,8903.059972,494.614443,635.932855,139.741531,1,2
0,0,10,10,10,18,28,62,45,107,0.000333,0.171462,10,5143.869767,285.770543,514.386977,108.277931,1,2
0,0,11,11,11,16,27,71,43,114,0.000333,0.180686,10,5420.571752,301.142875,542.057175,102.053748,1,2
0,0,12,12,11,19,30,63,47,110,0.000333,0.179919,10,5397.579655,299.865536,539.757966,118.764371,1,2
0,0,10,10,10,18,28,62,45,107,0.000333,0.171462,10,5143.869767,285.770543,514.386977,108.277931,1,2
0,0,12,12,10,19,29,68,57,125,0.000333,0.202416,15,9108.714366,506.039687,607.247624,113.929904,1,2
0,0,14,14,10,20,30,74,69,143,0.000333,0.233895,15,10525.28033,584.737796,701.685355,119.657843,1,2
0,0,11,11,11,19,30,68,48,116,0.000333,0.189733,10,5691.993091,316.221838,569.199309,118.764371,1,2
0,0,12,12,11,20,31,77,52,129,0.000333,0.21303,10,6390.91324,355.050736,639.091324,124.49231,1,2
0,0,11,11,10,19,29,70,49,119,0.000333,0.1927,10,5780.997384,321.166521,578.099738,113.929904,1,2
0,0,13,13,10,21,31,77,55,132,0.000333,0.217985,10,6539.53913,363.307729,653.953913,125.457947,1,2
0,0,16,16,14,22,36,75,70,145,0.000333,0.24988,21,15742.42163,874.578979,749.639125,151.410465,1,2
0,0,12,12,10,19,29,62,53,115,0.000333,0.186223,10,5586.678144,310.371008,558.667814,113.929904,1,2
0,0,11,11,14,21,35,69,53,122,0.000333,0.208591,14,8760.815393,486.711966,625.772528,145.541635,1,2
0,0,12,12,14,21,35,70,54,124,0.000333,0.21201,14,8904.435317,494.690851,636.031094,145.541635,1,2
0,0,8,8,10,13,23,50,32,82,0.000333,0.123644,10,3709.320804,206.073378,370.93208,81.324997,1,2
0,0,9,9,11,13,24,53,33,86,0.000333,0.131436,10,3943.067751,219.059319,394.306775,86.159464,2,2
0,0,9,9,11,14,25,53,34,87,0.000333,0.134672,10,4040.154885,224.453049,404.015489,91.356717,2,2
0,0,9,9,11,14,25,53,33,86,0.000333,0.133124,10,3993.716323,221.873129,399.371632,91.356717,2,2
0,0,11,11,12,16,28,59,39,98,0.000333,0.15704,12,5653.449388,314.080522,471.120782,107.01955,2,2
0,0,10,10,13,16,29,57,37,94,0.000333,0.152217,12,5479.802563,304.433476,456.650214,112.105716,2,2
0,0,10,10,12,16,28,56,37,93,0.000333,0.149028,12,5365.008093,298.056005,447.084008,107.01955,2,2
0,0,13,13,13,16,29,59,39,98,0.000333,0.158694,12,5712.98565,317.388092,476.082138,112.105716,2,2
0,0,9,9,11,14,25,53,33,86,0.000333,0.133124,10,3993.716323,221.873129,399.371632,91.356717,2,2
0,0,9,9,11,14,25,53,33,86,0.000333,0.133124,10,3993.716323,221.873129,399.371632,91.356717,2,2
0,0,9,9,11,14,25,53,33,86,0.000333,0.133124,10,3993.716323,221.873129,399.371632,91.356717,2,2
0,0,12,12,12,14,26,60,37,97,0.000333,0.151981,12,5471.311832,303.961768,455.942653,96.322519,2,2
0,0,9,9,11,15,26,53,34,87,0.000333,0.136313,10,4089.382555,227.18792,408.938255,96.657107,2,2
0,0,9,9,11,15,26,53,34,87,0.000333,0.136313,10,4089.382555,227.18792,408.938255,96.657107,2,2
0,0,14,14,15,16,31,65,36,101,0.000333,0.166791,14,7005.233583,389.179643,500.373827,122.603359,2,2
0,0,10,10,12,13,25,55,33,88,0.000333,0.13622,12,4903.912136,272.439563,408.659345,91.125266,2,2
0,0,9,9,13,14,27,58,37,95,0.000333,0.150571,12,5420.571752,301.142875,451.714313,101.408685,2,2
0,0,10,10,12,13,25,53,34,87,0.000333,0.134672,12,4848.185862,269.343659,404.015489,91.125266,1,2
0,0,10,10,10,14,24,56,38,94,0.000333,0.143662,10,4309.864751,239.436931,430.986475,86.52225,1,2
0,0,13,13,11,15,26,71,46,117,0.000333,0.183317,15,8249.271705,458.292873,549.951447,96.657107,1,2
0,0,15,15,14,20,34,66,52,118,0.000333,0.200107,14,8404.488614,466.916034,600.320615,139.741531,1,2
0,0,10,10,10,18,28,56,44,100,0.000333,0.160245,10,4807.354922,267.075273,480.735492,108.277931,1,2
0,0,11,11,11,16,27,65,42,107,0.000333,0.169591,10,5087.729627,282.651646,508.772963,102.053748,1,2
0,0,12,12,11,19,30,57,46,103,0.000333,0.16847,10,5054.097313,280.783184,505.409731,118.764371,1,2
0,0,10,10,10,18,28,56,44,100,0.000333,0.160245,10,4807.354922,267.075273,480.735492,108.277931,1,2
0,0,12,12,10,19,29,62,56,118,0.000333,0.191081,10,5732.417574,318.467643,573.241757,113.929904,1,2
0,0,14,14,10,20,30,68,68,136,0.000333,0.222446,15,10010.05682,556.114268,667.337121,119.657843,1,2
0,0,16,16,10,21,31,74,80,154,0.000333,0.254315,15,11444.19348,635.788526,762.946232,125.457947,1,2
0,0,11,11,11,19,30,62,47,109,0.000333,0.178284,10,5348.510749,297.139486,534.851075,118.764371,1,2
0,0,12,12,11,20,31,71,51,122,0.000333,0.201471,10,6044.119499,335.784417,604.41195,124.49231,1,2
0,0,11,11,10,19,29,64,48,112,0.000333,0.181365,10,5440.938715,302.274373,544.093871,113.929904,1,2
0,0,13,13,10,21,31,71,54,125,0.000333,0.206425,10,6192.745388,344.04141,619.274539,125.457947,1,2
0,0,16,16,14,22,36,69,69,138,0.000333,0.237817,21,14982.44265,832.357925,713.44965,151.410465,1,2
0,0,12,12,10,19,29,56,52,108,0.000333,0.174887,10,5246.619475,291.47886,524.661947,113.929904,1,2
0,0,11,11,14,21,35,63,52,115,0.000333,0.196623,14,8258.145657,458.78587,589.867547,145.541635,1,2
0,0,12,12,14,21,35,64,53,117,0.000333,0.200042,14,8401.765582,466.764755,600.126113,145.541635,1,2
0,0,8,8,9,11,20,24,23,47,0.000333,0.06771,8,1625.044964,90.280276,203.13062,66.583073,1,2
0,0,9,9,10,11,21,27,24,51,0.000333,0.074669,10,2240.081886,124.448994,224.008189,71.273029,2,2
0,0,9,9,10,12,22,27,25,52,0.000333,0.077297,10,2318.904442,128.828025,231.890444,76.238831,2,2
0,0,11,11,12,14,26,35,30,65,0.000333,0.101843,12,3666.34298,203.685721,305.528582,96.322519,2,2
0,0,11,11,11,14,25,33,30,63,0.000333,0.097521,10,2925.6294,162.534967,292.56294,91.356717,2,2
0,0,9,9,10,13,23,27,25,52,0.000333,0.078408,5,1176.126109,65.340339,235.225222,81.324997,2,2
0,0,10,10,11,14,25,30,28,58,0.000333,0.089781,10,2693.43659,149.635366,269.343659,91.356717,2,2
0,0,13,13,12,14,26,33,30,63,0.000333,0.098709,12,3553.532427,197.418468,296.127702,96.322519,2,2
0,0,9,9,10,12,22,27,24,51,0.000333,0.07581,10,2274.310126,126.350563,227.431013,76.238831,2,2
0,0,11,11,10,14,24,31,30,61,0.000333,0.093228,10,2796.827125,155.379285,279.682713,86.52225,2,2
0,0,14,14,12,14,26,32,30,62,0.000333,0.097142,12,3497.12715,194.284842,291.427263,96.322519,2,2
0,0,9,9,10,13,23,27,25,52,0.000333,0.078408,5,1176.126109,65.340339,235.225222,81.324997,2,2
0,0,10,10,10,14,24,29,28,57,0.000333,0.087114,10,2613.428625,145.190479,261.342863,86.52225,2,2
0,0,14,14,14,14,28,39,27,66,0.000333,0.105762,7,2220.997974,123.388776,317.285425,106.605938,2,2
0,0,10,10,11,11,22,29,24,53,0.000333,0.078783,10,2363.498758,131.305487,236.349876,76.107496,2,2
0,0,9,9,12,12,24,32,28,60,0.000333,0.091699,12,3301.173001,183.3985,275.09775,86.0391,2,2
0,0,10,10,11,11,22,27,25,52,0.000333,0.077297,10,2318.904442,128.828025,231.890444,76.107496,1,2
0,0,10,10,9,12,21,30,29,59,0.000333,0.086382,8,2073.173824,115.176324,259.146728,71.548875,1,2
0,0,13,13,10,13,23,45,37,82,0.000333,0.123644,10,3709.320804,206.073378,370.93208,81.324997,1,2
0,0,15,15,13,18,31,40,43,83,0.000333,0.137066,12,4934.379525,274.132196,411.198294,123.164366,1,2
0,0,10,10,9,16,25,30,35,65,0.000333,0.100617,8,2414.805219,134.155845,301.850652,92.529325,1,2
0,0,11,11,10,14,24,39,33,72,0.000333,0.110039,10,3301.173001,183.3985,330.1173,86.52225,1,2
0,0,12,12,10,17,27,31,37,68,0.000333,0.107777,10,3233.323501,179.629083,323.33235,102.706149,1,2
0,0,10,10,9,16,25,30,35,65,0.000333,0.100617,8,2414.805219,134.155845,301.850652,92.529325,1,2
0,0,12,12,9,17,26,36,47,83,0.000333,0.130045,8,3121.091973,173.393998,390.136497,98.016193,1,2
0,0,14,14,9,18,27,42,59,101,0.000333,0.160081,12,5762.923653,320.162425,480.243638,103.587975,1,2
0,0,16,16,9,19,28,48,71,119,0.000333,0.190692,12,6864.902829,381.38349,572.075236,109.239948,1,2
0,0,11,11,10,17,27,36,38,74,0.000333,0.117287,10,3518.616752,195.478708,351.861675,102.706149,1,2
0,0,12,12,10,18,28,45,42,87,0.000333,0.139413,10,4182.398782,232.355488,418.239878,108.277931,1,2
0,0,11,11,9,17,26,38,39,77,0.000333,0.120645,8,2895.470866,160.859493,361.933858,98.016193,1,2
0,0,13,13,9,19,28,45,45,90,0.000333,0.144221,8,3461.295544,192.294197,432.661943,109.239948,1,2
0,0,16,16,13,20,33,43,60,103,0.000333,0.173191,18,9352.306697,519.572594,519.572594,134.544278,1,2
0,0,12,12,9,17,26,30,43,73,0.000333,0.114377,8,2745.056795,152.503155,343.132099,98.016193,1,2
0,0,11,11,13,19,32,37,43,80,0.000333,0.133333,12,4800,266.666667,400,128.816339,1,2
0,0,8,8,10,12,22,34,27,61,0.000333,0.090675,10,2720.253287,151.125183,272.025329,76.238831,1,2
0,0,9,9,11,12,23,37,28,65,0.000333,0.098011,10,2940.315271,163.350848,294.031527,81.073298,2,2
0,0,9,9,11,13,24,37,29,66,0.000333,0.100869,10,3026.07525,168.115292,302.607525,86.159464,2,2
0,0,11,11,13,15,28,45,34,79,0.000333,0.126594,12,4557.372466,253.187359,379.781039,106.709075,2,2
0,0,11,11,12,15,27,43,34,77,0.000333,0.122042,12,4393.516052,244.084225,366.126338,101.622909,2,2
0,0,10,10,12,16,28,40,32,72,0.000333,0.115377,12,4153.554653,230.753036,346.129554,107.01955,2,2
0,0,10,10,12,15,27,40,32,72,0.000333,0.114117,12,4108.222802,228.2346,342.3519,101.622909,2,2
0,0,13,13,13,15,28,43,34,77,0.000333,0.123389,12,4441.995948,246.777553,370.166329,106.709075,2,2
0,0,9,9,11,13,24,37,28,65,0.000333,0.099341,10,2980.225625,165.56809,298.022563,86.159464,2,2
0,0,9,9,11,13,24,37,28,65,0.000333,0.099341,10,2980.225625,165.56809,298.022563,86.159464,2,2
0,0,9,9,11,13,24,37,28,65,0.000333,0.099341,10,2980.225625,165.56809,298.022563,86.159464,2,2
0,0,12,12,12,13,25,44,32,76,0.000333,0.117644,12,4235.196845,235.288714,352.93307,91.125266,2,2
0,0,10,10,12,15,27,40,32,72,0.000333,0.114117,12,4108.222802,228.2346,342.3519,101.622909,2,2
0,0,9,9,11,14,25,37,29,66,0.000333,0.102165,10,3064.945085,170.274727,306.494509,91.356717,2,2
0,0,14,14,15,15,30,49,31,80,0.000333,0.13085,14,5495.717467,305.317637,392.551248,117.206718,2,2
0,0,10,10,12,12,24,39,28,67,0.000333,0.102397,12,3686.309851,204.794992,307.192488,86.0391,2,2
0,0,9,9,13,13,26,42,32,74,0.000333,0.115944,12,4173.99047,231.888359,347.832539,96.211433,2,2
0,0,10,10,12,12,24,37,29,66,0.000333,0.100869,12,3631.290301,201.73835,302.607525,86.0391,1,2
0,0,10,10,10,13,23,40,33,73,0.000333,0.110073,10,3302.200228,183.455568,330.220023,81.324997,1,2
0,0,13,13,11,14,25,55,41,96,0.000333,0.148603,10,4458.101942,247.67233,445.810194,91.356717,1,2
0,0,15,15,14,19,33,50,47,97,0.000333,0.163102,14,6850.287214,380.571512,489.30623,134.013592,1,2
0,0,10,10,10,17,27,40,39,79,0.000333,0.125212,10,3756.361127,208.686729,375.636113,102.706149,1,2
0,0,11,11,11,15,26,49,37,86,0.000333,0.134746,10,4042.378158,224.576564,404.237816,96.657107,1,2
0,0,12,12,11,18,29,41,41,82,0.000333,0.132785,10,3983.544416,221.308023,398.354442,113.112398,1,2
0,0,10,10,10,17,27,40,39,79,0.000333,0.125212,10,3756.361127,208.686729,375.636113,102.706149,1,2
0,0,12,12,10,18,28,46,51,97,0.000333,0.155438,10,4663.134274,259.063015,466.313427,108.277931,1,2
0,0,14,14,10,19,29,52,63,115,0.000333,0.186223,15,8380.017217,465.556512,558.667814,113.929904,1,2
0,0,16,16,10,20,30,58,75,133,0.000333,0.217539,15,9789.246738,543.847041,652.616449,119.657843,1,2
0,0,11,11,11,18,29,46,42,88,0.000333,0.142501,10,4275.023276,237.501293,427.502328,113.112398,1,2
0,0,12,12,11,19,30,55,46,101,0.000333,0.165199,10,4955.959502,275.331083,495.59595,118.764371,1,2
0,0,11,11,10,18,28,48,43,91,0.000333,0.145823,10,4374.692979,243.038499,437.469298,108.277931,1,2
0,0,13,13,10,20,30,55,49,104,0.000333,0.170106,10,5103.166219,283.509234,510.316622,119.657843,1,2
0,0,16,16,14,21,35,53,64,117,0.000333,0.200042,21,12602.64837,700.147132,600.126113,145.541635,1,2
0,0,12,12,10,18,28,40,47,87,0.000333,0.139413,10,4182.398782,232.355488,418.239878,108.277931,1,2
0,0,11,11,14,20,34,47,47,94,0.000333,0.159407,14,6695.101099,371.950061,478.221507,139.741531,1,2
0,0,12,12,14,20,34,48,48,96,0.000333,0.162799,14,6837.550059,379.863892,488.396433,139.741531,1,2
0,0,8,8,10,12,22,34,27,61,0.000333,0.090675,10,2720.253287,151.125183,272.025329,76.238831,1,2
0,0,9,9,11,12,23,37,28,65,0.000333,0.098011,10,2940.315271,163.350848,294.031527,81.073298,2,2
0,0,9,9,11,13,24,37,29,66,0.000333,0.100869,10,3026.07525,168.115292,302.607525,86.159464,2,2
0,0,11,11,13,15,28,45,34,79,0.000333,0.126594,12,4557.372466,253.187359,379.781039,106.709075,2,2
0,0,11,11,12,15,27,43,34,77,0.000333,0.122042,12,4393.516052,244.084225,366.126338,101.622909,2,2
0,0,10,10,13,15,28,41,32,73,0.000333,0.116979,12,4211.242912,233.95794,350.936909,106.709075,2,2
0,0,10,10,12,15,27,40,32,72,0.000333,0.114117,12,4108.222802,228.2346,342.3519,101.622909,2,2
0,0,13,13,13,15,28,43,34,77,0.000333,0.123389,12,4441.995948,246.777553,370.166329,106.709075,2,2
0,0,11,11,12,15,27,43,34,77,0.000333,0.122042,12,4393.516052,244.084225,366.126338,101.622909,2,2
0,0,11,11,11,15,26,41,34,75,0.000333,0.117511,10,3525.329789,195.851655,352.532979,96.657107,2,2
0,0,13,13,12,15,27,41,34,75,0.000333,0.118872,12,4279.398752,237.744375,356.616563,101.622909,2,2
0,0,10,10,12,15,27,40,32,72,0.000333,0.114117,12,4108.222802,228.2346,342.3519,101.622909,2,2
0,0,10,10,11,15,26,39,32,71,0.000333,0.111244,10,3337.3122,185.406233,333.73122,96.657107,2,2
0,0,14,14,15,15,30,49,31,80,0.000333,0.13085,14,5495.717467,305.317637,392.551248,117.206718,2,2
0,0,10,10,12,12,24,39,28,67,0.000333,0.102397,12,3686.309851,204.794992,307.192488,86.0391,2,2
0,0,9,9,13,13,26,42,32,74,0.000333,0.115944,12,4173.99047,231.888359,347.832539,96.211433,2,2
0,0,10,10,12,12,24,37,29,66,0.000333,0.100869,12,3631.290301,201.73835,302.607525,86.0391,1,2
0,0,10,10,10,13,23,40,33,73,0.000333,0.110073,10,3302.200228,183.455568,330.220023,81.324997,1,2
0,0,13,13,11,14,25,55,41,96,0.000333,0.148603,10,4458.101942,247.67233,445.810194,91.356717,1,2
0,0,15,15,14,19,33,50,47,97,0.000333,0.163102,14,6850.287214,380.571512,489.30623,134.013592,1,2
0,0,10,10,10,17,27,40,39,79,0.000333,0.125212,10,3756.361127,208.686729,375.636113,102.706149,1,2
0,0,11,11,11,15,26,49,37,86,0.000333,0.134746,10,4042.378158,224.576564,404.237816,96.657107,1,2
0,0,12,12,11,18,29,41,41,82,0.000333,0.132785,10,3983.544416,221.308023,398.354442,113.112398,1,2
0,0,10,10,10,17,27,40,39,79,0.000333,0.125212,10,3756.361127,208.686729,375.636113,102.706149,1,2
0,0,12,12,10,18,28,46,51,97,0.000333,0.155438,10,4663.134274,259.063015,466.313427,108.277931,1,2
0,0,14,14,10,19,29,52,63,115,0.000333,0.186223,15,8380.017217,465.556512,558.667814,113.929904,1,2
0,0,16,16,10,20,30,58,75,133,0.000333,0.217539,15,9789.246738,543.847041,652.616449,119.657843,1,2
0,0,11,11,11,18,29,46,42,88,0.000333,0.142501,10,4275.023276,237.501293,427.502328,113.112398,1,2
0,0,12,12,11,19,30,55,46,101,0.000333,0.165199,10,4955.959502,275.331083,495.59595,118.764371,1,2
0,0,11,11,10,18,28,48,43,91,0.000333,0.145823,10,4374.692979,243.038499,437.469298,108.277931,1,2
0,0,13,13,10,20,30,55,49,104,0.000333,0.170106,10,5103.166219,283.509234,510.316622,119.657843,1,2
0,0,16,16,14,21,35,53,64,117,0.000333,0.200042,21,12602.64837,700.147132,600.126113,145.541635,1,2
0,0,12,12,10,18,28,40,47,87,0.000333,0.139413,10,4182.398782,232.355488,418.239878,108.277931,1,2
0,0,8,8,9,12,21,28,26,54,0.000333,0.079062,8,1897.481127,105.415618,237.185141,71.548875,1,2
0,0,9,9,10,12,22,31,27,58,0.000333,0.086216,10,2586.470339,143.692797,258.647034,76.238831,2,2
0,0,9,9,10,13,23,31,28,59,0.000333,0.088963,10,2668.901554,148.272309,266.890155,81.324997,2,2
0,0,11,11,12,15,27,39,33,72,0.000333,0.114117,12,4108.222802,228.2346,342.3519,101.622909,2,2
0,0,11,11,11,15,26,37,33,70,0.000333,0.109677,10,3290.307803,182.794878,329.03078,96.657107,2,2
0,0,11,11,13,14,27,56,39,95,0.000333,0.150571,12,5420.571752,301.142875,451.714313,101.408685,2,2
0,0,11,11,12,14,26,55,39,94,0.000333,0.14728,12,5302.096002,294.560889,441.841334,96.322519,2,2
0,0,14,14,13,15,28,58,41,99,0.000333,0.158643,12,5711.137647,317.285425,475.928137,106.709075,2,2
0,0,12,12,12,15,27,58,41,99,0.000333,0.156911,12,5648.806353,313.822575,470.733863,101.622909,2,2
0,0,12,12,11,15,26,56,41,97,0.000333,0.151981,10,4559.426527,253.301474,455.942653,96.657107,2,2
0,0,14,14,13,15,28,58,41,99,0.000333,0.158643,12,5711.137647,317.285425,475.928137,106.709075,2,2
0,0,11,11,12,14,26,55,39,94,0.000333,0.14728,12,5302.096002,294.560889,441.841334,96.322519,2,2
0,0,11,11,11,14,25,54,39,93,0.000333,0.14396,10,4318.786256,239.93257,431.878626,91.356717,2,2
0,0,14,14,15,12,27,60,36,96,0.000333,0.152156,21,9585.853204,532.5474,456.4692,101.622909,2,2
0,0,11,11,12,11,23,54,35,89,0.000333,0.134199,18,7246.746254,402.597014,402.597014,81.073298,2,2
0,0,10,10,13,13,26,57,39,96,0.000333,0.150414,18,8122.359833,451.242213,451.242213,96.211433,2,2
0,0,11,11,12,12,24,52,36,88,0.000333,0.134492,18,7262.580601,403.4767,403.4767,86.0391,1,2
0,0,11,11,10,12,22,55,40,95,0.000333,0.141215,15,6354.690057,353.038336,423.646004,76.238831,1,2
0,0,14,14,11,13,24,70,48,118,0.000333,0.180342,15,8115.383626,450.854646,541.025575,86.159464,1,2
0,0,16,16,14,17,31,65,52,117,0.000333,0.193214,21,12172.46034,676.247796,579.640968,122.789837,1,2
0,0,11,11,10,15,25,55,44,99,0.000333,0.153247,10,4597.417628,255.41209,459.741763,91.82264,1,2
0,0,12,12,11,14,25,64,44,108,0.000333,0.167179,15,7523.047027,417.947057,501.536468,91.356717,1,2
0,0,13,13,11,16,27,56,46,102,0.000333,0.161666,10,4849.985252,269.443625,484.998525,102.053748,1,2
0,0,11,11,10,15,25,55,44,99,0.000333,0.153247,10,4597.417628,255.41209,459.741763,91.82264,1,2
0,0,13,13,10,16,26,61,54,115,0.000333,0.180184,15,8108.258514,450.458806,540.550568,97.219281,1,2
0,0,15,15,10,17,27,67,64,131,0.000333,0.20763,15,9343.353942,519.075219,622.890263,102.706149,1,2
0,0,17,17,10,18,28,73,74,147,0.000333,0.23556,20,14133.62347,785.201304,706.681174,108.277931,1,2
0,0,12,12,11,16,27,61,47,108,0.000333,0.171176,10,5135.278502,285.29325,513.52785,102.053748,1,2
0,0,13,13,11,17,28,70,51,121,0.000333,0.193897,15,8725.349184,484.741621,581.689946,107.540616,1,2
0,0,12,12,10,16,26,63,48,111,0.000333,0.173916,15,7826.232131,434.790674,521.748809,97.219281,1,2
0,0,14,14,10,17,27,70,54,124,0.000333,0.196535,15,8844.090754,491.338375,589.60605,102.706149,1,2
0,0,17,17,14,19,33,68,65,133,0.000333,0.223635,21,14088.99278,782.721821,670.904418,134.013592,1,2
0,0,13,13,10,16,26,55,50,105,0.000333,0.164515,15,7403.192556,411.288475,493.54617,97.219281,1,2
0,0,12,12,14,18,32,62,51,113,0.000333,0.188333,14,7910,439.444444,565,128.361619,1,2
0,0,13,13,14,18,32,63,52,115,0.000333,0.191667,14,8050,447.222222,575,128.361619,1,2
0,0,9,9,10,11,21,49,33,82,0.000333,0.120057,15,5402.55043,300.141691,360.170029,71.273029,1,2
0,0,10,10,11,11,22,52,34,86,0.000333,0.127837,15,5752.666788,319.592599,383.511119,76.107496,2,2
0,0,10,10,11,12,23,52,35,87,0.000333,0.131183,10,3935.498902,218.638828,393.54989,81.073298,2,2
0,0,12,12,13,15,28,60,40,100,0.000333,0.160245,12,5768.825906,320.490328,480.735492,106.709075,2,2
0,0,12,12,12,15,27,58,40,98,0.000333,0.155326,12,5591.747703,310.65265,465.978975,101.622909,2,2
0,0,11,11,13,14,27,56,38,94,0.000333,0.148986,12,5363.513102,297.97295,446.959425,101.408685,2,2
0,0,11,11,12,14,26,55,38,93,0.000333,0.145714,12,5245.690725,291.427263,437.140894,96.322519,2,2
0,0,14,14,13,15,28,58,40,98,0.000333,0.15704,12,5653.449388,314.080522,471.120782,106.709075,2,2
0,0,12,12,12,15,27,58,40,98,0.000333,0.155326,12,5591.747703,310.65265,465.978975,101.622909,2,2
0,0,12,12,11,15,26,56,40,96,0.000333,0.150414,10,4512.422129,250.690118,451.242213,96.657107,2,2
0,0,14,14,12,15,27,56,40,96,0.000333,0.152156,12,5477.630402,304.3128,456.4692,101.622909,2,2
0,0,11,11,12,14,26,55,38,93,0.000333,0.145714,12,5245.690725,291.427263,437.140894,96.322519,2,2
0,0,11,11,11,14,25,54,38,92,0.000333,0.142412,10,4272.347695,237.35265,427.234769,91.356717,2,2
0,0,14,14,15,12,27,60,35,95,0.000333,0.150571,14,6324.000378,351.333354,451.714313,101.622909,2,2
0,0,11,11,12,11,23,54,34,88,0.000333,0.132691,18,7165.322138,398.073452,398.073452,81.073298,2,2
0,0,10,10,13,13,26,57,38,95,0.000333,0.148847,12,5358.501279,297.694515,446.541773,96.211433,2,2
0,0,11,11,12,12,24,52,35,87,0.000333,0.132964,12,4786.700851,265.927825,398.891738,86.0391,1,2
0,0,11,11,10,12,22,55,39,94,0.000333,0.139729,15,6287.798582,349.322143,419.186572,76.238831,1,2
0,0,14,14,11,13,24,70,47,117,0.000333,0.178814,15,8046.609189,447.033844,536.440613,86.159464,1,2
0,0,16,16,14,17,31,65,51,116,0.000333,0.191562,21,12068.42221,670.467901,574.686772,122.789837,1,2
0,0,12,12,10,15,25,60,46,106,0.000333,0.164083,15,7383.731342,410.207297,492.248756,91.82264,1,2
0,0,13,13,11,14,25,69,46,115,0.000333,0.178014,15,8010.651927,445.036218,534.043462,91.356717,1,2
0,0,14,14,11,16,27,61,48,109,0.000333,0.172761,15,7774.241066,431.902281,518.282738,102.053748,1,2
0,0,12,12,10,15,25,60,46,106,0.000333,0.164083,15,7383.731342,410.207297,492.248756,91.82264,1,2
0,0,14,14,10,16,26,66,56,122,0.000333,0.191151,15,8601.804684,477.878038,573.453646,97.219281,1,2
0,0,16,16,10,17,27,72,66,138,0.000333,0.218725,15,9842.617129,546.812063,656.174475,102.706149,1,2
0,0,18,18,10,18,28,78,76,154,0.000333,0.246778,20,14806.65316,822.591842,740.332658,108.277931,1,2
0,0,13,13,11,16,27,66,49,115,0.000333,0.182271,15,8202.180941,455.676719,546.812063,102.053748,1,2
0,0,14,14,11,17,28,75,53,128,0.000333,0.205114,15,9230.12145,512.784525,615.34143,107.540616,1,2
0,0,13,13,10,16,26,68,50,118,0.000333,0.184884,15,8319.778301,462.209906,554.651887,97.219281,1,2
0,0,15,15,10,18,28,75,56,131,0.000333,0.209921,15,9446.452422,524.802912,629.763495,108.277931,1,2
0,0,18,18,14,19,33,73,67,140,0.000333,0.235405,21,14830.51871,823.917706,706.215177,134.013592,1,2
0,0,14,14,10,16,26,60,52,112,0.000333,0.175483,15,7896.738726,438.707707,526.449248,97.219281,1,2
0,0,13,13,14,18,32,67,53,120,0.000333,0.2,14,8400,466.666667,600,128.361619,1,2
0,0,14,14,14,18,32,68,54,122,0.000333,0.203333,21,12810,711.666667,610,128.361619,1,2
0,0,9,9,9,10,19,40,31,71,0.000333,0.100534,12,3619.234241,201.068569,301.602853,61.748606,1,2
0,0,10,10,10,10,20,43,32,75,0.000333,0.108048,15,4862.169107,270.120506,324.144607,66.438562,2,2
0,0,10,10,10,11,21,43,33,76,0.000333,0.111272,15,5007.241862,278.180103,333.816124,71.273029,2,2
0,0,12,12,12,14,26,51,38,89,0.000333,0.139446,12,5020.069619,278.892757,418.339135,96.322519,2,2
0,0,12,12,11,14,25,49,38,87,0.000333,0.134672,10,4040.154885,224.453049,404.015489,91.356717,2,2
0,0,11,11,12,13,25,47,36,83,0.000333,0.12848,12,4625.280765,256.960043,385.440064,91.125266,2,2
0,0,11,11,11,13,24,46,36,82,0.000333,0.125322,10,3759.669251,208.870514,375.966925,86.159464,2,2
0,0,14,14,12,14,26,49,38,87,0.000333,0.136313,12,4907.259066,272.625504,408.938255,96.322519,2,2
0,0,12,12,11,14,25,49,38,87,0.000333,0.134672,10,4040.154885,224.453049,404.015489,91.356717,2,2
0,0,12,12,10,14,24,47,38,85,0.000333,0.129907,10,3897.218126,216.512118,389.721813,86.52225,2,2
0,0,14,14,11,14,25,47,38,85,0.000333,0.131576,10,3947.277761,219.293209,394.727776,91.356717,2,2
0,0,11,11,11,13,24,46,36,82,0.000333,0.125322,10,3759.669251,208.870514,375.966925,86.159464,2,2
0,0,11,11,10,13,23,45,36,81,0.000333,0.122136,10,3664.085184,203.560288,366.408518,81.324997,2,2
0,0,14,14,14,11,25,51,33,84,0.000333,0.130028,21,8191.762319,455.097907,390.08392,91.356717,2,2
0,0,11,11,11,10,21,45,32,77,0.000333,0.112736,15,5073.126623,281.840368,338.208442,71.273029,2,2
0,0,10,10,12,12,24,48,36,84,0.000333,0.128379,18,6932.463301,385.13685,385.13685,86.0391,2,2
0,0,11,11,11,11,22,43,33,76,0.000333,0.112972,15,5083.752045,282.430669,338.916803,76.107496,1,2
0,0,11,11,9,11,20,46,37,83,0.000333,0.119573,12,4304.640383,239.146688,358.720032,66.583073,1,2
0,0,14,14,10,12,22,61,45,106,0.000333,0.157567,15,7090.496274,393.91646,472.699752,76.238831,1,2
0,0,16,16,13,16,29,56,49,105,0.000333,0.170029,18,9181.584081,510.088004,510.088004,112.105716,1,2
0,0,11,11,9,14,23,46,41,87,0.000333,0.131183,8,3148.399121,174.911062,393.54989,81.832294,1,2
0,0,12,12,10,13,23,55,41,96,0.000333,0.144754,15,6513.929217,361.884956,434.261948,81.324997,1,2
0,0,13,13,10,15,25,47,43,90,0.000333,0.139316,10,4179.470571,232.192809,417.947057,91.82264,1,2
0,0,11,11,9,14,23,46,41,87,0.000333,0.131183,8,3148.399121,174.911062,393.54989,81.832294,1,2
0,0,13,13,9,15,24,52,51,103,0.000333,0.157417,12,5667.013651,314.834092,472.251138,87.132684,1,2
0,0,15,15,9,16,25,58,61,119,0.000333,0.184206,12,6631.426639,368.412591,552.618887,92.529325,1,2
0,0,17,17,9,17,26,64,71,135,0.000333,0.21152,16,10152.94979,564.052766,634.559362,98.016193,1,2
0,0,12,12,10,15,25,52,44,96,0.000333,0.148603,10,4458.101942,247.67233,445.810194,91.82264,1,2
0,0,13,13,10,16,26,61,48,109,0.000333,0.170783,15,7685.218939,426.956608,512.347929,97.219281,1,2
0,0,12,12,9,15,24,54,45,99,0.000333,0.151304,12,5446.935451,302.607525,453.911288,87.132684,1,2
0,0,14,14,9,16,25,61,51,112,0.000333,0.173371,12,6241.342719,346.741262,520.111893,92.529325,1,2
0,0,17,17,13,18,31,59,62,121,0.000333,0.199819,18,10790.23956,599.457754,599.457754,123.164366,1,2
0,0,13,13,9,15,24,46,47,93,0.000333,0.142134,12,5116.818151,284.267675,426.401513,87.132684,1,2
0,0,12,12,13,17,30,53,48,101,0.000333,0.165199,12,5947.151402,330.3973,495.59595,117.592585,1,2
0,0,13,13,13,17,30,54,49,103,0.000333,0.16847,12,6064.916776,336.939821,505.409731,117.592585,1,2
0,0,9,9,9,10,19,40,30,70,0.000333,0.099118,12,3568.259111,198.236617,297.354926,61.748606,1,2
0,0,10,10,10,10,20,43,31,74,0.000333,0.106608,15,4797.340185,266.518899,319.822679,66.438562,2,2
0,0,10,10,10,11,21,43,32,75,0.000333,0.109808,10,3294.238067,183.013226,329.423807,71.273029,2,2
0,0,12,12,12,14,26,51,37,88,0.000333,0.13788,12,4963.664342,275.75913,413.638695,96.322519,2,2
0,0,12,12,11,14,25,49,37,86,0.000333,0.133124,10,3993.716323,221.873129,399.371632,91.356717,2,2
0,0,11,11,12,13,25,47,35,82,0.000333,0.126932,12,4569.554491,253.864138,380.796208,91.125266,2,2
0,0,11,11,11,13,24,46,35,81,0.000333,0.123794,10,3713.819626,206.323313,371.381963,86.159464,2,2
0,0,14,14,12,14,26,49,37,86,0.000333,0.134746,12,4850.853789,269.491877,404.237816,96.322519,2,2
0,0,12,12,11,14,25,49,37,86,0.000333,0.133124,10,3993.716323,221.873129,399.371632,91.356717,2,2
0,0,12,12,10,14,24,47,37,84,0.000333,0.128379,10,3851.368501,213.964917,385.13685,86.52225,2,2
0,0,14,14,11,14,25,47,37,84,0.000333,0.130028,10,3900.839199,216.713289,390.08392,91.356717,2,2
0,0,11,11,11,13,24,46,35,81,0.000333,0.123794,10,3713.819626,206.323313,371.381963,86.159464,2,2
0,0,11,11,10,13,23,45,35,80,0.000333,0.120628,10,3618.849565,201.047198,361.884956,81.324997,2,2
0,0,14,14,14,11,25,51,32,83,0.000333,0.12848,14,5396.160893,299.786716,385.440064,91.356717,2,2
0,0,11,11,11,10,21,45,31,76,0.000333,0.111272,15,5007.241862,278.180103,333.816124,71.273029,2,2
0,0,10,10,12,12,24,48,35,83,0.000333,0.126851,12,4566.622651,253.701258,380.551888,86.0391,2,2
0,0,11,11,11,11,22,43,32,75,0.000333,0.111486,10,3344.573714,185.809651,334.457371,76.107496,1,2
0,0,11,11,9,11,20,46,36,82,0.000333,0.118133,12,4252.777245,236.265403,354.398104,66.583073,1,2
0,0,14,14,10,12,22,61,44,105,0.000333,0.15608,15,7023.604799,390.200267,468.24032,76.238831,1,2
0,0,16,16,13,16,29,56,48,104,0.000333,0.16841,18,9094.140423,505.230023,505.230023,112.105716,1,2
0,0,12,12,9,14,23,51,43,94,0.000333,0.141738,12,5102.577886,283.476549,425.214824,81.832294,1,2
0,0,13,13,10,13,23,60,43,103,0.000333,0.155309,15,6988.903222,388.272401,465.926881,81.324997,1,2
0,0,14,14,10,15,25,52,45,97,0.000333,0.150151,15,6756.810756,375.378375,450.45405,91.82264,1,2
0,0,12,12,9,14,23,51,43,94,0.000333,0.141738,12,5102.577886,283.476549,425.214824,81.832294,1,2
0,0,14,14,9,15,24,57,53,110,0.000333,0.168115,12,6052.150501,336.230583,504.345875,87.132684,1,2
0,0,16,16,9,16,25,63,63,126,0.000333,0.195042,12,7021.510559,390.08392,585.12588,92.529325,1,2
0,0,18,18,9,17,26,69,73,142,0.000333,0.222487,16,10679.39904,593.299947,667.46244,98.016193,1,2
0,0,13,13,10,15,25,57,46,103,0.000333,0.159439,15,7174.757813,398.597656,478.317188,91.82264,1,2
0,0,14,14,10,16,26,66,50,116,0.000333,0.18175,15,8178.76511,454.375839,545.251007,97.219281,1,2
0,0,13,13,9,15,24,59,47,106,0.000333,0.162002,12,5832.072301,324.004017,486.006025,87.132684,1,2
0,0,15,15,9,17,26,66,53,119,0.000333,0.186451,12,6712.227918,372.901551,559.352326,98.016193,1,2
0,0,18,18,13,18,31,64,64,128,0.000333,0.211379,18,11414.4683,634.137128,634.137128,123.164366,1,2
0,0,14,14,9,15,24,51,49,100,0.000333,0.152832,12,5501.955001,305.664167,458.49625,87.132684,1,2
0,0,13,13,13,17,30,58,50,108,0.000333,0.176648,12,6359.330212,353.296123,529.944184,117.592585,1,2
0,0,14,14,13,17,30,59,51,110,0.000333,0.179919,18,9715.643379,539.757966,539.757966,117.592585,1,2
0,0,10,10,10,12,22,51,36,87,0.000333,0.129324,15,5819.558262,323.308792,387.970551,76.238831,1,2
0,0,11,11,11,12,23,54,37,91,0.000333,0.137215,15,6174.66207,343.036782,411.644138,81.073298,2,2
0,0,11,11,11,13,24,54,38,92,0.000333,0.140606,10,4218.165501,234.342528,421.81655,86.159464,2,2
0,0,13,13,13,16,29,62,43,105,0.000333,0.170029,12,6121.056054,340.05867,510.088004,112.105716,2,2
0,0,13,13,12,16,28,60,43,103,0.000333,0.165053,12,5941.890684,330.105038,495.157557,107.01955,2,2
0,0,12,12,13,15,28,58,41,99,0.000333,0.158643,12,5711.137647,317.285425,475.928137,106.709075,2,2
0,0,12,12,12,15,27,57,41,98,0.000333,0.155326,12,5591.747703,310.65265,465.978975,101.622909,2,2
0,0,15,15,13,16,29,60,43,103,0.000333,0.166791,12,6004.46451,333.581362,500.372042,112.105716,2,2
0,0,13,13,12,16,28,60,43,103,0.000333,0.165053,12,5941.890684,330.105038,495.157557,107.01955,2,2
0,0,13,13,11,16,27,58,43,101,0.000333,0.160081,10,4802.436377,266.802021,480.243638,102.053748,2,2
0,0,11,11,11,13,24,54,37,91,0.000333,0.139077,10,4172.315876,231.795326,417.231588,86.159464,2,2
0,0,12,12,12,15,27,57,41,98,0.000333,0.155326,12,5591.747703,310.65265,465.978975,101.622909,2,2
0,0,12,12,11,15,26,56,41,97,0.000333,0.151981,10,4559.426527,253.301474,455.942653,96.657107,2,2
0,0,15,15,15,13,28,62,38,100,0.000333,0.160245,14,6730.296891,373.905383,480.735492,106.709075,2,2
0,0,12,12,12,12,24,56,37,93,0.000333,0.142134,18,7675.227226,426.401513,426.401513,86.0391,2,2
0,0,11,11,13,14,27,59,41,100,0.000333,0.158496,12,5705.865003,316.9925,475.48875,101.408685,2,2
0,0,12,12,12,13,25,54,38,92,0.000333,0.142412,12,5126.817234,284.82318,427.234769,91.125266,1,2
0,0,15,15,13,14,27,67,47,114,0.000333,0.180686,18,9757.029154,542.057175,542.057175,101.408685,2,2
0,0,15,15,12,16,28,66,55,121,0.000333,0.193897,18,10470.41902,581.689946,581.689946,107.01955,2,2
0,0,12,12,10,13,23,57,42,99,0.000333,0.149278,15,6717.489505,373.193861,447.832634,81.324997,1,2
0,0,15,15,11,14,25,72,50,122,0.000333,0.18885,15,8498.256827,472.125379,566.550455,91.356717,1,2
0,0,17,17,14,18,32,67,54,121,0.000333,0.201667,21,12705,705.833333,605,128.361619,1,2
0,0,12,12,10,16,26,57,46,103,0.000333,0.161382,10,4841.45291,268.969606,484.145291,97.219281,1,2
0,0,13,13,12,13,25,62,44,106,0.000333,0.164083,18,8860.47761,492.248756,492.248756,91.125266,1,2
0,0,13,13,11,15,26,66,46,112,0.000333,0.175483,15,7896.738726,438.707707,526.449248,96.657107,1,2
0,0,14,14,11,17,28,58,48,106,0.000333,0.16986,10,5095.796217,283.09979,509.579622,107.540616,1,2
0,0,12,12,10,16,26,57,46,103,0.000333,0.161382,10,4841.45291,268.969606,484.145291,97.219281,1,2
0,0,14,14,10,17,27,63,56,119,0.000333,0.188611,15,8487.474191,471.526344,565.831613,102.706149,1,2
0,0,16,16,10,18,28,69,66,135,0.000333,0.216331,15,9734.893717,540.827429,648.992914,108.277931,1,2
0,0,18,18,10,19,29,75,76,151,0.000333,0.244518,20,14671.10261,815.061256,733.55513,113.929904,1,2
0,0,13,13,11,15,26,61,48,109,0.000333,0.170783,15,7685.218939,426.956608,512.347929,96.657107,1,2
0,0,13,13,11,17,28,63,49,112,0.000333,0.179475,10,5384.237513,299.124306,538.423751,107.540616,1,2
0,0,14,14,11,18,29,72,53,125,0.000333,0.202416,10,6072.476244,337.359791,607.247624,113.112398,1,2
0,0,13,13,10,17,27,65,50,115,0.000333,0.182271,10,5468.120627,303.784479,546.812063,102.706149,1,2
0,0,15,15,10,18,28,72,56,128,0.000333,0.205114,15,9230.12145,512.784525,615.34143,108.277931,1,2
0,0,18,18,14,20,34,70,67,137,0.000333,0.232327,21,14636.63059,813.146144,696.982409,139.741531,1,2
0,0,14,14,10,17,27,57,52,109,0.000333,0.172761,15,7774.241066,431.902281,518.282738,102.706149,1,2
0,0,13,13,14,19,33,64,53,117,0.000333,0.196731,14,8262.717568,459.039865,590.194112,134.013592,1,2
0,0,14,14,14,19,33,65,54,119,0.000333,0.200094,14,8403.960603,466.8867,600.2829,134.013592,1,2
0,0,10,10,10,12,22,51,35,86,0.000333,0.127837,10,3835.111192,213.061733,383.511119,76.238831,1,2
0,0,11,11,11,12,23,54,36,90,0.000333,0.135707,15,6106.808641,339.267147,407.120576,81.073298,2,2
0,0,11,11,11,13,24,54,37,91,0.000333,0.139077,10,4172.315876,231.795326,417.231588,86.159464,2,2
0,0,13,13,13,16,29,62,42,104,0.000333,0.16841,12,6062.760282,336.820016,505.230023,112.105716,2,2
0,0,13,13,12,16,28,60,42,102,0.000333,0.16345,12,5884.202425,326.900135,490.350202,107.01955,2,2
0,0,12,12,13,15,28,58,40,98,0.000333,0.15704,12,5653.449388,314.080522,471.120782,106.709075,2,2
0,0,12,12,12,15,27,57,40,97,0.000333,0.153741,12,5534.689053,307.482725,461.224088,101.622909,2,2
0,0,15,15,13,16,29,60,42,102,0.000333,0.165171,12,5946.168738,330.342708,495.514062,112.105716,2,2
0,0,13,13,12,16,28,60,42,102,0.000333,0.16345,12,5884.202425,326.900135,490.350202,107.01955,2,2
0,0,13,13,11,16,27,58,42,100,0.000333,0.158496,10,4754.887502,264.160417,475.48875,102.053748,2,2
0,0,15,15,12,16,28,58,42,100,0.000333,0.160245,12,5768.825906,320.490328,480.735492,107.01955,2,2
0,0,12,12,12,15,27,57,40,97,0.000333,0.153741,12,5534.689053,307.482725,461.224088,101.622909,2,2
0,0,12,12,11,15,26,56,40,96,0.000333,0.150414,10,4512.422129,250.690118,451.242213,96.657107,2,2
0,0,15,15,15,13,28,62,37,99,0.000333,0.158643,14,6662.993922,370.166329,475.928137,106.709075,2,2
0,0,12,12,12,12,24,56,36,92,0.000333,0.140606,18,7592.697901,421.81655,421.81655,86.0391,2,2
0,0,11,11,13,14,27,59,40,99,0.000333,0.156911,12,5648.806353,313.822575,470.733863,101.408685,2,2
0,0,12,12,12,13,25,54,37,91,0.000333,0.140864,12,5071.090959,281.727276,422.590913,91.125266,1,2
0,0,15,15,13,14,27,67,46,113,0.000333,0.179101,18,9671.441179,537.302288,537.302288,101.408685,2,2
0,0,15,15,12,16,28,66,54,120,0.000333,0.192294,18,10383.88663,576.882591,576.882591,107.01955,2,2
0,0,12,12,10,13,23,57,41,98,0.000333,0.14777,15,6649.636075,369.424226,443.309072,81.324997,1,2
0,0,15,15,11,14,25,72,49,121,0.000333,0.187302,15,8428.598984,468.255499,561.906599,91.356717,1,2
0,0,17,17,14,18,32,67,53,120,0.000333,0.2,14,8400,466.666667,600,128.361619,1,2
0,0,13,13,10,16,26,62,48,110,0.000333,0.172349,15,7755.725535,430.873641,517.048369,97.219281,1,2
0,0,13,13,12,13,25,62,43,105,0.000333,0.162535,18,8776.888199,487.6049,487.6049,91.125266,1,2
0,0,14,14,11,15,26,71,48,119,0.000333,0.186451,15,8390.284897,466.126939,559.352326,96.657107,1,2
0,0,15,15,11,17,28,63,50,113,0.000333,0.181077,10,5432.311062,301.795059,543.231106,107.540616,1,2
0,0,13,13,10,16,26,62,48,110,0.000333,0.172349,15,7755.725535,430.873641,517.048369,97.219281,1,2
0,0,15,15,10,17,27,68,58,126,0.000333,0.199705,15,8986.737379,499.263188,599.115825,102.706149,1,2
0,0,17,17,10,18,28,74,68,142,0.000333,0.227548,15,10239.66598,568.870332,682.644399,108.277931,1,2
0,0,19,19,10,19,29,80,78,158,0.000333,0.255854,20,15351.21995,852.845552,767.560997,113.929904,1,2
0,0,13,13,11,15,26,61,47,108,0.000333,0.169216,15,7614.712343,423.039575,507.64749,96.657107,1,2
0,0,14,14,11,17,28,68,51,119,0.000333,0.190692,15,8581.128536,476.729363,572.075236,107.540616,1,2
0,0,15,15,11,18,29,77,55,132,0.000333,0.213751,15,9618.80237,534.377909,641.253491,113.112398,1,2
0,0,14,14,10,17,27,70,52,122,0.000333,0.193365,15,8701.444129,483.413563,580.096275,102.706149,1,2
0,0,16,16,10,19,29,77,58,135,0.000333,0.218609,15,9837.411515,546.522862,655.827434,113.929904,1,2
0,0,19,19,14,20,34,75,69,144,0.000333,0.244198,21,15384.48763,854.693757,732.594649,139.741531,1,2
0,0,15,15,10,17,27,62,54,116,0.000333,0.183856,15,8273.504254,459.639125,551.56695,102.706149,1,2
0,0,14,14,14,19,33,69,55,124,0.000333,0.208502,14,8757.068191,486.503788,625.504871,134.013592,1,2
0,0,15,15,14,19,33,70,56,126,0.000333,0.211865,14,8898.311227,494.350624,635.593659,134.013592,1,2
0,0,10,10,10,12,22,51,36,87,0.000333,0.129324,15,5819.558262,323.308792,387.970551,76.238831,1,2
0,0,11,11,11,12,23,54,37,91,0.000333,0.137215,15,6174.66207,343.036782,411.644138,81.073298,2,2
0,0,11,11,11,13,24,54,38,92,0.000333,0.140606,10,4218.165501,234.342528,421.81655,86.159464,2,2
0,0,13,13,13,16,29,62,43,105,0.000333,0.170029,12,6121.056054,340.05867,510.088004,112.105716,2,2
0,0,13,13,12,16,28,60,43,103,0.000333,0.165053,12,5941.890684,330.105038,495.157557,107.01955,2,2
0,0,12,12,13,15,28,58,41,99,0.000333,0.158643,12,5711.137647,317.285425,475.928137,106.709075,2,2
0,0,12,12,12,15,27,57,41,98,0.000333,0.155326,12,5591.747703,310.65265,465.978975,101.622909,2,2
0,0,15,15,13,16,29,60,43,103,0.000333,0.166791,12,6004.46451,333.581362,500.372042,112.105716,2,2
0,0,13,13,12,16,28,60,43,103,0.000333,0.165053,12,5941.890684,330.105038,495.157557,107.01955,2,2
0,0,13,13,11,16,27,58,43,101,0.000333,0.160081,10,4802.436377,266.802021,480.243638,102.053748,2,2
0,0,15,15,12,16,28,58,43,101,0.000333,0.161848,12,5826.514166,323.695231,485.542847,107.01955,2,2
0,0,12,12,12,15,27,57,41,98,0.000333,0.155326,12,5591.747703,310.65265,465.978975,101.622909,2,2
0,0,12,12,11,15,26,56,41,97,0.000333,0.151981,10,4559.426527,253.301474,455.942653,96.657107,2,2
0,0,15,15,15,13,28,62,38,100,0.000333,0.160245,14,6730.296891,373.905383,480.735492,106.709075,2,2
0,0,12,12,12,12,24,56,37,93,0.000333,0.142134,18,7675.227226,426.401513,426.401513,86.0391,2,2
0,0,11,11,13,14,27,59,41,100,0.000333,0.158496,12,5705.865003,316.9925,475.48875,101.408685,2,2
0,0,12,12,12,13,25,54,38,92,0.000333,0.142412,12,5126.817234,284.82318,427.234769,91.125266,1,2
0,0,15,15,13,14,27,67,47,114,0.000333,0.180686,18,9757.029154,542.057175,542.057175,101.408685,2,2
0,0,15,15,12,16,28,66,55,121,0.000333,0.193897,18,10470.41902,581.689946,581.689946,107.01955,2,2
0,0,12,12,10,13,23,57,42,99,0.000333,0.149278,15,6717.489505,373.193861,447.832634,81.324997,1,2
0,0,15,15,11,14,25,72,50,122,0.000333,0.18885,15,8498.256827,472.125379,566.550455,91.356717,1,2
0,0,17,17,14,18,32,67,54,121,0.000333,0.201667,21,12705,705.833333,605,128.361619,1,2
0,0,12,12,10,16,26,57,46,103,0.000333,0.161382,10,4841.45291,268.969606,484.145291,97.219281,1,2
0,0,13,13,12,13,25,62,44,106,0.000333,0.164083,18,8860.47761,492.248756,492.248756,91.125266,1,2
0,0,13,13,11,15,26,66,46,112,0.000333,0.175483,15,7896.738726,438.707707,526.449248,96.657107,1,2
0,0,14,14,11,17,28,58,48,106,0.000333,0.16986,10,5095.796217,283.09979,509.579622,107.540616,1,2
0,0,12,12,10,16,26,57,46,103,0.000333,0.161382,10,4841.45291,268.969606,484.145291,97.219281,1,2
0,0,14,14,10,17,27,63,56,119,0.000333,0.188611,15,8487.474191,471.526344,565.831613,102.706149,1,2
0,0,16,16,10,18,28,69,66,135,0.000333,0.216331,15,9734.893717,540.827429,648.992914,108.277931,1,2
0,0,18,18,10,19,29,75,76,151,0.000333,0.244518,20,14671.10261,815.061256,733.55513,113.929904,1,2
0,0,13,13,11,15,26,61,48,109,0.000333,0.170783,15,7685.218939,426.956608,512.347929,96.657107,1,2
0,0,13,13,11,17,28,63,49,112,0.000333,0.179475,10,5384.237513,299.124306,538.423751,107.540616,1,2
0,0,14,14,11,18,29,72,53,125,0.000333,0.202416,10,6072.476244,337.359791,607.247624,113.112398,1,2
0,0,13,13,10,17,27,65,50,115,0.000333,0.182271,10,5468.120627,303.784479,546.812063,102.706149,1,2
0,0,15,15,10,18,28,72,56,128,0.000333,0.205114,15,9230.12145,512.784525,615.34143,108.277931,1,2
0,0,18,18,14,20,34,70,67,137,0.000333,0.232327,21,14636.63059,813.146144,696.982409,139.741531,1,2
0,0,14,14,10,17,27,57,52,109,0.000333,0.172761,15,7774.241066,431.902281,518.282738,102.706149,1,2
0,0,13,13,14,19,33,64,53,117,0.000333,0.196731,14,8262.717568,459.039865,590.194112,134.013592,1,2
0,0,14,14,14,19,33,65,54,119,0.000333,0.200094,14,8403.960603,466.8867,600.2829,134.013592,1,2
0,0,10,10,10,12,22,51,35,86,0.000333,0.127837,10,3835.111192,213.061733,383.511119,76.238831,1,2
0,0,11,11,11,12,23,54,36,90,0.000333,0.135707,15,6106.808641,339.267147,407.120576,81.073298,2,2
0,0,11,11,11,13,24,54,37,91,0.000333,0.139077,10,4172.315876,231.795326,417.231588,86.159464,2,2
0,0,13,13,13,16,29,62,42,104,0.000333,0.16841,12,6062.760282,336.820016,505.230023,112.105716,2,2
0,0,13,13,12,16,28,60,42,102,0.000333,0.16345,12,5884.202425,326.900135,490.350202,107.01955,2,2
0,0,12,12,13,15,28,58,40,98,0.000333,0.15704,12,5653.449388,314.080522,471.120782,106.709075,2,2
0,0,12,12,12,15,27,57,40,97,0.000333,0.153741,12,5534.689053,307.482725,461.224088,101.622909,2,2
0,0,15,15,13,16,29,60,42,102,0.000333,0.165171,12,5946.168738,330.342708,495.514062,112.105716,2,2
0,0,13,13,12,16,28,60,42,102,0.000333,0.16345,12,5884.202425,326.900135,490.350202,107.01955,2,2
0,0,13,13,11,16,27,58,42,100,0.000333,0.158496,10,4754.887502,264.160417,475.48875,102.053748,2,2
0,0,15,15,12,16,28,58,42,100,0.000333,0.160245,12,5768.825906,320.490328,480.735492,107.01955,2,2
0,0,12,12,12,15,27,57,40,97,0.000333,0.153741,12,5534.689053,307.482725,461.224088,101.622909,2,2
0,0,12,12,11,15,26,56,40,96,0.000333,0.150414,10,4512.422129,250.690118,451.242213,96.657107,2,2
0,0,15,15,15,13,28,62,37,99,0.000333,0.158643,14,6662.993922,370.166329,475.928137,106.709075,2,2
0,0,12,12,12,12,24,56,36,92,0.000333,0.140606,18,7592.697901,421.81655,421.81655,86.0391,2,2
0,0,11,11,13,14,27,59,40,99,0.000333,0.156911,12,5648.806353,313.822575,470.733863,101.408685,2,2
0,0,12,12,12,13,25,54,37,91,0.000333,0.140864,12,5071.090959,281.727276,422.590913,91.125266,1,2
0,0,15,15,13,14,27,67,46,113,0.000333,0.179101,18,9671.441179,537.302288,537.302288,101.408685,2,2
0,0,15,15,12,16,28,66,54,120,0.000333,0.192294,18,10383.88663,576.882591,576.882591,107.01955,2,2
0,0,12,12,10,13,23,57,41,98,0.000333,0.14777,15,6649.636075,369.424226,443.309072,81.324997,1,2
0,0,15,15,11,14,25,72,49,121,0.000333,0.187302,15,8428.598984,468.255499,561.906599,91.356717,1,2
0,0,17,17,14,18,32,67,53,120,0.000333,0.2,14,8400,466.666667,600,128.361619,1,2
0,0,13,13,10,16,26,62,48,110,0.000333,0.172349,15,7755.725535,430.873641,517.048369,97.219281,1,2
0,0,13,13,12,13,25,62,43,105,0.000333,0.162535,18,8776.888199,487.6049,487.6049,91.125266,1,2
0,0,14,14,11,15,26,71,48,119,0.000333,0.186451,15,8390.284897,466.126939,559.352326,96.657107,1,2
0,0,15,15,11,17,28,63,50,113,0.000333,0.181077,10,5432.311062,301.795059,543.231106,107.540616,1,2
0,0,13,13,10,16,26,62,48,110,0.000333,0.172349,15,7755.725535,430.873641,517.048369,97.219281,1,2
0,0,15,15,10,17,27,68,58,126,0.000333,0.199705,15,8986.737379,499.263188,599.115825,102.706149,1,2
0,0,17,17,10,18,28,74,68,142,0.000333,0.227548,15,10239.66598,568.870332,682.644399,108.277931,1,2
0,0,19,19,10,19,29,80,78,158,0.000333,0.255854,20,15351.21995,852.845552,767.560997,113.929904,1,2
0,0,13,13,11,15,26,61,47,108,0.000333,0.169216,15,7614.712343,423.039575,507.64749,96.657107,1,2
0,0,14,14,11,17,28,68,51,119,0.000333,0.190692,15,8581.128536,476.729363,572.075236,107.540616,1,2
0,0,15,15,11,18,29,77,55,132,0.000333,0.213751,15,9618.80237,534.377909,641.253491,113.112398,1,2
0,0,14,14,10,17,27,70,52,122,0.000333,0.193365,15,8701.444129,483.413563,580.096275,102.706149,1,2
0,0,16,16,10,19,29,77,58,135,0.000333,0.218609,15,9837.411515,546.522862,655.827434,113.929904,1,2
0,0,16,16,11,19,30,69,61,130,0.000333,0.212632,15,9568.436661,531.579815,637.895777,118.764371,1,2
0,0,15,15,10,17,27,62,54,116,0.000333,0.183856,15,8273.504254,459.639125,551.56695,102.706149,1,2
0,0,14,14,14,19,33,69,55,124,0.000333,0.208502,14,8757.068191,486.503788,625.504871,134.013592,1,2
0,0,15,15,14,19,33,70,56,126,0.000333,0.211865,14,8898.311227,494.350624,635.593659,134.013592,1,2
0,0,13,13,14,18,32,58,51,109,0.000333,0.181667,14,7630,423.888889,545,128.361619,1,2
0,0,14,14,13,18,31,59,52,111,0.000333,0.183305,12,6598.989485,366.610527,549.91579,123.164366,1,2
0,0,14,14,14,18,32,63,53,116,0.000333,0.193333,14,8120,451.111111,580,128.361619,1,2
0,0,15,15,13,18,31,64,54,118,0.000333,0.194865,18,10522.71296,584.595165,584.595165,123.164366,1,2
0,0,13,13,14,18,32,58,51,109,0.000333,0.181667,14,7630,423.888889,545,128.361619,1,2
0,0,14,14,13,18,31,59,52,111,0.000333,0.183305,12,6598.989485,366.610527,549.91579,123.164366,1,2
0,0,14,14,14,18,32,63,53,116,0.000333,0.193333,14,8120,451.111111,580,128.361619,1,2
0,0,15,15,13,18,31,64,54,118,0.000333,0.194865,18,10522.71296,584.595165,584.595165,123.164366,1,2
0,0,9,9,10,11,21,49,34,83,0.000333,0.121521,15,5468.435191,303.801955,364.562346,71.273029,1,2
0,0,10,10,11,11,22,52,35,87,0.000333,0.129324,15,5819.558262,323.308792,387.970551,76.107496,2,2
0,0,10,10,11,12,23,52,36,88,0.000333,0.132691,15,5971.101782,331.727877,398.073452,81.073298,2,2
0,0,12,12,13,15,28,60,41,101,0.000333,0.161848,12,5826.514166,323.695231,485.542847,106.709075,2,2
0,0,12,12,12,15,27,58,41,99,0.000333,0.156911,12,5648.806353,313.822575,470.733863,101.622909,2,2
0,0,11,11,13,14,27,56,39,95,0.000333,0.150571,12,5420.571752,301.142875,451.714313,101.408685,2,2
0,0,11,11,12,14,26,55,39,94,0.000333,0.14728,12,5302.096002,294.560889,441.841334,96.322519,2,2
0,0,14,14,13,15,28,58,41,99,0.000333,0.158643,12,5711.137647,317.285425,475.928137,106.709075,2,2
0,0,12,12,12,15,27,58,41,99,0.000333,0.156911,12,5648.806353,313.822575,470.733863,101.622909,2,2
0,0,10,10,11,12,23,52,35,87,0.000333,0.131183,10,3935.498902,218.638828,393.54989,81.073298,2,2
0,0,14,14,12,15,27,56,41,97,0.000333,0.153741,12,5534.689053,307.482725,461.224088,101.622909,2,2
0,0,11,11,12,14,26,55,39,94,0.000333,0.14728,12,5302.096002,294.560889,441.841334,96.322519,2,2
0,0,11,11,11,14,25,54,39,93,0.000333,0.14396,10,4318.786256,239.93257,431.878626,91.356717,2,2
0,0,14,14,15,12,27,60,36,96,0.000333,0.152156,21,9585.853204,532.5474,456.4692,101.622909,2,2
0,0,11,11,12,11,23,54,35,89,0.000333,0.134199,18,7246.746254,402.597014,402.597014,81.073298,2,2
0,0,10,10,13,13,26,57,39,96,0.000333,0.150414,18,8122.359833,451.242213,451.242213,96.211433,2,2
0,0,11,11,12,12,24,52,36,88,0.000333,0.134492,18,7262.580601,403.4767,403.4767,86.0391,1,2
0,0,11,11,10,12,22,55,40,95,0.000333,0.141215,15,6354.690057,353.038336,423.646004,76.238831,1,2
0,0,14,14,11,13,24,70,48,118,0.000333,0.180342,15,8115.383626,450.854646,541.025575,86.159464,1,2
0,0,16,16,14,17,31,65,52,117,0.000333,0.193214,21,12172.46034,676.247796,579.640968,122.789837,1,2
0,0,11,11,10,15,25,55,44,99,0.000333,0.153247,10,4597.417628,255.41209,459.741763,91.82264,1,2
0,0,12,12,11,14,25,64,44,108,0.000333,0.167179,15,7523.047027,417.947057,501.536468,91.356717,1,2
0,0,13,13,11,16,27,56,46,102,0.000333,0.161666,10,4849.985252,269.443625,484.998525,102.053748,1,2
0,0,11,11,10,15,25,55,44,99,0.000333,0.153247,10,4597.417628,255.41209,459.741763,91.82264,1,2
0,0,13,13,10,16,26,61,54,115,0.000333,0.180184,15,8108.258514,450.458806,540.550568,97.219281,1,2
0,0,15,15,10,17,27,67,64,131,0.000333,0.20763,15,9343.353942,519.075219,622.890263,102.706149,1,2
0,0,17,17,10,18,28,73,74,147,0.000333,0.23556,20,14133.62347,785.201304,706.681174,108.277931,1,2
0,0,12,12,11,16,27,61,47,108,0.000333,0.171176,10,5135.278502,285.29325,513.52785,102.053748,1,2
0,0,13,13,11,17,28,70,51,121,0.000333,0.193897,15,8725.349184,484.741621,581.689946,107.540616,1,2
0,0,12,12,10,16,26,63,48,111,0.000333,0.173916,15,7826.232131,434.790674,521.748809,97.219281,1,2
0,0,14,14,10,17,27,70,54,124,0.000333,0.196535,15,8844.090754,491.338375,589.60605,102.706149,1,2
0,0,14,14,11,18,29,62,57,119,0.000333,0.1927,15,8671.496076,481.749782,578.099738,113.112398,1,2
0,0,13,13,10,16,26,55,50,105,0.000333,0.164515,15,7403.192556,411.288475,493.54617,97.219281,1,2
0,0,12,12,14,18,32,62,51,113,0.000333,0.188333,14,7910,439.444444,565,128.361619,1,2
0,0,13,13,14,18,32,63,52,115,0.000333,0.191667,14,8050,447.222222,575,128.361619,1,2
0,0,9,9,10,11,21,49,33,82,0.000333,0.120057,15,5402.55043,300.141691,360.170029,71.273029,1,2
0,0,10,10,11,11,22,52,34,86,0.000333,0.127837,15,5752.666788,319.592599,383.511119,76.107496,2,2
0,0,10,10,11,12,23,52,35,87,0.000333,0.131183,10,3935.498902,218.638828,393.54989,81.073298,2,2
0,0,12,12,13,15,28,60,40,100,0.000333,0.160245,12,5768.825906,320.490328,480.735492,106.709075,2,2
0,0,12,12,12,15,27,58,40,98,0.000333,0.155326,12,5591.747703,310.65265,465.978975,101.622909,2,2
0,0,11,11,13,14,27,56,38,94,0.000333,0.148986,12,5363.513102,297.97295,446.959425,101.408685,2,2
0,0,11,11,12,14,26,55,38,93,0.000333,0.145714,12,5245.690725,291.427263,437.140894,96.322519,2,2
0,0,14,14,13,15,28,58,40,98,0.000333,0.15704,12,5653.449388,314.080522,471.120782,106.709075,2,2
0,0,12,12,12,15,27,58,40,98,0.000333,0.155326,12,5591.747703,310.65265,465.978975,101.622909,2,2
0,0,12,12,11,15,26,56,40,96,0.000333,0.150414,10,4512.422129,250.690118,451.242213,96.657107,2,2
0,0,14,14,12,15,27,56,40,96,0.000333,0.152156,12,5477.630402,304.3128,456.4692,101.622909,2,2
0,0,11,11,12,14,26,55,38,93,0.000333,0.145714,12,5245.690725,291.427263,437.140894,96.322519,2,2
0,0,11,11,11,14,25,54,38,92,0.000333,0.142412,10,4272.347695,237.35265,427.234769,91.356717,2,2
0,0,14,14,15,12,27,60,35,95,0.000333,0.150571,14,6324.000378,351.333354,451.714313,101.622909,2,2
0,0,11,11,12,11,23,54,34,88,0.000333,0.132691,18,7165.322138,398.073452,398.073452,81.073298,2,2
0,0,10,10,13,13,26,57,38,95,0.000333,0.148847,12,5358.501279,297.694515,446.541773,96.211433,2,2
0,0,11,11,12,12,24,52,35,87,0.000333,0.132964,12,4786.700851,265.927825,398.891738,86.0391,1,2
0,0,11,11,10,12,22,55,39,94,0.000333,0.139729,15,6287.798582,349.322143,419.186572,76.238831,1,2
0,0,14,14,11,13,24,70,47,117,0.000333,0.178814,15,8046.609189,447.033844,536.440613,86.159464,1,2
0,0,16,16,14,17,31,65,51,116,0.000333,0.191562,21,12068.42221,670.467901,574.686772,122.789837,1,2
0,0,12,12,10,15,25,60,46,106,0.000333,0.164083,15,7383.731342,410.207297,492.248756,91.82264,1,2
0,0,13,13,11,14,25,69,46,115,0.000333,0.178014,15,8010.651927,445.036218,534.043462,91.356717,1,2
0,0,14,14,11,16,27,61,48,109,0.000333,0.172761,15,7774.241066,431.902281,518.282738,102.053748,1,2
0,0,12,12,10,15,25,60,46,106,0.000333,0.164083,15,7383.731342,410.207297,492.248756,91.82264,1,2
0,0,14,14,10,16,26,66,56,122,0.000333,0.191151,15,8601.804684,477.878038,573.453646,97.219281,1,2
0,0,16,16,10,17,27,72,66,138,0.000333,0.218725,15,9842.617129,546.812063,656.174475,102.706149,1,2
0,0,18,18,10,18,28,78,76,154,0.000333,0.246778,20,14806.65316,822.591842,740.332658,108.277931,1,2
0,0,13,13,11,16,27,66,49,115,0.000333,0.182271,15,8202.180941,455.676719,546.812063,102.053748,1,2
0,0,14,14,11,17,28,75,53,128,0.000333,0.205114,15,9230.12145,512.784525,615.34143,107.540616,1,2
0,0,13,13,10,16,26,68,50,118,0.000333,0.184884,15,8319.778301,462.209906,554.651887,97.219281,1,2
0,0,15,15,10,18,28,75,56,131,0.000333,0.209921,15,9446.452422,524.802912,629.763495,108.277931,1,2
0,0,18,18,14,19,33,73,67,140,0.000333,0.235405,21,14830.51871,823.917706,706.215177,134.013592,1,2
0,0,14,14,10,16,26,60,52,112,0.000333,0.175483,15,7896.738726,438.707707,526.449248,97.219281,1,2
0,0,13,13,14,18,32,67,53,120,0.000333,0.2,14,8400,466.666667,600,128.361619,1,2
0,0,14,14,14,18,32,68,54,122,0.000333,0.203333,21,12810,711.666667,610,128.361619,1,2
0,0,9,9,9,10,19,40,31,71,0.000333,0.100534,12,3619.234241,201.068569,301.602853,61.748606,1,2
0,0,10,10,10,10,20,43,32,75,0.000333,0.108048,15,4862.169107,270.120506,324.144607,66.438562,2,2
0,0,10,10,10,11,21,43,33,76,0.000333,0.111272,15,5007.241862,278.180103,333.816124,71.273029,2,2
0,0,12,12,12,14,26,51,38,89,0.000333,0.139446,12,5020.069619,278.892757,418.339135,96.322519,2,2
0,0,12,12,11,14,25,49,38,87,0.000333,0.134672,10,4040.154885,224.453049,404.015489,91.356717,2,2
0,0,11,11,12,13,25,47,36,83,0.000333,0.12848,12,4625.280765,256.960043,385.440064,91.125266,2,2
0,0,11,11,11,13,24,46,36,82,0.000333,0.125322,10,3759.669251,208.870514,375.966925,86.159464,2,2
0,0,14,14,12,14,26,49,38,87,0.000333,0.136313,12,4907.259066,272.625504,408.938255,96.322519,2,2
0,0,12,12,11,14,25,49,38,87,0.000333,0.134672,10,4040.154885,224.453049,404.015489,91.356717,2,2
0,0,12,12,10,14,24,47,38,85,0.000333,0.129907,10,3897.218126,216.512118,389.721813,86.52225,2,2
0,0,14,14,11,14,25,47,38,85,0.000333,0.131576,10,3947.277761,219.293209,394.727776,91.356717,2,2
0,0,11,11,11,13,24,46,36,82,0.000333,0.125322,10,3759.669251,208.870514,375.966925,86.159464,2,2
0,0,11,11,10,13,23,45,36,81,0.000333,0.122136,10,3664.085184,203.560288,366.408518,81.324997,2,2
0,0,14,14,14,11,25,51,33,84,0.000333,0.130028,21,8191.762319,455.097907,390.08392,91.356717,2,2
0,0,11,11,11,10,21,45,32,77,0.000333,0.112736,15,5073.126623,281.840368,338.208442,71.273029,2,2
0,0,10,10,12,12,24,48,36,84,0.000333,0.128379,18,6932.463301,385.13685,385.13685,86.0391,2,2
0,0,11,11,11,11,22,43,33,76,0.000333,0.112972,15,5083.752045,282.430669,338.916803,76.107496,1,2
0,0,11,11,9,11,20,46,37,83,0.000333,0.119573,12,4304.640383,239.146688,358.720032,66.583073,1,2
0,0,14,14,10,12,22,61,45,106,0.000333,0.157567,15,7090.496274,393.91646,472.699752,76.238831,1,2
0,0,16,16,13,16,29,56,49,105,0.000333,0.170029,18,9181.584081,510.088004,510.088004,112.105716,1,2
0,0,11,11,9,14,23,46,41,87,0.000333,0.131183,8,3148.399121,174.911062,393.54989,81.832294,1,2
0,0,12,12,10,13,23,55,41,96,0.000333,0.144754,15,6513.929217,361.884956,434.261948,81.324997,1,2
0,0,13,13,10,15,25,47,43,90,0.000333,0.139316,10,4179.470571,232.192809,417.947057,91.82264,1,2
0,0,11,11,9,14,23,46,41,87,0.000333,0.131183,8,3148.399121,174.911062,393.54989,81.832294,1,2
0,0,13,13,9,15,24,52,51,103,0.000333,0.157417,12,5667.013651,314.834092,472.251138,87.132684,1,2
0,0,15,15,9,16,25,58,61,119,0.000333,0.184206,12,6631.426639,368.412591,552.618887,92.529325,1,2
0,0,17,17,9,17,26,64,71,135,0.000333,0.21152,16,10152.94979,564.052766,634.559362,98.016193,1,2
0,0,12,12,10,15,25,52,44,96,0.000333,0.148603,10,4458.101942,247.67233,445.810194,91.82264,1,2
0,0,13,13,10,16,26,61,48,109,0.000333,0.170783,15,7685.218939,426.956608,512.347929,97.219281,1,2
0,0,12,12,9,15,24,54,45,99,0.000333,0.151304,12,5446.935451,302.607525,453.911288,87.132684,1,2
0,0,14,14,9,16,25,61,51,112,0.000333,0.173371,12,6241.342719,346.741262,520.111893,92.529325,1,2
0,0,14,14,10,17,27,53,54,107,0.000333,0.169591,15,7631.594441,423.977469,508.772963,102.706149,1,2
0,0,13,13,9,15,24,46,47,93,0.000333,0.142134,12,5116.818151,284.267675,426.401513,87.132684,1,2
0,0,12,12,13,17,30,53,48,101,0.000333,0.165199,12,5947.151402,330.3973,495.59595,117.592585,1,2
0,0,13,13,13,17,30,54,49,103,0.000333,0.16847,12,6064.916776,336.939821,505.409731,117.592585,1,2
0,0,9,9,9,10,19,40,30,70,0.000333,0.099118,12,3568.259111,198.236617,297.354926,61.748606,1,2
0,0,10,10,10,10,20,43,31,74,0.000333,0.106608,15,4797.340185,266.518899,319.822679,66.438562,2,2
0,0,10,10,10,11,21,43,32,75,0.000333,0.109808,10,3294.238067,183.013226,329.423807,71.273029,2,2
0,0,12,12,12,14,26,51,37,88,0.000333,0.13788,12,4963.664342,275.75913,413.638695,96.322519,2,2
0,0,12,12,11,14,25,49,37,86,0.000333,0.133124,10,3993.716323,221.873129,399.371632,91.356717,2,2
0,0,11,11,12,13,25,47,35,82,0.000333,0.126932,12,4569.554491,253.864138,380.796208,91.125266,2,2
0,0,11,11,11,13,24,46,35,81,0.000333,0.123794,10,3713.819626,206.323313,371.381963,86.159464,2,2
0,0,14,14,12,14,26,49,37,86,0.000333,0.134746,12,4850.853789,269.491877,404.237816,96.322519,2,2
0,0,12,12,11,14,25,49,37,86,0.000333,0.133124,10,3993.716323,221.873129,399.371632,91.356717,2,2
0,0,12,12,10,14,24,47,37,84,0.000333,0.128379,10,3851.368501,213.964917,385.13685,86.52225,2,2
0,0,14,14,11,14,25,47,37,84,0.000333,0.130028,10,3900.839199,216.713289,390.08392,91.356717,2,2
0,0,11,11,11,13,24,46,35,81,0.000333,0.123794,10,3713.819626,206.323313,371.381963,86.159464,2,2
0,0,11,11,10,13,23,45,35,80,0.000333,0.120628,10,3618.849565,201.047198,361.884956,81.324997,2,2
0,0,14,14,14,11,25,51,32,83,0.000333,0.12848,14,5396.160893,299.786716,385.440064,91.356717,2,2
0,0,11,11,11,10,21,45,31,76,0.000333,0.111272,15,5007.241862,278.180103,333.816124,71.273029,2,2
0,0,10,10,12,12,24,48,35,83,0.000333,0.126851,12,4566.622651,253.701258,380.551888,86.0391,2,2
0,0,11,11,11,11,22,43,32,75,0.000333,0.111486,10,3344.573714,185.809651,334.457371,76.107496,1,2
0,0,11,11,9,11,20,46,36,82,0.000333,0.118133,12,4252.777245,236.265403,354.398104,66.583073,1,2
0,0,14,14,10,12,22,61,44,105,0.000333,0.15608,15,7023.604799,390.200267,468.24032,76.238831,1,2
0,0,16,16,13,16,29,56,48,104,0.000333,0.16841,18,9094.140423,505.230023,505.230023,112.105716,1,2
0,0,12,12,9,14,23,51,43,94,0.000333,0.141738,12,5102.577886,283.476549,425.214824,81.832294,1,2
0,0,13,13,10,13,23,60,43,103,0.000333,0.155309,15,6988.903222,388.272401,465.926881,81.324997,1,2
0,0,14,14,10,15,25,52,45,97,0.000333,0.150151,15,6756.810756,375.378375,450.45405,91.82264,1,2
0,0,12,12,9,14,23,51,43,94,0.000333,0.141738,12,5102.577886,283.476549,425.214824,81.832294,1,2
0,0,14,14,9,15,24,57,53,110,0.000333,0.168115,12,6052.150501,336.230583,504.345875,87.132684,1,2
0,0,16,16,9,16,25,63,63,126,0.000333,0.195042,12,7021.510559,390.08392,585.12588,92.529325,1,2
0,0,18,18,9,17,26,69,73,142,0.000333,0.222487,16,10679.39904,593.299947,667.46244,98.016193,1,2
0,0,13,13,10,15,25,57,46,103,0.000333,0.159439,15,7174.757813,398.597656,478.317188,91.82264,1,2
0,0,14,14,10,16,26,66,50,116,0.000333,0.18175,15,8178.76511,454.375839,545.251007,97.219281,1,2
0,0,13,13,9,15,24,59,47,106,0.000333,0.162002,12,5832.072301,324.004017,486.006025,87.132684,1,2
0,0,15,15,9,17,26,66,53,119,0.000333,0.186451,12,6712.227918,372.901551,559.352326,98.016193,1,2
0,0,18,18,13,18,31,64,64,128,0.000333,0.211379,18,11414.4683,634.137128,634.137128,123.164366,1,2
0,0,14,14,9,15,24,51,49,100,0.000333,0.152832,12,5501.955001,305.664167,458.49625,87.132684,1,2
0,0,13,13,13,17,30,58,50,108,0.000333,0.176648,12,6359.330212,353.296123,529.944184,117.592585,1,2
0,0,14,14,13,17,30,59,51,110,0.000333,0.179919,18,9715.643379,539.757966,539.757966,117.592585,1,2
0,0,14,14,15,15,30,70,39,109,0.000333,0.178284,14,7487.915049,415.99528,534.851075,117.206718,6,2
0,0,16,16,15,15,30,76,41,117,0.000333,0.191369,14,8037.486796,446.527044,574.1062,117.206718,8,2
0,0,16,16,15,16,31,76,43,119,0.000333,0.196516,14,8253.691053,458.538392,589.549361,122.603359,8,2
0,0,18,18,17,18,35,84,47,131,0.000333,0.223979,16,10750.9772,597.276511,671.936075,144.545518,8,2
0,0,18,18,16,18,34,82,47,129,0.000333,0.218761,16,10500.5233,583.362406,656.282707,139.05865,8,2
0,0,17,17,17,18,35,80,46,126,0.000333,0.21543,16,10340.63456,574.479698,646.28966,144.545518,8,2
0,0,17,17,16,18,34,79,46,125,0.000333,0.211978,16,10174.92568,565.273649,635.932855,139.05865,8,2
0,0,20,20,17,18,35,82,47,129,0.000333,0.220559,16,10586.84015,588.157786,661.677509,144.545518,8,2
0,0,18,18,16,18,34,82,47,129,0.000333,0.218761,16,10500.5233,583.362406,656.282707,139.05865,8,2
0,0,18,18,15,18,33,80,47,127,0.000333,0.213546,14,8968.932744,498.274041,640.638053,133.662009,8,2
0,0,20,20,16,18,34,80,47,127,0.000333,0.215369,16,10337.72449,574.318027,646.107781,139.05865,8,2
0,0,7,7,10,12,22,27,22,49,0.000333,0.072837,5,1092.560747,60.697819,218.512149,76.238831,2,2
0,0,7,7,10,12,22,27,22,49,0.000333,0.072837,5,1092.560747,60.697819,218.512149,76.238831,2,2
0,0,7,7,10,11,21,27,21,48,0.000333,0.070277,5,1054.156181,58.564232,210.831236,71.273029,2,2
0,0,7,7,10,11,21,27,21,48,0.000333,0.070277,5,1054.156181,58.564232,210.831236,71.273029,2,2
0,0,7,7,10,11,21,27,21,48,0.000333,0.070277,5,1054.156181,58.564232,210.831236,71.273029,2,2
0,0,7,7,10,11,21,27,21,48,0.000333,0.070277,5,1054.156181,58.564232,210.831236,71.273029,2,2
0,0,10,10,11,12,23,34,25,59,0.000333,0.088963,10,2668.901554,148.272309,266.890155,81.073298,2,2
0,0,7,7,10,12,22,27,22,49,0.000333,0.072837,5,1092.560747,60.697819,218.512149,76.238831,2,2
0,0,7,7,10,12,22,27,22,49,0.000333,0.072837,5,1092.560747,60.697819,218.512149,76.238831,2,2
0,0,8,8,12,11,23,29,22,51,0.000333,0.076901,12,2768.419917,153.801107,230.70166,81.073298,2,2
0,0,7,7,10,10,20,27,21,48,0.000333,0.069151,10,2074.525486,115.251416,207.452549,66.438562,2,2
0,0,7,7,12,11,23,32,25,57,0.000333,0.085948,12,3094.116378,171.895354,257.843031,81.073298,2,2
0,0,8,8,11,10,21,27,22,49,0.000333,0.071741,10,2152.235537,119.568641,215.223554,71.273029,1,2
0,0,8,8,9,11,20,30,26,56,0.000333,0.080676,8,1936.223787,107.567988,242.027973,66.583073,1,2
0,0,11,11,10,12,22,45,34,79,0.000333,0.117432,10,3522.950979,195.719499,352.295098,76.238831,1,2
0,0,9,9,10,17,27,32,32,64,0.000333,0.101438,5,1521.564001,84.531333,304.3128,102.706149,1,2
0,0,8,8,9,15,24,30,32,62,0.000333,0.094756,8,2274.1414,126.341189,284.267675,87.132684,1,2
0,0,8,8,10,13,23,36,28,64,0.000333,0.096503,10,2895.079652,160.837758,289.507965,81.324997,1,2
0,0,10,10,10,16,26,31,34,65,0.000333,0.101843,10,3055.285817,169.738101,305.528582,97.219281,1,2
0,0,8,8,9,15,24,30,32,62,0.000333,0.094756,8,2274.1414,126.341189,284.267675,87.132684,1,2
0,0,10,10,9,16,25,36,44,80,0.000333,0.123836,8,2972.067961,165.114887,371.508495,92.529325,1,2
0,0,12,12,9,17,26,42,56,98,0.000333,0.153548,12,5527.717109,307.095395,460.643092,98.016193,1,2
0,0,14,14,9,18,27,48,68,116,0.000333,0.183856,12,6618.803403,367.7113,551.56695,103.587975,1,2
0,0,9,9,10,16,26,36,35,71,0.000333,0.111244,10,3337.3122,185.406233,333.73122,97.219281,1,2
0,0,10,10,10,17,27,45,39,84,0.000333,0.133137,10,3994.105502,221.89475,399.41055,102.706149,1,2
0,0,10,10,9,17,26,41,38,79,0.000333,0.123778,8,2970.677902,165.037661,371.334738,98.016193,1,2
0,0,11,11,9,18,27,45,42,87,0.000333,0.137892,8,3309.401702,183.85565,413.675213,103.587975,1,2
0,0,11,11,10,18,28,37,47,84,0.000333,0.134606,10,4038.178135,224.34323,403.817813,108.277931,1,2
0,0,10,10,9,16,25,30,40,70,0.000333,0.108357,8,2600.559466,144.475526,325.069933,92.529325,1,2
0,0,8,8,12,18,30,33,37,70,0.000333,0.114494,12,4121.7881,228.988228,343.482342,118.0782,1,2
0,0,8,8,11,18,29,32,37,69,0.000333,0.111734,10,3352.006887,186.222605,335.200689,113.112398,1,2
0,0,6,6,10,10,20,31,20,51,0.000333,0.073473,10,2204.183328,122.454629,220.418333,66.438562,1,2
0,0,7,7,11,10,21,34,21,55,0.000333,0.080526,10,2415.774583,134.209699,241.577458,71.273029,2,2
0,0,7,7,11,11,22,34,22,56,0.000333,0.083243,10,2497.281706,138.737873,249.728171,76.107496,2,2
0,0,6,6,10,10,20,31,20,51,0.000333,0.073473,10,2204.183328,122.454629,220.418333,66.438562,1,2
0,0,7,7,11,11,22,34,21,55,0.000333,0.081756,5,1226.343695,68.130205,245.268739,76.107496,2,2
0,0,7,7,11,11,22,33,21,54,0.000333,0.08027,5,1204.046537,66.891474,240.809307,76.107496,2,2
0,0,7,7,11,12,23,34,22,56,0.000333,0.08444,5,1266.597348,70.366519,253.31947,81.073298,2,2
0,0,7,7,11,11,22,34,21,55,0.000333,0.081756,5,1226.343695,68.130205,245.268739,76.107496,2,2
0,0,7,7,11,11,22,34,21,55,0.000333,0.081756,5,1226.343695,68.130205,245.268739,76.107496,2,2
0,0,7,7,11,11,22,34,21,55,0.000333,0.081756,5,1226.343695,68.130205,245.268739,76.107496,2,2
0,0,7,7,11,11,22,34,21,55,0.000333,0.081756,5,1226.343695,68.130205,245.268739,76.107496,2,2
0,0,7,7,11,11,22,34,21,55,0.000333,0.081756,5,1226.343695,68.130205,245.268739,76.107496,2,2
0,0,7,7,11,12,23,34,22,56,0.000333,0.08444,5,1266.597348,70.366519,253.31947,81.073298,2,2
0,0,7,7,11,12,23,34,22,56,0.000333,0.08444,5,1266.597348,70.366519,253.31947,81.073298,2,2
0,0,8,8,13,11,24,36,22,58,0.000333,0.088643,12,3191.133901,177.285217,265.927825,86.159464,2,2
0,0,7,7,11,10,21,34,21,55,0.000333,0.080526,10,2415.774583,134.209699,241.577458,71.273029,2,2
0,0,7,7,13,11,24,39,25,64,0.000333,0.097813,12,3521.251201,195.625067,293.4376,86.159464,2,2
0,0,8,8,12,10,22,34,22,56,0.000333,0.083243,12,2996.738048,166.485447,249.728171,76.238831,1,2
0,0,8,8,10,11,21,37,26,63,0.000333,0.092239,10,2767.159976,153.73111,276.715998,71.273029,1,2
0,0,11,11,11,12,23,52,34,86,0.000333,0.129675,10,3890.263282,216.125738,389.026328,81.073298,1,2
0,0,9,9,11,17,28,39,32,71,0.000333,0.113774,5,1706.610997,94.811722,341.322199,107.540616,1,2
0,0,8,8,10,15,25,37,32,69,0.000333,0.106809,10,3204.260771,178.014487,320.426077,91.82264,1,2
0,0,8,8,11,13,24,43,28,71,0.000333,0.108511,10,3255.323376,180.851299,325.532338,86.159464,1,2
0,0,10,10,11,16,27,38,34,72,0.000333,0.114117,10,3423.519002,190.1955,342.3519,102.053748,1,2
0,0,8,8,10,15,25,37,32,69,0.000333,0.106809,10,3204.260771,178.014487,320.426077,91.82264,1,2
0,0,10,10,10,16,26,43,44,87,0.000333,0.136313,10,4089.382555,227.18792,408.938255,97.219281,1,2
0,0,12,12,10,17,27,49,56,105,0.000333,0.166421,15,7488.947816,416.052656,499.263188,102.706149,1,2
0,0,14,14,10,19,29,54,68,122,0.000333,0.197558,15,8890.105221,493.894735,592.673681,113.929904,1,2
0,0,9,9,11,16,27,43,35,78,0.000333,0.123627,10,3708.812252,206.045125,370.881225,102.053748,1,2
0,0,10,10,11,17,28,52,39,91,0.000333,0.145823,10,4374.692979,243.038499,437.469298,107.540616,1,2
0,0,8,8,10,16,26,42,34,76,0.000333,0.119078,10,3572.334186,198.46301,357.233419,97.219281,1,2
0,0,11,11,10,18,28,52,42,94,0.000333,0.15063,10,4518.913627,251.050757,451.891363,108.277931,1,2
0,0,11,11,11,18,29,44,47,91,0.000333,0.147359,10,4420.762706,245.597928,442.076271,113.112398,1,2
0,0,10,10,10,16,26,37,40,77,0.000333,0.120645,10,3619.338583,201.074366,361.933858,97.219281,1,2
0,0,8,8,13,18,31,40,37,77,0.000333,0.127158,12,4577.677391,254.315411,381.473116,123.164366,1,2
0,0,8,8,12,18,30,39,37,76,0.000333,0.124308,12,4475.084223,248.61579,372.923685,118.0782,1,2
0,0,6,6,10,11,21,35,23,58,0.000333,0.084918,10,2547.544105,141.530228,254.754411,71.273029,1,2
0,0,7,7,11,11,22,38,24,62,0.000333,0.092162,10,2764.847604,153.602645,276.48476,76.107496,2,2
0,0,7,7,11,12,23,38,25,63,0.000333,0.094995,10,2849.844032,158.324668,284.984403,81.073298,2,2
0,0,7,7,11,12,23,38,24,62,0.000333,0.093487,10,2804.608413,155.811578,280.460841,81.073298,2,2
0,0,7,7,11,12,23,38,24,62,0.000333,0.093487,10,2804.608413,155.811578,280.460841,81.073298,2,2
0,0,7,7,11,13,24,38,25,63,0.000333,0.096284,5,1444.263188,80.236844,288.852638,86.159464,2,2
0,0,7,7,11,13,24,38,25,63,0.000333,0.096284,5,1444.263188,80.236844,288.852638,86.159464,2,2
0,0,7,7,11,12,23,38,24,62,0.000333,0.093487,10,2804.608413,155.811578,280.460841,81.073298,2,2
0,0,7,7,11,12,23,38,24,62,0.000333,0.093487,10,2804.608413,155.811578,280.460841,81.073298,2,2
0,0,7,7,11,12,23,38,24,62,0.000333,0.093487,10,2804.608413,155.811578,280.460841,81.073298,2,2
0,0,7,7,11,12,23,38,24,62,0.000333,0.093487,10,2804.608413,155.811578,280.460841,81.073298,2,2
0,0,7,7,11,12,23,38,24,62,0.000333,0.093487,10,2804.608413,155.811578,280.460841,81.073298,2,2
0,0,7,7,11,13,24,38,25,63,0.000333,0.096284,5,1444.263188,80.236844,288.852638,86.159464,2,2
0,0,7,7,11,13,24,38,25,63,0.000333,0.096284,5,1444.263188,80.236844,288.852638,86.159464,2,2
0,0,8,8,13,12,25,40,25,65,0.000333,0.100617,12,3622.207828,201.233768,301.850652,91.125266,2,2
0,0,7,7,11,11,22,38,24,62,0.000333,0.092162,10,2764.847604,153.602645,276.48476,76.107496,2,2
0,0,7,7,13,12,25,43,28,71,0.000333,0.109905,12,3956.565474,219.809193,329.713789,91.125266,2,2
0,0,8,8,12,11,23,38,25,63,0.000333,0.094995,12,3419.812839,189.989602,284.984403,81.073298,1,2
0,0,8,8,10,12,22,41,29,70,0.000333,0.104053,10,3121.602133,173.422341,312.160213,76.238831,1,2
0,0,11,11,11,13,24,56,37,93,0.000333,0.142134,10,4264.015126,236.889729,426.401513,86.159464,1,2
0,0,9,9,11,19,30,44,36,80,0.000333,0.13085,5,1962.756238,109.042013,392.551248,118.764371,1,2
0,0,8,8,10,16,26,41,35,76,0.000333,0.119078,10,3572.334186,198.46301,357.233419,97.219281,1,2
0,0,8,8,11,14,25,47,31,78,0.000333,0.12074,10,3622.207828,201.233768,362.220783,91.356717,1,2
0,0,10,10,11,17,28,42,37,79,0.000333,0.126594,10,3797.810388,210.989466,379.781039,107.540616,1,2
0,0,8,8,10,16,26,41,35,76,0.000333,0.119078,10,3572.334186,198.46301,357.233419,97.219281,1,2
0,0,10,10,10,17,27,47,47,94,0.000333,0.148986,10,4469.594252,248.310792,446.959425,102.706149,1,2
0,0,12,12,10,18,28,53,59,112,0.000333,0.179475,15,8076.356269,448.686459,538.423751,108.277931,1,2
0,0,14,14,10,19,29,59,71,130,0.000333,0.210513,15,9473.06294,526.281274,631.537529,113.929904,1,2
0,0,9,9,11,17,28,47,38,85,0.000333,0.136208,10,4086.251684,227.013982,408.625168,107.540616,1,2
0,0,10,10,11,18,29,56,42,98,0.000333,0.158694,10,4760.821375,264.490076,476.082138,113.112398,1,2
0,0,7,7,9,16,25,32,31,63,0.000333,0.097521,4,1170.25176,65.013987,292.56294,92.529325,1,2
0,0,11,11,10,19,29,56,45,101,0.000333,0.163552,10,4906.560805,272.586711,490.656081,113.929904,1,2
0,0,11,11,11,19,30,48,50,98,0.000333,0.160292,10,4808.752784,267.152932,480.875278,118.764371,1,2
0,0,10,10,10,17,27,41,43,84,0.000333,0.133137,10,3994.105502,221.89475,399.41055,102.706149,1,2
0,0,8,8,13,19,32,44,40,84,0.000333,0.14,12,5040,280,420,128.816339,1,2
0,0,8,8,12,19,31,43,40,83,0.000333,0.137066,12,4934.379525,274.132196,411.198294,123.730173,1,2
0,0,6,6,9,9,18,20,17,37,0.000333,0.051429,4,617.1489,34.28605,154.287225,57.05865,1,2
0,0,7,7,10,9,19,23,18,41,0.000333,0.058055,10,1741.650281,96.758349,174.165028,61.748606,2,2
0,0,7,7,10,10,20,23,19,42,0.000333,0.060507,5,907.6049,50.422494,181.52098,66.438562,2,2
0,0,7,7,10,10,20,23,18,41,0.000333,0.059066,5,885.995259,49.221959,177.199052,66.438562,2,2
0,0,7,7,10,10,20,23,18,41,0.000333,0.059066,5,885.995259,49.221959,177.199052,66.438562,2,2
0,0,7,7,10,11,21,23,19,42,0.000333,0.061492,5,922.386659,51.243703,184.477332,71.273029,2,2
0,0,7,7,10,11,21,23,19,42,0.000333,0.061492,5,922.386659,51.243703,184.477332,71.273029,2,2
0,0,7,7,10,10,20,23,18,41,0.000333,0.059066,5,885.995259,49.221959,177.199052,66.438562,2,2
0,0,7,7,10,10,20,23,18,41,0.000333,0.059066,5,885.995259,49.221959,177.199052,66.438562,2,2
0,0,7,7,10,10,20,23,18,41,0.000333,0.059066,5,885.995259,49.221959,177.199052,66.438562,2,2
0,0,7,7,10,10,20,23,18,41,0.000333,0.059066,5,885.995259,49.221959,177.199052,66.438562,2,2
0,0,7,7,10,10,20,23,18,41,0.000333,0.059066,5,885.995259,49.221959,177.199052,66.438562,2,2
0,0,7,7,10,11,21,23,19,42,0.000333,0.061492,5,922.386659,51.243703,184.477332,71.273029,2,2
0,0,7,7,10,11,21,23,19,42,0.000333,0.061492,5,922.386659,51.243703,184.477332,71.273029,2,2
0,0,8,8,12,10,22,25,19,44,0.000333,0.065405,6,1177.289947,65.404997,196.214991,76.238831,2,2
0,0,7,7,10,9,19,23,18,41,0.000333,0.058055,10,1741.650281,96.758349,174.165028,61.748606,2,2
0,0,7,7,12,10,22,28,22,50,0.000333,0.074324,12,2675.658971,148.647721,222.971581,76.238831,2,2
0,0,8,8,11,9,20,23,19,42,0.000333,0.060507,10,1815.2098,100.844989,181.52098,66.583073,1,2
0,0,8,8,9,10,19,26,23,49,0.000333,0.069383,8,1665.187585,92.510421,208.148448,61.748606,1,2
0,0,11,11,10,11,21,41,31,72,0.000333,0.105416,10,3162.468544,175.692697,316.246854,71.273029,1,2
0,0,9,9,10,16,26,28,29,57,0.000333,0.089308,5,1339.62532,74.423629,267.925064,97.219281,1,2
0,0,8,8,9,14,23,26,29,55,0.000333,0.082932,8,1990.367261,110.575959,248.795908,81.832294,1,2
0,0,8,8,10,12,22,32,25,57,0.000333,0.084729,10,2541.876023,141.215335,254.187602,76.238831,1,2
0,0,10,10,10,15,25,27,31,58,0.000333,0.089781,10,2693.43659,149.635366,269.343659,91.82264,1,2
0,0,8,8,9,14,23,26,29,55,0.000333,0.082932,8,1990.367261,110.575959,248.795908,81.832294,1,2
0,0,8,8,9,16,25,26,29,55,0.000333,0.085137,4,1021.648362,56.758242,255.41209,92.529325,1,2
0,0,12,12,9,16,25,38,53,91,0.000333,0.140864,12,5071.090959,281.727276,422.590913,92.529325,1,2
0,0,14,14,9,17,26,44,65,109,0.000333,0.170783,12,6148.175151,341.565286,512.347929,98.016193,1,2
0,0,9,9,10,15,25,32,32,64,0.000333,0.099069,10,2972.067961,165.114887,297.206796,91.82264,1,2
0,0,10,10,10,16,26,42,36,78,0.000333,0.122211,10,3666.34298,203.685721,366.634298,97.219281,1,2
0,0,8,8,9,15,24,31,31,62,0.000333,0.094756,8,2274.1414,126.341189,284.267675,87.132684,1,2
0,0,11,11,9,17,26,41,39,80,0.000333,0.125345,8,3008.28142,167.126746,376.035177,98.016193,1,2
0,0,11,11,10,17,27,33,44,77,0.000333,0.122042,10,3661.263377,203.403521,366.126338,102.706149,1,2
0,0,10,10,9,15,24,26,37,63,0.000333,0.096284,8,2310.8211,128.37895,288.852638,87.132684,1,2
0,0,8,8,12,17,29,29,34,63,0.000333,0.102018,12,3672.633632,204.035202,306.052803,112.506418,1,2
0,0,8,8,11,17,28,28,34,62,0.000333,0.099352,10,2980.560052,165.58667,298.056005,107.540616,1,2
0,0,6,6,9,10,19,24,20,44,0.000333,0.062303,8,1495.270485,83.070582,186.908811,61.748606,1,2
0,0,7,7,10,10,20,27,21,48,0.000333,0.069151,10,2074.525486,115.251416,207.452549,66.438562,2,2
0,0,7,7,10,11,21,27,22,49,0.000333,0.071741,10,2152.235537,119.568641,215.223554,71.273029,2,2
0,0,7,7,10,11,21,27,21,48,0.000333,0.070277,5,1054.156181,58.564232,210.831236,71.273029,2,2
0,0,7,7,10,11,21,27,21,48,0.000333,0.070277,5,1054.156181,58.564232,210.831236,71.273029,2,2
0,0,7,7,10,12,22,27,22,49,0.000333,0.072837,5,1092.560747,60.697819,218.512149,76.238831,2,2
0,0,7,7,10,12,22,27,22,49,0.000333,0.072837,5,1092.560747,60.697819,218.512149,76.238831,2,2
0,0,7,7,10,11,21,27,21,48,0.000333,0.070277,5,1054.156181,58.564232,210.831236,71.273029,2,2
0,0,7,7,10,11,21,27,21,48,0.000333,0.070277,5,1054.156181,58.564232,210.831236,71.273029,2,2
0,0,7,7,10,11,21,27,21,48,0.000333,0.070277,5,1054.156181,58.564232,210.831236,71.273029,2,2
0,0,7,7,10,11,21,27,21,48,0.000333,0.070277,5,1054.156181,58.564232,210.831236,71.273029,2,2
0,0,7,7,10,11,21,27,21,48,0.000333,0.070277,5,1054.156181,58.564232,210.831236,71.273029,2,2
0,0,7,7,10,12,22,27,22,49,0.000333,0.072837,5,1092.560747,60.697819,218.512149,76.238831,2,2
0,0,7,7,10,12,22,27,22,49,0.000333,0.072837,5,1092.560747,60.697819,218.512149,76.238831,2,2
0,0,8,8,12,11,23,29,22,51,0.000333,0.076901,12,2768.419917,153.801107,230.70166,81.073298,2,2
0,0,7,7,10,10,20,27,21,48,0.000333,0.069151,10,2074.525486,115.251416,207.452549,66.438562,2,2
0,0,7,7,12,11,23,32,25,57,0.000333,0.085948,12,3094.116378,171.895354,257.843031,81.073298,2,2
0,0,8,8,11,10,21,27,22,49,0.000333,0.071741,10,2152.235537,119.568641,215.223554,71.273029,1,2
0,0,8,8,9,11,20,30,26,56,0.000333,0.080676,8,1936.223787,107.567988,242.027973,66.583073,1,2
0,0,11,11,10,12,22,45,34,79,0.000333,0.117432,10,3522.950979,195.719499,352.295098,76.238831,1,2
0,0,9,9,10,17,27,32,32,64,0.000333,0.101438,5,1521.564001,84.531333,304.3128,102.706149,1,2
0,0,8,8,9,15,24,30,32,62,0.000333,0.094756,8,2274.1414,126.341189,284.267675,87.132684,1,2
0,0,8,8,10,13,23,36,28,64,0.000333,0.096503,10,2895.079652,160.837758,289.507965,81.324997,1,2
0,0,10,10,10,16,26,31,34,65,0.000333,0.101843,10,3055.285817,169.738101,305.528582,97.219281,1,2
0,0,8,8,9,15,24,30,32,62,0.000333,0.094756,8,2274.1414,126.341189,284.267675,87.132684,1,2
0,0,10,10,9,16,25,36,44,80,0.000333,0.123836,8,2972.067961,165.114887,371.508495,92.529325,1,2
0,0,12,12,9,17,26,42,56,98,0.000333,0.153548,12,5527.717109,307.095395,460.643092,98.016193,1,2
0,0,14,14,9,18,27,48,68,116,0.000333,0.183856,12,6618.803403,367.7113,551.56695,103.587975,1,2
0,0,9,9,10,17,27,35,35,70,0.000333,0.110947,10,3328.421252,184.912292,332.842125,102.706149,1,2
0,0,10,10,10,17,27,45,39,84,0.000333,0.133137,10,3994.105502,221.89475,399.41055,102.706149,1,2
0,0,8,8,9,16,25,35,34,69,0.000333,0.106809,8,2563.408617,142.41159,320.426077,92.529325,1,2
0,0,11,11,9,18,27,45,42,87,0.000333,0.137892,8,3309.401702,183.85565,413.675213,103.587975,1,2
0,0,11,11,10,18,28,37,47,84,0.000333,0.134606,10,4038.178135,224.34323,403.817813,108.277931,1,2
0,0,10,10,9,16,25,30,40,70,0.000333,0.108357,8,2600.559466,144.475526,325.069933,92.529325,1,2
0,0,8,8,12,18,30,33,37,70,0.000333,0.114494,12,4121.7881,228.988228,343.482342,118.0782,1,2
0,0,8,8,11,18,29,32,37,69,0.000333,0.111734,10,3352.006887,186.222605,335.200689,113.112398,1,2
0,0,8,8,10,11,21,39,26,65,0.000333,0.095167,10,2855.006325,158.611462,285.500632,71.273029,1,2
0,0,9,9,11,11,22,42,27,69,0.000333,0.102567,10,3077.007817,170.944879,307.700782,76.107496,2,2
0,0,9,9,11,12,23,42,28,70,0.000333,0.10555,10,3166.493369,175.916298,316.649337,81.073298,2,2
0,0,9,9,11,12,23,42,27,69,0.000333,0.104042,10,3121.25775,173.403208,312.125775,81.073298,2,2
0,0,9,9,11,12,23,42,27,69,0.000333,0.104042,10,3121.25775,173.403208,312.125775,81.073298,2,2
0,0,9,9,11,13,24,42,28,70,0.000333,0.106982,10,3209.473751,178.304097,320.947375,86.159464,2,2
0,0,9,9,11,13,24,42,28,70,0.000333,0.106982,10,3209.473751,178.304097,320.947375,86.159464,2,2
0,0,9,9,11,12,23,42,27,69,0.000333,0.104042,10,3121.25775,173.403208,312.125775,81.073298,2,2
0,0,9,9,11,12,23,42,27,69,0.000333,0.104042,10,3121.25775,173.403208,312.125775,81.073298,2,2
0,0,9,9,11,12,23,42,27,69,0.000333,0.104042,10,3121.25775,173.403208,312.125775,81.073298,2,2
0,0,9,9,11,12,23,42,27,69,0.000333,0.104042,10,3121.25775,173.403208,312.125775,81.073298,2,2
0,0,9,9,11,12,23,42,27,69,0.000333,0.104042,10,3121.25775,173.403208,312.125775,81.073298,2,2
0,0,9,9,11,13,24,42,28,70,0.000333,0.106982,10,3209.473751,178.304097,320.947375,86.159464,2,2
0,0,9,9,11,13,24,42,28,70,0.000333,0.106982,10,3209.473751,178.304097,320.947375,86.159464,2,2
0,0,10,10,13,12,25,44,28,72,0.000333,0.111453,12,4012.291748,222.905097,334.357646,91.125266,2,2
0,0,9,9,11,11,22,42,27,69,0.000333,0.102567,10,3077.007817,170.944879,307.700782,76.107496,2,2
0,0,9,9,13,12,25,47,31,78,0.000333,0.12074,12,4346.649394,241.480522,362.220783,91.125266,2,2
0,0,10,10,12,11,23,42,28,70,0.000333,0.10555,12,3799.792043,211.099558,316.649337,81.073298,1,2
0,0,10,10,10,12,22,45,32,77,0.000333,0.114459,10,3433.762346,190.764575,343.376235,76.238831,1,2
0,0,13,13,11,13,24,60,40,100,0.000333,0.152832,15,6877.443751,382.080208,458.49625,86.159464,1,2
0,0,11,11,11,18,29,47,38,85,0.000333,0.137643,10,4129.283846,229.404658,412.928385,113.112398,1,2
0,0,10,10,10,16,26,45,38,83,0.000333,0.130045,10,3901.364966,216.742498,390.136497,97.219281,1,2
0,0,10,10,11,14,25,51,34,85,0.000333,0.131576,10,3947.277761,219.293209,394.727776,91.356717,1,2
0,0,12,12,11,17,28,46,40,86,0.000333,0.137811,10,4134.325233,229.684735,413.432523,107.540616,1,2
0,0,10,10,10,16,26,45,38,83,0.000333,0.130045,10,3901.364966,216.742498,390.136497,97.219281,1,2
0,0,12,12,10,17,27,51,50,101,0.000333,0.160081,10,4802.436377,266.802021,480.243638,102.706149,1,2
0,0,14,14,10,18,28,57,62,119,0.000333,0.190692,15,8581.128536,476.729363,572.075236,108.277931,1,2
0,0,16,16,10,19,29,63,74,137,0.000333,0.221848,15,9983.150945,554.619497,665.543396,113.929904,1,2
0,0,11,11,11,17,28,51,41,92,0.000333,0.147426,10,4422.766528,245.709252,442.276653,107.540616,1,2
0,0,12,12,11,18,29,60,45,105,0.000333,0.170029,10,5100.880045,283.382225,510.088004,113.112398,1,2
0,0,10,10,10,17,27,50,40,90,0.000333,0.142647,10,4279.398752,237.744375,427.939875,102.706149,1,2
0,0,13,13,10,19,29,60,48,108,0.000333,0.174887,10,5246.619475,291.47886,524.661947,113.929904,1,2
0,0,13,13,11,19,30,52,53,105,0.000333,0.171741,10,5152.235125,286.235285,515.223513,118.764371,1,2
0,0,12,12,10,17,27,45,46,91,0.000333,0.144232,10,4326.947627,240.385979,432.694763,102.706149,1,2
0,0,10,10,13,19,32,48,43,91,0.000333,0.151667,12,5460,303.333333,455,128.816339,1,2
0,0,10,10,12,19,31,47,43,90,0.000333,0.148626,12,5350.532015,297.251779,445.877668,123.730173,1,2
0,0,8,8,10,11,21,40,27,67,0.000333,0.098095,10,2942.852673,163.491815,294.285267,71.273029,1,2
0,0,9,9,11,11,22,43,28,71,0.000333,0.10554,10,3166.196449,175.899803,316.619645,76.107496,2,2
0,0,9,9,11,12,23,43,29,72,0.000333,0.108565,10,3256.964608,180.942478,325.696461,81.073298,2,2
0,0,9,9,11,12,23,43,28,71,0.000333,0.107058,10,3211.728989,178.429388,321.172899,81.073298,2,2
0,0,9,9,11,12,23,43,28,71,0.000333,0.107058,10,3211.728989,178.429388,321.172899,81.073298,2,2
0,0,9,9,11,13,24,43,29,72,0.000333,0.110039,10,3301.173001,183.3985,330.1173,86.159464,2,2
0,0,9,9,11,13,24,43,29,72,0.000333,0.110039,10,3301.173001,183.3985,330.1173,86.159464,2,2
0,0,9,9,11,12,23,43,28,71,0.000333,0.107058,10,3211.728989,178.429388,321.172899,81.073298,2,2
0,0,9,9,11,12,23,43,28,71,0.000333,0.107058,10,3211.728989,178.429388,321.172899,81.073298,2,2
0,0,9,9,11,12,23,43,28,71,0.000333,0.107058,10,3211.728989,178.429388,321.172899,81.073298,2,2
0,0,9,9,11,12,23,43,28,71,0.000333,0.107058,10,3211.728989,178.429388,321.172899,81.073298,2,2
0,0,9,9,11,12,23,43,28,71,0.000333,0.107058,10,3211.728989,178.429388,321.172899,81.073298,2,2
0,0,9,9,11,13,24,43,29,72,0.000333,0.110039,10,3301.173001,183.3985,330.1173,86.159464,2,2
0,0,9,9,11,13,24,43,29,72,0.000333,0.110039,10,3301.173001,183.3985,330.1173,86.159464,2,2
0,0,10,10,13,12,25,45,29,74,0.000333,0.114548,12,4123.744297,229.096905,343.645358,91.125266,2,2
0,0,9,9,11,11,22,43,28,71,0.000333,0.10554,10,3166.196449,175.899803,316.619645,76.107496,2,2
0,0,9,9,13,12,25,48,32,80,0.000333,0.123836,12,4458.101942,247.67233,371.508495,91.125266,2,2
0,0,10,10,12,11,23,43,29,72,0.000333,0.108565,12,3908.35753,217.130974,325.696461,81.073298,1,2
0,0,10,10,10,11,21,46,33,79,0.000333,0.115664,15,5204.896146,289.160897,346.993076,71.273029,1,2
0,0,13,13,11,13,24,61,41,102,0.000333,0.155889,15,7014.992626,389.721813,467.666175,86.159464,1,2
0,0,11,11,11,18,29,48,39,87,0.000333,0.140881,10,4226.443466,234.802415,422.644347,113.112398,1,2
0,0,10,10,10,16,26,46,39,85,0.000333,0.133179,10,3995.37376,221.965209,399.537376,97.219281,1,2
0,0,11,11,11,14,25,57,38,95,0.000333,0.147055,10,4411.66338,245.09241,441.166338,91.356717,1,2
0,0,12,12,11,17,28,47,41,88,0.000333,0.141016,10,4230.472331,235.026241,423.047233,107.540616,1,2
0,0,10,10,10,16,26,46,39,85,0.000333,0.133179,10,3995.37376,221.965209,399.537376,97.219281,1,2
0,0,12,12,10,17,27,52,51,103,0.000333,0.163251,15,7346.301191,408.127844,489.753413,102.706149,1,2
0,0,14,14,10,18,28,58,63,121,0.000333,0.193897,15,8725.349184,484.741621,581.689946,108.277931,1,2
0,0,16,16,10,19,29,64,75,139,0.000333,0.225086,15,10128.89038,562.716132,675.259358,113.929904,1,2
0,0,11,11,11,17,28,52,42,94,0.000333,0.15063,10,4518.913627,251.050757,451.891363,107.540616,1,2
0,0,12,12,11,18,29,61,46,107,0.000333,0.173268,10,5198.039665,288.779981,519.803966,113.112398,1,2
0,0,10,10,10,17,27,51,41,92,0.000333,0.145817,10,4374.496502,243.027583,437.44965,102.706149,1,2
0,0,13,13,10,19,29,61,49,110,0.000333,0.178126,10,5343.779095,296.876616,534.377909,113.929904,1,2
0,0,13,13,11,19,30,53,54,107,0.000333,0.175012,10,5250.372937,291.687385,525.037294,118.764371,1,2
0,0,12,12,10,17,27,46,47,93,0.000333,0.147402,10,4422.045377,245.669188,442.204538,102.706149,1,2
0,0,10,10,13,19,32,49,44,93,0.000333,0.155,12,5580,310,465,128.816339,1,2
0,0,10,10,12,19,31,48,44,92,0.000333,0.151929,12,5469.432727,303.857374,455.786061,123.730173,1,2
0,0,8,8,11,11,22,40,26,66,0.000333,0.098107,10,2943.224868,163.512493,294.322487,76.107496,1,2
0,0,9,9,12,11,23,43,27,70,0.000333,0.10555,12,3799.792043,211.099558,316.649337,81.073298,2,2
0,0,9,9,12,12,24,43,28,71,0.000333,0.108511,12,3906.388051,217.021558,325.532338,86.0391,2,2
0,0,9,9,12,12,24,43,27,70,0.000333,0.106982,12,3851.368501,213.964917,320.947375,86.0391,2,2
0,0,9,9,12,12,24,43,27,70,0.000333,0.106982,12,3851.368501,213.964917,320.947375,86.0391,2,2
0,0,9,9,12,13,25,43,28,71,0.000333,0.109905,12,3956.565474,219.809193,329.713789,91.125266,2,2
0,0,9,9,12,13,25,43,28,71,0.000333,0.109905,12,3956.565474,219.809193,329.713789,91.125266,2,2
0,0,9,9,12,12,24,43,27,70,0.000333,0.106982,12,3851.368501,213.964917,320.947375,86.0391,2,2
0,0,9,9,12,12,24,43,27,70,0.000333,0.106982,12,3851.368501,213.964917,320.947375,86.0391,2,2
0,0,9,9,12,12,24,43,27,70,0.000333,0.106982,12,3851.368501,213.964917,320.947375,86.0391,2,2
0,0,9,9,12,12,24,43,27,70,0.000333,0.106982,12,3851.368501,213.964917,320.947375,86.0391,2,2
0,0,9,9,12,12,24,43,27,70,0.000333,0.106982,12,3851.368501,213.964917,320.947375,86.0391,2,2
0,0,9,9,12,13,25,43,28,71,0.000333,0.109905,12,3956.565474,219.809193,329.713789,91.125266,2,2
0,0,9,9,12,13,25,43,28,71,0.000333,0.109905,12,3956.565474,219.809193,329.713789,91.125266,2,2
0,0,10,10,14,12,26,45,28,73,0.000333,0.114377,14,4803.849392,266.880522,343.132099,96.322519,2,2
0,0,9,9,12,11,23,43,27,70,0.000333,0.10555,12,3799.792043,211.099558,316.649337,81.073298,2,2
0,0,9,9,14,12,26,48,31,79,0.000333,0.123778,14,5198.686328,288.815907,371.334738,96.322519,2,2
0,0,10,10,13,11,24,43,28,71,0.000333,0.108511,12,3906.388051,217.021558,325.532338,86.159464,1,2
0,0,10,10,11,12,23,46,32,78,0.000333,0.117613,10,3528.378326,196.021018,352.837833,81.073298,1,2
0,0,13,13,12,13,25,62,40,102,0.000333,0.157891,18,8526.119964,473.673331,473.673331,91.125266,1,2
0,0,11,11,12,18,30,49,38,87,0.000333,0.1423,12,5122.793782,284.599655,426.899482,118.0782,1,2
0,0,10,10,11,16,27,47,38,85,0.000333,0.134722,10,4041.654377,224.536354,404.165438,102.053748,1,2
0,0,10,10,12,14,26,53,34,87,0.000333,0.136313,12,4907.259066,272.625504,408.938255,96.322519,1,2
0,0,12,12,12,17,29,48,40,88,0.000333,0.142501,12,5130.027931,285.001552,427.502328,112.506418,1,2
0,0,10,10,11,16,27,47,38,85,0.000333,0.134722,10,4041.654377,224.536354,404.165438,102.053748,1,2
0,0,12,12,11,17,28,53,50,103,0.000333,0.165053,10,4951.57557,275.087532,495.157557,107.540616,1,2
0,0,14,14,11,18,29,59,62,121,0.000333,0.195939,15,8817.235506,489.846417,587.8157,113.112398,1,2
0,0,16,16,11,19,30,65,74,139,0.000333,0.227353,15,10230.86689,568.381494,682.057793,118.764371,1,2
0,0,11,11,12,17,29,53,41,94,0.000333,0.152217,12,5479.802563,304.433476,456.650214,112.506418,1,2
0,0,11,11,12,17,29,58,43,101,0.000333,0.163552,12,5887.872966,327.104054,490.656081,112.506418,1,2
0,0,10,10,11,17,28,52,40,92,0.000333,0.147426,10,4422.766528,245.709252,442.276653,107.540616,1,2
0,0,13,13,11,19,30,62,48,110,0.000333,0.179919,10,5397.579655,299.865536,539.757966,118.764371,1,2
0,0,13,13,12,19,31,54,53,107,0.000333,0.1767,12,6361.188063,353.399337,530.099005,123.730173,1,2
0,0,12,12,11,17,28,47,46,93,0.000333,0.149028,10,4470.840078,248.380004,447.084008,107.540616,1,2
0,0,10,10,14,19,33,50,43,93,0.000333,0.156376,14,6567.801143,364.877841,469.128653,134.013592,1,2
0,0,10,10,13,19,32,49,43,92,0.000333,0.153333,12,5520,306.666667,460,128.816339,1,2
0,0,8,8,9,10,19,30,23,53,0.000333,0.075047,8,1801.121266,100.062293,225.140158,61.748606,1,2
0,0,9,9,10,10,20,33,24,57,0.000333,0.082117,10,2463.499014,136.861056,246.349901,66.438562,2,2
0,0,9,9,10,11,21,33,25,58,0.000333,0.084918,10,2547.544105,141.530228,254.754411,71.273029,2,2
0,0,9,9,10,11,21,33,24,57,0.000333,0.083454,10,2503.620931,139.090052,250.362093,71.273029,2,2
0,0,9,9,10,11,21,33,24,57,0.000333,0.083454,10,2503.620931,139.090052,250.362093,71.273029,2,2
0,0,9,9,10,12,22,33,25,58,0.000333,0.086216,10,2586.470339,143.692797,258.647034,76.238831,2,2
0,0,9,9,10,12,22,33,25,58,0.000333,0.086216,10,2586.470339,143.692797,258.647034,76.238831,2,2
0,0,9,9,10,11,21,33,24,57,0.000333,0.083454,10,2503.620931,139.090052,250.362093,71.273029,2,2
0,0,9,9,10,11,21,33,24,57,0.000333,0.083454,10,2503.620931,139.090052,250.362093,71.273029,2,2
0,0,9,9,10,11,21,33,24,57,0.000333,0.083454,10,2503.620931,139.090052,250.362093,71.273029,2,2
0,0,9,9,10,11,21,33,24,57,0.000333,0.083454,10,2503.620931,139.090052,250.362093,71.273029,2,2
0,0,9,9,10,11,21,33,24,57,0.000333,0.083454,10,2503.620931,139.090052,250.362093,71.273029,2,2
0,0,9,9,10,12,22,33,25,58,0.000333,0.086216,10,2586.470339,143.692797,258.647034,76.238831,2,2
0,0,9,9,10,12,22,33,25,58,0.000333,0.086216,10,2586.470339,143.692797,258.647034,76.238831,2,2
0,0,10,10,12,11,23,35,25,60,0.000333,0.090471,12,3256.964608,180.942478,271.413717,81.073298,2,2
0,0,9,9,10,10,20,33,24,57,0.000333,0.082117,10,2463.499014,136.861056,246.349901,66.438562,2,2
0,0,9,9,12,11,23,38,28,66,0.000333,0.099518,12,3582.661069,199.036726,298.555089,81.073298,2,2
0,0,10,10,11,10,21,33,25,58,0.000333,0.084918,10,2547.544105,141.530228,254.754411,71.273029,1,2
0,0,10,10,9,11,20,36,29,65,0.000333,0.093642,8,2247.402609,124.855701,280.925326,66.583073,1,2
0,0,13,13,10,12,22,50,37,87,0.000333,0.129324,15,5819.558262,323.308792,387.970551,76.238831,1,2
0,0,10,10,10,17,27,36,33,69,0.000333,0.109362,5,1640.436188,91.135344,328.087238,102.706149,1,2
0,0,10,10,9,15,24,36,35,71,0.000333,0.108511,8,2604.2587,144.681039,325.532338,87.132684,1,2
0,0,10,10,10,13,23,42,31,73,0.000333,0.110073,10,3302.200228,183.455568,330.220023,81.324997,1,2
0,0,12,12,10,16,26,37,37,74,0.000333,0.115944,10,3478.325391,193.2403,347.832539,97.219281,1,2
0,0,10,10,9,15,24,36,35,71,0.000333,0.108511,8,2604.2587,144.681039,325.532338,87.132684,1,2
0,0,12,12,9,16,25,42,47,89,0.000333,0.137768,8,3306.425607,183.690312,413.303201,92.529325,1,2
0,0,14,14,9,17,26,48,59,107,0.000333,0.167649,12,6035.364598,335.298033,502.94705,98.016193,1,2
0,0,16,16,9,18,27,54,71,125,0.000333,0.19812,12,7132.331253,396.240625,594.360938,103.587975,1,2
0,0,11,11,10,16,26,42,38,80,0.000333,0.125345,10,3760.351775,208.908432,376.035177,97.219281,1,2
0,0,12,12,10,17,27,51,42,93,0.000333,0.147402,10,4422.045377,245.669188,442.204538,102.706149,1,2
0,0,7,7,9,13,22,32,30,62,0.000333,0.092162,8,2211.878083,122.882116,276.48476,76.635041,1,2
0,0,13,13,9,18,27,51,45,96,0.000333,0.152156,8,3651.753602,202.8752,456.4692,103.587975,1,2
0,0,13,13,10,18,28,43,50,93,0.000333,0.149028,10,4470.840078,248.380004,447.084008,108.277931,1,2
0,0,12,12,9,16,25,36,43,79,0.000333,0.122288,8,2934.917112,163.050951,366.864639,92.529325,1,2
0,0,10,10,12,18,30,39,40,79,0.000333,0.129215,12,4651.732285,258.429571,387.644357,118.0782,1,2
0,0,10,10,11,18,29,38,40,78,0.000333,0.126308,10,3789.225176,210.51251,378.922518,113.112398,1,2
0,0,8,8,9,10,19,31,24,55,0.000333,0.077879,8,1869.088106,103.838228,233.636013,61.748606,1,2
0,0,9,9,10,10,20,34,25,59,0.000333,0.084998,10,2549.937576,141.663199,254.993758,66.438562,2,2
0,0,9,9,10,11,21,34,26,60,0.000333,0.087846,10,2635.390454,146.410581,263.539045,71.273029,2,2
0,0,9,9,10,11,21,34,25,59,0.000333,0.086382,10,2591.467279,143.970404,259.146728,71.273029,2,2
0,0,9,9,10,11,21,34,25,59,0.000333,0.086382,10,2591.467279,143.970404,259.146728,71.273029,2,2
0,0,9,9,10,12,22,34,26,60,0.000333,0.089189,10,2675.658971,148.647721,267.565897,76.238831,2,2
0,0,9,9,10,12,22,34,26,60,0.000333,0.089189,10,2675.658971,148.647721,267.565897,76.238831,2,2
0,0,9,9,10,11,21,34,25,59,0.000333,0.086382,10,2591.467279,143.970404,259.146728,71.273029,2,2
0,0,9,9,10,11,21,34,25,59,0.000333,0.086382,10,2591.467279,143.970404,259.146728,71.273029,2,2
0,0,9,9,10,11,21,34,25,59,0.000333,0.086382,10,2591.467279,143.970404,259.146728,71.273029,2,2
0,0,9,9,10,11,21,34,25,59,0.000333,0.086382,10,2591.467279,143.970404,259.146728,71.273029,2,2
0,0,9,9,10,11,21,34,25,59,0.000333,0.086382,10,2591.467279,143.970404,259.146728,71.273029,2,2
0,0,9,9,10,12,22,34,26,60,0.000333,0.089189,10,2675.658971,148.647721,267.565897,76.238831,2,2
0,0,9,9,10,12,22,34,26,60,0.000333,0.089189,10,2675.658971,148.647721,267.565897,76.238831,2,2
0,0,10,10,12,11,23,36,26,62,0.000333,0.093487,12,3365.530095,186.973894,280.460841,81.073298,2,2
0,0,9,9,10,10,20,34,25,59,0.000333,0.084998,10,2549.937576,141.663199,254.993758,66.438562,2,2
0,0,9,9,12,11,23,39,29,68,0.000333,0.102534,12,3691.226556,205.068142,307.602213,81.073298,2,2
0,0,10,10,11,10,21,34,26,60,0.000333,0.087846,10,2635.390454,146.410581,263.539045,71.273029,1,2
0,0,10,10,9,11,20,37,30,67,0.000333,0.096523,8,2316.553459,128.697414,289.569182,66.583073,1,2
0,0,13,13,10,12,22,52,38,90,0.000333,0.133783,15,6020.232685,334.457371,401.348846,76.238831,1,2
0,0,11,11,10,17,27,39,36,75,0.000333,0.118872,10,3566.165627,198.120313,356.616563,102.706149,1,2
0,0,10,10,9,15,24,37,36,73,0.000333,0.111567,8,2677.6181,148.756561,334.702263,87.132684,1,2
0,0,10,10,10,13,23,43,32,75,0.000333,0.113089,10,3392.671467,188.481748,339.267147,81.324997,1,2
0,0,12,12,10,16,26,37,38,75,0.000333,0.117511,10,3525.329789,195.851655,352.532979,97.219281,1,2
0,0,10,10,9,15,24,37,36,73,0.000333,0.111567,8,2677.6181,148.756561,334.702263,87.132684,1,2
0,0,12,12,9,16,25,43,48,91,0.000333,0.140864,12,5071.090959,281.727276,422.590913,92.529325,1,2
0,0,14,14,9,17,26,49,60,109,0.000333,0.170783,12,6148.175151,341.565286,512.347929,98.016193,1,2
0,0,16,16,9,18,27,55,72,127,0.000333,0.20129,16,9661.931404,536.773967,603.870713,103.587975,1,2
0,0,11,11,10,16,26,43,39,82,0.000333,0.128479,10,3854.360569,214.131143,385.436057,97.219281,1,2
0,0,12,12,10,17,27,52,43,95,0.000333,0.150571,10,4517.143127,250.952396,451.714313,102.706149,1,2
0,0,10,10,9,16,25,42,38,80,0.000333,0.123836,8,2972.067961,165.114887,371.508495,92.529325,1,2
0,0,12,12,9,18,27,48,43,91,0.000333,0.144232,8,3461.558102,192.308783,432.694763,103.587975,1,2
0,0,13,13,10,18,28,44,51,95,0.000333,0.152233,10,4566.987176,253.72151,456.698718,108.277931,1,2
0,0,12,12,9,16,25,37,44,81,0.000333,0.125384,8,3009.218811,167.178823,376.152351,92.529325,1,2
0,0,10,10,12,18,30,40,41,81,0.000333,0.132486,12,4769.497659,264.972092,397.458138,118.0782,1,2
0,0,10,10,11,18,29,39,41,80,0.000333,0.129546,10,3886.384796,215.910266,388.63848,113.112398,1,2
0,0,8,8,10,10,20,32,23,55,0.000333,0.079235,10,2377.060452,132.058914,237.706045,66.438562,1,2
0,0,9,9,11,10,21,35,24,59,0.000333,0.086382,10,2591.467279,143.970404,259.146728,71.273029,2,2
0,0,9,9,11,11,22,35,25,60,0.000333,0.089189,10,2675.658971,148.647721,267.565897,76.107496,2,2
0,0,9,9,11,11,22,35,24,59,0.000333,0.087702,10,2631.064655,146.170259,263.106465,76.107496,2,2
0,0,9,9,11,11,22,35,24,59,0.000333,0.087702,10,2631.064655,146.170259,263.106465,76.107496,2,2
0,0,9,9,11,12,23,35,25,60,0.000333,0.090471,10,2714.137174,150.785399,271.413717,81.073298,2,2
0,0,9,9,11,12,23,35,25,60,0.000333,0.090471,10,2714.137174,150.785399,271.413717,81.073298,2,2
0,0,9,9,11,11,22,35,24,59,0.000333,0.087702,10,2631.064655,146.170259,263.106465,76.107496,2,2
0,0,9,9,11,11,22,35,24,59,0.000333,0.087702,10,2631.064655,146.170259,263.106465,76.107496,2,2
0,0,9,9,11,11,22,35,24,59,0.000333,0.087702,10,2631.064655,146.170259,263.106465,76.107496,2,2
0,0,9,9,11,11,22,35,24,59,0.000333,0.087702,10,2631.064655,146.170259,263.106465,76.107496,2,2
0,0,9,9,11,11,22,35,24,59,0.000333,0.087702,10,2631.064655,146.170259,263.106465,76.107496,2,2
0,0,9,9,11,12,23,35,25,60,0.000333,0.090471,10,2714.137174,150.785399,271.413717,81.073298,2,2
0,0,9,9,11,12,23,35,25,60,0.000333,0.090471,10,2714.137174,150.785399,271.413717,81.073298,2,2
0,0,10,10,13,11,24,37,25,62,0.000333,0.094756,12,3411.212101,189.511783,284.267675,86.159464,2,2
0,0,9,9,11,10,21,35,24,59,0.000333,0.086382,10,2591.467279,143.970404,259.146728,71.273029,2,2
0,0,9,9,13,11,24,40,28,68,0.000333,0.103926,12,3741.329401,207.851633,311.77745,86.159464,2,2
0,0,10,10,12,10,22,35,25,60,0.000333,0.089189,12,3210.790765,178.377265,267.565897,76.238831,1,2
0,0,10,10,10,11,21,38,29,67,0.000333,0.098095,10,2942.852673,163.491815,294.285267,71.273029,1,2
0,0,13,13,11,12,23,53,37,90,0.000333,0.135707,15,6106.808641,339.267147,407.120576,81.073298,1,2
0,0,11,11,11,17,28,40,35,75,0.000333,0.120184,10,3605.516192,200.306455,360.551619,107.540616,1,2
0,0,10,10,10,15,25,38,35,73,0.000333,0.113001,10,3390.015019,188.334168,339.001502,91.82264,1,2
0,0,10,10,11,13,24,44,31,75,0.000333,0.114624,10,3438.721876,191.040104,343.872188,86.159464,1,2
0,0,12,12,11,16,27,39,37,76,0.000333,0.120457,10,3613.714502,200.761917,361.37145,102.053748,1,2
0,0,10,10,10,15,25,38,35,73,0.000333,0.113001,10,3390.015019,188.334168,339.001502,91.82264,1,2
0,0,12,12,10,16,26,44,47,91,0.000333,0.14258,10,4277.400144,237.633341,427.740014,97.219281,1,2
0,0,14,14,10,17,27,50,59,109,0.000333,0.172761,15,7774.241066,431.902281,518.282738,102.706149,1,2
0,0,16,16,10,18,28,56,71,127,0.000333,0.203511,15,9158.011127,508.778396,610.534075,108.277931,1,2
0,0,11,11,11,16,27,44,38,82,0.000333,0.129967,10,3899.007752,216.611542,389.900775,102.053748,1,2
0,0,12,12,11,17,28,53,42,95,0.000333,0.152233,10,4566.987176,253.72151,456.698718,107.540616,1,2
0,0,10,10,10,16,26,43,37,80,0.000333,0.125345,10,3760.351775,208.908432,376.035177,97.219281,1,2
0,0,13,13,10,18,28,53,45,98,0.000333,0.15704,10,4711.207824,261.733768,471.120782,108.277931,1,2
0,0,13,13,11,18,29,45,50,95,0.000333,0.153836,10,4615.081945,256.393441,461.508195,113.112398,1,2
0,0,12,12,10,16,26,38,43,81,0.000333,0.126912,10,3807.356172,211.519787,380.735617,97.219281,1,2
0,0,10,10,13,18,31,41,40,81,0.000333,0.133763,12,4815.478814,267.526601,401.289901,123.164366,1,2
0,0,10,10,12,18,30,40,40,80,0.000333,0.13085,12,4710.614972,261.700832,392.551248,118.0782,1,2
0,0,8,8,10,11,21,39,26,65,0.000333,0.095167,10,2855.006325,158.611462,285.500632,71.273029,1,2
0,0,9,9,11,11,22,42,27,69,0.000333,0.102567,10,3077.007817,170.944879,307.700782,76.107496,2,2
0,0,9,9,11,12,23,42,28,70,0.000333,0.10555,10,3166.493369,175.916298,316.649337,81.073298,2,2
0,0,9,9,11,12,23,42,27,69,0.000333,0.104042,10,3121.25775,173.403208,312.125775,81.073298,2,2
0,0,9,9,11,12,23,42,27,69,0.000333,0.104042,10,3121.25775,173.403208,312.125775,81.073298,2,2
0,0,9,9,11,13,24,42,28,70,0.000333,0.106982,10,3209.473751,178.304097,320.947375,86.159464,2,2
0,0,9,9,11,13,24,42,28,70,0.000333,0.106982,10,3209.473751,178.304097,320.947375,86.159464,2,2
0,0,9,9,11,12,23,42,27,69,0.000333,0.104042,10,3121.25775,173.403208,312.125775,81.073298,2,2
0,0,9,9,11,12,23,42,27,69,0.000333,0.104042,10,3121.25775,173.403208,312.125775,81.073298,2,2
0,0,9,9,11,12,23,42,27,69,0.000333,0.104042,10,3121.25775,173.403208,312.125775,81.073298,2,2
0,0,9,9,11,12,23,42,27,69,0.000333,0.104042,10,3121.25775,173.403208,312.125775,81.073298,2,2
0,0,9,9,11,12,23,42,27,69,0.000333,0.104042,10,3121.25775,173.403208,312.125775,81.073298,2,2
0,0,9,9,11,13,24,42,28,70,0.000333,0.106982,10,3209.473751,178.304097,320.947375,86.159464,2,2
0,0,9,9,11,13,24,42,28,70,0.000333,0.106982,10,3209.473751,178.304097,320.947375,86.159464,2,2
0,0,10,10,13,12,25,44,28,72,0.000333,0.111453,12,4012.291748,222.905097,334.357646,91.125266,2,2
0,0,9,9,11,11,22,42,27,69,0.000333,0.102567,10,3077.007817,170.944879,307.700782,76.107496,2,2
0,0,9,9,13,12,25,47,31,78,0.000333,0.12074,12,4346.649394,241.480522,362.220783,91.125266,2,2
0,0,10,10,12,11,23,42,28,70,0.000333,0.10555,12,3799.792043,211.099558,316.649337,81.073298,1,2
0,0,10,10,10,12,22,45,32,77,0.000333,0.114459,10,3433.762346,190.764575,343.376235,76.238831,1,2
0,0,13,13,11,13,24,60,40,100,0.000333,0.152832,15,6877.443751,382.080208,458.49625,86.159464,1,2
0,0,11,11,11,18,29,47,38,85,0.000333,0.137643,10,4129.283846,229.404658,412.928385,113.112398,1,2
0,0,10,10,10,16,26,45,38,83,0.000333,0.130045,10,3901.364966,216.742498,390.136497,97.219281,1,2
0,0,10,10,11,14,25,51,34,85,0.000333,0.131576,10,3947.277761,219.293209,394.727776,91.356717,1,2
0,0,12,12,11,17,28,46,40,86,0.000333,0.137811,10,4134.325233,229.684735,413.432523,107.540616,1,2
0,0,10,10,10,16,26,45,38,83,0.000333,0.130045,10,3901.364966,216.742498,390.136497,97.219281,1,2
0,0,12,12,10,17,27,51,50,101,0.000333,0.160081,10,4802.436377,266.802021,480.243638,102.706149,1,2
0,0,14,14,10,18,28,57,62,119,0.000333,0.190692,15,8581.128536,476.729363,572.075236,108.277931,1,2
0,0,16,16,10,19,29,63,74,137,0.000333,0.221848,15,9983.150945,554.619497,665.543396,113.929904,1,2
0,0,11,11,11,17,28,51,41,92,0.000333,0.147426,10,4422.766528,245.709252,442.276653,107.540616,1,2
0,0,12,12,11,18,29,60,45,105,0.000333,0.170029,10,5100.880045,283.382225,510.088004,113.112398,1,2
0,0,10,10,10,17,27,50,40,90,0.000333,0.142647,10,4279.398752,237.744375,427.939875,102.706149,1,2
0,0,13,13,10,19,29,60,48,108,0.000333,0.174887,10,5246.619475,291.47886,524.661947,113.929904,1,2
0,0,13,13,11,19,30,52,53,105,0.000333,0.171741,10,5152.235125,286.235285,515.223513,118.764371,1,2
0,0,12,12,10,17,27,45,46,91,0.000333,0.144232,10,4326.947627,240.385979,432.694763,102.706149,1,2
0,0,10,10,13,19,32,48,43,91,0.000333,0.151667,12,5460,303.333333,455,128.816339,1,2
0,0,10,10,12,19,31,47,43,90,0.000333,0.148626,12,5350.532015,297.251779,445.877668,123.730173,1,2
0,0,8,8,10,11,21,40,27,67,0.000333,0.098095,10,2942.852673,163.491815,294.285267,71.273029,1,2
0,0,9,9,11,11,22,43,28,71,0.000333,0.10554,10,3166.196449,175.899803,316.619645,76.107496,2,2
0,0,9,9,11,12,23,43,29,72,0.000333,0.108565,10,3256.964608,180.942478,325.696461,81.073298,2,2
0,0,9,9,11,12,23,43,28,71,0.000333,0.107058,10,3211.728989,178.429388,321.172899,81.073298,2,2
0,0,9,9,11,12,23,43,28,71,0.000333,0.107058,10,3211.728989,178.429388,321.172899,81.073298,2,2
0,0,9,9,11,13,24,43,29,72,0.000333,0.110039,10,3301.173001,183.3985,330.1173,86.159464,2,2
0,0,9,9,11,13,24,43,29,72,0.000333,0.110039,10,3301.173001,183.3985,330.1173,86.159464,2,2
0,0,9,9,11,12,23,43,28,71,0.000333,0.107058,10,3211.728989,178.429388,321.172899,81.073298,2,2
0,0,9,9,11,12,23,43,28,71,0.000333,0.107058,10,3211.728989,178.429388,321.172899,81.073298,2,2
0,0,9,9,11,12,23,43,28,71,0.000333,0.107058,10,3211.728989,178.429388,321.172899,81.073298,2,2
0,0,9,9,11,12,23,43,28,71,0.000333,0.107058,10,3211.728989,178.429388,321.172899,81.073298,2,2
0,0,9,9,11,12,23,43,28,71,0.000333,0.107058,10,3211.728989,178.429388,321.172899,81.073298,2,2
0,0,9,9,11,13,24,43,29,72,0.000333,0.110039,10,3301.173001,183.3985,330.1173,86.159464,2,2
0,0,9,9,11,13,24,43,29,72,0.000333,0.110039,10,3301.173001,183.3985,330.1173,86.159464,2,2
0,0,10,10,13,12,25,45,29,74,0.000333,0.114548,12,4123.744297,229.096905,343.645358,91.125266,2,2
0,0,9,9,11,11,22,43,28,71,0.000333,0.10554,10,3166.196449,175.899803,316.619645,76.107496,2,2
0,0,6,6,10,11,21,31,20,51,0.000333,0.074669,5,1120.040943,62.224497,224.008189,71.273029,1,2
0,0,6,6,10,9,19,31,20,51,0.000333,0.072215,10,2166.443032,120.357946,216.644303,61.748606,1,2
0,0,6,6,10,10,20,31,20,51,0.000333,0.073473,10,2204.183328,122.454629,220.418333,66.438562,1,2
0,0,8,8,10,11,21,37,26,63,0.000333,0.092239,10,2767.159976,153.73111,276.715998,71.273029,1,2
0,0,6,6,11,9,20,34,22,56,0.000333,0.080676,10,2420.279733,134.459985,242.027973,66.583073,1,2
0,0,7,7,11,15,26,32,27,59,0.000333,0.092442,5,1386.629717,77.034984,277.325943,96.657107,1,2
0,0,9,9,10,15,25,43,37,80,0.000333,0.123836,10,3715.084952,206.393608,371.508495,91.82264,1,2
0,0,9,9,11,13,24,46,30,76,0.000333,0.116152,10,3484.571501,193.587306,348.45715,86.159464,1,2
0,0,9,9,10,15,25,37,32,69,0.000333,0.106809,10,3204.260771,178.014487,320.426077,91.82264,1,2
0,0,6,6,10,14,24,30,25,55,0.000333,0.084058,5,1260.864688,70.048038,252.172938,86.52225,1,2
0,0,6,6,10,14,24,30,25,55,0.000333,0.084058,5,1260.864688,70.048038,252.172938,86.52225,1,2
0,0,6,6,10,14,24,30,25,55,0.000333,0.084058,5,1260.864688,70.048038,252.172938,86.52225,1,2
0,0,6,6,10,14,24,30,25,55,0.000333,0.084058,5,1260.864688,70.048038,252.172938,86.52225,1,2
0,0,7,7,10,15,25,35,28,63,0.000333,0.097521,5,1462.8147,81.267483,292.56294,91.82264,1,2
0,0,8,8,10,16,26,44,32,76,0.000333,0.119078,10,3572.334186,198.46301,357.233419,97.219281,1,2
0,0,6,6,10,14,24,30,25,55,0.000333,0.084058,5,1260.864688,70.048038,252.172938,86.52225,1,2
0,0,7,7,10,15,25,37,29,66,0.000333,0.102165,5,1532.472543,85.137363,306.494509,91.82264,1,2
0,0,7,7,11,17,28,33,32,65,0.000333,0.104159,5,1562.39035,86.799464,312.47807,107.540616,1,2
0,0,6,6,10,13,23,30,24,54,0.000333,0.081424,5,1221.361728,67.853429,244.272346,81.324997,1,2
0,0,6,6,12,15,27,32,26,58,0.000333,0.091928,6,1654.700851,91.927825,275.783475,101.622909,1,2
0,0,6,6,11,15,26,31,26,57,0.000333,0.089308,5,1339.62532,74.423629,267.925064,96.657107,1,2
0,0,6,6,11,10,21,32,19,51,0.000333,0.074669,5,1120.040943,62.224497,224.008189,71.273029,1,2
0,0,7,7,11,10,21,34,21,55,0.000333,0.080526,10,2415.774583,134.209699,241.577458,71.273029,1,2
0,0,6,6,11,10,21,32,19,51,0.000333,0.074669,5,1120.040943,62.224497,224.008189,71.273029,1,2
0,0,6,6,11,10,21,32,19,51,0.000333,0.074669,5,1120.040943,62.224497,224.008189,71.273029,1,2
0,0,6,6,11,10,21,32,19,51,0.000333,0.074669,5,1120.040943,62.224497,224.008189,71.273029,1,2
0,0,6,6,11,10,21,32,19,51,0.000333,0.074669,5,1120.040943,62.224497,224.008189,71.273029,1,2
0,0,6,6,11,10,21,32,19,51,0.000333,0.074669,5,1120.040943,62.224497,224.008189,71.273029,1,2
0,0,6,6,11,10,21,32,19,51,0.000333,0.074669,5,1120.040943,62.224497,224.008189,71.273029,1,2
0,0,6,6,11,10,21,32,19,51,0.000333,0.074669,5,1120.040943,62.224497,224.008189,71.273029,1,2
0,0,6,6,11,10,21,32,19,51,0.000333,0.074669,5,1120.040943,62.224497,224.008189,71.273029,1,2
0,0,6,6,11,10,21,32,19,51,0.000333,0.074669,5,1120.040943,62.224497,224.008189,71.273029,1,2
0,0,6,6,11,10,21,32,19,51,0.000333,0.074669,5,1120.040943,62.224497,224.008189,71.273029,1,2
0,0,6,6,11,10,21,32,19,51,0.000333,0.074669,5,1120.040943,62.224497,224.008189,71.273029,1,2
0,0,6,6,11,10,21,32,19,51,0.000333,0.074669,5,1120.040943,62.224497,224.008189,71.273029,1,2
0,0,6,6,11,10,21,32,19,51,0.000333,0.074669,5,1120.040943,62.224497,224.008189,71.273029,1,2
0,0,6,6,11,10,21,32,19,51,0.000333,0.074669,5,1120.040943,62.224497,224.008189,71.273029,1,2
0,0,8,8,11,11,22,38,25,63,0.000333,0.093648,10,2809.44192,156.080107,280.944192,76.107496,1,2
0,0,6,6,12,10,22,35,21,56,0.000333,0.083243,12,2996.738048,166.485447,249.728171,76.238831,1,2
0,0,7,7,12,16,28,35,26,61,0.000333,0.09775,6,1759.491901,97.74955,293.24865,107.01955,1,2
0,0,10,10,11,15,26,49,37,86,0.000333,0.134746,10,4042.378158,224.576564,404.237816,96.657107,1,2
0,0,9,9,12,13,25,47,31,78,0.000333,0.12074,12,4346.649394,241.480522,362.220783,91.125266,1,2
0,0,8,8,10,12,22,28,30,58,0.000333,0.086216,10,2586.470339,143.692797,258.647034,76.238831,1,2
0,0,7,7,11,15,26,35,26,61,0.000333,0.095576,5,1433.634114,79.64634,286.726823,96.657107,1,2
0,0,7,7,11,15,26,35,26,61,0.000333,0.095576,5,1433.634114,79.64634,286.726823,96.657107,1,2
0,0,7,7,11,15,26,35,26,61,0.000333,0.095576,5,1433.634114,79.64634,286.726823,96.657107,1,2
0,0,7,7,11,15,26,35,26,61,0.000333,0.095576,5,1433.634114,79.64634,286.726823,96.657107,1,2
0,0,9,9,12,16,28,44,34,78,0.000333,0.124991,12,4499.684207,249.982456,374.973684,107.01955,1,2
0,0,10,10,12,18,30,53,38,91,0.000333,0.148842,12,5358.32453,297.684696,446.527044,118.0782,1,2
0,0,9,9,11,17,28,46,32,78,0.000333,0.124991,5,1874.86842,104.159357,374.973684,107.540616,1,2
0,0,11,11,11,18,29,53,41,94,0.000333,0.152217,10,4566.502135,253.694563,456.650214,113.112398,1,2
0,0,11,11,12,18,30,45,46,91,0.000333,0.148842,12,5358.32453,297.684696,446.527044,118.0782,1,2
0,0,8,8,12,16,28,42,31,73,0.000333,0.116979,6,2105.621456,116.97897,350.936909,107.01955,1,2
0,0,5,5,13,15,28,31,23,54,0.000333,0.086532,6,1557.582995,86.532389,259.597166,106.709075,1,2
0,0,9,9,14,18,32,44,41,85,0.000333,0.141667,14,5950,330.555556,425,128.361619,1,2
0,0,7,7,10,10,20,34,21,55,0.000333,0.079235,10,2377.060452,132.058914,237.706045,66.438562,1,2
0,0,8,8,10,10,20,36,23,59,0.000333,0.084998,10,2549.937576,141.663199,254.993758,66.438562,1,2
0,0,8,8,10,10,20,26,20,46,0.000333,0.06627,10,1988.086924,110.449274,198.808692,66.438562,2,2
0,0,7,7,11,11,22,33,20,53,0.000333,0.078783,5,1181.749379,65.652743,236.349876,76.107496,2,2
0,0,8,8,11,11,22,35,22,57,0.000333,0.084729,10,2541.876023,141.215335,254.187602,76.107496,2,2
0,0,7,7,11,12,23,33,21,54,0.000333,0.081424,5,1221.361728,67.853429,244.272346,81.073298,2,2
0,0,7,7,11,12,23,33,21,54,0.000333,0.081424,5,1221.361728,67.853429,244.272346,81.073298,2,2
0,0,7,7,11,11,22,33,20,53,0.000333,0.078783,5,1181.749379,65.652743,236.349876,76.107496,2,2
0,0,7,7,11,11,22,33,20,53,0.000333,0.078783,5,1181.749379,65.652743,236.349876,76.107496,2,2
0,0,7,7,11,11,22,33,20,53,0.000333,0.078783,5,1181.749379,65.652743,236.349876,76.107496,2,2
0,0,7,7,11,11,22,33,20,53,0.000333,0.078783,5,1181.749379,65.652743,236.349876,76.107496,2,2
0,0,7,7,11,11,22,33,20,53,0.000333,0.078783,5,1181.749379,65.652743,236.349876,76.107496,2,2
0,0,6,6,10,10,20,30,19,49,0.000333,0.070591,5,1058.872383,58.826244,211.774477,66.438562,1,2
0,0,6,6,10,10,20,30,19,49,0.000333,0.070591,5,1058.872383,58.826244,211.774477,66.438562,1,2
0,0,6,6,10,10,20,30,19,49,0.000333,0.070591,5,1058.872383,58.826244,211.774477,66.438562,1,2
0,0,6,6,10,10,20,30,19,49,0.000333,0.070591,5,1058.872383,58.826244,211.774477,66.438562,1,2
0,0,6,6,10,10,20,30,19,49,0.000333,0.070591,5,1058.872383,58.826244,211.774477,66.438562,1,2
0,0,6,6,10,9,19,30,19,49,0.000333,0.069383,10,2081.484482,115.638027,208.148448,61.748606,1,2
0,0,8,8,10,11,21,36,25,61,0.000333,0.08931,10,2679.313628,148.850757,267.931363,71.273029,1,2
0,0,6,6,11,10,21,33,21,54,0.000333,0.079062,10,2371.851408,131.769523,237.185141,71.273029,1,2
0,0,6,6,11,15,26,29,24,53,0.000333,0.083041,5,1245.616525,69.200918,249.123305,96.657107,1,2
0,0,8,8,10,15,25,39,33,72,0.000333,0.111453,10,3343.576457,185.754248,334.357646,91.82264,1,2
0,0,9,9,11,13,24,45,29,74,0.000333,0.113096,10,3392.872251,188.492903,339.287225,86.159464,1,2
0,0,9,9,10,15,25,36,31,67,0.000333,0.103713,10,3111.383647,172.854647,311.138365,91.82264,1,2
0,0,8,8,10,15,25,36,31,67,0.000333,0.103713,10,3111.383647,172.854647,311.138365,91.82264,1,2
0,0,8,8,10,16,26,36,31,67,0.000333,0.104976,5,1574.647306,87.480406,314.929461,97.219281,1,2
0,0,8,8,10,16,26,36,31,67,0.000333,0.104976,5,1574.647306,87.480406,314.929461,97.219281,1,2
0,0,8,8,10,15,25,36,31,67,0.000333,0.103713,10,3111.383647,172.854647,311.138365,91.82264,1,2
0,0,9,9,10,17,27,41,34,75,0.000333,0.118872,10,3566.165627,198.120313,356.616563,102.706149,1,2
0,0,10,10,10,16,26,42,35,77,0.000333,0.120645,10,3619.338583,201.074366,361.933858,97.219281,1,2
0,0,9,9,9,15,24,35,32,67,0.000333,0.102397,8,2457.5399,136.529994,307.192488,87.132684,1,2
0,0,11,11,9,17,26,42,38,80,0.000333,0.125345,8,3008.28142,167.126746,376.035177,98.016193,1,2
0,0,11,11,10,17,27,34,43,77,0.000333,0.122042,10,3661.263377,203.403521,366.126338,102.706149,1,2
0,0,8,8,9,14,23,25,29,54,0.000333,0.081424,8,1954.178765,108.565487,244.272346,81.832294,1,2
0,0,9,9,13,17,30,34,36,70,0.000333,0.114494,12,4121.7881,228.988228,343.482342,117.592585,1,2
0,0,9,9,12,17,29,33,36,69,0.000333,0.111734,12,4022.408264,223.467126,335.200689,112.506418,1,2
0,0,6,6,10,10,20,31,20,51,0.000333,0.073473,10,2204.183328,122.454629,220.418333,66.438562,1,2
0,0,7,7,10,10,20,33,22,55,0.000333,0.079235,10,2377.060452,132.058914,237.706045,66.438562,1,2
0,0,6,6,10,10,20,31,20,51,0.000333,0.073473,10,2204.183328,122.454629,220.418333,66.438562,1,2
0,0,6,6,10,10,20,31,20,51,0.000333,0.073473,10,2204.183328,122.454629,220.418333,66.438562,1,2
0,0,6,6,10,10,20,31,20,51,0.000333,0.073473,10,2204.183328,122.454629,220.418333,66.438562,1,2
0,0,6,6,10,10,20,31,20,51,0.000333,0.073473,10,2204.183328,122.454629,220.418333,66.438562,1,2
0,0,6,6,10,9,19,31,20,51,0.000333,0.072215,10,2166.443032,120.357946,216.644303,61.748606,1,2
0,0,6,6,10,10,20,31,20,51,0.000333,0.073473,10,2204.183328,122.454629,220.418333,66.438562,1,2
0,0,6,6,10,10,20,31,20,51,0.000333,0.073473,10,2204.183328,122.454629,220.418333,66.438562,1,2
0,0,6,6,10,10,20,31,20,51,0.000333,0.073473,10,2204.183328,122.454629,220.418333,66.438562,1,2
0,0,6,6,10,10,20,31,20,51,0.000333,0.073473,10,2204.183328,122.454629,220.418333,66.438562,1,2
0,0,6,6,10,10,20,31,20,51,0.000333,0.073473,10,2204.183328,122.454629,220.418333,66.438562,1,2
0,0,6,6,10,10,20,31,20,51,0.000333,0.073473,10,2204.183328,122.454629,220.418333,66.438562,1,2
0,0,6,6,10,10,20,31,20,51,0.000333,0.073473,10,2204.183328,122.454629,220.418333,66.438562,1,2
0,0,6,6,10,10,20,31,20,51,0.000333,0.073473,10,2204.183328,122.454629,220.418333,66.438562,1,2
0,0,6,6,10,10,20,31,20,51,0.000333,0.073473,10,2204.183328,122.454629,220.418333,66.438562,1,2
0,0,6,6,10,10,20,31,20,51,0.000333,0.073473,10,2204.183328,122.454629,220.418333,66.438562,1,2
0,0,6,6,10,10,20,31,20,51,0.000333,0.073473,10,2204.183328,122.454629,220.418333,66.438562,1,2
0,0,8,8,10,11,21,37,26,63,0.000333,0.092239,10,2767.159976,153.73111,276.715998,71.273029,1,2
0,0,6,6,11,10,21,34,22,56,0.000333,0.08199,10,2459.697757,136.649875,245.969776,71.273029,1,2
0,0,7,7,11,15,26,32,27,59,0.000333,0.092442,5,1386.629717,77.034984,277.325943,96.657107,1,2
0,0,11,11,9,14,23,41,41,82,0.000333,0.123644,8,2967.456643,164.858702,370.93208,81.832294,1,2
0,0,9,9,11,13,24,46,30,76,0.000333,0.116152,10,3484.571501,193.587306,348.45715,86.159464,1,2
0,0,8,8,10,15,25,35,30,65,0.000333,0.100617,10,3018.506523,167.694807,301.850652,91.82264,1,2
0,0,8,8,9,14,23,28,29,57,0.000333,0.085948,8,2062.744252,114.596903,257.843031,81.832294,1,2
0,0,8,8,9,15,24,28,29,57,0.000333,0.087114,4,1045.37145,58.076192,261.342863,87.132684,1,2
0,0,8,8,9,15,24,28,29,57,0.000333,0.087114,4,1045.37145,58.076192,261.342863,87.132684,1,2
0,0,8,8,9,15,24,28,29,57,0.000333,0.087114,4,1045.37145,58.076192,261.342863,87.132684,1,2
0,0,9,9,10,15,25,34,32,66,0.000333,0.102165,10,3064.945085,170.274727,306.494509,91.82264,1,2
0,0,10,10,10,16,26,43,36,79,0.000333,0.123778,10,3713.347377,206.297077,371.334738,97.219281,1,2
0,0,9,9,10,17,27,45,33,78,0.000333,0.123627,5,1854.406126,103.022563,370.881225,102.706149,1,2
0,0,11,11,9,17,26,43,39,82,0.000333,0.128479,8,3083.488455,171.304914,385.436057,98.016193,1,2
0,0,11,11,10,17,27,35,44,79,0.000333,0.125212,10,3756.361127,208.686729,375.636113,102.706149,1,2
0,0,8,8,9,14,23,26,30,56,0.000333,0.08444,8,2026.555756,112.586431,253.31947,81.832294,1,2
0,0,8,8,13,17,30,33,35,68,0.000333,0.111223,12,4004.022726,222.445707,333.668561,117.592585,1,2
0,0,8,8,13,19,32,41,38,79,0.000333,0.131667,12,4740,263.333333,395,128.816339,1,2
0,0,6,6,11,10,21,32,19,51,0.000333,0.074669,5,1120.040943,62.224497,224.008189,71.273029,1,2
0,0,6,6,11,10,21,32,19,51,0.000333,0.074669,5,1120.040943,62.224497,224.008189,71.273029,1,2
0,0,6,6,11,10,21,32,19,51,0.000333,0.074669,5,1120.040943,62.224497,224.008189,71.273029,1,2
0,0,6,6,11,10,21,32,19,51,0.000333,0.074669,5,1120.040943,62.224497,224.008189,71.273029,1,2
0,0,6,6,11,10,21,32,19,51,0.000333,0.074669,5,1120.040943,62.224497,224.008189,71.273029,1,2
0,0,6,6,11,10,21,32,19,51,0.000333,0.074669,5,1120.040943,62.224497,224.008189,71.273029,1,2
0,0,6,6,11,10,21,32,19,51,0.000333,0.074669,5,1120.040943,62.224497,224.008189,71.273029,1,2
0,0,6,6,11,10,21,32,19,51,0.000333,0.074669,5,1120.040943,62.224497,224.008189,71.273029,1,2
0,0,6,6,11,10,21,32,19,51,0.000333,0.074669,5,1120.040943,62.224497,224.008189,71.273029,1,2
0,0,6,6,11,10,21,32,19,51,0.000333,0.074669,5,1120.040943,62.224497,224.008189,71.273029,1,2
0,0,6,6,11,10,21,32,19,51,0.000333,0.074669,5,1120.040943,62.224497,224.008189,71.273029,1,2
0,0,6,6,11,10,21,32,19,51,0.000333,0.074669,5,1120.040943,62.224497,224.008189,71.273029,1,2
0,0,6,6,11,10,21,32,19,51,0.000333,0.074669,5,1120.040943,62.224497,224.008189,71.273029,1,2
0,0,6,6,11,10,21,32,19,51,0.000333,0.074669,5,1120.040943,62.224497,224.008189,71.273029,1,2
0,0,6,6,11,10,21,32,19,51,0.000333,0.074669,5,1120.040943,62.224497,224.008189,71.273029,1,2
0,0,6,6,11,10,21,32,19,51,0.000333,0.074669,5,1120.040943,62.224497,224.008189,71.273029,1,2
0,0,6,6,11,10,21,32,19,51,0.000333,0.074669,5,1120.040943,62.224497,224.008189,71.273029,1,2
0,0,6,6,11,10,21,32,19,51,0.000333,0.074669,5,1120.040943,62.224497,224.008189,71.273029,1,2
0,0,8,8,11,11,22,38,25,63,0.000333,0.093648,10,2809.44192,156.080107,280.944192,76.107496,1,2
0,0,7,7,12,10,22,37,23,60,0.000333,0.089189,12,3210.790765,178.377265,267.565897,76.238831,1,2
0,0,7,7,12,15,27,33,26,59,0.000333,0.093513,6,1683.230176,93.512788,280.538363,101.622909,1,2
0,0,9,9,11,15,26,45,35,80,0.000333,0.125345,10,3760.351775,208.908432,376.035177,96.657107,1,2
0,0,9,9,12,13,25,47,29,76,0.000333,0.117644,12,4235.196845,235.288714,352.93307,91.125266,1,2
0,0,9,9,11,15,26,38,31,69,0.000333,0.10811,10,3243.303406,180.183523,324.330341,96.657107,1,2
0,0,8,8,10,14,24,29,28,57,0.000333,0.087114,10,2613.428625,145.190479,261.342863,86.52225,1,2
0,0,8,8,10,16,26,29,28,57,0.000333,0.089308,5,1339.62532,74.423629,267.925064,97.219281,1,2
0,0,8,8,10,16,26,29,28,57,0.000333,0.089308,5,1339.62532,74.423629,267.925064,97.219281,1,2
0,0,8,8,10,16,26,29,28,57,0.000333,0.089308,5,1339.62532,74.423629,267.925064,97.219281,1,2
0,0,9,9,11,15,26,35,31,66,0.000333,0.10341,10,3102.290214,172.349456,310.229021,96.657107,1,2
0,0,10,10,11,16,27,44,35,79,0.000333,0.125212,10,3756.361127,208.686729,375.636113,102.053748,1,2
0,0,9,9,10,15,25,37,32,69,0.000333,0.106809,10,3204.260771,178.014487,320.426077,91.82264,1,2
0,0,11,11,10,17,27,44,38,82,0.000333,0.129967,10,3899.007752,216.611542,389.900775,102.706149,1,2
0,0,11,11,11,17,28,36,43,79,0.000333,0.126594,10,3797.810388,210.989466,379.781039,107.540616,1,2
0,0,9,9,10,14,24,29,31,60,0.000333,0.091699,10,2750.9775,152.832083,275.09775,86.52225,1,2
0,0,9,9,14,17,31,36,36,72,0.000333,0.118901,14,4993.829881,277.434993,356.702134,122.789837,1,2
0,0,9,9,13,17,30,35,36,71,0.000333,0.11613,12,4180.670787,232.259488,348.389232,117.592585,1,2
0,0,5,5,10,10,20,34,20,54,0.000333,0.077795,10,2333.841171,129.657843,233.384117,66.438562,1,2
0,0,5,5,10,10,20,34,20,54,0.000333,0.077795,10,2333.841171,129.657843,233.384117,66.438562,1,2
0,0,5,5,10,10,20,34,20,54,0.000333,0.077795,10,2333.841171,129.657843,233.384117,66.438562,1,2
0,0,5,5,10,10,20,34,20,54,0.000333,0.077795,10,2333.841171,129.657843,233.384117,66.438562,1,2
0,0,5,5,10,10,20,34,20,54,0.000333,0.077795,10,2333.841171,129.657843,233.384117,66.438562,1,2
0,0,5,5,10,10,20,34,20,54,0.000333,0.077795,10,2333.841171,129.657843,233.384117,66.438562,1,2
0,0,5,5,10,10,20,34,20,54,0.000333,0.077795,10,2333.841171,129.657843,233.384117,66.438562,1,2
0,0,5,5,10,10,20,34,20,54,0.000333,0.077795,10,2333.841171,129.657843,233.384117,66.438562,1,2
0,0,5,5,10,10,20,34,20,54,0.000333,0.077795,10,2333.841171,129.657843,233.384117,66.438562,1,2
0,0,5,5,10,10,20,34,20,54,0.000333,0.077795,10,2333.841171,129.657843,233.384117,66.438562,1,2
0,0,5,5,10,10,20,34,20,54,0.000333,0.077795,10,2333.841171,129.657843,233.384117,66.438562,1,2
0,0,5,5,10,11,21,34,20,54,0.000333,0.079062,5,1185.925704,65.884761,237.185141,71.273029,1,2
0,0,5,5,10,10,20,34,20,54,0.000333,0.077795,10,2333.841171,129.657843,233.384117,66.438562,1,2
0,0,5,5,10,10,20,34,20,54,0.000333,0.077795,10,2333.841171,129.657843,233.384117,66.438562,1,2
0,0,5,5,10,10,20,34,20,54,0.000333,0.077795,10,2333.841171,129.657843,233.384117,66.438562,1,2
0,0,5,5,10,10,20,34,20,54,0.000333,0.077795,10,2333.841171,129.657843,233.384117,66.438562,1,2
0,0,5,5,10,10,20,34,20,54,0.000333,0.077795,10,2333.841171,129.657843,233.384117,66.438562,1,2
0,0,5,5,10,10,20,34,20,54,0.000333,0.077795,10,2333.841171,129.657843,233.384117,66.438562,1,2
0,0,8,8,12,10,22,45,28,73,0.000333,0.108513,12,3906.462098,217.025672,325.538508,76.238831,1,2
0,0,5,5,9,13,22,33,23,56,0.000333,0.083243,4,998.912683,55.495149,249.728171,76.635041,1,2
0,0,7,7,10,10,20,38,25,63,0.000333,0.09076,10,2722.8147,151.267483,272.28147,66.438562,1,2
0,0,6,6,10,9,19,32,20,52,0.000333,0.073631,10,2208.922307,122.717906,220.892231,61.748606,1,2
0,0,8,8,11,17,28,42,32,74,0.000333,0.118581,5,1778.721321,98.817851,355.744264,107.540616,1,2
0,0,7,7,10,15,25,40,32,72,0.000333,0.111453,10,3343.576457,185.754248,334.357646,91.82264,1,2
0,0,8,8,11,11,22,44,27,71,0.000333,0.10554,10,3166.196449,175.899803,316.619645,76.107496,1,2
0,0,8,8,11,13,24,49,30,79,0.000333,0.120737,10,3622.120376,201.22891,362.212038,86.159464,1,2
0,0,8,8,10,15,25,40,32,72,0.000333,0.111453,10,3343.576457,185.754248,334.357646,91.82264,1,2
0,0,7,7,10,15,25,40,32,72,0.000333,0.111453,10,3343.576457,185.754248,334.357646,91.82264,1,2
0,0,7,7,10,16,26,40,32,72,0.000333,0.112811,10,3384.316597,188.017589,338.43166,97.219281,1,2
0,0,7,7,10,16,26,40,32,72,0.000333,0.112811,10,3384.316597,188.017589,338.43166,97.219281,1,2
0,0,7,7,10,16,26,40,32,72,0.000333,0.112811,10,3384.316597,188.017589,338.43166,97.219281,1,2
0,0,5,5,9,13,22,33,23,56,0.000333,0.083243,4,998.912683,55.495149,249.728171,76.635041,1,2
0,0,7,7,11,16,27,46,35,81,0.000333,0.128382,10,3851.458877,213.969938,385.145888,102.053748,1,2
0,0,9,9,11,17,28,55,39,94,0.000333,0.15063,10,4518.913627,251.050757,451.891363,107.540616,1,2
0,0,8,8,10,16,26,48,36,84,0.000333,0.131612,10,3948.369363,219.353854,394.836936,97.219281,1,2
0,0,10,10,10,18,28,55,42,97,0.000333,0.155438,10,4663.134274,259.063015,466.313427,108.277931,1,2
0,0,10,10,11,18,29,47,47,94,0.000333,0.152217,10,4566.502135,253.694563,456.650214,113.112398,1,2
0,0,8,8,10,15,25,40,35,75,0.000333,0.116096,10,3482.892142,193.494008,348.289214,91.82264,1,2
0,0,8,8,14,18,32,47,40,87,0.000333,0.145,14,6090,338.333333,435,128.361619,1,2
0,0,8,8,13,18,31,46,40,86,0.000333,0.14202,12,5112.730592,284.040588,426.060883,123.164366,1,2
0,0,6,6,10,11,21,40,24,64,0.000333,0.093703,10,2811.083151,156.171286,281.108315,71.273029,1,2
0,0,6,6,10,11,21,40,24,64,0.000333,0.093703,10,2811.083151,156.171286,281.108315,71.273029,1,2
0,0,6,6,10,11,21,40,24,64,0.000333,0.093703,10,2811.083151,156.171286,281.108315,71.273029,1,2
0,0,6,6,10,11,21,40,24,64,0.000333,0.093703,10,2811.083151,156.171286,281.108315,71.273029,1,2
0,0,6,6,10,11,21,40,24,64,0.000333,0.093703,10,2811.083151,156.171286,281.108315,71.273029,1,2
0,0,6,6,10,11,21,40,24,64,0.000333,0.093703,10,2811.083151,156.171286,281.108315,71.273029,1,2
0,0,6,6,10,11,21,40,24,64,0.000333,0.093703,10,2811.083151,156.171286,281.108315,71.273029,1,2
0,0,6,6,10,11,21,40,24,64,0.000333,0.093703,10,2811.083151,156.171286,281.108315,71.273029,1,2
0,0,6,6,10,11,21,40,24,64,0.000333,0.093703,10,2811.083151,156.171286,281.108315,71.273029,1,2
0,0,6,6,10,11,21,40,24,64,0.000333,0.093703,10,2811.083151,156.171286,281.108315,71.273029,1,2
0,0,6,6,10,11,21,40,24,64,0.000333,0.093703,10,2811.083151,156.171286,281.108315,71.273029,1,2
0,0,6,6,10,11,21,40,24,64,0.000333,0.093703,10,2811.083151,156.171286,281.108315,71.273029,1,2
0,0,6,6,10,11,21,40,24,64,0.000333,0.093703,10,2811.083151,156.171286,281.108315,71.273029,1,2
0,0,6,6,10,11,21,40,24,64,0.000333,0.093703,10,2811.083151,156.171286,281.108315,71.273029,1,2
0,0,6,6,10,11,21,40,24,64,0.000333,0.093703,10,2811.083151,156.171286,281.108315,71.273029,1,2
0,0,6,6,10,11,21,40,24,64,0.000333,0.093703,10,2811.083151,156.171286,281.108315,71.273029,1,2
0,0,6,6,10,11,21,40,24,64,0.000333,0.093703,10,2811.083151,156.171286,281.108315,71.273029,1,2
0,0,6,6,10,11,21,40,24,64,0.000333,0.093703,10,2811.083151,156.171286,281.108315,71.273029,1,2
0,0,8,8,12,11,23,45,28,73,0.000333,0.110073,12,3962.640274,220.146682,330.220023,81.073298,1,2
0,0,6,6,9,15,24,35,28,63,0.000333,0.096284,4,1155.41055,64.189475,288.852638,87.132684,1,2
0,0,8,8,10,12,22,46,30,76,0.000333,0.112972,10,3389.16803,188.287113,338.916803,76.238831,1,2
0,0,11,11,11,13,24,61,38,99,0.000333,0.151304,10,4539.112876,252.172938,453.911288,86.159464,1,2
0,0,9,9,11,18,29,48,36,84,0.000333,0.136023,10,4080.704036,226.70578,408.070404,113.112398,1,2
0,0,8,8,10,16,26,46,36,82,0.000333,0.128479,10,3854.360569,214.131143,385.436057,97.219281,1,2
0,0,10,10,11,12,23,54,34,88,0.000333,0.132691,10,3980.734521,221.151918,398.073452,81.073298,1,2
0,0,9,9,11,14,25,55,34,89,0.000333,0.137768,10,4133.032009,229.612889,413.303201,91.356717,1,2
0,0,9,9,10,16,26,46,36,82,0.000333,0.128479,10,3854.360569,214.131143,385.436057,97.219281,1,2
0,0,8,8,10,16,26,46,36,82,0.000333,0.128479,10,3854.360569,214.131143,385.436057,97.219281,1,2
0,0,8,8,10,17,27,46,36,82,0.000333,0.129967,10,3899.007752,216.611542,389.900775,102.706149,1,2
0,0,8,8,10,17,27,46,36,82,0.000333,0.129967,10,3899.007752,216.611542,389.900775,102.706149,1,2
0,0,8,8,10,17,27,46,36,82,0.000333,0.129967,10,3899.007752,216.611542,389.900775,102.706149,1,2
0,0,8,8,11,14,25,45,34,79,0.000333,0.122288,10,3668.64639,203.813688,366.864639,91.356717,1,2
0,0,9,9,11,17,28,52,39,91,0.000333,0.145823,10,4374.692979,243.038499,437.469298,107.540616,1,2
0,0,10,10,11,18,29,61,43,104,0.000333,0.16841,10,5052.300235,280.683346,505.230023,113.112398,1,2
0,0,9,9,10,17,27,54,40,94,0.000333,0.148986,10,4469.594252,248.310792,446.959425,102.706149,1,2
0,0,11,11,10,19,29,61,46,107,0.000333,0.173268,10,5198.039665,288.779981,519.803966,113.929904,1,2
0,0,11,11,11,19,30,53,51,104,0.000333,0.170106,10,5103.166219,283.509234,510.316622,118.764371,1,2
0,0,10,10,10,17,27,47,44,91,0.000333,0.144232,10,4326.947627,240.385979,432.694763,102.706149,1,2
0,0,9,9,14,19,33,53,44,97,0.000333,0.163102,14,6850.287214,380.571512,489.30623,134.013592,1,2
0,0,9,9,13,19,32,52,44,96,0.000333,0.16,12,5760,320,480,128.816339,1,2
0,0,6,6,10,11,21,36,23,59,0.000333,0.086382,10,2591.467279,143.970404,259.146728,71.273029,1,2
0,0,6,6,10,11,21,36,23,59,0.000333,0.086382,10,2591.467279,143.970404,259.146728,71.273029,1,2
0,0,6,6,10,11,21,36,23,59,0.000333,0.086382,10,2591.467279,143.970404,259.146728,71.273029,1,2
0,0,6,6,10,11,21,36,23,59,0.000333,0.086382,10,2591.467279,143.970404,259.146728,71.273029,1,2
0,0,6,6,10,11,21,36,23,59,0.000333,0.086382,10,2591.467279,143.970404,259.146728,71.273029,1,2
0,0,6,6,10,11,21,36,23,59,0.000333,0.086382,10,2591.467279,143.970404,259.146728,71.273029,1,2
0,0,6,6,10,11,21,36,23,59,0.000333,0.086382,10,2591.467279,143.970404,259.146728,71.273029,1,2
0,0,6,6,10,11,21,36,23,59,0.000333,0.086382,10,2591.467279,143.970404,259.146728,71.273029,1,2
0,0,6,6,10,11,21,36,23,59,0.000333,0.086382,10,2591.467279,143.970404,259.146728,71.273029,1,2
0,0,6,6,10,11,21,36,23,59,0.000333,0.086382,10,2591.467279,143.970404,259.146728,71.273029,1,2
0,0,6,6,10,11,21,36,23,59,0.000333,0.086382,10,2591.467279,143.970404,259.146728,71.273029,1,2
0,0,6,6,10,11,21,36,23,59,0.000333,0.086382,10,2591.467279,143.970404,259.146728,71.273029,1,2
0,0,6,6,10,11,21,36,23,59,0.000333,0.086382,10,2591.467279,143.970404,259.146728,71.273029,1,2
0,0,6,6,10,11,21,36,23,59,0.000333,0.086382,10,2591.467279,143.970404,259.146728,71.273029,1,2
0,0,6,6,10,11,21,36,23,59,0.000333,0.086382,10,2591.467279,143.970404,259.146728,71.273029,1,2
0,0,6,6,10,11,21,36,23,59,0.000333,0.086382,10,2591.467279,143.970404,259.146728,71.273029,1,2
0,0,6,6,10,11,21,36,23,59,0.000333,0.086382,10,2591.467279,143.970404,259.146728,71.273029,1,2
0,0,6,6,10,11,21,36,23,59,0.000333,0.086382,10,2591.467279,143.970404,259.146728,71.273029,1,2
0,0,6,6,10,11,21,36,23,59,0.000333,0.086382,10,2591.467279,143.970404,259.146728,71.273029,1,2
0,0,11,11,12,13,25,53,36,89,0.000333,0.137768,12,4959.638411,275.535467,413.303201,91.125266,1,2
0,0,10,10,10,16,26,51,47,98,0.000333,0.153548,10,4606.430924,255.912829,460.643092,97.219281,1,2
0,0,8,8,10,12,22,42,29,71,0.000333,0.10554,10,3166.196449,175.899803,316.619645,76.238831,1,2
0,0,8,8,11,12,23,45,29,74,0.000333,0.111581,10,3347.435847,185.968658,334.743585,81.073298,1,2
0,0,9,9,11,18,29,44,35,79,0.000333,0.127927,5,1918.902493,106.605694,383.780499,113.112398,1,2
0,0,8,8,10,16,26,42,35,77,0.000333,0.120645,10,3619.338583,201.074366,361.933858,97.219281,1,2
0,0,8,8,11,12,23,45,30,75,0.000333,0.113089,10,3392.671467,188.481748,339.267147,81.073298,1,2
0,0,9,9,11,14,25,51,33,84,0.000333,0.130028,10,3900.839199,216.713289,390.08392,91.356717,1,2
0,0,9,9,11,17,28,40,31,71,0.000333,0.113774,5,1706.610997,94.811722,341.322199,107.540616,1,2
0,0,8,8,10,16,26,42,35,77,0.000333,0.120645,10,3619.338583,201.074366,361.933858,97.219281,1,2
0,0,7,7,9,16,25,30,29,59,0.000333,0.091329,4,1095.950061,60.886114,273.987515,92.529325,1,2
0,0,8,8,10,17,27,42,35,77,0.000333,0.122042,10,3661.263377,203.403521,366.126338,102.706149,1,2
0,0,8,8,10,17,27,42,35,77,0.000333,0.122042,10,3661.263377,203.403521,366.126338,102.706149,1,2
0,0,7,7,10,15,25,40,29,69,0.000333,0.106809,5,1602.130385,89.007244,320.426077,91.82264,1,2
0,0,9,9,11,17,28,48,38,86,0.000333,0.137811,10,4134.325233,229.684735,413.432523,107.540616,1,2
0,0,10,10,11,18,29,57,42,99,0.000333,0.160313,10,4809.401185,267.188955,480.940119,113.112398,1,2
0,0,9,9,10,17,27,50,39,89,0.000333,0.141062,10,4231.849877,235.102771,423.184988,102.706149,1,2
0,0,11,11,10,19,29,57,45,102,0.000333,0.165171,10,4955.140615,275.28559,495.514062,113.929904,1,2
0,0,11,11,11,19,30,49,50,99,0.000333,0.161927,10,4857.82169,269.878983,485.782169,118.764371,1,2
0,0,10,10,10,17,27,43,43,86,0.000333,0.136307,10,4089.203252,227.177958,408.920325,102.706149,1,2
0,0,9,9,14,19,33,49,43,92,0.000333,0.154695,14,6497.179626,360.954424,464.084259,134.013592,1,2
0,0,9,9,13,19,32,48,43,91,0.000333,0.151667,12,5460,303.333333,455,128.816339,1,2
0,0,6,6,10,11,21,36,23,59,0.000333,0.086382,10,2591.467279,143.970404,259.146728,71.273029,1,2
0,0,6,6,10,11,21,36,23,59,0.000333,0.086382,10,2591.467279,143.970404,259.146728,71.273029,1,2
0,0,6,6,10,11,21,36,23,59,0.000333,0.086382,10,2591.467279,143.970404,259.146728,71.273029,1,2
0,0,6,6,10,11,21,36,23,59,0.000333,0.086382,10,2591.467279,143.970404,259.146728,71.273029,1,2
0,0,6,6,10,11,21,36,23,59,0.000333,0.086382,10,2591.467279,143.970404,259.146728,71.273029,1,2
0,0,6,6,10,11,21,36,23,59,0.000333,0.086382,10,2591.467279,143.970404,259.146728,71.273029,1,2
0,0,6,6,10,11,21,36,23,59,0.000333,0.086382,10,2591.467279,143.970404,259.146728,71.273029,1,2
0,0,6,6,10,11,21,36,23,59,0.000333,0.086382,10,2591.467279,143.970404,259.146728,71.273029,1,2
0,0,6,6,10,11,21,36,23,59,0.000333,0.086382,10,2591.467279,143.970404,259.146728,71.273029,1,2
0,0,6,6,10,11,21,36,23,59,0.000333,0.086382,10,2591.467279,143.970404,259.146728,71.273029,1,2
0,0,6,6,10,11,21,36,23,59,0.000333,0.086382,10,2591.467279,143.970404,259.146728,71.273029,1,2
0,0,6,6,10,11,21,36,23,59,0.000333,0.086382,10,2591.467279,143.970404,259.146728,71.273029,1,2
0,0,6,6,10,11,21,36,23,59,0.000333,0.086382,10,2591.467279,143.970404,259.146728,71.273029,1,2
0,0,6,6,10,11,21,36,23,59,0.000333,0.086382,10,2591.467279,143.970404,259.146728,71.273029,1,2
0,0,6,6,10,11,21,36,23,59,0.000333,0.086382,10,2591.467279,143.970404,259.146728,71.273029,1,2
0,0,6,6,10,11,21,36,23,59,0.000333,0.086382,10,2591.467279,143.970404,259.146728,71.273029,1,2
0,0,6,6,10,11,21,36,23,59,0.000333,0.086382,10,2591.467279,143.970404,259.146728,71.273029,1,2
0,0,6,6,10,11,21,36,23,59,0.000333,0.086382,10,2591.467279,143.970404,259.146728,71.273029,1,2
0,0,8,8,12,11,23,41,27,68,0.000333,0.102534,12,3691.226556,205.068142,307.602213,81.073298,1,2
0,0,10,10,10,16,26,49,43,92,0.000333,0.144147,10,4324.404541,240.244697,432.440454,97.219281,1,2
0,0,8,8,10,12,22,42,29,71,0.000333,0.10554,10,3166.196449,175.899803,316.619645,76.238831,1,2
0,0,8,8,11,12,23,45,29,74,0.000333,0.111581,10,3347.435847,185.968658,334.743585,81.073298,1,2
0,0,9,9,11,18,29,44,35,79,0.000333,0.127927,5,1918.902493,106.605694,383.780499,113.112398,1,2
0,0,8,8,10,16,26,42,35,77,0.000333,0.120645,10,3619.338583,201.074366,361.933858,97.219281,1,2
0,0,9,9,12,12,24,47,31,78,0.000333,0.119209,12,4291.524901,238.41805,357.627075,86.0391,1,2
0,0,9,9,11,14,25,51,33,84,0.000333,0.130028,10,3900.839199,216.713289,390.08392,91.356717,1,2
0,0,10,10,11,17,28,44,37,81,0.000333,0.129799,10,3893.957487,216.330971,389.395749,107.540616,1,2
0,0,8,8,10,16,26,42,35,77,0.000333,0.120645,10,3619.338583,201.074366,361.933858,97.219281,1,2
0,0,8,8,10,17,27,42,35,77,0.000333,0.122042,10,3661.263377,203.403521,366.126338,102.706149,1,2
0,0,8,8,10,17,27,42,35,77,0.000333,0.122042,10,3661.263377,203.403521,366.126338,102.706149,1,2
0,0,8,8,10,17,27,42,35,77,0.000333,0.122042,10,3661.263377,203.403521,366.126338,102.706149,1,2
0,0,8,8,10,15,25,45,36,81,0.000333,0.125384,10,3761.523514,208.973529,376.152351,91.82264,1,2
0,0,9,9,11,17,28,48,38,86,0.000333,0.137811,10,4134.325233,229.684735,413.432523,107.540616,1,2
0,0,10,10,11,18,29,57,42,99,0.000333,0.160313,10,4809.401185,267.188955,480.940119,113.112398,1,2
0,0,9,9,10,17,27,50,39,89,0.000333,0.141062,10,4231.849877,235.102771,423.184988,102.706149,1,2
0,0,11,11,10,19,29,57,45,102,0.000333,0.165171,10,4955.140615,275.28559,495.514062,113.929904,1,2
0,0,11,11,11,19,30,49,50,99,0.000333,0.161927,10,4857.82169,269.878983,485.782169,118.764371,1,2
0,0,10,10,10,17,27,43,43,86,0.000333,0.136307,10,4089.203252,227.177958,408.920325,102.706149,1,2
0,0,9,9,12,20,32,44,40,84,0.000333,0.14,12,5040,280,420,129.458112,1,2
0,0,9,9,13,19,32,48,43,91,0.000333,0.151667,12,5460,303.333333,455,128.816339,1,2
0,0,6,6,11,11,22,38,23,61,0.000333,0.090675,10,2720.253287,151.125183,272.025329,76.107496,1,2
0,0,6,6,11,11,22,38,23,61,0.000333,0.090675,10,2720.253287,151.125183,272.025329,76.107496,1,2
0,0,6,6,11,11,22,38,23,61,0.000333,0.090675,10,2720.253287,151.125183,272.025329,76.107496,1,2
0,0,6,6,11,11,22,38,23,61,0.000333,0.090675,10,2720.253287,151.125183,272.025329,76.107496,1,2
0,0,6,6,11,11,22,38,23,61,0.000333,0.090675,10,2720.253287,151.125183,272.025329,76.107496,1,2
0,0,6,6,11,11,22,38,23,61,0.000333,0.090675,10,2720.253287,151.125183,272.025329,76.107496,1,2
0,0,6,6,11,11,22,38,23,61,0.000333,0.090675,10,2720.253287,151.125183,272.025329,76.107496,1,2
0,0,6,6,11,11,22,38,23,61,0.000333,0.090675,10,2720.253287,151.125183,272.025329,76.107496,1,2
0,0,6,6,11,11,22,38,23,61,0.000333,0.090675,10,2720.253287,151.125183,272.025329,76.107496,1,2
0,0,6,6,11,11,22,38,23,61,0.000333,0.090675,10,2720.253287,151.125183,272.025329,76.107496,1,2
0,0,6,6,11,11,22,38,23,61,0.000333,0.090675,10,2720.253287,151.125183,272.025329,76.107496,1,2
0,0,6,6,11,11,22,38,23,61,0.000333,0.090675,10,2720.253287,151.125183,272.025329,76.107496,1,2
0,0,6,6,11,11,22,38,23,61,0.000333,0.090675,10,2720.253287,151.125183,272.025329,76.107496,1,2
0,0,6,6,11,11,22,38,23,61,0.000333,0.090675,10,2720.253287,151.125183,272.025329,76.107496,1,2
0,0,6,6,11,11,22,38,23,61,0.000333,0.090675,10,2720.253287,151.125183,272.025329,76.107496,1,2
0,0,6,6,11,11,22,38,23,61,0.000333,0.090675,10,2720.253287,151.125183,272.025329,76.107496,1,2
0,0,6,6,11,11,22,38,23,61,0.000333,0.090675,10,2720.253287,151.125183,272.025329,76.107496,1,2
0,0,6,6,11,11,22,38,23,61,0.000333,0.090675,10,2720.253287,151.125183,272.025329,76.107496,1,2
0,0,11,11,13,13,26,55,36,91,0.000333,0.14258,12,5132.880172,285.16001,427.740014,96.211433,1,2
0,0,9,9,11,16,27,48,41,89,0.000333,0.141062,10,4231.849877,235.102771,423.184988,102.053748,1,2
0,0,8,8,11,12,23,44,29,73,0.000333,0.110073,10,3302.200228,183.455568,330.220023,81.073298,1,2
0,0,8,8,12,12,24,47,29,76,0.000333,0.116152,12,4181.485801,232.304767,348.45715,86.0391,1,2
0,0,9,9,12,18,30,46,35,81,0.000333,0.132486,6,2384.748829,132.486046,397.458138,118.0782,1,2
0,0,8,8,11,16,27,44,35,79,0.000333,0.125212,10,3756.361127,208.686729,375.636113,102.053748,1,2
0,0,10,10,13,12,25,53,34,87,0.000333,0.134672,12,4848.185862,269.343659,404.015489,91.125266,1,2
0,0,9,9,12,14,26,53,33,86,0.000333,0.134746,12,4850.853789,269.491877,404.237816,96.322519,1,2
0,0,10,10,12,17,29,45,37,82,0.000333,0.132785,12,4780.253299,265.569628,398.354442,112.506418,1,2
0,0,8,8,11,16,27,44,35,79,0.000333,0.125212,10,3756.361127,208.686729,375.636113,102.053748,1,2
0,0,8,8,11,17,28,44,35,79,0.000333,0.126594,10,3797.810388,210.989466,379.781039,107.540616,1,2
0,0,8,8,11,17,28,44,35,79,0.000333,0.126594,10,3797.810388,210.989466,379.781039,107.540616,1,2
0,0,8,8,11,17,28,44,35,79,0.000333,0.126594,10,3797.810388,210.989466,379.781039,107.540616,1,2
0,0,8,8,11,15,26,47,36,83,0.000333,0.130045,10,3901.364966,216.742498,390.136497,96.657107,1,2
0,0,9,9,12,18,30,48,38,86,0.000333,0.140664,12,5063.911095,281.328394,421.992591,118.0782,1,2
0,0,10,10,12,18,30,59,42,101,0.000333,0.165199,12,5947.151402,330.3973,495.59595,118.0782,1,2
0,0,9,9,11,17,28,52,39,91,0.000333,0.145823,10,4374.692979,243.038499,437.469298,107.540616,1,2
0,0,11,11,11,20,31,57,45,102,0.000333,0.168443,10,5053.280237,280.737791,505.328024,124.49231,1,2
0,0,11,11,12,19,31,51,50,101,0.000333,0.166791,12,6004.485928,333.582552,500.373827,123.730173,1,2
0,0,10,10,11,17,28,44,43,87,0.000333,0.139413,10,4182.398782,232.355488,418.239878,107.540616,1,2
0,0,9,9,15,19,34,51,43,94,0.000333,0.159407,14,6695.101099,371.950061,478.221507,139.313982,1,2
0,0,9,9,14,19,33,50,43,93,0.000333,0.156376,14,6567.801143,364.877841,469.128653,134.013592,1,2
0,0,6,6,10,10,20,31,21,52,0.000333,0.074913,10,2247.402609,124.855701,224.740261,66.438562,1,2
0,0,4,4,8,11,19,28,17,45,0.000333,0.063719,4,764.626952,42.479275,191.156738,62.053748,1,2
0,0,4,4,8,11,19,28,17,45,0.000333,0.063719,4,764.626952,42.479275,191.156738,62.053748,1,2
0,0,4,4,8,11,19,28,17,45,0.000333,0.063719,4,764.626952,42.479275,191.156738,62.053748,1,2
0,0,4,4,8,11,19,28,17,45,0.000333,0.063719,4,764.626952,42.479275,191.156738,62.053748,1,2
0,0,4,4,8,11,19,28,17,45,0.000333,0.063719,4,764.626952,42.479275,191.156738,62.053748,1,2
0,0,4,4,8,11,19,28,17,45,0.000333,0.063719,4,764.626952,42.479275,191.156738,62.053748,1,2
0,0,4,4,8,11,19,28,17,45,0.000333,0.063719,4,764.626952,42.479275,191.156738,62.053748,1,2
0,0,4,4,8,11,19,28,17,45,0.000333,0.063719,4,764.626952,42.479275,191.156738,62.053748,1,2
0,0,4,4,8,11,19,28,17,45,0.000333,0.063719,4,764.626952,42.479275,191.156738,62.053748,1,2
0,0,4,4,8,11,19,28,17,45,0.000333,0.063719,4,764.626952,42.479275,191.156738,62.053748,1,2
0,0,4,4,8,11,19,28,17,45,0.000333,0.063719,4,764.626952,42.479275,191.156738,62.053748,1,2
0,0,4,4,8,11,19,28,17,45,0.000333,0.063719,4,764.626952,42.479275,191.156738,62.053748,1,2
0,0,4,4,8,11,19,28,17,45,0.000333,0.063719,4,764.626952,42.479275,191.156738,62.053748,1,2
0,0,4,4,8,11,19,28,17,45,0.000333,0.063719,4,764.626952,42.479275,191.156738,62.053748,1,2
0,0,4,4,8,11,19,28,17,45,0.000333,0.063719,4,764.626952,42.479275,191.156738,62.053748,1,2
0,0,4,4,8,11,19,28,17,45,0.000333,0.063719,4,764.626952,42.479275,191.156738,62.053748,1,2
0,0,4,4,8,11,19,28,17,45,0.000333,0.063719,4,764.626952,42.479275,191.156738,62.053748,1,2
0,0,4,4,8,11,19,28,17,45,0.000333,0.063719,4,764.626952,42.479275,191.156738,62.053748,1,2
0,0,4,4,8,11,19,28,17,45,0.000333,0.063719,4,764.626952,42.479275,191.156738,62.053748,1,2
0,0,4,4,8,11,19,28,17,45,0.000333,0.063719,4,764.626952,42.479275,191.156738,62.053748,1,2
0,0,4,4,8,11,19,28,17,45,0.000333,0.063719,4,764.626952,42.479275,191.156738,62.053748,1,2
0,0,4,4,8,11,19,28,17,45,0.000333,0.063719,4,764.626952,42.479275,191.156738,62.053748,1,2
0,0,4,4,8,11,19,28,17,45,0.000333,0.063719,4,764.626952,42.479275,191.156738,62.053748,1,2
0,0,4,4,8,11,19,28,17,45,0.000333,0.063719,4,764.626952,42.479275,191.156738,62.053748,1,2
0,0,4,4,8,11,19,28,17,45,0.000333,0.063719,4,764.626952,42.479275,191.156738,62.053748,1,2
0,0,4,4,8,11,19,28,17,45,0.000333,0.063719,4,764.626952,42.479275,191.156738,62.053748,1,2
0,0,4,4,8,11,19,28,17,45,0.000333,0.063719,4,764.626952,42.479275,191.156738,62.053748,1,2
0,0,4,4,8,11,19,28,17,45,0.000333,0.063719,4,764.626952,42.479275,191.156738,62.053748,1,2
0,0,4,4,8,11,19,28,17,45,0.000333,0.063719,4,764.626952,42.479275,191.156738,62.053748,1,2
0,0,4,4,8,11,19,28,17,45,0.000333,0.063719,4,764.626952,42.479275,191.156738,62.053748,1,2
0,0,4,4,8,11,19,28,17,45,0.000333,0.063719,4,764.626952,42.479275,191.156738,62.053748,1,2
0,0,4,4,8,11,19,28,17,45,0.000333,0.063719,4,764.626952,42.479275,191.156738,62.053748,1,2
0,0,4,4,8,11,19,28,17,45,0.000333,0.063719,4,764.626952,42.479275,191.156738,62.053748,1,2
0,0,4,4,8,11,19,28,17,45,0.000333,0.063719,4,764.626952,42.479275,191.156738,62.053748,1,2
0,0,4,4,8,11,19,28,17,45,0.000333,0.063719,4,764.626952,42.479275,191.156738,62.053748,1,2
0,0,4,4,8,11,19,28,17,45,0.000333,0.063719,4,764.626952,42.479275,191.156738,62.053748,1,2
0,0,7,7,12,11,23,35,25,60,0.000333,0.090471,12,3256.964608,180.942478,271.413717,81.073298,1,2
0,0,8,8,12,12,24,43,29,72,0.000333,0.110039,12,3961.407601,220.0782,330.1173,86.0391,1,2
0,0,9,9,12,12,24,35,27,62,0.000333,0.094756,12,3411.212101,189.511783,284.267675,86.0391,1,2
0,0,7,7,11,11,22,34,25,59,0.000333,0.087702,10,2631.064655,146.170259,263.106465,76.107496,1,2
0,0,9,9,11,12,23,40,31,71,0.000333,0.107058,10,3211.728989,178.429388,321.172899,81.073298,1,2
0,0,11,11,11,13,24,46,37,83,0.000333,0.126851,10,3805.518876,211.417715,380.551888,86.159464,1,2
0,0,13,13,11,14,25,52,43,95,0.000333,0.147055,15,6617.49507,367.638615,441.166338,91.356717,1,2
0,0,8,8,12,10,22,38,27,65,0.000333,0.096621,12,3478.356663,193.242037,289.863055,76.238831,1,2
0,0,7,7,12,11,23,36,25,61,0.000333,0.091979,12,3311.247352,183.958186,275.937279,81.073298,1,2
0,0,8,8,12,12,24,40,28,68,0.000333,0.103926,12,3741.329401,207.851633,311.77745,86.0391,1,2
0,0,9,9,12,13,25,49,32,81,0.000333,0.125384,12,4513.828216,250.768234,376.152351,91.125266,1,2
0,0,8,8,11,12,23,42,29,71,0.000333,0.107058,10,3211.728989,178.429388,321.172899,81.073298,1,2
0,0,10,10,11,14,25,49,35,84,0.000333,0.130028,10,3900.839199,216.713289,390.08392,91.356717,1,2
0,0,10,10,12,14,26,41,34,75,0.000333,0.117511,12,4230.395746,235.021986,352.532979,96.322519,1,2
0,0,9,9,11,15,26,34,33,67,0.000333,0.104976,10,3149.294611,174.960812,314.929461,96.657107,1,2
0,0,12,12,14,16,30,66,51,117,0.000333,0.191369,21,12056.23019,669.790566,574.1062,117.302969,1,2
0,0,12,12,14,15,29,56,42,98,0.000333,0.158694,14,6665.149925,370.286107,476.082138,111.906328,1,2
0,0,12,12,13,16,29,59,44,103,0.000333,0.166791,12,6004.46451,333.581362,500.372042,112.105716,1,2
0,0,5,5,10,9,19,22,18,40,0.000333,0.056639,10,1699.171005,94.398389,169.917101,61.748606,1,2
0,0,6,6,11,9,20,25,19,44,0.000333,0.063388,10,1901.648362,105.647131,190.164836,66.583073,2,2
0,0,6,6,11,10,21,25,20,45,0.000333,0.065885,10,1976.54284,109.807936,197.654284,71.273029,2,2
0,0,6,6,11,10,21,25,19,44,0.000333,0.064421,5,966.309833,53.68388,193.261967,71.273029,2,2
0,0,6,6,11,10,21,25,19,44,0.000333,0.064421,5,966.309833,53.68388,193.261967,71.273029,2,2
0,0,6,6,11,11,22,25,20,45,0.000333,0.066891,5,1003.372114,55.742895,200.674423,76.107496,2,2
0,0,6,6,11,11,22,25,20,45,0.000333,0.066891,5,1003.372114,55.742895,200.674423,76.107496,2,2
0,0,6,6,11,10,21,25,19,44,0.000333,0.064421,5,966.309833,53.68388,193.261967,71.273029,2,2
0,0,6,6,11,10,21,25,19,44,0.000333,0.064421,5,966.309833,53.68388,193.261967,71.273029,2,2
0,0,6,6,11,10,21,25,19,44,0.000333,0.064421,5,966.309833,53.68388,193.261967,71.273029,2,2
0,0,6,6,11,10,21,25,19,44,0.000333,0.064421,5,966.309833,53.68388,193.261967,71.273029,2,2
0,0,8,8,12,10,22,32,23,55,0.000333,0.081756,12,2943.224868,163.512493,245.268739,76.238831,2,2
0,0,6,6,11,11,22,25,20,45,0.000333,0.066891,5,1003.372114,55.742895,200.674423,76.107496,2,2
0,0,6,6,11,11,22,25,20,45,0.000333,0.066891,5,1003.372114,55.742895,200.674423,76.107496,2,2
0,0,7,7,13,10,23,27,20,47,0.000333,0.070869,12,2551.288943,141.738275,212.607412,81.324997,2,2
0,0,6,6,11,9,20,25,19,44,0.000333,0.063388,10,1901.648362,105.647131,190.164836,66.583073,2,2
0,0,6,6,13,11,24,30,23,53,0.000333,0.081001,12,2916.03615,162.002008,243.003013,86.159464,2,2
0,0,7,7,12,9,21,25,20,45,0.000333,0.065885,12,2371.851408,131.769523,197.654284,71.548875,1,2
0,0,10,10,13,11,24,38,29,67,0.000333,0.102397,12,3686.309851,204.794992,307.192488,86.159464,2,2
0,0,10,10,12,11,23,37,29,66,0.000333,0.099518,12,3582.661069,199.036726,298.555089,81.073298,2,2
0,0,7,7,10,10,20,28,24,52,0.000333,0.074913,10,2247.402609,124.855701,224.740261,66.438562,1,2
0,0,10,10,11,11,22,43,32,75,0.000333,0.111486,10,3344.573714,185.809651,334.457371,76.107496,1,2
0,0,7,7,11,10,21,29,24,53,0.000333,0.077598,10,2327.928234,129.329346,232.792823,71.273029,1,2
0,0,8,8,11,13,24,30,27,57,0.000333,0.087114,10,2613.428625,145.190479,261.342863,86.159464,1,2
0,0,7,7,10,11,21,28,24,52,0.000333,0.076134,10,2284.00506,126.88917,228.400506,71.273029,1,2
0,0,8,8,12,10,22,33,26,59,0.000333,0.087702,12,3157.277586,175.40431,263.106465,76.238831,1,2
0,0,7,7,11,11,22,29,24,53,0.000333,0.078783,10,2363.498758,131.305487,236.349876,76.107496,1,2
0,0,8,8,11,12,23,37,28,65,0.000333,0.098011,10,2940.315271,163.350848,294.031527,81.073298,1,2
0,0,9,9,11,12,23,29,26,55,0.000333,0.082932,10,2487.959076,138.219949,248.795908,81.073298,1,2
0,0,7,7,10,11,21,28,24,52,0.000333,0.076134,10,2284.00506,126.88917,228.400506,71.273029,1,2
0,0,9,9,10,12,22,34,30,64,0.000333,0.095135,10,2854.036236,158.557569,285.403624,76.238831,1,2
0,0,11,11,10,13,23,40,36,76,0.000333,0.114597,10,3437.907087,190.994838,343.790709,81.324997,1,2
0,0,13,13,10,14,24,46,42,88,0.000333,0.134492,15,6052.150501,336.230583,403.4767,86.52225,1,2
0,0,8,8,11,10,21,32,26,58,0.000333,0.084918,10,2547.544105,141.530228,254.754411,71.273029,1,2
0,0,7,7,11,11,22,29,24,53,0.000333,0.078783,10,2363.498758,131.305487,236.349876,76.107496,1,2
0,0,8,8,11,12,23,34,27,61,0.000333,0.091979,10,2759.372793,153.298489,275.937279,81.073298,1,2
0,0,9,9,11,13,24,43,31,74,0.000333,0.113096,10,3392.872251,188.492903,339.287225,86.159464,1,2
0,0,8,8,10,12,22,36,28,64,0.000333,0.095135,10,2854.036236,158.557569,285.403624,76.238831,1,2
0,0,10,10,10,14,24,43,34,77,0.000333,0.117681,10,3530.421126,196.134507,353.042113,86.52225,1,2
0,0,10,10,11,14,25,35,33,68,0.000333,0.105261,10,3157.822209,175.434567,315.782221,91.356717,1,2
0,0,9,9,10,15,25,28,32,60,0.000333,0.092877,10,2786.313714,154.795206,278.631371,91.82264,1,2
0,0,11,11,13,16,29,56,47,103,0.000333,0.166791,12,6004.46451,333.581362,500.372042,112.105716,1,2
0,0,12,12,13,15,28,50,41,91,0.000333,0.145823,12,5249.631575,291.646199,437.469298,106.709075,1,2
0,0,12,12,12,16,28,53,43,96,0.000333,0.153835,12,5538.07287,307.670715,461.506073,107.01955,1,2
0,0,10,10,13,10,23,46,31,77,0.000333,0.116105,18,6269.656871,348.314271,348.314271,81.324997,2,2
0,0,11,11,14,10,24,49,32,81,0.000333,0.123794,21,7799.021214,433.278956,371.381963,86.52225,3,2
0,0,11,11,14,11,25,50,33,83,0.000333,0.12848,21,8094.241339,449.680074,385.440064,91.356717,3,2
0,0,11,11,14,11,25,49,32,81,0.000333,0.125384,14,5266.132919,292.56294,376.152351,91.356717,3,2
0,0,11,11,14,11,25,49,32,81,0.000333,0.125384,14,5266.132919,292.56294,376.152351,91.356717,3,2
0,0,11,11,14,12,26,49,33,82,0.000333,0.128479,14,5396.104796,299.7836,385.436057,96.322519,3,2
0,0,11,11,14,12,26,50,33,83,0.000333,0.130045,14,5461.910952,303.439497,390.136497,96.322519,3,2
0,0,11,11,14,11,25,49,32,81,0.000333,0.125384,14,5266.132919,292.56294,376.152351,91.356717,3,2
0,0,11,11,14,11,25,49,32,81,0.000333,0.125384,14,5266.132919,292.56294,376.152351,91.356717,3,2
0,0,11,11,14,11,25,49,32,81,0.000333,0.125384,14,5266.132919,292.56294,376.152351,91.356717,3,2
0,0,11,11,14,11,25,49,32,81,0.000333,0.125384,14,5266.132919,292.56294,376.152351,91.356717,3,2
0,0,14,14,15,11,26,59,37,96,0.000333,0.150414,21,9476.086472,526.449248,451.242213,96.657107,3,2
0,0,11,11,14,12,26,49,33,82,0.000333,0.128479,14,5396.104796,299.7836,385.436057,96.322519,3,2
0,0,11,11,14,12,26,49,33,82,0.000333,0.128479,14,5396.104796,299.7836,385.436057,96.322519,3,2
0,0,12,12,16,11,27,51,33,84,0.000333,0.133137,24,9585.853204,532.5474,399.41055,102.053748,3,2
0,0,11,11,14,10,24,49,32,81,0.000333,0.123794,21,7799.021214,433.278956,371.381963,86.52225,3,2
0,0,11,11,13,10,23,54,36,90,0.000333,0.135707,18,7328.170369,407.120576,407.120576,81.324997,3,2
0,0,12,12,15,10,25,49,33,82,0.000333,0.126932,21,7996.720359,444.262242,380.796208,91.82264,2,2
0,0,15,15,16,12,28,62,42,104,0.000333,0.166655,24,11999.15789,666.619883,499.964912,107.01955,3,2
0,0,15,15,15,12,27,61,42,103,0.000333,0.163251,21,10284.82167,571.378982,489.753413,101.622909,3,2
0,0,12,12,13,11,24,52,37,89,0.000333,0.136021,18,7345.109926,408.061663,408.061663,86.159464,2,2
0,0,15,15,14,12,26,67,45,112,0.000333,0.175483,21,11055.43422,614.19079,526.449248,96.322519,2,2
0,0,12,12,14,11,25,53,37,90,0.000333,0.139316,21,8776.888199,487.6049,417.947057,91.356717,2,2
0,0,13,13,14,14,28,54,40,94,0.000333,0.15063,14,6326.479077,351.47106,451.891363,106.605938,2,2
0,0,12,12,13,12,25,52,37,89,0.000333,0.137768,18,7439.457616,413.303201,413.303201,91.125266,2,2
0,0,13,13,15,11,26,57,39,96,0.000333,0.150414,21,9476.086472,526.449248,451.242213,96.657107,2,2
0,0,12,12,14,12,26,53,37,90,0.000333,0.141013,21,8883.831067,493.54617,423.039575,96.322519,2,2
0,0,13,13,14,13,27,61,41,102,0.000333,0.161666,21,10184.96903,565.831613,484.998525,101.408685,2,2
0,0,14,14,14,13,27,53,39,92,0.000333,0.145817,21,9186.442654,510.357925,437.44965,101.408685,2,2
0,0,12,12,13,12,25,52,37,89,0.000333,0.137768,18,7439.457616,413.303201,413.303201,91.125266,2,2
0,0,14,14,13,14,27,58,43,101,0.000333,0.160081,18,8644.385479,480.243638,480.243638,101.408685,2,2
0,0,16,16,13,15,28,64,49,113,0.000333,0.181077,18,9778.159911,543.231106,543.231106,106.709075,2,2
0,0,18,18,13,16,29,70,55,125,0.000333,0.202416,18,10930.45724,607.247624,607.247624,112.105716,2,2
0,0,13,13,14,11,25,56,39,95,0.000333,0.147055,21,9264.493099,514.694061,441.166338,91.356717,2,2
0,0,12,12,14,12,26,53,37,90,0.000333,0.141013,21,8883.831067,493.54617,423.039575,96.322519,2,2
0,0,13,13,14,13,27,58,40,98,0.000333,0.155326,21,9785.558479,543.642138,465.978975,101.408685,2,2
0,0,14,14,14,14,28,67,44,111,0.000333,0.177872,21,11205.94432,622.552462,533.616396,106.605938,2,2
0,0,13,13,13,13,26,60,41,101,0.000333,0.158248,18,8545.399408,474.744412,474.744412,96.211433,2,2
0,0,15,15,13,15,28,67,47,114,0.000333,0.182679,18,9864.6923,548.038461,548.038461,106.709075,2,2
0,0,15,15,14,15,29,59,46,105,0.000333,0.170029,21,10711.84809,595.102672,510.088004,111.906328,2,2
0,0,14,14,13,16,29,52,45,97,0.000333,0.157075,12,5654.689878,314.149438,471.224157,112.105716,2,2
0,0,17,17,15,17,32,84,63,147,0.000333,0.245,21,15435,857.5,735,128.090227,2,2
0,0,17,17,15,16,31,74,54,128,0.000333,0.211379,21,13316.87968,739.826649,634.137128,122.603359,2,2
0,0,17,17,14,16,30,77,56,133,0.000333,0.217539,21,13704.94543,761.385857,652.616449,117.302969,2,2
0,0,8,8,11,10,21,36,24,60,0.000333,0.087846,10,2635.390454,146.410581,263.539045,71.273029,1,2
0,0,9,9,12,10,22,39,25,64,0.000333,0.095135,12,3424.843483,190.269082,285.403624,76.238831,2,2
0,0,9,9,12,11,23,39,26,65,0.000333,0.098011,12,3528.378326,196.021018,294.031527,81.073298,2,2
0,0,9,9,12,11,23,39,25,64,0.000333,0.096503,12,3474.095582,193.00531,289.507965,81.073298,2,2
0,0,9,9,12,11,23,39,25,64,0.000333,0.096503,12,3474.095582,193.00531,289.507965,81.073298,2,2
0,0,9,9,12,12,24,39,26,65,0.000333,0.099341,12,3576.270751,198.681708,298.022563,86.0391,2,2
0,0,9,9,12,12,24,39,26,65,0.000333,0.099341,12,3576.270751,198.681708,298.022563,86.0391,2,2
0,0,9,9,12,11,23,39,25,64,0.000333,0.096503,12,3474.095582,193.00531,289.507965,81.073298,2,2
0,0,9,9,12,11,23,39,25,64,0.000333,0.096503,12,3474.095582,193.00531,289.507965,81.073298,2,2
0,0,9,9,12,11,23,39,25,64,0.000333,0.096503,12,3474.095582,193.00531,289.507965,81.073298,2,2
0,0,9,9,12,11,23,39,25,64,0.000333,0.096503,12,3474.095582,193.00531,289.507965,81.073298,2,2
0,0,12,12,13,11,24,49,30,79,0.000333,0.120737,12,4346.544451,241.474692,362.212038,86.159464,2,2
0,0,9,9,12,12,24,39,26,65,0.000333,0.099341,12,3576.270751,198.681708,298.022563,86.0391,2,2
0,0,9,9,12,12,24,39,26,65,0.000333,0.099341,12,3576.270751,198.681708,298.022563,86.0391,2,2
0,0,10,10,14,11,25,41,26,67,0.000333,0.103713,14,4355.937106,241.996506,311.138365,91.356717,2,2
0,0,9,9,12,10,22,39,25,64,0.000333,0.095135,12,3424.843483,190.269082,285.403624,76.238831,2,2
0,0,9,9,14,11,25,44,29,73,0.000333,0.113001,14,4746.021026,263.667835,339.001502,91.356717,2,2
0,0,10,10,13,10,23,39,26,65,0.000333,0.098011,12,3528.378326,196.021018,294.031527,81.324997,1,2
0,0,13,13,14,12,26,52,35,87,0.000333,0.136313,14,5725.135577,318.063088,408.938255,96.322519,2,2
0,0,13,13,13,12,25,51,35,86,0.000333,0.133124,12,4792.459588,266.247755,399.371632,91.125266,2,2
0,0,10,10,11,11,22,42,30,72,0.000333,0.107026,10,3210.790765,178.377265,321.079077,76.107496,1,2
0,0,13,13,12,12,24,57,38,95,0.000333,0.14519,18,7840.285876,435.571438,435.571438,86.0391,1,2
0,0,10,10,12,11,23,43,30,73,0.000333,0.110073,12,3962.640274,220.146682,330.220023,81.073298,1,2
0,0,11,11,12,14,26,44,33,77,0.000333,0.120645,12,4343.2063,241.289239,361.933858,96.322519,1,2
0,0,10,10,11,12,23,42,30,72,0.000333,0.108565,10,3256.964608,180.942478,325.696461,81.073298,1,2
0,0,11,11,13,11,24,47,32,79,0.000333,0.120737,12,4346.544451,241.474692,362.212038,86.159464,1,2
0,0,10,10,12,12,24,43,30,73,0.000333,0.111567,12,4016.427151,223.134842,334.702263,86.0391,1,2
0,0,11,11,12,13,25,51,34,85,0.000333,0.131576,12,4736.733314,263.151851,394.727776,91.125266,1,2
0,0,12,12,12,13,25,43,32,75,0.000333,0.116096,12,4179.470571,232.192809,348.289214,91.125266,1,2
0,0,10,10,11,12,23,42,30,72,0.000333,0.108565,10,3256.964608,180.942478,325.696461,81.073298,1,2
0,0,12,12,11,13,24,48,36,84,0.000333,0.128379,10,3851.368501,213.964917,385.13685,86.159464,1,2
0,0,14,14,11,14,25,54,42,96,0.000333,0.148603,15,6687.152913,371.508495,445.810194,91.356717,1,2
0,0,16,16,11,15,26,60,48,108,0.000333,0.169216,15,7614.712343,423.039575,507.64749,96.657107,1,2
0,0,11,11,12,11,23,46,32,78,0.000333,0.117613,12,4234.053991,235.225222,352.837833,81.073298,1,2
0,0,10,10,12,12,24,43,30,73,0.000333,0.111567,12,4016.427151,223.134842,334.702263,86.0391,1,2
0,0,11,11,12,13,25,48,33,81,0.000333,0.125384,12,4513.828216,250.768234,376.152351,91.125266,1,2
0,0,12,12,12,14,26,57,37,94,0.000333,0.14728,12,5302.096002,294.560889,441.841334,96.322519,1,2
0,0,11,11,11,13,24,50,34,84,0.000333,0.128379,10,3851.368501,213.964917,385.13685,86.159464,1,2
0,0,13,13,11,15,26,57,40,97,0.000333,0.151981,10,4559.426527,253.301474,455.942653,96.657107,1,2
0,0,13,13,12,15,27,49,39,88,0.000333,0.139477,12,5021.161202,278.9534,418.4301,101.622909,1,2
0,0,12,12,11,16,27,42,38,80,0.000333,0.126797,10,3803.910002,211.328333,380.391,102.053748,1,2
0,0,15,15,14,17,31,74,56,130,0.000333,0.214682,21,13524.95593,751.38644,644.04552,122.789837,1,2
0,0,15,15,14,16,30,64,47,111,0.000333,0.181555,14,7625.307986,423.628221,544.664856,117.302969,1,2
0,0,15,15,13,16,29,67,49,116,0.000333,0.187842,18,10143.46432,563.525795,563.525795,112.105716,1,2
0,0,8,8,11,10,21,36,24,60,0.000333,0.087846,10,2635.390454,146.410581,263.539045,71.273029,1,2
0,0,9,9,12,10,22,39,25,64,0.000333,0.095135,12,3424.843483,190.269082,285.403624,76.238831,2,2
0,0,9,9,12,11,23,39,26,65,0.000333,0.098011,12,3528.378326,196.021018,294.031527,81.073298,2,2
0,0,9,9,12,11,23,39,25,64,0.000333,0.096503,12,3474.095582,193.00531,289.507965,81.073298,2,2
0,0,9,9,12,11,23,39,25,64,0.000333,0.096503,12,3474.095582,193.00531,289.507965,81.073298,2,2
0,0,9,9,12,12,24,39,26,65,0.000333,0.099341,12,3576.270751,198.681708,298.022563,86.0391,2,2
0,0,9,9,12,12,24,39,26,65,0.000333,0.099341,12,3576.270751,198.681708,298.022563,86.0391,2,2
0,0,9,9,12,11,23,39,25,64,0.000333,0.096503,12,3474.095582,193.00531,289.507965,81.073298,2,2
0,0,9,9,12,11,23,39,25,64,0.000333,0.096503,12,3474.095582,193.00531,289.507965,81.073298,2,2
0,0,9,9,12,11,23,39,25,64,0.000333,0.096503,12,3474.095582,193.00531,289.507965,81.073298,2,2
0,0,9,9,12,11,23,39,25,64,0.000333,0.096503,12,3474.095582,193.00531,289.507965,81.073298,2,2
0,0,12,12,13,11,24,49,30,79,0.000333,0.120737,12,4346.544451,241.474692,362.212038,86.159464,2,2
0,0,9,9,12,12,24,39,26,65,0.000333,0.099341,12,3576.270751,198.681708,298.022563,86.0391,2,2
0,0,9,9,12,12,24,39,26,65,0.000333,0.099341,12,3576.270751,198.681708,298.022563,86.0391,2,2
0,0,10,10,14,11,25,41,26,67,0.000333,0.103713,14,4355.937106,241.996506,311.138365,91.356717,2,2
0,0,9,9,12,10,22,39,25,64,0.000333,0.095135,12,3424.843483,190.269082,285.403624,76.238831,2,2
0,0,9,9,14,11,25,44,29,73,0.000333,0.113001,14,4746.021026,263.667835,339.001502,91.356717,2,2
0,0,10,10,13,10,23,39,26,65,0.000333,0.098011,12,3528.378326,196.021018,294.031527,81.324997,1,2
0,0,13,13,14,12,26,52,35,87,0.000333,0.136313,14,5725.135577,318.063088,408.938255,96.322519,2,2
0,0,13,13,13,12,25,51,35,86,0.000333,0.133124,12,4792.459588,266.247755,399.371632,91.125266,2,2
0,0,10,10,11,11,22,42,30,72,0.000333,0.107026,10,3210.790765,178.377265,321.079077,76.107496,1,2
0,0,13,13,12,12,24,57,38,95,0.000333,0.14519,18,7840.285876,435.571438,435.571438,86.0391,1,2
0,0,10,10,12,11,23,43,30,73,0.000333,0.110073,12,3962.640274,220.146682,330.220023,81.073298,1,2
0,0,11,11,12,14,26,44,33,77,0.000333,0.120645,12,4343.2063,241.289239,361.933858,96.322519,1,2
0,0,10,10,11,12,23,42,30,72,0.000333,0.108565,10,3256.964608,180.942478,325.696461,81.073298,1,2
0,0,11,11,13,11,24,47,32,79,0.000333,0.120737,12,4346.544451,241.474692,362.212038,86.159464,1,2
0,0,10,10,12,12,24,43,30,73,0.000333,0.111567,12,4016.427151,223.134842,334.702263,86.0391,1,2
0,0,11,11,12,13,25,51,34,85,0.000333,0.131576,12,4736.733314,263.151851,394.727776,91.125266,1,2
0,0,12,12,12,13,25,43,32,75,0.000333,0.116096,12,4179.470571,232.192809,348.289214,91.125266,1,2
0,0,10,10,11,12,23,42,30,72,0.000333,0.108565,10,3256.964608,180.942478,325.696461,81.073298,1,2
0,0,12,12,11,13,24,48,36,84,0.000333,0.128379,10,3851.368501,213.964917,385.13685,86.159464,1,2
0,0,14,14,11,14,25,54,42,96,0.000333,0.148603,15,6687.152913,371.508495,445.810194,91.356717,1,2
0,0,16,16,11,15,26,60,48,108,0.000333,0.169216,15,7614.712343,423.039575,507.64749,96.657107,1,2
0,0,11,11,12,11,23,46,32,78,0.000333,0.117613,12,4234.053991,235.225222,352.837833,81.073298,1,2
0,0,10,10,12,12,24,43,30,73,0.000333,0.111567,12,4016.427151,223.134842,334.702263,86.0391,1,2
0,0,11,11,12,13,25,48,33,81,0.000333,0.125384,12,4513.828216,250.768234,376.152351,91.125266,1,2
0,0,12,12,12,14,26,57,37,94,0.000333,0.14728,12,5302.096002,294.560889,441.841334,96.322519,1,2
0,0,11,11,11,13,24,50,34,84,0.000333,0.128379,10,3851.368501,213.964917,385.13685,86.159464,1,2
0,0,13,13,11,15,26,57,40,97,0.000333,0.151981,10,4559.426527,253.301474,455.942653,96.657107,1,2
0,0,13,13,12,15,27,49,39,88,0.000333,0.139477,12,5021.161202,278.9534,418.4301,101.622909,1,2
0,0,12,12,11,16,27,42,38,80,0.000333,0.126797,10,3803.910002,211.328333,380.391,102.053748,1,2
0,0,15,15,14,17,31,74,56,130,0.000333,0.214682,21,13524.95593,751.38644,644.04552,122.789837,1,2
0,0,15,15,14,16,30,64,47,111,0.000333,0.181555,14,7625.307986,423.628221,544.664856,117.302969,1,2
0,0,15,15,13,16,29,67,49,116,0.000333,0.187842,18,10143.46432,563.525795,563.525795,112.105716,1,2
0,0,8,8,10,10,20,32,23,55,0.000333,0.079235,10,2377.060452,132.058914,237.706045,66.438562,1,2
0,0,9,9,11,10,21,35,24,59,0.000333,0.086382,10,2591.467279,143.970404,259.146728,71.273029,2,2
0,0,9,9,11,11,22,35,25,60,0.000333,0.089189,10,2675.658971,148.647721,267.565897,76.107496,2,2
0,0,9,9,11,11,22,35,24,59,0.000333,0.087702,10,2631.064655,146.170259,263.106465,76.107496,2,2
0,0,9,9,11,11,22,35,24,59,0.000333,0.087702,10,2631.064655,146.170259,263.106465,76.107496,2,2
0,0,9,9,11,12,23,35,25,60,0.000333,0.090471,10,2714.137174,150.785399,271.413717,81.073298,2,2
0,0,9,9,11,12,23,35,25,60,0.000333,0.090471,10,2714.137174,150.785399,271.413717,81.073298,2,2
0,0,9,9,11,11,22,35,24,59,0.000333,0.087702,10,2631.064655,146.170259,263.106465,76.107496,2,2
0,0,9,9,11,11,22,35,24,59,0.000333,0.087702,10,2631.064655,146.170259,263.106465,76.107496,2,2
0,0,9,9,11,11,22,35,24,59,0.000333,0.087702,10,2631.064655,146.170259,263.106465,76.107496,2,2
0,0,9,9,11,11,22,35,24,59,0.000333,0.087702,10,2631.064655,146.170259,263.106465,76.107496,2,2
0,0,12,12,12,11,23,45,29,74,0.000333,0.111581,12,4016.923017,223.16239,334.743585,81.073298,2,2
0,0,9,9,11,12,23,35,25,60,0.000333,0.090471,10,2714.137174,150.785399,271.413717,81.073298,2,2
0,0,9,9,11,12,23,35,25,60,0.000333,0.090471,10,2714.137174,150.785399,271.413717,81.073298,2,2
0,0,10,10,13,11,24,37,25,62,0.000333,0.094756,12,3411.212101,189.511783,284.267675,86.159464,2,2
0,0,9,9,11,10,21,35,24,59,0.000333,0.086382,10,2591.467279,143.970404,259.146728,71.273029,2,2
0,0,9,9,13,11,24,40,28,68,0.000333,0.103926,12,3741.329401,207.851633,311.77745,86.159464,2,2
0,0,10,10,12,10,22,35,25,60,0.000333,0.089189,12,3210.790765,178.377265,267.565897,76.238831,1,2
0,0,13,13,13,12,25,48,34,82,0.000333,0.126932,12,4569.554491,253.864138,380.796208,91.125266,2,2
0,0,13,13,12,12,24,47,34,81,0.000333,0.123794,12,4456.583551,247.587975,371.381963,86.0391,2,2
0,0,10,10,10,11,21,38,29,67,0.000333,0.098095,10,2942.852673,163.491815,294.285267,71.273029,1,2
0,0,13,13,11,12,23,53,37,90,0.000333,0.135707,15,6106.808641,339.267147,407.120576,81.073298,1,2
0,0,10,10,11,11,22,39,29,68,0.000333,0.10108,10,3032.413501,168.467417,303.24135,76.107496,1,2
0,0,11,11,11,14,25,40,32,72,0.000333,0.111453,10,3343.576457,185.754248,334.357646,91.356717,1,2
0,0,10,10,10,12,22,37,29,66,0.000333,0.098107,10,2943.224868,163.512493,294.322487,76.238831,1,2
0,0,11,11,12,11,23,42,31,73,0.000333,0.110073,12,3962.640274,220.146682,330.220023,81.073298,1,2
0,0,10,10,11,12,23,38,29,67,0.000333,0.101026,10,3030.786511,168.377028,303.078651,81.073298,1,2
0,0,11,11,11,13,24,47,33,80,0.000333,0.122266,10,3667.970001,203.776111,366.797,86.159464,1,2
0,0,12,12,11,13,24,39,31,70,0.000333,0.106982,10,3209.473751,178.304097,320.947375,86.159464,1,2
0,0,10,10,10,12,22,38,29,67,0.000333,0.099594,10,2987.819184,165.989955,298.781918,76.238831,1,2
0,0,12,12,10,13,23,44,35,79,0.000333,0.11912,10,3573.613945,198.534108,357.361395,81.324997,1,2
0,0,14,14,10,14,24,50,41,91,0.000333,0.139077,10,4172.315876,231.795326,417.231588,86.52225,1,2
0,0,16,16,10,15,25,56,47,103,0.000333,0.159439,15,7174.757813,398.597656,478.317188,91.82264,1,2
0,0,11,11,11,11,22,42,31,73,0.000333,0.108513,10,3255.385082,180.854727,325.538508,76.107496,1,2
0,0,10,10,11,12,23,39,29,68,0.000333,0.102534,10,3076.02213,170.890118,307.602213,81.073298,1,2
0,0,11,11,11,13,24,44,32,76,0.000333,0.116152,10,3484.571501,193.587306,348.45715,86.159464,1,2
0,0,12,12,11,14,25,53,36,89,0.000333,0.137768,10,4133.032009,229.612889,413.303201,91.356717,1,2
0,0,11,11,10,13,23,46,33,79,0.000333,0.11912,10,3573.613945,198.534108,357.361395,81.324997,1,2
0,0,13,13,10,15,25,53,39,92,0.000333,0.142412,10,4272.347695,237.35265,427.234769,91.82264,1,2
0,0,13,13,11,15,26,45,38,83,0.000333,0.130045,10,3901.364966,216.742498,390.136497,96.657107,1,2
0,0,12,12,10,16,26,38,37,75,0.000333,0.117511,10,3525.329789,195.851655,352.532979,97.219281,1,2
0,0,15,15,13,17,30,70,55,125,0.000333,0.204454,18,11040.50384,613.361324,613.361324,117.592585,1,2
0,0,15,15,13,16,29,60,46,106,0.000333,0.171649,12,6179.351826,343.297324,514.945985,112.105716,1,2
0,0,15,15,12,16,28,63,48,111,0.000333,0.177872,18,9605.095134,533.616396,533.616396,107.01955,1,2
0,0,8,8,10,10,20,33,24,57,0.000333,0.082117,10,2463.499014,136.861056,246.349901,66.438562,1,2
0,0,9,9,11,10,21,36,25,61,0.000333,0.08931,10,2679.313628,148.850757,267.931363,71.273029,2,2
0,0,9,9,11,11,22,36,26,62,0.000333,0.092162,10,2764.847604,153.602645,276.48476,76.107496,2,2
0,0,9,9,11,11,22,36,25,61,0.000333,0.090675,10,2720.253287,151.125183,272.025329,76.107496,2,2
0,0,9,9,11,11,22,36,25,61,0.000333,0.090675,10,2720.253287,151.125183,272.025329,76.107496,2,2
0,0,9,9,11,12,23,36,26,62,0.000333,0.093487,10,2804.608413,155.811578,280.460841,81.073298,2,2
0,0,9,9,11,12,23,37,26,63,0.000333,0.094995,10,2849.844032,158.324668,284.984403,81.073298,2,2
0,0,9,9,11,11,22,36,25,61,0.000333,0.090675,10,2720.253287,151.125183,272.025329,76.107496,2,2
0,0,9,9,11,11,22,36,25,61,0.000333,0.090675,10,2720.253287,151.125183,272.025329,76.107496,2,2
0,0,9,9,11,11,22,36,25,61,0.000333,0.090675,10,2720.253287,151.125183,272.025329,76.107496,2,2
0,0,9,9,11,11,22,36,25,61,0.000333,0.090675,10,2720.253287,151.125183,272.025329,76.107496,2,2
0,0,12,12,12,11,23,46,30,76,0.000333,0.114597,12,4125.488504,229.193806,343.790709,81.073298,2,2
0,0,9,9,11,12,23,36,26,62,0.000333,0.093487,10,2804.608413,155.811578,280.460841,81.073298,2,2
0,0,9,9,11,12,23,36,26,62,0.000333,0.093487,10,2804.608413,155.811578,280.460841,81.073298,2,2
0,0,10,10,13,11,24,38,26,64,0.000333,0.097813,12,3521.251201,195.625067,293.4376,86.159464,2,2
0,0,9,9,11,10,21,36,25,61,0.000333,0.08931,10,2679.313628,148.850757,267.931363,71.273029,2,2
0,0,9,9,13,11,24,41,29,70,0.000333,0.106982,12,3851.368501,213.964917,320.947375,86.159464,2,2
0,0,10,10,12,10,22,36,26,62,0.000333,0.092162,12,3317.817124,184.323174,276.48476,76.238831,1,2
0,0,13,13,13,12,25,49,35,84,0.000333,0.130028,12,4681.007039,260.055947,390.08392,91.125266,2,2
0,0,13,13,12,12,24,48,35,83,0.000333,0.126851,12,4566.622651,253.701258,380.551888,86.0391,2,2
0,0,10,10,10,11,21,39,30,69,0.000333,0.101023,10,3030.699022,168.372168,303.069902,71.273029,1,2
0,0,13,13,11,12,23,54,38,92,0.000333,0.138723,15,6242.515499,346.806417,416.1677,81.073298,1,2
0,0,10,10,11,11,22,40,30,70,0.000333,0.104053,10,3121.602133,173.422341,312.160213,76.107496,1,2
0,0,11,11,11,14,25,41,33,74,0.000333,0.114548,10,3436.45358,190.914088,343.645358,91.356717,1,2
0,0,10,10,10,12,22,39,30,69,0.000333,0.102567,10,3077.007817,170.944879,307.700782,76.238831,1,2
0,0,11,11,12,11,23,44,32,76,0.000333,0.114597,12,4125.488504,229.193806,343.790709,81.073298,1,2
0,0,10,10,11,12,23,40,30,70,0.000333,0.10555,10,3166.493369,175.916298,316.649337,81.073298,1,2
0,0,11,11,11,13,24,48,34,82,0.000333,0.125322,10,3759.669251,208.870514,375.966925,86.159464,1,2
0,0,12,12,11,13,24,40,32,72,0.000333,0.110039,10,3301.173001,183.3985,330.1173,86.159464,1,2
0,0,10,10,10,12,22,39,30,69,0.000333,0.102567,10,3077.007817,170.944879,307.700782,76.238831,1,2
0,0,12,12,10,13,23,45,36,81,0.000333,0.122136,10,3664.085184,203.560288,366.408518,81.324997,1,2
0,0,14,14,10,14,24,51,42,93,0.000333,0.142134,15,6396.022689,355.334594,426.401513,86.52225,1,2
0,0,16,16,10,15,25,57,48,105,0.000333,0.162535,15,7314.073499,406.337417,487.6049,91.82264,1,2
0,0,11,11,11,11,22,43,32,75,0.000333,0.111486,10,3344.573714,185.809651,334.457371,76.107496,1,2
0,0,10,10,11,12,23,40,30,70,0.000333,0.10555,10,3166.493369,175.916298,316.649337,81.073298,1,2
0,0,11,11,11,13,24,45,33,78,0.000333,0.119209,10,3576.270751,198.681708,357.627075,86.159464,1,2
0,0,12,12,11,14,25,54,37,91,0.000333,0.140864,10,4225.909133,234.77273,422.590913,91.356717,1,2
0,0,11,11,10,13,23,47,34,81,0.000333,0.122136,10,3664.085184,203.560288,366.408518,81.324997,1,2
0,0,13,13,10,15,25,54,40,94,0.000333,0.145507,10,4365.224818,242.51249,436.522482,91.82264,1,2
0,0,13,13,11,15,26,46,39,85,0.000333,0.133179,10,3995.37376,221.965209,399.537376,96.657107,1,2
0,0,12,12,10,16,26,39,38,77,0.000333,0.120645,10,3619.338583,201.074366,361.933858,97.219281,1,2
0,0,15,15,13,17,30,71,56,127,0.000333,0.207725,18,11217.1519,623.175106,623.175106,117.592585,1,2
0,0,15,15,13,16,29,61,47,108,0.000333,0.174887,12,6295.94337,349.774632,524.661947,112.105716,1,2
0,0,15,15,12,16,28,64,49,113,0.000333,0.181077,18,9778.159911,543.231106,543.231106,107.01955,1,2
0,0,8,8,11,10,21,34,23,57,0.000333,0.083454,10,2503.620931,139.090052,250.362093,71.273029,1,2
0,0,9,9,12,10,22,37,24,61,0.000333,0.090675,12,3264.303945,181.350219,272.025329,76.238831,2,2
0,0,9,9,12,11,23,37,25,62,0.000333,0.093487,12,3365.530095,186.973894,280.460841,81.073298,2,2
0,0,9,9,12,11,23,37,24,61,0.000333,0.091979,12,3311.247352,183.958186,275.937279,81.073298,2,2
0,0,9,9,12,11,23,37,24,61,0.000333,0.091979,12,3311.247352,183.958186,275.937279,81.073298,2,2
0,0,9,9,12,12,24,37,25,62,0.000333,0.094756,12,3411.212101,189.511783,284.267675,86.0391,2,2
0,0,9,9,12,12,24,37,25,62,0.000333,0.094756,12,3411.212101,189.511783,284.267675,86.0391,2,2
0,0,9,9,12,11,23,37,24,61,0.000333,0.091979,12,3311.247352,183.958186,275.937279,81.073298,2,2
0,0,9,9,12,11,23,37,24,61,0.000333,0.091979,12,3311.247352,183.958186,275.937279,81.073298,2,2
0,0,9,9,12,11,23,37,24,61,0.000333,0.091979,12,3311.247352,183.958186,275.937279,81.073298,2,2
0,0,9,9,12,11,23,37,24,61,0.000333,0.091979,12,3311.247352,183.958186,275.937279,81.073298,2,2
0,0,12,12,13,11,24,47,29,76,0.000333,0.116152,12,4181.485801,232.304767,348.45715,86.159464,2,2
0,0,9,9,12,12,24,37,25,62,0.000333,0.094756,12,3411.212101,189.511783,284.267675,86.0391,2,2
0,0,9,9,12,12,24,37,25,62,0.000333,0.094756,12,3411.212101,189.511783,284.267675,86.0391,2,2
0,0,10,10,14,11,25,39,25,64,0.000333,0.099069,14,4160.895146,231.160841,297.206796,91.356717,2,2
0,0,9,9,12,10,22,37,24,61,0.000333,0.090675,12,3264.303945,181.350219,272.025329,76.238831,2,2
0,0,9,9,14,11,25,42,28,70,0.000333,0.108357,14,4550.979066,252.83217,325.069933,91.356717,2,2
0,0,10,10,13,10,23,37,25,62,0.000333,0.093487,12,3365.530095,186.973894,280.460841,81.324997,1,2
0,0,13,13,14,12,26,50,34,84,0.000333,0.131612,14,5527.717109,307.095395,394.836936,96.322519,2,2
0,0,13,13,13,12,25,49,34,83,0.000333,0.12848,12,4625.280765,256.960043,385.440064,91.125266,2,2
0,0,10,10,11,11,22,40,29,69,0.000333,0.102567,10,3077.007817,170.944879,307.700782,76.107496,1,2
0,0,13,13,12,12,24,55,37,92,0.000333,0.140606,18,7592.697901,421.81655,421.81655,86.0391,1,2
0,0,10,10,12,11,23,41,29,70,0.000333,0.10555,12,3799.792043,211.099558,316.649337,81.073298,1,2
0,0,11,11,12,14,26,42,32,74,0.000333,0.115944,12,4173.99047,231.888359,347.832539,96.322519,1,2
0,0,10,10,11,12,23,40,29,69,0.000333,0.104042,10,3121.25775,173.403208,312.125775,81.073298,1,2
0,0,11,11,13,11,24,45,31,76,0.000333,0.116152,12,4181.485801,232.304767,348.45715,86.159464,1,2
0,0,10,10,12,12,24,41,29,70,0.000333,0.106982,12,3851.368501,213.964917,320.947375,86.0391,1,2
0,0,11,11,12,13,25,49,33,82,0.000333,0.126932,12,4569.554491,253.864138,380.796208,91.125266,1,2
0,0,12,12,12,13,25,41,31,72,0.000333,0.111453,12,4012.291748,222.905097,334.357646,91.125266,1,2
0,0,10,10,11,12,23,40,29,69,0.000333,0.104042,10,3121.25775,173.403208,312.125775,81.073298,1,2
0,0,12,12,11,13,24,46,35,81,0.000333,0.123794,10,3713.819626,206.323313,371.381963,86.159464,1,2
0,0,14,14,11,14,25,52,41,93,0.000333,0.14396,10,4318.786256,239.93257,431.878626,91.356717,1,2
0,0,16,16,11,15,26,58,47,105,0.000333,0.164515,15,7403.192556,411.288475,493.54617,96.657107,1,2
0,0,11,11,12,11,23,44,31,75,0.000333,0.113089,12,4071.20576,226.178098,339.267147,81.073298,1,2
0,0,10,10,12,12,24,41,29,70,0.000333,0.106982,12,3851.368501,213.964917,320.947375,86.0391,1,2
0,0,11,11,12,13,25,46,32,78,0.000333,0.12074,12,4346.649394,241.480522,362.220783,91.125266,1,2
0,0,12,12,12,14,26,55,36,91,0.000333,0.14258,12,5132.880172,285.16001,427.740014,96.322519,1,2
0,0,11,11,11,13,24,48,33,81,0.000333,0.123794,10,3713.819626,206.323313,371.381963,86.159464,1,2
0,0,13,13,11,15,26,55,39,94,0.000333,0.14728,10,4418.413335,245.467408,441.841334,96.657107,1,2
0,0,13,13,12,15,27,47,38,85,0.000333,0.134722,12,4849.985252,269.443625,404.165438,101.622909,1,2
0,0,12,12,11,16,27,40,37,77,0.000333,0.122042,10,3661.263377,203.403521,366.126338,102.053748,1,2
0,0,15,15,14,17,31,72,55,127,0.000333,0.209728,21,13212.84156,734.046753,629.182931,122.789837,1,2
0,0,15,15,14,16,30,62,46,108,0.000333,0.176648,14,7419.218581,412.17881,529.944184,117.302969,1,2
0,0,15,15,13,16,29,65,48,113,0.000333,0.182984,18,9881.133344,548.951852,548.951852,112.105716,1,2
0,0,8,8,14,11,25,39,28,67,0.000333,0.103713,14,4355.937106,241.996506,311.138365,91.356717,2,2
0,0,9,9,15,12,27,42,29,71,0.000333,0.112532,14,4726.358177,262.575454,337.597013,101.622909,3,2
0,0,9,9,15,12,27,42,30,72,0.000333,0.114117,14,4792.926602,266.2737,342.3519,101.622909,3,2
0,0,5,5,10,9,19,26,17,43,0.000333,0.060887,5,913.304415,50.739134,182.660883,61.748606,1,2
0,0,5,5,10,9,19,25,17,42,0.000333,0.059471,5,892.064778,49.559154,178.412956,61.748606,1,2
0,0,5,5,10,9,19,25,17,42,0.000333,0.059471,5,892.064778,49.559154,178.412956,61.748606,1,2
0,0,5,5,10,9,19,25,17,42,0.000333,0.059471,5,892.064778,49.559154,178.412956,61.748606,1,2
0,0,5,5,10,9,19,25,17,42,0.000333,0.059471,5,892.064778,49.559154,178.412956,61.748606,1,2
0,0,5,5,10,9,19,25,17,42,0.000333,0.059471,5,892.064778,49.559154,178.412956,61.748606,1,2
0,0,5,5,10,9,19,25,17,42,0.000333,0.059471,5,892.064778,49.559154,178.412956,61.748606,1,2
0,0,5,5,10,9,19,25,17,42,0.000333,0.059471,5,892.064778,49.559154,178.412956,61.748606,1,2
0,0,5,5,10,9,19,25,17,42,0.000333,0.059471,5,892.064778,49.559154,178.412956,61.748606,1,2
0,0,5,5,10,9,19,25,17,42,0.000333,0.059471,5,892.064778,49.559154,178.412956,61.748606,1,2
0,0,5,5,10,9,19,25,17,42,0.000333,0.059471,5,892.064778,49.559154,178.412956,61.748606,1,2
0,0,5,5,10,9,19,25,17,42,0.000333,0.059471,5,892.064778,49.559154,178.412956,61.748606,1,2
0,0,5,5,10,9,19,25,17,42,0.000333,0.059471,5,892.064778,49.559154,178.412956,61.748606,1,2
0,0,5,5,10,9,19,25,17,42,0.000333,0.059471,5,892.064778,49.559154,178.412956,61.748606,1,2
0,0,5,5,10,9,19,25,17,42,0.000333,0.059471,5,892.064778,49.559154,178.412956,61.748606,1,2
0,0,5,5,10,9,19,25,17,42,0.000333,0.059471,5,892.064778,49.559154,178.412956,61.748606,1,2
0,0,5,5,10,9,19,25,17,42,0.000333,0.059471,5,892.064778,49.559154,178.412956,61.748606,1,2
0,0,9,9,12,10,22,40,28,68,0.000333,0.10108,12,3638.896201,202.1609,303.24135,76.238831,1,2
0,0,9,9,11,13,24,39,37,76,0.000333,0.116152,10,3484.571501,193.587306,348.45715,86.159464,1,2
0,0,7,7,10,10,20,31,23,54,0.000333,0.077795,10,2333.841171,129.657843,233.384117,66.438562,1,2
0,0,10,10,11,11,22,46,31,77,0.000333,0.114459,10,3433.762346,190.764575,343.376235,76.107496,1,2
0,0,7,7,11,15,26,30,26,56,0.000333,0.087742,5,1316.123121,73.117951,263.224624,96.657107,1,2
0,0,7,7,10,14,24,31,29,60,0.000333,0.091699,10,2750.9775,152.832083,275.09775,86.52225,1,2
0,0,9,9,12,10,22,40,28,68,0.000333,0.10108,12,3638.896201,202.1609,303.24135,76.238831,1,2
0,0,8,8,11,12,23,40,27,67,0.000333,0.101026,10,3030.786511,168.377028,303.078651,81.073298,1,2
0,0,9,9,11,15,26,32,31,63,0.000333,0.098709,10,2961.277022,164.51539,296.127702,96.657107,1,2
0,0,7,7,10,14,24,31,29,60,0.000333,0.091699,10,2750.9775,152.832083,275.09775,86.52225,1,2
0,0,9,9,10,15,25,37,41,78,0.000333,0.12074,10,3622.207828,201.233768,362.220783,91.82264,1,2
0,0,11,11,10,16,26,43,53,96,0.000333,0.150414,15,6768.633194,376.035177,451.242213,97.219281,1,2
0,0,13,13,10,17,27,49,65,114,0.000333,0.180686,15,8130.857629,451.714313,542.057175,102.706149,1,2
0,0,9,9,11,13,24,39,37,76,0.000333,0.116152,10,3484.571501,193.587306,348.45715,86.159464,1,2
0,0,8,8,11,15,26,37,32,69,0.000333,0.10811,10,3243.303406,180.183523,324.330341,96.657107,1,2
0,0,9,9,11,16,27,46,36,82,0.000333,0.129967,10,3899.007752,216.611542,389.900775,102.053748,1,2
0,0,8,8,10,15,25,39,33,72,0.000333,0.111453,10,3343.576457,185.754248,334.357646,91.82264,1,2
0,0,10,10,10,17,27,46,39,85,0.000333,0.134722,10,4041.654377,224.536354,404.165438,102.706149,1,2
0,0,10,10,11,17,28,38,44,82,0.000333,0.131401,10,3942.031036,219.001724,394.203104,107.540616,1,2
0,0,9,9,10,15,25,31,37,68,0.000333,0.105261,10,3157.822209,175.434567,315.782221,91.82264,1,2
0,0,8,8,14,17,31,38,37,75,0.000333,0.123855,14,5201.906126,288.994785,371.564723,122.789837,1,2
0,0,8,8,13,17,30,37,37,74,0.000333,0.121037,12,4357.318849,242.073269,363.109904,117.592585,1,2
0,0,5,5,10,9,19,25,17,42,0.000333,0.059471,5,892.064778,49.559154,178.412956,61.748606,1,2
0,0,5,5,10,9,19,25,17,42,0.000333,0.059471,5,892.064778,49.559154,178.412956,61.748606,1,2
0,0,5,5,10,9,19,25,17,42,0.000333,0.059471,5,892.064778,49.559154,178.412956,61.748606,1,2
0,0,5,5,10,9,19,25,17,42,0.000333,0.059471,5,892.064778,49.559154,178.412956,61.748606,1,2
0,0,5,5,10,9,19,25,17,42,0.000333,0.059471,5,892.064778,49.559154,178.412956,61.748606,1,2
0,0,5,5,10,9,19,25,17,42,0.000333,0.059471,5,892.064778,49.559154,178.412956,61.748606,1,2
0,0,5,5,10,9,19,25,17,42,0.000333,0.059471,5,892.064778,49.559154,178.412956,61.748606,1,2
0,0,5,5,10,9,19,25,17,42,0.000333,0.059471,5,892.064778,49.559154,178.412956,61.748606,1,2
0,0,5,5,10,9,19,25,17,42,0.000333,0.059471,5,892.064778,49.559154,178.412956,61.748606,1,2
0,0,5,5,10,9,19,25,17,42,0.000333,0.059471,5,892.064778,49.559154,178.412956,61.748606,1,2
0,0,5,5,10,9,19,25,17,42,0.000333,0.059471,5,892.064778,49.559154,178.412956,61.748606,1,2
0,0,5,5,10,9,19,25,17,42,0.000333,0.059471,5,892.064778,49.559154,178.412956,61.748606,1,2
0,0,5,5,10,9,19,25,17,42,0.000333,0.059471,5,892.064778,49.559154,178.412956,61.748606,1,2
0,0,5,5,10,9,19,25,17,42,0.000333,0.059471,5,892.064778,49.559154,178.412956,61.748606,1,2
0,0,5,5,10,9,19,25,17,42,0.000333,0.059471,5,892.064778,49.559154,178.412956,61.748606,1,2
0,0,5,5,10,9,19,25,17,42,0.000333,0.059471,5,892.064778,49.559154,178.412956,61.748606,1,2
0,0,5,5,10,9,19,25,17,42,0.000333,0.059471,5,892.064778,49.559154,178.412956,61.748606,1,2
0,0,5,5,10,9,19,25,17,42,0.000333,0.059471,5,892.064778,49.559154,178.412956,61.748606,1,2
0,0,9,9,12,10,22,40,28,68,0.000333,0.10108,12,3638.896201,202.1609,303.24135,76.238831,1,2
0,0,9,9,11,13,24,39,37,76,0.000333,0.116152,10,3484.571501,193.587306,348.45715,86.159464,1,2
0,0,7,7,10,10,20,31,23,54,0.000333,0.077795,10,2333.841171,129.657843,233.384117,66.438562,1,2
0,0,10,10,11,11,22,46,31,77,0.000333,0.114459,10,3433.762346,190.764575,343.376235,76.107496,1,2
0,0,7,7,11,15,26,30,26,56,0.000333,0.087742,5,1316.123121,73.117951,263.224624,96.657107,1,2
0,0,7,7,10,14,24,31,29,60,0.000333,0.091699,10,2750.9775,152.832083,275.09775,86.52225,1,2
0,0,9,9,12,10,22,40,28,68,0.000333,0.10108,12,3638.896201,202.1609,303.24135,76.238831,1,2
0,0,8,8,11,12,23,40,27,67,0.000333,0.101026,10,3030.786511,168.377028,303.078651,81.073298,1,2
0,0,9,9,11,15,26,32,31,63,0.000333,0.098709,10,2961.277022,164.51539,296.127702,96.657107,1,2
0,0,7,7,10,14,24,31,29,60,0.000333,0.091699,10,2750.9775,152.832083,275.09775,86.52225,1,2
0,0,9,9,10,15,25,37,41,78,0.000333,0.12074,10,3622.207828,201.233768,362.220783,91.82264,1,2
0,0,11,11,10,16,26,43,53,96,0.000333,0.150414,15,6768.633194,376.035177,451.242213,97.219281,1,2
0,0,13,13,10,17,27,49,65,114,0.000333,0.180686,15,8130.857629,451.714313,542.057175,102.706149,1,2
0,0,9,9,11,13,24,39,37,76,0.000333,0.116152,10,3484.571501,193.587306,348.45715,86.159464,1,2
0,0,8,8,11,15,26,37,32,69,0.000333,0.10811,10,3243.303406,180.183523,324.330341,96.657107,1,2
0,0,9,9,11,16,27,46,36,82,0.000333,0.129967,10,3899.007752,216.611542,389.900775,102.053748,1,2
0,0,8,8,10,15,25,39,33,72,0.000333,0.111453,10,3343.576457,185.754248,334.357646,91.82264,1,2
0,0,9,9,10,16,26,42,36,78,0.000333,0.122211,10,3666.34298,203.685721,366.634298,97.219281,1,2
0,0,9,9,11,17,28,37,39,76,0.000333,0.121786,10,3653.589741,202.977208,365.358974,107.540616,1,2
0,0,9,9,10,15,25,31,37,68,0.000333,0.105261,10,3157.822209,175.434567,315.782221,91.82264,1,2
0,0,8,8,14,17,31,38,37,75,0.000333,0.123855,14,5201.906126,288.994785,371.564723,122.789837,1,2
0,0,8,8,13,17,30,37,37,74,0.000333,0.121037,12,4357.318849,242.073269,363.109904,117.592585,1,2
0,0,5,5,8,9,17,21,16,37,0.000333,0.050412,4,604.944501,33.608028,151.236125,52.529325,1,2
0,0,5,5,8,9,17,21,16,37,0.000333,0.050412,4,604.944501,33.608028,151.236125,52.529325,1,2
0,0,5,5,8,9,17,21,16,37,0.000333,0.050412,4,604.944501,33.608028,151.236125,52.529325,1,2
0,0,5,5,8,9,17,21,16,37,0.000333,0.050412,4,604.944501,33.608028,151.236125,52.529325,1,2
0,0,5,5,8,9,17,21,16,37,0.000333,0.050412,4,604.944501,33.608028,151.236125,52.529325,1,2
0,0,5,5,8,9,17,21,16,37,0.000333,0.050412,4,604.944501,33.608028,151.236125,52.529325,1,2
0,0,5,5,8,9,17,21,16,37,0.000333,0.050412,4,604.944501,33.608028,151.236125,52.529325,1,2
0,0,5,5,8,9,17,21,16,37,0.000333,0.050412,4,604.944501,33.608028,151.236125,52.529325,1,2
0,0,5,5,8,9,17,21,16,37,0.000333,0.050412,4,604.944501,33.608028,151.236125,52.529325,1,2
0,0,5,5,8,9,17,21,16,37,0.000333,0.050412,4,604.944501,33.608028,151.236125,52.529325,1,2
0,0,5,5,8,9,17,21,16,37,0.000333,0.050412,4,604.944501,33.608028,151.236125,52.529325,1,2
0,0,5,5,8,9,17,21,16,37,0.000333,0.050412,4,604.944501,33.608028,151.236125,52.529325,1,2
0,0,5,5,8,9,17,21,16,37,0.000333,0.050412,4,604.944501,33.608028,151.236125,52.529325,1,2
0,0,5,5,8,9,17,21,16,37,0.000333,0.050412,4,604.944501,33.608028,151.236125,52.529325,1,2
0,0,5,5,8,9,17,21,16,37,0.000333,0.050412,4,604.944501,33.608028,151.236125,52.529325,1,2
0,0,5,5,8,9,17,21,16,37,0.000333,0.050412,4,604.944501,33.608028,151.236125,52.529325,1,2
0,0,5,5,8,9,17,21,16,37,0.000333,0.050412,4,604.944501,33.608028,151.236125,52.529325,1,2
0,0,5,5,8,9,17,21,16,37,0.000333,0.050412,4,604.944501,33.608028,151.236125,52.529325,1,2
0,0,9,9,11,10,21,36,27,63,0.000333,0.092239,10,2767.159976,153.73111,276.715998,71.273029,1,2
0,0,9,9,10,13,23,35,36,71,0.000333,0.107058,10,3211.728989,178.429388,321.172899,81.324997,1,2
0,0,7,7,9,10,19,27,22,49,0.000333,0.069383,8,1665.187585,92.510421,208.148448,61.748606,1,2
0,0,10,10,10,11,21,42,30,72,0.000333,0.105416,10,3162.468544,175.692697,316.246854,71.273029,1,2
0,0,8,8,10,16,26,29,28,57,0.000333,0.089308,5,1339.62532,74.423629,267.925064,97.219281,1,2
0,0,7,7,9,14,23,27,28,55,0.000333,0.082932,8,1990.367261,110.575959,248.795908,81.832294,1,2
0,0,8,8,11,10,21,32,24,56,0.000333,0.08199,10,2459.697757,136.649875,245.969776,71.273029,1,2
0,0,8,8,10,12,22,36,26,62,0.000333,0.092162,10,2764.847604,153.602645,276.48476,76.238831,1,2
0,0,9,9,10,15,25,28,30,58,0.000333,0.089781,10,2693.43659,149.635366,269.343659,91.82264,1,2
0,0,7,7,9,14,23,27,28,55,0.000333,0.082932,8,1990.367261,110.575959,248.795908,81.832294,1,2
0,0,9,9,9,15,24,33,40,73,0.000333,0.111567,8,2677.6181,148.756561,334.702263,87.132684,1,2
0,0,11,11,9,16,25,39,52,91,0.000333,0.140864,12,5071.090959,281.727276,422.590913,92.529325,1,2
0,0,13,13,9,17,26,45,64,109,0.000333,0.170783,12,6148.175151,341.565286,512.347929,98.016193,1,2
0,0,9,9,10,13,23,35,36,71,0.000333,0.107058,10,3211.728989,178.429388,321.172899,81.324997,1,2
0,0,8,8,10,15,25,33,31,64,0.000333,0.099069,10,2972.067961,165.114887,297.206796,91.82264,1,2
0,0,9,9,10,16,26,42,35,77,0.000333,0.120645,10,3619.338583,201.074366,361.933858,97.219281,1,2
0,0,8,8,9,15,24,35,32,67,0.000333,0.102397,8,2457.5399,136.529994,307.192488,87.132684,1,2
0,0,10,10,9,17,26,42,38,80,0.000333,0.125345,8,3008.28142,167.126746,376.035177,98.016193,1,2
0,0,10,10,10,17,27,34,43,77,0.000333,0.122042,10,3661.263377,203.403521,366.126338,102.706149,1,2
0,0,9,9,9,15,24,27,36,63,0.000333,0.096284,8,2310.8211,128.37895,288.852638,87.132684,1,2
0,0,8,8,13,17,30,34,36,70,0.000333,0.114494,12,4121.7881,228.988228,343.482342,117.592585,1,2
0,0,8,8,12,17,29,33,36,69,0.000333,0.111734,12,4022.408264,223.467126,335.200689,112.506418,1,2
0,0,5,5,8,9,17,21,16,37,0.000333,0.050412,4,604.944501,33.608028,151.236125,52.529325,1,2
0,0,5,5,8,9,17,21,16,37,0.000333,0.050412,4,604.944501,33.608028,151.236125,52.529325,1,2
0,0,5,5,8,9,17,21,16,37,0.000333,0.050412,4,604.944501,33.608028,151.236125,52.529325,1,2
0,0,5,5,8,9,17,21,16,37,0.000333,0.050412,4,604.944501,33.608028,151.236125,52.529325,1,2
0,0,5,5,8,9,17,21,16,37,0.000333,0.050412,4,604.944501,33.608028,151.236125,52.529325,1,2
0,0,5,5,8,9,17,21,16,37,0.000333,0.050412,4,604.944501,33.608028,151.236125,52.529325,1,2
0,0,5,5,8,9,17,21,16,37,0.000333,0.050412,4,604.944501,33.608028,151.236125,52.529325,1,2
0,0,5,5,8,9,17,21,16,37,0.000333,0.050412,4,604.944501,33.608028,151.236125,52.529325,1,2
0,0,5,5,8,9,17,21,16,37,0.000333,0.050412,4,604.944501,33.608028,151.236125,52.529325,1,2
0,0,5,5,8,9,17,21,16,37,0.000333,0.050412,4,604.944501,33.608028,151.236125,52.529325,1,2
0,0,5,5,8,9,17,21,16,37,0.000333,0.050412,4,604.944501,33.608028,151.236125,52.529325,1,2
0,0,5,5,8,9,17,21,16,37,0.000333,0.050412,4,604.944501,33.608028,151.236125,52.529325,1,2
0,0,5,5,8,9,17,21,16,37,0.000333,0.050412,4,604.944501,33.608028,151.236125,52.529325,1,2
0,0,5,5,8,9,17,21,16,37,0.000333,0.050412,4,604.944501,33.608028,151.236125,52.529325,1,2
0,0,5,5,8,9,17,21,16,37,0.000333,0.050412,4,604.944501,33.608028,151.236125,52.529325,1,2
0,0,5,5,8,9,17,21,16,37,0.000333,0.050412,4,604.944501,33.608028,151.236125,52.529325,1,2
0,0,5,5,8,9,17,21,16,37,0.000333,0.050412,4,604.944501,33.608028,151.236125,52.529325,1,2
0,0,5,5,8,9,17,21,16,37,0.000333,0.050412,4,604.944501,33.608028,151.236125,52.529325,1,2
0,0,9,9,11,10,21,36,27,63,0.000333,0.092239,10,2767.159976,153.73111,276.715998,71.273029,1,2
0,0,9,9,10,13,23,35,36,71,0.000333,0.107058,10,3211.728989,178.429388,321.172899,81.324997,1,2
0,0,7,7,9,10,19,27,22,49,0.000333,0.069383,8,1665.187585,92.510421,208.148448,61.748606,1,2
0,0,10,10,10,11,21,42,30,72,0.000333,0.105416,10,3162.468544,175.692697,316.246854,71.273029,1,2
0,0,8,8,10,16,26,29,28,57,0.000333,0.089308,5,1339.62532,74.423629,267.925064,97.219281,1,2
0,0,7,7,9,14,23,27,28,55,0.000333,0.082932,8,1990.367261,110.575959,248.795908,81.832294,1,2
0,0,9,9,11,10,21,36,27,63,0.000333,0.092239,10,2767.159976,153.73111,276.715998,71.273029,1,2
0,0,8,8,10,12,22,36,26,62,0.000333,0.092162,10,2764.847604,153.602645,276.48476,76.238831,1,2
0,0,9,9,10,15,25,28,30,58,0.000333,0.089781,10,2693.43659,149.635366,269.343659,91.82264,1,2
0,0,7,7,9,14,23,27,28,55,0.000333,0.082932,8,1990.367261,110.575959,248.795908,81.832294,1,2
0,0,9,9,9,15,24,33,40,73,0.000333,0.111567,8,2677.6181,148.756561,334.702263,87.132684,1,2
0,0,11,11,9,16,25,39,52,91,0.000333,0.140864,12,5071.090959,281.727276,422.590913,92.529325,1,2
0,0,13,13,9,17,26,45,64,109,0.000333,0.170783,12,6148.175151,341.565286,512.347929,98.016193,1,2
0,0,9,9,10,13,23,35,36,71,0.000333,0.107058,10,3211.728989,178.429388,321.172899,81.324997,1,2
0,0,8,8,10,15,25,33,31,64,0.000333,0.099069,10,2972.067961,165.114887,297.206796,91.82264,1,2
0,0,9,9,10,16,26,42,35,77,0.000333,0.120645,10,3619.338583,201.074366,361.933858,97.219281,1,2
0,0,8,8,9,15,24,35,32,67,0.000333,0.102397,8,2457.5399,136.529994,307.192488,87.132684,1,2
0,0,10,10,9,17,26,42,38,80,0.000333,0.125345,8,3008.28142,167.126746,376.035177,98.016193,1,2
0,0,10,10,10,17,27,34,43,77,0.000333,0.122042,10,3661.263377,203.403521,366.126338,102.706149,1,2
0,0,9,9,9,15,24,27,36,63,0.000333,0.096284,8,2310.8211,128.37895,288.852638,87.132684,1,2
0,0,8,8,13,17,30,34,36,70,0.000333,0.114494,12,4121.7881,228.988228,343.482342,117.592585,1,2
0,0,8,8,12,17,29,33,36,69,0.000333,0.111734,12,4022.408264,223.467126,335.200689,112.506418,1,2
0,0,5,5,9,9,18,23,16,39,0.000333,0.054209,4,650.5083,36.13935,162.627075,57.05865,1,2
0,0,5,5,9,9,18,23,16,39,0.000333,0.054209,4,650.5083,36.13935,162.627075,57.05865,1,2
0,0,5,5,9,9,18,23,16,39,0.000333,0.054209,4,650.5083,36.13935,162.627075,57.05865,1,2
0,0,5,5,9,9,18,23,16,39,0.000333,0.054209,4,650.5083,36.13935,162.627075,57.05865,1,2
0,0,5,5,9,9,18,23,16,39,0.000333,0.054209,4,650.5083,36.13935,162.627075,57.05865,1,2
0,0,5,5,9,9,18,23,16,39,0.000333,0.054209,4,650.5083,36.13935,162.627075,57.05865,1,2
0,0,5,5,9,9,18,23,16,39,0.000333,0.054209,4,650.5083,36.13935,162.627075,57.05865,1,2
0,0,5,5,9,9,18,23,16,39,0.000333,0.054209,4,650.5083,36.13935,162.627075,57.05865,1,2
0,0,5,5,9,9,18,23,16,39,0.000333,0.054209,4,650.5083,36.13935,162.627075,57.05865,1,2
0,0,5,5,9,9,18,23,16,39,0.000333,0.054209,4,650.5083,36.13935,162.627075,57.05865,1,2
0,0,5,5,9,9,18,23,16,39,0.000333,0.054209,4,650.5083,36.13935,162.627075,57.05865,1,2
0,0,5,5,9,9,18,23,16,39,0.000333,0.054209,4,650.5083,36.13935,162.627075,57.05865,1,2
0,0,5,5,9,9,18,23,16,39,0.000333,0.054209,4,650.5083,36.13935,162.627075,57.05865,1,2
0,0,5,5,9,9,18,23,16,39,0.000333,0.054209,4,650.5083,36.13935,162.627075,57.05865,1,2
0,0,5,5,9,9,18,23,16,39,0.000333,0.054209,4,650.5083,36.13935,162.627075,57.05865,1,2
0,0,5,5,9,9,18,23,16,39,0.000333,0.054209,4,650.5083,36.13935,162.627075,57.05865,1,2
0,0,5,5,9,9,18,23,16,39,0.000333,0.054209,4,650.5083,36.13935,162.627075,57.05865,1,2
0,0,5,5,9,9,18,23,16,39,0.000333,0.054209,4,650.5083,36.13935,162.627075,57.05865,1,2
0,0,9,9,12,10,22,38,27,65,0.000333,0.096621,12,3478.356663,193.242037,289.863055,76.238831,1,2
0,0,9,9,11,13,24,37,36,73,0.000333,0.111567,10,3347.022626,185.945701,334.702263,86.159464,1,2
0,0,7,7,10,10,20,29,22,51,0.000333,0.073473,10,2204.183328,122.454629,220.418333,66.438562,1,2
0,0,10,10,11,11,22,44,30,74,0.000333,0.109999,10,3299.979398,183.332189,329.99794,76.107496,1,2
0,0,8,8,11,16,27,31,28,59,0.000333,0.093513,5,1402.691813,77.927323,280.538363,102.053748,1,2
0,0,7,7,10,14,24,29,28,57,0.000333,0.087114,10,2613.428625,145.190479,261.342863,86.52225,1,2
0,0,9,9,12,10,22,38,27,65,0.000333,0.096621,12,3478.356663,193.242037,289.863055,76.238831,1,2
0,0,8,8,11,12,23,38,26,64,0.000333,0.096503,10,2895.079652,160.837758,289.507965,81.073298,1,2
0,0,9,9,11,15,26,30,30,60,0.000333,0.094009,10,2820.263831,156.681324,282.026383,96.657107,1,2
0,0,7,7,10,14,24,29,28,57,0.000333,0.087114,10,2613.428625,145.190479,261.342863,86.52225,1,2
0,0,9,9,10,15,25,35,40,75,0.000333,0.116096,10,3482.892142,193.494008,348.289214,91.82264,1,2
0,0,11,11,10,16,26,41,52,93,0.000333,0.145714,15,6557.113407,364.284078,437.140894,97.219281,1,2
0,0,13,13,10,17,27,47,64,111,0.000333,0.175931,15,7916.887691,439.827094,527.792513,102.706149,1,2
0,0,9,9,11,13,24,37,36,73,0.000333,0.111567,10,3347.022626,185.945701,334.702263,86.159464,1,2
0,0,8,8,11,15,26,35,31,66,0.000333,0.10341,10,3102.290214,172.349456,310.229021,96.657107,1,2
0,0,9,9,11,16,27,44,35,79,0.000333,0.125212,10,3756.361127,208.686729,375.636113,102.053748,1,2
0,0,8,8,10,15,25,37,32,69,0.000333,0.106809,10,3204.260771,178.014487,320.426077,91.82264,1,2
0,0,10,10,10,17,27,44,38,82,0.000333,0.129967,10,3899.007752,216.611542,389.900775,102.706149,1,2
0,0,10,10,11,17,28,36,43,79,0.000333,0.126594,10,3797.810388,210.989466,379.781039,107.540616,1,2
0,0,9,9,10,15,25,29,36,65,0.000333,0.100617,10,3018.506523,167.694807,301.850652,91.82264,1,2
0,0,8,8,14,17,31,36,36,72,0.000333,0.118901,14,4993.829881,277.434993,356.702134,122.789837,1,2
0,0,8,8,13,17,30,35,36,71,0.000333,0.11613,12,4180.670787,232.259488,348.389232,117.592585,1,2
0,0,5,5,10,10,20,30,19,49,0.000333,0.070591,5,1058.872383,58.826244,211.774477,66.438562,1,2
0,0,5,5,10,10,20,30,19,49,0.000333,0.070591,5,1058.872383,58.826244,211.774477,66.438562,1,2
0,0,5,5,10,10,20,30,19,49,0.000333,0.070591,5,1058.872383,58.826244,211.774477,66.438562,1,2
0,0,5,5,10,10,20,30,19,49,0.000333,0.070591,5,1058.872383,58.826244,211.774477,66.438562,1,2
0,0,5,5,10,10,20,30,19,49,0.000333,0.070591,5,1058.872383,58.826244,211.774477,66.438562,1,2
0,0,5,5,10,10,20,30,19,49,0.000333,0.070591,5,1058.872383,58.826244,211.774477,66.438562,1,2
0,0,5,5,10,10,20,30,19,49,0.000333,0.070591,5,1058.872383,58.826244,211.774477,66.438562,1,2
0,0,5,5,10,10,20,30,19,49,0.000333,0.070591,5,1058.872383,58.826244,211.774477,66.438562,1,2
0,0,5,5,10,10,20,30,19,49,0.000333,0.070591,5,1058.872383,58.826244,211.774477,66.438562,1,2
0,0,5,5,10,10,20,30,19,49,0.000333,0.070591,5,1058.872383,58.826244,211.774477,66.438562,1,2
0,0,5,5,10,10,20,30,19,49,0.000333,0.070591,5,1058.872383,58.826244,211.774477,66.438562,1,2
0,0,5,5,10,10,20,30,19,49,0.000333,0.070591,5,1058.872383,58.826244,211.774477,66.438562,1,2
0,0,5,5,10,10,20,30,19,49,0.000333,0.070591,5,1058.872383,58.826244,211.774477,66.438562,1,2
0,0,5,5,10,10,20,30,19,49,0.000333,0.070591,5,1058.872383,58.826244,211.774477,66.438562,1,2
0,0,5,5,10,10,20,30,19,49,0.000333,0.070591,5,1058.872383,58.826244,211.774477,66.438562,1,2
0,0,5,5,10,10,20,30,19,49,0.000333,0.070591,5,1058.872383,58.826244,211.774477,66.438562,1,2
0,0,5,5,10,10,20,30,19,49,0.000333,0.070591,5,1058.872383,58.826244,211.774477,66.438562,1,2
0,0,5,5,10,10,20,30,19,49,0.000333,0.070591,5,1058.872383,58.826244,211.774477,66.438562,1,2
0,0,9,9,12,11,23,45,30,75,0.000333,0.113089,12,4071.20576,226.178098,339.267147,81.073298,1,2
0,0,9,9,11,14,25,44,39,83,0.000333,0.12848,10,3854.400638,214.133369,385.440064,91.356717,1,2
0,0,7,7,10,11,21,36,25,61,0.000333,0.08931,10,2679.313628,148.850757,267.931363,71.273029,1,2
0,0,10,10,11,12,23,51,33,84,0.000333,0.12666,10,3799.792043,211.099558,379.979204,81.073298,1,2
0,0,8,8,11,17,28,38,31,69,0.000333,0.110569,5,1658.537448,92.140969,331.70749,107.540616,1,2
0,0,7,7,10,15,25,36,31,67,0.000333,0.103713,10,3111.383647,172.854647,311.138365,91.82264,1,2
0,0,9,9,12,11,23,45,30,75,0.000333,0.113089,12,4071.20576,226.178098,339.267147,81.073298,1,2
0,0,8,8,11,13,24,45,29,74,0.000333,0.113096,10,3392.872251,188.492903,339.287225,86.159464,1,2
0,0,9,9,11,16,27,37,33,70,0.000333,0.110947,10,3328.421252,184.912292,332.842125,102.053748,1,2
0,0,7,7,10,15,25,36,31,67,0.000333,0.103713,10,3111.383647,172.854647,311.138365,91.82264,1,2
0,0,9,9,10,16,26,42,43,85,0.000333,0.133179,10,3995.37376,221.965209,399.537376,97.219281,1,2
0,0,11,11,10,17,27,48,55,103,0.000333,0.163251,15,7346.301191,408.127844,489.753413,102.706149,1,2
0,0,13,13,10,18,28,54,67,121,0.000333,0.193897,15,8725.349184,484.741621,581.689946,108.277931,1,2
0,0,9,9,11,14,25,44,39,83,0.000333,0.12848,10,3854.400638,214.133369,385.440064,91.356717,1,2
0,0,8,8,11,16,27,42,34,76,0.000333,0.120457,10,3613.714502,200.761917,361.37145,102.053748,1,2
0,0,9,9,11,17,28,51,38,89,0.000333,0.142618,10,4278.545881,237.696993,427.854588,107.540616,1,2
0,0,8,8,10,16,26,44,35,79,0.000333,0.123778,10,3713.347377,206.297077,371.334738,97.219281,1,2
0,0,10,10,10,18,28,51,41,92,0.000333,0.147426,10,4422.766528,245.709252,442.276653,108.277931,1,2
0,0,10,10,11,18,29,43,46,89,0.000333,0.14412,10,4323.603086,240.200171,432.360309,113.112398,1,2
0,0,9,9,10,16,26,36,39,75,0.000333,0.117511,10,3525.329789,195.851655,352.532979,97.219281,1,2
0,0,8,8,14,18,32,43,39,82,0.000333,0.136667,14,5740,318.888889,410,128.361619,1,2
0,0,8,8,13,18,31,42,39,81,0.000333,0.133763,12,4815.478814,267.526601,401.289901,123.164366,1,2
0,0,5,5,10,10,20,30,19,49,0.000333,0.070591,5,1058.872383,58.826244,211.774477,66.438562,1,2
0,0,5,5,10,10,20,30,19,49,0.000333,0.070591,5,1058.872383,58.826244,211.774477,66.438562,1,2
0,0,5,5,10,10,20,30,19,49,0.000333,0.070591,5,1058.872383,58.826244,211.774477,66.438562,1,2
0,0,5,5,10,10,20,30,19,49,0.000333,0.070591,5,1058.872383,58.826244,211.774477,66.438562,1,2
0,0,5,5,10,10,20,30,19,49,0.000333,0.070591,5,1058.872383,58.826244,211.774477,66.438562,1,2
0,0,5,5,10,10,20,30,19,49,0.000333,0.070591,5,1058.872383,58.826244,211.774477,66.438562,1,2
0,0,5,5,10,10,20,30,19,49,0.000333,0.070591,5,1058.872383,58.826244,211.774477,66.438562,1,2
0,0,5,5,10,10,20,30,19,49,0.000333,0.070591,5,1058.872383,58.826244,211.774477,66.438562,1,2
0,0,5,5,10,10,20,30,19,49,0.000333,0.070591,5,1058.872383,58.826244,211.774477,66.438562,1,2
0,0,5,5,10,10,20,30,19,49,0.000333,0.070591,5,1058.872383,58.826244,211.774477,66.438562,1,2
0,0,5,5,10,10,20,30,19,49,0.000333,0.070591,5,1058.872383,58.826244,211.774477,66.438562,1,2
0,0,5,5,10,10,20,30,19,49,0.000333,0.070591,5,1058.872383,58.826244,211.774477,66.438562,1,2
0,0,5,5,10,10,20,30,19,49,0.000333,0.070591,5,1058.872383,58.826244,211.774477,66.438562,1,2
0,0,5,5,10,10,20,30,19,49,0.000333,0.070591,5,1058.872383,58.826244,211.774477,66.438562,1,2
0,0,5,5,10,10,20,30,19,49,0.000333,0.070591,5,1058.872383,58.826244,211.774477,66.438562,1,2
0,0,5,5,10,10,20,30,19,49,0.000333,0.070591,5,1058.872383,58.826244,211.774477,66.438562,1,2
0,0,5,5,10,10,20,30,19,49,0.000333,0.070591,5,1058.872383,58.826244,211.774477,66.438562,1,2
0,0,5,5,10,10,20,30,19,49,0.000333,0.070591,5,1058.872383,58.826244,211.774477,66.438562,1,2
0,0,9,9,12,11,23,45,30,75,0.000333,0.113089,12,4071.20576,226.178098,339.267147,81.073298,1,2
0,0,9,9,11,14,25,44,39,83,0.000333,0.12848,10,3854.400638,214.133369,385.440064,91.356717,1,2
0,0,7,7,10,11,21,36,25,61,0.000333,0.08931,10,2679.313628,148.850757,267.931363,71.273029,1,2
0,0,10,10,11,12,23,51,33,84,0.000333,0.12666,10,3799.792043,211.099558,379.979204,81.073298,1,2
0,0,8,8,11,17,28,38,31,69,0.000333,0.110569,5,1658.537448,92.140969,331.70749,107.540616,1,2
0,0,7,7,10,15,25,36,31,67,0.000333,0.103713,10,3111.383647,172.854647,311.138365,91.82264,1,2
0,0,9,9,12,11,23,45,30,75,0.000333,0.113089,12,4071.20576,226.178098,339.267147,81.073298,1,2
0,0,8,8,11,13,24,45,29,74,0.000333,0.113096,10,3392.872251,188.492903,339.287225,86.159464,1,2
0,0,9,9,11,16,27,37,33,70,0.000333,0.110947,10,3328.421252,184.912292,332.842125,102.053748,1,2
0,0,7,7,10,15,25,36,31,67,0.000333,0.103713,10,3111.383647,172.854647,311.138365,91.82264,1,2
0,0,9,9,10,16,26,42,43,85,0.000333,0.133179,10,3995.37376,221.965209,399.537376,97.219281,1,2
0,0,11,11,10,17,27,48,55,103,0.000333,0.163251,15,7346.301191,408.127844,489.753413,102.706149,1,2
0,0,13,13,10,18,28,54,67,121,0.000333,0.193897,15,8725.349184,484.741621,581.689946,108.277931,1,2
0,0,9,9,11,14,25,44,39,83,0.000333,0.12848,10,3854.400638,214.133369,385.440064,91.356717,1,2
0,0,8,8,11,16,27,42,34,76,0.000333,0.120457,10,3613.714502,200.761917,361.37145,102.053748,1,2
0,0,9,9,11,17,28,51,38,89,0.000333,0.142618,10,4278.545881,237.696993,427.854588,107.540616,1,2
0,0,8,8,10,16,26,44,35,79,0.000333,0.123778,10,3713.347377,206.297077,371.334738,97.219281,1,2
0,0,10,10,10,18,28,51,41,92,0.000333,0.147426,10,4422.766528,245.709252,442.276653,108.277931,1,2
0,0,10,10,11,18,29,43,46,89,0.000333,0.14412,10,4323.603086,240.200171,432.360309,113.112398,1,2
0,0,9,9,10,16,26,36,39,75,0.000333,0.117511,10,3525.329789,195.851655,352.532979,97.219281,1,2
0,0,8,8,14,18,32,43,39,82,0.000333,0.136667,14,5740,318.888889,410,128.361619,1,2
0,0,8,8,13,18,31,42,39,81,0.000333,0.133763,12,4815.478814,267.526601,401.289901,123.164366,1,2
0,0,5,5,11,10,21,32,19,51,0.000333,0.074669,5,1120.040943,62.224497,224.008189,71.273029,1,2
0,0,5,5,11,10,21,32,19,51,0.000333,0.074669,5,1120.040943,62.224497,224.008189,71.273029,1,2
0,0,5,5,11,10,21,32,19,51,0.000333,0.074669,5,1120.040943,62.224497,224.008189,71.273029,1,2
0,0,5,5,11,10,21,32,19,51,0.000333,0.074669,5,1120.040943,62.224497,224.008189,71.273029,1,2
0,0,5,5,11,10,21,32,19,51,0.000333,0.074669,5,1120.040943,62.224497,224.008189,71.273029,1,2
0,0,5,5,11,10,21,32,19,51,0.000333,0.074669,5,1120.040943,62.224497,224.008189,71.273029,1,2
0,0,5,5,11,10,21,32,19,51,0.000333,0.074669,5,1120.040943,62.224497,224.008189,71.273029,1,2
0,0,5,5,11,10,21,32,19,51,0.000333,0.074669,5,1120.040943,62.224497,224.008189,71.273029,1,2
0,0,5,5,11,10,21,32,19,51,0.000333,0.074669,5,1120.040943,62.224497,224.008189,71.273029,1,2
0,0,5,5,11,10,21,32,19,51,0.000333,0.074669,5,1120.040943,62.224497,224.008189,71.273029,1,2
0,0,5,5,11,10,21,32,19,51,0.000333,0.074669,5,1120.040943,62.224497,224.008189,71.273029,1,2
0,0,5,5,11,10,21,32,19,51,0.000333,0.074669,5,1120.040943,62.224497,224.008189,71.273029,1,2
0,0,5,5,11,10,21,32,19,51,0.000333,0.074669,5,1120.040943,62.224497,224.008189,71.273029,1,2
0,0,5,5,11,10,21,32,19,51,0.000333,0.074669,5,1120.040943,62.224497,224.008189,71.273029,1,2
0,0,5,5,11,10,21,32,19,51,0.000333,0.074669,5,1120.040943,62.224497,224.008189,71.273029,1,2
0,0,5,5,11,10,21,32,19,51,0.000333,0.074669,5,1120.040943,62.224497,224.008189,71.273029,1,2
0,0,5,5,11,10,21,32,19,51,0.000333,0.074669,5,1120.040943,62.224497,224.008189,71.273029,1,2
0,0,5,5,11,10,21,32,19,51,0.000333,0.074669,5,1120.040943,62.224497,224.008189,71.273029,1,2
0,0,9,9,13,11,24,47,30,77,0.000333,0.117681,12,4236.505351,235.361408,353.042113,86.159464,1,2
0,0,9,9,12,14,26,46,39,85,0.000333,0.133179,12,4794.448513,266.358251,399.537376,96.322519,1,2
0,0,7,7,11,11,22,38,25,63,0.000333,0.093648,10,2809.44192,156.080107,280.944192,76.107496,1,2
0,0,10,10,12,12,24,53,33,86,0.000333,0.131436,12,4731.681301,262.871183,394.306775,86.0391,1,2
0,0,8,8,12,17,29,40,31,71,0.000333,0.114972,6,2069.499904,114.972217,344.916651,112.506418,1,2
0,0,7,7,11,15,26,38,31,69,0.000333,0.10811,10,3243.303406,180.183523,324.330341,96.657107,1,2
0,0,9,9,13,11,24,47,30,77,0.000333,0.117681,12,4236.505351,235.361408,353.042113,86.159464,1,2
0,0,8,8,12,13,25,47,29,76,0.000333,0.117644,12,4235.196845,235.288714,352.93307,91.125266,1,2
0,0,9,9,12,16,28,39,33,72,0.000333,0.115377,12,4153.554653,230.753036,346.129554,107.01955,1,2
0,0,7,7,11,15,26,38,31,69,0.000333,0.10811,10,3243.303406,180.183523,324.330341,96.657107,1,2
0,0,9,9,11,16,27,44,43,87,0.000333,0.137892,10,4136.752127,229.819563,413.675213,102.053748,1,2
0,0,11,11,11,17,28,50,55,105,0.000333,0.168257,15,7571.584002,420.643556,504.772267,107.540616,1,2
0,0,13,13,11,18,29,56,67,123,0.000333,0.199177,15,8962.974936,497.943052,597.531662,113.112398,1,2
0,0,9,9,12,14,26,46,39,85,0.000333,0.133179,12,4794.448513,266.358251,399.537376,96.322519,1,2
0,0,8,8,12,16,28,44,34,78,0.000333,0.124991,12,4499.684207,249.982456,374.973684,107.01955,1,2
0,0,9,9,12,17,29,53,38,91,0.000333,0.147359,12,5304.915247,294.717514,442.076271,112.506418,1,2
0,0,8,8,11,16,27,46,35,81,0.000333,0.128382,10,3851.458877,213.969938,385.145888,102.053748,1,2
0,0,10,10,11,18,29,53,41,94,0.000333,0.152217,10,4566.502135,253.694563,456.650214,113.112398,1,2
0,0,10,10,12,18,30,45,46,91,0.000333,0.148842,12,5358.32453,297.684696,446.527044,118.0782,1,2
0,0,9,9,11,16,27,38,39,77,0.000333,0.122042,10,3661.263377,203.403521,366.126338,102.053748,1,2
0,0,8,8,15,18,33,45,39,84,0.000333,0.141243,14,5932.207484,329.567082,423.729106,133.662009,1,2
0,0,8,8,14,18,32,44,39,83,0.000333,0.138333,14,5810,322.777778,415,128.361619,1,2
0,0,5,5,8,9,17,21,16,37,0.000333,0.050412,4,604.944501,33.608028,151.236125,52.529325,1,2
0,0,5,5,8,9,17,21,16,37,0.000333,0.050412,4,604.944501,33.608028,151.236125,52.529325,1,2
0,0,5,5,8,9,17,21,16,37,0.000333,0.050412,4,604.944501,33.608028,151.236125,52.529325,1,2
0,0,5,5,8,9,17,21,16,37,0.000333,0.050412,4,604.944501,33.608028,151.236125,52.529325,1,2
0,0,5,5,8,9,17,21,16,37,0.000333,0.050412,4,604.944501,33.608028,151.236125,52.529325,1,2
0,0,5,5,8,9,17,21,16,37,0.000333,0.050412,4,604.944501,33.608028,151.236125,52.529325,1,2
0,0,5,5,8,9,17,21,16,37,0.000333,0.050412,4,604.944501,33.608028,151.236125,52.529325,1,2
0,0,5,5,8,9,17,21,16,37,0.000333,0.050412,4,604.944501,33.608028,151.236125,52.529325,1,2
0,0,5,5,8,9,17,21,16,37,0.000333,0.050412,4,604.944501,33.608028,151.236125,52.529325,1,2
0,0,5,5,8,9,17,21,16,37,0.000333,0.050412,4,604.944501,33.608028,151.236125,52.529325,1,2
0,0,5,5,8,9,17,21,16,37,0.000333,0.050412,4,604.944501,33.608028,151.236125,52.529325,1,2
0,0,5,5,8,9,17,21,16,37,0.000333,0.050412,4,604.944501,33.608028,151.236125,52.529325,1,2
0,0,5,5,8,9,17,21,16,37,0.000333,0.050412,4,604.944501,33.608028,151.236125,52.529325,1,2
0,0,5,5,8,9,17,21,16,37,0.000333,0.050412,4,604.944501,33.608028,151.236125,52.529325,1,2
0,0,5,5,8,9,17,21,16,37,0.000333,0.050412,4,604.944501,33.608028,151.236125,52.529325,1,2
0,0,5,5,8,9,17,21,16,37,0.000333,0.050412,4,604.944501,33.608028,151.236125,52.529325,1,2
0,0,5,5,8,9,17,21,16,37,0.000333,0.050412,4,604.944501,33.608028,151.236125,52.529325,1,2
0,0,5,5,8,9,17,21,16,37,0.000333,0.050412,4,604.944501,33.608028,151.236125,52.529325,1,2
0,0,9,9,11,10,21,36,27,63,0.000333,0.092239,10,2767.159976,153.73111,276.715998,71.273029,1,2
0,0,9,9,10,13,23,35,36,71,0.000333,0.107058,10,3211.728989,178.429388,321.172899,81.324997,1,2
0,0,7,7,9,10,19,27,22,49,0.000333,0.069383,8,1665.187585,92.510421,208.148448,61.748606,1,2
0,0,10,10,10,11,21,42,30,72,0.000333,0.105416,10,3162.468544,175.692697,316.246854,71.273029,1,2
0,0,8,8,10,16,26,29,28,57,0.000333,0.089308,5,1339.62532,74.423629,267.925064,97.219281,1,2
0,0,7,7,9,14,23,27,28,55,0.000333,0.082932,8,1990.367261,110.575959,248.795908,81.832294,1,2
0,0,9,9,11,10,21,36,27,63,0.000333,0.092239,10,2767.159976,153.73111,276.715998,71.273029,1,2
0,0,8,8,10,12,22,36,26,62,0.000333,0.092162,10,2764.847604,153.602645,276.48476,76.238831,1,2
0,0,9,9,10,15,25,28,30,58,0.000333,0.089781,10,2693.43659,149.635366,269.343659,91.82264,1,2
0,0,7,7,9,14,23,27,28,55,0.000333,0.082932,8,1990.367261,110.575959,248.795908,81.832294,1,2
0,0,9,9,9,15,24,33,40,73,0.000333,0.111567,8,2677.6181,148.756561,334.702263,87.132684,1,2
0,0,11,11,9,16,25,39,52,91,0.000333,0.140864,12,5071.090959,281.727276,422.590913,92.529325,1,2
0,0,13,13,9,17,26,45,64,109,0.000333,0.170783,12,6148.175151,341.565286,512.347929,98.016193,1,2
0,0,9,9,10,13,23,35,36,71,0.000333,0.107058,10,3211.728989,178.429388,321.172899,81.324997,1,2
0,0,8,8,10,15,25,33,31,64,0.000333,0.099069,10,2972.067961,165.114887,297.206796,91.82264,1,2
0,0,9,9,10,16,26,42,35,77,0.000333,0.120645,10,3619.338583,201.074366,361.933858,97.219281,1,2
0,0,8,8,9,15,24,35,32,67,0.000333,0.102397,8,2457.5399,136.529994,307.192488,87.132684,1,2
0,0,10,10,9,17,26,42,38,80,0.000333,0.125345,8,3008.28142,167.126746,376.035177,98.016193,1,2
0,0,10,10,10,17,27,34,43,77,0.000333,0.122042,10,3661.263377,203.403521,366.126338,102.706149,1,2
0,0,9,9,9,15,24,27,36,63,0.000333,0.096284,8,2310.8211,128.37895,288.852638,87.132684,1,2
0,0,8,8,13,17,30,34,36,70,0.000333,0.114494,12,4121.7881,228.988228,343.482342,117.592585,1,2
0,0,8,8,12,17,29,33,36,69,0.000333,0.111734,12,4022.408264,223.467126,335.200689,112.506418,1,2
0,0,5,5,8,9,17,21,16,37,0.000333,0.050412,4,604.944501,33.608028,151.236125,52.529325,1,2
0,0,5,5,8,9,17,21,16,37,0.000333,0.050412,4,604.944501,33.608028,151.236125,52.529325,1,2
0,0,5,5,8,9,17,21,16,37,0.000333,0.050412,4,604.944501,33.608028,151.236125,52.529325,1,2
0,0,5,5,8,9,17,21,16,37,0.000333,0.050412,4,604.944501,33.608028,151.236125,52.529325,1,2
0,0,5,5,8,9,17,21,16,37,0.000333,0.050412,4,604.944501,33.608028,151.236125,52.529325,1,2
0,0,5,5,8,9,17,21,16,37,0.000333,0.050412,4,604.944501,33.608028,151.236125,52.529325,1,2
0,0,5,5,8,9,17,21,16,37,0.000333,0.050412,4,604.944501,33.608028,151.236125,52.529325,1,2
0,0,5,5,8,9,17,21,16,37,0.000333,0.050412,4,604.944501,33.608028,151.236125,52.529325,1,2
0,0,5,5,8,9,17,21,16,37,0.000333,0.050412,4,604.944501,33.608028,151.236125,52.529325,1,2
0,0,5,5,8,9,17,21,16,37,0.000333,0.050412,4,604.944501,33.608028,151.236125,52.529325,1,2
0,0,5,5,8,9,17,21,16,37,0.000333,0.050412,4,604.944501,33.608028,151.236125,52.529325,1,2
0,0,5,5,8,9,17,21,16,37,0.000333,0.050412,4,604.944501,33.608028,151.236125,52.529325,1,2
0,0,5,5,8,9,17,21,16,37,0.000333,0.050412,4,604.944501,33.608028,151.236125,52.529325,1,2
0,0,5,5,8,9,17,21,16,37,0.000333,0.050412,4,604.944501,33.608028,151.236125,52.529325,1,2
0,0,5,5,8,9,17,21,16,37,0.000333,0.050412,4,604.944501,33.608028,151.236125,52.529325,1,2
0,0,5,5,8,9,17,21,16,37,0.000333,0.050412,4,604.944501,33.608028,151.236125,52.529325,1,2
0,0,5,5,8,9,17,21,16,37,0.000333,0.050412,4,604.944501,33.608028,151.236125,52.529325,1,2
0,0,5,5,8,9,17,21,16,37,0.000333,0.050412,4,604.944501,33.608028,151.236125,52.529325,1,2
0,0,9,9,11,10,21,36,27,63,0.000333,0.092239,10,2767.159976,153.73111,276.715998,71.273029,1,2
0,0,9,9,10,13,23,35,36,71,0.000333,0.107058,10,3211.728989,178.429388,321.172899,81.324997,1,2
0,0,7,7,9,10,19,27,22,49,0.000333,0.069383,8,1665.187585,92.510421,208.148448,61.748606,1,2
0,0,10,10,10,11,21,42,30,72,0.000333,0.105416,10,3162.468544,175.692697,316.246854,71.273029,1,2
0,0,8,8,10,16,26,29,28,57,0.000333,0.089308,5,1339.62532,74.423629,267.925064,97.219281,1,2
0,0,7,7,9,14,23,27,28,55,0.000333,0.082932,8,1990.367261,110.575959,248.795908,81.832294,1,2
0,0,9,9,11,10,21,36,27,63,0.000333,0.092239,10,2767.159976,153.73111,276.715998,71.273029,1,2
0,0,8,8,10,12,22,36,26,62,0.000333,0.092162,10,2764.847604,153.602645,276.48476,76.238831,1,2
0,0,9,9,10,15,25,28,30,58,0.000333,0.089781,10,2693.43659,149.635366,269.343659,91.82264,1,2
0,0,7,7,9,14,23,27,28,55,0.000333,0.082932,8,1990.367261,110.575959,248.795908,81.832294,1,2
0,0,9,9,9,15,24,33,40,73,0.000333,0.111567,8,2677.6181,148.756561,334.702263,87.132684,1,2
0,0,11,11,9,16,25,39,52,91,0.000333,0.140864,12,5071.090959,281.727276,422.590913,92.529325,1,2
0,0,13,13,9,17,26,45,64,109,0.000333,0.170783,12,6148.175151,341.565286,512.347929,98.016193,1,2
0,0,9,9,10,13,23,35,36,71,0.000333,0.107058,10,3211.728989,178.429388,321.172899,81.324997,1,2
0,0,8,8,10,15,25,33,31,64,0.000333,0.099069,10,2972.067961,165.114887,297.206796,91.82264,1,2
0,0,9,9,10,16,26,42,35,77,0.000333,0.120645,10,3619.338583,201.074366,361.933858,97.219281,1,2
0,0,8,8,9,15,24,35,32,67,0.000333,0.102397,8,2457.5399,136.529994,307.192488,87.132684,1,2
0,0,10,10,9,17,26,42,38,80,0.000333,0.125345,8,3008.28142,167.126746,376.035177,98.016193,1,2
0,0,10,10,10,17,27,34,43,77,0.000333,0.122042,10,3661.263377,203.403521,366.126338,102.706149,1,2
0,0,9,9,9,15,24,27,36,63,0.000333,0.096284,8,2310.8211,128.37895,288.852638,87.132684,1,2
0,0,8,8,13,17,30,34,36,70,0.000333,0.114494,12,4121.7881,228.988228,343.482342,117.592585,1,2
0,0,8,8,12,17,29,33,36,69,0.000333,0.111734,12,4022.408264,223.467126,335.200689,112.506418,1,2
0,0,5,5,9,9,18,23,16,39,0.000333,0.054209,4,650.5083,36.13935,162.627075,57.05865,1,2
0,0,5,5,9,9,18,23,16,39,0.000333,0.054209,4,650.5083,36.13935,162.627075,57.05865,1,2
0,0,8,8,12,13,25,44,26,70,0.000333,0.108357,12,3900.839199,216.713289,325.069933,91.125266,1,2
0,0,8,8,12,15,27,34,28,62,0.000333,0.098268,6,1768.818151,98.267675,294.803025,101.622909,1,2
0,0,6,6,11,14,25,33,26,59,0.000333,0.091329,5,1369.937576,76.107643,273.987515,91.356717,1,2
0,0,8,8,11,15,26,39,38,77,0.000333,0.120645,10,3619.338583,201.074366,361.933858,96.657107,1,2
0,0,10,10,11,16,27,45,50,95,0.000333,0.150571,15,6775.714691,376.428594,451.714313,102.053748,1,2
0,0,12,12,11,17,28,51,62,113,0.000333,0.181077,15,8148.466593,452.692588,543.231106,107.540616,1,2
0,0,8,8,12,13,25,41,34,75,0.000333,0.116096,12,4179.470571,232.192809,348.289214,91.125266,1,2
0,0,7,7,12,15,27,39,29,68,0.000333,0.107777,6,1939.994101,107.77745,323.33235,101.622909,1,2
0,0,8,8,12,16,28,48,33,81,0.000333,0.129799,12,4672.748984,259.597166,389.395749,107.01955,1,2
0,0,8,8,11,16,27,43,32,75,0.000333,0.118872,10,3566.165627,198.120313,356.616563,102.053748,1,2
0,0,10,10,11,18,29,50,38,88,0.000333,0.142501,10,4275.023276,237.501293,427.502328,113.112398,1,2
0,0,9,9,12,17,29,40,41,81,0.000333,0.131165,12,4721.957527,262.330974,393.496461,112.506418,1,2
0,0,8,8,11,15,26,33,34,67,0.000333,0.104976,10,3149.294611,174.960812,314.929461,96.657107,1,2
0,0,7,7,15,17,32,40,34,74,0.000333,0.123333,14,5180,287.777778,370,128.090227,1,2
0,0,7,7,14,17,31,39,34,73,0.000333,0.120552,14,5063.188629,281.288257,361.656331,122.789837,1,2
0,0,5,5,10,9,19,28,17,45,0.000333,0.063719,5,955.783691,53.099094,191.156738,61.748606,1,2
0,0,5,5,10,9,19,28,17,45,0.000333,0.063719,5,955.783691,53.099094,191.156738,61.748606,1,2
0,0,5,5,10,9,19,28,17,45,0.000333,0.063719,5,955.783691,53.099094,191.156738,61.748606,1,2
0,0,5,5,10,9,19,28,17,45,0.000333,0.063719,5,955.783691,53.099094,191.156738,61.748606,1,2
0,0,5,5,10,9,19,28,17,45,0.000333,0.063719,5,955.783691,53.099094,191.156738,61.748606,1,2
0,0,5,5,10,9,19,28,17,45,0.000333,0.063719,5,955.783691,53.099094,191.156738,61.748606,1,2
0,0,5,5,10,9,19,28,17,45,0.000333,0.063719,5,955.783691,53.099094,191.156738,61.748606,1,2
0,0,5,5,10,9,19,28,17,45,0.000333,0.063719,5,955.783691,53.099094,191.156738,61.748606,1,2
0,0,5,5,10,9,19,28,17,45,0.000333,0.063719,5,955.783691,53.099094,191.156738,61.748606,1,2
0,0,5,5,10,9,19,28,17,45,0.000333,0.063719,5,955.783691,53.099094,191.156738,61.748606,1,2
0,0,5,5,10,9,19,28,17,45,0.000333,0.063719,5,955.783691,53.099094,191.156738,61.748606,1,2
0,0,5,5,10,9,19,28,17,45,0.000333,0.063719,5,955.783691,53.099094,191.156738,61.748606,1,2
0,0,5,5,10,9,19,28,17,45,0.000333,0.063719,5,955.783691,53.099094,191.156738,61.748606,1,2
0,0,5,5,10,9,19,28,17,45,0.000333,0.063719,5,955.783691,53.099094,191.156738,61.748606,1,2
0,0,5,5,10,9,19,28,17,45,0.000333,0.063719,5,955.783691,53.099094,191.156738,61.748606,1,2
0,0,5,5,10,9,19,28,17,45,0.000333,0.063719,5,955.783691,53.099094,191.156738,61.748606,1,2
0,0,5,5,10,9,19,28,17,45,0.000333,0.063719,5,955.783691,53.099094,191.156738,61.748606,1,2
0,0,5,5,10,9,19,28,17,45,0.000333,0.063719,5,955.783691,53.099094,191.156738,61.748606,1,2
0,0,10,10,12,11,23,45,30,75,0.000333,0.113089,12,4071.20576,226.178098,339.267147,81.073298,1,2
0,0,10,10,11,14,25,44,39,83,0.000333,0.12848,10,3854.400638,214.133369,385.440064,91.356717,1,2
0,0,7,7,10,10,20,34,23,57,0.000333,0.082117,10,2463.499014,136.861056,246.349901,66.438562,1,2
0,0,10,10,11,12,23,48,30,78,0.000333,0.117613,10,3528.378326,196.021018,352.837833,81.073298,1,2
0,0,8,8,11,16,27,36,29,65,0.000333,0.103023,5,1545.338438,85.852135,309.067688,102.053748,1,2
0,0,7,7,10,14,24,34,29,63,0.000333,0.096284,10,2888.526375,160.473688,288.852638,86.52225,1,2
0,0,10,10,12,11,23,45,30,75,0.000333,0.113089,12,4071.20576,226.178098,339.267147,81.073298,1,2
0,0,9,9,11,13,24,45,29,74,0.000333,0.113096,10,3392.872251,188.492903,339.287225,86.159464,1,2
0,0,9,9,11,15,26,35,31,66,0.000333,0.10341,10,3102.290214,172.349456,310.229021,96.657107,1,2
0,0,7,7,10,14,24,34,29,63,0.000333,0.096284,10,2888.526375,160.473688,288.852638,86.52225,1,2
0,0,9,9,10,15,25,40,41,81,0.000333,0.125384,10,3761.523514,208.973529,376.152351,91.82264,1,2
0,0,11,11,10,16,26,46,53,99,0.000333,0.155115,15,6980.152981,387.786277,465.343532,97.219281,1,2
0,0,13,13,10,17,27,52,65,117,0.000333,0.185441,15,8344.827566,463.601531,556.321838,102.706149,1,2
0,0,10,10,11,14,25,44,39,83,0.000333,0.12848,10,3854.400638,214.133369,385.440064,91.356717,1,2
0,0,8,8,11,15,26,40,32,72,0.000333,0.112811,10,3384.316597,188.017589,338.43166,96.657107,1,2
0,0,9,9,11,16,27,49,36,85,0.000333,0.134722,10,4041.654377,224.536354,404.165438,102.053748,1,2
0,0,8,8,10,15,25,42,33,75,0.000333,0.116096,10,3482.892142,193.494008,348.289214,91.82264,1,2
0,0,10,10,10,17,27,49,39,88,0.000333,0.139477,10,4184.301002,232.461167,418.4301,102.706149,1,2
0,0,10,10,11,17,28,41,44,85,0.000333,0.136208,10,4086.251684,227.013982,408.625168,107.540616,1,2
0,0,9,9,10,15,25,34,37,71,0.000333,0.109905,10,3297.137895,183.174327,329.713789,91.82264,1,2
0,0,8,8,14,17,31,41,37,78,0.000333,0.128809,14,5409.982371,300.554576,386.427312,122.789837,1,2
0,0,8,8,13,17,30,40,37,77,0.000333,0.125944,12,4533.96691,251.887051,377.830576,117.592585,1,2
0,0,5,5,10,9,19,29,18,47,0.000333,0.066551,10,1996.525931,110.918107,199.652593,61.748606,1,2
0,0,5,5,10,9,19,29,18,47,0.000333,0.066551,10,1996.525931,110.918107,199.652593,61.748606,1,2
0,0,5,5,10,9,19,29,18,47,0.000333,0.066551,10,1996.525931,110.918107,199.652593,61.748606,1,2
0,0,5,5,10,9,19,29,18,47,0.000333,0.066551,10,1996.525931,110.918107,199.652593,61.748606,1,2
0,0,5,5,10,9,19,29,18,47,0.000333,0.066551,10,1996.525931,110.918107,199.652593,61.748606,1,2
0,0,5,5,10,9,19,29,18,47,0.000333,0.066551,10,1996.525931,110.918107,199.652593,61.748606,1,2
0,0,5,5,10,9,19,29,18,47,0.000333,0.066551,10,1996.525931,110.918107,199.652593,61.748606,1,2
0,0,5,5,10,9,19,29,18,47,0.000333,0.066551,10,1996.525931,110.918107,199.652593,61.748606,1,2
0,0,5,5,10,9,19,29,18,47,0.000333,0.066551,10,1996.525931,110.918107,199.652593,61.748606,1,2
0,0,5,5,10,9,19,29,18,47,0.000333,0.066551,10,1996.525931,110.918107,199.652593,61.748606,1,2
0,0,5,5,10,9,19,29,18,47,0.000333,0.066551,10,1996.525931,110.918107,199.652593,61.748606,1,2
0,0,5,5,10,9,19,29,18,47,0.000333,0.066551,10,1996.525931,110.918107,199.652593,61.748606,1,2
0,0,5,5,10,9,19,29,18,47,0.000333,0.066551,10,1996.525931,110.918107,199.652593,61.748606,1,2
0,0,5,5,10,9,19,29,18,47,0.000333,0.066551,10,1996.525931,110.918107,199.652593,61.748606,1,2
0,0,5,5,10,9,19,29,18,47,0.000333,0.066551,10,1996.525931,110.918107,199.652593,61.748606,1,2
0,0,5,5,10,9,19,29,18,47,0.000333,0.066551,10,1996.525931,110.918107,199.652593,61.748606,1,2
0,0,5,5,10,9,19,29,18,47,0.000333,0.066551,10,1996.525931,110.918107,199.652593,61.748606,1,2
0,0,5,5,10,9,19,29,18,47,0.000333,0.066551,10,1996.525931,110.918107,199.652593,61.748606,1,2
0,0,10,10,12,11,23,46,31,77,0.000333,0.116105,12,4179.771247,232.209514,348.314271,81.073298,1,2
0,0,10,10,11,14,25,45,40,85,0.000333,0.131576,10,3947.277761,219.293209,394.727776,91.356717,1,2
0,0,7,7,10,10,20,35,24,59,0.000333,0.084998,10,2549.937576,141.663199,254.993758,66.438562,1,2
0,0,11,11,11,12,23,52,34,86,0.000333,0.129675,10,3890.263282,216.125738,389.026328,81.073298,1,2
0,0,8,8,11,16,27,37,30,67,0.000333,0.106192,5,1592.887313,88.49374,318.577463,102.053748,1,2
0,0,7,7,10,14,24,35,30,65,0.000333,0.099341,10,2980.225625,165.56809,298.022563,86.52225,1,2
0,0,10,10,12,11,23,46,31,77,0.000333,0.116105,12,4179.771247,232.209514,348.314271,81.073298,1,2
0,0,9,9,11,13,24,46,30,76,0.000333,0.116152,10,3484.571501,193.587306,348.45715,86.159464,1,2
0,0,9,9,11,15,26,36,32,68,0.000333,0.106543,10,3196.299008,177.572167,319.629901,96.657107,1,2
0,0,7,7,10,14,24,35,30,65,0.000333,0.099341,10,2980.225625,165.56809,298.022563,86.52225,1,2
0,0,9,9,10,15,25,41,42,83,0.000333,0.12848,10,3854.400638,214.133369,385.440064,91.82264,1,2
0,0,11,11,10,16,26,47,54,101,0.000333,0.158248,15,7121.166173,395.620343,474.744412,97.219281,1,2
0,0,13,13,10,17,27,53,66,119,0.000333,0.188611,15,8487.474191,471.526344,565.831613,102.706149,1,2
0,0,9,9,11,13,24,43,38,81,0.000333,0.123794,10,3713.819626,206.323313,371.381963,86.159464,1,2
0,0,8,8,11,15,26,41,33,74,0.000333,0.115944,10,3478.325391,193.2403,347.832539,96.657107,1,2
0,0,9,9,11,16,27,50,37,87,0.000333,0.137892,10,4136.752127,229.819563,413.675213,102.053748,1,2
0,0,9,9,10,16,26,45,36,81,0.000333,0.126912,10,3807.356172,211.519787,380.735617,97.219281,1,2
0,0,11,11,10,18,28,52,42,94,0.000333,0.15063,10,4518.913627,251.050757,451.891363,108.277931,1,2
0,0,10,10,11,17,28,50,47,97,0.000333,0.155438,10,4663.134274,259.063015,466.313427,107.540616,1,2
0,0,9,9,10,15,25,35,38,73,0.000333,0.113001,10,3390.015019,188.334168,339.001502,91.82264,1,2
0,0,8,8,14,17,31,42,38,80,0.000333,0.132112,14,5548.699868,308.261104,396.335705,122.789837,1,2
0,0,8,8,13,17,30,41,38,79,0.000333,0.129215,12,4651.732285,258.429571,387.644357,117.592585,1,2
0,0,5,5,11,9,20,30,17,47,0.000333,0.06771,5,1015.653102,56.425172,203.13062,66.583073,1,2
0,0,5,5,11,9,20,30,17,47,0.000333,0.06771,5,1015.653102,56.425172,203.13062,66.583073,1,2
0,0,5,5,11,9,20,30,17,47,0.000333,0.06771,5,1015.653102,56.425172,203.13062,66.583073,1,2
0,0,5,5,11,9,20,30,17,47,0.000333,0.06771,5,1015.653102,56.425172,203.13062,66.583073,1,2
0,0,5,5,11,9,20,30,17,47,0.000333,0.06771,5,1015.653102,56.425172,203.13062,66.583073,1,2
0,0,5,5,11,9,20,30,17,47,0.000333,0.06771,5,1015.653102,56.425172,203.13062,66.583073,1,2
0,0,5,5,11,9,20,30,17,47,0.000333,0.06771,5,1015.653102,56.425172,203.13062,66.583073,1,2
0,0,5,5,11,9,20,30,17,47,0.000333,0.06771,5,1015.653102,56.425172,203.13062,66.583073,1,2
0,0,5,5,11,9,20,30,17,47,0.000333,0.06771,5,1015.653102,56.425172,203.13062,66.583073,1,2
0,0,5,5,11,9,20,30,17,47,0.000333,0.06771,5,1015.653102,56.425172,203.13062,66.583073,1,2
0,0,5,5,11,9,20,30,17,47,0.000333,0.06771,5,1015.653102,56.425172,203.13062,66.583073,1,2
0,0,5,5,11,9,20,30,17,47,0.000333,0.06771,5,1015.653102,56.425172,203.13062,66.583073,1,2
0,0,5,5,11,9,20,30,17,47,0.000333,0.06771,5,1015.653102,56.425172,203.13062,66.583073,1,2
0,0,5,5,11,9,20,30,17,47,0.000333,0.06771,5,1015.653102,56.425172,203.13062,66.583073,1,2
0,0,5,5,11,9,20,30,17,47,0.000333,0.06771,5,1015.653102,56.425172,203.13062,66.583073,1,2
0,0,5,5,11,9,20,30,17,47,0.000333,0.06771,5,1015.653102,56.425172,203.13062,66.583073,1,2
0,0,5,5,11,9,20,30,17,47,0.000333,0.06771,5,1015.653102,56.425172,203.13062,66.583073,1,2
0,0,5,5,11,9,20,30,17,47,0.000333,0.06771,5,1015.653102,56.425172,203.13062,66.583073,1,2
0,0,10,10,13,11,24,47,30,77,0.000333,0.117681,12,4236.505351,235.361408,353.042113,86.159464,1,2
0,0,10,10,12,14,26,46,39,85,0.000333,0.133179,12,4794.448513,266.358251,399.537376,96.322519,1,2
0,0,7,7,11,10,21,36,23,59,0.000333,0.086382,10,2591.467279,143.970404,259.146728,71.273029,1,2
0,0,11,11,12,12,24,53,33,86,0.000333,0.131436,12,4731.681301,262.871183,394.306775,86.0391,1,2
0,0,8,8,12,16,28,38,29,67,0.000333,0.107364,6,1932.556679,107.36426,322.09278,107.01955,1,2
0,0,7,7,11,14,25,36,29,65,0.000333,0.100617,10,3018.506523,167.694807,301.850652,91.356717,1,2
0,0,10,10,13,11,24,47,30,77,0.000333,0.117681,12,4236.505351,235.361408,353.042113,86.159464,1,2
0,0,9,9,12,13,25,47,29,76,0.000333,0.117644,12,4235.196845,235.288714,352.93307,91.125266,1,2
0,0,9,9,12,15,27,37,31,68,0.000333,0.107777,12,3879.988202,215.5549,323.33235,101.622909,1,2
0,0,7,7,11,14,25,36,29,65,0.000333,0.100617,10,3018.506523,167.694807,301.850652,91.356717,1,2
0,0,9,9,11,15,26,42,41,83,0.000333,0.130045,10,3901.364966,216.742498,390.136497,96.657107,1,2
0,0,11,11,11,16,27,48,53,101,0.000333,0.160081,15,7203.654566,400.203031,480.243638,102.053748,1,2
0,0,13,13,11,17,28,54,65,119,0.000333,0.190692,15,8581.128536,476.729363,572.075236,107.540616,1,2
0,0,9,9,12,13,25,44,37,81,0.000333,0.125384,12,4513.828216,250.768234,376.152351,91.125266,1,2
0,0,8,8,12,15,27,42,32,74,0.000333,0.117287,12,4222.340102,234.57445,351.861675,101.622909,1,2
0,0,9,9,12,16,28,51,36,87,0.000333,0.139413,12,5018.878539,278.826585,418.239878,107.01955,1,2
0,0,9,9,11,16,27,46,35,81,0.000333,0.128382,10,3851.458877,213.969938,385.145888,102.053748,1,2
0,0,11,11,11,18,29,53,41,94,0.000333,0.152217,10,4566.502135,253.694563,456.650214,113.112398,1,2
0,0,10,10,12,17,29,43,44,87,0.000333,0.140881,12,5071.732159,281.762898,422.644347,112.506418,1,2
0,0,9,9,11,15,26,36,37,73,0.000333,0.114377,10,3431.320994,190.628944,343.132099,96.657107,1,2
0,0,8,8,15,17,32,43,37,80,0.000333,0.133333,14,5600,311.111111,400,128.090227,1,2
0,0,8,8,14,17,31,42,37,79,0.000333,0.130461,14,5479.341119,304.40784,391.381509,122.789837,1,2
0,0,4,4,10,9,19,31,17,48,0.000333,0.067967,5,1019.502603,56.639034,203.900521,61.748606,1,2
0,0,4,4,10,9,19,31,17,48,0.000333,0.067967,5,1019.502603,56.639034,203.900521,61.748606,1,2
0,0,4,4,10,9,19,31,17,48,0.000333,0.067967,5,1019.502603,56.639034,203.900521,61.748606,1,2
0,0,4,4,10,9,19,31,17,48,0.000333,0.067967,5,1019.502603,56.639034,203.900521,61.748606,1,2
0,0,4,4,10,9,19,31,17,48,0.000333,0.067967,5,1019.502603,56.639034,203.900521,61.748606,1,2
0,0,4,4,10,9,19,31,17,48,0.000333,0.067967,5,1019.502603,56.639034,203.900521,61.748606,1,2
0,0,4,4,10,9,19,31,17,48,0.000333,0.067967,5,1019.502603,56.639034,203.900521,61.748606,1,2
0,0,4,4,10,9,19,31,17,48,0.000333,0.067967,5,1019.502603,56.639034,203.900521,61.748606,1,2
0,0,4,4,10,9,19,31,17,48,0.000333,0.067967,5,1019.502603,56.639034,203.900521,61.748606,1,2
0,0,4,4,10,9,19,31,17,48,0.000333,0.067967,5,1019.502603,56.639034,203.900521,61.748606,1,2
0,0,4,4,10,9,19,31,17,48,0.000333,0.067967,5,1019.502603,56.639034,203.900521,61.748606,1,2
0,0,4,4,10,9,19,31,17,48,0.000333,0.067967,5,1019.502603,56.639034,203.900521,61.748606,1,2
0,0,4,4,10,9,19,31,17,48,0.000333,0.067967,5,1019.502603,56.639034,203.900521,61.748606,1,2
0,0,4,4,10,9,19,31,17,48,0.000333,0.067967,5,1019.502603,56.639034,203.900521,61.748606,1,2
0,0,4,4,10,9,19,31,17,48,0.000333,0.067967,5,1019.502603,56.639034,203.900521,61.748606,1,2
0,0,4,4,10,9,19,31,17,48,0.000333,0.067967,5,1019.502603,56.639034,203.900521,61.748606,1,2
0,0,4,4,10,9,19,31,17,48,0.000333,0.067967,5,1019.502603,56.639034,203.900521,61.748606,1,2
0,0,4,4,10,9,19,31,17,48,0.000333,0.067967,5,1019.502603,56.639034,203.900521,61.748606,1,2
0,0,8,8,12,10,22,46,28,74,0.000333,0.109999,12,3959.975277,219.998627,329.99794,76.238831,1,2
0,0,8,8,11,13,24,45,37,82,0.000333,0.125322,10,3759.669251,208.870514,375.966925,86.159464,1,2
0,0,6,6,10,10,20,37,23,60,0.000333,0.086439,10,2593.156857,144.06427,259.315686,66.438562,1,2
0,0,9,9,11,11,22,52,31,83,0.000333,0.123378,10,3701.328243,205.629347,370.132824,76.107496,1,2
0,0,7,7,11,16,27,39,29,68,0.000333,0.107777,5,1616.661751,89.814542,323.33235,102.053748,1,2
0,0,6,6,10,14,24,37,29,66,0.000333,0.100869,10,3026.07525,168.115292,302.607525,86.52225,1,2
0,0,8,8,12,10,22,46,28,74,0.000333,0.109999,12,3959.975277,219.998627,329.99794,76.238831,1,2
0,0,7,7,11,12,23,46,27,73,0.000333,0.110073,10,3302.200228,183.455568,330.220023,81.073298,1,2
0,0,8,8,11,15,26,38,31,69,0.000333,0.10811,10,3243.303406,180.183523,324.330341,96.657107,1,2
0,0,6,6,10,14,24,37,29,66,0.000333,0.100869,10,3026.07525,168.115292,302.607525,86.52225,1,2
0,0,8,8,10,15,25,43,41,84,0.000333,0.130028,10,3900.839199,216.713289,390.08392,91.82264,1,2
0,0,10,10,10,16,26,49,53,102,0.000333,0.159815,15,7191.672769,399.537376,479.444851,97.219281,1,2
0,0,12,12,10,17,27,55,65,120,0.000333,0.190196,15,8558.797504,475.48875,570.5865,102.706149,1,2
0,0,8,8,11,13,24,45,37,82,0.000333,0.125322,10,3759.669251,208.870514,375.966925,86.159464,1,2
0,0,7,7,11,15,26,43,32,75,0.000333,0.117511,10,3525.329789,195.851655,352.532979,96.657107,1,2
0,0,8,8,11,16,27,52,36,88,0.000333,0.139477,10,4184.301002,232.461167,418.4301,102.053748,1,2
0,0,7,7,10,15,25,45,33,78,0.000333,0.12074,10,3622.207828,201.233768,362.220783,91.82264,1,2
0,0,9,9,10,17,27,52,39,91,0.000333,0.144232,10,4326.947627,240.385979,432.694763,102.706149,1,2
0,0,9,9,11,17,28,44,44,88,0.000333,0.141016,10,4230.472331,235.026241,423.047233,107.540616,1,2
0,0,8,8,10,15,25,37,37,74,0.000333,0.114548,10,3436.45358,190.914088,343.645358,91.82264,1,2
0,0,7,7,14,17,31,44,37,81,0.000333,0.133763,14,5618.058616,312.114368,401.289901,122.789837,1,2
0,0,7,7,13,17,30,43,37,80,0.000333,0.13085,12,4710.614972,261.700832,392.551248,117.592585,1,2
0,0,4,4,10,9,19,31,17,48,0.000333,0.067967,5,1019.502603,56.639034,203.900521,61.748606,1,2
0,0,4,4,10,9,19,31,17,48,0.000333,0.067967,5,1019.502603,56.639034,203.900521,61.748606,1,2
0,0,4,4,10,9,19,31,17,48,0.000333,0.067967,5,1019.502603,56.639034,203.900521,61.748606,1,2
0,0,4,4,10,9,19,31,17,48,0.000333,0.067967,5,1019.502603,56.639034,203.900521,61.748606,1,2
0,0,4,4,10,9,19,31,17,48,0.000333,0.067967,5,1019.502603,56.639034,203.900521,61.748606,1,2
0,0,4,4,10,9,19,31,17,48,0.000333,0.067967,5,1019.502603,56.639034,203.900521,61.748606,1,2
0,0,4,4,10,9,19,31,17,48,0.000333,0.067967,5,1019.502603,56.639034,203.900521,61.748606,1,2
0,0,4,4,10,9,19,31,17,48,0.000333,0.067967,5,1019.502603,56.639034,203.900521,61.748606,1,2
0,0,4,4,10,9,19,31,17,48,0.000333,0.067967,5,1019.502603,56.639034,203.900521,61.748606,1,2
0,0,4,4,10,9,19,31,17,48,0.000333,0.067967,5,1019.502603,56.639034,203.900521,61.748606,1,2
0,0,4,4,10,9,19,31,17,48,0.000333,0.067967,5,1019.502603,56.639034,203.900521,61.748606,1,2
0,0,4,4,10,9,19,31,17,48,0.000333,0.067967,5,1019.502603,56.639034,203.900521,61.748606,1,2
0,0,4,4,10,9,19,31,17,48,0.000333,0.067967,5,1019.502603,56.639034,203.900521,61.748606,1,2
0,0,4,4,10,9,19,31,17,48,0.000333,0.067967,5,1019.502603,56.639034,203.900521,61.748606,1,2
0,0,4,4,10,9,19,31,17,48,0.000333,0.067967,5,1019.502603,56.639034,203.900521,61.748606,1,2
0,0,4,4,10,9,19,31,17,48,0.000333,0.067967,5,1019.502603,56.639034,203.900521,61.748606,1,2
0,0,4,4,10,9,19,31,17,48,0.000333,0.067967,5,1019.502603,56.639034,203.900521,61.748606,1,2
0,0,4,4,10,9,19,31,17,48,0.000333,0.067967,5,1019.502603,56.639034,203.900521,61.748606,1,2
0,0,8,8,12,10,22,46,28,74,0.000333,0.109999,12,3959.975277,219.998627,329.99794,76.238831,1,2
0,0,8,8,11,13,24,45,37,82,0.000333,0.125322,10,3759.669251,208.870514,375.966925,86.159464,1,2
0,0,6,6,10,10,20,37,23,60,0.000333,0.086439,10,2593.156857,144.06427,259.315686,66.438562,1,2
0,0,9,9,11,11,22,52,31,83,0.000333,0.123378,10,3701.328243,205.629347,370.132824,76.107496,1,2
0,0,7,7,11,16,27,39,29,68,0.000333,0.107777,5,1616.661751,89.814542,323.33235,102.053748,1,2
0,0,6,6,10,14,24,37,29,66,0.000333,0.100869,10,3026.07525,168.115292,302.607525,86.52225,1,2
0,0,8,8,12,10,22,46,28,74,0.000333,0.109999,12,3959.975277,219.998627,329.99794,76.238831,1,2
0,0,7,7,11,12,23,46,27,73,0.000333,0.110073,10,3302.200228,183.455568,330.220023,81.073298,1,2
0,0,8,8,11,15,26,38,31,69,0.000333,0.10811,10,3243.303406,180.183523,324.330341,96.657107,1,2
0,0,6,6,10,14,24,37,29,66,0.000333,0.100869,10,3026.07525,168.115292,302.607525,86.52225,1,2
0,0,8,8,10,15,25,43,41,84,0.000333,0.130028,10,3900.839199,216.713289,390.08392,91.82264,1,2
0,0,10,10,10,16,26,49,53,102,0.000333,0.159815,15,7191.672769,399.537376,479.444851,97.219281,1,2
0,0,12,12,10,17,27,55,65,120,0.000333,0.190196,15,8558.797504,475.48875,570.5865,102.706149,1,2
0,0,8,8,11,13,24,45,37,82,0.000333,0.125322,10,3759.669251,208.870514,375.966925,86.159464,1,2
0,0,7,7,11,15,26,43,32,75,0.000333,0.117511,10,3525.329789,195.851655,352.532979,96.657107,1,2
0,0,8,8,11,16,27,52,36,88,0.000333,0.139477,10,4184.301002,232.461167,418.4301,102.053748,1,2
0,0,7,7,10,15,25,45,33,78,0.000333,0.12074,10,3622.207828,201.233768,362.220783,91.82264,1,2
0,0,8,8,10,16,26,48,36,84,0.000333,0.131612,10,3948.369363,219.353854,394.836936,97.219281,1,2
0,0,9,9,11,17,28,44,44,88,0.000333,0.141016,10,4230.472331,235.026241,423.047233,107.540616,1,2
0,0,8,8,10,15,25,37,37,74,0.000333,0.114548,10,3436.45358,190.914088,343.645358,91.82264,1,2
0,0,7,7,14,17,31,44,37,81,0.000333,0.133763,14,5618.058616,312.114368,401.289901,122.789837,1,2
0,0,7,7,13,17,30,43,37,80,0.000333,0.13085,12,4710.614972,261.700832,392.551248,117.592585,1,2
0,0,4,4,10,9,19,27,16,43,0.000333,0.060887,5,913.304415,50.739134,182.660883,61.748606,1,2
0,0,4,4,10,9,19,27,16,43,0.000333,0.060887,5,913.304415,50.739134,182.660883,61.748606,1,2
0,0,4,4,10,9,19,27,16,43,0.000333,0.060887,5,913.304415,50.739134,182.660883,61.748606,1,2
0,0,4,4,10,9,19,27,16,43,0.000333,0.060887,5,913.304415,50.739134,182.660883,61.748606,1,2
0,0,4,4,10,9,19,27,16,43,0.000333,0.060887,5,913.304415,50.739134,182.660883,61.748606,1,2
0,0,4,4,10,9,19,27,16,43,0.000333,0.060887,5,913.304415,50.739134,182.660883,61.748606,1,2
0,0,4,4,10,9,19,27,16,43,0.000333,0.060887,5,913.304415,50.739134,182.660883,61.748606,1,2
0,0,4,4,10,9,19,27,16,43,0.000333,0.060887,5,913.304415,50.739134,182.660883,61.748606,1,2
0,0,4,4,10,9,19,27,16,43,0.000333,0.060887,5,913.304415,50.739134,182.660883,61.748606,1,2
0,0,4,4,10,9,19,27,16,43,0.000333,0.060887,5,913.304415,50.739134,182.660883,61.748606,1,2
0,0,5,5,9,9,18,23,16,39,0.000333,0.054209,4,650.5083,36.13935,162.627075,57.05865,1,2
0,0,5,5,9,9,18,23,16,39,0.000333,0.054209,4,650.5083,36.13935,162.627075,57.05865,1,2
0,0,5,5,9,9,18,23,16,39,0.000333,0.054209,4,650.5083,36.13935,162.627075,57.05865,1,2
0,0,5,5,9,9,18,23,16,39,0.000333,0.054209,4,650.5083,36.13935,162.627075,57.05865,1,2
0,0,5,5,9,9,18,23,16,39,0.000333,0.054209,4,650.5083,36.13935,162.627075,57.05865,1,2
0,0,5,5,9,9,18,23,16,39,0.000333,0.054209,4,650.5083,36.13935,162.627075,57.05865,1,2
0,0,5,5,9,9,18,23,16,39,0.000333,0.054209,4,650.5083,36.13935,162.627075,57.05865,1,2
0,0,5,5,9,9,18,23,16,39,0.000333,0.054209,4,650.5083,36.13935,162.627075,57.05865,1,2
0,0,5,5,9,9,18,23,16,39,0.000333,0.054209,4,650.5083,36.13935,162.627075,57.05865,1,2
0,0,5,5,9,9,18,23,16,39,0.000333,0.054209,4,650.5083,36.13935,162.627075,57.05865,1,2
0,0,4,4,9,8,17,23,14,37,0.000333,0.050412,4,604.944501,33.608028,151.236125,52.529325,1,2
0,0,5,5,9,9,18,23,16,39,0.000333,0.054209,4,650.5083,36.13935,162.627075,57.05865,1,2
0,0,5,5,9,9,18,23,16,39,0.000333,0.054209,4,650.5083,36.13935,162.627075,57.05865,1,2
0,0,5,5,9,9,18,23,16,39,0.000333,0.054209,4,650.5083,36.13935,162.627075,57.05865,1,2
0,0,5,5,9,9,18,23,16,39,0.000333,0.054209,4,650.5083,36.13935,162.627075,57.05865,1,2
0,0,5,5,9,9,18,23,16,39,0.000333,0.054209,4,650.5083,36.13935,162.627075,57.05865,1,2
0,0,3,3,9,8,17,18,11,29,0.000333,0.039512,4,474.14569,26.341427,118.536422,52.529325,1,2
0,0,11,11,12,10,22,49,33,82,0.000333,0.121891,18,6582.121069,365.673393,365.673393,76.238831,1,2
0,0,9,9,11,13,24,37,36,73,0.000333,0.111567,10,3347.022626,185.945701,334.702263,86.159464,1,2
0,0,5,5,10,9,19,24,17,41,0.000333,0.058055,5,870.82514,48.379174,174.165028,61.748606,1,2
0,0,8,8,11,11,22,42,27,69,0.000333,0.102567,10,3077.007817,170.944879,307.700782,76.107496,1,2
0,0,8,8,11,16,27,34,29,63,0.000333,0.099853,5,1497.789563,83.210531,299.557913,102.053748,1,2
0,0,5,5,10,13,23,24,23,47,0.000333,0.070869,5,1063.03706,59.057614,212.607412,81.324997,1,2
0,0,5,5,10,9,19,24,15,39,0.000333,0.055223,5,828.345865,46.019215,165.669173,61.748606,1,2
0,0,9,9,11,13,24,44,30,74,0.000333,0.113096,10,3392.872251,188.492903,339.287225,86.159464,1,2
0,0,6,6,10,13,23,24,23,47,0.000333,0.070869,5,1063.03706,59.057614,212.607412,81.324997,1,2
0,0,8,8,10,15,25,35,32,67,0.000333,0.103713,10,3111.383647,172.854647,311.138365,91.82264,1,2
0,0,10,10,10,16,26,41,44,85,0.000333,0.133179,10,3995.37376,221.965209,399.537376,97.219281,1,2
0,0,12,12,10,17,27,47,56,103,0.000333,0.163251,15,7346.301191,408.127844,489.753413,102.706149,1,2
0,0,14,14,10,18,28,53,68,121,0.000333,0.193897,15,8725.349184,484.741621,581.689946,108.277931,1,2
0,0,6,6,10,13,23,30,22,52,0.000333,0.078408,5,1176.126109,65.340339,235.225222,81.324997,1,2
0,0,9,9,11,16,27,41,35,76,0.000333,0.120457,10,3613.714502,200.761917,361.37145,102.053748,1,2
0,0,10,10,11,17,28,50,39,89,0.000333,0.142618,10,4278.545881,237.696993,427.854588,107.540616,1,2
0,0,9,9,10,16,26,43,36,79,0.000333,0.123778,10,3713.347377,206.297077,371.334738,97.219281,1,2
0,0,11,11,10,18,28,50,42,92,0.000333,0.147426,10,4422.766528,245.709252,442.276653,108.277931,1,2
0,0,11,11,11,18,29,42,47,89,0.000333,0.14412,10,4323.603086,240.200171,432.360309,113.112398,1,2
0,0,9,9,10,15,25,35,35,70,0.000333,0.108357,10,3250.699333,180.594407,325.069933,91.82264,1,2
0,0,9,9,14,18,32,42,40,82,0.000333,0.136667,14,5740,318.888889,410,128.361619,1,2
0,0,9,9,13,18,31,41,40,81,0.000333,0.133763,12,4815.478814,267.526601,401.289901,123.164366,1,2
0,0,7,7,10,11,21,36,23,59,0.000333,0.086382,10,2591.467279,143.970404,259.146728,71.273029,1,2
0,0,8,8,10,11,21,38,25,63,0.000333,0.092239,10,2767.159976,153.73111,276.715998,71.273029,1,2
0,0,8,8,10,11,21,38,25,63,0.000333,0.092239,10,2767.159976,153.73111,276.715998,71.273029,1,2
0,0,8,8,10,11,21,38,25,63,0.000333,0.092239,10,2767.159976,153.73111,276.715998,71.273029,1,2
0,0,8,8,10,11,21,38,25,63,0.000333,0.092239,10,2767.159976,153.73111,276.715998,71.273029,1,2
0,0,8,8,10,11,21,38,25,63,0.000333,0.092239,10,2767.159976,153.73111,276.715998,71.273029,1,2
0,0,8,8,10,11,21,38,25,63,0.000333,0.092239,10,2767.159976,153.73111,276.715998,71.273029,1,2
0,0,8,8,10,11,21,38,25,63,0.000333,0.092239,10,2767.159976,153.73111,276.715998,71.273029,1,2
0,0,8,8,10,11,21,38,25,63,0.000333,0.092239,10,2767.159976,153.73111,276.715998,71.273029,1,2
0,0,8,8,10,11,21,38,25,63,0.000333,0.092239,10,2767.159976,153.73111,276.715998,71.273029,1,2
0,0,8,8,10,11,21,38,25,63,0.000333,0.092239,10,2767.159976,153.73111,276.715998,71.273029,1,2
0,0,8,8,10,11,21,38,25,63,0.000333,0.092239,10,2767.159976,153.73111,276.715998,71.273029,1,2
0,0,8,8,10,11,21,38,25,63,0.000333,0.092239,10,2767.159976,153.73111,276.715998,71.273029,1,2
0,0,8,8,10,11,21,38,25,63,0.000333,0.092239,10,2767.159976,153.73111,276.715998,71.273029,1,2
0,0,8,8,10,11,21,38,25,63,0.000333,0.092239,10,2767.159976,153.73111,276.715998,71.273029,1,2
0,0,8,8,10,11,21,38,25,63,0.000333,0.092239,10,2767.159976,153.73111,276.715998,71.273029,1,2
0,0,8,8,10,11,21,38,25,63,0.000333,0.092239,10,2767.159976,153.73111,276.715998,71.273029,1,2
0,0,8,8,10,11,21,38,25,63,0.000333,0.092239,10,2767.159976,153.73111,276.715998,71.273029,1,2
0,0,10,10,10,12,22,44,31,75,0.000333,0.111486,10,3344.573714,185.809651,334.457371,76.238831,1,2
0,0,12,12,11,13,24,54,36,90,0.000333,0.137549,10,4126.466251,229.248125,412.646625,86.159464,1,2
0,0,9,9,11,16,27,41,31,72,0.000333,0.114117,5,1711.759501,95.09775,342.3519,102.053748,1,2
0,0,9,9,10,15,25,42,33,75,0.000333,0.116096,10,3482.892142,193.494008,348.289214,91.82264,1,2
0,0,11,11,11,14,25,53,35,88,0.000333,0.13622,10,4086.593447,227.032969,408.659345,91.356717,1,2
0,0,11,11,10,15,25,44,35,79,0.000333,0.122288,10,3668.64639,203.813688,366.864639,91.82264,1,2
0,0,10,10,10,15,25,44,35,79,0.000333,0.122288,10,3668.64639,203.813688,366.864639,91.82264,1,2
0,0,12,12,10,16,26,50,45,95,0.000333,0.148847,10,4465.417732,248.078763,446.541773,97.219281,1,2
0,0,14,14,10,17,27,56,55,111,0.000333,0.175931,15,7916.887691,439.827094,527.792513,102.706149,1,2
0,0,16,16,10,21,31,62,67,129,0.000333,0.21303,15,9586.369861,532.576103,639.091324,125.457947,1,2
0,0,11,11,11,16,27,50,38,88,0.000333,0.139477,10,4184.301002,232.461167,418.4301,102.053748,1,2
0,0,12,12,11,17,28,59,42,101,0.000333,0.161848,10,4855.428471,269.746026,485.542847,107.540616,1,2
0,0,11,11,10,16,26,52,39,91,0.000333,0.14258,10,4277.400144,237.633341,427.740014,97.219281,1,2
0,0,13,13,10,18,28,59,45,104,0.000333,0.166655,10,4999.649119,277.758284,499.964912,108.277931,1,2
0,0,13,13,11,18,29,51,48,99,0.000333,0.160313,10,4809.401185,267.188955,480.940119,113.112398,1,2
0,0,11,11,10,15,25,44,37,81,0.000333,0.125384,10,3761.523514,208.973529,376.152351,91.82264,1,2
0,0,11,11,14,18,32,51,42,93,0.000333,0.155,14,6510,361.666667,465,128.361619,1,2
0,0,11,11,13,18,31,50,42,92,0.000333,0.151929,12,5469.432727,303.857374,455.786061,123.164366,1,2
0,0,8,8,10,11,21,38,25,63,0.000333,0.092239,10,2767.159976,153.73111,276.715998,71.273029,1,2
0,0,8,8,10,11,21,38,25,63,0.000333,0.092239,10,2767.159976,153.73111,276.715998,71.273029,1,2
0,0,8,8,10,11,21,38,25,63,0.000333,0.092239,10,2767.159976,153.73111,276.715998,71.273029,1,2
0,0,8,8,10,11,21,38,25,63,0.000333,0.092239,10,2767.159976,153.73111,276.715998,71.273029,1,2
0,0,8,8,10,11,21,38,25,63,0.000333,0.092239,10,2767.159976,153.73111,276.715998,71.273029,1,2
0,0,8,8,10,11,21,38,25,63,0.000333,0.092239,10,2767.159976,153.73111,276.715998,71.273029,1,2
0,0,8,8,10,11,21,38,25,63,0.000333,0.092239,10,2767.159976,153.73111,276.715998,71.273029,1,2
0,0,8,8,10,11,21,38,25,63,0.000333,0.092239,10,2767.159976,153.73111,276.715998,71.273029,1,2
0,0,8,8,10,11,21,38,25,63,0.000333,0.092239,10,2767.159976,153.73111,276.715998,71.273029,1,2
0,0,8,8,10,11,21,38,25,63,0.000333,0.092239,10,2767.159976,153.73111,276.715998,71.273029,1,2
0,0,8,8,10,11,21,38,25,63,0.000333,0.092239,10,2767.159976,153.73111,276.715998,71.273029,1,2
0,0,8,8,10,11,21,38,25,63,0.000333,0.092239,10,2767.159976,153.73111,276.715998,71.273029,1,2
0,0,8,8,10,11,21,38,25,63,0.000333,0.092239,10,2767.159976,153.73111,276.715998,71.273029,1,2
0,0,8,8,10,11,21,38,25,63,0.000333,0.092239,10,2767.159976,153.73111,276.715998,71.273029,1,2
0,0,8,8,10,11,21,38,25,63,0.000333,0.092239,10,2767.159976,153.73111,276.715998,71.273029,1,2
0,0,8,8,10,11,21,38,25,63,0.000333,0.092239,10,2767.159976,153.73111,276.715998,71.273029,1,2
0,0,8,8,10,11,21,38,25,63,0.000333,0.092239,10,2767.159976,153.73111,276.715998,71.273029,1,2
0,0,8,8,10,11,21,38,25,63,0.000333,0.092239,10,2767.159976,153.73111,276.715998,71.273029,1,2
0,0,10,10,10,12,22,44,31,75,0.000333,0.111486,10,3344.573714,185.809651,334.457371,76.238831,1,2
0,0,13,13,11,13,24,59,39,98,0.000333,0.149775,15,6739.894876,374.438604,449.326325,86.159464,1,2
0,0,10,10,11,16,27,43,33,76,0.000333,0.120457,10,3613.714502,200.761917,361.37145,102.053748,1,2
0,0,10,10,10,15,25,44,35,79,0.000333,0.122288,10,3668.64639,203.813688,366.864639,91.82264,1,2
0,0,11,11,11,14,25,53,35,88,0.000333,0.13622,10,4086.593447,227.032969,408.659345,91.356717,1,2
0,0,11,11,10,15,25,44,35,79,0.000333,0.122288,10,3668.64639,203.813688,366.864639,91.82264,1,2
0,0,10,10,10,15,25,44,35,79,0.000333,0.122288,10,3668.64639,203.813688,366.864639,91.82264,1,2
0,0,12,12,10,16,26,50,45,95,0.000333,0.148847,10,4465.417732,248.078763,446.541773,97.219281,1,2
0,0,14,14,10,17,27,56,55,111,0.000333,0.175931,15,7916.887691,439.827094,527.792513,102.706149,1,2
0,0,16,16,10,20,30,62,70,132,0.000333,0.215903,15,9715.643379,539.757966,647.709559,119.657843,1,2
0,0,11,11,11,16,27,50,38,88,0.000333,0.139477,10,4184.301002,232.461167,418.4301,102.053748,1,2
0,0,12,12,11,17,28,59,42,101,0.000333,0.161848,10,4855.428471,269.746026,485.542847,107.540616,1,2
0,0,11,11,10,16,26,52,39,91,0.000333,0.14258,10,4277.400144,237.633341,427.740014,97.219281,1,2
0,0,13,13,10,18,28,59,45,104,0.000333,0.166655,10,4999.649119,277.758284,499.964912,108.277931,1,2
0,0,13,13,11,18,29,51,48,99,0.000333,0.160313,10,4809.401185,267.188955,480.940119,113.112398,1,2
0,0,11,11,10,15,25,44,37,81,0.000333,0.125384,10,3761.523514,208.973529,376.152351,91.82264,1,2
0,0,11,11,14,18,32,51,42,93,0.000333,0.155,14,6510,361.666667,465,128.361619,1,2
0,0,11,11,13,18,31,50,42,92,0.000333,0.151929,12,5469.432727,303.857374,455.786061,123.164366,1,2
0,0,8,8,9,10,19,29,22,51,0.000333,0.072215,8,1733.154425,96.286357,216.644303,61.748606,1,2
0,0,8,8,9,10,19,29,22,51,0.000333,0.072215,8,1733.154425,96.286357,216.644303,61.748606,1,2
0,0,8,8,9,10,19,29,22,51,0.000333,0.072215,8,1733.154425,96.286357,216.644303,61.748606,1,2
0,0,8,8,9,10,19,29,22,51,0.000333,0.072215,8,1733.154425,96.286357,216.644303,61.748606,1,2
0,0,8,8,9,10,19,29,22,51,0.000333,0.072215,8,1733.154425,96.286357,216.644303,61.748606,1,2
0,0,8,8,9,10,19,29,22,51,0.000333,0.072215,8,1733.154425,96.286357,216.644303,61.748606,1,2
0,0,8,8,9,10,19,29,22,51,0.000333,0.072215,8,1733.154425,96.286357,216.644303,61.748606,1,2
0,0,8,8,9,10,19,29,22,51,0.000333,0.072215,8,1733.154425,96.286357,216.644303,61.748606,1,2
0,0,8,8,9,10,19,29,22,51,0.000333,0.072215,8,1733.154425,96.286357,216.644303,61.748606,1,2
0,0,8,8,9,10,19,29,22,51,0.000333,0.072215,8,1733.154425,96.286357,216.644303,61.748606,1,2
0,0,8,8,9,10,19,29,22,51,0.000333,0.072215,8,1733.154425,96.286357,216.644303,61.748606,1,2
0,0,8,8,9,10,19,29,22,51,0.000333,0.072215,8,1733.154425,96.286357,216.644303,61.748606,1,2
0,0,8,8,9,10,19,29,22,51,0.000333,0.072215,8,1733.154425,96.286357,216.644303,61.748606,1,2
0,0,8,8,9,10,19,29,22,51,0.000333,0.072215,8,1733.154425,96.286357,216.644303,61.748606,1,2
0,0,8,8,9,10,19,29,22,51,0.000333,0.072215,8,1733.154425,96.286357,216.644303,61.748606,1,2
0,0,8,8,9,10,19,29,22,51,0.000333,0.072215,8,1733.154425,96.286357,216.644303,61.748606,1,2
0,0,12,12,9,10,19,44,32,76,0.000333,0.107614,12,3874.109892,215.228327,322.842491,61.748606,1,2
0,0,12,12,9,10,19,44,32,76,0.000333,0.107614,12,3874.109892,215.228327,322.842491,61.748606,1,2
0,0,12,12,9,10,19,44,32,76,0.000333,0.107614,12,3874.109892,215.228327,322.842491,61.748606,1,2
0,0,13,13,10,12,22,50,36,86,0.000333,0.127837,15,5752.666788,319.592599,383.511119,76.238831,1,2
0,0,9,9,10,15,25,32,28,60,0.000333,0.092877,5,1393.156857,77.397603,278.631371,91.82264,1,2
0,0,10,10,9,14,23,35,32,67,0.000333,0.101026,8,2424.629208,134.701623,303.078651,81.832294,1,2
0,0,11,11,10,13,23,44,32,76,0.000333,0.114597,10,3437.907087,190.994838,343.790709,81.324997,1,2
0,0,11,11,9,14,23,35,32,67,0.000333,0.101026,8,2424.629208,134.701623,303.078651,81.832294,1,2
0,0,10,10,9,14,23,35,32,67,0.000333,0.101026,8,2424.629208,134.701623,303.078651,81.832294,1,2
0,0,12,12,9,15,24,41,42,83,0.000333,0.126851,8,3044.4151,169.134172,380.551888,87.132684,1,2
0,0,14,14,9,16,25,47,52,99,0.000333,0.153247,12,5516.901153,306.494509,459.741763,92.529325,1,2
0,0,16,16,9,17,26,53,62,115,0.000333,0.180184,12,6486.606811,360.367045,540.550568,98.016193,1,2
0,0,11,11,10,15,25,41,35,76,0.000333,0.117644,10,3529.330704,196.073928,352.93307,91.82264,1,2
0,0,12,12,10,16,26,50,39,89,0.000333,0.139446,10,4183.391349,232.410631,418.339135,97.219281,1,2
0,0,11,11,9,15,24,43,36,79,0.000333,0.120737,8,2897.6963,160.983128,362.212038,87.132684,1,2
0,0,13,13,9,17,26,50,42,92,0.000333,0.144147,8,3459.523633,192.195757,432.440454,98.016193,1,2
0,0,13,13,10,17,27,42,45,87,0.000333,0.137892,10,4136.752127,229.819563,413.675213,102.706149,1,2
0,0,11,11,9,14,23,35,34,69,0.000333,0.104042,8,2497.0062,138.722567,312.125775,81.832294,1,2
0,0,11,11,13,17,30,42,39,81,0.000333,0.132486,12,4769.497659,264.972092,397.458138,117.592585,1,2
0,0,11,11,12,17,29,41,39,80,0.000333,0.129546,12,4663.661755,259.09232,388.63848,112.506418,1,2
0,0,8,8,9,10,19,29,22,51,0.000333,0.072215,8,1733.154425,96.286357,216.644303,61.748606,1,2
0,0,8,8,9,10,19,29,22,51,0.000333,0.072215,8,1733.154425,96.286357,216.644303,61.748606,1,2
0,0,8,8,9,10,19,29,22,51,0.000333,0.072215,8,1733.154425,96.286357,216.644303,61.748606,1,2
0,0,8,8,9,10,19,29,22,51,0.000333,0.072215,8,1733.154425,96.286357,216.644303,61.748606,1,2
0,0,8,8,9,10,19,29,22,51,0.000333,0.072215,8,1733.154425,96.286357,216.644303,61.748606,1,2
0,0,8,8,9,10,19,29,22,51,0.000333,0.072215,8,1733.154425,96.286357,216.644303,61.748606,1,2
0,0,8,8,9,10,19,29,22,51,0.000333,0.072215,8,1733.154425,96.286357,216.644303,61.748606,1,2
0,0,8,8,9,10,19,29,22,51,0.000333,0.072215,8,1733.154425,96.286357,216.644303,61.748606,1,2
0,0,8,8,9,10,19,29,22,51,0.000333,0.072215,8,1733.154425,96.286357,216.644303,61.748606,1,2
0,0,8,8,9,10,19,29,22,51,0.000333,0.072215,8,1733.154425,96.286357,216.644303,61.748606,1,2
0,0,8,8,9,10,19,29,22,51,0.000333,0.072215,8,1733.154425,96.286357,216.644303,61.748606,1,2
0,0,8,8,9,10,19,29,22,51,0.000333,0.072215,8,1733.154425,96.286357,216.644303,61.748606,1,2
0,0,8,8,9,10,19,29,22,51,0.000333,0.072215,8,1733.154425,96.286357,216.644303,61.748606,1,2
0,0,8,8,9,10,19,29,22,51,0.000333,0.072215,8,1733.154425,96.286357,216.644303,61.748606,1,2
0,0,8,8,9,10,19,29,22,51,0.000333,0.072215,8,1733.154425,96.286357,216.644303,61.748606,1,2
0,0,8,8,9,10,19,29,22,51,0.000333,0.072215,8,1733.154425,96.286357,216.644303,61.748606,1,2
0,0,8,8,9,10,19,29,22,51,0.000333,0.072215,8,1733.154425,96.286357,216.644303,61.748606,1,2
0,0,8,8,9,10,19,29,22,51,0.000333,0.072215,8,1733.154425,96.286357,216.644303,61.748606,1,2
0,0,10,10,9,11,20,35,28,63,0.000333,0.09076,8,2178.25176,121.013987,272.28147,66.583073,1,2
0,0,13,13,10,12,22,50,36,86,0.000333,0.127837,15,5752.666788,319.592599,383.511119,76.238831,1,2
0,0,9,9,10,15,25,32,28,60,0.000333,0.092877,5,1393.156857,77.397603,278.631371,91.82264,1,2
0,0,10,10,9,14,23,35,32,67,0.000333,0.101026,8,2424.629208,134.701623,303.078651,81.832294,1,2
0,0,11,11,10,13,23,44,32,76,0.000333,0.114597,10,3437.907087,190.994838,343.790709,81.324997,1,2
0,0,11,11,9,14,23,35,32,67,0.000333,0.101026,8,2424.629208,134.701623,303.078651,81.832294,1,2
0,0,10,10,9,14,23,35,32,67,0.000333,0.101026,8,2424.629208,134.701623,303.078651,81.832294,1,2
0,0,12,12,9,15,24,41,42,83,0.000333,0.126851,8,3044.4151,169.134172,380.551888,87.132684,1,2
0,0,14,14,9,16,25,47,52,99,0.000333,0.153247,12,5516.901153,306.494509,459.741763,92.529325,1,2
0,0,16,16,9,20,29,53,64,117,0.000333,0.189461,12,6820.605317,378.922518,568.383776,114.967887,1,2
0,0,11,11,10,15,25,41,35,76,0.000333,0.117644,10,3529.330704,196.073928,352.93307,91.82264,1,2
0,0,12,12,10,16,26,50,39,89,0.000333,0.139446,10,4183.391349,232.410631,418.339135,97.219281,1,2
0,0,11,11,9,15,24,43,36,79,0.000333,0.120737,8,2897.6963,160.983128,362.212038,87.132684,1,2
0,0,13,13,9,17,26,50,42,92,0.000333,0.144147,8,3459.523633,192.195757,432.440454,98.016193,1,2
0,0,13,13,10,17,27,42,45,87,0.000333,0.137892,10,4136.752127,229.819563,413.675213,102.706149,1,2
0,0,11,11,9,14,23,35,34,69,0.000333,0.104042,8,2497.0062,138.722567,312.125775,81.832294,1,2
0,0,11,11,13,17,30,42,39,81,0.000333,0.132486,12,4769.497659,264.972092,397.458138,117.592585,1,2
0,0,11,11,12,17,29,41,39,80,0.000333,0.129546,12,4663.661755,259.09232,388.63848,112.506418,1,2
0,0,8,8,10,11,21,38,25,63,0.000333,0.092239,10,2767.159976,153.73111,276.715998,71.273029,1,2
0,0,8,8,10,11,21,38,25,63,0.000333,0.092239,10,2767.159976,153.73111,276.715998,71.273029,1,2
0,0,8,8,10,11,21,38,25,63,0.000333,0.092239,10,2767.159976,153.73111,276.715998,71.273029,1,2
0,0,8,8,10,11,21,38,25,63,0.000333,0.092239,10,2767.159976,153.73111,276.715998,71.273029,1,2
0,0,8,8,10,11,21,38,25,63,0.000333,0.092239,10,2767.159976,153.73111,276.715998,71.273029,1,2
0,0,8,8,10,11,21,38,25,63,0.000333,0.092239,10,2767.159976,153.73111,276.715998,71.273029,1,2
0,0,8,8,10,11,21,38,25,63,0.000333,0.092239,10,2767.159976,153.73111,276.715998,71.273029,1,2
0,0,8,8,10,11,21,38,25,63,0.000333,0.092239,10,2767.159976,153.73111,276.715998,71.273029,1,2
0,0,8,8,10,11,21,38,25,63,0.000333,0.092239,10,2767.159976,153.73111,276.715998,71.273029,1,2
0,0,8,8,10,11,21,38,25,63,0.000333,0.092239,10,2767.159976,153.73111,276.715998,71.273029,1,2
0,0,8,8,10,11,21,38,25,63,0.000333,0.092239,10,2767.159976,153.73111,276.715998,71.273029,1,2
0,0,8,8,10,11,21,38,25,63,0.000333,0.092239,10,2767.159976,153.73111,276.715998,71.273029,1,2
0,0,8,8,10,11,21,38,25,63,0.000333,0.092239,10,2767.159976,153.73111,276.715998,71.273029,1,2
0,0,8,8,10,11,21,38,25,63,0.000333,0.092239,10,2767.159976,153.73111,276.715998,71.273029,1,2
0,0,8,8,10,11,21,38,25,63,0.000333,0.092239,10,2767.159976,153.73111,276.715998,71.273029,1,2
0,0,8,8,10,11,21,38,25,63,0.000333,0.092239,10,2767.159976,153.73111,276.715998,71.273029,1,2
0,0,8,8,10,11,21,38,25,63,0.000333,0.092239,10,2767.159976,153.73111,276.715998,71.273029,1,2
0,0,8,8,10,11,21,38,25,63,0.000333,0.092239,10,2767.159976,153.73111,276.715998,71.273029,1,2
0,0,10,10,10,12,22,44,31,75,0.000333,0.111486,10,3344.573714,185.809651,334.457371,76.238831,1,2
0,0,13,13,11,13,24,59,39,98,0.000333,0.149775,15,6739.894876,374.438604,449.326325,86.159464,1,2
0,0,10,10,11,16,27,43,33,76,0.000333,0.120457,10,3613.714502,200.761917,361.37145,102.053748,1,2
0,0,10,10,10,15,25,44,35,79,0.000333,0.122288,10,3668.64639,203.813688,366.864639,91.82264,1,2
0,0,11,11,11,14,25,53,35,88,0.000333,0.13622,10,4086.593447,227.032969,408.659345,91.356717,1,2
0,0,11,11,10,15,25,44,35,79,0.000333,0.122288,10,3668.64639,203.813688,366.864639,91.82264,1,2
0,0,10,10,10,15,25,44,35,79,0.000333,0.122288,10,3668.64639,203.813688,366.864639,91.82264,1,2
0,0,12,12,10,16,26,50,45,95,0.000333,0.148847,10,4465.417732,248.078763,446.541773,97.219281,1,2
0,0,14,14,10,17,27,56,55,111,0.000333,0.175931,15,7916.887691,439.827094,527.792513,102.706149,1,2
0,0,16,16,10,18,28,62,65,127,0.000333,0.203511,15,9158.011127,508.778396,610.534075,108.277931,1,2
0,0,11,11,11,16,27,50,38,88,0.000333,0.139477,10,4184.301002,232.461167,418.4301,102.053748,1,2
0,0,12,12,11,17,28,59,42,101,0.000333,0.161848,10,4855.428471,269.746026,485.542847,107.540616,1,2
0,0,11,11,10,16,26,52,39,91,0.000333,0.14258,10,4277.400144,237.633341,427.740014,97.219281,1,2
0,0,13,13,10,18,28,59,45,104,0.000333,0.166655,10,4999.649119,277.758284,499.964912,108.277931,1,2
0,0,13,13,11,18,29,51,48,99,0.000333,0.160313,10,4809.401185,267.188955,480.940119,113.112398,1,2
0,0,11,11,10,15,25,44,37,81,0.000333,0.125384,10,3761.523514,208.973529,376.152351,91.82264,1,2
0,0,11,11,14,18,32,51,42,93,0.000333,0.155,14,6510,361.666667,465,128.361619,1,2
0,0,11,11,13,18,31,50,42,92,0.000333,0.151929,12,5469.432727,303.857374,455.786061,123.164366,1,2
0,0,8,8,9,10,19,29,22,51,0.000333,0.072215,8,1733.154425,96.286357,216.644303,61.748606,1,2
0,0,8,8,9,10,19,29,22,51,0.000333,0.072215,8,1733.154425,96.286357,216.644303,61.748606,1,2
0,0,8,8,9,10,19,29,22,51,0.000333,0.072215,8,1733.154425,96.286357,216.644303,61.748606,1,2
0,0,8,8,9,10,19,29,22,51,0.000333,0.072215,8,1733.154425,96.286357,216.644303,61.748606,1,2
0,0,8,8,9,10,19,29,22,51,0.000333,0.072215,8,1733.154425,96.286357,216.644303,61.748606,1,2
0,0,8,8,9,10,19,29,22,51,0.000333,0.072215,8,1733.154425,96.286357,216.644303,61.748606,1,2
0,0,8,8,9,10,19,29,22,51,0.000333,0.072215,8,1733.154425,96.286357,216.644303,61.748606,1,2
0,0,8,8,9,10,19,29,22,51,0.000333,0.072215,8,1733.154425,96.286357,216.644303,61.748606,1,2
0,0,8,8,9,10,19,29,22,51,0.000333,0.072215,8,1733.154425,96.286357,216.644303,61.748606,1,2
0,0,8,8,9,10,19,29,22,51,0.000333,0.072215,8,1733.154425,96.286357,216.644303,61.748606,1,2
0,0,8,8,9,10,19,29,22,51,0.000333,0.072215,8,1733.154425,96.286357,216.644303,61.748606,1,2
0,0,8,8,9,10,19,29,22,51,0.000333,0.072215,8,1733.154425,96.286357,216.644303,61.748606,1,2
0,0,8,8,9,10,19,29,22,51,0.000333,0.072215,8,1733.154425,96.286357,216.644303,61.748606,1,2
0,0,8,8,9,10,19,29,22,51,0.000333,0.072215,8,1733.154425,96.286357,216.644303,61.748606,1,2
0,0,8,8,9,10,19,29,22,51,0.000333,0.072215,8,1733.154425,96.286357,216.644303,61.748606,1,2
0,0,8,8,9,10,19,29,22,51,0.000333,0.072215,8,1733.154425,96.286357,216.644303,61.748606,1,2
0,0,8,8,9,10,19,29,22,51,0.000333,0.072215,8,1733.154425,96.286357,216.644303,61.748606,1,2
0,0,8,8,9,10,19,29,22,51,0.000333,0.072215,8,1733.154425,96.286357,216.644303,61.748606,1,2
0,0,10,10,9,11,20,35,28,63,0.000333,0.09076,8,2178.25176,121.013987,272.28147,66.583073,1,2
0,0,12,12,10,12,22,47,34,81,0.000333,0.120405,10,3612.139611,200.674423,361.213961,76.238831,1,2
0,0,10,10,10,15,25,34,30,64,0.000333,0.099069,10,2972.067961,165.114887,297.206796,91.82264,1,2
0,0,10,10,9,14,23,35,32,67,0.000333,0.101026,8,2424.629208,134.701623,303.078651,81.832294,1,2
0,0,11,11,10,13,23,44,32,76,0.000333,0.114597,10,3437.907087,190.994838,343.790709,81.324997,1,2
0,0,11,11,9,14,23,35,32,67,0.000333,0.101026,8,2424.629208,134.701623,303.078651,81.832294,1,2
0,0,10,10,9,14,23,35,32,67,0.000333,0.101026,8,2424.629208,134.701623,303.078651,81.832294,1,2
0,0,12,12,9,15,24,41,42,83,0.000333,0.126851,8,3044.4151,169.134172,380.551888,87.132684,1,2
0,0,14,14,9,16,25,47,52,99,0.000333,0.153247,12,5516.901153,306.494509,459.741763,92.529325,1,2
0,0,16,16,10,17,27,54,62,116,0.000333,0.183856,15,8273.504254,459.639125,551.56695,102.706149,1,2
0,0,11,11,10,15,25,41,35,76,0.000333,0.117644,10,3529.330704,196.073928,352.93307,91.82264,1,2
0,0,12,12,10,16,26,50,39,89,0.000333,0.139446,10,4183.391349,232.410631,418.339135,97.219281,1,2
0,0,11,11,9,15,24,43,36,79,0.000333,0.120737,8,2897.6963,160.983128,362.212038,87.132684,1,2
0,0,13,13,9,17,26,50,42,92,0.000333,0.144147,8,3459.523633,192.195757,432.440454,98.016193,1,2
0,0,13,13,10,17,27,42,45,87,0.000333,0.137892,10,4136.752127,229.819563,413.675213,102.706149,1,2
0,0,11,11,9,14,23,35,34,69,0.000333,0.104042,8,2497.0062,138.722567,312.125775,81.832294,1,2
0,0,11,11,13,17,30,42,39,81,0.000333,0.132486,12,4769.497659,264.972092,397.458138,117.592585,1,2
0,0,11,11,12,17,29,41,39,80,0.000333,0.129546,12,4663.661755,259.09232,388.63848,112.506418,1,2
0,0,7,7,10,10,20,35,23,58,0.000333,0.083557,10,2506.718295,139.262128,250.67183,66.438562,1,2
0,0,7,7,10,10,20,35,23,58,0.000333,0.083557,10,2506.718295,139.262128,250.67183,66.438562,1,2
0,0,7,7,10,10,20,35,23,58,0.000333,0.083557,10,2506.718295,139.262128,250.67183,66.438562,1,2
0,0,7,7,10,10,20,35,23,58,0.000333,0.083557,10,2506.718295,139.262128,250.67183,66.438562,1,2
0,0,7,7,10,10,20,35,23,58,0.000333,0.083557,10,2506.718295,139.262128,250.67183,66.438562,1,2
0,0,7,7,10,10,20,35,23,58,0.000333,0.083557,10,2506.718295,139.262128,250.67183,66.438562,1,2
0,0,7,7,10,10,20,35,23,58,0.000333,0.083557,10,2506.718295,139.262128,250.67183,66.438562,1,2
0,0,7,7,10,10,20,35,23,58,0.000333,0.083557,10,2506.718295,139.262128,250.67183,66.438562,1,2
0,0,7,7,10,10,20,35,23,58,0.000333,0.083557,10,2506.718295,139.262128,250.67183,66.438562,1,2
0,0,7,7,10,10,20,35,23,58,0.000333,0.083557,10,2506.718295,139.262128,250.67183,66.438562,1,2
0,0,7,7,10,10,20,35,23,58,0.000333,0.083557,10,2506.718295,139.262128,250.67183,66.438562,1,2
0,0,7,7,10,10,20,35,23,58,0.000333,0.083557,10,2506.718295,139.262128,250.67183,66.438562,1,2
0,0,7,7,10,10,20,35,23,58,0.000333,0.083557,10,2506.718295,139.262128,250.67183,66.438562,1,2
0,0,7,7,10,10,20,35,23,58,0.000333,0.083557,10,2506.718295,139.262128,250.67183,66.438562,1,2
0,0,7,7,10,10,20,35,23,58,0.000333,0.083557,10,2506.718295,139.262128,250.67183,66.438562,1,2
0,0,7,7,10,10,20,35,23,58,0.000333,0.083557,10,2506.718295,139.262128,250.67183,66.438562,1,2
0,0,7,7,10,10,20,35,23,58,0.000333,0.083557,10,2506.718295,139.262128,250.67183,66.438562,1,2
0,0,7,7,10,10,20,35,23,58,0.000333,0.083557,10,2506.718295,139.262128,250.67183,66.438562,1,2
0,0,10,10,12,11,23,46,31,77,0.000333,0.116105,12,4179.771247,232.209514,348.314271,81.073298,1,2
0,0,11,11,11,14,25,47,39,86,0.000333,0.133124,10,3993.716323,221.873129,399.371632,91.356717,1,2
0,0,9,9,10,11,21,41,29,70,0.000333,0.102487,10,3074.622196,170.812344,307.46222,71.273029,1,2
0,0,11,11,11,12,23,53,35,88,0.000333,0.132691,10,3980.734521,221.151918,398.073452,81.073298,1,2
0,0,9,9,11,15,26,40,31,71,0.000333,0.111244,10,3337.3122,185.406233,333.73122,96.657107,1,2
0,0,9,9,10,14,24,41,33,74,0.000333,0.113096,10,3392.872251,188.492903,339.287225,86.52225,1,2
0,0,10,10,12,11,23,46,31,77,0.000333,0.116105,12,4179.771247,232.209514,348.314271,81.073298,1,2
0,0,10,10,11,13,24,50,33,83,0.000333,0.126851,10,3805.518876,211.417715,380.551888,86.159464,1,2
0,0,10,10,10,14,24,41,33,74,0.000333,0.113096,10,3392.872251,188.492903,339.287225,86.52225,1,2
0,0,9,9,10,14,24,41,33,74,0.000333,0.113096,10,3392.872251,188.492903,339.287225,86.52225,1,2
0,0,11,11,10,15,25,47,43,90,0.000333,0.139316,10,4179.470571,232.192809,417.947057,91.82264,1,2
0,0,13,13,10,16,26,53,53,106,0.000333,0.166082,15,7473.699152,415.205508,498.24661,97.219281,1,2
0,0,15,15,10,17,27,59,63,122,0.000333,0.193365,15,8701.444129,483.413563,580.096275,102.706149,1,2
0,0,10,10,11,13,24,45,35,80,0.000333,0.122266,10,3667.970001,203.776111,366.797,86.159464,1,2
0,0,10,10,11,15,26,47,36,83,0.000333,0.130045,10,3901.364966,216.742498,390.136497,96.657107,1,2
0,0,11,11,11,16,27,56,40,96,0.000333,0.152156,10,4564.692002,253.594,456.4692,102.053748,1,2
0,0,10,10,10,15,25,49,37,86,0.000333,0.133124,10,3993.716323,221.873129,399.371632,91.82264,1,2
0,0,12,12,10,17,27,56,43,99,0.000333,0.156911,10,4707.338627,261.518813,470.733863,102.706149,1,2
0,0,12,12,11,17,28,48,46,94,0.000333,0.15063,10,4518.913627,251.050757,451.891363,107.540616,1,2
0,0,10,10,10,14,24,41,35,76,0.000333,0.116152,10,3484.571501,193.587306,348.45715,86.52225,1,2
0,0,10,10,14,17,31,48,40,88,0.000333,0.145323,14,6103.569854,339.087214,435.969275,122.789837,1,2
0,0,10,10,13,17,30,47,40,87,0.000333,0.1423,12,5122.793782,284.599655,426.899482,117.592585,1,2
0,0,7,7,10,10,20,35,23,58,0.000333,0.083557,10,2506.718295,139.262128,250.67183,66.438562,1,2
0,0,7,7,10,10,20,35,23,58,0.000333,0.083557,10,2506.718295,139.262128,250.67183,66.438562,1,2
0,0,7,7,10,10,20,35,23,58,0.000333,0.083557,10,2506.718295,139.262128,250.67183,66.438562,1,2
0,0,7,7,10,10,20,35,23,58,0.000333,0.083557,10,2506.718295,139.262128,250.67183,66.438562,1,2
0,0,7,7,10,10,20,35,23,58,0.000333,0.083557,10,2506.718295,139.262128,250.67183,66.438562,1,2
0,0,7,7,10,10,20,35,23,58,0.000333,0.083557,10,2506.718295,139.262128,250.67183,66.438562,1,2
0,0,7,7,10,10,20,35,23,58,0.000333,0.083557,10,2506.718295,139.262128,250.67183,66.438562,1,2
0,0,7,7,10,10,20,35,23,58,0.000333,0.083557,10,2506.718295,139.262128,250.67183,66.438562,1,2
0,0,7,7,10,10,20,35,23,58,0.000333,0.083557,10,2506.718295,139.262128,250.67183,66.438562,1,2
0,0,7,7,10,10,20,35,23,58,0.000333,0.083557,10,2506.718295,139.262128,250.67183,66.438562,1,2
0,0,7,7,10,10,20,35,23,58,0.000333,0.083557,10,2506.718295,139.262128,250.67183,66.438562,1,2
0,0,7,7,10,10,20,35,23,58,0.000333,0.083557,10,2506.718295,139.262128,250.67183,66.438562,1,2
0,0,7,7,10,10,20,35,23,58,0.000333,0.083557,10,2506.718295,139.262128,250.67183,66.438562,1,2
0,0,7,7,10,10,20,35,23,58,0.000333,0.083557,10,2506.718295,139.262128,250.67183,66.438562,1,2
0,0,7,7,10,10,20,35,23,58,0.000333,0.083557,10,2506.718295,139.262128,250.67183,66.438562,1,2
0,0,7,7,10,10,20,35,23,58,0.000333,0.083557,10,2506.718295,139.262128,250.67183,66.438562,1,2
0,0,7,7,10,10,20,35,23,58,0.000333,0.083557,10,2506.718295,139.262128,250.67183,66.438562,1,2
0,0,7,7,10,10,20,35,23,58,0.000333,0.083557,10,2506.718295,139.262128,250.67183,66.438562,1,2
0,0,9,9,12,11,23,44,29,73,0.000333,0.110073,12,3962.640274,220.146682,330.220023,81.073298,1,2
0,0,11,11,11,14,25,47,39,86,0.000333,0.133124,10,3993.716323,221.873129,399.371632,91.356717,1,2
0,0,9,9,10,11,21,41,29,70,0.000333,0.102487,10,3074.622196,170.812344,307.46222,71.273029,1,2
0,0,11,11,11,12,23,53,35,88,0.000333,0.132691,10,3980.734521,221.151918,398.073452,81.073298,1,2
0,0,9,9,11,15,26,40,31,71,0.000333,0.111244,10,3337.3122,185.406233,333.73122,96.657107,1,2
0,0,9,9,10,14,24,41,33,74,0.000333,0.113096,10,3392.872251,188.492903,339.287225,86.52225,1,2
0,0,10,10,12,11,23,46,31,77,0.000333,0.116105,12,4179.771247,232.209514,348.314271,81.073298,1,2
0,0,10,10,11,13,24,50,33,83,0.000333,0.126851,10,3805.518876,211.417715,380.551888,86.159464,1,2
0,0,10,10,10,14,24,41,33,74,0.000333,0.113096,10,3392.872251,188.492903,339.287225,86.52225,1,2
0,0,9,9,10,14,24,41,33,74,0.000333,0.113096,10,3392.872251,188.492903,339.287225,86.52225,1,2
0,0,11,11,10,15,25,47,43,90,0.000333,0.139316,10,4179.470571,232.192809,417.947057,91.82264,1,2
0,0,13,13,10,16,26,53,53,106,0.000333,0.166082,15,7473.699152,415.205508,498.24661,97.219281,1,2
0,0,15,15,10,17,27,59,63,122,0.000333,0.193365,15,8701.444129,483.413563,580.096275,102.706149,1,2
0,0,10,10,11,13,24,45,35,80,0.000333,0.122266,10,3667.970001,203.776111,366.797,86.159464,1,2
0,0,10,10,11,15,26,47,36,83,0.000333,0.130045,10,3901.364966,216.742498,390.136497,96.657107,1,2
0,0,11,11,11,16,27,56,40,96,0.000333,0.152156,10,4564.692002,253.594,456.4692,102.053748,1,2
0,0,10,10,10,15,25,49,37,86,0.000333,0.133124,10,3993.716323,221.873129,399.371632,91.82264,1,2
0,0,12,12,10,17,27,56,43,99,0.000333,0.156911,10,4707.338627,261.518813,470.733863,102.706149,1,2
0,0,12,12,11,17,28,48,46,94,0.000333,0.15063,10,4518.913627,251.050757,451.891363,107.540616,1,2
0,0,11,11,10,15,25,41,39,80,0.000333,0.123836,10,3715.084952,206.393608,371.508495,91.82264,1,2
0,0,10,10,14,17,31,48,40,88,0.000333,0.145323,14,6103.569854,339.087214,435.969275,122.789837,1,2
0,0,10,10,13,17,30,47,40,87,0.000333,0.1423,12,5122.793782,284.599655,426.899482,117.592585,1,2
0,0,7,7,9,9,18,26,20,46,0.000333,0.063939,8,1534.532401,85.2518,191.81655,57.05865,1,2
0,0,7,7,9,9,18,26,20,46,0.000333,0.063939,8,1534.532401,85.2518,191.81655,57.05865,1,2
0,0,7,7,9,9,18,26,20,46,0.000333,0.063939,8,1534.532401,85.2518,191.81655,57.05865,1,2
0,0,7,7,9,9,18,26,20,46,0.000333,0.063939,8,1534.532401,85.2518,191.81655,57.05865,1,2
0,0,7,7,9,9,18,26,20,46,0.000333,0.063939,8,1534.532401,85.2518,191.81655,57.05865,1,2
0,0,7,7,9,9,18,26,20,46,0.000333,0.063939,8,1534.532401,85.2518,191.81655,57.05865,1,2
0,0,7,7,9,9,18,26,20,46,0.000333,0.063939,8,1534.532401,85.2518,191.81655,57.05865,1,2
0,0,7,7,9,9,18,26,20,46,0.000333,0.063939,8,1534.532401,85.2518,191.81655,57.05865,1,2
0,0,7,7,9,9,18,26,20,46,0.000333,0.063939,8,1534.532401,85.2518,191.81655,57.05865,1,2
0,0,7,7,9,9,18,26,20,46,0.000333,0.063939,8,1534.532401,85.2518,191.81655,57.05865,1,2
0,0,7,7,9,9,18,26,20,46,0.000333,0.063939,8,1534.532401,85.2518,191.81655,57.05865,1,2
0,0,7,7,9,9,18,26,20,46,0.000333,0.063939,8,1534.532401,85.2518,191.81655,57.05865,1,2
0,0,7,7,9,9,18,26,20,46,0.000333,0.063939,8,1534.532401,85.2518,191.81655,57.05865,1,2
0,0,7,7,9,9,18,26,20,46,0.000333,0.063939,8,1534.532401,85.2518,191.81655,57.05865,1,2
0,0,7,7,9,9,18,26,20,46,0.000333,0.063939,8,1534.532401,85.2518,191.81655,57.05865,1,2
0,0,7,7,9,9,18,26,20,46,0.000333,0.063939,8,1534.532401,85.2518,191.81655,57.05865,1,2
0,0,7,7,9,9,18,26,20,46,0.000333,0.063939,8,1534.532401,85.2518,191.81655,57.05865,1,2
0,0,7,7,9,9,18,26,20,46,0.000333,0.063939,8,1534.532401,85.2518,191.81655,57.05865,1,2
0,0,10,10,11,10,21,37,28,65,0.000333,0.095167,10,2855.006325,158.611462,285.500632,71.273029,1,2
0,0,11,11,10,13,23,38,36,74,0.000333,0.111581,10,3347.435847,185.968658,334.743585,81.324997,1,2
0,0,9,9,9,10,19,32,26,58,0.000333,0.082127,8,1971.038366,109.502131,246.379796,61.748606,1,2
0,0,12,12,10,11,21,47,34,81,0.000333,0.118593,15,5336.665669,296.481426,355.777711,71.273029,1,2
0,0,9,9,10,14,24,31,28,59,0.000333,0.090171,10,2705.127875,150.284882,270.512788,86.52225,1,2
0,0,9,9,9,13,22,32,30,62,0.000333,0.092162,8,2211.878083,122.882116,276.48476,76.635041,1,2
0,0,10,10,11,10,21,37,28,65,0.000333,0.095167,10,2855.006325,158.611462,285.500632,71.273029,1,2
0,0,10,10,10,12,22,41,30,71,0.000333,0.10554,10,3166.196449,175.899803,316.619645,76.238831,1,2
0,0,10,10,9,13,22,32,30,62,0.000333,0.092162,8,2211.878083,122.882116,276.48476,76.635041,1,2
0,0,9,9,9,13,22,32,30,62,0.000333,0.092162,8,2211.878083,122.882116,276.48476,76.635041,1,2
0,0,11,11,9,14,23,38,40,78,0.000333,0.117613,8,2822.702661,156.816814,352.837833,81.832294,1,2
0,0,13,13,9,16,25,44,50,94,0.000333,0.145507,12,5238.269782,291.014988,436.522482,92.529325,1,2
0,0,15,15,9,16,25,50,60,110,0.000333,0.170275,12,6129.890171,340.549454,510.824181,92.529325,1,2
0,0,10,10,10,12,22,36,32,68,0.000333,0.10108,10,3032.413501,168.467417,303.24135,76.238831,1,2
0,0,10,10,10,14,24,38,33,71,0.000333,0.108511,10,3255.323376,180.851299,325.532338,86.52225,1,2
0,0,11,11,10,15,25,47,37,84,0.000333,0.130028,10,3900.839199,216.713289,390.08392,91.82264,1,2
0,0,10,10,9,14,23,40,34,74,0.000333,0.111581,8,2677.948678,148.774927,334.743585,81.832294,1,2
0,0,12,12,9,16,25,47,40,87,0.000333,0.134672,8,3232.123908,179.562439,404.015489,92.529325,1,2
0,0,12,12,10,16,26,39,43,82,0.000333,0.128479,10,3854.360569,214.131143,385.436057,97.219281,1,2
0,0,10,10,9,13,22,32,32,64,0.000333,0.095135,8,2283.228989,126.846055,285.403624,76.635041,1,2
0,0,10,10,13,16,29,39,37,76,0.000333,0.123069,12,4430.478668,246.137704,369.206556,112.105716,1,2
0,0,11,11,13,16,29,40,38,78,0.000333,0.126308,12,4547.070211,252.615012,378.922518,112.105716,1,2
0,0,7,7,9,9,18,26,20,46,0.000333,0.063939,8,1534.532401,85.2518,191.81655,57.05865,1,2
0,0,7,7,9,9,18,26,20,46,0.000333,0.063939,8,1534.532401,85.2518,191.81655,57.05865,1,2
0,0,7,7,9,9,18,26,20,46,0.000333,0.063939,8,1534.532401,85.2518,191.81655,57.05865,1,2
0,0,7,7,9,9,18,26,20,46,0.000333,0.063939,8,1534.532401,85.2518,191.81655,57.05865,1,2
0,0,7,7,9,9,18,26,20,46,0.000333,0.063939,8,1534.532401,85.2518,191.81655,57.05865,1,2
0,0,7,7,9,9,18,26,20,46,0.000333,0.063939,8,1534.532401,85.2518,191.81655,57.05865,1,2
0,0,7,7,9,9,18,26,20,46,0.000333,0.063939,8,1534.532401,85.2518,191.81655,57.05865,1,2
0,0,7,7,9,9,18,26,20,46,0.000333,0.063939,8,1534.532401,85.2518,191.81655,57.05865,1,2
0,0,7,7,9,9,18,26,20,46,0.000333,0.063939,8,1534.532401,85.2518,191.81655,57.05865,1,2
0,0,7,7,9,9,18,26,20,46,0.000333,0.063939,8,1534.532401,85.2518,191.81655,57.05865,1,2
0,0,7,7,9,9,18,26,20,46,0.000333,0.063939,8,1534.532401,85.2518,191.81655,57.05865,1,2
0,0,7,7,9,9,18,26,20,46,0.000333,0.063939,8,1534.532401,85.2518,191.81655,57.05865,1,2
0,0,7,7,9,9,18,26,20,46,0.000333,0.063939,8,1534.532401,85.2518,191.81655,57.05865,1,2
0,0,7,7,9,9,18,26,20,46,0.000333,0.063939,8,1534.532401,85.2518,191.81655,57.05865,1,2
0,0,7,7,9,9,18,26,20,46,0.000333,0.063939,8,1534.532401,85.2518,191.81655,57.05865,1,2
0,0,7,7,9,9,18,26,20,46,0.000333,0.063939,8,1534.532401,85.2518,191.81655,57.05865,1,2
0,0,7,7,9,9,18,26,20,46,0.000333,0.063939,8,1534.532401,85.2518,191.81655,57.05865,1,2
0,0,7,7,9,9,18,26,20,46,0.000333,0.063939,8,1534.532401,85.2518,191.81655,57.05865,1,2
0,0,10,10,11,10,21,37,28,65,0.000333,0.095167,10,2855.006325,158.611462,285.500632,71.273029,1,2
0,0,10,10,10,13,23,34,30,64,0.000333,0.096503,10,2895.079652,160.837758,289.507965,81.324997,1,2
0,0,9,9,9,10,19,32,26,58,0.000333,0.082127,8,1971.038366,109.502131,246.379796,61.748606,1,2
0,0,12,12,10,11,21,49,35,84,0.000333,0.122985,15,5534.319953,307.46222,368.954664,71.273029,1,2
0,0,9,9,10,14,24,31,28,59,0.000333,0.090171,10,2705.127875,150.284882,270.512788,86.52225,1,2
0,0,9,9,9,13,22,32,30,62,0.000333,0.092162,8,2211.878083,122.882116,276.48476,76.635041,1,2
0,0,10,10,11,10,21,37,28,65,0.000333,0.095167,10,2855.006325,158.611462,285.500632,71.273029,1,2
0,0,10,10,10,12,22,41,30,71,0.000333,0.10554,10,3166.196449,175.899803,316.619645,76.238831,1,2
0,0,10,10,9,13,22,32,30,62,0.000333,0.092162,8,2211.878083,122.882116,276.48476,76.635041,1,2
0,0,9,9,9,13,22,32,30,62,0.000333,0.092162,8,2211.878083,122.882116,276.48476,76.635041,1,2
0,0,11,11,9,14,23,38,40,78,0.000333,0.117613,8,2822.702661,156.816814,352.837833,81.832294,1,2
0,0,13,13,9,15,24,44,50,94,0.000333,0.143662,12,5171.837701,287.324317,430.986475,87.132684,1,2
0,0,15,15,9,16,25,50,60,110,0.000333,0.170275,12,6129.890171,340.549454,510.824181,92.529325,1,2
0,0,10,10,10,12,22,36,32,68,0.000333,0.10108,10,3032.413501,168.467417,303.24135,76.238831,1,2
0,0,10,10,10,14,24,38,33,71,0.000333,0.108511,10,3255.323376,180.851299,325.532338,86.52225,1,2
0,0,11,11,10,15,25,47,37,84,0.000333,0.130028,10,3900.839199,216.713289,390.08392,91.82264,1,2
0,0,10,10,9,14,23,40,34,74,0.000333,0.111581,8,2677.948678,148.774927,334.743585,81.832294,1,2
0,0,12,12,9,16,25,47,40,87,0.000333,0.134672,8,3232.123908,179.562439,404.015489,92.529325,1,2
0,0,12,12,10,16,26,39,43,82,0.000333,0.128479,10,3854.360569,214.131143,385.436057,97.219281,1,2
0,0,10,10,9,13,22,32,32,64,0.000333,0.095135,8,2283.228989,126.846055,285.403624,76.635041,1,2
0,0,10,10,13,16,29,39,37,76,0.000333,0.123069,12,4430.478668,246.137704,369.206556,112.105716,1,2
0,0,10,10,12,16,28,38,37,75,0.000333,0.120184,12,4326.61943,240.367746,360.551619,107.01955,1,2
0,0,7,7,10,10,20,35,23,58,0.000333,0.083557,10,2506.718295,139.262128,250.67183,66.438562,1,2
0,0,7,7,10,10,20,35,23,58,0.000333,0.083557,10,2506.718295,139.262128,250.67183,66.438562,1,2
0,0,7,7,10,10,20,35,23,58,0.000333,0.083557,10,2506.718295,139.262128,250.67183,66.438562,1,2
0,0,7,7,10,10,20,35,23,58,0.000333,0.083557,10,2506.718295,139.262128,250.67183,66.438562,1,2
0,0,7,7,10,10,20,35,23,58,0.000333,0.083557,10,2506.718295,139.262128,250.67183,66.438562,1,2
0,0,7,7,10,10,20,35,23,58,0.000333,0.083557,10,2506.718295,139.262128,250.67183,66.438562,1,2
0,0,7,7,10,10,20,35,23,58,0.000333,0.083557,10,2506.718295,139.262128,250.67183,66.438562,1,2
0,0,7,7,10,10,20,35,23,58,0.000333,0.083557,10,2506.718295,139.262128,250.67183,66.438562,1,2
0,0,7,7,10,10,20,35,23,58,0.000333,0.083557,10,2506.718295,139.262128,250.67183,66.438562,1,2
0,0,7,7,10,10,20,35,23,58,0.000333,0.083557,10,2506.718295,139.262128,250.67183,66.438562,1,2
0,0,7,7,10,10,20,35,23,58,0.000333,0.083557,10,2506.718295,139.262128,250.67183,66.438562,1,2
0,0,7,7,10,10,20,35,23,58,0.000333,0.083557,10,2506.718295,139.262128,250.67183,66.438562,1,2
0,0,7,7,10,10,20,35,23,58,0.000333,0.083557,10,2506.718295,139.262128,250.67183,66.438562,1,2
0,0,7,7,10,10,20,35,23,58,0.000333,0.083557,10,2506.718295,139.262128,250.67183,66.438562,1,2
0,0,7,7,10,10,20,35,23,58,0.000333,0.083557,10,2506.718295,139.262128,250.67183,66.438562,1,2
0,0,7,7,10,10,20,35,23,58,0.000333,0.083557,10,2506.718295,139.262128,250.67183,66.438562,1,2
0,0,7,7,10,10,20,35,23,58,0.000333,0.083557,10,2506.718295,139.262128,250.67183,66.438562,1,2
0,0,7,7,10,10,20,35,23,58,0.000333,0.083557,10,2506.718295,139.262128,250.67183,66.438562,1,2
0,0,10,10,12,11,23,46,31,77,0.000333,0.116105,12,4179.771247,232.209514,348.314271,81.073298,1,2
0,0,10,10,11,14,25,43,33,76,0.000333,0.117644,10,3529.330704,196.073928,352.93307,91.356717,1,2
0,0,9,9,10,11,21,41,29,70,0.000333,0.102487,10,3074.622196,170.812344,307.46222,71.273029,1,2
0,0,12,12,11,12,23,56,37,93,0.000333,0.14023,15,6310.368929,350.576052,420.691262,81.073298,1,2
0,0,9,9,11,15,26,40,31,71,0.000333,0.111244,10,3337.3122,185.406233,333.73122,96.657107,1,2
0,0,9,9,10,14,24,41,33,74,0.000333,0.113096,10,3392.872251,188.492903,339.287225,86.52225,1,2
0,0,10,10,12,11,23,46,31,77,0.000333,0.116105,12,4179.771247,232.209514,348.314271,81.073298,1,2
0,0,10,10,11,13,24,50,33,83,0.000333,0.126851,10,3805.518876,211.417715,380.551888,86.159464,1,2
0,0,10,10,10,14,24,41,33,74,0.000333,0.113096,10,3392.872251,188.492903,339.287225,86.52225,1,2
0,0,9,9,10,14,24,41,33,74,0.000333,0.113096,10,3392.872251,188.492903,339.287225,86.52225,1,2
0,0,9,9,10,14,24,41,33,74,0.000333,0.113096,10,3392.872251,188.492903,339.287225,86.52225,1,2
0,0,13,13,10,16,26,53,53,106,0.000333,0.166082,15,7473.699152,415.205508,498.24661,97.219281,1,2
0,0,15,15,10,17,27,59,63,122,0.000333,0.193365,15,8701.444129,483.413563,580.096275,102.706149,1,2
0,0,10,10,11,13,24,45,35,80,0.000333,0.122266,10,3667.970001,203.776111,366.797,86.159464,1,2
0,0,10,10,11,15,26,47,36,83,0.000333,0.130045,10,3901.364966,216.742498,390.136497,96.657107,1,2
0,0,11,11,11,16,27,56,40,96,0.000333,0.152156,10,4564.692002,253.594,456.4692,102.053748,1,2
0,0,10,10,10,15,25,49,37,86,0.000333,0.133124,10,3993.716323,221.873129,399.371632,91.82264,1,2
0,0,12,12,10,17,27,56,43,99,0.000333,0.156911,10,4707.338627,261.518813,470.733863,102.706149,1,2
0,0,12,12,11,17,28,48,46,94,0.000333,0.15063,10,4518.913627,251.050757,451.891363,107.540616,1,2
0,0,11,11,10,15,25,41,39,80,0.000333,0.123836,10,3715.084952,206.393608,371.508495,91.82264,1,2
0,0,10,10,14,17,31,48,40,88,0.000333,0.145323,14,6103.569854,339.087214,435.969275,122.789837,1,2
0,0,10,10,13,17,30,47,40,87,0.000333,0.1423,12,5122.793782,284.599655,426.899482,117.592585,1,2
0,0,7,7,9,9,18,26,20,46,0.000333,0.063939,8,1534.532401,85.2518,191.81655,57.05865,1,2
0,0,7,7,9,9,18,26,20,46,0.000333,0.063939,8,1534.532401,85.2518,191.81655,57.05865,1,2
0,0,7,7,9,9,18,26,20,46,0.000333,0.063939,8,1534.532401,85.2518,191.81655,57.05865,1,2
0,0,7,7,9,9,18,26,20,46,0.000333,0.063939,8,1534.532401,85.2518,191.81655,57.05865,1,2
0,0,7,7,9,9,18,26,20,46,0.000333,0.063939,8,1534.532401,85.2518,191.81655,57.05865,1,2
0,0,7,7,9,9,18,26,20,46,0.000333,0.063939,8,1534.532401,85.2518,191.81655,57.05865,1,2
0,0,7,7,9,9,18,26,20,46,0.000333,0.063939,8,1534.532401,85.2518,191.81655,57.05865,1,2
0,0,7,7,9,9,18,26,20,46,0.000333,0.063939,8,1534.532401,85.2518,191.81655,57.05865,1,2
0,0,7,7,9,9,18,26,20,46,0.000333,0.063939,8,1534.532401,85.2518,191.81655,57.05865,1,2
0,0,7,7,9,9,18,26,20,46,0.000333,0.063939,8,1534.532401,85.2518,191.81655,57.05865,1,2
0,0,7,7,9,9,18,26,20,46,0.000333,0.063939,8,1534.532401,85.2518,191.81655,57.05865,1,2
0,0,7,7,9,9,18,26,20,46,0.000333,0.063939,8,1534.532401,85.2518,191.81655,57.05865,1,2
0,0,7,7,9,9,18,26,20,46,0.000333,0.063939,8,1534.532401,85.2518,191.81655,57.05865,1,2
0,0,7,7,9,9,18,26,20,46,0.000333,0.063939,8,1534.532401,85.2518,191.81655,57.05865,1,2
0,0,7,7,9,9,18,26,20,46,0.000333,0.063939,8,1534.532401,85.2518,191.81655,57.05865,1,2
0,0,7,7,9,9,18,26,20,46,0.000333,0.063939,8,1534.532401,85.2518,191.81655,57.05865,1,2
0,0,7,7,9,9,18,26,20,46,0.000333,0.063939,8,1534.532401,85.2518,191.81655,57.05865,1,2
0,0,7,7,9,9,18,26,20,46,0.000333,0.063939,8,1534.532401,85.2518,191.81655,57.05865,1,2
0,0,10,10,11,10,21,37,28,65,0.000333,0.095167,10,2855.006325,158.611462,285.500632,71.273029,1,2
0,0,11,11,10,13,23,38,36,74,0.000333,0.111581,10,3347.435847,185.968658,334.743585,81.324997,1,2
0,0,9,9,9,10,19,32,26,58,0.000333,0.082127,8,1971.038366,109.502131,246.379796,61.748606,1,2
0,0,12,12,10,11,21,47,34,81,0.000333,0.118593,15,5336.665669,296.481426,355.777711,71.273029,1,2
0,0,9,9,10,14,24,31,28,59,0.000333,0.090171,10,2705.127875,150.284882,270.512788,86.52225,1,2
0,0,9,9,9,13,22,32,30,62,0.000333,0.092162,8,2211.878083,122.882116,276.48476,76.635041,1,2
0,0,10,10,11,10,21,37,28,65,0.000333,0.095167,10,2855.006325,158.611462,285.500632,71.273029,1,2
0,0,10,10,10,12,22,41,30,71,0.000333,0.10554,10,3166.196449,175.899803,316.619645,76.238831,1,2
0,0,10,10,9,13,22,32,30,62,0.000333,0.092162,8,2211.878083,122.882116,276.48476,76.635041,1,2
0,0,9,9,9,13,22,32,30,62,0.000333,0.092162,8,2211.878083,122.882116,276.48476,76.635041,1,2
0,0,11,11,9,14,23,38,40,78,0.000333,0.117613,8,2822.702661,156.816814,352.837833,81.832294,1,2
0,0,13,13,9,15,24,44,50,94,0.000333,0.143662,12,5171.837701,287.324317,430.986475,87.132684,1,2
0,0,15,15,9,16,25,50,60,110,0.000333,0.170275,12,6129.890171,340.549454,510.824181,92.529325,1,2
0,0,10,10,10,12,22,36,32,68,0.000333,0.10108,10,3032.413501,168.467417,303.24135,76.238831,1,2
0,0,10,10,10,14,24,38,33,71,0.000333,0.108511,10,3255.323376,180.851299,325.532338,86.52225,1,2
0,0,11,11,10,15,25,47,37,84,0.000333,0.130028,10,3900.839199,216.713289,390.08392,91.82264,1,2
0,0,10,10,9,14,23,40,34,74,0.000333,0.111581,8,2677.948678,148.774927,334.743585,81.832294,1,2
0,0,12,12,9,16,25,47,40,87,0.000333,0.134672,8,3232.123908,179.562439,404.015489,92.529325,1,2
0,0,12,12,10,16,26,39,43,82,0.000333,0.128479,10,3854.360569,214.131143,385.436057,97.219281,1,2
0,0,10,10,9,13,22,32,32,64,0.000333,0.095135,8,2283.228989,126.846055,285.403624,76.635041,1,2
0,0,10,10,13,16,29,39,37,76,0.000333,0.123069,12,4430.478668,246.137704,369.206556,112.105716,1,2
0,0,10,10,12,16,28,38,37,75,0.000333,0.120184,12,4326.61943,240.367746,360.551619,107.01955,1,2
0,0,8,8,14,19,33,36,32,68,0.000333,0.11434,7,2401.131601,133.3962,343.0188,134.013592,4,2
0,0,7,7,12,13,25,32,24,56,0.000333,0.086685,6,1560.33568,86.685316,260.055947,91.125266,4,2
0,0,6,6,11,11,22,28,21,49,0.000333,0.072837,5,1092.560747,60.697819,218.512149,76.107496,4,2
0,0,6,6,11,11,22,28,21,49,0.000333,0.072837,5,1092.560747,60.697819,218.512149,76.107496,4,2
0,0,4,4,12,8,20,19,11,30,0.000333,0.043219,6,777.947057,43.219281,129.657843,67.01955,2,2
0,0,4,4,12,8,20,19,11,30,0.000333,0.043219,6,777.947057,43.219281,129.657843,67.01955,2,2
0,0,3,3,11,6,17,15,8,23,0.000333,0.031337,5,470.058227,26.114346,94.011645,53.563523,2,2
0,0,3,3,11,6,17,15,8,23,0.000333,0.031337,5,470.058227,26.114346,94.011645,53.563523,2,2
0,0,8,8,14,19,33,36,32,68,0.000333,0.11434,7,2401.131601,133.3962,343.0188,134.013592,4,2
0,0,7,7,12,13,25,32,24,56,0.000333,0.086685,6,1560.33568,86.685316,260.055947,91.125266,4,2
0,0,6,6,11,11,22,28,21,49,0.000333,0.072837,5,1092.560747,60.697819,218.512149,76.107496,4,2
0,0,6,6,11,11,22,28,21,49,0.000333,0.072837,5,1092.560747,60.697819,218.512149,76.107496,4,2
0,0,8,8,14,16,30,31,35,66,0.000333,0.107952,14,4533.96691,251.887051,323.854779,117.302969,1,2
0,0,8,8,12,16,28,30,35,65,0.000333,0.104159,12,3749.736839,208.318713,312.47807,107.01955,1,2
0,0,8,8,15,17,32,41,39,80,0.000333,0.133333,14,5600,311.111111,400,128.090227,1,2
0,0,8,8,13,17,30,40,39,79,0.000333,0.129215,12,4651.732285,258.429571,387.644357,117.592585,1,2
0,0,8,8,15,17,32,41,39,80,0.000333,0.133333,14,5600,311.111111,400,128.090227,1,2
0,0,8,8,13,17,30,40,39,79,0.000333,0.129215,12,4651.732285,258.429571,387.644357,117.592585,1,2
0,0,8,8,14,17,31,35,38,73,0.000333,0.120552,14,5063.188629,281.288257,361.656331,122.789837,1,2
0,0,8,8,12,17,29,34,38,72,0.000333,0.116592,12,4197.29558,233.183088,349.774632,112.506418,1,2
0,0,8,8,14,16,30,31,35,66,0.000333,0.107952,14,4533.96691,251.887051,323.854779,117.302969,1,2
0,0,8,8,12,16,28,30,35,65,0.000333,0.104159,12,3749.736839,208.318713,312.47807,107.01955,1,2
0,0,8,8,14,17,31,35,38,73,0.000333,0.120552,14,5063.188629,281.288257,361.656331,122.789837,1,2
0,0,8,8,12,17,29,34,38,72,0.000333,0.116592,12,4197.29558,233.183088,349.774632,112.506418,1,2
0,0,11,11,14,18,32,45,43,88,0.000333,0.146667,14,6160,342.222222,440,128.361619,1,2
0,0,11,11,12,18,30,44,43,87,0.000333,0.1423,12,5122.793782,284.599655,426.899482,118.0782,1,2
0,0,11,11,14,18,32,46,44,90,0.000333,0.15,14,6300,350,450,128.361619,1,2
0,0,10,10,12,17,29,41,35,76,0.000333,0.123069,12,4430.478668,246.137704,369.206556,112.506418,1,2
0,0,10,10,14,17,31,43,34,77,0.000333,0.127158,14,5340.623623,296.701312,381.473116,122.789837,1,2
0,0,10,10,13,17,30,42,34,76,0.000333,0.124308,12,4475.084223,248.61579,372.923685,117.592585,1,2
0,0,10,10,13,17,30,41,34,75,0.000333,0.122672,12,4416.201536,245.34453,368.016795,117.592585,1,2
0,0,10,10,12,17,29,40,34,74,0.000333,0.11983,12,4313.887124,239.660396,359.490594,112.506418,1,2
0,0,10,10,13,17,30,42,35,77,0.000333,0.125944,12,4533.96691,251.887051,377.830576,117.592585,1,2
0,0,10,10,12,17,29,41,35,76,0.000333,0.123069,12,4430.478668,246.137704,369.206556,112.506418,1,2
0,0,10,10,14,17,31,43,34,77,0.000333,0.127158,14,5340.623623,296.701312,381.473116,122.789837,1,2
0,0,10,10,13,17,30,42,34,76,0.000333,0.124308,12,4475.084223,248.61579,372.923685,117.592585,1,2
0,0,8,8,14,16,30,42,32,74,0.000333,0.121037,14,5083.538657,282.418814,363.109904,117.302969,1,2
0,0,8,8,13,16,29,41,32,73,0.000333,0.118211,12,4255.591352,236.421742,354.632613,112.105716,1,2
0,0,8,8,14,16,30,42,32,74,0.000333,0.121037,14,5083.538657,282.418814,363.109904,117.302969,1,2
0,0,8,8,13,16,29,41,32,73,0.000333,0.118211,12,4255.591352,236.421742,354.632613,112.105716,1,2
0,0,8,8,13,16,29,38,31,69,0.000333,0.111734,6,2011.204132,111.733563,335.200689,112.105716,1,2
0,0,8,8,12,16,28,37,31,68,0.000333,0.108967,6,1961.400808,108.966712,326.900135,107.01955,1,2
0,0,8,8,13,16,29,38,31,69,0.000333,0.111734,6,2011.204132,111.733563,335.200689,112.105716,1,2
0,0,8,8,12,16,28,37,31,68,0.000333,0.108967,6,1961.400808,108.966712,326.900135,107.01955,1,2
0,0,8,8,14,16,30,40,31,71,0.000333,0.11613,7,2438.724626,135.484701,348.389232,117.302969,1,2
0,0,8,8,13,16,29,39,31,70,0.000333,0.113353,6,2040.352018,113.35289,340.05867,112.105716,1,2
0,0,8,8,13,16,29,38,31,69,0.000333,0.111734,6,2011.204132,111.733563,335.200689,112.105716,1,2
0,0,8,8,12,16,28,37,31,68,0.000333,0.108967,6,1961.400808,108.966712,326.900135,107.01955,1,2
0,0,8,8,13,16,29,38,31,69,0.000333,0.111734,6,2011.204132,111.733563,335.200689,112.105716,1,2
0,0,8,8,12,16,28,37,31,68,0.000333,0.108967,6,1961.400808,108.966712,326.900135,107.01955,1,2
0,0,8,8,14,16,30,40,31,71,0.000333,0.11613,7,2438.724626,135.484701,348.389232,117.302969,1,2
0,0,8,8,13,16,29,39,31,70,0.000333,0.113353,6,2040.352018,113.35289,340.05867,112.105716,1,2
0,0,10,10,13,16,29,40,32,72,0.000333,0.116592,12,4197.29558,233.183088,349.774632,112.105716,1,2
0,0,10,10,12,16,28,39,32,71,0.000333,0.113774,12,4095.866394,227.548133,341.322199,107.01955,1,2
0,0,10,10,13,16,29,40,32,72,0.000333,0.116592,12,4197.29558,233.183088,349.774632,112.105716,1,2
0,0,10,10,12,16,28,39,32,71,0.000333,0.113774,12,4095.866394,227.548133,341.322199,107.01955,1,2
0,0,10,10,13,16,29,40,32,72,0.000333,0.116592,12,4197.29558,233.183088,349.774632,112.105716,1,2
0,0,10,10,12,16,28,39,32,71,0.000333,0.113774,12,4095.866394,227.548133,341.322199,107.01955,1,2
0,0,8,8,13,14,27,35,28,63,0.000333,0.099853,12,3594.694952,199.705275,299.557913,101.408685,1,2
0,0,8,8,12,14,26,34,28,62,0.000333,0.097142,12,3497.12715,194.284842,291.427263,96.322519,1,2
0,0,8,8,13,14,27,35,28,63,0.000333,0.099853,12,3594.694952,199.705275,299.557913,101.408685,1,2
0,0,8,8,12,14,26,34,28,62,0.000333,0.097142,12,3497.12715,194.284842,291.427263,96.322519,1,2
0,0,8,8,13,14,27,35,28,63,0.000333,0.099853,12,3594.694952,199.705275,299.557913,101.408685,1,2
0,0,8,8,12,14,26,34,28,62,0.000333,0.097142,12,3497.12715,194.284842,291.427263,96.322519,1,2
0,0,5,5,10,12,22,35,21,56,0.000333,0.083243,5,1248.640853,69.368936,249.728171,76.238831,1,2
0,0,6,6,10,13,23,37,23,60,0.000333,0.090471,5,1357.068587,75.392699,271.413717,81.324997,1,2
0,0,6,6,10,13,23,37,23,60,0.000333,0.090471,5,1357.068587,75.392699,271.413717,81.324997,1,2
0,0,6,6,10,13,23,37,23,60,0.000333,0.090471,5,1357.068587,75.392699,271.413717,81.324997,1,2
0,0,6,6,10,13,23,37,23,60,0.000333,0.090471,5,1357.068587,75.392699,271.413717,81.324997,1,2
0,0,6,6,10,13,23,37,23,60,0.000333,0.090471,5,1357.068587,75.392699,271.413717,81.324997,1,2
0,0,6,6,10,13,23,37,23,60,0.000333,0.090471,5,1357.068587,75.392699,271.413717,81.324997,1,2
0,0,6,6,10,13,23,37,23,60,0.000333,0.090471,5,1357.068587,75.392699,271.413717,81.324997,1,2
0,0,6,6,10,13,23,37,23,60,0.000333,0.090471,5,1357.068587,75.392699,271.413717,81.324997,1,2
0,0,6,6,10,13,23,37,23,60,0.000333,0.090471,5,1357.068587,75.392699,271.413717,81.324997,1,2
0,0,6,6,10,13,23,37,23,60,0.000333,0.090471,5,1357.068587,75.392699,271.413717,81.324997,1,2
0,0,6,6,10,13,23,37,23,60,0.000333,0.090471,5,1357.068587,75.392699,271.413717,81.324997,1,2
0,0,6,6,10,13,23,37,23,60,0.000333,0.090471,5,1357.068587,75.392699,271.413717,81.324997,1,2
0,0,6,6,10,13,23,37,23,60,0.000333,0.090471,5,1357.068587,75.392699,271.413717,81.324997,1,2
0,0,6,6,10,13,23,37,23,60,0.000333,0.090471,5,1357.068587,75.392699,271.413717,81.324997,1,2
0,0,6,6,10,13,23,37,23,60,0.000333,0.090471,5,1357.068587,75.392699,271.413717,81.324997,1,2
0,0,6,6,10,13,23,37,23,60,0.000333,0.090471,5,1357.068587,75.392699,271.413717,81.324997,1,2
0,0,6,6,10,13,23,37,23,60,0.000333,0.090471,5,1357.068587,75.392699,271.413717,81.324997,1,2
0,0,7,7,11,13,24,42,27,69,0.000333,0.105454,10,3163.624125,175.756896,316.362413,86.159464,1,2
0,0,7,7,10,16,26,41,33,74,0.000333,0.115944,10,3478.325391,193.2403,347.832539,97.219281,1,2
0,0,7,7,10,13,23,41,27,68,0.000333,0.102534,10,3076.02213,170.890118,307.602213,81.324997,1,2
0,0,11,11,11,15,26,57,37,94,0.000333,0.14728,10,4418.413335,245.467408,441.841334,96.657107,1,2
0,0,9,9,11,19,30,44,34,78,0.000333,0.127579,5,1913.687332,106.315963,382.737466,118.764371,1,2
0,0,7,7,11,13,24,42,27,69,0.000333,0.105454,10,3163.624125,175.756896,316.362413,86.159464,1,2
0,0,10,10,12,14,26,50,33,83,0.000333,0.130045,12,4681.637959,260.090998,390.136497,96.322519,1,2
0,0,10,10,11,15,26,54,35,89,0.000333,0.139446,10,4183.391349,232.410631,418.339135,96.657107,1,2
0,0,10,10,10,18,28,45,37,82,0.000333,0.131401,10,3942.031036,219.001724,394.203104,108.277931,1,2
0,0,9,9,10,17,27,45,37,82,0.000333,0.129967,10,3899.007752,216.611542,389.900775,102.706149,1,2
0,0,11,11,10,18,28,51,49,100,0.000333,0.160245,10,4807.354922,267.075273,480.735492,108.277931,1,2
0,0,12,12,10,20,30,57,61,118,0.000333,0.193004,15,8685.196354,482.510909,579.01309,119.657843,1,2
0,0,15,15,10,20,30,63,73,136,0.000333,0.222446,15,10010.05682,556.114268,667.337121,119.657843,1,2
0,0,10,10,11,17,28,49,39,88,0.000333,0.141016,10,4230.472331,235.026241,423.047233,107.540616,1,2
0,0,10,10,11,18,29,51,40,91,0.000333,0.147359,10,4420.762706,245.597928,442.076271,113.112398,1,2
0,0,11,11,11,19,30,60,44,104,0.000333,0.170106,10,5103.166219,283.509234,510.316622,118.764371,1,2
0,0,10,10,10,18,28,53,41,94,0.000333,0.15063,10,4518.913627,251.050757,451.891363,108.277931,1,2
0,0,12,12,10,20,30,60,47,107,0.000333,0.175012,10,5250.372937,291.687385,525.037294,119.657843,1,2
0,0,12,12,11,20,31,52,52,104,0.000333,0.171745,10,5152.364163,286.242453,515.236416,124.49231,1,2
0,0,10,10,10,18,28,45,40,85,0.000333,0.136208,10,4086.251684,227.013982,408.625168,108.277931,1,2
0,0,10,10,14,20,34,52,45,97,0.000333,0.164495,14,6908.774538,383.820808,493.483896,139.741531,1,2
0,0,10,10,13,20,33,51,45,96,0.000333,0.161421,12,5811.142026,322.841224,484.261835,134.544278,1,2
0,0,8,8,13,15,28,44,30,74,0.000333,0.118581,12,4268.931171,237.162843,355.744264,106.709075,4,2
0,0,8,8,13,15,28,44,30,74,0.000333,0.118581,12,4268.931171,237.162843,355.744264,106.709075,4,2
0,0,8,8,13,15,28,44,30,74,0.000333,0.118581,12,4268.931171,237.162843,355.744264,106.709075,4,2
0,0,8,8,13,15,28,44,30,74,0.000333,0.118581,12,4268.931171,237.162843,355.744264,106.709075,4,2
0,0,8,8,13,15,28,44,30,74,0.000333,0.118581,12,4268.931171,237.162843,355.744264,106.709075,4,2
0,0,8,8,13,15,28,44,30,74,0.000333,0.118581,12,4268.931171,237.162843,355.744264,106.709075,4,2
0,0,8,8,13,15,28,44,30,74,0.000333,0.118581,12,4268.931171,237.162843,355.744264,106.709075,4,2
0,0,8,8,13,15,28,44,30,74,0.000333,0.118581,12,4268.931171,237.162843,355.744264,106.709075,4,2
0,0,8,8,13,15,28,44,30,74,0.000333,0.118581,12,4268.931171,237.162843,355.744264,106.709075,4,2
0,0,8,8,13,15,28,44,30,74,0.000333,0.118581,12,4268.931171,237.162843,355.744264,106.709075,4,2
0,0,8,8,13,15,28,44,30,74,0.000333,0.118581,12,4268.931171,237.162843,355.744264,106.709075,4,2
0,0,8,8,13,15,28,44,30,74,0.000333,0.118581,12,4268.931171,237.162843,355.744264,106.709075,4,2
0,0,8,8,13,15,28,44,30,74,0.000333,0.118581,12,4268.931171,237.162843,355.744264,106.709075,4,2
0,0,8,8,13,15,28,44,30,74,0.000333,0.118581,12,4268.931171,237.162843,355.744264,106.709075,4,2
0,0,8,8,13,15,28,44,30,74,0.000333,0.118581,12,4268.931171,237.162843,355.744264,106.709075,4,2
0,0,8,8,13,15,28,44,30,74,0.000333,0.118581,12,4268.931171,237.162843,355.744264,106.709075,4,2
0,0,8,8,13,15,28,44,30,74,0.000333,0.118581,12,4268.931171,237.162843,355.744264,106.709075,4,2
0,0,8,8,13,15,28,44,30,74,0.000333,0.118581,12,4268.931171,237.162843,355.744264,106.709075,4,2
0,0,10,10,14,17,31,50,36,86,0.000333,0.14202,14,5964.852358,331.380687,426.060883,122.789837,4,2
0,0,10,10,13,20,33,49,42,91,0.000333,0.153013,12,5508.478378,306.026577,459.039865,134.544278,4,2
0,0,10,10,13,16,29,48,36,84,0.000333,0.136023,12,4896.844843,272.046936,408.070404,112.105716,4,2
0,0,9,9,13,16,29,47,33,80,0.000333,0.129546,12,4663.661755,259.09232,388.63848,112.105716,4,2
0,0,22,22,17,23,40,101,64,165,0.000333,0.292706,16,14049.89017,780.549454,878.118136,173.528793,7,2
0,0,25,25,18,23,41,104,65,169,0.000333,0.301809,18,16297.6732,905.426289,905.426289,179.100575,7,2
0,0,23,23,18,23,41,104,65,169,0.000333,0.301809,18,16297.6732,905.426289,905.426289,179.100575,7,2
0,0,23,23,17,23,40,102,65,167,0.000333,0.296254,16,14220.19187,790.010659,888.761992,173.528793,7,2
0,0,25,25,18,23,41,102,65,167,0.000333,0.298237,18,16104.80133,894.711185,894.711185,179.100575,7,2
0,0,22,22,18,23,41,101,64,165,0.000333,0.294665,18,15911.92945,883.996081,883.996081,179.100575,7,2
0,0,23,23,18,25,43,104,67,171,0.000333,0.309297,18,16702.04292,927.891273,927.891273,191.155055,7,2
0,0,26,26,21,22,43,108,61,169,0.000333,0.30568,20,18340.77487,1018.931937,917.038744,190.346161,7,2
0,0,23,23,18,20,38,102,59,161,0.000333,0.281639,18,15208.49393,844.91633,844.91633,161.497212,7,2
0,0,21,21,20,22,42,108,67,175,0.000333,0.314552,30,28309.66647,1572.759248,943.655549,184.546058,7,2
0,0,22,22,19,22,41,96,59,155,0.000333,0.276807,18,14947.57009,830.420561,830.420561,178.818118,5,2
0,0,21,21,17,21,38,97,60,157,0.000333,0.274642,16,13182.79391,732.37744,823.92462,161.725534,6,2
0,0,21,21,16,24,40,96,72,168,0.000333,0.298028,24,21458.01408,1192.111893,894.08392,174.0391,6,2
0,0,21,21,17,21,38,98,63,161,0.000333,0.281639,24,20277.99191,1126.555106,844.91633,161.725534,5,2
0,0,24,24,18,22,40,113,71,184,0.000333,0.326412,27,26439.33878,1468.852154,979.234769,173.166146,5,2
0,0,25,25,20,27,47,106,71,177,0.000333,0.327721,20,19663.24454,1092.402474,983.162227,214.820524,5,2
0,0,21,21,17,21,38,99,63,162,0.000333,0.283388,24,20403.94217,1133.552343,850.164257,161.725534,5,2
0,0,22,22,18,21,39,103,65,168,0.000333,0.295983,27,23974.58447,1331.921359,887.947573,167.297316,5,2
0,0,20,20,17,21,38,102,61,163,0.000333,0.285137,16,13686.59496,760.366386,855.412185,161.725534,5,2
0,0,23,23,17,25,42,99,71,170,0.000333,0.305565,16,14667.10339,814.839077,916.693962,185.583273,5,2
0,0,21,21,17,24,41,98,69,167,0.000333,0.298237,16,14315.37896,795.298831,894.711185,179.525968,5,2
0,0,23,23,17,25,42,104,81,185,0.000333,0.332526,24,23941.88936,1330.104964,997.578723,185.583273,5,2
0,0,25,25,17,26,43,110,93,203,0.000333,0.367177,24,26436.76189,1468.708994,1101.531745,191.698301,5,2
0,0,27,27,17,27,44,116,105,221,0.000333,0.402178,24,28956.82531,1608.712517,1206.534388,197.868831,5,2
0,0,22,22,18,24,42,102,71,173,0.000333,0.310957,18,16791.67646,932.870914,932.870914,185.09775,5,2
0,0,22,22,18,25,43,104,72,176,0.000333,0.318341,18,17190.40674,955.022597,955.022597,191.155055,5,2
0,0,23,23,18,26,44,113,76,189,0.000333,0.343944,18,18572.98637,1031.832576,1031.832576,197.270083,5,2
0,0,20,20,16,24,40,101,67,168,0.000333,0.298028,16,14305.34272,794.741262,894.08392,174.0391,5,2
0,0,24,24,17,27,44,113,79,192,0.000333,0.349404,16,16771.37393,931.742996,1048.210871,197.868831,5,2
0,0,27,27,21,28,49,111,94,205,0.000333,0.383672,30,34530.46554,1918.359197,1151.015518,226.844604,5,2
0,0,23,23,17,25,42,98,77,175,0.000333,0.314552,24,22647.73318,1258.207399,943.655549,185.583273,5,2
0,0,22,22,21,27,48,105,77,182,0.000333,0.338821,20,20329.2635,1129.403528,1016.463175,220.620628,5,2
0,0,22,22,20,27,47,104,77,181,0.000333,0.335127,20,20107.61164,1117.089536,1005.380582,214.820524,5,2
0,0,12,12,15,15,30,57,38,95,0.000333,0.155385,14,6526.164492,362.564694,466.154607,117.206718,6,2
0,0,14,14,15,15,30,63,40,103,0.000333,0.16847,14,7075.736239,393.096458,505.409731,117.206718,8,2
0,0,14,14,15,16,31,63,42,105,0.000333,0.173397,14,7282.668576,404.592699,520.190613,122.603359,8,2
0,0,16,16,17,17,34,71,46,117,0.000333,0.198411,16,9523.730439,529.096135,595.233152,138.973737,8,2
0,0,16,16,16,17,33,69,46,115,0.000333,0.193368,16,9281.68518,515.649177,580.105324,133.486868,8,2
0,0,15,15,17,17,34,67,45,112,0.000333,0.189932,16,9116.733412,506.48519,569.795838,138.973737,8,2
0,0,15,15,16,17,33,66,45,111,0.000333,0.186643,16,8958.843956,497.713553,559.927747,133.486868,8,2
0,0,18,18,17,17,34,69,46,115,0.000333,0.195019,16,9360.931628,520.051757,585.058227,138.973737,8,2
0,0,16,16,16,17,33,69,46,115,0.000333,0.193368,16,9281.68518,515.649177,580.105324,133.486868,8,2
0,0,16,16,15,17,32,67,46,113,0.000333,0.188333,14,7910,439.444444,565,128.090227,8,2
0,0,18,18,16,17,33,67,46,113,0.000333,0.190006,16,9120.264568,506.681365,570.016535,133.486868,8,2
0,0,15,15,16,17,33,66,45,111,0.000333,0.186643,16,8958.843956,497.713553,559.927747,133.486868,8,2
0,0,15,15,15,17,32,65,45,110,0.000333,0.183333,14,7700,427.777778,550,128.090227,8,2
0,0,22,22,20,17,37,79,42,121,0.000333,0.210115,20,12606.87715,700.382064,630.343857,155.92543,8,2
0,0,16,16,17,15,32,67,40,107,0.000333,0.178333,16,8560,475.555556,535,128.090227,8,2
0,0,14,14,18,17,35,73,48,121,0.000333,0.206881,18,11171.57841,620.643245,620.643245,144.545518,8,2
0,0,16,16,17,17,34,63,42,105,0.000333,0.178061,16,8546.937573,474.829865,534.183598,138.973737,6,2
0,0,16,16,16,18,34,69,47,116,0.000333,0.196715,16,9442.331033,524.573946,590.14569,139.05865,7,2
0,0,16,16,15,20,35,68,55,123,0.000333,0.210301,14,8832.625355,490.701409,630.901811,145.041921,7,2
0,0,14,14,15,16,31,63,44,107,0.000333,0.1767,14,7421.386073,412.299226,530.099005,122.603359,6,2
0,0,17,17,16,17,33,78,52,130,0.000333,0.21859,24,15738.50965,874.361647,655.771236,133.486868,6,2
0,0,19,19,19,21,40,73,56,129,0.000333,0.228843,18,12357.51704,686.528724,686.528724,172.949289,6,2
0,0,14,14,16,17,33,64,44,108,0.000333,0.181598,16,8716.713038,484.261835,544.794565,133.486868,6,2
0,0,15,15,17,16,33,68,46,114,0.000333,0.191687,16,9200.974874,511.165271,575.06093,133.486868,6,2
0,0,15,15,16,18,34,72,48,120,0.000333,0.203499,16,9767.928655,542.662703,610.495541,139.05865,6,2
0,0,16,16,16,20,36,64,50,114,0.000333,0.196457,16,9429.943203,523.885733,589.37145,150.438562,6,2
0,0,14,14,15,19,34,63,48,111,0.000333,0.188236,14,7905.917255,439.217625,564.708375,139.313982,6,2
0,0,16,16,15,20,35,69,58,127,0.000333,0.21714,14,9119.865204,506.659178,651.418943,145.041921,6,2
0,0,18,18,15,21,36,75,68,143,0.000333,0.246433,21,15525.28478,862.515821,739.299275,150.842025,6,2
0,0,20,20,15,22,37,81,78,159,0.000333,0.276101,21,17394.36479,966.353599,828.303085,156.710855,6,2
0,0,15,15,16,18,34,67,50,117,0.000333,0.198411,16,9523.730439,529.096135,595.233152,139.05865,6,2
0,0,15,15,16,20,36,69,51,120,0.000333,0.206797,16,9926.256003,551.458667,620.391,150.438562,6,2
0,0,16,16,16,21,37,78,55,133,0.000333,0.230952,16,11085.71676,615.873153,692.857298,156.238666,6,2
0,0,15,15,15,20,35,71,52,123,0.000333,0.210301,14,8832.625355,490.701409,630.901811,145.041921,6,2
0,0,17,17,15,22,37,78,58,136,0.000333,0.236162,14,9918.799208,551.0444,708.485658,156.710855,6,2
0,0,17,17,16,22,38,70,61,131,0.000333,0.22916,16,10999.65607,611.092004,687.478504,162.107496,6,2
0,0,16,16,15,20,35,63,54,117,0.000333,0.200042,14,8401.765582,466.764755,600.126113,145.041921,6,2
0,0,15,15,19,22,41,70,55,125,0.000333,0.223231,18,12054.49201,669.694001,669.694001,178.818118,6,2
0,0,15,15,18,22,40,69,55,124,0.000333,0.219973,18,11878.54351,659.919084,659.919084,173.166146,6,2
0,0,12,12,15,14,29,56,37,93,0.000333,0.150597,14,6325.091256,351.393959,451.792233,111.906328,5,2
0,0,14,14,15,14,29,62,39,101,0.000333,0.163552,14,6869.185127,381.621396,490.656081,111.906328,7,2
0,0,14,14,15,15,30,62,41,103,0.000333,0.16847,14,7075.736239,393.096458,505.409731,117.206718,7,2
0,0,16,16,17,16,33,70,45,115,0.000333,0.193368,16,9281.68518,515.649177,580.105324,133.486868,7,2
0,0,16,16,16,16,32,68,45,113,0.000333,0.188333,16,9040,502.222222,565,128,7,2
0,0,15,15,17,16,33,66,44,110,0.000333,0.184961,16,8878.13365,493.229647,554.883353,133.486868,7,2
0,0,15,15,16,16,32,65,44,109,0.000333,0.181667,16,8720,484.444444,545,128,7,2
0,0,18,18,17,16,33,68,45,113,0.000333,0.190006,16,9120.264568,506.681365,570.016535,133.486868,7,2
0,0,16,16,16,16,32,68,45,113,0.000333,0.188333,16,9040,502.222222,565,128,7,2
0,0,16,16,15,16,31,66,45,111,0.000333,0.183305,14,7698.821066,427.712281,549.91579,122.603359,7,2
0,0,18,18,16,16,32,66,45,111,0.000333,0.185,16,8880,493.333333,555,128,7,2
0,0,15,15,16,16,32,65,44,109,0.000333,0.181667,16,8720,484.444444,545,128,7,2
0,0,15,15,15,16,31,64,44,108,0.000333,0.178351,14,7490.744821,416.15249,535.053202,122.603359,7,2
0,0,22,22,20,16,36,78,41,119,0.000333,0.205074,20,12304.4215,683.578972,615.221075,150.438562,7,2
0,0,16,16,17,14,31,66,39,105,0.000333,0.173397,16,8323.049801,462.391656,520.190613,122.789837,7,2
0,0,14,14,18,16,34,72,47,119,0.000333,0.201803,18,10897.34541,605.408078,605.408078,139.05865,7,2
0,0,16,16,17,16,33,62,41,103,0.000333,0.173191,16,8313.161509,461.842306,519.572594,133.486868,5,2
0,0,16,16,16,17,33,68,46,114,0.000333,0.191687,16,9200.974874,511.165271,575.06093,133.486868,6,2
0,0,16,16,15,19,34,67,54,121,0.000333,0.205194,14,8618.162053,478.786781,615.583004,139.313982,6,2
0,0,14,14,15,15,30,62,43,105,0.000333,0.171741,14,7213.129176,400.729399,515.223513,117.206718,5,2
0,0,17,17,16,16,32,77,51,128,0.000333,0.213333,24,15360,853.333333,640,128,5,2
0,0,15,15,16,20,36,64,48,112,0.000333,0.193011,16,9264.505603,514.694756,579.0316,150.438562,5,2
0,0,14,14,16,16,32,63,43,106,0.000333,0.176667,16,8480,471.111111,530,128,5,2
0,0,15,15,17,15,32,67,45,112,0.000333,0.186667,24,13440,746.666667,560,128.090227,5,2
0,0,14,14,16,17,33,69,45,114,0.000333,0.191687,16,9200.974874,511.165271,575.06093,133.486868,5,2
0,0,16,16,16,19,35,63,49,112,0.000333,0.191493,16,9191.675166,510.64862,574.479698,144.710623,5,2
0,0,14,14,15,18,33,62,47,109,0.000333,0.18328,14,7697.745426,427.652524,549.838959,133.662009,5,2
0,0,16,16,15,19,34,68,57,125,0.000333,0.211978,21,13354.58996,741.921664,635.932855,139.313982,5,2
0,0,18,18,15,20,35,74,67,141,0.000333,0.241076,21,15187.80701,843.767056,723.228905,145.041921,5,2
0,0,20,20,15,21,36,80,77,157,0.000333,0.270559,21,17045.24273,946.957929,811.678225,150.842025,5,2
0,0,15,15,16,17,33,66,49,115,0.000333,0.193368,16,9281.68518,515.649177,580.105324,133.486868,5,2
0,0,15,15,16,19,35,68,50,118,0.000333,0.201752,16,9684.086336,538.004796,605.255396,144.710623,5,2
0,0,16,16,16,20,36,77,54,131,0.000333,0.225753,16,10836.1628,602.009045,677.260175,150.438562,5,2
0,0,15,15,15,19,34,70,51,121,0.000333,0.205194,14,8618.162053,478.786781,615.583004,139.313982,5,2
0,0,17,17,15,21,36,77,57,134,0.000333,0.230923,14,9698.779303,538.821072,692.76995,150.842025,5,2
0,0,17,17,16,21,37,69,60,129,0.000333,0.224006,16,10752.31175,597.350653,672.019484,156.238666,5,2
0,0,16,16,15,19,34,62,53,115,0.000333,0.195019,14,8190.815174,455.045287,585.058227,139.313982,5,2
0,0,14,14,19,21,40,67,52,119,0.000333,0.211103,18,11399.56998,633.309443,633.309443,172.949289,5,2
0,0,14,14,18,21,39,66,52,118,0.000333,0.207892,18,11226.19431,623.677462,623.677462,167.297316,5,2
0,0,18,18,15,21,36,64,52,116,0.000333,0.199904,14,8395.958202,466.442122,599.7113,150.842025,7,2
0,0,19,19,14,21,35,68,52,120,0.000333,0.205171,14,8617.195468,478.733082,615.513962,145.541635,9,2
0,0,19,19,14,22,36,68,54,122,0.000333,0.210244,14,8830.231902,490.568439,630.73085,151.410465,9,2
0,0,21,21,16,23,39,76,58,134,0.000333,0.236081,16,11331.90236,629.550131,708.243897,168.041925,9,2
0,0,21,21,15,23,38,74,58,132,0.000333,0.230909,14,9698.170045,538.787225,692.726432,162.645284,9,2
0,0,20,20,16,23,39,72,57,129,0.000333,0.227272,16,10909.07018,606.059454,681.816886,168.041925,9,2
0,0,20,20,15,23,38,71,57,128,0.000333,0.223912,14,9404.286104,522.460339,671.734722,162.645284,9,2
0,0,23,23,16,23,39,74,58,132,0.000333,0.232558,16,11162.76949,620.15386,697.673093,168.041925,9,2
0,0,21,21,15,23,38,74,58,132,0.000333,0.230909,14,9698.170045,538.787225,692.726432,162.645284,9,2
0,0,21,21,14,23,37,72,58,130,0.000333,0.225743,14,9481.205125,526.733618,677.228938,157.344894,9,2
0,0,23,23,15,23,38,72,58,130,0.000333,0.22741,14,9551.228074,530.623782,682.230577,162.645284,9,2
0,0,20,20,15,23,38,71,57,128,0.000333,0.223912,14,9404.286104,522.460339,671.734722,162.645284,9,2
0,0,20,20,14,23,37,70,57,127,0.000333,0.220534,14,9262.408084,514.578227,661.600577,157.344894,9,2
0,0,27,27,19,23,42,84,54,138,0.000333,0.248047,18,13394.51648,744.139804,744.139804,184.752548,9,2
0,0,21,21,16,21,37,72,52,124,0.000333,0.215324,16,10335.55548,574.197527,645.972217,156.238666,9,2
0,0,19,19,17,23,40,78,60,138,0.000333,0.244809,16,11750.81723,652.82318,734.426077,173.528793,9,2
0,0,21,21,16,23,39,68,54,122,0.000333,0.21494,16,10317.10513,573.172507,644.819071,168.041925,7,2
0,0,21,21,16,24,40,74,59,133,0.000333,0.235939,16,11325.06299,629.170166,707.816437,174.0391,8,2
0,0,21,21,15,26,41,73,67,140,0.000333,0.250019,14,10500.80193,583.377885,750.057281,180.814792,8,2
0,0,19,19,15,22,37,68,56,124,0.000333,0.215324,14,9043.611043,502.422836,645.972217,156.710855,7,2
0,0,22,22,16,23,39,83,64,147,0.000333,0.258985,16,12431.26602,690.62589,776.954126,168.041925,7,2
0,0,21,21,16,27,43,72,63,135,0.000333,0.244182,16,11720.73187,651.151771,732.545742,192.381963,7,2
0,0,19,19,16,23,39,69,56,125,0.000333,0.220225,16,10570.80444,587.266913,660.675277,168.041925,7,2
0,0,21,21,17,22,39,75,60,135,0.000333,0.237843,16,11416.46879,634.248266,713.5293,167.594364,7,2
0,0,20,20,16,24,40,77,60,137,0.000333,0.243035,16,11665.66638,648.092577,729.104149,174.0391,7,2
0,0,22,22,16,26,42,71,64,135,0.000333,0.242654,16,11647.40563,647.078091,727.962852,186.211433,7,2
0,0,19,19,15,25,40,68,60,128,0.000333,0.227069,14,9536.895146,529.827508,681.206796,174.699764,7,2
0,0,21,21,15,26,41,74,70,144,0.000333,0.257162,14,10800.82484,600.045825,771.487489,180.814792,7,2
0,0,23,23,15,27,42,80,80,160,0.000333,0.28759,14,12078.79103,671.043946,862.770788,186.985321,7,2
0,0,25,25,15,28,43,86,90,176,0.000333,0.318341,21,20055.47453,1114.19303,955.022597,193.209297,7,2
0,0,21,21,16,24,40,74,64,138,0.000333,0.244809,16,11750.81723,652.82318,734.426077,174.0391,7,2
0,0,21,21,16,26,42,76,65,141,0.000333,0.253439,16,12165.06811,675.837117,760.316757,186.211433,7,2
0,0,21,21,16,27,43,83,67,150,0.000333,0.271313,16,13023.03541,723.501967,813.939713,192.381963,7,2
0,0,21,21,15,26,41,78,66,144,0.000333,0.257162,14,10800.82484,600.045825,771.487489,180.814792,7,2
0,0,23,23,15,28,43,85,72,157,0.000333,0.283975,14,11926.92993,662.607218,851.923566,193.209297,7,2
0,0,23,23,16,28,44,77,75,152,0.000333,0.276611,16,13277.3377,737.629872,829.833606,198.605938,7,2
0,0,22,22,15,26,41,70,68,138,0.000333,0.246447,14,10350.79047,575.043915,739.342177,180.814792,7,2
0,0,21,21,19,28,47,77,69,146,0.000333,0.270323,18,14597.4595,810.969972,810.969972,215.316561,7,2
0,0,21,21,18,28,46,76,69,145,0.000333,0.266972,18,14416.49671,800.916484,800.916484,209.664588,7,2
0,0,16,16,17,21,38,74,51,125,0.000333,0.218664,16,10495.85503,583.103057,655.990939,161.725534,6,2
0,0,18,18,17,21,38,80,53,133,0.000333,0.232658,16,11167.58975,620.421653,697.974359,161.725534,8,2
0,0,18,18,17,22,39,80,55,135,0.000333,0.237843,16,11416.46879,634.248266,713.5293,167.594364,8,2
0,0,20,20,18,23,41,88,59,147,0.000333,0.26252,18,14176.0826,787.560145,787.560145,179.100575,8,2
0,0,20,20,17,23,40,86,59,145,0.000333,0.257227,16,12346.87318,685.937399,771.679574,173.528793,8,2
0,0,19,19,18,23,41,84,58,142,0.000333,0.253591,18,13693.90292,760.772385,760.772385,179.100575,8,2
0,0,19,19,17,23,40,83,58,141,0.000333,0.250131,16,12006.26978,667.014988,750.391861,173.528793,8,2
0,0,22,22,18,23,41,86,59,145,0.000333,0.258948,18,13983.21073,776.845041,776.845041,179.100575,8,2
0,0,20,20,18,23,41,86,59,145,0.000333,0.258948,18,13983.21073,776.845041,776.845041,179.100575,8,2
0,0,20,20,17,23,40,84,59,143,0.000333,0.253679,16,12176.57148,676.476193,761.035718,173.528793,8,2
0,0,22,22,18,23,41,84,59,143,0.000333,0.255377,18,13790.33886,766.129937,766.129937,179.100575,8,2
0,0,19,19,18,23,41,83,58,141,0.000333,0.251805,18,13597.46699,755.414833,755.414833,179.100575,8,2
0,0,19,19,17,23,40,82,58,140,0.000333,0.248357,16,11921.11893,662.284385,745.069933,173.528793,8,2
0,0,23,23,22,23,45,90,55,145,0.000333,0.26544,22,17519.01138,973.27841,796.318699,202.149421,8,2
0,0,20,20,19,21,40,84,53,137,0.000333,0.243035,18,13123.87468,729.104149,729.104149,172.949289,8,2
0,0,19,19,20,23,43,92,63,155,0.000333,0.280357,20,16821.42074,934.523374,841.071037,190.480487,8,2
0,0,20,20,19,23,42,80,55,135,0.000333,0.242654,18,13103.33134,727.962852,727.962852,184.752548,6,2
0,0,18,18,17,22,39,79,54,133,0.000333,0.234319,16,11247.33592,624.851996,702.958495,167.594364,7,2
0,0,18,18,16,24,40,78,62,140,0.000333,0.248357,16,11921.11893,662.284385,745.069933,174.0391,7,2
0,0,18,18,17,22,39,80,57,137,0.000333,0.241367,16,11585.60166,643.644537,724.100104,167.594364,6,2
0,0,21,21,18,23,41,95,65,160,0.000333,0.285736,18,15429.74977,857.208321,857.208321,179.100575,6,2
0,0,18,18,17,22,39,80,57,137,0.000333,0.241367,16,11585.60166,643.644537,724.100104,167.594364,6,2
0,0,18,18,17,22,39,81,57,138,0.000333,0.243129,16,11670.1681,648.342672,729.385506,167.594364,6,2
0,0,20,20,18,22,40,87,61,148,0.000333,0.262548,18,14177.61645,787.645358,787.645358,173.166146,6,2
0,0,17,17,17,22,39,84,55,139,0.000333,0.24489,16,11754.73454,653.040807,734.670908,167.594364,6,2
0,0,20,20,17,25,42,81,63,144,0.000333,0.258831,16,12423.89934,690.21663,776.493709,185.583273,6,2
0,0,18,18,17,24,41,80,61,141,0.000333,0.251805,16,12086.63732,671.479851,755.414833,179.525968,6,2
0,0,20,20,17,25,42,86,71,157,0.000333,0.282198,16,13545.50137,752.527854,846.593835,185.583273,6,2
0,0,22,22,17,26,43,92,81,173,0.000333,0.312915,24,22529.85126,1251.658403,938.743803,191.698301,6,2
0,0,24,24,17,27,44,98,91,189,0.000333,0.343944,24,24763.98182,1375.776768,1031.832576,197.868831,6,2
0,0,20,20,18,24,42,86,65,151,0.000333,0.271413,18,14656.31876,814.239931,814.239931,185.09775,6,2
0,0,20,20,18,25,43,88,66,154,0.000333,0.278548,18,15041.6059,835.644772,835.644772,191.155055,6,2
0,0,20,20,18,26,44,95,68,163,0.000333,0.296629,18,16017.97237,889.887354,889.887354,197.270083,6,2
0,0,17,17,16,24,40,83,59,142,0.000333,0.251905,16,12091.42063,671.745591,755.713789,174.0391,6,2
0,0,21,21,17,27,44,95,71,166,0.000333,0.302089,16,14500.25038,805.569466,906.265649,197.868831,6,2
0,0,21,21,18,27,45,87,74,161,0.000333,0.294729,18,15915.39027,884.188349,884.188349,203.440613,6,2
0,0,20,20,17,25,42,80,67,147,0.000333,0.264224,16,12682.73058,704.596143,792.670661,185.583273,6,2
0,0,19,19,21,27,48,87,68,155,0.000333,0.288556,20,17313.38375,961.854653,865.669188,220.620628,6,2
0,0,19,19,20,27,47,86,68,154,0.000333,0.285136,20,17108.13366,950.45187,855.406683,214.820524,6,2
0,0,5,5,7,14,21,26,20,46,0.000333,0.067349,3,606.139804,33.674434,202.046601,72.954453,2,0
0,0,5,5,7,14,21,26,20,46,0.000333,0.067349,3,606.139804,33.674434,202.046601,72.954453,2,0
0,0,55,55,22,62,84,406,286,692,0.000333,1.474495,44,194633.2809,10812.96005,4423.483657,467.267667,32,0
0,0,5,5,13,16,29,37,26,63,0.000333,0.102018,6,1836.316816,102.017601,306.052803,112.105716,2,0
0,0,7,7,10,15,25,30,24,54,0.000333,0.083589,5,1253.841171,69.657843,250.768234,91.82264,2,0
0,0,6,6,13,13,26,30,22,52,0.000333,0.081474,6,1466.537192,81.474288,244.422865,96.211433,2,0
0,0,12,12,14,15,29,70,48,118,0.000333,0.191081,21,12038.07691,668.78205,573.241757,111.906328,1,0
0,0,19,19,15,26,41,94,71,165,0.000333,0.294665,14,12375.94513,687.552507,883.996081,180.814792,2,0
0,0,19,19,15,26,41,94,71,165,0.000333,0.294665,14,12375.94513,687.552507,883.996081,180.814792,2,0
0,0,4,4,11,6,17,19,10,29,0.000333,0.039512,5,592.682112,32.926784,118.536422,53.563523,3,0
0,0,4,4,11,6,17,19,10,29,0.000333,0.039512,5,592.682112,32.926784,118.536422,53.563523,3,0
0,0,3,3,6,7,13,13,10,23,0.000333,0.02837,3,255.330341,14.185019,85.110114,35.161259,4,0
0,0,13,13,18,43,61,142,82,224,0.000333,0.442828,9,11956.36647,664.242582,1328.485164,308.388034,1,0
0,0,13,13,16,30,46,70,52,122,0.000333,0.224625,8,5390.996469,299.499804,673.874559,211.206718,4,0
0,0,28,28,17,36,53,140,127,267,0.000333,0.509785,24,36704.51427,2039.139682,1529.354761,255.604168,3,0
0,0,6,6,10,14,24,23,20,43,0.000333,0.065718,5,985.766938,54.76483,197.153388,86.52225,1,0
0,0,4,4,9,12,21,17,15,32,0.000333,0.046851,4,562.21663,31.234257,140.554158,71.548875,1,0
0,0,5,5,9,16,25,21,20,41,0.000333,0.063466,4,761.592415,42.31069,190.398104,92.529325,1,0
0,0,4,4,12,8,20,17,11,28,0.000333,0.040338,6,726.08392,40.337996,121.013987,67.01955,2,0
0,0,3,3,7,7,14,20,11,31,0.000333,0.039343,3,354.084008,19.671334,118.028003,39.302969,2,0
0,0,3,3,7,7,14,20,11,31,0.000333,0.039343,3,354.084008,19.671334,118.028003,39.302969,2,0
0,0,3,3,11,10,21,22,15,37,0.000333,0.054172,5,812.578723,45.143262,162.515745,71.273029,2,0
0,0,4,4,11,9,20,22,14,36,0.000333,0.051863,5,777.947057,43.219281,155.589411,66.583073,2,0
0,0,4,4,11,9,20,22,14,36,0.000333,0.051863,5,777.947057,43.219281,155.589411,66.583073,2,0
0,0,4,4,18,13,31,36,21,57,0.000333,0.09413,9,2541.502707,141.194595,282.38919,123.164366,2,0
0,0,6,6,17,12,29,31,23,54,0.000333,0.087444,8,2098.64779,116.591544,262.330974,112.506418,3,0
0,0,3,3,8,10,18,18,14,32,0.000333,0.044479,4,533.7504,29.6528,133.4376,57.219281,2,0
0,0,45,45,19,47,66,211,164,375,0.000333,0.755549,27,61199.49046,3399.971692,2266.647795,341.776299,8,0
0,0,8,8,10,9,19,62,33,95,0.000333,0.134518,15,6053.296707,336.294261,403.553114,61.748606,2,0
0,0,3,3,10,9,19,20,13,33,0.000333,0.046727,5,700.90804,38.939336,140.181608,61.748606,3,0
0,0,3,3,11,6,17,15,8,23,0.000333,0.031337,5,470.058227,26.114346,94.011645,53.563523,1,0
0,0,33,33,17,43,60,220,173,393,0.000333,0.773803,32,74285.05613,4126.947563,2321.408004,302.816253,1,0
0,0,29,29,14,41,55,199,163,362,0.000333,0.697617,21,43949.89654,2441.660919,2092.852216,272.962601,1,0
0,0,32,32,17,43,60,213,170,383,0.000333,0.754113,24,54296.13836,3016.452131,2262.339098,302.816253,1,0
0,0,32,32,17,43,60,223,178,401,0.000333,0.789554,32,75797.22012,4210.956673,2368.663129,302.816253,1,0
0,0,4,4,11,12,23,26,17,43,0.000333,0.064838,5,972.565821,54.031434,194.513164,81.073298,3,0
0,0,4,4,11,12,23,26,17,43,0.000333,0.064838,5,972.565821,54.031434,194.513164,81.073298,3,0
0,0,15,15,14,21,35,75,63,138,0.000333,0.235947,21,14864.66218,825.814566,707.841056,145.541635,7,0
0,0,5,5,8,11,19,22,21,43,0.000333,0.060887,4,730.643532,40.591307,182.660883,62.053748,1,0
0,0,5,5,17,15,32,39,21,60,0.000333,0.1,8,2400,133.333333,300,128.090227,2,0
0,0,15,15,19,23,42,115,69,184,0.000333,0.330729,27,26789.03296,1488.279609,992.186406,184.752548,5,0
0,0,5,5,10,14,24,41,22,63,0.000333,0.096284,5,1444.263188,80.236844,288.852638,86.52225,4,0
0,0,5,5,10,14,24,41,22,63,0.000333,0.096284,5,1444.263188,80.236844,288.852638,86.52225,4,0
0,0,4,4,11,19,30,27,23,50,0.000333,0.081782,5,1226.722649,68.151258,245.34453,118.764371,1,0
0,0,4,4,11,19,30,27,23,50,0.000333,0.081782,5,1226.722649,68.151258,245.34453,118.764371,1,0
0,0,12,12,16,22,38,57,35,92,0.000333,0.160936,8,3862.47465,214.581925,482.809331,162.107496,3,0
0,0,15,15,14,23,37,106,89,195,0.000333,0.338614,21,21332.71153,1185.150641,1015.843406,157.344894,2,0
0,0,3,3,12,13,25,26,20,46,0.000333,0.071206,6,1281.704308,71.205795,213.617385,91.125266,2,0
0,0,9,9,16,20,36,62,46,108,0.000333,0.186117,16,8933.630402,496.3128,558.3519,150.438562,3,0
0,0,11,11,18,22,40,67,52,119,0.000333,0.211103,18,11399.56998,633.309443,633.309443,173.166146,3,0
0,0,3,3,9,7,16,14,9,23,0.000333,0.030667,4,368,20.444444,92,48.180809,1,0
0,0,94,94,25,75,100,598,499,1097,0.000333,2.429437,72,524758.3373,29153.24096,7288.31024,583.257807,57,0
0,0,11,11,17,23,40,72,45,117,0.000333,0.207555,8,4981.324697,276.740261,622.665587,173.528793,4,0
0,0,95,95,26,82,108,632,525,1157,0.000333,2.605135,78,609601.5775,33866.75431,7815.40484,643.530697,57,0
0,0,6,6,17,15,32,39,24,63,0.000333,0.105,8,2520,140,315,128.090227,3,0
0,0,3,3,8,10,18,17,12,29,0.000333,0.040309,4,483.7113,26.87285,120.927825,57.219281,1,0
0,0,3,3,8,10,18,17,12,29,0.000333,0.040309,4,483.7113,26.87285,120.927825,57.219281,1,0
0,0,9,9,11,18,29,62,45,107,0.000333,0.173268,10,5198.039665,288.779981,519.803966,113.112398,1,0
0,0,4,4,6,9,15,18,15,33,0.000333,0.042976,3,386.782169,21.487898,128.92739,44.0391,1,0
0,0,4,4,16,15,31,33,26,59,0.000333,0.097433,8,2338.380659,129.910037,292.297582,122.603359,3,0
0,0,8,8,9,16,25,35,37,72,0.000333,0.111453,8,2674.861165,148.603398,334.357646,92.529325,1,0
0,0,9,9,17,23,40,56,41,97,0.000333,0.172076,8,4129.816202,229.434233,516.227025,173.528793,2,0
0,0,11,11,15,16,31,65,39,104,0.000333,0.171745,14,7213.309828,400.739435,515.236416,122.603359,11,0
0,0,11,11,15,16,31,65,39,104,0.000333,0.171745,14,7213.309828,400.739435,515.236416,122.603359,11,0
0,0,10,10,11,19,30,71,51,122,0.000333,0.199547,10,5986.406527,332.57814,598.640653,118.764371,1,0
0,0,21,21,10,5,15,85,43,128,0.000333,0.166694,40,20003.27985,1111.293325,500.081996,44.828921,22,0
0,0,21,21,10,5,15,85,43,128,0.000333,0.166694,40,20003.27985,1111.293325,500.081996,44.828921,22,0
0,0,40,40,16,42,58,208,165,373,0.000333,0.728342,24,52440.64587,2913.369215,2185.026911,290.477332,1,0
0,0,14,14,10,20,30,71,52,123,0.000333,0.201183,10,6035.475433,335.304191,603.547543,119.657843,1,0
0,0,3,3,8,8,16,18,11,29,0.000333,0.038667,4,464,25.777778,116,48,2,0
0,0,3,3,8,8,16,18,11,29,0.000333,0.038667,4,464,25.777778,116,48,2,0
0,0,4,4,9,13,22,22,17,39,0.000333,0.057973,4,695.671333,38.648407,173.917833,76.635041,1,0
0,0,4,4,9,13,22,22,17,39,0.000333,0.057973,4,695.671333,38.648407,173.917833,76.635041,1,0
0,0,3,3,9,5,14,17,8,25,0.000333,0.031728,4,380.735492,21.151972,95.183873,40.138965,2,0
0,0,74,74,25,51,76,327,278,605,0.000333,1.259999,60,226799.7687,12599.98715,3779.996146,405.390097,24,0
0,0,18,18,9,32,41,84,82,166,0.000333,0.296451,8,7114.829062,395.268281,889.353633,188.529325,1,0
0,0,18,18,9,32,41,86,84,170,0.000333,0.303595,8,7286.270726,404.792818,910.783841,188.529325,1,0
0,0,3,3,9,7,16,13,10,23,0.000333,0.030667,4,368,20.444444,92,48.180809,1,0
0,0,3,3,9,7,16,13,10,23,0.000333,0.030667,4,368,20.444444,92,48.180809,1,0
0,0,5,5,8,13,21,24,21,45,0.000333,0.065885,4,790.617136,43.923174,197.654284,72.105716,1,0
0,0,5,5,8,13,21,24,21,45,0.000333,0.065885,4,790.617136,43.923174,197.654284,72.105716,1,0
0,0,24,24,16,30,46,124,106,230,0.000333,0.423473,24,30490.062,1693.892333,1270.41925,211.206718,6,0
0,0,5,5,12,4,16,43,14,57,0.000333,0.076,18,4104,228,228,51.01955,6,0
0,0,19,19,18,51,69,203,121,324,0.000333,0.659721,18,35624.91463,1979.161924,1979.161924,364.352342,2,0
0,0,5,5,14,7,21,27,13,40,0.000333,0.058564,7,1229.848878,68.324938,175.692697,72.954453,3,0
0,0,5,5,14,7,21,27,13,40,0.000333,0.058564,7,1229.848878,68.324938,175.692697,72.954453,3,0
0,0,17,17,18,51,69,195,117,312,0.000333,0.635287,18,34305.47335,1905.859631,1905.859631,364.352342,1,0
0,0,9,9,15,8,23,46,22,68,0.000333,0.102534,14,4306.430982,239.246166,307.602213,82.603359,5,0
0,0,9,9,15,8,23,46,22,68,0.000333,0.102534,14,4306.430982,239.246166,307.602213,82.603359,5,0
0,0,3,3,5,7,12,10,9,19,0.000333,0.022705,2,136.228575,7.568254,68.114288,31.261125,2,0
0,0,18,18,18,51,69,199,119,318,0.000333,0.647504,18,34965.19399,1942.510777,1942.510777,364.352342,2,0
0,0,4,4,7,10,17,15,14,29,0.000333,0.039512,3,355.609267,19.75607,118.536422,52.870765,1,0
0,0,3,3,9,11,20,31,20,51,0.000333,0.073473,4,881.673331,48.981852,220.418333,66.583073,10,0
0,0,4,4,9,8,17,17,13,30,0.000333,0.040875,4,490.495541,27.249752,122.623885,52.529325,1,0
0,0,4,4,9,8,17,17,13,30,0.000333,0.040875,4,490.495541,27.249752,122.623885,52.529325,1,0
0,0,49,49,20,61,81,298,207,505,0.000333,1.067208,30,96048.72754,5336.040419,3201.624251,448.213539,22,0
0,0,19,19,19,20,39,91,66,157,0.000333,0.276603,27,22404.82001,1244.712223,829.808148,167.149185,3,0
0,0,19,19,19,20,39,91,66,157,0.000333,0.276603,27,22404.82001,1244.712223,829.808148,167.149185,3,0
0,0,30,30,21,37,58,231,133,364,0.000333,0.710768,30,63969.15247,3553.841804,2132.305082,284.98844,12,0
0,0,4,4,6,9,15,15,13,28,0.000333,0.036464,3,328.17881,18.232156,109.392937,44.0391,1,0
0,0,4,4,6,9,15,15,13,28,0.000333,0.036464,3,328.17881,18.232156,109.392937,44.0391,1,0
0,0,14,14,18,18,36,102,59,161,0.000333,0.277453,27,22473.66398,1248.536888,832.357925,150.1173,15,0
0,0,14,14,18,18,36,102,59,161,0.000333,0.277453,27,22473.66398,1248.536888,832.357925,150.1173,15,0
0,0,12,12,19,19,38,87,53,140,0.000333,0.244903,18,13224.77733,734.709852,734.709852,161.421246,6,0
0,0,12,12,19,19,38,87,53,140,0.000333,0.244903,18,13224.77733,734.709852,734.709852,161.421246,6,0
0,0,14,14,20,18,38,90,56,146,0.000333,0.255399,30,22985.92251,1276.995695,766.197417,161.497212,5,0
0,0,14,14,20,18,38,90,56,146,0.000333,0.255399,30,22985.92251,1276.995695,766.197417,161.497212,5,0
0,0,43,43,20,46,66,247,170,417,0.000333,0.840171,30,75615.37043,4200.853913,2520.512348,340.522412,5,0
0,0,43,43,20,46,66,247,170,417,0.000333,0.840171,30,75615.37043,4200.853913,2520.512348,340.522412,5,0
0,0,19,19,18,21,39,120,74,194,0.000333,0.341789,27,27684.93682,1538.052046,1025.36803,167.297316,20,0
0,0,19,19,18,21,39,120,74,194,0.000333,0.341789,27,27684.93682,1538.052046,1025.36803,167.297316,20,0
0,0,6,6,10,15,25,34,23,57,0.000333,0.088233,5,1323.499014,73.527723,264.699803,91.82264,2,0
0,0,20,20,21,23,44,118,79,197,0.000333,0.358503,30,32265.24087,1792.513381,1075.508029,196.280591,6,0
0,0,20,20,21,23,44,118,79,197,0.000333,0.358503,30,32265.24087,1792.513381,1075.508029,196.280591,6,0
0,0,18,18,20,24,44,115,76,191,0.000333,0.347584,30,31282.54318,1737.919065,1042.751439,196.477662,7,0
0,0,18,18,20,24,44,115,76,191,0.000333,0.347584,30,31282.54318,1737.919065,1042.751439,196.477662,7,0
0,0,3,3,8,8,16,25,13,38,0.000333,0.050667,4,608,33.777778,152,48,3,0
0,0,3,3,8,8,16,25,13,38,0.000333,0.050667,4,608,33.777778,152,48,3,0
0,0,6,6,9,11,20,35,26,61,0.000333,0.087879,8,2109.10091,117.172273,263.637614,66.583073,3,0
0,0,6,6,12,21,33,42,33,75,0.000333,0.12611,6,2269.977354,126.109853,378.329559,135.258216,3,0
0,0,6,6,12,19,31,40,30,70,0.000333,0.115598,6,2080.76245,115.597914,346.793742,123.730173,3,0
0,0,8,8,10,13,23,38,26,64,0.000333,0.096503,10,2895.079652,160.837758,289.507965,81.324997,1,0
0,0,8,8,10,13,23,38,26,64,0.000333,0.096503,10,2895.079652,160.837758,289.507965,81.324997,1,0
0,0,11,11,15,31,46,110,59,169,0.000333,0.311161,7,6534.373794,363.020766,933.481971,212.183445,1,0
0,0,3,3,9,8,17,15,10,25,0.000333,0.034062,4,408.746284,22.708127,102.186571,52.529325,1,0
0,0,3,3,9,8,17,15,10,25,0.000333,0.034062,4,408.746284,22.708127,102.186571,52.529325,1,0
0,0,14,14,14,25,39,99,80,179,0.000333,0.315362,21,19867.82694,1103.768163,946.086997,169.399374,4,0
0,0,4,4,9,7,16,14,11,25,0.000333,0.033333,4,400,22.222222,100,48.180809,1,0
0,0,4,4,9,7,16,14,11,25,0.000333,0.033333,4,400,22.222222,100,48.180809,1,0
0,0,3,3,9,10,19,18,14,32,0.000333,0.045311,4,543.734722,30.207485,135.93368,61.748606,1,0
0,0,3,3,9,10,19,18,14,32,0.000333,0.045311,4,543.734722,30.207485,135.93368,61.748606,1,0
0,0,7,7,6,13,19,26,22,48,0.000333,0.067967,3,611.701562,33.98342,203.900521,63.615491,1,0
0,0,7,7,6,13,19,26,22,48,0.000333,0.067967,3,611.701562,33.98342,203.900521,63.615491,1,0
0,0,17,17,13,33,46,98,94,192,0.000333,0.353508,12,12726.28675,707.01593,1060.523896,214.570722,1,0
0,0,9,9,12,6,18,63,29,92,0.000333,0.127878,24,9207.194403,511.5108,383.6331,58.529325,8,0
0,0,9,9,12,6,18,63,29,92,0.000333,0.127878,24,9207.194403,511.5108,383.6331,58.529325,8,0
0,0,9,9,10,8,18,69,37,106,0.000333,0.147337,20,8840.241003,491.1245,442.01205,57.219281,2,0
0,0,4,4,7,10,17,15,14,29,0.000333,0.039512,3,355.609267,19.75607,118.536422,52.870765,1,0
0,0,5,5,14,21,35,33,32,65,0.000333,0.111134,7,2333.823773,129.656876,333.403396,145.541635,1,0
0,0,42,42,16,45,61,230,181,411,0.000333,0.812511,32,78001.05746,4333.392081,2437.533046,311.133389,1,0
0,0,5,5,13,10,23,37,24,61,0.000333,0.091979,12,3311.247352,183.958186,275.937279,81.324997,4,0
0,0,39,39,25,41,66,202,149,351,0.000333,0.707194,36,76376.96409,4243.164672,2121.582336,335.756037,9,0
0,0,6,6,13,11,24,28,17,45,0.000333,0.068774,6,1237.939875,68.774438,206.323313,86.159464,3,0
0,0,6,6,13,11,24,28,17,45,0.000333,0.068774,6,1237.939875,68.774438,206.323313,86.159464,3,0
0,0,4,4,12,8,20,24,14,38,0.000333,0.054744,6,985.399606,54.744423,164.233268,67.01955,4,0
0,0,4,4,12,8,20,24,14,38,0.000333,0.054744,6,985.399606,54.744423,164.233268,67.01955,4,0
0,0,13,13,17,24,41,64,58,122,0.000333,0.217874,16,10457.94151,580.996751,653.621345,179.525968,5,0
0,0,3,3,5,7,12,12,11,23,0.000333,0.027485,2,164.908275,9.161571,82.454138,31.261125,1,0
0,0,45,45,15,42,57,204,175,379,0.000333,0.736888,28,61898.62883,3438.812713,2210.665315,285.080691,10,0
0,0,4,4,13,12,25,36,23,59,0.000333,0.091329,6,1643.925091,91.329172,273.987515,91.125266,1,0
0,0,3,3,13,13,26,22,16,38,0.000333,0.059539,6,1071.700256,59.538903,178.616709,96.211433,3,0
0,0,8,8,15,24,39,68,62,130,0.000333,0.229034,14,9619.432038,534.412891,687.102288,168.642459,5,0
0,0,7,7,12,10,22,40,24,64,0.000333,0.095135,12,3424.843483,190.269082,285.403624,76.238831,7,0
0,0,7,7,12,10,22,40,24,64,0.000333,0.095135,12,3424.843483,190.269082,285.403624,76.238831,7,0
0,0,11,11,14,39,53,65,61,126,0.000333,0.240573,7,5052.025841,280.668102,721.717977,259.433655,5,0
0,0,17,17,18,24,42,116,54,170,0.000333,0.305565,18,16500.49131,916.693962,916.693962,185.09775,10,0
0,0,11,11,10,13,23,35,34,69,0.000333,0.104042,10,3121.25775,173.403208,312.125775,81.324997,3,0
0,0,9,9,12,16,28,49,41,90,0.000333,0.144221,12,5191.943316,288.441295,432.661943,107.01955,3,0
0,0,12,12,12,23,35,93,65,158,0.000333,0.270142,12,9725.1206,540.284478,810.426717,147.061475,1,0
0,0,4,4,7,10,17,15,14,29,0.000333,0.039512,3,355.609267,19.75607,118.536422,52.870765,1,0
0,0,11,11,12,13,25,58,31,89,0.000333,0.137768,12,4959.638411,275.535467,413.303201,91.125266,6,0
0,0,11,11,12,13,25,58,31,89,0.000333,0.137768,12,4959.638411,275.535467,413.303201,91.125266,6,0
0,0,3,3,6,4,10,9,6,15,0.000333,0.01661,3,149.486764,8.30482,49.828921,23.509775,1,0
0,0,81,81,27,70,97,408,281,689,0.000333,1.51578,52,236461.6773,13136.75985,4547.339948,557.431774,10,0
0,0,5,5,6,10,16,27,28,55,0.000333,0.073333,6,1320,73.333333,220,48.729056,1,0
0,0,8,8,10,23,33,50,52,102,0.000333,0.171509,10,5145.282002,285.849,514.5282,137.261206,1,0
0,0,13,13,12,24,36,102,70,172,0.000333,0.296409,12,10670.7252,592.818067,889.2271,153.05865,1,0
0,0,4,4,7,10,17,19,14,33,0.000333,0.044962,3,404.658821,22.481046,134.886274,52.870765,2,0
0,0,4,4,7,10,17,19,14,33,0.000333,0.044962,3,404.658821,22.481046,134.886274,52.870765,2,0
0,0,14,14,16,25,41,85,64,149,0.000333,0.266092,16,12772.40398,709.577999,798.275249,180.096405,1,0
0,0,18,18,16,31,47,133,97,230,0.000333,0.425852,24,30661.33046,1703.407248,1277.555436,217.580086,1,0
0,0,3,3,13,6,19,18,9,27,0.000333,0.038231,6,688.164257,38.231348,114.694043,63.615491,2,0
0,0,4,4,12,11,23,31,21,52,0.000333,0.078408,6,1411.35133,78.408407,235.225222,81.073298,3,0
0,0,20,20,11,42,53,95,77,172,0.000333,0.328401,5,4926.011591,273.667311,985.202318,264.53108,2,0
0,0,20,20,11,42,53,95,77,172,0.000333,0.328401,5,4926.011591,273.667311,985.202318,264.53108,2,0
0,0,17,17,13,33,46,98,94,192,0.000333,0.353508,12,12726.28675,707.01593,1060.523896,214.570722,1,0
0,0,37,37,15,42,57,198,177,375,0.000333,0.729111,28,61245.34515,3402.519175,2187.333755,285.080691,2,0
0,0,4,4,8,12,20,24,22,46,0.000333,0.06627,4,795.234769,44.179709,198.808692,67.01955,1,0
0,0,4,4,12,14,26,20,19,39,0.000333,0.061106,6,1099.902894,61.105716,183.317149,96.322519,1,0
0,0,69,69,26,54,80,452,365,817,0.000333,1.721672,78,402871.1898,22381.73277,5165.015254,432.975358,26,0
0,0,27,27,18,47,65,153,110,263,0.000333,0.527961,18,28509.88923,1583.882735,1583.882735,336.124326,9,0
0,0,35,35,26,50,76,257,167,424,0.000333,0.88304,39,103315.7294,5739.762742,2649.121266,404.404242,25,0
0,0,37,37,16,39,55,228,201,429,0.000333,0.826734,40,99208.13268,5511.562927,2480.203317,270.130687,6,0
0,0,46,46,29,55,84,298,206,504,0.000333,1.073909,42,135312.5752,7517.365289,3221.727981,458.856233,26,0
0,0,11,11,13,19,32,79,45,124,0.000333,0.206667,12,7440,413.333333,620,128.816339,3,0
0,0,11,11,13,19,32,79,45,124,0.000333,0.206667,12,7440,413.333333,620,128.816339,3,0
0,0,3,3,8,6,14,15,9,24,0.000333,0.030459,4,365.506073,20.305893,91.376518,39.509775,1,0
0,0,19,19,15,26,41,94,71,165,0.000333,0.294665,14,12375.94513,687.552507,883.996081,180.814792,2,0
0,0,19,19,15,26,41,94,71,165,0.000333,0.294665,14,12375.94513,687.552507,883.996081,180.814792,2,0
0,0,3,3,13,10,23,25,15,40,0.000333,0.060314,6,1085.654869,60.314159,180.942478,81.324997,5,0
0,0,62,62,29,64,93,379,366,745,0.000333,1.623891,70,341017.132,18945.39622,4871.673314,524.881449,10,0
0,0,62,62,29,64,93,379,366,745,0.000333,1.623891,70,341017.132,18945.39622,4871.673314,524.881449,10,0
0,0,4,4,6,6,12,13,12,25,0.000333,0.029875,6,537.744375,29.874688,89.624063,31.01955,1,0
0,0,4,4,6,6,12,13,12,25,0.000333,0.029875,6,537.744375,29.874688,89.624063,31.01955,1,0
0,0,28,28,17,36,53,140,127,267,0.000333,0.509785,24,36704.51427,2039.139682,1529.354761,255.604168,3,0
0,0,3,3,7,7,14,20,11,31,0.000333,0.039343,3,354.084008,19.671334,118.028003,39.302969,2,0
0,0,3,3,7,7,14,20,11,31,0.000333,0.039343,3,354.084008,19.671334,118.028003,39.302969,2,0
0,0,3,3,8,13,21,20,19,39,0.000333,0.0571,4,685.201518,38.066751,171.300379,72.105716,1,0
0,0,3,3,7,7,14,20,11,31,0.000333,0.039343,3,354.084008,19.671334,118.028003,39.302969,2,0
0,0,3,3,7,7,14,20,11,31,0.000333,0.039343,3,354.084008,19.671334,118.028003,39.302969,2,0
0,0,10,10,12,21,33,60,53,113,0.000333,0.190006,12,6840.198426,380.011024,570.016535,135.258216,1,0
0,0,9,9,15,16,31,53,34,87,0.000333,0.143672,14,6034.211106,335.23395,431.015079,122.603359,9,0
0,0,9,9,15,16,31,53,34,87,0.000333,0.143672,14,6034.211106,335.23395,431.015079,122.603359,9,0
0,0,19,19,15,28,43,99,74,173,0.000333,0.312915,14,13142.41324,730.134069,938.743803,193.209297,2,0
0,0,7,7,15,16,31,44,29,73,0.000333,0.120552,7,2531.594315,140.644129,361.656331,122.603359,7,0
0,0,7,7,15,16,31,44,29,73,0.000333,0.120552,7,2531.594315,140.644129,361.656331,122.603359,7,0
0,0,10,10,13,15,28,66,40,106,0.000333,0.16986,12,6114.955461,339.719748,509.579622,106.709075,2,0
0,0,70,70,20,60,80,464,375,839,0.000333,1.768033,60,318245.8603,17680.32557,5304.097672,440.851998,7,0
0,0,8,8,9,21,30,46,43,89,0.000333,0.145571,8,3493.706104,194.094784,436.713263,120.767991,1,0
0,0,7,7,8,15,23,26,19,45,0.000333,0.067853,4,814.241152,45.23562,203.560288,82.603359,1,0
0,0,37,37,16,39,55,228,201,429,0.000333,0.826734,40,99208.13268,5511.562927,2480.203317,270.130687,6,0
0,0,14,14,16,19,35,83,61,144,0.000333,0.246206,24,17726.80211,984.822339,738.616754,144.710623,1,0
0,0,13,13,17,16,33,101,49,150,0.000333,0.25222,24,18159.81883,1008.878824,756.659118,133.486868,4,0
0,0,44,44,16,55,71,235,218,453,0.000333,0.928612,24,66860.05068,3714.44726,2785.835445,381.974784,1,0
0,0,26,26,29,53,82,228,182,410,0.000333,0.868865,42,109477.0455,6082.058084,2606.596322,444.461233,15,0
0,0,4,4,9,10,19,19,17,36,0.000333,0.050975,4,611.701562,33.98342,152.92539,61.748606,1,0
0,0,4,4,9,10,19,19,17,36,0.000333,0.050975,4,611.701562,33.98342,152.92539,61.748606,1,0
0,0,35,35,17,33,50,161,140,301,0.000333,0.566267,32,54361.62282,3020.090157,1698.800713,235.951874,10,0
0,0,4,4,8,9,17,29,16,45,0.000333,0.061312,4,735.743311,40.874628,183.935828,52.529325,3,0
0,0,4,4,8,9,17,29,16,45,0.000333,0.061312,4,735.743311,40.874628,183.935828,52.529325,3,0
0,0,13,13,18,22,40,94,57,151,0.000333,0.26787,18,14465.00056,803.611142,803.611142,173.166146,4,0
0,0,71,71,20,62,82,474,383,857,0.000333,1.816141,60,326905.3241,18161.40689,5448.422068,455.598733,7,0
0,0,14,14,6,20,26,65,64,129,0.000333,0.202119,9,5457.210513,303.178362,606.356724,101.948337,1,0
0,0,8,8,15,25,40,81,45,126,0.000333,0.223521,7,4693.94058,260.774477,670.56294,174.699764,1,0
0,0,38,38,18,50,68,247,210,457,0.000333,0.927324,36,100150.9387,5563.941037,2781.970518,357.25146,1,0
0,0,50,50,19,45,64,230,197,427,0.000333,0.854,36,92232,5124,2562,327.844012,17,0
0,0,61,61,19,49,68,286,234,520,0.000333,1.05516,36,113957.3044,6330.961355,3165.480677,355.831405,18,0
0,0,7,7,8,15,23,26,19,45,0.000333,0.067853,4,814.241152,45.23562,203.560288,82.603359,1,0
0,0,3,3,7,12,19,15,17,32,0.000333,0.045311,3,407.801041,22.655613,135.93368,62.671034,1,0
0,0,21,21,21,36,57,153,91,244,0.000333,0.474408,20,28464.50327,1581.361293,1423.225163,278.355966,7,0
0,0,21,21,21,36,57,153,91,244,0.000333,0.474408,20,28464.50327,1581.361293,1423.225163,278.355966,7,0
0,0,58,58,26,62,88,422,252,674,0.000333,1.451219,52,226390.1594,12577.23108,4353.656911,491.371604,20,0
0,0,56,56,26,62,88,406,241,647,0.000333,1.393084,39,162990.838,9055.046557,4179.252257,491.371604,20,0
0,0,49,49,26,62,88,341,212,553,0.000333,1.190689,39,139310.5617,7739.475651,3572.065685,491.371604,15,0
0,0,6,6,10,18,28,33,24,57,0.000333,0.09134,5,1370.096153,76.116453,274.019231,108.277931,2,0
0,0,3,3,6,11,17,16,15,31,0.000333,0.042237,3,380.134044,21.118558,126.711348,53.563523,1,0
0,0,6,6,13,12,25,37,19,56,0.000333,0.086685,6,1560.33568,86.685316,260.055947,91.125266,3,0
0,0,3,3,8,5,13,14,8,22,0.000333,0.027137,4,325.638695,18.091039,81.409674,35.60964,1,0
0,0,9,9,11,18,29,61,45,106,0.000333,0.171649,10,5149.459855,286.081103,514.945985,113.112398,1,0
0,0,11,11,12,12,24,58,31,89,0.000333,0.136021,12,4896.739951,272.041108,408.061663,86.0391,6,0
0,0,10,10,12,12,24,54,28,82,0.000333,0.125322,12,4511.603101,250.644617,375.966925,86.0391,6,0
0,0,7,7,13,15,28,52,37,89,0.000333,0.142618,12,5134.255057,285.236392,427.854588,106.709075,5,0
0,0,6,6,8,13,21,20,15,35,0.000333,0.051244,4,614.924439,34.162469,153.73111,72.105716,1,0
0,0,10,10,16,29,45,94,54,148,0.000333,0.270931,8,6502.354066,361.241893,812.794258,204.881449,1,0
0,0,6,6,8,13,21,20,15,35,0.000333,0.051244,4,614.924439,34.162469,153.73111,72.105716,1,0
0,0,7,7,12,18,30,49,34,83,0.000333,0.135757,6,2443.631517,135.757306,407.271919,118.0782,1,0
0,0,7,7,12,18,30,49,34,83,0.000333,0.135757,6,2443.631517,135.757306,407.271919,118.0782,1,0
0,0,4,4,6,9,15,18,15,33,0.000333,0.042976,3,386.782169,21.487898,128.92739,44.0391,1,0
0,0,7,7,15,24,39,66,38,104,0.000333,0.183227,7,3847.772815,213.765156,549.681831,168.642459,1,0
0,0,28,28,14,40,54,194,161,355,0.000333,0.680995,28,57203.58177,3177.976765,2042.985063,266.180093,1,0
0,0,92,92,23,97,120,633,491,1124,0.000333,2.587782,55,426983.9766,23721.33203,7763.345029,744.233471,28,0
0,0,21,21,10,5,15,85,43,128,0.000333,0.166694,40,20003.27985,1111.293325,500.081996,44.828921,22,0
0,0,21,21,10,5,15,85,43,128,0.000333,0.166694,40,20003.27985,1111.293325,500.081996,44.828921,22,0
0,0,3,3,12,14,26,23,17,40,0.000333,0.062673,6,1128.105532,62.67253,188.017589,96.322519,3,0
0,0,25,25,15,43,58,142,119,261,0.000333,0.509644,14,21405.06256,1189.170142,1528.93304,291.932743,4,0
0,0,25,25,15,43,58,142,119,261,0.000333,0.509644,14,21405.06256,1189.170142,1528.93304,291.932743,4,0
0,0,6,6,13,18,31,39,27,66,0.000333,0.108992,6,1961.861739,108.992319,326.976956,123.164366,1,0
0,0,6,6,13,18,31,38,27,65,0.000333,0.107341,6,1932.136561,107.34092,322.02276,123.164366,1,0
0,0,11,11,12,20,32,87,63,150,0.000333,0.25,18,13500,750,750,129.458112,3,0
0,0,8,8,13,18,31,47,31,78,0.000333,0.128809,6,2318.563873,128.809104,386.427312,123.164366,1,0
0,0,18,18,22,21,43,139,74,213,0.000333,0.385265,33,38141.21496,2118.956387,1155.794393,190.346161,11,0
0,0,18,18,22,21,43,139,74,213,0.000333,0.385265,33,38141.21496,2118.956387,1155.794393,190.346161,11,0
0,0,7,7,8,15,23,26,19,45,0.000333,0.067853,4,814.241152,45.23562,203.560288,82.603359,1,0
0,0,3,3,9,11,20,17,13,30,0.000333,0.043219,4,518.631371,28.812854,129.657843,66.583073,2,0
0,0,5,5,7,8,15,22,19,41,0.000333,0.053394,6,961.095087,53.394171,160.182514,43.651484,1,0
0,0,3,3,10,13,23,19,18,37,0.000333,0.055791,5,836.858962,46.492165,167.371792,81.324997,1,0
0,0,7,7,16,21,37,38,31,69,0.000333,0.119817,8,2875.618258,159.75657,359.452282,156.238666,1,0
0,0,4,4,10,15,25,23,22,45,0.000333,0.069658,5,1044.867643,58.048202,208.973529,91.82264,1,0
0,0,5,5,16,17,33,29,25,54,0.000333,0.090799,8,2179.17826,121.065459,272.397282,133.486868,1,0
0,0,57,57,14,41,55,287,254,541,0.000333,1.042572,42,131364.0554,7298.003078,3127.715605,272.962601,1,0
0,0,19,19,20,22,42,134,72,206,0.000333,0.370272,30,33324.52167,1851.362315,1110.817389,184.546058,9,0
0,0,19,19,20,22,42,134,72,206,0.000333,0.370272,30,33324.52167,1851.362315,1110.817389,184.546058,9,0
0,0,4,4,7,10,17,19,20,39,0.000333,0.053137,6,956.466305,53.137017,159.411051,52.870765,4,0
0,0,5,5,13,19,32,27,27,54,0.000333,0.09,6,1620,90,270,128.816339,1,0
0,0,5,5,13,19,32,26,27,53,0.000333,0.088333,6,1590,88.333333,265,128.816339,1,0
0,0,7,7,14,16,30,45,32,77,0.000333,0.125944,14,5289.628062,293.868226,377.830576,117.302969,4,0
0,0,7,7,14,16,30,45,32,77,0.000333,0.125944,14,5289.628062,293.868226,377.830576,117.302969,4,0
0,0,15,15,11,21,32,104,88,192,0.000333,0.32,20,19200,1066.666667,960,130.292414,2,0
0,0,12,12,13,19,32,65,48,113,0.000333,0.188333,12,6780,376.666667,565,128.816339,11,0
0,0,4,4,11,6,17,19,10,29,0.000333,0.039512,5,592.682112,32.926784,118.536422,53.563523,3,0
0,0,4,4,11,6,17,19,10,29,0.000333,0.039512,5,592.682112,32.926784,118.536422,53.563523,3,0
0,0,44,44,24,57,81,337,240,577,0.000333,1.219364,48,175588.4857,9754.915871,3658.093452,442.513831,27,0
0,0,6,6,16,13,29,45,25,70,0.000333,0.113353,8,2720.469357,151.137187,340.05867,112.105716,6,0
0,0,5,5,14,9,23,28,18,46,0.000333,0.069361,14,2913.1739,161.842994,208.08385,81.832294,2,0
0,0,6,6,10,9,19,30,19,49,0.000333,0.069383,10,2081.484482,115.638027,208.148448,61.748606,2,0
0,0,6,6,10,9,19,30,19,49,0.000333,0.069383,10,2081.484482,115.638027,208.148448,61.748606,2,0
0,0,5,5,10,12,22,24,20,44,0.000333,0.065405,5,981.074956,54.504164,196.214991,76.238831,1,0
0,0,6,6,11,13,24,24,17,41,0.000333,0.062661,5,939.917313,52.217628,187.983463,86.159464,2,0
0,0,4,4,9,14,23,19,17,36,0.000333,0.054283,4,651.392922,36.188496,162.84823,81.832294,1,0
0,0,14,14,15,11,26,77,35,112,0.000333,0.175483,21,11055.43422,614.19079,526.449248,96.657107,9,0
0,0,14,14,15,11,26,77,35,112,0.000333,0.175483,21,11055.43422,614.19079,526.449248,96.657107,9,0
0,0,37,37,25,41,66,190,139,329,0.000333,0.662869,36,71589.80395,3977.211331,1988.605665,335.756037,8,0
0,0,6,6,12,13,25,42,32,74,0.000333,0.114548,12,4123.744297,229.096905,343.645358,91.125266,3,0
0,0,34,34,11,40,51,151,144,295,0.000333,0.557788,15,25100.48214,1394.47123,1673.365476,250.930872,1,0
0,0,4,4,10,8,18,23,15,38,0.000333,0.052819,5,792.28575,44.015875,158.45715,57.219281,1,0
0,0,3,3,10,8,18,20,12,32,0.000333,0.044479,5,667.188,37.066,133.4376,57.219281,1,0
0,0,14,14,15,11,26,101,40,141,0.000333,0.220921,21,13918.00201,773.222334,662.762,96.657107,17,0
0,0,14,14,15,11,26,101,40,141,0.000333,0.220921,21,13918.00201,773.222334,662.762,96.657107,17,0
0,0,77,77,26,54,80,347,288,635,0.000333,1.338141,65,260937.5821,14496.53234,4014.42434,432.975358,9,0
0,0,68,68,26,52,78,321,263,584,0.000333,1.223558,65,238593.8682,13255.2149,3670.674896,418.634298,9,0
0,0,5,5,11,13,24,29,26,55,0.000333,0.084058,10,2521.729375,140.096076,252.172938,86.159464,1,0
0,0,7,7,12,11,23,41,21,62,0.000333,0.093487,6,1682.765048,93.486947,280.460841,81.073298,4,0
0,0,6,6,11,7,18,42,16,58,0.000333,0.080619,10,2418.556501,134.36425,241.85565,57.705232,5,0
0,0,21,21,18,53,71,214,130,344,0.000333,0.705171,18,38079.23416,2115.513009,2115.513009,378.638434,2,0
0,0,25,25,14,27,41,117,103,220,0.000333,0.392887,21,24751.89026,1375.105015,1178.661441,181.684931,9,0
0,0,20,20,18,53,71,209,126,335,0.000333,0.686722,18,37082.97513,2060.165285,2060.165285,378.638434,2,0
0,0,57,57,16,37,53,288,229,517,0.000333,0.987112,48,142144.074,7896.893,2961.334875,256.749775,24,0
0,0,46,46,15,31,46,201,167,368,0.000333,0.677557,35,71143.47799,3952.415444,2032.6708,212.183445,19,0
0,0,5,5,7,8,15,28,18,46,0.000333,0.059906,6,1078.301804,59.905656,179.716967,43.651484,1,0
0,0,4,4,5,3,8,28,12,40,0.000333,0.04,8,960,53.333333,120,16.364528,1,0
0,0,4,4,8,11,19,22,18,40,0.000333,0.056639,4,679.668402,37.759356,169.917101,62.053748,1,0
0,0,12,12,16,21,37,55,49,104,0.000333,0.180594,16,8668.5304,481.585022,541.78315,156.238666,4,0
0,0,6,6,10,15,25,34,23,57,0.000333,0.088233,5,1323.499014,73.527723,264.699803,91.82264,2,0
0,0,5,5,10,7,17,18,14,32,0.000333,0.0436,10,1307.988109,72.666006,130.798811,52.870765,1,0
0,0,15,15,14,25,39,103,72,175,0.000333,0.308315,14,12949.23544,719.401969,924.945388,169.399374,27,0
0,0,61,61,22,69,91,378,268,646,0.000333,1.401345,33,138733.1661,7707.398119,4204.035338,519.595683,27,0
0,0,4,4,7,8,15,15,12,27,0.000333,0.035162,3,316.458138,17.581008,105.486046,43.651484,1,0
0,0,4,4,7,8,15,15,12,27,0.000333,0.035162,3,316.458138,17.581008,105.486046,43.651484,1,0
0,0,15,15,12,28,40,123,82,205,0.000333,0.363665,12,13091.94311,727.330173,1090.995259,177.625488,1,0
0,0,37,37,15,42,57,198,177,375,0.000333,0.729111,28,61245.34515,3402.519175,2187.333755,285.080691,2,0
0,0,21,21,10,5,15,85,43,128,0.000333,0.166694,40,20003.27985,1111.293325,500.081996,44.828921,22,0
0,0,21,21,10,5,15,85,43,128,0.000333,0.166694,40,20003.27985,1111.293325,500.081996,44.828921,22,0
0,0,6,6,9,7,16,27,18,45,0.000333,0.06,8,1440,80,180,48.180809,2,0
0,0,6,6,9,7,16,27,18,45,0.000333,0.06,8,1440,80,180,48.180809,2,0
0,0,4,4,11,14,25,28,18,46,0.000333,0.071206,5,1068.086924,59.338162,213.617385,91.356717,3,0
0,0,4,4,12,6,18,25,18,43,0.000333,0.059769,18,3227.521951,179.306775,179.306775,58.529325,4,0
0,0,4,4,7,12,19,17,15,32,0.000333,0.045311,3,407.801041,22.655613,135.93368,62.671034,1,0
0,0,4,4,7,12,19,17,15,32,0.000333,0.045311,3,407.801041,22.655613,135.93368,62.671034,1,0
0,0,12,12,13,21,34,75,60,135,0.000333,0.228936,12,8241.689803,457.871656,686.807484,140.344382,4,0
0,0,3,3,8,7,15,25,13,38,0.000333,0.049487,4,593.847371,32.991521,148.461843,43.651484,1,0
0,0,11,11,21,19,40,57,32,89,0.000333,0.157884,10,4736.516004,263.139778,473.6516,172.949289,7,0
0,0,10,10,22,23,45,85,67,152,0.000333,0.278254,22,18364.75675,1020.264264,834.761671,202.149421,5,0
0,0,16,16,19,25,44,70,54,124,0.000333,0.225657,18,12185.45137,676.969521,676.969521,196.807027,3,0
0,0,4,4,8,5,13,14,8,22,0.000333,0.027137,4,325.638695,18.091039,81.409674,35.60964,1,0
0,0,8,8,7,9,16,21,20,41,0.000333,0.054667,6,984,54.666667,164,48.180809,3,0
0,0,8,8,7,9,16,21,20,41,0.000333,0.054667,6,984,54.666667,164,48.180809,3,0
0,0,3,3,8,5,13,10,8,18,0.000333,0.022203,4,266.43166,14.801759,66.607915,35.60964,1,0
0,0,3,3,6,5,11,23,11,34,0.000333,0.039207,6,705.72405,39.206892,117.620675,27.119415,1,0
0,0,4,4,12,10,22,28,20,48,0.000333,0.071351,12,2568.632612,142.701812,214.052718,76.238831,3,0
0,0,3,3,5,7,12,12,11,23,0.000333,0.027485,2,164.908275,9.161571,82.454138,31.261125,1,0
0,0,3,3,10,12,22,19,15,34,0.000333,0.05054,5,758.103375,42.116854,151.620675,76.238831,1,0
0,0,3,3,8,9,17,15,11,26,0.000333,0.035425,4,425.096135,23.616452,106.274034,52.529325,1,0
0,0,3,3,8,9,17,15,11,26,0.000333,0.035425,4,425.096135,23.616452,106.274034,52.529325,1,0
0,0,8,8,10,21,31,49,34,83,0.000333,0.137066,5,2055.991469,114.221748,411.198294,125.457947,1,0
0,0,4,4,8,9,17,12,12,24,0.000333,0.0327,4,392.396433,21.799802,98.099108,52.529325,1,0
0,0,4,4,10,8,18,23,12,35,0.000333,0.048649,5,729.736875,40.540938,145.947375,57.219281,3,0
0,0,3,3,7,7,14,20,11,31,0.000333,0.039343,3,354.084008,19.671334,118.028003,39.302969,2,0
0,0,3,3,7,7,14,20,11,31,0.000333,0.039343,3,354.084008,19.671334,118.028003,39.302969,2,0
0,0,4,4,12,8,20,23,11,34,0.000333,0.048982,6,881.673331,48.981852,146.945555,67.01955,3,0
0,0,4,4,12,8,20,23,11,34,0.000333,0.048982,6,881.673331,48.981852,146.945555,67.01955,3,0
0,0,19,19,15,26,41,94,71,165,0.000333,0.294665,14,12375.94513,687.552507,883.996081,180.814792,2,0
0,0,19,19,15,26,41,94,71,165,0.000333,0.294665,14,12375.94513,687.552507,883.996081,180.814792,2,0
0,0,4,4,9,6,15,15,9,24,0.000333,0.031255,4,375.061497,20.83675,93.765374,44.0391,1,0
0,0,5,5,9,7,16,19,12,31,0.000333,0.041333,4,496,27.555556,124,48.180809,1,0
0,0,9,9,13,14,27,50,32,82,0.000333,0.129967,12,4678.809302,259.93385,389.900775,101.408685,2,0
0,0,32,32,20,63,83,276,170,446,0.000333,0.947756,20,56865.35173,3159.186207,2843.267586,463.007197,2,0
0,0,4,4,9,8,17,18,10,28,0.000333,0.03815,4,457.795838,25.433102,114.44896,52.529325,4,0
0,0,9,9,16,24,40,58,37,95,0.000333,0.168528,8,4044.665352,224.703631,505.583169,174.0391,3,0
0,0,26,26,17,40,57,164,140,304,0.000333,0.591066,24,42556.76554,2364.264752,1773.198564,282.363992,4,0
0,0,3,3,6,8,14,23,14,37,0.000333,0.046957,3,422.616396,23.478689,140.872132,39.509775,2,0
0,0,3,3,6,8,14,23,14,37,0.000333,0.046957,3,422.616396,23.478689,140.872132,39.509775,2,0
0,0,19,19,18,22,40,112,72,184,0.000333,0.326412,27,26439.33878,1468.852154,979.234769,173.166146,16,0
0,0,19,19,15,26,41,94,71,165,0.000333,0.294665,14,12375.94513,687.552507,883.996081,180.814792,2,0
0,0,19,19,15,26,41,94,71,165,0.000333,0.294665,14,12375.94513,687.552507,883.996081,180.814792,2,0
0,0,41,41,23,44,67,196,166,362,0.000333,0.731975,33,72465.50147,4025.861193,2195.924287,344.256916,5,0
0,0,93,93,25,48,73,378,315,693,0.000333,1.429849,72,308847.4862,17158.19368,4289.548419,384.174605,5,0
0,0,76,76,28,50,78,320,261,581,0.000333,1.217273,70,255627.3082,14201.51713,3651.818689,416.798747,5,0
0,0,5,5,8,8,16,28,16,44,0.000333,0.058667,8,1408,78.222222,176,48,1,0
0,0,5,5,8,8,16,28,16,44,0.000333,0.058667,8,1408,78.222222,176,48,1,0
0,0,3,3,11,11,22,22,18,40,0.000333,0.059459,5,891.886324,49.54924,178.377265,76.107496,1,0
0,0,8,8,12,18,30,40,33,73,0.000333,0.119401,6,2149.218081,119.401004,358.203013,118.0782,1,0
0,0,6,6,9,8,17,48,26,74,0.000333,0.100824,12,3629.667003,201.648167,302.47225,52.529325,2,0
0,0,17,17,20,21,41,96,51,147,0.000333,0.26252,20,15751.20289,875.066827,787.560145,178.677228,15,0
0,0,13,13,16,30,46,73,49,122,0.000333,0.224625,8,5390.996469,299.499804,673.874559,211.206718,3,0
0,0,13,13,16,30,46,73,49,122,0.000333,0.224625,8,5390.996469,299.499804,673.874559,211.206718,3,0
0,0,15,15,19,20,39,87,45,132,0.000333,0.232558,18,12558.11567,697.673093,697.673093,167.149185,15,0
0,0,17,17,22,23,45,95,52,147,0.000333,0.269101,22,17760.65291,986.70294,807.302405,202.149421,17,0
0,0,69,69,27,76,103,531,403,934,0.000333,2.08173,65,405937.447,22552.08039,6245.191492,603.224454,32,0
0,0,13,13,15,16,31,57,40,97,0.000333,0.160186,14,6727.79859,373.766588,480.557042,122.603359,1,0
0,0,13,13,15,16,31,57,40,97,0.000333,0.160186,14,6727.79859,373.766588,480.557042,122.603359,1,0
0,0,5,5,12,10,22,31,19,50,0.000333,0.074324,6,1337.829486,74.32386,222.971581,76.238831,5,0
0,0,5,5,12,10,22,31,19,50,0.000333,0.074324,6,1337.829486,74.32386,222.971581,76.238831,5,0
0,0,32,32,18,40,58,200,135,335,0.000333,0.654141,27,52985.4381,2943.63545,1962.423633,287.935774,6,0
0,0,7,7,7,10,17,35,22,57,0.000333,0.077662,6,1397.912292,77.661794,232.985382,52.870765,2,0
0,0,7,7,7,10,17,35,22,57,0.000333,0.077662,6,1397.912292,77.661794,232.985382,52.870765,2,0
0,0,24,24,21,51,72,204,136,340,0.000333,0.699258,20,41955.49001,2330.860556,2097.7745,381.532358,13,0
0,0,26,26,17,40,57,164,140,304,0.000333,0.591066,24,42556.76554,2364.264752,1773.198564,282.363992,4,0
0,0,35,35,21,40,61,167,143,310,0.000333,0.612843,30,55155.85724,3064.214291,1838.528575,305.11579,1,0
0,0,35,35,21,40,61,167,143,310,0.000333,0.612843,30,55155.85724,3064.214291,1838.528575,305.11579,1,0
0,0,5,5,11,15,26,34,30,64,0.000333,0.100276,10,3008.28142,167.126746,300.828142,96.657107,2,0
0,0,6,6,10,18,28,33,24,57,0.000333,0.09134,5,1370.096153,76.116453,274.019231,108.277931,2,0
0,0,36,36,16,31,47,180,151,331,0.000333,0.612856,32,58834.20512,3268.566951,1838.56891,217.580086,12,0
0,0,37,37,23,38,61,188,161,349,0.000333,0.689942,44,91072.40256,5059.57792,2069.827331,303.463171,1,0
0,0,37,37,23,38,61,188,161,349,0.000333,0.689942,44,91072.40256,5059.57792,2069.827331,303.463171,1,0
0,0,3,3,6,8,14,14,12,26,0.000333,0.032997,3,296.973684,16.498538,98.991228,39.509775,1,0
0,0,3,3,6,8,14,14,12,26,0.000333,0.032997,3,296.973684,16.498538,98.991228,39.509775,1,0
0,0,7,7,21,20,41,57,35,92,0.000333,0.164298,10,4928.947844,273.830436,492.894784,178.677228,7,0
0,0,3,3,8,5,13,14,8,22,0.000333,0.027137,4,325.638695,18.091039,81.409674,35.60964,1,0
0,0,3,3,7,7,14,12,9,21,0.000333,0.026651,3,239.86336,13.325742,79.954453,39.302969,1,0
0,0,14,14,12,27,39,114,77,191,0.000333,0.336504,12,12114.14189,673.007883,1009.511824,171.401513,1,0
0,0,9,9,14,16,30,50,28,78,0.000333,0.127579,7,2679.162265,148.842348,382.737466,117.302969,3,0
0,0,4,4,5,12,17,20,24,44,0.000333,0.059949,4,719.39346,39.966303,179.848365,54.62919,1,0
0,0,55,55,19,55,74,276,232,508,0.000333,1.051467,36,113558.4832,6308.804619,3154.40231,398.685407,10,0
0,0,18,18,16,31,47,133,97,230,0.000333,0.425852,24,30661.33046,1703.407248,1277.555436,217.580086,1,0
0,0,7,7,13,15,28,52,27,79,0.000333,0.126594,6,2278.686233,126.59368,379.781039,106.709075,4,0
0,0,3,3,9,12,21,19,16,35,0.000333,0.051244,4,614.924439,34.162469,153.73111,71.548875,1,0
0,0,3,3,9,12,21,19,16,35,0.000333,0.051244,4,614.924439,34.162469,153.73111,71.548875,1,0
0,0,3,3,6,7,13,9,10,19,0.000333,0.023436,3,210.925064,11.718059,70.308355,35.161259,1,0
0,0,16,16,16,28,44,140,65,205,0.000333,0.373061,16,17906.93571,994.829762,1119.183482,198.605938,8,0
0,0,3,3,9,7,16,14,9,23,0.000333,0.030667,4,368,20.444444,92,48.180809,1,0
0,0,14,14,16,25,41,85,64,149,0.000333,0.266092,16,12772.40398,709.577999,798.275249,180.096405,1,0
0,0,6,6,13,18,31,48,31,79,0.000333,0.130461,6,2348.289051,130.460503,391.381509,123.164366,3,0
0,0,3,3,10,8,18,19,12,31,0.000333,0.043089,5,646.338375,35.907688,129.267675,57.219281,6,0
0,0,18,18,11,21,32,123,82,205,0.000333,0.341667,15,15375,854.166667,1025,130.292414,6,0
0,0,13,13,14,30,44,75,48,123,0.000333,0.223837,7,4700.570624,261.142812,671.510089,200.509687,4,0
0,0,35,35,20,64,84,292,181,473,0.000333,1.007855,20,60471.32282,3359.517934,3023.566141,470.438562,2,0
0,0,53,53,19,49,68,239,208,447,0.000333,0.907032,36,97959.45204,5442.19178,2721.09589,355.831405,14,0
0,0,73,73,27,76,103,571,432,1003,0.000333,2.23552,65,435926.4019,24218.13344,6706.560029,603.224454,34,0
0,0,5,5,13,10,23,31,18,49,0.000333,0.073885,6,1329.927215,73.884845,221.654536,81.324997,1,0
0,0,5,5,13,10,23,31,18,49,0.000333,0.073885,6,1329.927215,73.884845,221.654536,81.324997,1,0
0,0,13,13,15,23,38,53,43,96,0.000333,0.167934,7,3526.607289,195.922627,503.801041,162.645284,4,0
0,0,89,89,20,79,99,421,358,779,0.000333,1.721423,40,206570.7523,11476.15291,5164.268807,584.437241,11,0
0,0,3,3,12,10,22,24,16,40,0.000333,0.059459,6,1070.263588,59.459088,178.377265,76.238831,2,0
0,0,49,49,17,48,65,238,204,442,0.000333,0.887296,32,85180.37035,4732.242797,2661.886573,337.565068,9,0
0,0,11,11,14,39,53,65,61,126,0.000333,0.240573,7,5052.025841,280.668102,721.717977,259.433655,5,0
0,0,19,19,14,31,45,143,112,255,0.000333,0.466808,21,29408.87333,1633.826296,1400.42254,206.883055,1,0
0,0,8,8,7,20,27,62,63,125,0.000333,0.19812,9,5349.24844,297.180469,594.360938,106.090046,1,0
0,0,9,9,12,18,30,60,50,110,0.000333,0.179919,12,6477.095586,359.838644,539.757966,118.0782,1,0
0,0,5,5,8,13,21,26,22,48,0.000333,0.070277,4,843.324945,46.851386,210.831236,72.105716,5,0
0,0,8,8,8,21,29,63,64,127,0.000333,0.205655,12,7403.563037,411.309058,616.963586,116.238666,1,0
0,0,4,4,4,7,11,13,11,24,0.000333,0.027675,2,166.052718,9.225151,83.026359,27.651484,3,0
0,0,4,4,4,7,11,13,11,24,0.000333,0.027675,2,166.052718,9.225151,83.026359,27.651484,3,0
0,0,3,3,8,8,16,12,10,22,0.000333,0.029333,4,352,19.555556,88,48,2,0
0,0,13,13,13,29,42,114,99,213,0.000333,0.382855,18,20674.145,1148.563611,1148.563611,188.987165,1,0
0,0,8,8,8,20,28,63,63,126,0.000333,0.201909,12,7268.720642,403.817813,605.72672,110.438562,1,0
0,0,8,8,8,21,29,63,64,127,0.000333,0.205655,12,7403.563037,411.309058,616.963586,116.238666,1,0
0,0,8,8,10,24,34,70,71,141,0.000333,0.239111,10,7173.322606,398.517923,717.332261,143.258381,1,0
0,0,8,8,11,23,34,72,68,140,0.000333,0.237415,10,7122.447978,395.691554,712.244798,142.095673,1,0
0,0,8,8,9,22,31,66,66,132,0.000333,0.217985,12,7847.446956,435.969275,653.953913,126.636821,1,0
0,0,6,6,8,13,21,20,15,35,0.000333,0.051244,4,614.924439,34.162469,153.73111,72.105716,1,0
0,0,4,4,12,8,20,27,15,42,0.000333,0.060507,6,1089.12588,60.506993,181.52098,67.01955,6,0
0,0,11,11,20,14,34,84,44,128,0.000333,0.217065,30,19535.85731,1085.325406,651.195244,139.741531,8,0
0,0,5,5,14,18,32,38,26,64,0.000333,0.106667,7,2240,124.444444,320,128.361619,1,0
0,0,4,4,11,14,25,33,23,56,0.000333,0.086685,5,1300.279733,72.237763,260.055947,91.356717,4,0
0,0,6,6,14,20,34,51,31,82,0.000333,0.139057,7,2920.203671,162.233537,417.171953,139.741531,1,0
0,0,11,11,20,21,41,59,34,93,0.000333,0.166084,10,4982.523364,276.806854,498.252336,178.677228,3,0
0,0,32,32,18,34,52,166,117,283,0.000333,0.537741,27,43557.05989,2419.83666,1613.22444,248.032387,3,0
0,0,32,32,18,34,52,166,117,283,0.000333,0.537741,27,43557.05989,2419.83666,1613.22444,248.032387,3,0
0,0,7,7,13,20,33,43,30,73,0.000333,0.122747,6,2209.444624,122.746924,368.240771,134.544278,5,0
0,0,26,26,25,46,71,185,127,312,0.000333,0.639574,24,46049.30643,2558.294802,1918.721101,370.180255,25,0
0,0,26,26,25,46,71,185,127,312,0.000333,0.639574,24,46049.30643,2558.294802,1918.721101,370.180255,25,0
0,0,3,3,8,12,20,15,15,30,0.000333,0.043219,4,518.631371,28.812854,129.657843,67.01955,1,0
0,0,81,81,26,55,81,415,329,744,0.000333,1.572283,65,306595.1461,17033.06367,4716.848402,440.186217,9,0
0,0,10,10,17,15,32,81,41,122,0.000333,0.203333,16,9760,542.222222,610,128.090227,12,0
0,0,13,13,15,23,38,77,57,134,0.000333,0.234407,14,9845.112015,546.950668,703.222287,162.645284,2,0
0,0,4,4,7,13,20,24,17,41,0.000333,0.059066,3,531.597156,29.533175,177.199052,67.757201,1,0
0,0,5,5,7,13,20,28,19,47,0.000333,0.06771,3,609.391861,33.855103,203.13062,67.757201,1,0
0,0,4,4,11,14,25,28,18,46,0.000333,0.071206,5,1068.086924,59.338162,213.617385,91.356717,3,0
0,0,34,34,14,23,37,168,116,284,0.000333,0.493162,35,51781.96645,2876.775914,1479.484756,157.344894,2,0
0,0,34,34,14,23,37,168,116,284,0.000333,0.493162,35,51781.96645,2876.775914,1479.484756,157.344894,2,0
0,0,8,8,10,23,33,50,52,102,0.000333,0.171509,10,5145.282002,285.849,514.5282,137.261206,1,0
0,0,8,8,8,18,26,38,28,66,0.000333,0.10341,4,1240.916086,68.939783,310.229021,99.05865,3,0
0,0,8,8,8,18,26,38,28,66,0.000333,0.10341,4,1240.916086,68.939783,310.229021,99.05865,3,0
0,0,6,6,14,13,27,46,22,68,0.000333,0.107777,7,2263.326451,125.740358,323.33235,101.408685,4,0
0,0,23,23,16,30,46,117,98,215,0.000333,0.395855,24,28501.57969,1583.421094,1187.565821,211.206718,3,0
0,0,4,4,10,22,32,25,31,56,0.000333,0.093333,5,1400,77.777778,280,131.326777,2,0
0,0,36,36,22,48,70,255,212,467,0.000333,0.954125,44,125944.5074,6996.91708,2862.375169,366.185696,18,0
0,0,40,40,18,50,68,268,211,479,0.000333,0.971965,36,104972.2092,5831.789402,2915.894701,357.25146,11,0
0,0,12,12,17,22,39,70,47,117,0.000333,0.206131,16,9894.272954,549.681831,618.39206,167.594364,4,0
0,0,16,16,13,20,33,92,68,160,0.000333,0.269034,18,14527.85506,807.103059,807.103059,134.544278,13,0
0,0,30,30,16,28,44,231,166,397,0.000333,0.722465,40,86695.7741,4816.431895,2167.394353,198.605938,12,0
0,0,25,25,13,17,30,161,95,256,0.000333,0.418721,30,37684.91977,2093.606654,1256.163992,117.592585,3,0
0,0,3,3,9,12,21,13,12,25,0.000333,0.036603,4,439.231742,24.401763,109.807936,71.548875,1,0
0,0,3,3,6,6,12,11,9,20,0.000333,0.0239,3,215.09775,11.949875,71.69925,31.01955,1,0
0,0,3,3,8,9,17,19,15,34,0.000333,0.046325,4,555.894946,30.883053,138.973737,52.529325,1,0
0,0,3,3,8,9,17,19,15,34,0.000333,0.046325,4,555.894946,30.883053,138.973737,52.529325,1,0
0,0,15,15,17,31,48,98,63,161,0.000333,0.299726,16,14386.8634,799.270189,899.178963,223.066954,2,0
0,0,21,21,13,26,39,146,116,262,0.000333,0.461592,24,33234.60915,1846.367175,1384.775381,170.317149,20,0
0,0,14,14,12,26,38,114,76,190,0.000333,0.332369,12,11965.27473,664.737485,997.106228,165.230983,1,0
0,0,3,3,6,7,13,15,12,27,0.000333,0.033304,3,299.735617,16.651979,99.911872,35.161259,1,0
0,0,9,9,18,12,30,59,28,87,0.000333,0.1423,18,7684.190673,426.899482,426.899482,118.0782,4,0
0,0,3,3,8,7,15,16,12,28,0.000333,0.036464,4,437.571747,24.309541,109.392937,43.651484,1,0
0,0,3,3,11,14,25,22,17,39,0.000333,0.06037,5,905.551957,50.308442,181.110391,91.356717,1,0
0,0,31,31,20,30,50,175,119,294,0.000333,0.553098,30,49778.81159,2765.489533,1659.29372,233.64528,5,0
0,0,31,31,20,30,50,175,119,294,0.000333,0.553098,30,49778.81159,2765.489533,1659.29372,233.64528,5,0
0,0,17,17,19,24,43,110,70,180,0.000333,0.325576,18,17581.09781,976.727656,976.727656,190.749723,4,0
0,0,17,17,19,24,43,110,70,180,0.000333,0.325576,18,17581.09781,976.727656,976.727656,190.749723,4,0
0,0,3,3,8,8,16,16,11,27,0.000333,0.036,4,432,24,108,48,1,0
0,0,3,3,9,5,14,17,8,25,0.000333,0.031728,4,380.735492,21.151972,95.183873,40.138965,2,0
0,0,4,4,11,15,26,22,18,40,0.000333,0.062673,5,940.087944,52.227108,188.017589,96.657107,2,0
0,0,4,4,11,15,26,22,18,40,0.000333,0.062673,5,940.087944,52.227108,188.017589,96.657107,2,0
0,0,16,16,14,30,44,132,110,242,0.000333,0.440394,21,27744.83149,1541.379527,1321.182452,200.509687,1,0
0,0,7,7,14,19,33,56,29,85,0.000333,0.142925,7,3001.414501,166.74525,428.7735,134.013592,6,0
0,0,42,42,16,43,59,202,175,377,0.000333,0.739252,32,70968.20575,3942.678097,2217.75643,297.329384,9,0
0,0,8,8,10,13,23,38,26,64,0.000333,0.096503,10,2895.079652,160.837758,289.507965,81.324997,1,0
0,0,8,8,10,13,23,38,26,64,0.000333,0.096503,10,2895.079652,160.837758,289.507965,81.324997,1,0
0,0,4,4,14,8,22,23,13,36,0.000333,0.053513,7,1123.776768,62.432043,160.539538,77.302969,2,0
0,0,75,75,25,54,79,369,305,674,0.000333,1.416249,60,254924.8935,14162.49408,4248.748224,426.86033,25,0
0,0,10,10,13,23,36,55,43,98,0.000333,0.168884,6,3039.915901,168.884217,506.65265,152.147641,1,0
0,0,3,3,7,7,14,19,10,29,0.000333,0.036804,3,331.239878,18.402215,110.413293,39.302969,1,0
0,0,30,30,17,42,59,207,170,377,0.000333,0.739252,32,70968.20575,3942.678097,2217.75643,295.9642,1,0
0,0,3,3,7,11,18,14,12,26,0.000333,0.036139,3,325.25415,18.069675,108.41805,57.705232,1,0
0,0,3,3,7,11,18,14,12,26,0.000333,0.036139,3,325.25415,18.069675,108.41805,57.705232,1,0
0,0,3,3,7,8,15,11,10,21,0.000333,0.027348,3,246.134108,13.674117,82.044703,43.651484,1,0
0,0,5,5,14,9,23,26,16,42,0.000333,0.06333,7,1329.927215,73.884845,189.989602,81.832294,2,0
0,0,19,19,22,52,74,199,118,317,0.000333,0.656132,22,43304.72777,2405.81821,1968.396717,394.530361,2,0
0,0,3,3,11,11,22,22,18,40,0.000333,0.059459,5,891.886324,49.54924,178.377265,76.107496,1,0
0,0,21,21,11,42,53,98,79,177,0.000333,0.337947,5,5069.209602,281.622756,1013.84192,264.53108,2,0
0,0,21,21,11,42,53,98,79,177,0.000333,0.337947,5,5069.209602,281.622756,1013.84192,264.53108,2,0
0,0,11,11,20,27,47,76,48,124,0.000333,0.22959,10,6887.690176,382.649454,688.769018,214.820524,10,0
0,0,21,21,11,42,53,98,79,177,0.000333,0.337947,5,5069.209602,281.622756,1013.84192,264.53108,2,0
0,0,21,21,11,42,53,98,79,177,0.000333,0.337947,5,5069.209602,281.622756,1013.84192,264.53108,2,0
0,0,8,8,9,17,26,37,30,67,0.000333,0.104976,4,1259.717844,69.984325,314.929461,98.016193,1,0
0,0,16,16,13,20,33,104,74,178,0.000333,0.299301,18,16162.23876,897.902153,897.902153,134.544278,17,0
0,0,3,3,5,7,12,8,9,17,0.000333,0.020315,2,121.888725,6.771596,60.944363,31.261125,1,0
0,0,7,7,12,21,33,49,38,87,0.000333,0.146287,6,2633.17373,146.287429,438.862288,135.258216,2,0
0,0,7,7,12,21,33,49,38,87,0.000333,0.146287,6,2633.17373,146.287429,438.862288,135.258216,2,0
0,0,5,5,17,15,32,39,21,60,0.000333,0.1,8,2400,133.333333,300,128.090227,2,0
0,0,6,6,13,18,31,48,31,79,0.000333,0.130461,6,2348.289051,130.460503,391.381509,123.164366,3,0
0,0,3,3,6,5,11,23,11,34,0.000333,0.039207,6,705.72405,39.206892,117.620675,27.119415,1,0
0,0,37,37,25,59,84,283,200,483,0.000333,1.029163,36,111149.6153,6174.97863,3087.489315,463.172345,14,0
0,0,3,3,5,10,15,15,12,27,0.000333,0.035162,2,210.972092,11.720672,105.486046,44.828921,1,0
0,0,8,8,9,24,33,46,49,95,0.000333,0.159739,8,3833.739531,212.985529,479.217441,138.568425,1,0
0,0,11,11,12,34,46,74,68,142,0.000333,0.261449,12,9412.149573,522.897199,784.345798,215.993287,1,0
0,0,5,5,14,12,26,36,18,54,0.000333,0.084608,7,1776.766213,98.709234,253.823745,96.322519,3,0
0,0,5,5,12,9,21,32,22,54,0.000333,0.079062,12,2846.22169,158.123427,237.185141,71.548875,10,0
0,0,71,71,15,27,42,284,224,508,0.000333,0.913099,56,153400.646,8522.258114,2739.297251,186.985321,5,0
0,0,16,16,17,22,39,115,60,175,0.000333,0.308315,16,14799.12621,822.173678,924.945388,167.594364,8,0
0,0,76,76,25,53,78,327,282,609,0.000333,1.275937,60,229668.5971,12759.3665,3827.809951,419.676189,30,0
0,0,14,14,14,25,39,99,80,179,0.000333,0.315362,21,19867.82694,1103.768163,946.086997,169.399374,4,0
0,0,61,61,30,61,91,399,288,687,0.000333,1.490285,60,268251.2951,14902.84973,4470.854918,508.981695,9,0
0,0,27,27,19,56,75,244,148,392,0.000333,0.813899,18,43950.54468,2441.696927,2441.696927,405.922498,2,0
0,0,6,6,6,9,15,18,15,33,0.000333,0.042976,3,386.782169,21.487898,128.92739,44.0391,1,0
0,0,6,6,6,9,15,18,15,33,0.000333,0.042976,3,386.782169,21.487898,128.92739,44.0391,1,0
0,0,11,11,12,6,18,69,31,100,0.000333,0.138998,30,12509.775,694.9875,416.9925,58.529325,9,0
0,0,10,10,12,6,18,62,28,90,0.000333,0.125098,24,9007.038003,500.391,375.29325,58.529325,8,0
0,0,10,10,7,9,16,22,23,45,0.000333,0.06,6,1080,60,180,48.180809,5,0
0,0,10,10,7,9,16,22,23,45,0.000333,0.06,6,1080,60,180,48.180809,5,0
0,0,5,5,9,7,16,15,12,27,0.000333,0.036,4,432,24,108,48.180809,1,0
0,0,5,5,9,7,16,15,12,27,0.000333,0.036,4,432,24,108,48.180809,1,0
0,0,4,4,7,10,17,19,20,39,0.000333,0.053137,6,956.466305,53.137017,159.411051,52.870765,4,0
0,0,6,6,9,7,16,27,18,45,0.000333,0.06,8,1440,80,180,48.180809,2,0
0,0,6,6,9,7,16,27,18,45,0.000333,0.06,8,1440,80,180,48.180809,2,0
0,0,4,4,7,8,15,11,12,23,0.000333,0.029953,3,269.575451,14.976414,89.858484,43.651484,1,0
0,0,13,13,15,22,37,82,55,137,0.000333,0.237898,14,9991.731555,555.096198,713.695111,156.710855,4,0
0,0,25,25,15,44,59,142,119,261,0.000333,0.51179,14,21495.1777,1194.176539,1535.369836,298.81835,4,0
0,0,25,25,15,44,59,142,119,261,0.000333,0.51179,14,21495.1777,1194.176539,1535.369836,298.81835,4,0
0,0,4,4,7,12,19,17,15,32,0.000333,0.045311,3,407.801041,22.655613,135.93368,62.671034,1,0
0,0,4,4,7,12,19,17,15,32,0.000333,0.045311,3,407.801041,22.655613,135.93368,62.671034,1,0
0,0,5,5,7,11,18,23,19,42,0.000333,0.058379,3,525.41055,29.189475,175.13685,57.705232,1,0
0,0,5,5,7,11,18,23,19,42,0.000333,0.058379,3,525.41055,29.189475,175.13685,57.705232,1,0
0,0,40,40,18,50,68,268,211,479,0.000333,0.971965,36,104972.2092,5831.789402,2915.894701,357.25146,11,0
0,0,4,4,7,11,18,21,19,40,0.000333,0.055599,3,500.391,27.7995,166.797,57.705232,1,0
0,0,7,7,8,14,22,42,34,76,0.000333,0.112972,8,2711.334424,150.62969,338.916803,77.302969,1,0
0,0,6,6,12,19,31,40,30,70,0.000333,0.115598,6,2080.76245,115.597914,346.793742,123.730173,3,0
0,0,6,6,12,21,33,42,33,75,0.000333,0.12611,6,2269.977354,126.109853,378.329559,135.258216,3,0
0,0,21,21,10,5,15,85,43,128,0.000333,0.166694,40,20003.27985,1111.293325,500.081996,44.828921,22,0
0,0,21,21,10,5,15,85,43,128,0.000333,0.166694,40,20003.27985,1111.293325,500.081996,44.828921,22,0
0,0,31,31,26,46,72,212,139,351,0.000333,0.721881,39,84460.10335,4692.227964,2165.643676,376.295283,27,0
0,0,31,31,26,46,72,212,139,351,0.000333,0.721881,39,84460.10335,4692.227964,2165.643676,376.295283,27,0
0,0,5,5,8,16,24,26,29,55,0.000333,0.084058,4,1008.69175,56.038431,252.172938,88,1,0
0,0,3,3,12,14,26,23,17,40,0.000333,0.062673,6,1128.105532,62.67253,188.017589,96.322519,3,0
0,0,4,4,9,13,22,22,17,39,0.000333,0.057973,4,695.671333,38.648407,173.917833,76.635041,1,0
0,0,4,4,9,13,22,22,17,39,0.000333,0.057973,4,695.671333,38.648407,173.917833,76.635041,1,0
0,0,3,3,8,7,15,12,10,22,0.000333,0.028651,4,343.806372,19.100354,85.951593,43.651484,1,0
0,0,99,99,23,77,100,545,391,936,0.000333,2.072883,55,342025.7167,19001.4287,6218.649394,586.584489,60,0
0,0,7,7,11,21,32,33,37,70,0.000333,0.116667,5,1750,97.222222,350,130.292414,1,0
0,0,3,3,7,3,10,15,8,23,0.000333,0.025468,6,458.426077,25.468115,76.404346,24.406372,1,0
0,0,4,4,9,8,17,26,13,39,0.000333,0.053137,4,637.644203,35.424678,159.411051,52.529325,4,0
0,0,8,8,8,17,25,35,37,72,0.000333,0.111453,8,2674.861165,148.603398,334.357646,93.486868,1,0
0,0,19,19,18,26,44,93,77,170,0.000333,0.309368,18,16705.86075,928.103375,928.103375,197.270083,4,0
0,0,8,8,8,20,28,63,63,126,0.000333,0.201909,12,7268.720642,403.817813,605.72672,110.438562,1,0
0,0,38,38,18,42,60,240,192,432,0.000333,0.850592,36,91863.96254,5103.553475,2551.776737,301.535982,7,0
0,0,11,11,16,31,47,101,58,159,0.000333,0.294393,8,7065.437019,392.524279,883.179627,217.580086,1,0
0,0,8,8,10,21,31,49,34,83,0.000333,0.137066,5,2055.991469,114.221748,411.198294,125.457947,1,0
0,0,43,43,19,42,61,270,216,486,0.000333,0.960779,45,129705.2256,7205.845865,2882.338346,307.187955,7,0
0,0,10,10,14,14,28,57,34,91,0.000333,0.145823,14,6124.570171,340.253898,437.469298,106.605938,9,0
0,0,10,10,14,14,28,57,34,91,0.000333,0.145823,14,6124.570171,340.253898,437.469298,106.605938,9,0
0,0,5,5,8,8,16,24,17,41,0.000333,0.054667,8,1312,72.888889,164,48,3,0
0,0,34,34,16,36,52,167,143,310,0.000333,0.589045,24,42411.2715,2356.18175,1767.136313,250.1173,9,0
0,0,19,19,22,24,46,104,58,162,0.000333,0.298272,22,19685.97481,1093.665267,894.817037,208.146596,17,0
0,0,73,73,34,69,103,443,361,804,0.000333,1.791982,85,456955.446,25386.41367,5375.946424,594.461924,15,0
0,0,73,73,34,69,103,443,361,804,0.000333,1.791982,85,456955.446,25386.41367,5375.946424,594.461924,15,0
0,0,16,16,17,48,65,135,113,248,0.000333,0.497849,16,23896.75548,1327.597527,1493.547218,337.565068,5,0
0,0,6,6,10,11,21,24,21,45,0.000333,0.065885,5,988.27142,54.903968,197.654284,71.273029,1,0
0,0,11,11,15,21,36,84,43,127,0.000333,0.21886,14,9192.126653,510.673703,656.580475,150.842025,2,0
0,0,8,8,15,18,33,66,34,100,0.000333,0.168146,7,3531.075884,196.170882,504.439412,133.662009,2,0
0,0,4,4,7,8,15,20,12,32,0.000333,0.041673,3,375.061497,20.83675,125.020499,43.651484,1,0
0,0,9,9,15,20,35,72,36,108,0.000333,0.184654,7,3877.737961,215.429887,553.962566,145.041921,2,0
0,0,8,8,15,18,33,66,34,100,0.000333,0.168146,7,3531.075884,196.170882,504.439412,133.662009,2,0
0,0,9,9,15,20,35,72,36,108,0.000333,0.184654,7,3877.737961,215.429887,553.962566,145.041921,2,0
0,0,8,8,15,18,33,66,34,100,0.000333,0.168146,7,3531.075884,196.170882,504.439412,133.662009,2,0
0,0,5,5,8,10,18,28,17,45,0.000333,0.062549,4,750.5865,41.69925,187.646625,57.219281,1,0
0,0,4,4,12,12,24,42,17,59,0.000333,0.090171,6,1623.076725,90.170929,270.512788,86.0391,5,0
0,0,9,9,15,19,34,68,35,103,0.000333,0.17467,7,3668.060709,203.78115,524.008673,139.313982,2,0
0,0,11,11,15,21,36,84,43,127,0.000333,0.21886,14,9192.126653,510.673703,656.580475,150.842025,2,0
0,0,8,8,15,18,33,66,34,100,0.000333,0.168146,7,3531.075884,196.170882,504.439412,133.662009,2,0
0,0,9,9,15,19,34,68,35,103,0.000333,0.17467,7,3668.060709,203.78115,524.008673,139.313982,2,0
0,0,5,5,8,10,18,28,17,45,0.000333,0.062549,4,750.5865,41.69925,187.646625,57.219281,1,0
0,0,8,8,15,18,33,66,34,100,0.000333,0.168146,7,3531.075884,196.170882,504.439412,133.662009,2,0
0,0,8,8,16,17,33,49,35,84,0.000333,0.141243,16,6779.665696,376.648094,423.729106,133.486868,4,0
0,0,4,4,4,7,11,13,11,24,0.000333,0.027675,2,166.052718,9.225151,83.026359,27.651484,3,0
0,0,8,8,16,17,33,49,35,84,0.000333,0.141243,16,6779.665696,376.648094,423.729106,133.486868,4,0
0,0,5,5,11,12,23,31,19,50,0.000333,0.075393,5,1130.890489,62.827249,226.178098,81.073298,2,0
0,0,5,5,10,12,22,26,19,45,0.000333,0.066891,5,1003.372114,55.742895,200.674423,76.238831,1,0
0,0,4,4,4,7,11,13,11,24,0.000333,0.027675,2,166.052718,9.225151,83.026359,27.651484,3,0
0,0,9,9,15,19,34,68,35,103,0.000333,0.17467,7,3668.060709,203.78115,524.008673,139.313982,2,0
0,0,8,8,15,18,33,66,34,100,0.000333,0.168146,7,3531.075884,196.170882,504.439412,133.662009,2,0
0,0,11,11,15,21,36,84,43,127,0.000333,0.21886,14,9192.126653,510.673703,656.580475,150.842025,2,0
0,0,6,6,7,11,18,41,25,66,0.000333,0.091738,6,1651.290301,91.73835,275.21505,57.705232,1,0
0,0,4,4,8,11,19,27,17,44,0.000333,0.062303,4,747.635242,41.535291,186.908811,62.053748,1,0
0,0,4,4,5,9,14,15,13,28,0.000333,0.035535,2,213.211876,11.845104,106.605938,40.138965,1,0
0,0,4,4,8,12,20,18,19,37,0.000333,0.053304,4,639.645358,35.535853,159.91134,67.01955,1,0
0,0,7,7,11,19,30,44,28,72,0.000333,0.117765,5,1766.480614,98.137812,353.296123,118.764371,2,0
0,0,3,3,8,7,15,15,9,24,0.000333,0.031255,4,375.061497,20.83675,93.765374,43.651484,3,0
0,0,4,4,4,7,11,13,11,24,0.000333,0.027675,2,166.052718,9.225151,83.026359,27.651484,3,0
0,0,4,4,7,8,15,16,12,28,0.000333,0.036464,3,328.17881,18.232156,109.392937,43.651484,3,0
0,0,3,3,9,8,17,16,11,27,0.000333,0.036787,4,441.445987,24.524777,110.361497,52.529325,2,0
0,0,22,22,13,29,42,136,72,208,0.000333,0.373867,12,13459.22429,747.734683,1121.602024,188.987165,1,0
0,0,9,9,15,19,34,68,35,103,0.000333,0.17467,7,3668.060709,203.78115,524.008673,139.313982,2,0
0,0,8,8,15,18,33,66,34,100,0.000333,0.168146,7,3531.075884,196.170882,504.439412,133.662009,2,0
0,0,11,11,15,21,36,84,43,127,0.000333,0.21886,14,9192.126653,510.673703,656.580475,150.842025,2,0
0,0,7,7,11,19,30,44,28,72,0.000333,0.117765,5,1766.480614,98.137812,353.296123,118.764371,2,0
0,0,10,10,15,27,42,169,61,230,0.000333,0.413411,14,17363.2621,964.625672,1240.233007,186.985321,7,0
0,0,9,9,14,17,31,44,25,69,0.000333,0.113947,7,2392.876818,132.937601,341.839545,122.789837,3,0
0,0,7,7,11,18,29,48,28,76,0.000333,0.123069,5,1846.032778,102.557377,369.206556,113.112398,1,0
0,0,13,13,10,13,23,53,40,93,0.000333,0.14023,15,6310.368929,350.576052,420.691262,81.324997,1,0
0,0,3,3,10,8,18,16,13,29,0.000333,0.040309,5,604.639125,33.591063,120.927825,57.219281,3,0
0,0,4,4,8,11,19,24,16,40,0.000333,0.056639,4,679.668402,37.759356,169.917101,62.053748,1,0
0,0,8,8,15,18,33,66,34,100,0.000333,0.168146,7,3531.075884,196.170882,504.439412,133.662009,2,0
0,0,8,8,16,17,33,49,35,84,0.000333,0.141243,16,6779.665696,376.648094,423.729106,133.486868,4,0
0,0,3,3,6,9,15,26,11,37,0.000333,0.048185,3,433.664856,24.092492,144.554952,44.0391,1,0
0,0,9,9,15,19,34,68,35,103,0.000333,0.17467,7,3668.060709,203.78115,524.008673,139.313982,2,0
0,0,8,8,11,15,26,59,34,93,0.000333,0.145714,10,4371.408938,242.856052,437.140894,96.657107,1,0
0,0,5,5,10,11,21,29,17,46,0.000333,0.067349,5,1010.233007,56.124056,202.046601,71.273029,1,0
0,0,3,3,9,8,17,16,11,27,0.000333,0.036787,4,441.445987,24.524777,110.361497,52.529325,2,0
0,0,3,3,6,7,13,13,9,22,0.000333,0.027137,3,244.229021,13.568279,81.409674,35.161259,2,0
0,0,3,3,8,8,16,20,12,32,0.000333,0.042667,4,512,28.444444,128,48,1,0
0,0,9,9,15,19,34,68,35,103,0.000333,0.17467,7,3668.060709,203.78115,524.008673,139.313982,2,0
0,0,11,11,15,21,36,84,43,127,0.000333,0.21886,14,9192.126653,510.673703,656.580475,150.842025,2,0
0,0,8,8,15,18,33,66,34,100,0.000333,0.168146,7,3531.075884,196.170882,504.439412,133.662009,2,0
0,0,5,5,8,8,16,25,13,38,0.000333,0.050667,4,608,33.777778,152,48,3,0
0,0,4,4,4,7,11,13,11,24,0.000333,0.027675,2,166.052718,9.225151,83.026359,27.651484,3,0
0,0,4,4,10,15,25,32,21,53,0.000333,0.082041,5,1230.62189,68.367883,246.124378,91.82264,1,0
0,0,7,7,11,19,30,44,28,72,0.000333,0.117765,5,1766.480614,98.137812,353.296123,118.764371,2,0
0,0,5,5,11,12,23,31,19,50,0.000333,0.075393,5,1130.890489,62.827249,226.178098,81.073298,2,0
0,0,4,4,6,8,14,17,12,29,0.000333,0.036804,3,331.239878,18.402215,110.413293,39.509775,3,0
0,0,6,6,14,12,26,38,24,62,0.000333,0.097142,14,4079.981675,226.665649,291.427263,96.322519,4,0
0,0,3,3,8,13,21,16,16,32,0.000333,0.046851,4,562.21663,31.234257,140.554158,72.105716,7,0
0,0,3,3,7,8,15,23,12,35,0.000333,0.04558,3,410.223513,22.790195,136.741171,43.651484,1,0
0,0,3,3,10,8,18,19,11,30,0.000333,0.041699,5,625.48875,34.749375,125.09775,57.219281,1,0
0,0,3,3,7,5,12,11,7,18,0.000333,0.02151,3,193.587975,10.754888,64.529325,31.261125,1,0
0,0,6,6,8,12,20,23,20,43,0.000333,0.061948,4,743.371632,41.298424,185.842908,67.01955,3,0
0,0,4,4,4,7,11,13,11,24,0.000333,0.027675,2,166.052718,9.225151,83.026359,27.651484,3,0
0,0,3,3,7,5,12,11,7,18,0.000333,0.02151,3,193.587975,10.754888,64.529325,31.261125,1,0
0,0,5,5,8,10,18,28,17,45,0.000333,0.062549,4,750.5865,41.69925,187.646625,57.219281,1,0
0,0,6,6,9,9,18,23,15,38,0.000333,0.052819,4,633.8286,35.2127,158.45715,57.05865,1,0
0,0,5,5,8,10,18,28,17,45,0.000333,0.062549,4,750.5865,41.69925,187.646625,57.219281,1,0
0,0,3,3,8,7,15,11,9,20,0.000333,0.026046,4,312.551248,17.363958,78.137812,43.651484,1,0
0,0,3,3,8,7,15,15,9,24,0.000333,0.031255,4,375.061497,20.83675,93.765374,43.651484,3,0
0,0,3,3,9,8,17,16,11,27,0.000333,0.036787,4,441.445987,24.524777,110.361497,52.529325,2,0
0,0,3,3,7,5,12,11,7,18,0.000333,0.02151,3,193.587975,10.754888,64.529325,31.261125,1,0
0,0,3,3,8,8,16,20,12,32,0.000333,0.042667,4,512,28.444444,128,48,1,0
0,0,3,3,8,6,14,11,9,20,0.000333,0.025382,4,304.588394,16.921577,76.147098,39.509775,1,0
0,0,5,5,8,10,18,28,17,45,0.000333,0.062549,4,750.5865,41.69925,187.646625,57.219281,1,0
0,0,9,9,15,19,34,68,35,103,0.000333,0.17467,7,3668.060709,203.78115,524.008673,139.313982,2,0
0,0,11,11,15,21,36,84,43,127,0.000333,0.21886,14,9192.126653,510.673703,656.580475,150.842025,2,0
0,0,6,6,14,10,24,37,22,59,0.000333,0.090171,14,3787.179026,210.398835,270.512788,86.52225,4,0
0,0,3,3,5,6,11,9,8,17,0.000333,0.019603,2,117.620675,6.534482,58.810338,27.119415,2,0
0,0,5,5,8,10,18,26,15,41,0.000333,0.056989,4,683.8677,37.99265,170.966925,57.219281,1,0
0,0,5,5,11,12,23,31,19,50,0.000333,0.075393,5,1130.890489,62.827249,226.178098,81.073298,2,0
0,0,10,10,7,14,21,57,36,93,0.000333,0.136162,6,2450.913122,136.16184,408.48552,72.954453,1,0
0,0,7,7,11,19,30,44,28,72,0.000333,0.117765,5,1766.480614,98.137812,353.296123,118.764371,2,0
0,0,25,25,12,35,47,382,213,595,0.000333,1.10166,36,118979.2932,6609.960733,3304.980367,222.544456,4,0
0,0,7,7,11,19,30,44,28,72,0.000333,0.117765,5,1766.480614,98.137812,353.296123,118.764371,2,0
0,0,4,4,6,9,15,16,12,28,0.000333,0.036464,3,328.17881,18.232156,109.392937,44.0391,1,0
0,0,6,6,6,15,21,23,32,55,0.000333,0.080526,6,1449.46475,80.525819,241.577458,74.113134,1,0
0,0,8,8,15,18,33,66,34,100,0.000333,0.168146,7,3531.075884,196.170882,504.439412,133.662009,2,0
0,0,8,8,15,18,33,66,34,100,0.000333,0.168146,7,3531.075884,196.170882,504.439412,133.662009,2,0
0,0,25,25,12,35,47,382,213,595,0.000333,1.10166,36,118979.2932,6609.960733,3304.980367,222.544456,4,0
0,0,4,4,8,10,18,34,17,51,0.000333,0.070889,4,850.6647,47.25915,212.666175,57.219281,1,0
0,0,4,4,5,7,12,14,10,24,0.000333,0.02868,2,172.0782,9.5599,86.0391,31.261125,2,0
0,0,7,7,11,18,29,48,28,76,0.000333,0.123069,5,1846.032778,102.557377,369.206556,113.112398,1,0
0,0,25,25,12,35,47,382,213,595,0.000333,1.10166,36,118979.2932,6609.960733,3304.980367,222.544456,4,0
0,0,5,5,11,12,23,33,21,54,0.000333,0.081424,5,1221.361728,67.853429,244.272346,81.073298,1,0
0,0,5,5,10,10,20,27,14,41,0.000333,0.059066,5,885.995259,49.221959,177.199052,66.438562,3,0
0,0,4,4,5,10,15,13,13,26,0.000333,0.03386,2,203.158311,11.286573,101.579155,44.828921,1,0
0,0,9,9,15,19,34,68,35,103,0.000333,0.17467,7,3668.060709,203.78115,524.008673,139.313982,2,0
0,0,6,6,5,14,19,22,31,53,0.000333,0.075047,4,900.560633,50.031146,225.140158,64.912609,1,0
0,0,11,11,15,21,36,84,43,127,0.000333,0.21886,14,9192.126653,510.673703,656.580475,150.842025,2,0
0,0,5,5,7,8,15,17,12,29,0.000333,0.037767,3,339.899482,18.883305,113.299827,43.651484,1,0
0,0,4,4,4,7,11,13,11,24,0.000333,0.027675,2,166.052718,9.225151,83.026359,27.651484,3,0
0,0,4,4,5,11,16,14,15,29,0.000333,0.038667,2,232,12.888889,116,49.663388,1,0
0,0,4,4,4,7,11,13,11,24,0.000333,0.027675,2,166.052718,9.225151,83.026359,27.651484,2,0
0,0,6,6,5,12,17,19,26,45,0.000333,0.061312,4,735.743311,40.874628,183.935828,54.62919,1,0
0,0,6,6,10,11,21,24,21,45,0.000333,0.065885,5,988.27142,54.903968,197.654284,71.273029,1,0
0,0,9,9,15,19,34,68,35,103,0.000333,0.17467,7,3668.060709,203.78115,524.008673,139.313982,2,0
0,0,5,5,8,10,18,28,17,45,0.000333,0.062549,4,750.5865,41.69925,187.646625,57.219281,1,0
0,0,3,3,7,8,15,23,12,35,0.000333,0.04558,3,410.223513,22.790195,136.741171,43.651484,1,0
0,0,3,3,9,8,17,16,11,27,0.000333,0.036787,4,441.445987,24.524777,110.361497,52.529325,2,0
0,0,7,7,8,12,20,29,20,49,0.000333,0.070591,4,847.097907,47.060995,211.774477,67.01955,1,0
0,0,8,8,15,18,33,66,34,100,0.000333,0.168146,7,3531.075884,196.170882,504.439412,133.662009,2,0
0,0,11,11,15,21,36,84,43,127,0.000333,0.21886,14,9192.126653,510.673703,656.580475,150.842025,2,0
0,0,4,4,10,8,18,25,15,40,0.000333,0.055599,5,833.985,46.3325,166.797,57.219281,1,0
0,0,3,3,9,8,17,16,11,27,0.000333,0.036787,4,441.445987,24.524777,110.361497,52.529325,2,0
0,0,4,4,11,10,21,24,14,38,0.000333,0.055636,5,834.54031,46.363351,166.908062,71.273029,3,0
0,0,3,3,6,8,14,13,12,25,0.000333,0.031728,3,285.551619,15.863979,95.183873,39.509775,5,0
0,0,11,11,12,18,30,69,40,109,0.000333,0.178284,12,6418.212899,356.567383,534.851075,118.0782,2,0
0,0,4,4,6,11,17,16,15,31,0.000333,0.042237,3,380.134044,21.118558,126.711348,53.563523,1,0
0,0,3,3,7,5,12,11,7,18,0.000333,0.02151,3,193.587975,10.754888,64.529325,31.261125,1,0
0,0,3,3,7,5,12,11,7,18,0.000333,0.02151,3,193.587975,10.754888,64.529325,31.261125,1,0
0,0,6,6,7,11,18,41,25,66,0.000333,0.091738,6,1651.290301,91.73835,275.21505,57.705232,1,0
0,0,5,5,8,10,18,28,17,45,0.000333,0.062549,4,750.5865,41.69925,187.646625,57.219281,1,0
0,0,7,7,11,19,30,44,28,72,0.000333,0.117765,5,1766.480614,98.137812,353.296123,118.764371,2,0
0,0,4,4,5,9,14,15,13,28,0.000333,0.035535,2,213.211876,11.845104,106.605938,40.138965,1,0
0,0,3,3,8,7,15,11,9,20,0.000333,0.026046,4,312.551248,17.363958,78.137812,43.651484,1,0
0,0,4,4,5,9,14,15,13,28,0.000333,0.035535,2,213.211876,11.845104,106.605938,40.138965,1,0
0,0,6,6,10,11,21,24,21,45,0.000333,0.065885,5,988.27142,54.903968,197.654284,71.273029,1,0
0,0,6,6,9,15,24,34,24,58,0.000333,0.088643,4,1063.7113,59.095072,265.927825,87.132684,1,0
0,0,4,4,9,13,22,22,17,39,0.000333,0.057973,4,695.671333,38.648407,173.917833,76.635041,3,0
0,0,3,3,8,8,16,20,12,32,0.000333,0.042667,4,512,28.444444,128,48,1,0
0,0,6,6,7,17,24,36,30,66,0.000333,0.100869,3,907.822575,50.434588,302.607525,89.138353,1,0
0,0,4,4,7,15,22,25,23,48,0.000333,0.071351,3,642.158153,35.675453,214.052718,78.254843,1,0
0,0,3,3,8,8,16,20,12,32,0.000333,0.042667,4,512,28.444444,128,48,1,0
0,0,3,3,8,6,14,11,9,20,0.000333,0.025382,4,304.588394,16.921577,76.147098,39.509775,1,0
0,0,5,5,9,15,24,20,27,47,0.000333,0.071831,4,861.97295,47.887386,215.493238,87.132684,1,0
0,0,3,3,10,8,18,16,13,29,0.000333,0.040309,5,604.639125,33.591063,120.927825,57.219281,3,0
0,0,3,3,9,13,22,20,16,36,0.000333,0.053513,4,642.158153,35.675453,160.539538,76.635041,3,0
0,0,3,3,7,8,15,23,12,35,0.000333,0.04558,3,410.223513,22.790195,136.741171,43.651484,1,0
0,0,5,5,8,10,18,28,17,45,0.000333,0.062549,4,750.5865,41.69925,187.646625,57.219281,1,0
0,0,8,8,15,18,33,66,34,100,0.000333,0.168146,7,3531.075884,196.170882,504.439412,133.662009,2,0
0,0,4,4,10,15,25,32,21,53,0.000333,0.082041,5,1230.62189,68.367883,246.124378,91.82264,1,0
0,0,25,25,12,35,47,382,213,595,0.000333,1.10166,36,118979.2932,6609.960733,3304.980367,222.544456,4,0
0,0,5,5,11,12,23,33,21,54,0.000333,0.081424,5,1221.361728,67.853429,244.272346,81.073298,1,0
0,0,3,3,7,8,15,23,12,35,0.000333,0.04558,3,410.223513,22.790195,136.741171,43.651484,1,0
0,0,7,7,11,19,30,44,28,72,0.000333,0.117765,5,1766.480614,98.137812,353.296123,118.764371,2,0
0,0,5,5,8,10,18,28,17,45,0.000333,0.062549,4,750.5865,41.69925,187.646625,57.219281,1,0
0,0,3,3,7,8,15,23,12,35,0.000333,0.04558,3,410.223513,22.790195,136.741171,43.651484,1,0
0,0,11,11,15,21,36,84,43,127,0.000333,0.21886,14,9192.126653,510.673703,656.580475,150.842025,2,0
0,0,9,9,15,19,34,68,35,103,0.000333,0.17467,7,3668.060709,203.78115,524.008673,139.313982,2,0
0,0,4,4,10,7,17,25,15,40,0.000333,0.0545,10,1634.985137,90.832508,163.498514,52.870765,1,0
0,0,14,14,14,21,35,74,43,117,0.000333,0.200042,14,8401.765582,466.764755,600.126113,145.541635,11,0
0,0,8,8,15,18,33,66,34,100,0.000333,0.168146,7,3531.075884,196.170882,504.439412,133.662009,2,0
0,0,7,7,9,11,20,31,20,51,0.000333,0.073473,4,881.673331,48.981852,220.418333,66.583073,1,0
0,0,4,4,7,12,19,17,16,33,0.000333,0.046727,3,420.544824,23.363601,140.181608,62.671034,1,0
0,0,18,18,11,28,39,116,64,180,0.000333,0.317124,10,9513.723994,528.540222,951.372399,172.659686,1,0
0,0,4,4,4,7,11,13,11,24,0.000333,0.027675,2,166.052718,9.225151,83.026359,27.651484,3,0
0,0,20,20,11,20,31,123,70,193,0.000333,0.31872,15,14342.39832,796.799907,956.159888,124.49231,5,0
0,0,8,8,15,18,33,66,34,100,0.000333,0.168146,7,3531.075884,196.170882,504.439412,133.662009,2,0
0,0,11,11,15,21,36,84,43,127,0.000333,0.21886,14,9192.126653,510.673703,656.580475,150.842025,2,0
0,0,9,9,15,19,34,68,35,103,0.000333,0.17467,7,3668.060709,203.78115,524.008673,139.313982,2,0
0,0,3,3,9,8,17,16,11,27,0.000333,0.036787,4,441.445987,24.524777,110.361497,52.529325,2,0
0,0,5,5,7,13,20,18,18,36,0.000333,0.051863,3,466.768234,25.931569,155.589411,67.757201,1,0
0,0,4,4,4,7,11,13,11,24,0.000333,0.027675,2,166.052718,9.225151,83.026359,27.651484,3,0
0,0,4,4,8,7,15,17,12,29,0.000333,0.037767,4,453.199309,25.177739,113.299827,43.651484,1,0
0,0,4,4,10,9,19,22,13,35,0.000333,0.049559,5,743.387315,41.299295,148.677463,61.748606,1,0
0,0,5,5,12,10,22,25,14,39,0.000333,0.057973,6,1043.506999,57.972611,173.917833,76.238831,3,0
0,0,3,3,9,8,17,16,11,27,0.000333,0.036787,4,441.445987,24.524777,110.361497,52.529325,2,0
0,0,4,4,5,13,18,16,17,33,0.000333,0.045869,2,275.21505,15.289725,137.607525,59.715357,1,0
0,0,5,5,8,10,18,28,17,45,0.000333,0.062549,4,750.5865,41.69925,187.646625,57.219281,1,0
0,0,3,3,9,8,17,16,11,27,0.000333,0.036787,4,441.445987,24.524777,110.361497,52.529325,2,0
0,0,5,5,10,13,23,24,23,47,0.000333,0.070869,5,1063.03706,59.057614,212.607412,81.324997,1,0
0,0,4,4,4,7,11,13,11,24,0.000333,0.027675,2,166.052718,9.225151,83.026359,27.651484,3,0
0,0,3,3,9,8,17,16,11,27,0.000333,0.036787,4,441.445987,24.524777,110.361497,52.529325,2,0
0,0,3,3,8,7,15,15,9,24,0.000333,0.031255,4,375.061497,20.83675,93.765374,43.651484,3,0
0,0,9,9,15,19,34,68,35,103,0.000333,0.17467,7,3668.060709,203.78115,524.008673,139.313982,2,0
0,0,4,4,8,15,23,22,21,43,0.000333,0.064838,4,778.052656,43.225148,194.513164,82.603359,1,0
0,0,11,11,15,21,36,84,43,127,0.000333,0.21886,14,9192.126653,510.673703,656.580475,150.842025,2,0
0,0,5,5,10,12,22,23,18,41,0.000333,0.060946,5,914.183482,50.787971,182.836696,76.238831,1,0
0,0,5,5,8,10,18,28,17,45,0.000333,0.062549,4,750.5865,41.69925,187.646625,57.219281,1,0
0,0,3,3,9,8,17,16,11,27,0.000333,0.036787,4,441.445987,24.524777,110.361497,52.529325,2,0
0,0,3,3,5,6,11,9,8,17,0.000333,0.019603,2,117.620675,6.534482,58.810338,27.119415,1,0
0,0,3,3,8,7,15,20,12,32,0.000333,0.041673,4,500.081996,27.782333,125.020499,43.651484,1,0
0,0,4,4,11,10,21,17,15,32,0.000333,0.046851,5,702.770788,39.042822,140.554158,71.273029,1,0
0,0,8,8,9,16,25,34,31,65,0.000333,0.100617,4,1207.402609,67.077923,301.850652,92.529325,1,0
0,0,13,13,11,22,33,99,50,149,0.000333,0.250538,10,7516.147238,417.563735,751.614724,136.161243,3,0
0,0,4,4,4,7,11,13,11,24,0.000333,0.027675,2,166.052718,9.225151,83.026359,27.651484,3,0
0,0,5,5,8,10,18,28,17,45,0.000333,0.062549,4,750.5865,41.69925,187.646625,57.219281,1,0
0,0,9,9,15,19,34,68,35,103,0.000333,0.17467,7,3668.060709,203.78115,524.008673,139.313982,2,0
0,0,5,5,9,9,18,27,17,44,0.000333,0.061159,4,733.9068,40.7726,183.4767,57.05865,1,0
0,0,8,8,15,18,33,66,34,100,0.000333,0.168146,7,3531.075884,196.170882,504.439412,133.662009,2,0
0,0,9,9,15,19,34,68,35,103,0.000333,0.17467,7,3668.060709,203.78115,524.008673,139.313982,2,0
0,0,36,36,16,62,78,272,185,457,0.000333,0.957476,16,45958.86102,2553.270057,2872.428814,433.160171,4,0
0,0,7,7,11,19,30,44,28,72,0.000333,0.117765,5,1766.480614,98.137812,353.296123,118.764371,2,0
0,0,5,5,10,10,20,26,15,41,0.000333,0.059066,5,885.995259,49.221959,177.199052,66.438562,1,0
0,0,9,9,15,19,34,68,35,103,0.000333,0.17467,7,3668.060709,203.78115,524.008673,139.313982,2,0
0,0,9,9,15,19,34,68,35,103,0.000333,0.17467,7,3668.060709,203.78115,524.008673,139.313982,2,0
0,0,5,5,10,11,21,29,17,46,0.000333,0.067349,5,1010.233007,56.124056,202.046601,71.273029,1,0
0,0,3,3,5,6,11,9,8,17,0.000333,0.019603,2,117.620675,6.534482,58.810338,27.119415,4,0
0,0,63,63,27,53,80,316,350,666,0.000333,1.403468,78,328411.5207,18245.08448,4210.404111,431.961747,8,0
0,0,5,5,10,10,20,26,15,41,0.000333,0.059066,5,885.995259,49.221959,177.199052,66.438562,1,0
0,0,7,7,11,19,30,44,28,72,0.000333,0.117765,5,1766.480614,98.137812,353.296123,118.764371,2,0
0,0,12,12,15,22,37,59,49,108,0.000333,0.18754,14,7876.693489,437.594083,562.620963,156.710855,2,0
0,0,4,4,5,7,12,14,10,24,0.000333,0.02868,2,172.0782,9.5599,86.0391,31.261125,2,0
0,0,5,5,6,13,19,21,19,40,0.000333,0.056639,3,509.751302,28.319517,169.917101,63.615491,1,0
0,0,3,3,7,5,12,11,7,18,0.000333,0.02151,3,193.587975,10.754888,64.529325,31.261125,1,0
0,0,3,3,8,6,14,11,9,20,0.000333,0.025382,4,304.588394,16.921577,76.147098,39.509775,1,0
0,0,5,5,7,7,14,19,13,32,0.000333,0.040612,3,365.506073,20.305893,121.835358,39.302969,1,0
0,0,7,7,8,14,22,37,26,63,0.000333,0.093648,4,1123.776768,62.432043,280.944192,77.302969,1,0
0,0,7,7,8,17,25,34,31,65,0.000333,0.100617,4,1207.402609,67.077923,301.850652,93.486868,1,0
0,0,8,8,14,13,27,52,33,85,0.000333,0.134722,14,5658.316128,314.350896,404.165438,101.408685,5,0
0,0,4,4,8,8,16,18,12,30,0.000333,0.04,4,480,26.666667,120,48,1,0
0,0,3,3,7,5,12,11,7,18,0.000333,0.02151,3,193.587975,10.754888,64.529325,31.261125,1,0
0,0,6,6,13,11,24,38,23,61,0.000333,0.093228,12,3356.192551,186.455142,279.682713,86.159464,4,0
0,0,9,9,15,19,34,68,35,103,0.000333,0.17467,7,3668.060709,203.78115,524.008673,139.313982,2,0
0,0,4,4,6,8,14,17,12,29,0.000333,0.036804,3,331.239878,18.402215,110.413293,39.509775,3,0
0,0,3,3,9,8,17,16,11,27,0.000333,0.036787,4,441.445987,24.524777,110.361497,52.529325,2,0
0,0,12,12,9,20,29,68,60,128,0.000333,0.207274,12,7461.858809,414.547712,621.821567,114.967887,1,0
0,0,8,8,9,18,27,38,44,82,0.000333,0.129967,8,3119.206201,173.289233,389.900775,103.587975,1,0
0,0,5,5,8,10,18,28,17,45,0.000333,0.062549,4,750.5865,41.69925,187.646625,57.219281,1,0
0,0,3,3,7,5,12,11,7,18,0.000333,0.02151,3,193.587975,10.754888,64.529325,31.261125,1,0
0,0,5,5,8,10,18,28,17,45,0.000333,0.062549,4,750.5865,41.69925,187.646625,57.219281,1,0
0,0,3,3,8,8,16,20,12,32,0.000333,0.042667,4,512,28.444444,128,48,1,0
0,0,5,5,8,10,18,26,15,41,0.000333,0.056989,4,683.8677,37.99265,170.966925,57.219281,1,0
0,0,5,5,8,10,18,28,17,45,0.000333,0.062549,4,750.5865,41.69925,187.646625,57.219281,1,0
0,0,52,52,28,89,117,523,358,881,0.000333,2.017597,56,338956.3138,18830.90632,6052.791318,710.946213,30,0
0,0,9,9,15,19,34,68,35,103,0.000333,0.17467,7,3668.060709,203.78115,524.008673,139.313982,2,0
0,0,11,11,15,21,36,84,43,127,0.000333,0.21886,14,9192.126653,510.673703,656.580475,150.842025,2,0
0,0,4,4,4,7,11,13,11,24,0.000333,0.027675,2,166.052718,9.225151,83.026359,27.651484,3,0
0,0,8,8,11,17,28,46,37,83,0.000333,0.133003,10,3990.104585,221.672477,399.010459,107.540616,1,0
0,0,3,3,7,8,15,23,12,35,0.000333,0.04558,3,410.223513,22.790195,136.741171,43.651484,1,0
0,0,3,3,10,8,18,16,13,29,0.000333,0.040309,5,604.639125,33.591063,120.927825,57.219281,3,0
0,0,3,3,6,9,15,26,11,37,0.000333,0.048185,3,433.664856,24.092492,144.554952,44.0391,1,0
0,0,4,4,8,11,19,17,18,35,0.000333,0.049559,4,594.709852,33.039436,148.677463,62.053748,1,0
0,0,4,4,4,7,11,13,11,24,0.000333,0.027675,2,166.052718,9.225151,83.026359,27.651484,2,0
0,0,10,10,14,18,32,51,39,90,0.000333,0.15,14,6300,350,450,128.361619,2,0
0,0,3,3,7,5,12,11,7,18,0.000333,0.02151,3,193.587975,10.754888,64.529325,31.261125,1,0
0,0,3,3,8,8,16,20,12,32,0.000333,0.042667,4,512,28.444444,128,48,1,0
0,0,3,3,9,8,17,16,11,27,0.000333,0.036787,4,441.445987,24.524777,110.361497,52.529325,2,0
0,0,4,4,4,7,11,13,11,24,0.000333,0.027675,2,166.052718,9.225151,83.026359,27.651484,3,0
0,0,5,5,10,11,21,29,17,46,0.000333,0.067349,5,1010.233007,56.124056,202.046601,71.273029,1,0
0,0,3,3,7,8,15,23,12,35,0.000333,0.04558,3,410.223513,22.790195,136.741171,43.651484,1,0
0,0,4,4,10,15,25,32,21,53,0.000333,0.082041,5,1230.62189,68.367883,246.124378,91.82264,1,0
0,0,7,7,11,19,30,44,28,72,0.000333,0.117765,5,1766.480614,98.137812,353.296123,118.764371,2,0
0,0,4,4,4,7,11,13,11,24,0.000333,0.027675,2,166.052718,9.225151,83.026359,27.651484,3,0
0,0,5,5,12,16,28,39,25,64,0.000333,0.102557,6,1846.02429,102.556905,307.670715,107.01955,4,0
0,0,4,4,11,10,21,36,17,53,0.000333,0.077598,5,1163.964117,64.664673,232.792823,71.273029,1,0
0,0,9,9,12,14,26,48,35,83,0.000333,0.130045,12,4681.637959,260.090998,390.136497,96.322519,1,0
0,0,8,8,12,18,30,51,34,85,0.000333,0.139029,6,2502.514204,139.028567,417.085701,118.0782,1,0
0,0,3,3,7,8,15,23,12,35,0.000333,0.04558,3,410.223513,22.790195,136.741171,43.651484,1,0
0,0,11,11,12,16,28,56,40,96,0.000333,0.153835,12,5538.07287,307.670715,461.506073,107.01955,1,0
0,0,3,3,8,7,15,11,9,20,0.000333,0.026046,4,312.551248,17.363958,78.137812,43.651484,1,0
0,0,5,5,11,13,24,27,19,46,0.000333,0.070303,5,1054.541375,58.585632,210.908275,86.159464,1,0
0,0,4,4,5,13,18,16,17,33,0.000333,0.045869,2,275.21505,15.289725,137.607525,59.715357,1,0
0,0,7,7,11,18,29,48,28,76,0.000333,0.123069,5,1846.032778,102.557377,369.206556,113.112398,1,0
0,0,7,7,11,19,30,44,28,72,0.000333,0.117765,5,1766.480614,98.137812,353.296123,118.764371,2,0
0,0,9,9,15,19,34,68,35,103,0.000333,0.17467,7,3668.060709,203.78115,524.008673,139.313982,2,0
0,0,4,4,6,8,14,17,12,29,0.000333,0.036804,3,331.239878,18.402215,110.413293,39.509775,3,0
0,0,4,4,5,9,14,15,13,28,0.000333,0.035535,2,213.211876,11.845104,106.605938,40.138965,1,0
0,0,5,5,8,10,18,28,17,45,0.000333,0.062549,4,750.5865,41.69925,187.646625,57.219281,1,0
0,0,4,4,8,7,15,16,12,28,0.000333,0.036464,4,437.571747,24.309541,109.392937,43.651484,1,0
0,0,9,9,14,25,39,156,54,210,0.000333,0.369978,14,15539.08252,863.282362,1109.934466,169.399374,5,0
0,0,3,3,9,8,17,16,11,27,0.000333,0.036787,4,441.445987,24.524777,110.361497,52.529325,2,0
0,0,9,9,8,17,25,42,35,77,0.000333,0.119192,8,2860.615413,158.923078,357.576927,93.486868,1,0
0,0,7,7,11,19,30,44,28,72,0.000333,0.117765,5,1766.480614,98.137812,353.296123,118.764371,2,0
0,0,4,4,9,7,16,17,12,29,0.000333,0.038667,4,464,25.777778,116,48.180809,1,0
0,0,3,3,5,6,11,9,8,17,0.000333,0.019603,2,117.620675,6.534482,58.810338,27.119415,1,0
0,0,4,4,5,10,15,13,13,26,0.000333,0.03386,2,203.158311,11.286573,101.579155,44.828921,1,0
0,0,61,61,28,89,117,610,409,1019,0.000333,2.333634,56,392050.4924,21780.58291,7000.901649,710.946213,35,0
0,0,11,11,15,21,36,84,43,127,0.000333,0.21886,14,9192.126653,510.673703,656.580475,150.842025,2,0
0,0,9,9,15,19,34,68,35,103,0.000333,0.17467,7,3668.060709,203.78115,524.008673,139.313982,2,0
0,0,7,7,11,19,30,44,28,72,0.000333,0.117765,5,1766.480614,98.137812,353.296123,118.764371,2,0
0,0,3,3,9,6,15,16,10,26,0.000333,0.03386,4,406.316622,22.573146,101.579155,44.0391,1,0
0,0,15,15,12,22,34,99,56,155,0.000333,0.262852,12,9462.680885,525.704494,788.55674,141.127046,2,0
0,0,4,4,9,8,17,20,12,32,0.000333,0.0436,4,523.195244,29.066402,130.798811,52.529325,1,0
0,0,6,6,5,14,19,20,30,50,0.000333,0.070799,4,849.585503,47.199195,212.396376,64.912609,1,0
0,0,3,3,10,7,17,22,12,34,0.000333,0.046325,5,694.868683,38.603816,138.973737,52.870765,1,0
0,0,8,8,11,15,26,59,34,93,0.000333,0.145714,10,4371.408938,242.856052,437.140894,96.657107,1,0
0,0,4,4,9,8,17,21,14,35,0.000333,0.047687,4,572.244798,31.791378,143.061199,52.529325,1,0
0,0,3,3,7,5,12,11,7,18,0.000333,0.02151,3,193.587975,10.754888,64.529325,31.261125,1,0
0,0,3,3,14,14,28,29,19,48,0.000333,0.076918,7,1615.271254,89.737292,230.753036,106.605938,2,0
0,0,4,4,6,8,14,17,12,29,0.000333,0.036804,3,331.239878,18.402215,110.413293,39.509775,3,0
0,0,3,3,9,8,17,16,11,27,0.000333,0.036787,4,441.445987,24.524777,110.361497,52.529325,2,0
0,0,3,3,8,7,15,20,12,32,0.000333,0.041673,4,500.081996,27.782333,125.020499,43.651484,1,0
0,0,36,36,16,62,78,272,185,457,0.000333,0.957476,16,45958.86102,2553.270057,2872.428814,433.160171,4,0
0,0,3,3,7,8,15,23,12,35,0.000333,0.04558,3,410.223513,22.790195,136.741171,43.651484,1,0
0,0,8,8,15,18,33,66,34,100,0.000333,0.168146,7,3531.075884,196.170882,504.439412,133.662009,2,0
0,0,3,3,9,8,17,16,11,27,0.000333,0.036787,4,441.445987,24.524777,110.361497,52.529325,2,0
0,0,6,6,9,10,19,28,17,45,0.000333,0.063719,4,764.626952,42.479275,191.156738,61.748606,1,0
0,0,3,3,9,8,17,16,11,27,0.000333,0.036787,4,441.445987,24.524777,110.361497,52.529325,2,0
0,0,14,14,11,23,34,85,48,133,0.000333,0.225544,10,6766.325579,375.906977,676.632558,142.095673,1,0
0,0,3,3,7,8,15,23,12,35,0.000333,0.04558,3,410.223513,22.790195,136.741171,43.651484,1,0
0,0,3,3,9,7,16,19,11,30,0.000333,0.04,4,480,26.666667,120,48.180809,1,0
0,0,5,5,8,9,17,84,15,99,0.000333,0.134886,4,1618.635285,89.924183,404.658821,52.529325,1,0
0,0,9,9,15,19,34,68,35,103,0.000333,0.17467,7,3668.060709,203.78115,524.008673,139.313982,2,0
0,0,8,8,15,18,33,66,34,100,0.000333,0.168146,7,3531.075884,196.170882,504.439412,133.662009,2,0
0,0,11,11,15,21,36,84,43,127,0.000333,0.21886,14,9192.126653,510.673703,656.580475,150.842025,2,0
0,0,5,5,8,8,16,19,12,31,0.000333,0.041333,4,496,27.555556,124,48,1,0
0,0,5,5,8,14,22,28,29,57,0.000333,0.084729,8,2033.500818,112.972268,254.187602,77.302969,1,0
0,0,10,10,13,13,26,49,36,85,0.000333,0.133179,12,4794.448513,266.358251,399.537376,96.211433,1,0
0,0,4,4,6,9,15,14,12,26,0.000333,0.03386,3,304.737466,16.929859,101.579155,44.0391,1,0
0,0,4,4,11,9,20,20,18,38,0.000333,0.054744,10,1642.332676,91.240704,164.233268,66.583073,1,0
0,0,6,6,6,13,19,27,21,48,0.000333,0.067967,3,611.701562,33.98342,203.900521,63.615491,1,0
0,0,5,5,7,7,14,16,11,27,0.000333,0.034266,3,308.395749,17.133097,102.798583,39.302969,1,0
0,0,5,5,10,12,22,26,19,45,0.000333,0.066891,5,1003.372114,55.742895,200.674423,76.238831,1,0
0,0,6,6,10,13,23,38,25,63,0.000333,0.094995,5,1424.922016,79.162334,284.984403,81.324997,1,0
0,0,7,7,10,14,24,40,27,67,0.000333,0.102397,5,1535.962438,85.331247,307.192488,86.52225,1,0
0,0,7,7,11,19,30,44,28,72,0.000333,0.117765,5,1766.480614,98.137812,353.296123,118.764371,2,0
0,0,3,3,7,8,15,23,12,35,0.000333,0.04558,3,410.223513,22.790195,136.741171,43.651484,1,0
0,0,7,7,8,16,24,30,28,58,0.000333,0.088643,4,1063.7113,59.095072,265.927825,88,1,0
0,0,8,8,10,11,21,46,27,73,0.000333,0.10688,10,3206.391719,178.132873,320.639172,71.273029,6,0
0,0,9,9,16,24,40,75,54,129,0.000333,0.228843,16,10984.45959,610.247755,686.528724,174.0391,2,0
0,0,9,9,15,19,34,68,35,103,0.000333,0.17467,7,3668.060709,203.78115,524.008673,139.313982,2,0
0,0,11,11,15,21,36,84,43,127,0.000333,0.21886,14,9192.126653,510.673703,656.580475,150.842025,2,0
0,0,4,4,4,7,11,13,11,24,0.000333,0.027675,2,166.052718,9.225151,83.026359,27.651484,3,0
0,0,4,4,12,11,23,24,15,39,0.000333,0.058806,6,1058.513498,58.806305,176.418916,81.073298,4,0
0,0,3,3,7,5,12,11,7,18,0.000333,0.02151,3,193.587975,10.754888,64.529325,31.261125,1,0
0,0,5,5,7,8,15,20,15,35,0.000333,0.04558,3,410.223513,22.790195,136.741171,43.651484,1,0
0,0,8,8,16,19,35,72,39,111,0.000333,0.189783,16,9109.606638,506.089258,569.350415,144.710623,10,0
0,0,3,3,8,7,15,20,12,32,0.000333,0.041673,4,500.081996,27.782333,125.020499,43.651484,1,0
0,0,7,7,11,19,30,44,28,72,0.000333,0.117765,5,1766.480614,98.137812,353.296123,118.764371,2,0
0,0,12,12,12,21,33,85,61,146,0.000333,0.245494,12,8837.778497,490.987694,736.481541,135.258216,1,0
0,0,5,5,8,10,18,28,17,45,0.000333,0.062549,4,750.5865,41.69925,187.646625,57.219281,1,0
0,0,5,5,8,11,19,36,19,55,0.000333,0.077879,4,934.544053,51.919114,233.636013,62.053748,1,0
0,0,4,4,7,8,15,19,14,33,0.000333,0.042976,3,386.782169,21.487898,128.92739,43.651484,1,0
0,0,6,6,16,9,25,46,18,64,0.000333,0.099069,16,4755.308738,264.183819,297.206796,92.529325,2,0
0,0,9,9,15,19,34,68,35,103,0.000333,0.17467,7,3668.060709,203.78115,524.008673,139.313982,2,0
0,0,3,3,7,8,15,23,12,35,0.000333,0.04558,3,410.223513,22.790195,136.741171,43.651484,1,0
0,0,4,4,4,7,11,13,11,24,0.000333,0.027675,2,166.052718,9.225151,83.026359,27.651484,3,0
0,0,3,3,8,8,16,20,12,32,0.000333,0.042667,4,512,28.444444,128,48,1,0
0,0,13,13,10,14,24,73,48,121,0.000333,0.184927,15,8321.706939,462.317052,554.780463,86.52225,1,0
0,0,7,7,8,10,18,31,20,51,0.000333,0.070889,8,1701.329401,94.5183,212.666175,57.219281,3,0
0,0,5,5,9,10,19,29,21,50,0.000333,0.070799,8,1699.171005,94.398389,212.396376,61.748606,1,0
0,0,4,4,9,7,16,16,11,27,0.000333,0.036,4,432,24,108,48.180809,1,0
0,0,3,3,7,8,15,23,12,35,0.000333,0.04558,3,410.223513,22.790195,136.741171,43.651484,1,0
0,0,6,6,7,13,20,35,24,59,0.000333,0.084998,3,764.981273,42.49896,254.993758,67.757201,1,0
0,0,3,3,7,8,15,23,12,35,0.000333,0.04558,3,410.223513,22.790195,136.741171,43.651484,1,0
0,0,6,6,9,15,24,24,26,50,0.000333,0.076416,4,916.9925,50.944028,229.248125,87.132684,1,0
0,0,5,5,8,10,18,26,15,41,0.000333,0.056989,4,683.8677,37.99265,170.966925,57.219281,1,0
0,0,5,5,8,11,19,30,18,48,0.000333,0.067967,4,815.602083,45.311227,203.900521,62.053748,1,0
0,0,7,7,6,9,15,37,23,60,0.000333,0.078138,6,1406.480614,78.137812,234.413436,44.0391,1,0
0,0,4,4,6,8,14,17,12,29,0.000333,0.036804,3,331.239878,18.402215,110.413293,39.509775,3,0
0,0,7,7,11,19,30,44,28,72,0.000333,0.117765,5,1766.480614,98.137812,353.296123,118.764371,2,0
0,0,4,4,8,10,18,34,17,51,0.000333,0.070889,4,850.6647,47.25915,212.666175,57.219281,1,0
0,0,9,9,10,11,21,31,28,59,0.000333,0.086382,10,2591.467279,143.970404,259.146728,71.273029,1,0
0,0,6,6,7,13,20,35,24,59,0.000333,0.084998,3,764.981273,42.49896,254.993758,67.757201,1,0
0,0,4,4,7,11,18,24,17,41,0.000333,0.056989,3,512.900775,28.494488,170.966925,57.705232,1,0
0,0,5,5,8,10,18,28,17,45,0.000333,0.062549,4,750.5865,41.69925,187.646625,57.219281,1,0
0,0,6,6,14,12,26,43,26,69,0.000333,0.10811,14,4540.624768,252.256932,324.330341,96.322519,4,0
0,0,4,4,10,15,25,32,21,53,0.000333,0.082041,5,1230.62189,68.367883,246.124378,91.82264,1,0
0,0,8,8,15,18,33,66,34,100,0.000333,0.168146,7,3531.075884,196.170882,504.439412,133.662009,2,0
0,0,11,11,13,17,30,60,47,107,0.000333,0.175012,12,6300.447525,350.024862,525.037294,117.592585,1,0
0,0,3,3,7,5,12,11,7,18,0.000333,0.02151,3,193.587975,10.754888,64.529325,31.261125,1,0
0,0,3,3,7,8,15,23,12,35,0.000333,0.04558,3,410.223513,22.790195,136.741171,43.651484,1,0
0,0,8,8,8,11,19,31,24,55,0.000333,0.077879,8,1869.088106,103.838228,233.636013,62.053748,1,0
0,0,7,7,14,15,29,42,31,73,0.000333,0.118211,14,4964.856577,275.825365,354.632613,111.906328,4,0
0,0,5,5,8,10,18,28,17,45,0.000333,0.062549,4,750.5865,41.69925,187.646625,57.219281,1,0
0,0,4,4,8,10,18,28,16,44,0.000333,0.061159,4,733.9068,40.7726,183.4767,57.219281,1,0
0,0,3,3,8,8,16,20,12,32,0.000333,0.042667,4,512,28.444444,128,48,1,0
0,0,3,3,8,6,14,11,9,20,0.000333,0.025382,4,304.588394,16.921577,76.147098,39.509775,1,0
0,0,3,3,6,6,12,20,9,29,0.000333,0.034655,3,311.891738,17.327319,103.963913,31.01955,1,0
0,0,3,3,6,7,13,13,9,22,0.000333,0.027137,3,244.229021,13.568279,81.409674,35.161259,1,0
0,0,5,5,9,11,20,29,23,52,0.000333,0.074913,8,1797.922087,99.88456,224.740261,66.583073,1,0
0,0,4,4,7,10,17,21,15,36,0.000333,0.04905,3,441.445987,24.524777,147.148662,52.870765,1,0
0,0,9,9,15,19,34,68,35,103,0.000333,0.17467,7,3668.060709,203.78115,524.008673,139.313982,2,0
0,0,3,3,8,7,15,11,9,20,0.000333,0.026046,4,312.551248,17.363958,78.137812,43.651484,1,0
0,0,8,8,15,18,33,66,34,100,0.000333,0.168146,7,3531.075884,196.170882,504.439412,133.662009,2,0
0,0,11,11,15,21,36,84,43,127,0.000333,0.21886,14,9192.126653,510.673703,656.580475,150.842025,2,0
0,0,3,3,8,6,14,11,9,20,0.000333,0.025382,4,304.588394,16.921577,76.147098,39.509775,1,0
0,0,5,5,12,16,28,39,25,64,0.000333,0.102557,6,1846.02429,102.556905,307.670715,107.01955,2,0
0,0,4,4,4,7,11,13,11,24,0.000333,0.027675,2,166.052718,9.225151,83.026359,27.651484,3,0
0,0,5,5,8,10,18,28,17,45,0.000333,0.062549,4,750.5865,41.69925,187.646625,57.219281,1,0
0,0,19,19,9,22,31,125,69,194,0.000333,0.320371,12,11533.36901,640.742723,961.114084,126.636821,31,0
0,0,3,3,7,5,12,11,7,18,0.000333,0.02151,3,193.587975,10.754888,64.529325,31.261125,1,0
0,0,7,7,11,17,28,38,31,69,0.000333,0.110569,5,1658.537448,92.140969,331.70749,107.540616,5,0
0,0,16,16,11,26,37,114,60,174,0.000333,0.302148,10,9064.448856,503.580492,906.444886,160.26518,1,0
0,0,9,9,12,14,26,44,34,78,0.000333,0.122211,12,4399.611576,244.422865,366.634298,96.322519,1,0
0,0,3,3,8,8,16,20,12,32,0.000333,0.042667,4,512,28.444444,128,48,1,0
0,0,12,12,14,20,34,53,42,95,0.000333,0.161103,14,6766.325579,375.906977,483.30897,139.741531,2,0
0,0,3,3,7,6,13,9,8,17,0.000333,0.020969,3,188.722426,10.484579,62.907475,35.161259,1,0
0,0,5,5,10,14,24,27,22,49,0.000333,0.074888,5,1123.315813,62.406434,224.663163,86.52225,3,0
0,0,5,5,11,11,22,31,17,48,0.000333,0.071351,5,1070.263588,59.459088,214.052718,76.107496,1,0
0,0,6,6,9,10,19,28,17,45,0.000333,0.063719,4,764.626952,42.479275,191.156738,61.748606,1,0
0,0,4,4,4,7,11,13,11,24,0.000333,0.027675,2,166.052718,9.225151,83.026359,27.651484,3,0
0,0,4,4,8,9,17,15,13,28,0.000333,0.03815,4,457.795838,25.433102,114.44896,52.529325,1,0
0,0,3,3,7,5,12,11,7,18,0.000333,0.02151,3,193.587975,10.754888,64.529325,31.261125,1,0
0,0,6,6,8,10,18,25,21,46,0.000333,0.063939,8,1534.532401,85.2518,191.81655,57.219281,1,0
0,0,7,7,10,14,24,40,27,67,0.000333,0.102397,5,1535.962438,85.331247,307.192488,86.52225,1,0
0,0,5,5,8,8,16,20,14,34,0.000333,0.045333,4,544,30.222222,136,48,1,0
0,0,3,3,11,11,22,26,15,41,0.000333,0.060946,5,914.183482,50.787971,182.836696,76.107496,3,0
0,0,5,5,8,11,19,36,19,55,0.000333,0.077879,4,934.544053,51.919114,233.636013,62.053748,1,0
0,0,3,3,8,6,14,11,9,20,0.000333,0.025382,4,304.588394,16.921577,76.147098,39.509775,1,0
0,0,4,4,10,7,17,25,15,40,0.000333,0.0545,10,1634.985137,90.832508,163.498514,52.870765,1,0
0,0,4,4,4,7,11,13,11,24,0.000333,0.027675,2,166.052718,9.225151,83.026359,27.651484,3,0
0,0,7,7,10,14,24,40,27,67,0.000333,0.102397,5,1535.962438,85.331247,307.192488,86.52225,1,0
0,0,9,9,15,19,34,68,35,103,0.000333,0.17467,7,3668.060709,203.78115,524.008673,139.313982,2,0
0,0,11,11,15,21,36,84,43,127,0.000333,0.21886,14,9192.126653,510.673703,656.580475,150.842025,2,0
0,0,8,8,15,18,33,66,34,100,0.000333,0.168146,7,3531.075884,196.170882,504.439412,133.662009,2,0
0,0,6,6,5,14,19,22,31,53,0.000333,0.075047,4,900.560633,50.031146,225.140158,64.912609,1,0
0,0,5,5,10,12,22,21,17,38,0.000333,0.056486,5,847.292008,47.071778,169.458402,76.238831,1,0
0,0,3,3,7,8,15,23,12,35,0.000333,0.04558,3,410.223513,22.790195,136.741171,43.651484,1,0
0,0,9,9,15,19,34,68,35,103,0.000333,0.17467,7,3668.060709,203.78115,524.008673,139.313982,2,0
0,0,7,7,17,14,31,46,29,75,0.000333,0.123855,16,5945.035572,330.279754,371.564723,122.789837,4,0
0,0,3,3,8,7,15,11,9,20,0.000333,0.026046,4,312.551248,17.363958,78.137812,43.651484,1,0
0,0,4,4,12,8,20,23,11,34,0.000333,0.048982,6,881.673331,48.981852,146.945555,67.01955,4,0
0,0,4,4,4,7,11,13,11,24,0.000333,0.027675,2,166.052718,9.225151,83.026359,27.651484,3,0
0,0,3,3,9,8,17,16,10,26,0.000333,0.035425,4,425.096135,23.616452,106.274034,52.529325,3,0
0,0,9,9,15,20,35,72,36,108,0.000333,0.184654,7,3877.737961,215.429887,553.962566,145.041921,2,0
0,0,9,9,15,19,34,68,35,103,0.000333,0.17467,7,3668.060709,203.78115,524.008673,139.313982,2,0
0,0,3,3,7,5,12,11,7,18,0.000333,0.02151,3,193.587975,10.754888,64.529325,31.261125,1,0
0,0,4,4,5,8,13,23,14,37,0.000333,0.045639,2,273.832539,15.212919,136.91627,35.60964,1,0
0,0,3,3,7,8,15,23,12,35,0.000333,0.04558,3,410.223513,22.790195,136.741171,43.651484,1,0
0,0,9,9,15,19,34,68,35,103,0.000333,0.17467,7,3668.060709,203.78115,524.008673,139.313982,2,0
0,0,4,4,4,7,11,13,11,24,0.000333,0.027675,2,166.052718,9.225151,83.026359,27.651484,3,0
0,0,3,3,7,8,15,23,12,35,0.000333,0.04558,3,410.223513,22.790195,136.741171,43.651484,1,0
0,0,5,5,8,10,18,28,17,45,0.000333,0.062549,4,750.5865,41.69925,187.646625,57.219281,1,0
0,0,5,5,8,11,19,25,18,43,0.000333,0.060887,4,730.643532,40.591307,182.660883,62.053748,1,0
0,0,5,5,12,13,25,28,18,46,0.000333,0.071206,6,1281.704308,71.205795,213.617385,91.125266,3,0
0,0,4,4,4,7,11,13,11,24,0.000333,0.027675,2,166.052718,9.225151,83.026359,27.651484,3,0
0,0,5,5,10,7,17,20,16,36,0.000333,0.04905,10,1471.486623,81.749257,147.148662,52.870765,1,0
0,0,3,3,7,5,12,11,7,18,0.000333,0.02151,3,193.587975,10.754888,64.529325,31.261125,1,0
0,0,3,3,8,11,19,21,17,38,0.000333,0.053807,4,645.684982,35.871388,161.421246,62.053748,1,0
0,0,5,5,8,13,21,32,24,56,0.000333,0.08199,4,983.879103,54.65995,245.969776,72.105716,1,0
0,0,8,8,15,18,33,66,34,100,0.000333,0.168146,7,3531.075884,196.170882,504.439412,133.662009,2,0
0,0,8,8,15,18,33,66,34,100,0.000333,0.168146,7,3531.075884,196.170882,504.439412,133.662009,2,0
0,0,9,9,15,19,34,68,35,103,0.000333,0.17467,7,3668.060709,203.78115,524.008673,139.313982,2,0
0,0,8,8,12,15,27,42,27,69,0.000333,0.109362,6,1968.523426,109.362413,328.087238,101.622909,2,0
0,0,11,11,15,21,36,84,43,127,0.000333,0.21886,14,9192.126653,510.673703,656.580475,150.842025,2,0
0,0,4,4,5,7,12,14,10,24,0.000333,0.02868,2,172.0782,9.5599,86.0391,31.261125,2,0
0,0,3,3,7,8,15,23,12,35,0.000333,0.04558,3,410.223513,22.790195,136.741171,43.651484,1,0
0,0,7,7,11,19,30,44,28,72,0.000333,0.117765,5,1766.480614,98.137812,353.296123,118.764371,2,0
0,0,8,8,16,16,32,49,33,82,0.000333,0.136667,16,6560,364.444444,410,128,4,0
0,0,4,4,4,7,11,13,11,24,0.000333,0.027675,2,166.052718,9.225151,83.026359,27.651484,3,0
0,0,4,4,6,8,14,17,12,29,0.000333,0.036804,3,331.239878,18.402215,110.413293,39.509775,3,0
0,0,4,4,9,13,22,22,17,39,0.000333,0.057973,4,695.671333,38.648407,173.917833,76.635041,3,0
0,0,54,54,28,89,117,539,373,912,0.000333,2.088591,56,350883.267,19493.51483,6265.772624,710.946213,33,0
0,0,9,9,15,19,34,68,35,103,0.000333,0.17467,7,3668.060709,203.78115,524.008673,139.313982,2,0
0,0,4,4,8,11,19,27,17,44,0.000333,0.062303,4,747.635242,41.535291,186.908811,62.053748,1,0
0,0,5,5,10,11,21,33,18,51,0.000333,0.074669,5,1120.040943,62.224497,224.008189,71.273029,1,0
0,0,5,5,7,15,22,31,26,57,0.000333,0.084729,3,762.562807,42.3646,254.187602,78.254843,1,0
0,0,4,4,8,8,16,18,12,30,0.000333,0.04,4,480,26.666667,120,48,1,0
0,0,3,3,9,8,17,16,11,27,0.000333,0.036787,4,441.445987,24.524777,110.361497,52.529325,2,0
0,0,3,3,9,8,17,16,11,27,0.000333,0.036787,4,441.445987,24.524777,110.361497,52.529325,2,0
0,0,11,11,13,21,34,91,48,139,0.000333,0.235719,12,8485.888019,471.438223,707.157335,140.344382,5,0
0,0,3,3,9,8,17,16,11,27,0.000333,0.036787,4,441.445987,24.524777,110.361497,52.529325,2,0
0,0,5,5,8,11,19,30,18,48,0.000333,0.067967,4,815.602083,45.311227,203.900521,62.053748,1,0
0,0,6,6,5,14,19,22,31,53,0.000333,0.075047,4,900.560633,50.031146,225.140158,64.912609,1,0
0,0,9,9,12,14,26,48,35,83,0.000333,0.130045,12,4681.637959,260.090998,390.136497,96.322519,1,0
0,0,6,6,6,14,20,30,23,53,0.000333,0.076354,3,687.186567,38.177032,229.062189,68.812744,1,0
0,0,10,10,14,18,32,51,39,90,0.000333,0.15,14,6300,350,450,128.361619,2,0
0,0,6,6,13,11,24,44,20,64,0.000333,0.097813,6,1760.6256,97.812533,293.4376,86.159464,5,0
0,0,10,10,8,16,24,59,34,93,0.000333,0.142134,8,3411.212101,189.511783,426.401513,88,3,0
0,0,3,3,8,6,14,11,9,20,0.000333,0.025382,4,304.588394,16.921577,76.147098,39.509775,1,0
0,0,4,4,10,8,18,25,15,40,0.000333,0.055599,5,833.985,46.3325,166.797,57.219281,1,0
0,0,8,8,12,11,23,36,31,67,0.000333,0.101026,12,3636.943813,202.052434,303.078651,81.073298,1,0
0,0,3,3,7,8,15,23,12,35,0.000333,0.04558,3,410.223513,22.790195,136.741171,43.651484,1,0
0,0,3,3,7,5,12,11,7,18,0.000333,0.02151,3,193.587975,10.754888,64.529325,31.261125,1,0
0,0,3,3,8,7,15,20,12,32,0.000333,0.041673,4,500.081996,27.782333,125.020499,43.651484,1,0
0,0,3,3,8,7,15,11,9,20,0.000333,0.026046,4,312.551248,17.363958,78.137812,43.651484,1,0
0,0,4,4,5,13,18,16,17,33,0.000333,0.045869,2,275.21505,15.289725,137.607525,59.715357,1,0
0,0,6,6,14,11,25,38,23,61,0.000333,0.094425,14,3965.853186,220.325177,283.275228,91.356717,4,0
0,0,4,4,4,7,11,13,11,24,0.000333,0.027675,2,166.052718,9.225151,83.026359,27.651484,3,0
0,0,8,8,15,18,33,66,34,100,0.000333,0.168146,7,3531.075884,196.170882,504.439412,133.662009,2,0
0,0,11,11,15,21,36,84,43,127,0.000333,0.21886,14,9192.126653,510.673703,656.580475,150.842025,2,0
0,0,9,9,15,19,34,68,35,103,0.000333,0.17467,7,3668.060709,203.78115,524.008673,139.313982,2,0
0,0,4,4,5,10,15,13,13,26,0.000333,0.03386,2,203.158311,11.286573,101.579155,44.828921,1,0
0,0,16,16,19,22,41,97,56,153,0.000333,0.273235,18,14754.69822,819.705457,819.705457,178.818118,6,0
0,0,5,5,10,11,21,33,18,51,0.000333,0.074669,5,1120.040943,62.224497,224.008189,71.273029,1,0
0,0,11,11,15,21,36,84,43,127,0.000333,0.21886,14,9192.126653,510.673703,656.580475,150.842025,2,0
0,0,3,3,11,11,22,26,15,41,0.000333,0.060946,5,914.183482,50.787971,182.836696,76.107496,3,0
0,0,6,6,14,12,26,43,26,69,0.000333,0.10811,14,4540.624768,252.256932,324.330341,96.322519,4,0
0,0,5,5,10,10,20,20,20,40,0.000333,0.057626,10,1728.771238,96.042847,172.877124,66.438562,1,0
0,0,5,5,8,11,19,30,18,48,0.000333,0.067967,4,815.602083,45.311227,203.900521,62.053748,1,0
0,0,22,22,13,29,42,139,80,219,0.000333,0.393639,12,14171.01019,787.278344,1180.917516,188.987165,2,0
0,0,5,5,8,11,19,36,19,55,0.000333,0.077879,4,934.544053,51.919114,233.636013,62.053748,1,0
0,0,5,5,8,11,19,30,18,48,0.000333,0.067967,4,815.602083,45.311227,203.900521,62.053748,1,0
0,0,5,5,11,12,23,31,19,50,0.000333,0.075393,5,1130.890489,62.827249,226.178098,81.073298,2,0
0,0,8,8,15,18,33,66,34,100,0.000333,0.168146,7,3531.075884,196.170882,504.439412,133.662009,2,0
0,0,4,4,5,12,17,16,16,32,0.000333,0.0436,2,261.597622,14.533201,130.798811,54.62919,1,0
0,0,3,3,7,8,15,23,12,35,0.000333,0.04558,3,410.223513,22.790195,136.741171,43.651484,1,0
0,0,5,5,8,10,18,28,17,45,0.000333,0.062549,4,750.5865,41.69925,187.646625,57.219281,1,0
0,0,6,6,7,16,23,36,29,65,0.000333,0.098011,3,882.094581,49.005255,294.031527,83.651484,1,0
0,0,5,5,8,10,18,28,17,45,0.000333,0.062549,4,750.5865,41.69925,187.646625,57.219281,1,0
0,0,4,4,10,15,25,32,21,53,0.000333,0.082041,5,1230.62189,68.367883,246.124378,91.82264,1,0
0,0,7,7,11,19,30,44,28,72,0.000333,0.117765,5,1766.480614,98.137812,353.296123,118.764371,2,0
0,0,7,7,9,13,22,31,22,53,0.000333,0.078783,4,945.399503,52.522195,236.349876,76.635041,1,0
0,0,6,6,13,11,24,38,23,61,0.000333,0.093228,12,3356.192551,186.455142,279.682713,86.159464,4,0
0,0,5,5,7,7,14,16,11,27,0.000333,0.034266,3,308.395749,17.133097,102.798583,39.302969,1,0
0,0,4,4,10,8,18,25,15,40,0.000333,0.055599,5,833.985,46.3325,166.797,57.219281,1,0
0,0,5,5,7,7,14,16,11,27,0.000333,0.034266,3,308.395749,17.133097,102.798583,39.302969,1,0
0,0,3,3,9,8,17,16,11,27,0.000333,0.036787,4,441.445987,24.524777,110.361497,52.529325,2,0
0,0,16,16,11,24,35,97,52,149,0.000333,0.254754,10,7642.631695,424.59065,764.26317,148.092848,1,0
0,0,4,4,5,7,12,23,14,37,0.000333,0.044215,4,530.57445,29.476358,132.643613,31.261125,1,0
0,0,6,6,10,13,23,38,25,63,0.000333,0.094995,5,1424.922016,79.162334,284.984403,81.324997,1,0
0,0,6,6,8,15,23,30,27,57,0.000333,0.085948,4,1031.372126,57.298451,257.843031,82.603359,1,0
0,0,7,7,11,19,30,44,28,72,0.000333,0.117765,5,1766.480614,98.137812,353.296123,118.764371,2,0
0,0,3,3,8,8,16,20,12,32,0.000333,0.042667,4,512,28.444444,128,48,1,0
0,0,8,8,10,11,21,31,27,58,0.000333,0.084918,10,2547.544105,141.530228,254.754411,71.273029,1,0
0,0,4,4,4,7,11,13,11,24,0.000333,0.027675,2,166.052718,9.225151,83.026359,27.651484,2,0
0,0,7,7,7,8,15,29,19,48,0.000333,0.06251,6,1125.184492,62.51025,187.530749,43.651484,3,0
0,0,8,8,16,17,33,49,35,84,0.000333,0.141243,16,6779.665696,376.648094,423.729106,133.486868,4,0
0,0,5,5,7,8,15,17,12,29,0.000333,0.037767,3,339.899482,18.883305,113.299827,43.651484,1,0
0,0,5,5,8,9,17,23,16,39,0.000333,0.053137,4,637.644203,35.424678,159.411051,52.529325,1,0
0,0,5,5,11,13,24,24,19,43,0.000333,0.065718,5,985.766938,54.76483,197.153388,86.159464,1,0
0,0,6,6,8,12,20,21,18,39,0.000333,0.056185,4,674.220783,37.45671,168.555196,67.01955,1,0
0,0,3,3,8,7,15,11,9,20,0.000333,0.026046,4,312.551248,17.363958,78.137812,43.651484,1,0
0,0,9,9,8,14,22,51,37,88,0.000333,0.13081,8,3139.43986,174.413326,392.429982,77.302969,1,0
0,0,7,7,14,17,31,42,35,77,0.000333,0.127158,14,5340.623623,296.701312,381.473116,122.789837,4,0
0,0,5,5,11,11,22,31,17,48,0.000333,0.071351,5,1070.263588,59.459088,214.052718,76.107496,1,0
0,0,10,10,7,14,21,57,36,93,0.000333,0.136162,6,2450.913122,136.16184,408.48552,72.954453,1,0
0,0,4,4,10,8,18,25,15,40,0.000333,0.055599,5,833.985,46.3325,166.797,57.219281,1,0
0,0,5,5,10,13,23,22,18,40,0.000333,0.060314,5,904.712391,50.2618,180.942478,81.324997,1,0
0,0,4,4,4,7,11,13,11,24,0.000333,0.027675,2,166.052718,9.225151,83.026359,27.651484,3,0
0,0,7,7,11,19,30,44,28,72,0.000333,0.117765,5,1766.480614,98.137812,353.296123,118.764371,2,0
0,0,8,8,15,18,33,66,34,100,0.000333,0.168146,7,3531.075884,196.170882,504.439412,133.662009,2,0
0,0,11,11,15,21,36,84,43,127,0.000333,0.21886,14,9192.126653,510.673703,656.580475,150.842025,2,0
0,0,8,8,15,18,33,66,34,100,0.000333,0.168146,7,3531.075884,196.170882,504.439412,133.662009,2,0
0,0,9,9,15,19,34,68,35,103,0.000333,0.17467,7,3668.060709,203.78115,524.008673,139.313982,2,0
0,0,4,4,11,12,23,20,16,36,0.000333,0.054283,5,814.241152,45.23562,162.84823,81.073298,1,0
0,0,5,5,8,11,19,30,18,48,0.000333,0.067967,4,815.602083,45.311227,203.900521,62.053748,1,0
0,0,3,3,5,6,11,9,8,17,0.000333,0.019603,2,117.620675,6.534482,58.810338,27.119415,1,0
0,0,5,5,11,12,23,33,21,54,0.000333,0.081424,5,1221.361728,67.853429,244.272346,81.073298,1,0
0,0,6,6,8,12,20,23,20,43,0.000333,0.061948,4,743.371632,41.298424,185.842908,67.01955,3,0
0,0,6,6,7,11,18,41,25,66,0.000333,0.091738,6,1651.290301,91.73835,275.21505,57.705232,1,0
0,0,3,3,7,14,21,20,20,40,0.000333,0.058564,3,527.078091,29.282116,175.692697,72.954453,1,0
0,0,3,3,9,8,17,16,11,27,0.000333,0.036787,4,441.445987,24.524777,110.361497,52.529325,2,0
0,0,6,6,5,12,17,19,26,45,0.000333,0.061312,4,735.743311,40.874628,183.935828,54.62919,1,0
0,0,5,5,8,10,18,28,17,45,0.000333,0.062549,4,750.5865,41.69925,187.646625,57.219281,1,0
0,0,5,5,7,8,15,17,12,29,0.000333,0.037767,3,339.899482,18.883305,113.299827,43.651484,1,0
0,0,7,7,11,12,23,49,24,73,0.000333,0.110073,10,3302.200228,183.455568,330.220023,81.073298,1,0
0,0,4,4,4,7,11,13,11,24,0.000333,0.027675,2,166.052718,9.225151,83.026359,27.651484,3,0
0,0,4,4,9,9,18,19,15,34,0.000333,0.047259,4,567.1098,31.5061,141.77745,57.05865,1,0
0,0,6,6,7,13,20,35,24,59,0.000333,0.084998,3,764.981273,42.49896,254.993758,67.757201,1,0
0,0,4,4,7,11,18,24,17,41,0.000333,0.056989,3,512.900775,28.494488,170.966925,57.705232,1,0
0,0,25,25,12,35,47,382,213,595,0.000333,1.10166,36,118979.2932,6609.960733,3304.980367,222.544456,4,0
0,0,5,5,11,12,23,33,21,54,0.000333,0.081424,5,1221.361728,67.853429,244.272346,81.073298,1,0
0,0,5,5,7,7,14,16,11,27,0.000333,0.034266,3,308.395749,17.133097,102.798583,39.302969,1,0
0,0,4,4,6,8,14,17,12,29,0.000333,0.036804,3,331.239878,18.402215,110.413293,39.509775,3,0
0,0,13,13,16,36,52,233,88,321,0.000333,0.609947,16,29277.45839,1626.525466,1829.84115,250.1173,14,0
0,0,3,3,8,7,15,11,9,20,0.000333,0.026046,4,312.551248,17.363958,78.137812,43.651484,1,0
0,0,4,4,4,7,11,13,11,24,0.000333,0.027675,2,166.052718,9.225151,83.026359,27.651484,3,0
0,0,3,3,8,7,15,15,9,24,0.000333,0.031255,4,375.061497,20.83675,93.765374,43.651484,3,0
0,0,3,3,5,6,11,10,8,18,0.000333,0.020757,2,124.539538,6.918863,62.269769,27.119415,1,0
0,0,5,5,8,10,18,28,17,45,0.000333,0.062549,4,750.5865,41.69925,187.646625,57.219281,1,0
0,0,5,5,7,12,19,33,22,55,0.000333,0.077879,3,700.90804,38.939336,233.636013,62.671034,1,0
0,0,3,3,8,8,16,20,12,32,0.000333,0.042667,4,512,28.444444,128,48,1,0
0,0,13,13,13,17,30,63,50,113,0.000333,0.184826,12,6653.743648,369.652425,554.478637,117.592585,1,0
0,0,9,9,15,20,35,72,36,108,0.000333,0.184654,7,3877.737961,215.429887,553.962566,145.041921,2,0
0,0,8,8,15,18,33,66,34,100,0.000333,0.168146,7,3531.075884,196.170882,504.439412,133.662009,2,0
0,0,8,8,15,18,33,66,34,100,0.000333,0.168146,7,3531.075884,196.170882,504.439412,133.662009,2,0
0,0,11,11,15,21,36,84,43,127,0.000333,0.21886,14,9192.126653,510.673703,656.580475,150.842025,2,0
0,0,9,9,15,19,34,68,35,103,0.000333,0.17467,7,3668.060709,203.78115,524.008673,139.313982,2,0
0,0,5,5,8,10,18,28,17,45,0.000333,0.062549,4,750.5865,41.69925,187.646625,57.219281,1,0
0,0,8,8,16,17,33,49,35,84,0.000333,0.141243,16,6779.665696,376.648094,423.729106,133.486868,4,0
0,0,5,5,8,10,18,28,17,45,0.000333,0.062549,4,750.5865,41.69925,187.646625,57.219281,1,0
0,0,8,8,15,18,33,66,34,100,0.000333,0.168146,7,3531.075884,196.170882,504.439412,133.662009,2,0
0,0,6,6,10,11,21,30,16,46,0.000333,0.067349,5,1010.233007,56.124056,202.046601,71.273029,3,0
0,0,5,5,10,10,20,20,20,40,0.000333,0.057626,10,1728.771238,96.042847,172.877124,66.438562,1,0
0,0,7,7,11,18,29,48,28,76,0.000333,0.123069,5,1846.032778,102.557377,369.206556,113.112398,1,0
0,0,14,14,11,23,34,85,48,133,0.000333,0.225544,10,6766.325579,375.906977,676.632558,142.095673,1,0
0,0,6,6,6,15,21,23,32,55,0.000333,0.080526,6,1449.46475,80.525819,241.577458,74.113134,1,0
0,0,5,5,8,10,18,28,17,45,0.000333,0.062549,4,750.5865,41.69925,187.646625,57.219281,1,0
0,0,8,8,9,18,27,49,37,86,0.000333,0.136307,8,3271.362601,181.742367,408.920325,103.587975,1,0
0,0,4,4,6,8,14,17,12,29,0.000333,0.036804,3,331.239878,18.402215,110.413293,39.509775,3,0
0,0,9,9,15,19,34,68,35,103,0.000333,0.17467,7,3668.060709,203.78115,524.008673,139.313982,2,0
0,0,13,13,16,36,52,233,88,321,0.000333,0.609947,16,29277.45839,1626.525466,1829.84115,250.1173,14,0
0,0,5,5,8,10,18,28,17,45,0.000333,0.062549,4,750.5865,41.69925,187.646625,57.219281,1,0
0,0,6,6,8,16,24,40,31,71,0.000333,0.108511,4,1302.12935,72.340519,325.532338,88,1,0
0,0,3,3,8,8,16,20,12,32,0.000333,0.042667,4,512,28.444444,128,48,1,0
0,0,3,3,7,8,15,23,12,35,0.000333,0.04558,3,410.223513,22.790195,136.741171,43.651484,1,0
0,0,5,5,10,10,20,26,15,41,0.000333,0.059066,5,885.995259,49.221959,177.199052,66.438562,1,0
0,0,4,4,8,8,16,18,12,30,0.000333,0.04,4,480,26.666667,120,48,1,0
0,0,3,3,7,5,12,11,7,18,0.000333,0.02151,3,193.587975,10.754888,64.529325,31.261125,1,0
0,0,7,7,11,19,30,44,28,72,0.000333,0.117765,5,1766.480614,98.137812,353.296123,118.764371,2,0
0,0,9,9,15,19,34,68,35,103,0.000333,0.17467,7,3668.060709,203.78115,524.008673,139.313982,2,0
0,0,4,4,5,7,12,14,10,24,0.000333,0.02868,2,172.0782,9.5599,86.0391,31.261125,2,0
0,0,5,5,8,13,21,20,18,38,0.000333,0.055636,4,667.632248,37.09068,166.908062,72.105716,1,0
0,0,25,25,12,19,31,159,81,240,0.000333,0.396336,24,28536.17075,1585.342819,1189.007114,123.730173,25,0
0,0,18,18,11,28,39,115,64,179,0.000333,0.315362,10,9460.869972,525.603887,946.086997,172.659686,3,0
0,0,9,9,15,19,34,68,35,103,0.000333,0.17467,7,3668.060709,203.78115,524.008673,139.313982,2,0
0,0,4,4,8,7,15,16,11,27,0.000333,0.035162,4,421.944184,23.441344,105.486046,43.651484,1,0
0,0,7,7,10,13,23,38,25,63,0.000333,0.094995,5,1424.922016,79.162334,284.984403,81.324997,1,0
0,0,3,3,9,8,17,16,11,27,0.000333,0.036787,4,441.445987,24.524777,110.361497,52.529325,2,0
0,0,3,3,7,5,12,11,7,18,0.000333,0.02151,3,193.587975,10.754888,64.529325,31.261125,1,0
0,0,3,3,9,8,17,16,11,27,0.000333,0.036787,4,441.445987,24.524777,110.361497,52.529325,2,0
0,0,7,7,11,19,30,44,28,72,0.000333,0.117765,5,1766.480614,98.137812,353.296123,118.764371,2,0
0,0,4,4,5,9,14,15,13,28,0.000333,0.035535,2,213.211876,11.845104,106.605938,40.138965,1,0
0,0,13,13,13,22,35,98,52,150,0.000333,0.256464,12,9232.709431,512.928302,769.392453,146.213212,5,0
0,0,6,6,10,10,20,24,19,43,0.000333,0.061948,5,929.21454,51.62303,185.842908,66.438562,1,0
0,0,4,4,11,10,21,24,14,38,0.000333,0.055636,5,834.54031,46.363351,166.908062,71.273029,3,0
0,0,4,4,6,8,14,17,12,29,0.000333,0.036804,3,331.239878,18.402215,110.413293,39.509775,3,0
0,0,4,4,4,7,11,13,11,24,0.000333,0.027675,2,166.052718,9.225151,83.026359,27.651484,3,0
0,0,6,6,9,10,19,28,17,45,0.000333,0.063719,4,764.626952,42.479275,191.156738,61.748606,1,0
0,0,5,5,10,11,21,29,17,46,0.000333,0.067349,5,1010.233007,56.124056,202.046601,71.273029,1,0
0,0,3,3,7,8,15,23,12,35,0.000333,0.04558,3,410.223513,22.790195,136.741171,43.651484,1,0
0,0,5,5,10,10,20,26,15,41,0.000333,0.059066,5,885.995259,49.221959,177.199052,66.438562,1,0
0,0,7,7,11,19,30,44,28,72,0.000333,0.117765,5,1766.480614,98.137812,353.296123,118.764371,2,0
0,0,6,6,8,12,20,23,20,43,0.000333,0.061948,4,743.371632,41.298424,185.842908,67.01955,3,0
0,0,4,4,4,7,11,13,11,24,0.000333,0.027675,2,166.052718,9.225151,83.026359,27.651484,3,0
0,0,3,3,7,8,15,23,12,35,0.000333,0.04558,3,410.223513,22.790195,136.741171,43.651484,1,0
0,0,10,10,16,9,25,65,27,92,0.000333,0.142412,24,10253.63447,569.646359,427.234769,92.529325,7,0
0,0,4,4,9,7,16,26,16,42,0.000333,0.056,8,1344,74.666667,168,48.180809,1,0
0,0,4,4,6,9,15,16,12,28,0.000333,0.036464,3,328.17881,18.232156,109.392937,44.0391,1,0
0,0,3,3,7,8,15,23,12,35,0.000333,0.04558,3,410.223513,22.790195,136.741171,43.651484,1,0
0,0,3,3,5,6,11,9,8,17,0.000333,0.019603,2,117.620675,6.534482,58.810338,27.119415,1,0
0,0,5,5,11,12,23,31,19,50,0.000333,0.075393,5,1130.890489,62.827249,226.178098,81.073298,2,0
0,0,5,5,10,11,21,33,18,51,0.000333,0.074669,5,1120.040943,62.224497,224.008189,71.273029,1,0
0,0,15,15,12,22,34,99,56,155,0.000333,0.262852,12,9462.680885,525.704494,788.55674,141.127046,5,0
0,0,11,11,15,21,36,84,43,127,0.000333,0.21886,14,9192.126653,510.673703,656.580475,150.842025,2,0
0,0,9,9,15,19,34,68,35,103,0.000333,0.17467,7,3668.060709,203.78115,524.008673,139.313982,2,0
0,0,4,4,8,10,18,34,17,51,0.000333,0.070889,4,850.6647,47.25915,212.666175,57.219281,1,0
0,0,3,3,9,8,17,16,11,27,0.000333,0.036787,4,441.445987,24.524777,110.361497,52.529325,2,0
0,0,7,7,11,19,30,44,28,72,0.000333,0.117765,5,1766.480614,98.137812,353.296123,118.764371,2,0
0,0,5,5,12,13,25,28,19,47,0.000333,0.072754,6,1309.567446,72.753747,218.261241,91.125266,1,0
0,0,8,8,15,18,33,66,34,100,0.000333,0.168146,7,3531.075884,196.170882,504.439412,133.662009,2,0
0,0,11,11,15,21,36,84,43,127,0.000333,0.21886,14,9192.126653,510.673703,656.580475,150.842025,2,0
0,0,6,6,14,11,25,40,23,63,0.000333,0.097521,14,4095.881159,227.548953,292.56294,91.356717,4,0
0,0,3,3,7,5,12,11,7,18,0.000333,0.02151,3,193.587975,10.754888,64.529325,31.261125,1,0
0,0,4,4,4,7,11,13,11,24,0.000333,0.027675,2,166.052718,9.225151,83.026359,27.651484,3,0
0,0,5,5,11,12,23,31,19,50,0.000333,0.075393,5,1130.890489,62.827249,226.178098,81.073298,2,0
0,0,3,3,9,9,18,14,12,26,0.000333,0.036139,4,433.6722,24.0929,108.41805,57.05865,1,0
0,0,5,5,9,10,19,29,21,50,0.000333,0.070799,8,1699.171005,94.398389,212.396376,61.748606,1,0
0,0,5,5,10,11,21,33,18,51,0.000333,0.074669,5,1120.040943,62.224497,224.008189,71.273029,1,0
0,0,9,9,15,19,34,68,35,103,0.000333,0.17467,7,3668.060709,203.78115,524.008673,139.313982,2,0
0,0,11,11,15,21,36,84,43,127,0.000333,0.21886,14,9192.126653,510.673703,656.580475,150.842025,2,0
0,0,11,11,15,21,36,84,43,127,0.000333,0.21886,14,9192.126653,510.673703,656.580475,150.842025,2,0
0,0,8,8,15,18,33,66,34,100,0.000333,0.168146,7,3531.075884,196.170882,504.439412,133.662009,2,0
0,0,8,8,15,18,33,66,34,100,0.000333,0.168146,7,3531.075884,196.170882,504.439412,133.662009,2,0
0,0,11,11,15,21,36,84,43,127,0.000333,0.21886,14,9192.126653,510.673703,656.580475,150.842025,2,0
0,0,9,9,15,19,34,68,35,103,0.000333,0.17467,7,3668.060709,203.78115,524.008673,139.313982,2,0
0,0,4,4,10,15,25,32,21,53,0.000333,0.082041,5,1230.62189,68.367883,246.124378,91.82264,1,0
0,0,6,6,10,15,25,37,28,65,0.000333,0.100617,5,1509.253262,83.847403,301.850652,91.82264,1,0
0,0,4,4,8,12,20,23,17,40,0.000333,0.057626,4,691.508495,38.417139,172.877124,67.01955,1,0
0,0,3,3,11,11,22,26,15,41,0.000333,0.060946,5,914.183482,50.787971,182.836696,76.107496,3,0
0,0,3,3,8,8,16,20,12,32,0.000333,0.042667,4,512,28.444444,128,48,1,0
0,0,5,5,12,16,28,39,25,64,0.000333,0.102557,6,1846.02429,102.556905,307.670715,107.01955,2,0
0,0,6,6,14,12,26,41,24,65,0.000333,0.101843,14,4277.400144,237.633341,305.528582,96.322519,5,0
0,0,4,4,9,7,16,17,12,29,0.000333,0.038667,4,464,25.777778,116,48.180809,1,0
0,0,5,5,14,17,31,60,30,90,0.000333,0.148626,7,3121.143676,173.396871,445.877668,122.789837,4,0
0,0,4,4,4,7,11,13,11,24,0.000333,0.027675,2,166.052718,9.225151,83.026359,27.651484,3,0
0,0,11,11,14,17,31,55,37,92,0.000333,0.151929,14,6381.004848,354.500269,455.786061,122.789837,2,0
0,0,7,7,11,19,30,44,28,72,0.000333,0.117765,5,1766.480614,98.137812,353.296123,118.764371,2,0
0,0,5,5,8,10,18,28,17,45,0.000333,0.062549,4,750.5865,41.69925,187.646625,57.219281,1,0
0,0,5,5,8,10,18,26,15,41,0.000333,0.056989,4,683.8677,37.99265,170.966925,57.219281,1,0
0,0,3,3,9,8,17,16,11,27,0.000333,0.036787,4,441.445987,24.524777,110.361497,52.529325,2,0
0,0,3,3,8,8,16,20,12,32,0.000333,0.042667,4,512,28.444444,128,48,1,0
0,0,3,3,8,6,14,11,9,20,0.000333,0.025382,4,304.588394,16.921577,76.147098,39.509775,1,0
0,0,8,8,15,18,33,66,34,100,0.000333,0.168146,7,3531.075884,196.170882,504.439412,133.662009,2,0
0,0,3,3,7,8,15,23,12,35,0.000333,0.04558,3,410.223513,22.790195,136.741171,43.651484,1,0
0,0,3,3,8,7,15,20,12,32,0.000333,0.041673,4,500.081996,27.782333,125.020499,43.651484,1,0
0,0,8,8,15,18,33,66,34,100,0.000333,0.168146,7,3531.075884,196.170882,504.439412,133.662009,2,0
0,0,11,11,15,21,36,84,43,127,0.000333,0.21886,14,9192.126653,510.673703,656.580475,150.842025,2,0
0,0,3,3,11,11,22,26,15,41,0.000333,0.060946,5,914.183482,50.787971,182.836696,76.107496,3,0
0,0,5,5,7,13,20,18,18,36,0.000333,0.051863,3,466.768234,25.931569,155.589411,67.757201,1,0
0,0,6,6,14,12,26,41,24,65,0.000333,0.101843,14,4277.400144,237.633341,305.528582,96.322519,5,0
0,0,4,4,11,10,21,36,17,53,0.000333,0.077598,5,1163.964117,64.664673,232.792823,71.273029,1,0
0,0,6,6,7,13,20,35,24,59,0.000333,0.084998,3,764.981273,42.49896,254.993758,67.757201,1,0
0,0,8,8,15,18,33,66,34,100,0.000333,0.168146,7,3531.075884,196.170882,504.439412,133.662009,2,0
0,0,11,11,15,21,36,84,43,127,0.000333,0.21886,14,9192.126653,510.673703,656.580475,150.842025,2,0
0,0,9,9,15,19,34,68,35,103,0.000333,0.17467,7,3668.060709,203.78115,524.008673,139.313982,2,0
0,0,3,3,9,8,17,16,11,27,0.000333,0.036787,4,441.445987,24.524777,110.361497,52.529325,2,0
0,0,5,5,8,10,18,28,17,45,0.000333,0.062549,4,750.5865,41.69925,187.646625,57.219281,1,0
0,0,25,25,12,35,47,382,213,595,0.000333,1.10166,36,118979.2932,6609.960733,3304.980367,222.544456,4,0
0,0,5,5,11,12,23,33,21,54,0.000333,0.081424,5,1221.361728,67.853429,244.272346,81.073298,1,0
0,0,4,4,10,15,25,32,21,53,0.000333,0.082041,5,1230.62189,68.367883,246.124378,91.82264,1,0
0,0,3,3,7,8,15,23,12,35,0.000333,0.04558,3,410.223513,22.790195,136.741171,43.651484,1,0
0,0,6,6,6,14,20,22,30,52,0.000333,0.074913,6,1348.441566,74.91342,224.740261,68.812744,1,0
0,0,3,3,7,5,12,11,7,18,0.000333,0.02151,3,193.587975,10.754888,64.529325,31.261125,1,0
0,0,10,10,13,18,31,50,43,93,0.000333,0.15358,12,5528.883082,307.160171,460.740257,123.164366,1,0
0,0,4,4,6,9,15,16,12,28,0.000333,0.036464,3,328.17881,18.232156,109.392937,44.0391,1,0
0,0,4,4,4,7,11,13,11,24,0.000333,0.027675,2,166.052718,9.225151,83.026359,27.651484,3,0
0,0,3,3,8,7,15,20,12,32,0.000333,0.041673,4,500.081996,27.782333,125.020499,43.651484,1,0
0,0,3,3,9,8,17,16,11,27,0.000333,0.036787,4,441.445987,24.524777,110.361497,52.529325,2,0
0,0,8,8,15,18,33,66,34,100,0.000333,0.168146,7,3531.075884,196.170882,504.439412,133.662009,2,0
0,0,9,9,15,19,34,68,35,103,0.000333,0.17467,7,3668.060709,203.78115,524.008673,139.313982,2,0
0,0,11,11,15,21,36,84,43,127,0.000333,0.21886,14,9192.126653,510.673703,656.580475,150.842025,2,0
0,0,3,3,9,9,18,14,12,26,0.000333,0.036139,4,433.6722,24.0929,108.41805,57.05865,1,0
0,0,7,7,11,12,23,49,24,73,0.000333,0.110073,10,3302.200228,183.455568,330.220023,81.073298,1,0
0,0,6,6,14,11,25,40,23,63,0.000333,0.097521,14,4095.881159,227.548953,292.56294,91.356717,4,0
0,0,5,5,7,7,14,16,11,27,0.000333,0.034266,3,308.395749,17.133097,102.798583,39.302969,1,0
0,0,4,4,9,9,18,28,15,43,0.000333,0.059769,4,717.2271,39.84595,179.306775,57.05865,1,0
0,0,3,3,9,8,17,16,11,27,0.000333,0.036787,4,441.445987,24.524777,110.361497,52.529325,2,0
0,0,3,3,7,8,15,23,12,35,0.000333,0.04558,3,410.223513,22.790195,136.741171,43.651484,1,0
0,0,3,3,10,8,18,16,13,29,0.000333,0.040309,5,604.639125,33.591063,120.927825,57.219281,3,0
0,0,12,12,14,17,31,61,46,107,0.000333,0.1767,14,7421.386073,412.299226,530.099005,122.789837,2,0
0,0,4,4,6,9,15,16,12,28,0.000333,0.036464,3,328.17881,18.232156,109.392937,44.0391,1,0
0,0,10,10,13,13,26,49,36,85,0.000333,0.133179,12,4794.448513,266.358251,399.537376,96.211433,1,0
0,0,29,29,22,49,71,182,138,320,0.000333,0.655973,22,43294.21972,2405.234429,1967.919078,373.228278,5,0
0,0,7,7,11,19,30,44,28,72,0.000333,0.117765,5,1766.480614,98.137812,353.296123,118.764371,2,0
0,0,3,3,7,8,15,23,12,35,0.000333,0.04558,3,410.223513,22.790195,136.741171,43.651484,1,0
0,0,8,8,15,18,33,66,34,100,0.000333,0.168146,7,3531.075884,196.170882,504.439412,133.662009,2,0
0,0,7,7,11,19,30,44,28,72,0.000333,0.117765,5,1766.480614,98.137812,353.296123,118.764371,2,0
0,0,5,5,8,9,17,24,14,38,0.000333,0.051775,4,621.294352,34.516353,155.323588,52.529325,1,0
0,0,11,11,15,16,31,56,38,94,0.000333,0.155231,14,6519.722344,362.206797,465.694453,122.603359,2,0
0,0,6,6,7,13,20,35,24,59,0.000333,0.084998,3,764.981273,42.49896,254.993758,67.757201,1,0
0,0,3,3,7,5,12,11,7,18,0.000333,0.02151,3,193.587975,10.754888,64.529325,31.261125,1,0
0,0,4,4,7,6,13,14,9,23,0.000333,0.02837,3,255.330341,14.185019,85.110114,35.161259,1,0
0,0,9,9,15,19,34,68,35,103,0.000333,0.17467,7,3668.060709,203.78115,524.008673,139.313982,2,0
0,0,4,4,10,15,25,32,21,53,0.000333,0.082041,5,1230.62189,68.367883,246.124378,91.82264,1,0
0,0,28,28,11,33,44,176,100,276,0.000333,0.502268,15,22602.0469,1255.669272,1506.803127,204.518754,1,0
0,0,3,3,8,7,15,11,9,20,0.000333,0.026046,4,312.551248,17.363958,78.137812,43.651484,1,0
0,0,5,5,8,10,18,28,17,45,0.000333,0.062549,4,750.5865,41.69925,187.646625,57.219281,1,0
0,0,9,9,15,20,35,72,36,108,0.000333,0.184654,7,3877.737961,215.429887,553.962566,145.041921,2,0
0,0,4,4,7,9,16,17,16,33,0.000333,0.044,3,396,22,132,48.180809,1,0
0,0,8,8,15,18,33,66,34,100,0.000333,0.168146,7,3531.075884,196.170882,504.439412,133.662009,2,0
0,0,9,9,15,19,34,68,35,103,0.000333,0.17467,7,3668.060709,203.78115,524.008673,139.313982,2,0
0,0,4,4,4,7,11,13,11,24,0.000333,0.027675,2,166.052718,9.225151,83.026359,27.651484,3,0
0,0,5,5,10,9,19,24,16,40,0.000333,0.056639,5,849.585503,47.199195,169.917101,61.748606,1,0
0,0,9,9,15,19,34,68,35,103,0.000333,0.17467,7,3668.060709,203.78115,524.008673,139.313982,2,0
0,0,4,4,6,9,15,14,12,26,0.000333,0.03386,3,304.737466,16.929859,101.579155,44.0391,1,0
0,0,13,13,13,22,35,98,52,150,0.000333,0.256464,12,9232.709431,512.928302,769.392453,146.213212,2,0
0,0,8,8,15,18,33,66,34,100,0.000333,0.168146,7,3531.075884,196.170882,504.439412,133.662009,2,0
0,0,11,11,15,21,36,84,43,127,0.000333,0.21886,14,9192.126653,510.673703,656.580475,150.842025,2,0
0,0,5,5,9,8,17,23,18,41,0.000333,0.055862,8,1340.687812,74.482656,167.585976,52.529325,1,0
0,0,3,3,7,8,15,23,12,35,0.000333,0.04558,3,410.223513,22.790195,136.741171,43.651484,1,0
0,0,4,4,5,9,14,15,13,28,0.000333,0.035535,2,213.211876,11.845104,106.605938,40.138965,1,0
0,0,3,3,7,8,15,23,12,35,0.000333,0.04558,3,410.223513,22.790195,136.741171,43.651484,1,0
0,0,3,3,7,8,15,23,12,35,0.000333,0.04558,3,410.223513,22.790195,136.741171,43.651484,1,0
0,0,3,3,8,7,15,20,12,32,0.000333,0.041673,4,500.081996,27.782333,125.020499,43.651484,1,0
0,0,5,5,8,10,18,28,17,45,0.000333,0.062549,4,750.5865,41.69925,187.646625,57.219281,1,0
0,0,3,3,7,5,12,11,7,18,0.000333,0.02151,3,193.587975,10.754888,64.529325,31.261125,1,0
0,0,3,3,5,6,11,9,8,17,0.000333,0.019603,2,117.620675,6.534482,58.810338,27.119415,1,0
0,0,3,3,7,8,15,23,12,35,0.000333,0.04558,3,410.223513,22.790195,136.741171,43.651484,1,0
0,0,7,7,11,19,30,44,28,72,0.000333,0.117765,5,1766.480614,98.137812,353.296123,118.764371,2,0
0,0,4,4,9,8,17,15,12,27,0.000333,0.036787,4,441.445987,24.524777,110.361497,52.529325,1,0
0,0,3,3,8,6,14,11,9,20,0.000333,0.025382,4,304.588394,16.921577,76.147098,39.509775,1,0
0,0,9,9,15,19,34,68,35,103,0.000333,0.17467,7,3668.060709,203.78115,524.008673,139.313982,2,0
0,0,6,6,14,11,25,40,23,63,0.000333,0.097521,14,4095.881159,227.548953,292.56294,91.356717,4,0
0,0,5,5,12,16,28,39,25,64,0.000333,0.102557,6,1846.02429,102.556905,307.670715,107.01955,2,0
0,0,15,15,14,25,39,81,56,137,0.000333,0.241367,14,10137.40146,563.18897,724.100104,169.399374,3,0
0,0,5,5,8,8,16,19,12,31,0.000333,0.041333,4,496,27.555556,124,48,1,0
0,0,6,6,9,10,19,28,17,45,0.000333,0.063719,4,764.626952,42.479275,191.156738,61.748606,1,0
0,0,12,12,11,19,30,73,36,109,0.000333,0.178284,5,2674.255375,148.569743,534.851075,118.764371,11,0
0,0,4,4,6,9,15,16,12,28,0.000333,0.036464,3,328.17881,18.232156,109.392937,44.0391,1,0
0,0,8,8,13,14,27,39,29,68,0.000333,0.107777,12,3879.988202,215.5549,323.33235,101.408685,1,0
0,0,7,7,17,14,31,46,29,75,0.000333,0.123855,16,5945.035572,330.279754,371.564723,122.789837,4,0
0,0,18,18,10,20,30,128,69,197,0.000333,0.322219,15,14499.86171,805.547873,966.657447,119.657843,3,0
0,0,8,8,15,18,33,66,34,100,0.000333,0.168146,7,3531.075884,196.170882,504.439412,133.662009,2,0
0,0,9,9,15,19,34,68,35,103,0.000333,0.17467,7,3668.060709,203.78115,524.008673,139.313982,2,0
0,0,4,4,10,15,25,32,21,53,0.000333,0.082041,5,1230.62189,68.367883,246.124378,91.82264,1,0
0,0,11,11,15,21,36,84,43,127,0.000333,0.21886,14,9192.126653,510.673703,656.580475,150.842025,2,0
0,0,11,11,15,21,36,84,43,127,0.000333,0.21886,14,9192.126653,510.673703,656.580475,150.842025,2,0
0,0,9,9,15,19,34,68,35,103,0.000333,0.17467,7,3668.060709,203.78115,524.008673,139.313982,2,0
0,0,6,6,7,15,22,29,33,62,0.000333,0.092162,6,1658.908562,92.161587,276.48476,78.254843,1,0
0,0,4,4,9,9,18,19,15,34,0.000333,0.047259,4,567.1098,31.5061,141.77745,57.05865,1,0
0,0,7,7,11,19,30,44,28,72,0.000333,0.117765,5,1766.480614,98.137812,353.296123,118.764371,2,0
0,0,19,19,15,27,42,106,69,175,0.000333,0.314552,14,13211.17769,733.954316,943.655549,186.985321,2,0
0,0,4,4,8,9,17,24,13,37,0.000333,0.050412,4,604.944501,33.608028,151.236125,52.529325,1,0
0,0,3,3,7,8,15,23,12,35,0.000333,0.04558,3,410.223513,22.790195,136.741171,43.651484,1,0
0,0,10,10,13,17,30,64,29,93,0.000333,0.152114,6,2738.044952,152.113608,456.340825,117.592585,5,0
0,0,6,6,9,9,18,21,16,37,0.000333,0.051429,4,617.1489,34.28605,154.287225,57.05865,1,0
0,0,4,4,8,9,17,24,13,37,0.000333,0.050412,4,604.944501,33.608028,151.236125,52.529325,1,0
0,0,4,4,11,11,22,19,15,34,0.000333,0.05054,5,758.103375,42.116854,151.620675,76.107496,1,0
0,0,25,25,12,35,47,382,213,595,0.000333,1.10166,36,118979.2932,6609.960733,3304.980367,222.544456,4,0
0,0,5,5,11,12,23,33,21,54,0.000333,0.081424,5,1221.361728,67.853429,244.272346,81.073298,1,0
0,0,3,3,7,5,12,11,7,18,0.000333,0.02151,3,193.587975,10.754888,64.529325,31.261125,1,0
0,0,4,4,6,12,18,16,15,31,0.000333,0.043089,3,387.803025,21.544613,129.267675,58.529325,1,0
0,0,7,7,11,13,24,39,25,64,0.000333,0.097813,5,1467.188,81.510444,293.4376,86.159464,1,0
0,0,5,5,9,9,18,34,14,48,0.000333,0.066719,4,800.6256,44.4792,200.1564,57.05865,3,0
0,0,5,5,9,8,17,29,19,48,0.000333,0.065399,8,1569.585731,87.199207,196.198216,52.529325,1,0
0,0,3,3,9,8,17,16,11,27,0.000333,0.036787,4,441.445987,24.524777,110.361497,52.529325,2,0
0,0,5,5,10,10,20,26,15,41,0.000333,0.059066,5,885.995259,49.221959,177.199052,66.438562,1,0
0,0,7,7,8,13,21,20,24,44,0.000333,0.064421,4,773.047866,42.947104,193.261967,72.105716,1,0
0,0,6,6,14,11,25,40,23,63,0.000333,0.097521,14,4095.881159,227.548953,292.56294,91.356717,4,0
0,0,7,7,11,19,30,44,28,72,0.000333,0.117765,5,1766.480614,98.137812,353.296123,118.764371,2,0
0,0,6,6,8,14,22,31,23,54,0.000333,0.08027,4,963.23723,53.513179,240.809307,77.302969,1,0
0,0,6,6,9,10,19,28,17,45,0.000333,0.063719,4,764.626952,42.479275,191.156738,61.748606,1,0
0,0,10,10,16,18,34,56,43,99,0.000333,0.167886,16,8058.541141,447.69673,503.658821,139.05865,4,0
0,0,6,6,9,12,21,23,23,46,0.000333,0.067349,4,808.186406,44.899245,202.046601,71.548875,1,0
0,0,11,11,15,21,36,84,43,127,0.000333,0.21886,14,9192.126653,510.673703,656.580475,150.842025,2,0
0,0,8,8,15,18,33,66,34,100,0.000333,0.168146,7,3531.075884,196.170882,504.439412,133.662009,2,0
0,0,5,5,8,11,19,30,18,48,0.000333,0.067967,4,815.602083,45.311227,203.900521,62.053748,1,0
0,0,3,3,8,8,16,20,12,32,0.000333,0.042667,4,512,28.444444,128,48,1,0
0,0,5,5,11,12,23,31,19,50,0.000333,0.075393,5,1130.890489,62.827249,226.178098,81.073298,2,0
0,0,3,3,14,8,22,29,14,43,0.000333,0.063919,7,1342.288917,74.571607,191.75556,77.302969,3,0
0,0,6,6,9,10,19,28,17,45,0.000333,0.063719,4,764.626952,42.479275,191.156738,61.748606,1,0
0,0,5,5,8,10,18,28,17,45,0.000333,0.062549,4,750.5865,41.69925,187.646625,57.219281,1,0
0,0,6,6,8,12,20,23,20,43,0.000333,0.061948,4,743.371632,41.298424,185.842908,67.01955,3,0
0,0,9,9,15,19,34,68,35,103,0.000333,0.17467,7,3668.060709,203.78115,524.008673,139.313982,2,0
0,0,3,3,8,7,15,11,9,20,0.000333,0.026046,4,312.551248,17.363958,78.137812,43.651484,1,0
0,0,4,4,10,15,25,32,21,53,0.000333,0.082041,5,1230.62189,68.367883,246.124378,91.82264,1,0
0,0,28,28,11,31,42,190,99,289,0.000333,0.51946,15,23375.69603,1298.649779,1558.379735,191.633833,1,0
0,0,10,10,15,27,42,169,61,230,0.000333,0.413411,14,17363.2621,964.625672,1240.233007,186.985321,7,0
0,0,7,7,15,17,32,45,36,81,0.000333,0.135,14,5670,315,405,128.090227,4,0
0,0,5,5,8,8,16,19,12,31,0.000333,0.041333,4,496,27.555556,124,48,1,0
0,0,5,5,8,10,18,28,17,45,0.000333,0.062549,4,750.5865,41.69925,187.646625,57.219281,1,0
0,0,3,3,8,8,16,20,12,32,0.000333,0.042667,4,512,28.444444,128,48,1,0
0,0,4,4,4,7,11,13,11,24,0.000333,0.027675,2,166.052718,9.225151,83.026359,27.651484,3,0
0,0,5,5,8,11,19,30,18,48,0.000333,0.067967,4,815.602083,45.311227,203.900521,62.053748,1,0
0,0,9,9,15,19,34,68,35,103,0.000333,0.17467,7,3668.060709,203.78115,524.008673,139.313982,2,0
0,0,11,11,11,18,29,70,34,104,0.000333,0.16841,5,2526.150117,140.341673,505.230023,113.112398,5,0
0,0,8,8,15,18,33,66,34,100,0.000333,0.168146,7,3531.075884,196.170882,504.439412,133.662009,2,0
0,0,11,11,13,21,34,91,48,139,0.000333,0.235719,12,8485.888019,471.438223,707.157335,140.344382,2,0
0,0,3,3,8,7,15,20,12,32,0.000333,0.041673,4,500.081996,27.782333,125.020499,43.651484,1,0
0,0,3,3,9,8,17,16,11,27,0.000333,0.036787,4,441.445987,24.524777,110.361497,52.529325,2,0
0,0,14,14,11,23,34,85,48,133,0.000333,0.225544,10,6766.325579,375.906977,676.632558,142.095673,1,0
0,0,9,9,15,19,34,68,35,103,0.000333,0.17467,7,3668.060709,203.78115,524.008673,139.313982,2,0
0,0,9,9,15,19,34,68,35,103,0.000333,0.17467,7,3668.060709,203.78115,524.008673,139.313982,2,0
0,0,8,8,12,11,23,36,31,67,0.000333,0.101026,12,3636.943813,202.052434,303.078651,81.073298,1,0
0,0,3,3,7,8,15,23,12,35,0.000333,0.04558,3,410.223513,22.790195,136.741171,43.651484,1,0
0,0,3,3,9,8,17,16,11,27,0.000333,0.036787,4,441.445987,24.524777,110.361497,52.529325,2,0
0,0,11,11,15,21,36,84,43,127,0.000333,0.21886,14,9192.126653,510.673703,656.580475,150.842025,2,0
0,0,9,9,15,19,34,68,35,103,0.000333,0.17467,7,3668.060709,203.78115,524.008673,139.313982,2,0
0,0,8,8,15,18,33,66,34,100,0.000333,0.168146,7,3531.075884,196.170882,504.439412,133.662009,2,0
0,0,4,4,9,7,16,16,11,27,0.000333,0.036,4,432,24,108,48.180809,1,0
0,0,9,9,15,19,34,68,35,103,0.000333,0.17467,7,3668.060709,203.78115,524.008673,139.313982,2,0
0,0,3,3,7,8,15,23,12,35,0.000333,0.04558,3,410.223513,22.790195,136.741171,43.651484,1,0
0,0,11,11,12,18,30,69,40,109,0.000333,0.178284,12,6418.212899,356.567383,534.851075,118.0782,2,0
0,0,7,7,8,12,20,29,20,49,0.000333,0.070591,4,847.097907,47.060995,211.774477,67.01955,1,0
0,0,5,5,8,10,18,28,17,45,0.000333,0.062549,4,750.5865,41.69925,187.646625,57.219281,1,0
0,0,5,5,8,10,18,26,15,41,0.000333,0.056989,4,683.8677,37.99265,170.966925,57.219281,1,0
0,0,6,6,9,9,18,30,19,49,0.000333,0.068109,8,1634.610601,90.8117,204.326325,57.05865,1,0
0,0,3,3,7,5,12,11,7,18,0.000333,0.02151,3,193.587975,10.754888,64.529325,31.261125,1,0
0,0,6,6,5,12,17,19,26,45,0.000333,0.061312,4,735.743311,40.874628,183.935828,54.62919,1,0
0,0,5,5,8,11,19,36,19,55,0.000333,0.077879,4,934.544053,51.919114,233.636013,62.053748,1,0
0,0,4,4,10,15,25,32,21,53,0.000333,0.082041,5,1230.62189,68.367883,246.124378,91.82264,1,0
0,0,5,5,8,10,18,28,17,45,0.000333,0.062549,4,750.5865,41.69925,187.646625,57.219281,1,0
0,0,8,8,12,16,28,39,24,63,0.000333,0.100954,6,1817.180161,100.954453,302.86336,107.01955,3,0
0,0,5,5,8,10,18,28,17,45,0.000333,0.062549,4,750.5865,41.69925,187.646625,57.219281,1,0
0,0,7,7,11,18,29,48,28,76,0.000333,0.123069,5,1846.032778,102.557377,369.206556,113.112398,1,0
0,0,3,3,9,8,17,16,11,27,0.000333,0.036787,4,441.445987,24.524777,110.361497,52.529325,2,0
0,0,4,4,9,7,16,17,12,29,0.000333,0.038667,4,464,25.777778,116,48.180809,1,0
0,0,3,3,8,6,14,11,9,20,0.000333,0.025382,4,304.588394,16.921577,76.147098,39.509775,1,0
0,0,5,5,8,10,18,28,17,45,0.000333,0.062549,4,750.5865,41.69925,187.646625,57.219281,1,0
0,0,7,7,11,19,30,44,28,72,0.000333,0.117765,5,1766.480614,98.137812,353.296123,118.764371,2,0
0,0,5,5,11,12,23,33,21,54,0.000333,0.081424,5,1221.361728,67.853429,244.272346,81.073298,1,0
0,0,5,5,9,14,23,25,20,45,0.000333,0.067853,4,814.241152,45.23562,203.560288,81.832294,1,0
0,0,4,4,9,7,16,16,11,27,0.000333,0.036,4,432,24,108,48.180809,1,0
0,0,5,5,8,8,16,25,13,38,0.000333,0.050667,4,608,33.777778,152,48,3,0
0,0,4,4,4,7,11,13,11,24,0.000333,0.027675,2,166.052718,9.225151,83.026359,27.651484,3,0
0,0,4,4,4,7,11,13,11,24,0.000333,0.027675,2,166.052718,9.225151,83.026359,27.651484,3,0
0,0,4,4,11,10,21,24,14,38,0.000333,0.055636,5,834.54031,46.363351,166.908062,71.273029,3,0
0,0,3,3,9,8,17,16,11,27,0.000333,0.036787,4,441.445987,24.524777,110.361497,52.529325,2,0
0,0,7,7,11,19,30,44,28,72,0.000333,0.117765,5,1766.480614,98.137812,353.296123,118.764371,2,0
0,0,4,4,4,7,11,13,11,24,0.000333,0.027675,2,166.052718,9.225151,83.026359,27.651484,2,0
0,0,3,3,8,7,15,11,9,20,0.000333,0.026046,4,312.551248,17.363958,78.137812,43.651484,1,0
0,0,7,7,10,14,24,27,25,52,0.000333,0.079473,5,1192.09025,66.227236,238.41805,86.52225,1,0
0,0,14,14,14,12,26,80,41,121,0.000333,0.189584,21,11943.81732,663.545407,568.753206,96.322519,5,0
0,0,4,4,7,11,18,24,17,41,0.000333,0.056989,3,512.900775,28.494488,170.966925,57.705232,1,0
0,0,10,10,7,14,21,57,36,93,0.000333,0.136162,6,2450.913122,136.16184,408.48552,72.954453,1,0
0,0,5,5,12,16,28,39,25,64,0.000333,0.102557,6,1846.02429,102.556905,307.670715,107.01955,2,0
0,0,4,4,9,10,19,26,20,46,0.000333,0.065135,8,1563.237325,86.846518,195.404666,61.748606,1,0
0,0,3,3,9,8,17,16,11,27,0.000333,0.036787,4,441.445987,24.524777,110.361497,52.529325,2,0
0,0,3,3,9,8,17,16,11,27,0.000333,0.036787,4,441.445987,24.524777,110.361497,52.529325,2,0
0,0,5,5,7,8,15,17,12,29,0.000333,0.037767,3,339.899482,18.883305,113.299827,43.651484,1,0
0,0,4,4,4,7,11,13,11,24,0.000333,0.027675,2,166.052718,9.225151,83.026359,27.651484,3,0
0,0,3,3,9,8,17,16,11,27,0.000333,0.036787,4,441.445987,24.524777,110.361497,52.529325,2,0
0,0,9,9,15,18,33,46,38,84,0.000333,0.141243,14,5932.207484,329.567082,423.729106,133.662009,4,0
0,0,5,5,8,11,19,36,19,55,0.000333,0.077879,4,934.544053,51.919114,233.636013,62.053748,1,0
0,0,7,7,9,16,25,24,27,51,0.000333,0.078946,4,947.346663,52.63037,236.836666,92.529325,1,0
0,0,11,11,12,18,30,69,40,109,0.000333,0.178284,12,6418.212899,356.567383,534.851075,118.0782,7,0
0,0,5,5,10,10,20,20,20,40,0.000333,0.057626,10,1728.771238,96.042847,172.877124,66.438562,1,0
0,0,3,3,8,7,15,15,9,24,0.000333,0.031255,4,375.061497,20.83675,93.765374,43.651484,3,0
0,0,3,3,7,8,15,23,12,35,0.000333,0.04558,3,410.223513,22.790195,136.741171,43.651484,1,0
0,0,3,3,7,5,12,11,7,18,0.000333,0.02151,3,193.587975,10.754888,64.529325,31.261125,1,0
0,0,4,4,6,8,14,17,12,29,0.000333,0.036804,3,331.239878,18.402215,110.413293,39.509775,3,0
0,0,22,22,13,29,42,116,68,184,0.000333,0.330729,12,11906.23687,661.457604,992.186406,188.987165,1,0
0,0,3,3,11,11,22,26,15,41,0.000333,0.060946,5,914.183482,50.787971,182.836696,76.107496,3,0
0,0,5,5,8,10,18,28,17,45,0.000333,0.062549,4,750.5865,41.69925,187.646625,57.219281,1,0
0,0,7,7,11,19,30,44,28,72,0.000333,0.117765,5,1766.480614,98.137812,353.296123,118.764371,2,0
0,0,8,8,15,18,33,66,34,100,0.000333,0.168146,7,3531.075884,196.170882,504.439412,133.662009,2,0
0,0,10,10,15,20,35,80,41,121,0.000333,0.206881,14,8689.005431,482.722524,620.643245,145.041921,2,0
0,0,9,9,15,19,34,68,35,103,0.000333,0.17467,7,3668.060709,203.78115,524.008673,139.313982,2,0
0,0,3,3,7,14,21,20,20,40,0.000333,0.058564,3,527.078091,29.282116,175.692697,72.954453,1,0
0,0,5,5,8,10,18,28,17,45,0.000333,0.062549,4,750.5865,41.69925,187.646625,57.219281,1,0
0,0,10,10,7,14,21,57,36,93,0.000333,0.136162,6,2450.913122,136.16184,408.48552,72.954453,1,0
0,0,4,4,8,9,17,24,13,37,0.000333,0.050412,4,604.944501,33.608028,151.236125,52.529325,1,0
0,0,8,8,11,15,26,59,34,93,0.000333,0.145714,10,4371.408938,242.856052,437.140894,96.657107,1,0
0,0,5,5,10,10,20,26,15,41,0.000333,0.059066,5,885.995259,49.221959,177.199052,66.438562,1,0
0,0,6,6,9,10,19,24,17,41,0.000333,0.058055,4,696.660112,38.70334,174.165028,61.748606,1,0
0,0,4,4,5,12,17,14,15,29,0.000333,0.039512,2,237.072845,13.170714,118.536422,54.62919,1,0
0,0,7,7,11,10,21,32,20,52,0.000333,0.076134,10,2284.00506,126.88917,228.400506,71.273029,1,0
0,0,9,9,15,19,34,68,35,103,0.000333,0.17467,7,3668.060709,203.78115,524.008673,139.313982,2,0
0,0,14,14,26,36,62,96,63,159,0.000333,0.315572,13,12307.32377,683.74021,946.717213,308.328733,9,0
0,0,3,3,11,9,20,19,14,33,0.000333,0.047541,5,713.118136,39.617674,142.623627,66.583073,3,0
0,0,3,3,9,11,20,19,16,35,0.000333,0.050422,4,605.069933,33.614996,151.267483,66.583073,1,0
0,0,14,14,11,23,34,85,48,133,0.000333,0.225544,10,6766.325579,375.906977,676.632558,142.095673,1,0
0,0,4,4,7,10,17,17,17,34,0.000333,0.046325,3,416.92121,23.162289,138.973737,52.870765,1,0
0,0,4,4,5,9,14,15,13,28,0.000333,0.035535,2,213.211876,11.845104,106.605938,40.138965,1,0
0,0,11,11,15,21,36,84,43,127,0.000333,0.21886,14,9192.126653,510.673703,656.580475,150.842025,2,0
0,0,9,9,20,15,35,61,32,93,0.000333,0.159008,20,9540.466412,530.025912,477.023321,145.041921,5,0
0,0,12,12,12,16,28,61,46,107,0.000333,0.171462,12,6172.64372,342.924651,514.386977,107.01955,5,0
0,0,3,3,6,9,15,26,11,37,0.000333,0.048185,3,433.664856,24.092492,144.554952,44.0391,5,0
0,0,5,5,6,8,14,25,17,42,0.000333,0.053303,6,959.45344,53.302969,159.908907,39.509775,1,0
0,0,6,6,7,11,18,41,25,66,0.000333,0.091738,6,1651.290301,91.73835,275.21505,57.705232,1,0
0,0,7,7,11,19,30,44,28,72,0.000333,0.117765,5,1766.480614,98.137812,353.296123,118.764371,2,0
0,0,3,3,7,8,15,23,12,35,0.000333,0.04558,3,410.223513,22.790195,136.741171,43.651484,1,0
0,0,4,4,9,7,16,16,11,27,0.000333,0.036,4,432,24,108,48.180809,1,0
0,0,8,8,16,17,33,48,34,82,0.000333,0.13788,16,6618.245085,367.680282,413.640318,133.486868,5,0
0,0,3,3,9,8,17,16,11,27,0.000333,0.036787,4,441.445987,24.524777,110.361497,52.529325,2,0
0,0,3,3,7,8,15,23,12,35,0.000333,0.04558,3,410.223513,22.790195,136.741171,43.651484,1,0
0,0,6,6,10,11,21,24,21,45,0.000333,0.065885,5,988.27142,54.903968,197.654284,71.273029,1,0
0,0,7,7,8,12,20,29,20,49,0.000333,0.070591,4,847.097907,47.060995,211.774477,67.01955,1,0
0,0,7,7,6,9,15,37,23,60,0.000333,0.078138,6,1406.480614,78.137812,234.413436,44.0391,1,0
0,0,10,10,14,18,32,51,39,90,0.000333,0.15,14,6300,350,450,128.361619,2,0
0,0,5,5,7,13,20,16,19,35,0.000333,0.050422,3,453.80245,25.211247,151.267483,67.757201,1,0
0,0,3,3,7,8,15,23,12,35,0.000333,0.04558,3,410.223513,22.790195,136.741171,43.651484,1,0
0,0,5,5,8,10,18,28,17,45,0.000333,0.062549,4,750.5865,41.69925,187.646625,57.219281,1,0
0,0,4,4,4,7,11,13,11,24,0.000333,0.027675,2,166.052718,9.225151,83.026359,27.651484,3,0
0,0,5,5,8,10,18,28,17,45,0.000333,0.062549,4,750.5865,41.69925,187.646625,57.219281,1,0
0,0,4,4,4,7,11,13,11,24,0.000333,0.027675,2,166.052718,9.225151,83.026359,27.651484,3,0
0,0,3,3,8,7,15,20,12,32,0.000333,0.041673,4,500.081996,27.782333,125.020499,43.651484,1,0
0,0,4,4,9,8,17,21,14,35,0.000333,0.047687,4,572.244798,31.791378,143.061199,52.529325,1,0
0,0,4,4,4,7,11,13,11,24,0.000333,0.027675,2,166.052718,9.225151,83.026359,27.651484,3,0
0,0,9,9,10,12,22,32,29,61,0.000333,0.090675,10,2720.253287,151.125183,272.025329,76.238831,1,0
0,0,5,5,10,11,21,29,17,46,0.000333,0.067349,5,1010.233007,56.124056,202.046601,71.273029,1,0
0,0,4,4,8,9,17,24,13,37,0.000333,0.050412,4,604.944501,33.608028,151.236125,52.529325,1,0
0,0,4,4,4,7,11,13,11,24,0.000333,0.027675,2,166.052718,9.225151,83.026359,27.651484,3,0
0,0,6,6,8,17,25,33,28,61,0.000333,0.094425,4,1133.10091,62.950051,283.275228,93.486868,1,0
0,0,5,5,8,10,18,28,17,45,0.000333,0.062549,4,750.5865,41.69925,187.646625,57.219281,1,0
0,0,3,3,9,8,17,16,11,27,0.000333,0.036787,4,441.445987,24.524777,110.361497,52.529325,2,0
0,0,7,7,11,19,30,44,28,72,0.000333,0.117765,5,1766.480614,98.137812,353.296123,118.764371,2,0
0,0,4,4,12,12,24,42,17,59,0.000333,0.090171,6,1623.076725,90.170929,270.512788,86.0391,5,0
0,0,3,3,8,7,15,20,12,32,0.000333,0.041673,4,500.081996,27.782333,125.020499,43.651484,1,0
0,0,3,3,8,8,16,20,12,32,0.000333,0.042667,4,512,28.444444,128,48,1,0
0,0,5,5,9,12,21,22,18,40,0.000333,0.058564,4,702.770788,39.042822,175.692697,71.548875,1,0
0,0,9,9,15,19,34,68,35,103,0.000333,0.17467,7,3668.060709,203.78115,524.008673,139.313982,2,0
0,0,11,11,15,21,36,84,43,127,0.000333,0.21886,14,9192.126653,510.673703,656.580475,150.842025,2,0
0,0,8,8,15,18,33,66,34,100,0.000333,0.168146,7,3531.075884,196.170882,504.439412,133.662009,2,0
0,0,9,9,15,19,34,68,35,103,0.000333,0.17467,7,3668.060709,203.78115,524.008673,139.313982,2,0
0,0,8,8,15,18,33,66,34,100,0.000333,0.168146,7,3531.075884,196.170882,504.439412,133.662009,2,0
0,0,6,6,7,13,20,35,24,59,0.000333,0.084998,3,764.981273,42.49896,254.993758,67.757201,1,0
0,0,4,4,7,11,18,24,17,41,0.000333,0.056989,3,512.900775,28.494488,170.966925,57.705232,1,0
0,0,6,6,9,10,19,28,17,45,0.000333,0.063719,4,764.626952,42.479275,191.156738,61.748606,1,0
0,0,5,5,7,7,14,16,11,27,0.000333,0.034266,3,308.395749,17.133097,102.798583,39.302969,1,0
0,0,5,5,14,17,31,60,30,90,0.000333,0.148626,7,3121.143676,173.396871,445.877668,122.789837,4,0
0,0,5,5,7,8,15,17,12,29,0.000333,0.037767,3,339.899482,18.883305,113.299827,43.651484,1,0
0,0,3,3,6,10,16,25,13,38,0.000333,0.050667,3,456,25.333333,152,48.729056,3,0
0,0,3,3,10,8,18,16,13,29,0.000333,0.040309,5,604.639125,33.591063,120.927825,57.219281,3,0
0,0,6,6,9,10,19,28,17,45,0.000333,0.063719,4,764.626952,42.479275,191.156738,61.748606,1,0
0,0,3,3,11,11,22,26,15,41,0.000333,0.060946,5,914.183482,50.787971,182.836696,76.107496,3,0
0,0,18,18,11,28,39,115,64,179,0.000333,0.315362,10,9460.869972,525.603887,946.086997,172.659686,1,0
0,0,7,7,11,19,30,44,28,72,0.000333,0.117765,5,1766.480614,98.137812,353.296123,118.764371,2,0
0,0,3,3,8,6,14,11,9,20,0.000333,0.025382,4,304.588394,16.921577,76.147098,39.509775,1,0
0,0,9,9,11,15,26,61,34,95,0.000333,0.148847,10,4465.417732,248.078763,446.541773,96.657107,1,0
0,0,9,9,15,20,35,72,36,108,0.000333,0.184654,7,3877.737961,215.429887,553.962566,145.041921,2,0
0,0,8,8,11,15,26,59,34,93,0.000333,0.145714,10,4371.408938,242.856052,437.140894,96.657107,1,0
0,0,5,5,8,10,18,28,17,45,0.000333,0.062549,4,750.5865,41.69925,187.646625,57.219281,1,0
0,0,7,7,11,19,30,44,28,72,0.000333,0.117765,5,1766.480614,98.137812,353.296123,118.764371,2,0
0,0,8,8,15,18,33,66,34,100,0.000333,0.168146,7,3531.075884,196.170882,504.439412,133.662009,2,0
0,0,8,8,15,18,33,66,34,100,0.000333,0.168146,7,3531.075884,196.170882,504.439412,133.662009,2,0
0,0,11,11,15,21,36,84,43,127,0.000333,0.21886,14,9192.126653,510.673703,656.580475,150.842025,2,0
0,0,5,5,10,11,21,29,17,46,0.000333,0.067349,5,1010.233007,56.124056,202.046601,71.273029,1,0
0,0,3,3,8,6,14,11,9,20,0.000333,0.025382,4,304.588394,16.921577,76.147098,39.509775,1,0
0,0,3,3,8,8,16,20,12,32,0.000333,0.042667,4,512,28.444444,128,48,1,0
0,0,5,5,7,8,15,17,12,29,0.000333,0.037767,3,339.899482,18.883305,113.299827,43.651484,1,0
0,0,3,3,9,8,17,16,11,27,0.000333,0.036787,4,441.445987,24.524777,110.361497,52.529325,2,0
0,0,6,6,10,10,20,24,19,43,0.000333,0.061948,5,929.21454,51.62303,185.842908,66.438562,1,0
0,0,3,3,7,5,12,11,7,18,0.000333,0.02151,3,193.587975,10.754888,64.529325,31.261125,1,0
0,0,5,5,12,16,28,39,25,64,0.000333,0.102557,6,1846.02429,102.556905,307.670715,107.01955,2,0
0,0,8,8,15,18,33,66,34,100,0.000333,0.168146,7,3531.075884,196.170882,504.439412,133.662009,2,0
0,0,4,4,8,7,15,15,10,25,0.000333,0.032557,4,390.68906,21.704948,97.672265,43.651484,1,0
0,0,3,3,9,8,17,16,11,27,0.000333,0.036787,4,441.445987,24.524777,110.361497,52.529325,2,0
0,0,5,5,6,10,16,23,18,41,0.000333,0.054667,3,492,27.333333,164,48.729056,1,0
0,0,5,5,7,8,15,17,12,29,0.000333,0.037767,3,339.899482,18.883305,113.299827,43.651484,1,0
0,0,3,3,7,8,15,23,12,35,0.000333,0.04558,3,410.223513,22.790195,136.741171,43.651484,1,0
0,0,3,3,8,7,15,11,9,20,0.000333,0.026046,4,312.551248,17.363958,78.137812,43.651484,1,0
0,0,3,3,8,7,15,20,12,32,0.000333,0.041673,4,500.081996,27.782333,125.020499,43.651484,1,0
0,0,6,6,18,26,44,59,41,100,0.000333,0.181981,9,4913.488457,272.971581,545.943162,197.270083,4,0
0,0,13,13,9,19,28,127,46,173,0.000333,0.277224,8,6653.379212,369.632178,831.672402,109.239948,1,0
0,0,3,3,7,5,12,11,7,18,0.000333,0.02151,3,193.587975,10.754888,64.529325,31.261125,1,0
0,0,8,8,15,18,33,66,34,100,0.000333,0.168146,7,3531.075884,196.170882,504.439412,133.662009,2,0
0,0,4,4,11,10,21,36,17,53,0.000333,0.077598,5,1163.964117,64.664673,232.792823,71.273029,1,0
0,0,3,3,10,8,18,16,13,29,0.000333,0.040309,5,604.639125,33.591063,120.927825,57.219281,3,0
0,0,3,3,8,8,16,20,12,32,0.000333,0.042667,4,512,28.444444,128,48,1,0
0,0,6,6,9,10,19,28,17,45,0.000333,0.063719,4,764.626952,42.479275,191.156738,61.748606,1,0
0,0,3,3,9,8,17,16,11,27,0.000333,0.036787,4,441.445987,24.524777,110.361497,52.529325,2,0
0,0,7,7,11,19,30,44,28,72,0.000333,0.117765,5,1766.480614,98.137812,353.296123,118.764371,2,0
0,0,8,8,15,18,33,66,34,100,0.000333,0.168146,7,3531.075884,196.170882,504.439412,133.662009,2,0
0,0,5,5,10,10,20,26,15,41,0.000333,0.059066,5,885.995259,49.221959,177.199052,66.438562,1,0
0,0,6,6,9,10,19,28,17,45,0.000333,0.063719,4,764.626952,42.479275,191.156738,61.748606,1,0
0,0,3,3,7,5,12,11,7,18,0.000333,0.02151,3,193.587975,10.754888,64.529325,31.261125,1,0
0,0,3,3,8,8,16,20,12,32,0.000333,0.042667,4,512,28.444444,128,48,1,0
0,0,3,3,9,8,17,16,11,27,0.000333,0.036787,4,441.445987,24.524777,110.361497,52.529325,2,0
0,0,3,3,9,8,17,16,11,27,0.000333,0.036787,4,441.445987,24.524777,110.361497,52.529325,2,0
0,0,5,5,10,14,24,27,22,49,0.000333,0.074888,5,1123.315813,62.406434,224.663163,86.52225,3,0
0,0,4,4,6,12,18,17,16,33,0.000333,0.045869,3,412.822575,22.934588,137.607525,58.529325,1,0
0,0,11,11,15,21,36,84,43,127,0.000333,0.21886,14,9192.126653,510.673703,656.580475,150.842025,2,0
0,0,5,5,8,10,18,28,17,45,0.000333,0.062549,4,750.5865,41.69925,187.646625,57.219281,1,0
0,0,3,3,7,5,12,11,7,18,0.000333,0.02151,3,193.587975,10.754888,64.529325,31.261125,1,0
0,0,6,6,9,10,19,28,17,45,0.000333,0.063719,4,764.626952,42.479275,191.156738,61.748606,1,0
0,0,8,8,9,16,25,34,31,65,0.000333,0.100617,4,1207.402609,67.077923,301.850652,92.529325,1,0
0,0,8,8,15,18,33,66,34,100,0.000333,0.168146,7,3531.075884,196.170882,504.439412,133.662009,2,0
0,0,11,11,15,21,36,84,43,127,0.000333,0.21886,14,9192.126653,510.673703,656.580475,150.842025,2,0
0,0,19,19,19,27,46,152,72,224,0.000333,0.412426,18,22271.00181,1237.277878,1237.277878,209.092585,9,0
0,0,5,5,8,10,18,28,17,45,0.000333,0.062549,4,750.5865,41.69925,187.646625,57.219281,1,0
0,0,7,7,11,19,30,44,28,72,0.000333,0.117765,5,1766.480614,98.137812,353.296123,118.764371,2,0
0,0,4,4,8,8,16,18,12,30,0.000333,0.04,4,480,26.666667,120,48,1,0
0,0,7,7,7,18,25,45,34,79,0.000333,0.122288,3,1100.593917,61.144106,366.864639,94.710134,1,0
0,0,11,11,15,21,36,84,43,127,0.000333,0.21886,14,9192.126653,510.673703,656.580475,150.842025,2,0
0,0,9,9,15,19,34,68,35,103,0.000333,0.17467,7,3668.060709,203.78115,524.008673,139.313982,2,0
0,0,7,7,11,19,30,44,28,72,0.000333,0.117765,5,1766.480614,98.137812,353.296123,118.764371,2,0
0,0,8,8,8,11,19,40,31,71,0.000333,0.100534,8,2412.822828,134.045713,301.602853,62.053748,1,0
0,0,5,5,12,16,28,39,25,64,0.000333,0.102557,6,1846.02429,102.556905,307.670715,107.01955,3,0
0,0,8,8,15,18,33,66,34,100,0.000333,0.168146,7,3531.075884,196.170882,504.439412,133.662009,2,0
0,0,6,6,8,12,20,23,20,43,0.000333,0.061948,4,743.371632,41.298424,185.842908,67.01955,3,0
0,0,3,3,7,8,15,23,12,35,0.000333,0.04558,3,410.223513,22.790195,136.741171,43.651484,1,0
0,0,4,4,6,10,16,26,15,41,0.000333,0.054667,3,492,27.333333,164,48.729056,1,0
0,0,11,11,15,21,36,84,43,127,0.000333,0.21886,14,9192.126653,510.673703,656.580475,150.842025,2,0
0,0,8,8,15,18,33,66,34,100,0.000333,0.168146,7,3531.075884,196.170882,504.439412,133.662009,2,0
0,0,4,4,8,9,17,19,14,33,0.000333,0.044962,4,539.545095,29.974728,134.886274,52.529325,1,0
0,0,3,3,9,8,17,16,11,27,0.000333,0.036787,4,441.445987,24.524777,110.361497,52.529325,2,0
0,0,5,5,11,12,23,33,21,54,0.000333,0.081424,5,1221.361728,67.853429,244.272346,81.073298,1,0
0,0,25,25,12,35,47,382,213,595,0.000333,1.10166,36,118979.2932,6609.960733,3304.980367,222.544456,4,0
0,0,4,4,6,8,14,17,12,29,0.000333,0.036804,3,331.239878,18.402215,110.413293,39.509775,3,0
0,0,6,6,12,15,27,37,22,59,0.000333,0.093513,6,1683.230176,93.512788,280.538363,101.622909,3,0
0,0,6,6,8,10,18,20,16,36,0.000333,0.050039,4,600.4692,33.3594,150.1173,57.219281,1,0
0,0,4,4,4,7,11,13,11,24,0.000333,0.027675,2,166.052718,9.225151,83.026359,27.651484,3,0
0,0,7,7,11,19,30,44,28,72,0.000333,0.117765,5,1766.480614,98.137812,353.296123,118.764371,2,0
0,0,7,7,11,19,30,44,28,72,0.000333,0.117765,5,1766.480614,98.137812,353.296123,118.764371,2,0
0,0,6,6,8,11,19,29,21,50,0.000333,0.070799,4,849.585503,47.199195,212.396376,62.053748,1,0
0,0,6,6,9,12,21,23,18,41,0.000333,0.060028,4,720.340057,40.018892,180.085014,71.548875,1,0
0,0,3,3,8,8,16,20,12,32,0.000333,0.042667,4,512,28.444444,128,48,1,0
0,0,5,5,10,11,21,29,17,46,0.000333,0.067349,5,1010.233007,56.124056,202.046601,71.273029,1,0
0,0,9,9,11,12,23,34,29,63,0.000333,0.094995,10,2849.844032,158.324668,284.984403,81.073298,1,0
0,0,4,4,6,8,14,17,12,29,0.000333,0.036804,3,331.239878,18.402215,110.413293,39.509775,3,0
0,0,5,5,14,17,31,60,30,90,0.000333,0.148626,7,3121.143676,173.396871,445.877668,122.789837,4,0
0,0,7,7,11,19,30,44,28,72,0.000333,0.117765,5,1766.480614,98.137812,353.296123,118.764371,2,0
0,0,3,3,9,8,17,16,11,27,0.000333,0.036787,4,441.445987,24.524777,110.361497,52.529325,2,0
0,0,3,3,10,8,18,19,11,30,0.000333,0.041699,5,625.48875,34.749375,125.09775,57.219281,1,0
0,0,5,5,11,11,22,31,17,48,0.000333,0.071351,5,1070.263588,59.459088,214.052718,76.107496,1,0
0,0,6,6,7,11,18,41,25,66,0.000333,0.091738,6,1651.290301,91.73835,275.21505,57.705232,1,0
0,0,9,9,15,19,34,68,35,103,0.000333,0.17467,7,3668.060709,203.78115,524.008673,139.313982,2,0
0,0,4,4,7,6,13,14,9,23,0.000333,0.02837,3,255.330341,14.185019,85.110114,35.161259,1,0
0,0,18,18,16,24,40,188,64,252,0.000333,0.447042,16,21458.01408,1192.111893,1341.12588,174.0391,6,0
0,0,5,5,12,16,28,39,25,64,0.000333,0.102557,6,1846.02429,102.556905,307.670715,107.01955,4,0
0,0,3,3,7,13,20,20,19,39,0.000333,0.056185,3,505.665587,28.092533,168.555196,67.757201,1,0
0,0,7,7,11,19,30,44,28,72,0.000333,0.117765,5,1766.480614,98.137812,353.296123,118.764371,2,0
0,0,4,4,12,11,23,24,15,39,0.000333,0.058806,6,1058.513498,58.806305,176.418916,81.073298,4,0
0,0,5,5,7,8,15,17,12,29,0.000333,0.037767,3,339.899482,18.883305,113.299827,43.651484,1,0
0,0,3,3,9,8,17,16,11,27,0.000333,0.036787,4,441.445987,24.524777,110.361497,52.529325,2,0
0,0,4,4,4,7,11,13,11,24,0.000333,0.027675,2,166.052718,9.225151,83.026359,27.651484,3,0
0,0,7,7,11,19,30,44,28,72,0.000333,0.117765,5,1766.480614,98.137812,353.296123,118.764371,2,0
0,0,3,3,5,6,11,9,8,17,0.000333,0.019603,2,117.620675,6.534482,58.810338,27.119415,1,0
0,0,7,7,11,19,30,44,28,72,0.000333,0.117765,5,1766.480614,98.137812,353.296123,118.764371,2,0
0,0,3,3,8,7,15,11,9,20,0.000333,0.026046,4,312.551248,17.363958,78.137812,43.651484,1,0
0,0,9,9,15,19,34,68,35,103,0.000333,0.17467,7,3668.060709,203.78115,524.008673,139.313982,2,0
0,0,11,11,15,21,36,84,43,127,0.000333,0.21886,14,9192.126653,510.673703,656.580475,150.842025,2,0
0,0,3,3,7,8,15,23,12,35,0.000333,0.04558,3,410.223513,22.790195,136.741171,43.651484,1,0
0,0,5,5,10,12,22,23,18,41,0.000333,0.060946,5,914.183482,50.787971,182.836696,76.238831,1,0
0,0,3,3,11,11,22,26,15,41,0.000333,0.060946,5,914.183482,50.787971,182.836696,76.107496,3,0
0,0,8,8,15,18,33,66,34,100,0.000333,0.168146,7,3531.075884,196.170882,504.439412,133.662009,2,0
0,0,10,10,15,20,35,60,45,105,0.000333,0.179525,14,7540.046035,418.891446,538.574717,145.041921,4,0
0,0,7,7,14,17,31,42,35,77,0.000333,0.127158,14,5340.623623,296.701312,381.473116,122.789837,4,0
0,0,11,11,15,21,36,84,43,127,0.000333,0.21886,14,9192.126653,510.673703,656.580475,150.842025,2,0
0,0,3,3,9,8,17,16,11,27,0.000333,0.036787,4,441.445987,24.524777,110.361497,52.529325,2,0
0,0,7,7,10,14,24,40,27,67,0.000333,0.102397,5,1535.962438,85.331247,307.192488,86.52225,1,0
0,0,3,3,8,7,15,20,12,32,0.000333,0.041673,4,500.081996,27.782333,125.020499,43.651484,1,0
0,0,4,4,4,7,11,13,11,24,0.000333,0.027675,2,166.052718,9.225151,83.026359,27.651484,2,0
0,0,6,6,8,11,19,31,23,54,0.000333,0.076463,8,1835.104686,101.95026,229.388086,62.053748,1,0
0,0,3,3,8,6,14,13,9,22,0.000333,0.027921,4,335.047233,18.613735,83.761808,39.509775,1,0
0,0,25,25,12,35,47,382,213,595,0.000333,1.10166,36,118979.2932,6609.960733,3304.980367,222.544456,4,0
0,0,5,5,8,10,18,28,17,45,0.000333,0.062549,4,750.5865,41.69925,187.646625,57.219281,1,0
0,0,5,5,11,12,23,33,21,54,0.000333,0.081424,5,1221.361728,67.853429,244.272346,81.073298,1,0
0,0,5,5,8,13,21,22,23,45,0.000333,0.065885,4,790.617136,43.923174,197.654284,72.105716,1,0
0,0,4,4,5,9,14,15,13,28,0.000333,0.035535,2,213.211876,11.845104,106.605938,40.138965,1,0
0,0,7,7,11,19,30,44,28,72,0.000333,0.117765,5,1766.480614,98.137812,353.296123,118.764371,2,0
0,0,4,4,4,7,11,13,11,24,0.000333,0.027675,2,166.052718,9.225151,83.026359,27.651484,3,0
0,0,3,3,9,12,21,17,14,31,0.000333,0.045387,4,544.64736,30.258187,136.16184,71.548875,1,0
0,0,25,25,12,35,47,382,213,595,0.000333,1.10166,36,118979.2932,6609.960733,3304.980367,222.544456,4,0
0,0,5,5,11,12,23,33,21,54,0.000333,0.081424,5,1221.361728,67.853429,244.272346,81.073298,1,0
0,0,3,3,8,7,15,11,9,20,0.000333,0.026046,4,312.551248,17.363958,78.137812,43.651484,1,0
0,0,5,5,8,11,19,36,19,55,0.000333,0.077879,4,934.544053,51.919114,233.636013,62.053748,1,0
0,0,7,7,14,17,31,42,35,77,0.000333,0.127158,14,5340.623623,296.701312,381.473116,122.789837,4,0
0,0,4,4,9,8,17,15,12,27,0.000333,0.036787,4,441.445987,24.524777,110.361497,52.529325,1,0
0,0,3,3,8,6,14,11,9,20,0.000333,0.025382,4,304.588394,16.921577,76.147098,39.509775,1,0
0,0,7,7,11,19,30,44,28,72,0.000333,0.117765,5,1766.480614,98.137812,353.296123,118.764371,2,0
0,0,5,5,7,7,14,16,11,27,0.000333,0.034266,3,308.395749,17.133097,102.798583,39.302969,1,0
0,0,11,11,15,21,36,84,43,127,0.000333,0.21886,14,9192.126653,510.673703,656.580475,150.842025,2,0
0,0,9,9,15,19,34,68,35,103,0.000333,0.17467,7,3668.060709,203.78115,524.008673,139.313982,2,0
0,0,4,4,6,8,14,17,12,29,0.000333,0.036804,3,331.239878,18.402215,110.413293,39.509775,3,0
0,0,3,3,9,8,17,16,11,27,0.000333,0.036787,4,441.445987,24.524777,110.361497,52.529325,2,0
0,0,4,4,12,11,23,24,15,39,0.000333,0.058806,6,1058.513498,58.806305,176.418916,81.073298,4,0
0,0,11,11,15,21,36,84,43,127,0.000333,0.21886,14,9192.126653,510.673703,656.580475,150.842025,2,0
0,0,9,9,15,19,34,68,35,103,0.000333,0.17467,7,3668.060709,203.78115,524.008673,139.313982,2,0
0,0,7,7,11,19,30,44,28,72,0.000333,0.117765,5,1766.480614,98.137812,353.296123,118.764371,2,0
0,0,11,11,12,18,30,69,40,109,0.000333,0.178284,12,6418.212899,356.567383,534.851075,118.0782,5,0
0,0,8,8,12,17,29,42,24,66,0.000333,0.106876,6,1923.760474,106.875582,320.626746,112.506418,3,0
0,0,7,7,11,18,29,48,28,76,0.000333,0.123069,5,1846.032778,102.557377,369.206556,113.112398,1,0
0,0,5,5,10,12,22,23,18,41,0.000333,0.060946,5,914.183482,50.787971,182.836696,76.238831,1,0
0,0,4,4,8,10,18,28,16,44,0.000333,0.061159,4,733.9068,40.7726,183.4767,57.219281,1,0
0,0,4,4,4,7,11,13,11,24,0.000333,0.027675,2,166.052718,9.225151,83.026359,27.651484,3,0
0,0,5,5,8,10,18,28,17,45,0.000333,0.062549,4,750.5865,41.69925,187.646625,57.219281,1,0
0,0,4,4,10,8,18,19,16,35,0.000333,0.048649,10,1459.473751,81.081875,145.947375,57.219281,1,0
0,0,7,7,11,19,30,44,28,72,0.000333,0.117765,5,1766.480614,98.137812,353.296123,118.764371,2,0
0,0,5,5,10,14,24,27,22,49,0.000333,0.074888,5,1123.315813,62.406434,224.663163,86.52225,3,0
0,0,6,6,8,16,24,34,30,64,0.000333,0.097813,4,1173.7504,65.208356,293.4376,88,1,0
0,0,9,9,16,16,32,53,37,90,0.000333,0.15,16,7200,400,450,128,4,0
0,0,8,8,10,14,24,32,26,58,0.000333,0.088643,5,1329.639125,73.86884,265.927825,86.52225,1,0
0,0,4,4,7,11,18,24,17,41,0.000333,0.056989,3,512.900775,28.494488,170.966925,57.705232,1,0
0,0,6,6,7,13,20,35,24,59,0.000333,0.084998,3,764.981273,42.49896,254.993758,67.757201,1,0
0,0,4,4,5,9,14,15,13,28,0.000333,0.035535,2,213.211876,11.845104,106.605938,40.138965,1,0
0,0,6,6,10,10,20,24,19,43,0.000333,0.061948,5,929.21454,51.62303,185.842908,66.438562,1,0
0,0,3,3,8,7,15,20,12,32,0.000333,0.041673,4,500.081996,27.782333,125.020499,43.651484,1,0
0,0,4,4,11,10,21,24,14,38,0.000333,0.055636,5,834.54031,46.363351,166.908062,71.273029,3,0
0,0,5,5,8,10,18,28,17,45,0.000333,0.062549,4,750.5865,41.69925,187.646625,57.219281,1,0
0,0,4,4,4,7,11,13,11,24,0.000333,0.027675,2,166.052718,9.225151,83.026359,27.651484,3,0
0,0,6,6,6,14,20,30,23,53,0.000333,0.076354,3,687.186567,38.177032,229.062189,68.812744,1,0
0,0,9,9,15,19,34,68,35,103,0.000333,0.17467,7,3668.060709,203.78115,524.008673,139.313982,2,0
0,0,8,8,15,18,33,66,34,100,0.000333,0.168146,7,3531.075884,196.170882,504.439412,133.662009,2,0
0,0,11,11,15,21,36,84,43,127,0.000333,0.21886,14,9192.126653,510.673703,656.580475,150.842025,2,0
0,0,16,16,11,26,37,113,60,173,0.000333,0.300412,10,9012.354323,500.686351,901.235432,160.26518,1,0
0,0,4,4,7,8,15,19,14,33,0.000333,0.042976,3,386.782169,21.487898,128.92739,43.651484,1,0
0,0,10,10,9,15,24,43,35,78,0.000333,0.119209,8,2861.0166,158.945367,357.627075,87.132684,1,0
0,0,5,5,8,11,19,36,19,55,0.000333,0.077879,4,934.544053,51.919114,233.636013,62.053748,1,0
0,0,3,3,9,8,17,16,11,27,0.000333,0.036787,4,441.445987,24.524777,110.361497,52.529325,2,0
0,0,11,11,11,18,29,70,34,104,0.000333,0.16841,5,2526.150117,140.341673,505.230023,113.112398,5,0
0,0,5,5,8,10,18,26,15,41,0.000333,0.056989,4,683.8677,37.99265,170.966925,57.219281,1,0
0,0,3,3,7,8,15,23,12,35,0.000333,0.04558,3,410.223513,22.790195,136.741171,43.651484,1,0
0,0,8,8,15,18,33,66,34,100,0.000333,0.168146,7,3531.075884,196.170882,504.439412,133.662009,2,0
0,0,4,4,8,7,15,16,12,28,0.000333,0.036464,4,437.571747,24.309541,109.392937,43.651484,1,0
0,0,13,13,11,22,33,99,50,149,0.000333,0.250538,10,7516.147238,417.563735,751.614724,136.161243,1,0
0,0,18,18,11,28,39,115,64,179,0.000333,0.315362,10,9460.869972,525.603887,946.086997,172.659686,1,0
0,0,3,3,5,6,11,9,8,17,0.000333,0.019603,2,117.620675,6.534482,58.810338,27.119415,1,0
0,0,5,5,10,9,19,20,18,38,0.000333,0.053807,10,1614.212455,89.67847,161.421246,61.748606,1,0
0,0,25,25,12,35,47,382,213,595,0.000333,1.10166,36,118979.2932,6609.960733,3304.980367,222.544456,4,0
0,0,5,5,11,12,23,33,21,54,0.000333,0.081424,5,1221.361728,67.853429,244.272346,81.073298,1,0
0,0,4,4,4,7,11,13,11,24,0.000333,0.027675,2,166.052718,9.225151,83.026359,27.651484,3,0
0,0,11,11,17,19,36,56,41,97,0.000333,0.167161,16,8023.723602,445.762422,501.482725,150.197491,3,0
0,0,7,7,11,19,30,44,28,72,0.000333,0.117765,5,1766.480614,98.137812,353.296123,118.764371,2,0
0,0,9,9,15,19,34,68,35,103,0.000333,0.17467,7,3668.060709,203.78115,524.008673,139.313982,2,0
0,0,4,4,4,7,11,13,11,24,0.000333,0.027675,2,166.052718,9.225151,83.026359,27.651484,3,0
0,0,3,3,9,8,17,16,11,27,0.000333,0.036787,4,441.445987,24.524777,110.361497,52.529325,2,0
0,0,5,5,14,17,31,60,30,90,0.000333,0.148626,7,3121.143676,173.396871,445.877668,122.789837,4,0
0,0,4,4,4,7,11,13,11,24,0.000333,0.027675,2,166.052718,9.225151,83.026359,27.651484,2,0
0,0,6,6,6,14,20,26,32,58,0.000333,0.083557,6,1504.030977,83.557277,250.67183,68.812744,1,0
0,0,7,7,11,19,30,44,28,72,0.000333,0.117765,5,1766.480614,98.137812,353.296123,118.764371,2,0
0,0,4,4,11,15,26,25,19,44,0.000333,0.06894,5,1034.096738,57.449819,206.819348,96.657107,2,0
0,0,5,5,8,10,18,28,17,45,0.000333,0.062549,4,750.5865,41.69925,187.646625,57.219281,1,0
0,0,3,3,10,9,19,37,16,53,0.000333,0.075047,5,1125.700791,62.538933,225.140158,61.748606,10,0
0,0,4,4,10,15,25,32,21,53,0.000333,0.082041,5,1230.62189,68.367883,246.124378,91.82264,1,0
0,0,4,4,5,9,14,15,13,28,0.000333,0.035535,2,213.211876,11.845104,106.605938,40.138965,1,0
0,0,7,7,11,19,30,44,28,72,0.000333,0.117765,5,1766.480614,98.137812,353.296123,118.764371,2,0
0,0,7,7,17,14,31,46,29,75,0.000333,0.123855,16,5945.035572,330.279754,371.564723,122.789837,4,0
0,0,8,8,11,15,26,59,34,93,0.000333,0.145714,10,4371.408938,242.856052,437.140894,96.657107,1,0
0,0,8,8,15,18,33,66,34,100,0.000333,0.168146,7,3531.075884,196.170882,504.439412,133.662009,2,0
0,0,11,11,15,21,36,84,43,127,0.000333,0.21886,14,9192.126653,510.673703,656.580475,150.842025,2,0
0,0,11,11,15,21,36,84,43,127,0.000333,0.21886,14,9192.126653,510.673703,656.580475,150.842025,2,0
0,0,9,9,15,19,34,68,35,103,0.000333,0.17467,7,3668.060709,203.78115,524.008673,139.313982,2,0
0,0,3,3,7,5,12,11,7,18,0.000333,0.02151,3,193.587975,10.754888,64.529325,31.261125,1,0
0,0,6,6,9,15,24,24,26,50,0.000333,0.076416,4,916.9925,50.944028,229.248125,87.132684,1,0
0,0,3,3,9,5,14,16,10,26,0.000333,0.032997,8,791.929824,43.996101,98.991228,40.138965,1,0
0,0,4,4,6,10,16,15,13,28,0.000333,0.037333,3,336,18.666667,112,48.729056,1,0
0,0,4,4,7,13,20,23,18,41,0.000333,0.059066,3,531.597156,29.533175,177.199052,67.757201,1,0
0,0,4,4,6,12,18,16,15,31,0.000333,0.043089,3,387.803025,21.544613,129.267675,58.529325,1,0
0,0,7,7,10,15,25,29,27,56,0.000333,0.086685,5,1300.279733,72.237763,260.055947,91.82264,1,0
0,0,4,4,10,15,25,32,21,53,0.000333,0.082041,5,1230.62189,68.367883,246.124378,91.82264,1,0
0,0,5,5,10,11,21,33,18,51,0.000333,0.074669,5,1120.040943,62.224497,224.008189,71.273029,1,0
0,0,6,6,6,14,20,22,30,52,0.000333,0.074913,6,1348.441566,74.91342,224.740261,68.812744,1,0
0,0,6,6,7,11,18,41,25,66,0.000333,0.091738,6,1651.290301,91.73835,275.21505,57.705232,1,0
0,0,5,5,8,14,22,19,19,38,0.000333,0.056486,4,677.833606,37.657423,169.458402,77.302969,1,0
0,0,4,4,4,7,11,13,11,24,0.000333,0.027675,2,166.052718,9.225151,83.026359,27.651484,3,0
0,0,3,3,7,5,12,11,7,18,0.000333,0.02151,3,193.587975,10.754888,64.529325,31.261125,1,0
0,0,4,4,4,7,11,13,11,24,0.000333,0.027675,2,166.052718,9.225151,83.026359,27.651484,3,0
0,0,4,4,11,10,21,24,14,38,0.000333,0.055636,5,834.54031,46.363351,166.908062,71.273029,3,0
0,0,5,5,8,11,19,36,19,55,0.000333,0.077879,4,934.544053,51.919114,233.636013,62.053748,1,0
0,0,8,8,16,19,35,72,39,111,0.000333,0.189783,16,9109.606638,506.089258,569.350415,144.710623,10,0
0,0,3,3,9,8,17,16,10,26,0.000333,0.035425,4,425.096135,23.616452,106.274034,52.529325,3,0
0,0,4,4,4,7,11,13,11,24,0.000333,0.027675,2,166.052718,9.225151,83.026359,27.651484,3,0
0,0,4,4,6,8,14,17,12,29,0.000333,0.036804,3,331.239878,18.402215,110.413293,39.509775,3,0
0,0,7,7,11,19,30,44,28,72,0.000333,0.117765,5,1766.480614,98.137812,353.296123,118.764371,2,0
0,0,9,9,15,19,34,68,35,103,0.000333,0.17467,7,3668.060709,203.78115,524.008673,139.313982,2,0
0,0,7,7,11,19,30,44,28,72,0.000333,0.117765,5,1766.480614,98.137812,353.296123,118.764371,2,0
0,0,3,3,7,5,12,11,7,18,0.000333,0.02151,3,193.587975,10.754888,64.529325,31.261125,1,0
0,0,7,7,11,19,30,44,28,72,0.000333,0.117765,5,1766.480614,98.137812,353.296123,118.764371,2,0
0,0,6,6,7,11,18,41,25,66,0.000333,0.091738,6,1651.290301,91.73835,275.21505,57.705232,1,0
0,0,5,5,10,7,17,20,16,36,0.000333,0.04905,10,1471.486623,81.749257,147.148662,52.870765,1,0
0,0,4,4,10,8,18,25,15,40,0.000333,0.055599,5,833.985,46.3325,166.797,57.219281,1,0
0,0,3,3,9,8,17,16,11,27,0.000333,0.036787,4,441.445987,24.524777,110.361497,52.529325,2,0
0,0,9,9,10,11,21,31,28,59,0.000333,0.086382,10,2591.467279,143.970404,259.146728,71.273029,1,0
0,0,3,3,8,7,15,11,9,20,0.000333,0.026046,4,312.551248,17.363958,78.137812,43.651484,1,0
0,0,5,5,6,10,16,29,20,49,0.000333,0.065333,6,1176,65.333333,196,48.729056,1,0
0,0,7,7,11,19,30,44,28,72,0.000333,0.117765,5,1766.480614,98.137812,353.296123,118.764371,2,0
0,0,3,3,7,5,12,11,7,18,0.000333,0.02151,3,193.587975,10.754888,64.529325,31.261125,1,0
0,0,7,7,8,17,25,40,32,72,0.000333,0.111453,4,1337.430583,74.301699,334.357646,93.486868,1,0
0,0,9,9,9,19,28,41,45,86,0.000333,0.137811,8,3307.460186,183.747788,413.432523,109.239948,1,0
0,0,4,4,6,8,14,17,12,29,0.000333,0.036804,3,331.239878,18.402215,110.413293,39.509775,3,0
0,0,4,4,5,11,16,13,14,27,0.000333,0.036,2,216,12,108,49.663388,1,0
0,0,14,14,11,23,34,85,48,133,0.000333,0.225544,10,6766.325579,375.906977,676.632558,142.095673,1,0
0,0,5,5,8,12,20,40,23,63,0.000333,0.09076,4,1089.12588,60.506993,272.28147,67.01955,1,0
0,0,3,3,9,8,17,16,11,27,0.000333,0.036787,4,441.445987,24.524777,110.361497,52.529325,2,0
0,0,11,11,15,21,36,84,43,127,0.000333,0.21886,14,9192.126653,510.673703,656.580475,150.842025,2,0
0,0,6,6,14,12,26,41,24,65,0.000333,0.101843,14,4277.400144,237.633341,305.528582,96.322519,5,0
0,0,5,5,8,10,18,28,17,45,0.000333,0.062549,4,750.5865,41.69925,187.646625,57.219281,1,0
0,0,9,9,15,19,34,68,35,103,0.000333,0.17467,7,3668.060709,203.78115,524.008673,139.313982,2,0
0,0,5,5,9,12,21,19,20,39,0.000333,0.0571,4,685.201518,38.066751,171.300379,71.548875,1,0
0,0,3,3,7,8,15,23,12,35,0.000333,0.04558,3,410.223513,22.790195,136.741171,43.651484,1,0
0,0,4,4,5,9,14,15,13,28,0.000333,0.035535,2,213.211876,11.845104,106.605938,40.138965,1,0
0,0,6,6,9,11,20,21,17,38,0.000333,0.054744,4,656.93307,36.496282,164.233268,66.583073,1,0
0,0,5,5,10,11,21,29,17,46,0.000333,0.067349,5,1010.233007,56.124056,202.046601,71.273029,1,0
0,0,5,5,8,13,21,22,19,41,0.000333,0.060028,4,720.340057,40.018892,180.085014,72.105716,1,0
0,0,4,4,6,8,14,17,12,29,0.000333,0.036804,3,331.239878,18.402215,110.413293,39.509775,3,0
0,0,4,4,5,9,14,15,13,28,0.000333,0.035535,2,213.211876,11.845104,106.605938,40.138965,1,0
0,0,4,4,7,12,19,17,20,37,0.000333,0.052391,3,471.519954,26.195553,157.173318,62.671034,1,0
0,0,4,4,4,7,11,27,15,42,0.000333,0.048432,4,581.184512,32.288028,145.296128,27.651484,3,0
0,0,9,9,12,14,26,48,35,83,0.000333,0.130045,12,4681.637959,260.090998,390.136497,96.322519,1,0
0,0,3,3,5,6,11,9,8,17,0.000333,0.019603,2,117.620675,6.534482,58.810338,27.119415,1,0
0,0,3,3,8,7,15,20,12,32,0.000333,0.041673,4,500.081996,27.782333,125.020499,43.651484,1,0
0,0,3,3,8,8,16,20,12,32,0.000333,0.042667,4,512,28.444444,128,48,1,0
0,0,5,5,10,10,20,26,15,41,0.000333,0.059066,5,885.995259,49.221959,177.199052,66.438562,1,0
0,0,3,3,9,8,17,16,10,26,0.000333,0.035425,4,425.096135,23.616452,106.274034,52.529325,3,0
0,0,3,3,8,8,16,20,12,32,0.000333,0.042667,4,512,28.444444,128,48,1,0
0,0,3,3,8,8,16,20,12,32,0.000333,0.042667,4,512,28.444444,128,48,1,0
0,0,19,19,21,26,47,149,82,231,0.000333,0.427703,30,38493.30074,2138.516708,1283.110025,214.450099,11,0
0,0,8,8,12,16,28,38,29,67,0.000333,0.107364,6,1932.556679,107.36426,322.09278,107.01955,1,0
0,0,25,25,12,35,47,382,213,595,0.000333,1.10166,36,118979.2932,6609.960733,3304.980367,222.544456,4,0
0,0,5,5,11,12,23,33,21,54,0.000333,0.081424,5,1221.361728,67.853429,244.272346,81.073298,1,0
0,0,4,4,4,7,11,13,11,24,0.000333,0.027675,2,166.052718,9.225151,83.026359,27.651484,3,0
0,0,25,25,12,35,47,382,213,595,0.000333,1.10166,36,118979.2932,6609.960733,3304.980367,222.544456,4,0
0,0,5,5,11,12,23,33,21,54,0.000333,0.081424,5,1221.361728,67.853429,244.272346,81.073298,1,0
0,0,8,8,15,18,33,66,34,100,0.000333,0.168146,7,3531.075884,196.170882,504.439412,133.662009,2,0
0,0,3,3,9,8,17,16,11,27,0.000333,0.036787,4,441.445987,24.524777,110.361497,52.529325,2,0
0,0,9,9,15,20,35,72,36,108,0.000333,0.184654,7,3877.737961,215.429887,553.962566,145.041921,2,0
0,0,8,8,13,14,27,39,29,68,0.000333,0.107777,12,3879.988202,215.5549,323.33235,101.408685,1,0
0,0,4,4,6,9,15,16,12,28,0.000333,0.036464,3,328.17881,18.232156,109.392937,44.0391,1,0
0,0,4,4,5,10,15,13,13,26,0.000333,0.03386,2,203.158311,11.286573,101.579155,44.828921,1,0
0,0,5,5,11,12,23,33,18,51,0.000333,0.076901,5,1153.508299,64.083794,230.70166,81.073298,3,0
0,0,4,4,5,7,12,14,10,24,0.000333,0.02868,2,172.0782,9.5599,86.0391,31.261125,2,0
0,0,7,7,11,19,30,44,28,72,0.000333,0.117765,5,1766.480614,98.137812,353.296123,118.764371,2,0
0,0,5,5,7,7,14,16,11,27,0.000333,0.034266,3,308.395749,17.133097,102.798583,39.302969,1,0
0,0,4,4,4,8,12,15,13,28,0.000333,0.03346,2,200.7579,11.153217,100.37895,32,1,0
0,0,9,9,11,18,29,35,42,77,0.000333,0.124688,10,3740.645366,207.813631,374.064537,113.112398,1,0
0,0,3,3,8,7,15,11,9,20,0.000333,0.026046,4,312.551248,17.363958,78.137812,43.651484,1,0
0,0,4,4,4,7,11,13,11,24,0.000333,0.027675,2,166.052718,9.225151,83.026359,27.651484,3,0
0,0,7,7,11,19,30,44,28,72,0.000333,0.117765,5,1766.480614,98.137812,353.296123,118.764371,2,0
0,0,6,6,14,12,26,41,24,65,0.000333,0.101843,14,4277.400144,237.633341,305.528582,96.322519,5,0
0,0,4,4,7,11,18,24,17,41,0.000333,0.056989,3,512.900775,28.494488,170.966925,57.705232,1,0
0,0,6,6,7,13,20,35,24,59,0.000333,0.084998,3,764.981273,42.49896,254.993758,67.757201,1,0
0,0,3,3,8,7,15,11,9,20,0.000333,0.026046,4,312.551248,17.363958,78.137812,43.651484,1,0
0,0,8,8,15,18,33,66,34,100,0.000333,0.168146,7,3531.075884,196.170882,504.439412,133.662009,2,0
0,0,5,5,8,10,18,28,17,45,0.000333,0.062549,4,750.5865,41.69925,187.646625,57.219281,1,0
0,0,3,3,7,8,15,23,12,35,0.000333,0.04558,3,410.223513,22.790195,136.741171,43.651484,1,0
0,0,4,4,9,8,17,21,14,35,0.000333,0.047687,4,572.244798,31.791378,143.061199,52.529325,1,0
0,0,7,7,11,19,30,44,28,72,0.000333,0.117765,5,1766.480614,98.137812,353.296123,118.764371,2,0
0,0,5,5,8,8,16,19,12,31,0.000333,0.041333,4,496,27.555556,124,48,1,0
0,0,3,3,7,5,12,11,7,18,0.000333,0.02151,3,193.587975,10.754888,64.529325,31.261125,1,0
0,0,5,5,8,12,20,25,19,44,0.000333,0.063388,4,760.659345,42.258852,190.164836,67.01955,1,0
0,0,9,9,15,19,34,68,35,103,0.000333,0.17467,7,3668.060709,203.78115,524.008673,139.313982,2,0
0,0,4,4,4,7,11,13,11,24,0.000333,0.027675,2,166.052718,9.225151,83.026359,27.651484,3,0
0,0,36,36,16,62,78,272,185,457,0.000333,0.957476,16,45958.86102,2553.270057,2872.428814,433.160171,4,0
0,0,7,7,11,19,30,44,28,72,0.000333,0.117765,5,1766.480614,98.137812,353.296123,118.764371,2,0
0,0,3,3,8,7,15,11,9,20,0.000333,0.026046,4,312.551248,17.363958,78.137812,43.651484,1,0
0,0,8,8,16,17,33,49,35,84,0.000333,0.141243,16,6779.665696,376.648094,423.729106,133.486868,4,0
0,0,9,9,15,19,34,68,35,103,0.000333,0.17467,7,3668.060709,203.78115,524.008673,139.313982,2,0
0,0,4,4,6,11,17,14,14,28,0.000333,0.03815,3,343.346879,19.074827,114.44896,53.563523,1,0
0,0,4,4,8,7,15,15,10,25,0.000333,0.032557,4,390.68906,21.704948,97.672265,43.651484,1,0
0,0,3,3,7,5,12,11,7,18,0.000333,0.02151,3,193.587975,10.754888,64.529325,31.261125,1,0
0,0,5,5,11,11,22,31,17,48,0.000333,0.071351,5,1070.263588,59.459088,214.052718,76.107496,1,0
0,0,9,9,15,19,34,68,35,103,0.000333,0.17467,7,3668.060709,203.78115,524.008673,139.313982,2,0
0,0,11,11,15,21,36,84,43,127,0.000333,0.21886,14,9192.126653,510.673703,656.580475,150.842025,2,0
0,0,8,8,15,18,33,66,34,100,0.000333,0.168146,7,3531.075884,196.170882,504.439412,133.662009,2,0
0,0,7,7,11,19,30,44,28,72,0.000333,0.117765,5,1766.480614,98.137812,353.296123,118.764371,2,0
0,0,5,5,8,11,19,36,19,55,0.000333,0.077879,4,934.544053,51.919114,233.636013,62.053748,1,0
0,0,7,7,11,18,29,48,28,76,0.000333,0.123069,5,1846.032778,102.557377,369.206556,113.112398,1,0
0,0,9,9,14,18,32,49,26,75,0.000333,0.125,7,2625,145.833333,375,128.361619,5,0
0,0,6,6,9,16,25,37,32,69,0.000333,0.106809,8,2563.408617,142.41159,320.426077,92.529325,1,0
0,0,3,3,7,8,15,23,12,35,0.000333,0.04558,3,410.223513,22.790195,136.741171,43.651484,1,0
0,0,5,5,8,9,17,25,15,40,0.000333,0.0545,4,653.994055,36.333003,163.498514,52.529325,1,0
0,0,5,5,9,7,16,40,20,60,0.000333,0.08,8,1920,106.666667,240,48.180809,6,0
0,0,7,7,8,14,22,51,25,76,0.000333,0.112972,4,1355.667212,75.314845,338.916803,77.302969,11,0
0,0,7,7,11,19,30,44,28,72,0.000333,0.117765,5,1766.480614,98.137812,353.296123,118.764371,2,0
0,0,3,3,7,8,15,23,12,35,0.000333,0.04558,3,410.223513,22.790195,136.741171,43.651484,1,0
0,0,6,6,14,12,26,41,24,65,0.000333,0.101843,14,4277.400144,237.633341,305.528582,96.322519,5,0
0,0,4,4,6,9,15,16,12,28,0.000333,0.036464,3,328.17881,18.232156,109.392937,44.0391,1,0
0,0,4,4,6,8,14,17,12,29,0.000333,0.036804,3,331.239878,18.402215,110.413293,39.509775,3,0
0,0,5,5,12,13,25,28,18,46,0.000333,0.071206,6,1281.704308,71.205795,213.617385,91.125266,3,0
0,0,8,8,15,18,33,66,34,100,0.000333,0.168146,7,3531.075884,196.170882,504.439412,133.662009,2,0
0,0,3,3,7,8,15,23,12,35,0.000333,0.04558,3,410.223513,22.790195,136.741171,43.651484,1,0
0,0,5,5,12,16,28,39,25,64,0.000333,0.102557,6,1846.02429,102.556905,307.670715,107.01955,2,0
0,0,9,9,8,14,22,38,32,70,0.000333,0.104053,8,2497.281706,138.737873,312.160213,77.302969,1,0
0,0,9,9,15,19,34,68,35,103,0.000333,0.17467,7,3668.060709,203.78115,524.008673,139.313982,2,0
0,0,8,8,12,15,27,42,27,69,0.000333,0.109362,6,1968.523426,109.362413,328.087238,101.622909,2,0
0,0,8,8,15,18,33,66,34,100,0.000333,0.168146,7,3531.075884,196.170882,504.439412,133.662009,2,0
0,0,10,10,15,20,35,80,41,121,0.000333,0.206881,14,8689.005431,482.722524,620.643245,145.041921,2,0
0,0,5,5,7,7,14,16,11,27,0.000333,0.034266,3,308.395749,17.133097,102.798583,39.302969,1,0
0,0,5,5,8,10,18,28,17,45,0.000333,0.062549,4,750.5865,41.69925,187.646625,57.219281,1,0
0,0,4,4,10,15,25,32,21,53,0.000333,0.082041,5,1230.62189,68.367883,246.124378,91.82264,1,0
0,0,3,3,9,8,17,16,11,27,0.000333,0.036787,4,441.445987,24.524777,110.361497,52.529325,2,0
0,0,7,7,11,19,30,44,28,72,0.000333,0.117765,5,1766.480614,98.137812,353.296123,118.764371,2,0
0,0,4,4,4,7,11,13,11,24,0.000333,0.027675,2,166.052718,9.225151,83.026359,27.651484,3,0
0,0,11,11,12,18,30,49,30,79,0.000333,0.129215,6,2325.866142,129.214786,387.644357,118.0782,3,0
0,0,3,3,8,7,15,15,9,24,0.000333,0.031255,4,375.061497,20.83675,93.765374,43.651484,3,0
0,0,3,3,9,8,17,16,11,27,0.000333,0.036787,4,441.445987,24.524777,110.361497,52.529325,2,0
0,0,4,4,4,7,11,13,11,24,0.000333,0.027675,2,166.052718,9.225151,83.026359,27.651484,3,0
0,0,5,5,7,15,22,31,26,57,0.000333,0.084729,3,762.562807,42.3646,254.187602,78.254843,1,0
0,0,10,10,14,18,32,51,39,90,0.000333,0.15,14,6300,350,450,128.361619,2,0
0,0,5,5,12,16,28,39,25,64,0.000333,0.102557,6,1846.02429,102.556905,307.670715,107.01955,2,0
0,0,3,3,9,8,17,16,11,27,0.000333,0.036787,4,441.445987,24.524777,110.361497,52.529325,2,0
0,0,9,9,15,19,34,68,35,103,0.000333,0.17467,7,3668.060709,203.78115,524.008673,139.313982,2,0
0,0,11,11,15,21,36,84,43,127,0.000333,0.21886,14,9192.126653,510.673703,656.580475,150.842025,2,0
0,0,5,5,11,12,23,33,21,54,0.000333,0.081424,5,1221.361728,67.853429,244.272346,81.073298,1,0
0,0,8,8,15,18,33,66,34,100,0.000333,0.168146,7,3531.075884,196.170882,504.439412,133.662009,2,0
0,0,25,25,12,35,47,382,213,595,0.000333,1.10166,36,118979.2932,6609.960733,3304.980367,222.544456,4,0
0,0,3,3,7,8,15,23,12,35,0.000333,0.04558,3,410.223513,22.790195,136.741171,43.651484,1,0
0,0,9,9,15,20,35,72,36,108,0.000333,0.184654,7,3877.737961,215.429887,553.962566,145.041921,2,0
0,0,3,3,8,6,14,11,9,20,0.000333,0.025382,4,304.588394,16.921577,76.147098,39.509775,1,0
0,0,14,14,11,23,34,85,48,133,0.000333,0.225544,10,6766.325579,375.906977,676.632558,142.095673,1,0
0,0,3,3,9,8,17,16,11,27,0.000333,0.036787,4,441.445987,24.524777,110.361497,52.529325,2,0
0,0,4,4,10,7,17,29,15,44,0.000333,0.059949,10,1798.48365,99.915758,179.848365,52.870765,2,0
0,0,8,8,15,18,33,66,34,100,0.000333,0.168146,7,3531.075884,196.170882,504.439412,133.662009,2,0
0,0,5,5,8,10,18,28,17,45,0.000333,0.062549,4,750.5865,41.69925,187.646625,57.219281,1,0
0,0,9,9,15,20,35,72,36,108,0.000333,0.184654,7,3877.737961,215.429887,553.962566,145.041921,2,0
0,0,3,3,8,7,15,21,11,32,0.000333,0.041673,4,500.081996,27.782333,125.020499,43.651484,1,0
0,0,20,20,19,27,46,157,73,230,0.000333,0.423473,18,22867.5465,1270.41925,1270.41925,209.092585,10,0
0,0,6,6,8,13,21,29,22,51,0.000333,0.074669,4,896.032754,49.779597,224.008189,72.105716,1,0
0,0,9,9,14,16,30,38,26,64,0.000333,0.10468,7,2198.286987,122.127055,314.040998,117.302969,2,0
0,0,4,4,4,7,11,13,11,24,0.000333,0.027675,2,166.052718,9.225151,83.026359,27.651484,3,0
0,0,3,3,9,8,17,16,11,27,0.000333,0.036787,4,441.445987,24.524777,110.361497,52.529325,2,0
0,0,24,24,22,43,65,158,101,259,0.000333,0.519931,22,34315.4518,1906.413989,1559.793264,331.43688,6,0
0,0,3,3,7,5,12,11,7,18,0.000333,0.02151,3,193.587975,10.754888,64.529325,31.261125,1,0
0,0,7,7,11,19,30,44,28,72,0.000333,0.117765,5,1766.480614,98.137812,353.296123,118.764371,2,0
0,0,6,6,7,14,21,34,24,58,0.000333,0.084918,3,764.263232,42.459068,254.754411,72.954453,1,0
0,0,3,3,7,14,21,20,19,39,0.000333,0.0571,3,513.901138,28.550063,171.300379,72.954453,1,0
0,0,5,5,7,16,23,31,26,57,0.000333,0.085948,3,773.529094,42.973839,257.843031,83.651484,1,0
0,0,7,7,11,19,30,44,28,72,0.000333,0.117765,5,1766.480614,98.137812,353.296123,118.764371,2,0
0,0,4,4,8,11,19,27,17,44,0.000333,0.062303,4,747.635242,41.535291,186.908811,62.053748,1,0
0,0,4,4,10,9,19,22,13,35,0.000333,0.049559,5,743.387315,41.299295,148.677463,61.748606,1,0
0,0,3,3,7,8,15,23,12,35,0.000333,0.04558,3,410.223513,22.790195,136.741171,43.651484,1,0
0,0,8,8,15,18,33,66,34,100,0.000333,0.168146,7,3531.075884,196.170882,504.439412,133.662009,2,0
0,0,11,11,15,21,36,84,43,127,0.000333,0.21886,14,9192.126653,510.673703,656.580475,150.842025,2,0
0,0,3,3,8,8,16,20,12,32,0.000333,0.042667,4,512,28.444444,128,48,1,0
0,0,5,5,10,10,20,27,14,41,0.000333,0.059066,5,885.995259,49.221959,177.199052,66.438562,3,0
0,0,20,20,14,27,41,208,68,276,0.000333,0.492895,14,20701.58095,1150.08783,1478.684353,181.684931,11,0
0,0,7,7,11,19,30,44,28,72,0.000333,0.117765,5,1766.480614,98.137812,353.296123,118.764371,2,0
0,0,7,7,11,18,29,48,28,76,0.000333,0.123069,5,1846.032778,102.557377,369.206556,113.112398,1,0
0,0,3,3,9,7,16,24,10,34,0.000333,0.045333,4,544,30.222222,136,48.180809,3,0
0,0,5,5,11,12,23,33,21,54,0.000333,0.081424,5,1221.361728,67.853429,244.272346,81.073298,1,0
0,0,5,5,8,11,19,30,18,48,0.000333,0.067967,4,815.602083,45.311227,203.900521,62.053748,1,0
0,0,5,5,8,12,20,20,17,37,0.000333,0.053304,4,639.645358,35.535853,159.91134,67.01955,1,0
0,0,7,7,11,19,30,44,28,72,0.000333,0.117765,5,1766.480614,98.137812,353.296123,118.764371,2,0
0,0,9,9,9,13,22,30,34,64,0.000333,0.095135,8,2283.228989,126.846055,285.403624,76.635041,1,0
0,0,7,7,11,19,30,44,28,72,0.000333,0.117765,5,1766.480614,98.137812,353.296123,118.764371,2,0
0,0,6,6,8,12,20,31,24,55,0.000333,0.079235,8,1901.648362,105.647131,237.706045,67.01955,1,0
0,0,3,3,9,8,17,16,11,27,0.000333,0.036787,4,441.445987,24.524777,110.361497,52.529325,2,0
0,0,5,5,7,7,14,16,11,27,0.000333,0.034266,3,308.395749,17.133097,102.798583,39.302969,1,0
0,0,3,3,7,8,15,23,12,35,0.000333,0.04558,3,410.223513,22.790195,136.741171,43.651484,1,0
0,0,11,11,13,21,34,91,48,139,0.000333,0.235719,12,8485.888019,471.438223,707.157335,140.344382,2,0
0,0,3,3,7,8,15,23,12,35,0.000333,0.04558,3,410.223513,22.790195,136.741171,43.651484,1,0
0,0,4,4,6,8,14,17,12,29,0.000333,0.036804,3,331.239878,18.402215,110.413293,39.509775,3,0
0,0,3,3,8,6,14,11,9,20,0.000333,0.025382,4,304.588394,16.921577,76.147098,39.509775,1,0
0,0,5,5,11,12,23,33,21,54,0.000333,0.081424,5,1221.361728,67.853429,244.272346,81.073298,1,0
0,0,4,4,9,9,18,28,15,43,0.000333,0.059769,4,717.2271,39.84595,179.306775,57.05865,1,0
0,0,3,3,5,5,10,12,7,19,0.000333,0.021039,2,126.233268,7.012959,63.116634,23.219281,1,0
0,0,11,11,15,21,36,84,43,127,0.000333,0.21886,14,9192.126653,510.673703,656.580475,150.842025,2,0
0,0,9,9,15,19,34,68,35,103,0.000333,0.17467,7,3668.060709,203.78115,524.008673,139.313982,2,0
0,0,18,18,11,28,39,116,64,180,0.000333,0.317124,10,9513.723994,528.540222,951.372399,172.659686,5,0
0,0,4,4,9,9,18,19,15,34,0.000333,0.047259,4,567.1098,31.5061,141.77745,57.05865,1,0
0,0,5,5,10,11,21,29,17,46,0.000333,0.067349,5,1010.233007,56.124056,202.046601,71.273029,1,0
0,0,9,9,10,17,27,30,39,69,0.000333,0.109362,10,3280.872376,182.270688,328.087238,102.706149,1,0
0,0,8,8,16,17,33,49,35,84,0.000333,0.141243,16,6779.665696,376.648094,423.729106,133.486868,4,0
0,0,5,5,10,12,22,21,17,38,0.000333,0.056486,5,847.292008,47.071778,169.458402,76.238831,1,0
0,0,3,3,8,7,15,20,12,32,0.000333,0.041673,4,500.081996,27.782333,125.020499,43.651484,1,0
0,0,3,3,9,8,17,16,11,27,0.000333,0.036787,4,441.445987,24.524777,110.361497,52.529325,2,0
0,0,6,6,5,14,19,22,31,53,0.000333,0.075047,4,900.560633,50.031146,225.140158,64.912609,1,0
0,0,9,9,15,19,34,68,35,103,0.000333,0.17467,7,3668.060709,203.78115,524.008673,139.313982,2,0
0,0,3,3,9,8,17,16,11,27,0.000333,0.036787,4,441.445987,24.524777,110.361497,52.529325,2,0
0,0,6,6,8,18,26,34,33,67,0.000333,0.104976,4,1259.717844,69.984325,314.929461,99.05865,1,0
0,0,4,4,8,16,24,23,26,49,0.000333,0.074888,4,898.65265,49.925147,224.663163,88,1,0
0,0,4,4,9,9,18,19,15,34,0.000333,0.047259,4,567.1098,31.5061,141.77745,57.05865,1,0
0,0,5,5,8,10,18,26,15,41,0.000333,0.056989,4,683.8677,37.99265,170.966925,57.219281,1,0
0,0,10,10,14,16,30,51,35,86,0.000333,0.140664,14,5907.896277,328.21646,421.992591,117.302969,2,0
0,0,4,4,4,7,11,13,11,24,0.000333,0.027675,2,166.052718,9.225151,83.026359,27.651484,3,0
0,0,3,3,7,8,15,23,12,35,0.000333,0.04558,3,410.223513,22.790195,136.741171,43.651484,1,0
0,0,7,7,11,19,30,44,28,72,0.000333,0.117765,5,1766.480614,98.137812,353.296123,118.764371,2,0
0,0,20,20,12,28,40,98,63,161,0.000333,0.28561,12,10281.96508,571.220282,856.830423,177.625488,1,0
0,0,11,11,15,21,36,84,43,127,0.000333,0.21886,14,9192.126653,510.673703,656.580475,150.842025,2,0
0,0,8,8,15,18,33,66,34,100,0.000333,0.168146,7,3531.075884,196.170882,504.439412,133.662009,2,0
0,0,9,9,15,19,34,68,35,103,0.000333,0.17467,7,3668.060709,203.78115,524.008673,139.313982,2,0
0,0,5,5,12,16,28,39,25,64,0.000333,0.102557,6,1846.02429,102.556905,307.670715,107.01955,2,0
0,0,3,3,9,8,17,16,11,27,0.000333,0.036787,4,441.445987,24.524777,110.361497,52.529325,2,0
0,0,5,5,8,10,18,28,17,45,0.000333,0.062549,4,750.5865,41.69925,187.646625,57.219281,1,0
0,0,4,4,9,7,16,17,12,29,0.000333,0.038667,4,464,25.777778,116,48.180809,1,0
0,0,7,7,8,10,18,29,21,50,0.000333,0.069499,8,1667.970001,92.665,208.49625,57.219281,1,0
0,0,4,4,6,13,19,16,16,32,0.000333,0.045311,3,407.801041,22.655613,135.93368,63.615491,1,0
0,0,3,3,11,11,22,26,15,41,0.000333,0.060946,5,914.183482,50.787971,182.836696,76.107496,3,0
0,0,3,3,8,8,16,20,12,32,0.000333,0.042667,4,512,28.444444,128,48,1,0
0,0,25,25,12,35,47,382,213,595,0.000333,1.10166,36,118979.2932,6609.960733,3304.980367,222.544456,4,0
0,0,5,5,11,12,23,33,21,54,0.000333,0.081424,5,1221.361728,67.853429,244.272346,81.073298,1,0
0,0,3,3,6,9,15,26,11,37,0.000333,0.048185,3,433.664856,24.092492,144.554952,44.0391,1,0
0,0,4,4,11,9,20,35,15,50,0.000333,0.072032,5,1080.482024,60.026779,216.096405,66.583073,2,0
0,0,4,4,6,9,15,16,12,28,0.000333,0.036464,3,328.17881,18.232156,109.392937,44.0391,1,0
0,0,8,8,15,18,33,66,34,100,0.000333,0.168146,7,3531.075884,196.170882,504.439412,133.662009,2,0
0,0,9,9,15,20,35,72,36,108,0.000333,0.184654,7,3877.737961,215.429887,553.962566,145.041921,2,0
0,0,10,10,8,12,20,46,37,83,0.000333,0.119573,12,4304.640383,239.146688,358.720032,67.01955,1,0
0,0,5,5,8,10,18,28,17,45,0.000333,0.062549,4,750.5865,41.69925,187.646625,57.219281,1,0
0,0,11,11,15,21,36,84,43,127,0.000333,0.21886,14,9192.126653,510.673703,656.580475,150.842025,2,0
0,0,4,4,4,7,11,13,11,24,0.000333,0.027675,2,166.052718,9.225151,83.026359,27.651484,3,0
0,0,8,8,15,18,33,66,34,100,0.000333,0.168146,7,3531.075884,196.170882,504.439412,133.662009,2,0
0,0,5,5,9,12,21,22,18,40,0.000333,0.058564,4,702.770788,39.042822,175.692697,71.548875,1,0
0,0,7,7,10,13,23,38,25,63,0.000333,0.094995,5,1424.922016,79.162334,284.984403,81.324997,1,0
0,0,4,4,4,10,14,16,13,29,0.000333,0.036804,2,220.826585,12.268144,110.413293,41.219281,1,0
0,0,5,5,9,7,16,23,16,39,0.000333,0.052,8,1248,69.333333,156,48.180809,1,0
0,0,5,5,8,11,19,36,19,55,0.000333,0.077879,4,934.544053,51.919114,233.636013,62.053748,1,0
0,0,6,6,8,16,24,34,30,64,0.000333,0.097813,4,1173.7504,65.208356,293.4376,88,1,0
0,0,4,4,5,10,15,13,13,26,0.000333,0.03386,2,203.158311,11.286573,101.579155,44.828921,1,0
0,0,7,7,11,19,30,44,28,72,0.000333,0.117765,5,1766.480614,98.137812,353.296123,118.764371,2,0
0,0,3,3,11,11,22,26,15,41,0.000333,0.060946,5,914.183482,50.787971,182.836696,76.107496,3,0
0,0,6,6,14,11,25,40,23,63,0.000333,0.097521,14,4095.881159,227.548953,292.56294,91.356717,4,0
0,0,6,6,14,11,25,38,23,61,0.000333,0.094425,14,3965.853186,220.325177,283.275228,91.356717,4,0
0,0,6,6,13,11,24,44,20,64,0.000333,0.097813,6,1760.6256,97.812533,293.4376,86.159464,5,0
0,0,3,3,5,6,11,9,8,17,0.000333,0.019603,2,117.620675,6.534482,58.810338,27.119415,1,0
0,0,5,5,8,14,22,28,29,57,0.000333,0.084729,8,2033.500818,112.972268,254.187602,77.302969,1,0
0,0,3,3,10,8,18,16,13,29,0.000333,0.040309,5,604.639125,33.591063,120.927825,57.219281,3,0
0,0,3,3,8,8,16,20,12,32,0.000333,0.042667,4,512,28.444444,128,48,1,0
0,0,5,5,8,10,18,28,17,45,0.000333,0.062549,4,750.5865,41.69925,187.646625,57.219281,1,0
0,0,15,15,12,22,34,99,56,155,0.000333,0.262852,12,9462.680885,525.704494,788.55674,141.127046,20,0
0,0,3,3,5,6,11,9,8,17,0.000333,0.019603,2,117.620675,6.534482,58.810338,27.119415,1,0
0,0,8,8,15,18,33,66,34,100,0.000333,0.168146,7,3531.075884,196.170882,504.439412,133.662009,2,0
0,0,11,11,15,21,36,84,43,127,0.000333,0.21886,14,9192.126653,510.673703,656.580475,150.842025,2,0
0,0,3,3,7,5,12,11,7,18,0.000333,0.02151,3,193.587975,10.754888,64.529325,31.261125,1,0
0,0,4,4,8,7,15,16,11,27,0.000333,0.035162,4,421.944184,23.441344,105.486046,43.651484,1,0
0,0,3,3,8,7,15,15,9,24,0.000333,0.031255,4,375.061497,20.83675,93.765374,43.651484,3,0
0,0,4,4,6,8,14,17,12,29,0.000333,0.036804,3,331.239878,18.402215,110.413293,39.509775,3,0
0,0,3,3,7,5,12,11,7,18,0.000333,0.02151,3,193.587975,10.754888,64.529325,31.261125,1,0
0,0,8,8,12,16,28,40,30,70,0.000333,0.112172,6,2019.089067,112.171615,336.514845,107.01955,1,0
0,0,3,3,9,8,17,16,11,27,0.000333,0.036787,4,441.445987,24.524777,110.361497,52.529325,2,0
0,0,5,5,7,7,14,19,13,32,0.000333,0.040612,3,365.506073,20.305893,121.835358,39.302969,1,0
0,0,3,3,9,8,17,16,11,27,0.000333,0.036787,4,441.445987,24.524777,110.361497,52.529325,2,0
0,0,5,5,7,7,14,16,11,27,0.000333,0.034266,3,308.395749,17.133097,102.798583,39.302969,1,0
0,0,5,5,10,11,21,29,17,46,0.000333,0.067349,5,1010.233007,56.124056,202.046601,71.273029,1,0
0,0,4,4,7,9,16,46,28,74,0.000333,0.098667,9,2664,148,296,48.180809,1,0
0,0,15,15,12,22,34,99,56,155,0.000333,0.262852,12,9462.680885,525.704494,788.55674,141.127046,2,0
0,0,3,3,7,8,15,23,12,35,0.000333,0.04558,3,410.223513,22.790195,136.741171,43.651484,1,0
0,0,5,5,8,10,18,28,17,45,0.000333,0.062549,4,750.5865,41.69925,187.646625,57.219281,1,0
0,0,3,3,6,9,15,26,11,37,0.000333,0.048185,3,433.664856,24.092492,144.554952,44.0391,1,0
0,0,4,4,6,8,14,17,12,29,0.000333,0.036804,3,331.239878,18.402215,110.413293,39.509775,3,0
0,0,3,3,9,7,16,24,10,34,0.000333,0.045333,4,544,30.222222,136,48.180809,3,0
0,0,3,3,8,6,14,11,9,20,0.000333,0.025382,4,304.588394,16.921577,76.147098,39.509775,1,0
0,0,4,4,11,10,21,36,17,53,0.000333,0.077598,5,1163.964117,64.664673,232.792823,71.273029,1,0
0,0,4,4,4,7,11,13,11,24,0.000333,0.027675,2,166.052718,9.225151,83.026359,27.651484,2,0
0,0,5,5,8,11,19,30,18,48,0.000333,0.067967,4,815.602083,45.311227,203.900521,62.053748,1,0
0,0,9,9,15,19,34,68,35,103,0.000333,0.17467,7,3668.060709,203.78115,524.008673,139.313982,2,0
0,0,5,5,11,12,23,33,21,54,0.000333,0.081424,5,1221.361728,67.853429,244.272346,81.073298,1,0
0,0,5,5,7,16,23,31,27,58,0.000333,0.087456,3,787.09978,43.727766,262.366593,83.651484,1,0
0,0,4,4,5,12,17,14,15,29,0.000333,0.039512,2,237.072845,13.170714,118.536422,54.62919,1,0
0,0,3,3,7,8,15,23,12,35,0.000333,0.04558,3,410.223513,22.790195,136.741171,43.651484,1,0
0,0,3,3,9,8,17,16,11,27,0.000333,0.036787,4,441.445987,24.524777,110.361497,52.529325,2,0
0,0,3,3,8,6,14,11,9,20,0.000333,0.025382,4,304.588394,16.921577,76.147098,39.509775,1,0
0,0,4,4,10,15,25,32,21,53,0.000333,0.082041,5,1230.62189,68.367883,246.124378,91.82264,1,0
0,0,7,7,6,9,15,37,23,60,0.000333,0.078138,6,1406.480614,78.137812,234.413436,44.0391,1,0
0,0,7,7,11,19,30,44,28,72,0.000333,0.117765,5,1766.480614,98.137812,353.296123,118.764371,2,0
0,0,10,10,7,14,21,57,36,93,0.000333,0.136162,6,2450.913122,136.16184,408.48552,72.954453,1,0
0,0,3,3,7,5,12,11,7,18,0.000333,0.02151,3,193.587975,10.754888,64.529325,31.261125,1,0
0,0,3,3,8,8,16,20,12,32,0.000333,0.042667,4,512,28.444444,128,48,1,0
0,0,5,5,14,10,24,27,14,41,0.000333,0.062661,7,1315.884238,73.10468,187.983463,86.52225,3,0
0,0,3,3,7,5,12,11,7,18,0.000333,0.02151,3,193.587975,10.754888,64.529325,31.261125,1,0
0,0,6,6,8,12,20,20,21,41,0.000333,0.059066,4,708.796208,39.377567,177.199052,67.01955,1,0
0,0,3,3,9,8,17,16,11,27,0.000333,0.036787,4,441.445987,24.524777,110.361497,52.529325,2,0
0,0,3,3,9,8,17,16,11,27,0.000333,0.036787,4,441.445987,24.524777,110.361497,52.529325,2,0
0,0,3,3,9,8,17,16,11,27,0.000333,0.036787,4,441.445987,24.524777,110.361497,52.529325,2,0
0,0,5,5,7,7,14,16,11,27,0.000333,0.034266,3,308.395749,17.133097,102.798583,39.302969,1,0
0,0,3,3,7,5,12,11,7,18,0.000333,0.02151,3,193.587975,10.754888,64.529325,31.261125,1,0
0,0,7,7,6,9,15,37,23,60,0.000333,0.078138,6,1406.480614,78.137812,234.413436,44.0391,1,0
0,0,4,4,6,8,14,17,12,29,0.000333,0.036804,3,331.239878,18.402215,110.413293,39.509775,3,0
0,0,8,8,15,18,33,66,34,100,0.000333,0.168146,7,3531.075884,196.170882,504.439412,133.662009,2,0
0,0,10,10,17,20,37,55,40,95,0.000333,0.164966,16,7918.369116,439.909395,494.89807,155.92543,4,0
0,0,3,3,8,7,15,11,9,20,0.000333,0.026046,4,312.551248,17.363958,78.137812,43.651484,1,0
0,0,4,4,10,15,25,32,21,53,0.000333,0.082041,5,1230.62189,68.367883,246.124378,91.82264,1,0
0,0,5,5,9,8,17,29,19,48,0.000333,0.065399,8,1569.585731,87.199207,196.198216,52.529325,1,0
0,0,3,3,8,8,16,20,12,32,0.000333,0.042667,4,512,28.444444,128,48,1,0
0,0,7,7,16,14,30,45,29,74,0.000333,0.121037,16,5809.758465,322.764359,363.109904,117.302969,4,0
0,0,3,3,9,12,21,15,14,29,0.000333,0.042459,4,509.508821,28.306046,127.377205,71.548875,2,0
0,0,25,25,12,35,47,382,213,595,0.000333,1.10166,36,118979.2932,6609.960733,3304.980367,222.544456,4,0
0,0,5,5,11,12,23,33,21,54,0.000333,0.081424,5,1221.361728,67.853429,244.272346,81.073298,1,0
0,0,4,4,4,7,11,13,11,24,0.000333,0.027675,2,166.052718,9.225151,83.026359,27.651484,3,0
0,0,3,3,9,8,17,16,11,27,0.000333,0.036787,4,441.445987,24.524777,110.361497,52.529325,2,0
0,0,4,4,4,7,11,13,11,24,0.000333,0.027675,2,166.052718,9.225151,83.026359,27.651484,3,0
0,0,13,13,12,19,31,81,44,125,0.000333,0.206425,12,7431.294466,412.849693,619.274539,123.730173,2,0
0,0,4,4,6,12,18,16,15,31,0.000333,0.043089,3,387.803025,21.544613,129.267675,58.529325,1,0
0,0,4,4,8,8,16,18,12,30,0.000333,0.04,4,480,26.666667,120,48,1,0
0,0,5,5,13,9,22,25,14,39,0.000333,0.057973,6,1043.506999,57.972611,173.917833,76.635041,2,0
0,0,3,3,8,7,15,11,9,20,0.000333,0.026046,4,312.551248,17.363958,78.137812,43.651484,1,0
0,0,4,4,8,7,15,15,10,25,0.000333,0.032557,4,390.68906,21.704948,97.672265,43.651484,1,0
0,0,11,11,15,21,36,84,43,127,0.000333,0.21886,14,9192.126653,510.673703,656.580475,150.842025,2,0
0,0,25,25,12,35,47,382,213,595,0.000333,1.10166,36,118979.2932,6609.960733,3304.980367,222.544456,4,0
0,0,5,5,11,12,23,33,21,54,0.000333,0.081424,5,1221.361728,67.853429,244.272346,81.073298,1,0
0,0,7,7,8,13,21,20,24,44,0.000333,0.064421,4,773.047866,42.947104,193.261967,72.105716,1,0
0,0,4,4,4,7,11,13,11,24,0.000333,0.027675,2,166.052718,9.225151,83.026359,27.651484,3,0
0,0,6,6,14,12,26,43,26,69,0.000333,0.10811,14,4540.624768,252.256932,324.330341,96.322519,4,0
0,0,11,11,12,18,30,69,40,109,0.000333,0.178284,12,6418.212899,356.567383,534.851075,118.0782,7,0
0,0,3,3,10,8,18,16,13,29,0.000333,0.040309,5,604.639125,33.591063,120.927825,57.219281,3,0
0,0,5,5,8,10,18,28,17,45,0.000333,0.062549,4,750.5865,41.69925,187.646625,57.219281,1,0
0,0,4,4,8,11,19,27,17,44,0.000333,0.062303,4,747.635242,41.535291,186.908811,62.053748,1,0
0,0,6,6,8,13,21,42,25,67,0.000333,0.098095,4,1177.141069,65.396726,294.285267,72.105716,1,0
0,0,3,3,13,10,23,21,15,36,0.000333,0.054283,6,977.089383,54.282743,162.84823,81.324997,3,0
0,0,8,8,12,13,25,41,24,65,0.000333,0.100617,6,1811.103914,100.616884,301.850652,91.125266,4,0
0,0,8,8,12,12,24,42,26,68,0.000333,0.103926,12,3741.329401,207.851633,311.77745,86.0391,4,0
0,0,4,4,6,5,11,24,12,36,0.000333,0.041513,6,747.23723,41.513179,124.539538,27.119415,1,0
0,0,5,5,10,9,19,35,18,53,0.000333,0.075047,10,2251.401582,125.077866,225.140158,61.748606,4,0
0,0,5,5,10,10,20,26,15,41,0.000333,0.059066,5,885.995259,49.221959,177.199052,66.438562,1,0
0,0,9,9,12,13,25,41,32,73,0.000333,0.113001,12,4068.018022,226.001001,339.001502,91.125266,1,0
0,0,6,6,7,13,20,23,34,57,0.000333,0.082117,6,1478.099408,82.116634,246.349901,67.757201,1,0
0,0,9,9,13,14,27,46,34,80,0.000333,0.126797,12,4564.692002,253.594,380.391,101.408685,1,0
0,0,4,4,6,8,14,17,12,29,0.000333,0.036804,3,331.239878,18.402215,110.413293,39.509775,3,0
0,0,3,3,7,5,12,11,7,18,0.000333,0.02151,3,193.587975,10.754888,64.529325,31.261125,1,0
0,0,4,4,4,7,11,13,11,24,0.000333,0.027675,2,166.052718,9.225151,83.026359,27.651484,3,0
0,0,4,4,9,8,17,21,14,35,0.000333,0.047687,4,572.244798,31.791378,143.061199,52.529325,1,0
0,0,4,4,10,15,25,32,21,53,0.000333,0.082041,5,1230.62189,68.367883,246.124378,91.82264,1,0
0,0,3,3,8,6,14,11,9,20,0.000333,0.025382,4,304.588394,16.921577,76.147098,39.509775,1,0
0,0,4,4,8,10,18,17,16,33,0.000333,0.045869,4,550.4301,30.57945,137.607525,57.219281,1,0
0,0,3,3,8,7,15,11,9,20,0.000333,0.026046,4,312.551248,17.363958,78.137812,43.651484,1,0
0,0,4,4,7,9,16,46,28,74,0.000333,0.098667,9,2664,148,296,48.180809,1,0
0,0,8,8,15,18,33,66,34,100,0.000333,0.168146,7,3531.075884,196.170882,504.439412,133.662009,2,0
0,0,11,11,12,18,30,69,40,109,0.000333,0.178284,12,6418.212899,356.567383,534.851075,118.0782,2,0
0,0,11,11,15,21,36,84,43,127,0.000333,0.21886,14,9192.126653,510.673703,656.580475,150.842025,2,0
0,0,9,9,15,19,34,68,35,103,0.000333,0.17467,7,3668.060709,203.78115,524.008673,139.313982,2,0
0,0,9,9,12,12,24,47,29,76,0.000333,0.116152,12,4181.485801,232.304767,348.45715,86.0391,4,0
0,0,9,9,12,12,24,45,29,74,0.000333,0.113096,12,4071.446701,226.191483,339.287225,86.0391,4,0
0,0,4,4,7,15,22,18,24,42,0.000333,0.062432,3,561.888384,31.216021,187.296128,78.254843,2,0
0,0,4,4,4,7,11,13,11,24,0.000333,0.027675,2,166.052718,9.225151,83.026359,27.651484,3,0
0,0,11,11,13,18,31,72,51,123,0.000333,0.203122,12,7312.393754,406.244097,609.366146,123.164366,1,0
0,0,5,5,8,11,19,30,18,48,0.000333,0.067967,4,815.602083,45.311227,203.900521,62.053748,1,0
0,0,6,6,10,8,18,37,22,59,0.000333,0.082009,10,2460.255751,136.680875,246.025575,57.219281,1,0
0,0,5,5,10,7,17,42,23,65,0.000333,0.088562,15,3985.27627,221.404237,265.685085,52.870765,1,0
0,0,3,3,9,6,15,19,10,29,0.000333,0.037767,4,453.199309,25.177739,113.299827,44.0391,1,0
0,0,5,5,9,12,21,22,18,40,0.000333,0.058564,4,702.770788,39.042822,175.692697,71.548875,1,0
0,0,3,3,7,8,15,23,12,35,0.000333,0.04558,3,410.223513,22.790195,136.741171,43.651484,1,0
0,0,4,4,11,9,20,35,15,50,0.000333,0.072032,5,1080.482024,60.026779,216.096405,66.583073,2,0
0,0,11,11,15,21,36,84,43,127,0.000333,0.21886,14,9192.126653,510.673703,656.580475,150.842025,2,0
0,0,8,8,15,18,33,66,34,100,0.000333,0.168146,7,3531.075884,196.170882,504.439412,133.662009,2,0
0,0,9,9,15,19,34,68,35,103,0.000333,0.17467,7,3668.060709,203.78115,524.008673,139.313982,2,0
0,0,5,5,8,10,18,28,17,45,0.000333,0.062549,4,750.5865,41.69925,187.646625,57.219281,1,0
0,0,8,8,8,15,23,30,28,58,0.000333,0.087456,4,1049.466374,58.303687,262.366593,82.603359,1,0
0,0,5,5,10,12,22,21,17,38,0.000333,0.056486,5,847.292008,47.071778,169.458402,76.238831,1,0
0,0,9,9,15,19,34,68,35,103,0.000333,0.17467,7,3668.060709,203.78115,524.008673,139.313982,2,0
0,0,5,5,8,10,18,28,17,45,0.000333,0.062549,4,750.5865,41.69925,187.646625,57.219281,1,0
0,0,8,8,15,18,33,66,34,100,0.000333,0.168146,7,3531.075884,196.170882,504.439412,133.662009,2,0
0,0,11,11,15,21,36,84,43,127,0.000333,0.21886,14,9192.126653,510.673703,656.580475,150.842025,2,0
0,0,25,25,12,35,47,382,213,595,0.000333,1.10166,36,118979.2932,6609.960733,3304.980367,222.544456,4,0
0,0,5,5,8,10,18,28,17,45,0.000333,0.062549,4,750.5865,41.69925,187.646625,57.219281,1,0
0,0,4,4,6,8,14,17,12,29,0.000333,0.036804,3,331.239878,18.402215,110.413293,39.509775,3,0
0,0,3,3,8,7,15,11,9,20,0.000333,0.026046,4,312.551248,17.363958,78.137812,43.651484,1,0
0,0,7,7,11,19,30,44,28,72,0.000333,0.117765,5,1766.480614,98.137812,353.296123,118.764371,2,0
0,0,7,7,9,13,22,31,22,53,0.000333,0.078783,4,945.399503,52.522195,236.349876,76.635041,1,0
0,0,8,8,12,15,27,51,31,82,0.000333,0.129967,12,4678.809302,259.93385,389.900775,101.622909,1,0
0,0,4,4,10,8,18,25,15,40,0.000333,0.055599,5,833.985,46.3325,166.797,57.219281,1,0
0,0,7,7,11,19,30,44,28,72,0.000333,0.117765,5,1766.480614,98.137812,353.296123,118.764371,2,0
0,0,3,3,9,8,17,16,11,27,0.000333,0.036787,4,441.445987,24.524777,110.361497,52.529325,2,0
0,0,4,4,8,10,18,16,15,31,0.000333,0.043089,4,517.0707,28.72615,129.267675,57.219281,1,0
0,0,4,4,10,15,25,32,21,53,0.000333,0.082041,5,1230.62189,68.367883,246.124378,91.82264,1,0
0,0,4,4,9,14,23,24,22,46,0.000333,0.069361,4,832.3354,46.240856,208.08385,81.832294,1,0
0,0,4,4,4,7,11,13,11,24,0.000333,0.027675,2,166.052718,9.225151,83.026359,27.651484,3,0
0,0,11,11,15,21,36,84,43,127,0.000333,0.21886,14,9192.126653,510.673703,656.580475,150.842025,2,0
0,0,8,8,15,18,33,66,34,100,0.000333,0.168146,7,3531.075884,196.170882,504.439412,133.662009,2,0
0,0,5,5,8,12,20,25,19,44,0.000333,0.063388,4,760.659345,42.258852,190.164836,67.01955,1,0
0,0,9,9,15,19,34,68,35,103,0.000333,0.17467,7,3668.060709,203.78115,524.008673,139.313982,2,0
0,0,3,3,7,8,15,23,12,35,0.000333,0.04558,3,410.223513,22.790195,136.741171,43.651484,1,0
0,0,3,3,8,7,15,21,11,32,0.000333,0.041673,4,500.081996,27.782333,125.020499,43.651484,1,0
0,0,6,6,11,14,25,28,21,49,0.000333,0.07585,5,1137.744766,63.208043,227.548953,91.356717,1,0
0,0,7,7,17,14,31,46,29,75,0.000333,0.123855,16,5945.035572,330.279754,371.564723,122.789837,4,0
0,0,4,4,6,12,18,20,17,37,0.000333,0.051429,3,462.861675,25.714538,154.287225,58.529325,1,0
0,0,7,7,11,19,30,44,28,72,0.000333,0.117765,5,1766.480614,98.137812,353.296123,118.764371,2,0
0,0,5,5,8,10,18,28,17,45,0.000333,0.062549,4,750.5865,41.69925,187.646625,57.219281,1,0
0,0,5,5,10,11,21,33,18,51,0.000333,0.074669,5,1120.040943,62.224497,224.008189,71.273029,1,0
0,0,19,19,10,21,31,130,74,204,0.000333,0.336885,15,15159.84071,842.213373,1010.656047,125.457947,5,0
0,0,10,10,14,18,32,51,39,90,0.000333,0.15,14,6300,350,450,128.361619,2,0
0,0,6,6,9,10,19,28,17,45,0.000333,0.063719,4,764.626952,42.479275,191.156738,61.748606,1,0
0,0,7,7,16,14,30,45,29,74,0.000333,0.121037,16,5809.758465,322.764359,363.109904,117.302969,4,0
0,0,4,4,4,7,11,13,11,24,0.000333,0.027675,2,166.052718,9.225151,83.026359,27.651484,3,0
0,0,3,3,8,7,15,11,9,20,0.000333,0.026046,4,312.551248,17.363958,78.137812,43.651484,1,0
0,0,25,25,12,35,47,382,213,595,0.000333,1.10166,36,118979.2932,6609.960733,3304.980367,222.544456,4,0
0,0,5,5,11,12,23,33,21,54,0.000333,0.081424,5,1221.361728,67.853429,244.272346,81.073298,1,0
0,0,3,3,8,7,15,20,12,32,0.000333,0.041673,4,500.081996,27.782333,125.020499,43.651484,1,0
0,0,7,7,11,19,30,44,28,72,0.000333,0.117765,5,1766.480614,98.137812,353.296123,118.764371,2,0
0,0,6,6,9,13,22,23,25,48,0.000333,0.071351,4,856.210871,47.567271,214.052718,76.635041,1,0
0,0,4,4,11,11,22,20,17,37,0.000333,0.055,5,824.994849,45.833047,164.99897,76.107496,1,0
0,0,8,8,8,15,23,30,30,60,0.000333,0.090471,8,2171.309739,120.628319,271.413717,82.603359,1,0
0,0,8,8,15,16,31,48,35,83,0.000333,0.137066,14,5756.776113,319.820895,411.198294,122.603359,4,0
0,0,5,5,10,10,20,26,15,41,0.000333,0.059066,5,885.995259,49.221959,177.199052,66.438562,1,0
0,0,11,11,15,21,36,84,43,127,0.000333,0.21886,14,9192.126653,510.673703,656.580475,150.842025,2,0
0,0,4,4,9,8,17,33,17,50,0.000333,0.068124,8,1634.985137,90.832508,204.373142,52.529325,1,0
0,0,11,11,12,18,30,69,40,109,0.000333,0.178284,12,6418.212899,356.567383,534.851075,118.0782,5,0
0,0,7,7,8,13,21,21,19,40,0.000333,0.058564,4,702.770788,39.042822,175.692697,72.105716,1,0
0,0,4,4,4,7,11,13,11,24,0.000333,0.027675,2,166.052718,9.225151,83.026359,27.651484,2,0
0,0,6,6,10,10,20,24,19,43,0.000333,0.061948,5,929.21454,51.62303,185.842908,66.438562,1,0
0,0,25,25,12,35,47,382,213,595,0.000333,1.10166,36,118979.2932,6609.960733,3304.980367,222.544456,4,0
0,0,5,5,11,12,23,33,21,54,0.000333,0.081424,5,1221.361728,67.853429,244.272346,81.073298,1,0
0,0,3,3,7,5,12,11,7,18,0.000333,0.02151,3,193.587975,10.754888,64.529325,31.261125,1,0
0,0,4,4,10,15,25,32,21,53,0.000333,0.082041,5,1230.62189,68.367883,246.124378,91.82264,1,0
0,0,4,4,10,15,25,32,21,53,0.000333,0.082041,5,1230.62189,68.367883,246.124378,91.82264,1,0
0,0,6,6,10,11,21,24,21,45,0.000333,0.065885,5,988.27142,54.903968,197.654284,71.273029,1,0
0,0,4,4,9,8,17,15,12,27,0.000333,0.036787,4,441.445987,24.524777,110.361497,52.529325,1,0
0,0,3,3,9,8,17,16,11,27,0.000333,0.036787,4,441.445987,24.524777,110.361497,52.529325,2,0
0,0,5,5,8,10,18,28,17,45,0.000333,0.062549,4,750.5865,41.69925,187.646625,57.219281,1,0
0,0,5,5,8,11,19,30,18,48,0.000333,0.067967,4,815.602083,45.311227,203.900521,62.053748,1,0
0,0,8,8,15,18,33,66,34,100,0.000333,0.168146,7,3531.075884,196.170882,504.439412,133.662009,2,0
0,0,7,7,11,19,30,44,28,72,0.000333,0.117765,5,1766.480614,98.137812,353.296123,118.764371,2,0
0,0,4,4,8,7,15,17,12,29,0.000333,0.037767,4,453.199309,25.177739,113.299827,43.651484,1,0
0,0,3,3,7,8,15,23,12,35,0.000333,0.04558,3,410.223513,22.790195,136.741171,43.651484,1,0
0,0,4,4,5,10,15,13,13,26,0.000333,0.03386,2,203.158311,11.286573,101.579155,44.828921,1,0
0,0,4,4,4,7,11,13,11,24,0.000333,0.027675,2,166.052718,9.225151,83.026359,27.651484,3,0
0,0,13,13,11,22,33,99,50,149,0.000333,0.250538,10,7516.147238,417.563735,751.614724,136.161243,1,0
0,0,8,8,12,15,27,42,27,69,0.000333,0.109362,6,1968.523426,109.362413,328.087238,101.622909,2,0
0,0,4,4,7,11,18,24,17,41,0.000333,0.056989,3,512.900775,28.494488,170.966925,57.705232,1,0
0,0,5,5,7,8,15,17,12,29,0.000333,0.037767,3,339.899482,18.883305,113.299827,43.651484,1,0
0,0,3,3,7,8,15,23,12,35,0.000333,0.04558,3,410.223513,22.790195,136.741171,43.651484,1,0
0,0,3,3,9,8,17,16,11,27,0.000333,0.036787,4,441.445987,24.524777,110.361497,52.529325,2,0
0,0,3,3,7,5,12,11,7,18,0.000333,0.02151,3,193.587975,10.754888,64.529325,31.261125,1,0
0,0,3,3,8,6,14,11,9,20,0.000333,0.025382,4,304.588394,16.921577,76.147098,39.509775,1,0
0,0,11,11,12,16,28,53,44,97,0.000333,0.155438,12,5595.761129,310.875618,466.313427,107.01955,1,0
0,0,3,3,9,8,17,16,11,27,0.000333,0.036787,4,441.445987,24.524777,110.361497,52.529325,2,0
0,0,4,4,4,7,11,13,11,24,0.000333,0.027675,2,166.052718,9.225151,83.026359,27.651484,3,0
0,0,5,5,8,8,16,19,12,31,0.000333,0.041333,4,496,27.555556,124,48,1,0
0,0,3,3,8,7,15,15,9,24,0.000333,0.031255,4,375.061497,20.83675,93.765374,43.651484,3,0
0,0,4,4,4,7,11,13,11,24,0.000333,0.027675,2,166.052718,9.225151,83.026359,27.651484,3,0
0,0,8,8,16,16,32,49,33,82,0.000333,0.136667,16,6560,364.444444,410,128,4,0
0,0,3,3,9,8,17,16,10,26,0.000333,0.035425,4,425.096135,23.616452,106.274034,52.529325,3,0
0,0,3,3,7,5,12,11,7,18,0.000333,0.02151,3,193.587975,10.754888,64.529325,31.261125,1,0
0,0,3,3,9,8,17,16,11,27,0.000333,0.036787,4,441.445987,24.524777,110.361497,52.529325,2,0
0,0,3,3,9,13,22,20,16,36,0.000333,0.053513,4,642.158153,35.675453,160.539538,76.635041,3,0
0,0,6,6,13,12,25,33,24,57,0.000333,0.088233,12,3176.397634,176.466535,264.699803,91.125266,1,0
0,0,4,4,4,7,11,13,11,24,0.000333,0.027675,2,166.052718,9.225151,83.026359,27.651484,3,0
0,0,3,3,9,8,17,16,11,27,0.000333,0.036787,4,441.445987,24.524777,110.361497,52.529325,2,0
0,0,5,5,11,12,23,33,18,51,0.000333,0.076901,5,1153.508299,64.083794,230.70166,81.073298,3,0
0,0,3,3,5,6,11,9,8,17,0.000333,0.019603,2,117.620675,6.534482,58.810338,27.119415,1,0
0,0,9,9,13,12,25,53,31,84,0.000333,0.130028,12,4681.007039,260.055947,390.08392,91.125266,4,0
0,0,8,8,12,13,25,41,24,65,0.000333,0.100617,6,1811.103914,100.616884,301.850652,91.125266,4,0
0,0,15,15,15,24,39,64,62,126,0.000333,0.221987,14,9323.449514,517.969417,665.96068,168.642459,2,0
0,0,4,4,9,7,16,26,16,42,0.000333,0.056,8,1344,74.666667,168,48.180809,1,0
0,0,13,13,11,22,33,99,50,149,0.000333,0.250538,10,7516.147238,417.563735,751.614724,136.161243,3,0
0,0,9,9,10,15,25,43,25,68,0.000333,0.105261,5,1578.911105,87.717284,315.782221,91.82264,4,0
0,0,3,3,8,7,15,11,9,20,0.000333,0.026046,4,312.551248,17.363958,78.137812,43.651484,1,0
0,0,6,6,5,14,19,22,31,53,0.000333,0.075047,4,900.560633,50.031146,225.140158,64.912609,1,0
0,0,4,4,7,11,18,18,15,33,0.000333,0.045869,3,412.822575,22.934588,137.607525,57.705232,1,0
0,0,3,3,8,7,15,20,12,32,0.000333,0.041673,4,500.081996,27.782333,125.020499,43.651484,1,0
0,0,6,6,8,11,19,40,23,63,0.000333,0.089206,8,2140.955467,118.94197,267.619433,62.053748,1,0
0,0,5,5,8,8,16,19,12,31,0.000333,0.041333,4,496,27.555556,124,48,1,0
0,0,16,16,11,26,37,113,60,173,0.000333,0.300412,10,9012.354323,500.686351,901.235432,160.26518,1,0
0,0,3,3,7,5,12,11,7,18,0.000333,0.02151,3,193.587975,10.754888,64.529325,31.261125,1,0
0,0,10,10,11,16,27,39,29,68,0.000333,0.107777,5,1616.661751,89.814542,323.33235,102.053748,1,0
0,0,3,3,8,7,15,11,9,20,0.000333,0.026046,4,312.551248,17.363958,78.137812,43.651484,1,0
0,0,3,3,7,8,15,23,12,35,0.000333,0.04558,3,410.223513,22.790195,136.741171,43.651484,1,0
0,0,6,6,7,13,20,35,24,59,0.000333,0.084998,3,764.981273,42.49896,254.993758,67.757201,1,0
0,0,3,3,9,8,17,16,11,27,0.000333,0.036787,4,441.445987,24.524777,110.361497,52.529325,2,0
0,0,3,3,9,8,17,16,10,26,0.000333,0.035425,4,425.096135,23.616452,106.274034,52.529325,3,0
0,0,8,8,11,16,27,36,29,65,0.000333,0.103023,5,1545.338438,85.852135,309.067688,102.053748,1,0
0,0,5,5,10,11,21,29,17,46,0.000333,0.067349,5,1010.233007,56.124056,202.046601,71.273029,1,0
0,0,5,5,11,12,23,27,19,46,0.000333,0.069361,5,1040.41925,57.801069,208.08385,81.073298,1,0
0,0,4,4,8,8,16,18,12,30,0.000333,0.04,4,480,26.666667,120,48,1,0
0,0,5,5,10,10,20,27,14,41,0.000333,0.059066,5,885.995259,49.221959,177.199052,66.438562,5,0
0,0,6,6,7,13,20,35,24,59,0.000333,0.084998,3,764.981273,42.49896,254.993758,67.757201,1,0
0,0,8,8,11,15,26,59,34,93,0.000333,0.145714,10,4371.408938,242.856052,437.140894,96.657107,1,0
0,0,5,5,10,10,20,26,15,41,0.000333,0.059066,5,885.995259,49.221959,177.199052,66.438562,1,0
0,0,3,3,8,7,15,11,9,20,0.000333,0.026046,4,312.551248,17.363958,78.137812,43.651484,1,0
0,0,3,3,9,8,17,16,11,27,0.000333,0.036787,4,441.445987,24.524777,110.361497,52.529325,2,0
0,0,7,7,11,19,30,44,28,72,0.000333,0.117765,5,1766.480614,98.137812,353.296123,118.764371,2,0
0,0,5,5,11,12,23,33,21,54,0.000333,0.081424,5,1221.361728,67.853429,244.272346,81.073298,1,0
0,0,25,25,12,35,47,382,213,595,0.000333,1.10166,36,118979.2932,6609.960733,3304.980367,222.544456,4,0
0,0,3,3,7,5,12,11,7,18,0.000333,0.02151,3,193.587975,10.754888,64.529325,31.261125,1,0
0,0,9,9,10,13,23,41,32,73,0.000333,0.110073,10,3302.200228,183.455568,330.220023,81.324997,1,0
0,0,5,5,8,10,18,28,17,45,0.000333,0.062549,4,750.5865,41.69925,187.646625,57.219281,1,0
0,0,7,7,11,19,30,44,28,72,0.000333,0.117765,5,1766.480614,98.137812,353.296123,118.764371,2,0
0,0,6,6,6,15,21,23,32,55,0.000333,0.080526,6,1449.46475,80.525819,241.577458,74.113134,1,0
0,0,5,5,8,10,18,28,17,45,0.000333,0.062549,4,750.5865,41.69925,187.646625,57.219281,1,0
0,0,5,5,10,11,21,27,16,43,0.000333,0.062957,5,944.348246,52.463791,188.869649,71.273029,1,0
0,0,25,25,12,35,47,382,213,595,0.000333,1.10166,36,118979.2932,6609.960733,3304.980367,222.544456,4,0
0,0,3,3,7,5,12,11,7,18,0.000333,0.02151,3,193.587975,10.754888,64.529325,31.261125,1,0
0,0,5,5,9,11,20,19,16,35,0.000333,0.050422,4,605.069933,33.614996,151.267483,66.583073,1,0
0,0,15,15,12,22,34,99,56,155,0.000333,0.262852,12,9462.680885,525.704494,788.55674,141.127046,6,0
0,0,11,11,12,18,30,69,40,109,0.000333,0.178284,12,6418.212899,356.567383,534.851075,118.0782,2,0
0,0,4,4,5,12,17,16,16,32,0.000333,0.0436,2,261.597622,14.533201,130.798811,54.62919,1,0
0,0,8,8,15,18,33,66,34,100,0.000333,0.168146,7,3531.075884,196.170882,504.439412,133.662009,2,0
0,0,5,5,11,12,23,33,18,51,0.000333,0.076901,5,1153.508299,64.083794,230.70166,81.073298,3,0
0,0,4,4,4,7,11,13,11,24,0.000333,0.027675,2,166.052718,9.225151,83.026359,27.651484,3,0
0,0,11,11,15,21,36,84,43,127,0.000333,0.21886,14,9192.126653,510.673703,656.580475,150.842025,2,0
0,0,5,5,7,8,15,17,12,29,0.000333,0.037767,3,339.899482,18.883305,113.299827,43.651484,1,0
0,0,4,4,4,7,11,13,11,24,0.000333,0.027675,2,166.052718,9.225151,83.026359,27.651484,3,0
0,0,6,6,8,13,21,42,25,67,0.000333,0.098095,4,1177.141069,65.396726,294.285267,72.105716,1,0
0,0,4,4,8,11,19,27,17,44,0.000333,0.062303,4,747.635242,41.535291,186.908811,62.053748,1,0
0,0,3,3,8,6,14,11,9,20,0.000333,0.025382,4,304.588394,16.921577,76.147098,39.509775,1,0
0,0,7,7,11,19,30,44,28,72,0.000333,0.117765,5,1766.480614,98.137812,353.296123,118.764371,2,0
0,0,5,5,10,11,21,27,16,43,0.000333,0.062957,5,944.348246,52.463791,188.869649,71.273029,3,0
0,0,5,5,8,11,19,36,19,55,0.000333,0.077879,4,934.544053,51.919114,233.636013,62.053748,1,0
0,0,3,3,8,7,15,11,9,20,0.000333,0.026046,4,312.551248,17.363958,78.137812,43.651484,1,0
0,0,3,3,7,8,15,23,12,35,0.000333,0.04558,3,410.223513,22.790195,136.741171,43.651484,1,0
0,0,7,7,14,15,29,42,31,73,0.000333,0.118211,14,4964.856577,275.825365,354.632613,111.906328,4,0
0,0,9,9,15,19,34,68,35,103,0.000333,0.17467,7,3668.060709,203.78115,524.008673,139.313982,2,0
0,0,4,4,6,9,15,16,12,28,0.000333,0.036464,3,328.17881,18.232156,109.392937,44.0391,1,0
0,0,9,9,14,25,39,156,54,210,0.000333,0.369978,14,15539.08252,863.282362,1109.934466,169.399374,5,0
0,0,3,3,8,7,15,11,9,20,0.000333,0.026046,4,312.551248,17.363958,78.137812,43.651484,1,0
0,0,11,11,15,21,36,84,43,127,0.000333,0.21886,14,9192.126653,510.673703,656.580475,150.842025,2,0
0,0,3,3,8,7,15,15,9,24,0.000333,0.031255,4,375.061497,20.83675,93.765374,43.651484,3,0
0,0,9,9,15,19,34,68,35,103,0.000333,0.17467,7,3668.060709,203.78115,524.008673,139.313982,2,0
0,0,3,3,7,5,12,11,7,18,0.000333,0.02151,3,193.587975,10.754888,64.529325,31.261125,1,0
0,0,3,3,9,8,17,16,11,27,0.000333,0.036787,4,441.445987,24.524777,110.361497,52.529325,2,0
0,0,4,4,6,9,15,16,12,28,0.000333,0.036464,3,328.17881,18.232156,109.392937,44.0391,1,0
0,0,10,10,14,18,32,51,39,90,0.000333,0.15,14,6300,350,450,128.361619,2,0
0,0,4,4,5,7,12,14,10,24,0.000333,0.02868,2,172.0782,9.5599,86.0391,31.261125,2,0
0,0,7,7,11,19,30,44,28,72,0.000333,0.117765,5,1766.480614,98.137812,353.296123,118.764371,2,0
0,0,7,7,11,19,30,44,28,72,0.000333,0.117765,5,1766.480614,98.137812,353.296123,118.764371,2,0
0,0,10,10,14,18,32,51,39,90,0.000333,0.15,14,6300,350,450,128.361619,2,0
0,0,9,9,11,17,28,43,43,86,0.000333,0.137811,10,4134.325233,229.684735,413.432523,107.540616,1,0
0,0,4,4,4,7,11,13,11,24,0.000333,0.027675,2,166.052718,9.225151,83.026359,27.651484,3,0
0,0,3,3,7,8,15,23,12,35,0.000333,0.04558,3,410.223513,22.790195,136.741171,43.651484,1,0
0,0,8,8,15,18,33,66,34,100,0.000333,0.168146,7,3531.075884,196.170882,504.439412,133.662009,2,0
0,0,11,11,15,21,36,84,43,127,0.000333,0.21886,14,9192.126653,510.673703,656.580475,150.842025,2,0
0,0,3,3,8,7,15,11,9,20,0.000333,0.026046,4,312.551248,17.363958,78.137812,43.651484,1,0
0,0,7,7,11,18,29,48,28,76,0.000333,0.123069,5,1846.032778,102.557377,369.206556,113.112398,1,0
0,0,3,3,7,8,15,23,12,35,0.000333,0.04558,3,410.223513,22.790195,136.741171,43.651484,1,0
0,0,5,5,7,8,15,20,15,35,0.000333,0.04558,3,410.223513,22.790195,136.741171,43.651484,1,0
0,0,7,7,12,9,21,43,19,62,0.000333,0.090775,12,3267.884163,181.54912,272.32368,71.548875,5,0
0,0,5,5,10,11,21,29,17,46,0.000333,0.067349,5,1010.233007,56.124056,202.046601,71.273029,1,0
0,0,5,5,8,10,18,28,17,45,0.000333,0.062549,4,750.5865,41.69925,187.646625,57.219281,1,0
0,0,5,5,8,10,18,26,15,41,0.000333,0.056989,4,683.8677,37.99265,170.966925,57.219281,1,0
0,0,3,3,8,8,16,20,12,32,0.000333,0.042667,4,512,28.444444,128,48,1,0
0,0,7,7,11,19,30,44,28,72,0.000333,0.117765,5,1766.480614,98.137812,353.296123,118.764371,2,0
0,0,6,6,9,10,19,28,17,45,0.000333,0.063719,4,764.626952,42.479275,191.156738,61.748606,1,0
0,0,5,5,11,13,24,26,19,45,0.000333,0.068774,5,1031.616563,57.312031,206.323313,86.159464,1,0
0,0,11,11,15,21,36,84,43,127,0.000333,0.21886,14,9192.126653,510.673703,656.580475,150.842025,2,0
0,0,9,9,15,19,34,68,35,103,0.000333,0.17467,7,3668.060709,203.78115,524.008673,139.313982,2,0
0,0,8,8,11,17,28,41,33,74,0.000333,0.118581,5,1778.721321,98.817851,355.744264,107.540616,1,0
0,0,5,5,10,11,21,29,17,46,0.000333,0.067349,5,1010.233007,56.124056,202.046601,71.273029,1,0
0,0,6,6,7,15,22,29,33,62,0.000333,0.092162,6,1658.908562,92.161587,276.48476,78.254843,1,0
0,0,3,3,5,6,11,9,8,17,0.000333,0.019603,2,117.620675,6.534482,58.810338,27.119415,1,0
0,0,8,8,15,18,33,66,34,100,0.000333,0.168146,7,3531.075884,196.170882,504.439412,133.662009,2,0
0,0,9,9,15,20,35,72,36,108,0.000333,0.184654,7,3877.737961,215.429887,553.962566,145.041921,2,0
0,0,4,4,8,7,15,16,11,27,0.000333,0.035162,4,421.944184,23.441344,105.486046,43.651484,1,0
0,0,4,4,8,8,16,18,12,30,0.000333,0.04,4,480,26.666667,120,48,1,0
0,0,5,5,10,15,25,30,22,52,0.000333,0.080494,5,1207.402609,67.077923,241.480522,91.82264,1,0
0,0,5,5,8,10,18,26,15,41,0.000333,0.056989,4,683.8677,37.99265,170.966925,57.219281,1,0
0,0,8,8,15,18,33,66,34,100,0.000333,0.168146,7,3531.075884,196.170882,504.439412,133.662009,2,0
0,0,9,9,15,19,34,68,35,103,0.000333,0.17467,7,3668.060709,203.78115,524.008673,139.313982,2,0
0,0,11,11,15,21,36,84,43,127,0.000333,0.21886,14,9192.126653,510.673703,656.580475,150.842025,2,0
0,0,3,3,7,8,15,23,12,35,0.000333,0.04558,3,410.223513,22.790195,136.741171,43.651484,1,0
0,0,7,7,11,19,30,44,28,72,0.000333,0.117765,5,1766.480614,98.137812,353.296123,118.764371,2,0
0,0,4,4,4,6,10,16,12,28,0.000333,0.031005,4,372.055947,20.669775,93.013987,23.509775,1,0
0,0,6,6,10,13,23,31,22,53,0.000333,0.079916,5,1198.743918,66.596884,239.748784,81.324997,1,0
0,0,4,4,5,11,16,14,15,29,0.000333,0.038667,2,232,12.888889,116,49.663388,1,0
0,0,5,5,8,10,18,28,17,45,0.000333,0.062549,4,750.5865,41.69925,187.646625,57.219281,1,0
0,0,5,5,10,11,21,29,17,46,0.000333,0.067349,5,1010.233007,56.124056,202.046601,71.273029,1,0
0,0,5,5,10,12,22,26,19,45,0.000333,0.066891,5,1003.372114,55.742895,200.674423,76.238831,1,0
0,0,7,7,14,12,26,51,31,82,0.000333,0.128479,14,5396.104796,299.7836,385.436057,96.322519,4,0
0,0,5,5,8,10,18,28,17,45,0.000333,0.062549,4,750.5865,41.69925,187.646625,57.219281,1,0
0,0,11,11,12,15,27,43,35,78,0.000333,0.123627,12,4450.574702,247.25415,370.881225,101.622909,1,0
0,0,8,8,11,15,26,59,34,93,0.000333,0.145714,10,4371.408938,242.856052,437.140894,96.657107,1,0
0,0,6,6,9,10,19,28,17,45,0.000333,0.063719,4,764.626952,42.479275,191.156738,61.748606,1,0
0,0,3,3,7,8,15,23,12,35,0.000333,0.04558,3,410.223513,22.790195,136.741171,43.651484,1,0
0,0,4,4,10,15,25,32,21,53,0.000333,0.082041,5,1230.62189,68.367883,246.124378,91.82264,1,0
0,0,5,5,11,12,23,33,21,54,0.000333,0.081424,5,1221.361728,67.853429,244.272346,81.073298,1,0
0,0,5,5,10,11,21,33,18,51,0.000333,0.074669,5,1120.040943,62.224497,224.008189,71.273029,1,0
0,0,7,7,11,19,30,44,28,72,0.000333,0.117765,5,1766.480614,98.137812,353.296123,118.764371,2,0
0,0,3,3,7,8,15,23,12,35,0.000333,0.04558,3,410.223513,22.790195,136.741171,43.651484,1,0
0,0,3,3,9,6,15,16,10,26,0.000333,0.03386,4,406.316622,22.573146,101.579155,44.0391,1,0
0,0,3,3,7,8,15,23,12,35,0.000333,0.04558,3,410.223513,22.790195,136.741171,43.651484,1,0
0,0,3,3,14,9,23,26,12,38,0.000333,0.057298,7,1203.26748,66.848193,171.895354,81.832294,3,0
0,0,5,5,8,10,18,28,17,45,0.000333,0.062549,4,750.5865,41.69925,187.646625,57.219281,1,0
0,0,3,3,7,8,15,23,12,35,0.000333,0.04558,3,410.223513,22.790195,136.741171,43.651484,1,0
0,0,4,4,4,7,11,13,11,24,0.000333,0.027675,2,166.052718,9.225151,83.026359,27.651484,3,0
0,0,3,3,9,8,17,16,11,27,0.000333,0.036787,4,441.445987,24.524777,110.361497,52.529325,2,0
0,0,11,11,15,21,36,84,43,127,0.000333,0.21886,14,9192.126653,510.673703,656.580475,150.842025,2,0
0,0,8,8,15,18,33,66,34,100,0.000333,0.168146,7,3531.075884,196.170882,504.439412,133.662009,2,0
0,0,3,3,8,8,16,20,12,32,0.000333,0.042667,4,512,28.444444,128,48,1,0
0,0,5,5,10,11,21,29,17,46,0.000333,0.067349,5,1010.233007,56.124056,202.046601,71.273029,1,0
0,0,4,4,10,15,25,32,21,53,0.000333,0.082041,5,1230.62189,68.367883,246.124378,91.82264,1,0
0,0,7,7,10,14,24,40,27,67,0.000333,0.102397,5,1535.962438,85.331247,307.192488,86.52225,1,0
0,0,5,5,8,8,16,19,12,31,0.000333,0.041333,4,496,27.555556,124,48,1,0
0,0,4,4,10,15,25,32,21,53,0.000333,0.082041,5,1230.62189,68.367883,246.124378,91.82264,1,0
0,0,5,5,10,10,20,27,14,41,0.000333,0.059066,5,885.995259,49.221959,177.199052,66.438562,3,0
0,0,7,7,11,18,29,48,28,76,0.000333,0.123069,5,1846.032778,102.557377,369.206556,113.112398,1,0
0,0,4,4,8,12,20,23,17,40,0.000333,0.057626,4,691.508495,38.417139,172.877124,67.01955,1,0
0,0,4,4,7,7,14,16,10,26,0.000333,0.032997,3,296.973684,16.498538,98.991228,39.302969,1,0
0,0,4,4,11,10,21,36,17,53,0.000333,0.077598,5,1163.964117,64.664673,232.792823,71.273029,1,0
0,0,6,6,8,13,21,42,25,67,0.000333,0.098095,4,1177.141069,65.396726,294.285267,72.105716,1,0
0,0,3,3,7,5,12,11,7,18,0.000333,0.02151,3,193.587975,10.754888,64.529325,31.261125,1,0
0,0,4,4,10,15,25,32,21,53,0.000333,0.082041,5,1230.62189,68.367883,246.124378,91.82264,1,0
0,0,9,9,12,13,25,41,32,73,0.000333,0.113001,12,4068.018022,226.001001,339.001502,91.125266,1,0
0,0,17,17,15,23,38,89,58,147,0.000333,0.257148,14,10800.23482,600.013046,771.445344,162.645284,6,0
0,0,4,4,4,7,11,13,11,24,0.000333,0.027675,2,166.052718,9.225151,83.026359,27.651484,3,0
0,0,4,4,4,7,11,13,11,24,0.000333,0.027675,2,166.052718,9.225151,83.026359,27.651484,3,0
0,0,4,4,10,9,19,22,13,35,0.000333,0.049559,5,743.387315,41.299295,148.677463,61.748606,1,0
0,0,25,25,12,35,47,382,213,595,0.000333,1.10166,36,118979.2932,6609.960733,3304.980367,222.544456,4,0
0,0,5,5,11,12,23,33,21,54,0.000333,0.081424,5,1221.361728,67.853429,244.272346,81.073298,1,0
0,0,3,3,9,8,17,16,11,27,0.000333,0.036787,4,441.445987,24.524777,110.361497,52.529325,2,0
0,0,9,9,15,19,34,68,35,103,0.000333,0.17467,7,3668.060709,203.78115,524.008673,139.313982,2,0
0,0,4,4,9,7,16,16,11,27,0.000333,0.036,4,432,24,108,48.180809,1,0
0,0,6,6,8,13,21,42,25,67,0.000333,0.098095,4,1177.141069,65.396726,294.285267,72.105716,1,0
0,0,3,3,9,8,17,16,11,27,0.000333,0.036787,4,441.445987,24.524777,110.361497,52.529325,2,0
0,0,22,22,17,30,47,118,76,194,0.000333,0.359197,16,17241.4438,957.857989,1077.590237,216.693586,7,0
0,0,8,8,11,15,26,59,34,93,0.000333,0.145714,10,4371.408938,242.856052,437.140894,96.657107,1,0
0,0,4,4,4,7,11,13,11,24,0.000333,0.027675,2,166.052718,9.225151,83.026359,27.651484,3,0
0,0,5,5,11,12,23,33,18,51,0.000333,0.076901,5,1153.508299,64.083794,230.70166,81.073298,3,0
0,0,3,3,7,5,12,11,7,18,0.000333,0.02151,3,193.587975,10.754888,64.529325,31.261125,1,0
0,0,9,9,11,17,28,43,43,86,0.000333,0.137811,10,4134.325233,229.684735,413.432523,107.540616,1,0
0,0,12,12,11,18,29,68,48,116,0.000333,0.187842,10,5635.257954,313.069886,563.525795,113.112398,1,0
0,0,7,7,11,19,30,44,28,72,0.000333,0.117765,5,1766.480614,98.137812,353.296123,118.764371,2,0
0,0,3,3,8,7,15,20,12,32,0.000333,0.041673,4,500.081996,27.782333,125.020499,43.651484,1,0
0,0,25,25,12,35,47,382,213,595,0.000333,1.10166,36,118979.2932,6609.960733,3304.980367,222.544456,4,0
0,0,5,5,8,17,25,38,29,67,0.000333,0.103713,4,1244.553459,69.141859,311.138365,93.486868,1,0
0,0,5,5,14,17,31,60,30,90,0.000333,0.148626,7,3121.143676,173.396871,445.877668,122.789837,4,0
0,0,4,4,4,7,11,13,11,24,0.000333,0.027675,2,166.052718,9.225151,83.026359,27.651484,3,0
0,0,3,3,7,5,12,11,7,18,0.000333,0.02151,3,193.587975,10.754888,64.529325,31.261125,1,0
0,0,3,3,7,8,15,23,12,35,0.000333,0.04558,3,410.223513,22.790195,136.741171,43.651484,1,0
0,0,6,6,5,14,19,20,30,50,0.000333,0.070799,4,849.585503,47.199195,212.396376,64.912609,1,0
0,0,3,3,8,7,15,15,9,24,0.000333,0.031255,4,375.061497,20.83675,93.765374,43.651484,3,0
0,0,4,4,4,7,11,13,11,24,0.000333,0.027675,2,166.052718,9.225151,83.026359,27.651484,3,0
0,0,3,3,8,7,15,20,12,32,0.000333,0.041673,4,500.081996,27.782333,125.020499,43.651484,1,0
0,0,11,11,12,18,30,69,40,109,0.000333,0.178284,12,6418.212899,356.567383,534.851075,118.0782,2,0
0,0,3,3,7,8,15,23,12,35,0.000333,0.04558,3,410.223513,22.790195,136.741171,43.651484,1,0
0,0,18,18,11,28,39,115,64,179,0.000333,0.315362,10,9460.869972,525.603887,946.086997,172.659686,1,0
0,0,3,3,9,8,17,16,11,27,0.000333,0.036787,4,441.445987,24.524777,110.361497,52.529325,2,0
0,0,4,4,8,7,15,17,10,27,0.000333,0.035162,4,421.944184,23.441344,105.486046,43.651484,1,0
0,0,4,4,4,7,11,13,11,24,0.000333,0.027675,2,166.052718,9.225151,83.026359,27.651484,3,0
0,0,8,8,15,18,33,66,34,100,0.000333,0.168146,7,3531.075884,196.170882,504.439412,133.662009,2,0
0,0,11,11,15,21,36,84,43,127,0.000333,0.21886,14,9192.126653,510.673703,656.580475,150.842025,2,0
0,0,4,4,11,9,20,35,15,50,0.000333,0.072032,5,1080.482024,60.026779,216.096405,66.583073,2,0
0,0,12,12,9,17,26,45,45,90,0.000333,0.141013,8,3384.316597,188.017589,423.039575,98.016193,1,0
0,0,4,4,5,7,12,14,10,24,0.000333,0.02868,2,172.0782,9.5599,86.0391,31.261125,2,0
0,0,4,4,9,8,17,20,12,32,0.000333,0.0436,4,523.195244,29.066402,130.798811,52.529325,1,0
0,0,19,19,21,26,47,149,82,231,0.000333,0.427703,30,38493.30074,2138.516708,1283.110025,214.450099,11,0
0,0,7,7,10,15,25,33,22,55,0.000333,0.085137,5,1277.060452,70.947803,255.41209,91.82264,1,0
0,0,5,5,7,7,14,16,11,27,0.000333,0.034266,3,308.395749,17.133097,102.798583,39.302969,1,0
0,0,4,4,8,6,14,16,12,28,0.000333,0.035535,8,852.847503,47.380417,106.605938,39.509775,1,0
0,0,5,5,7,8,15,17,12,29,0.000333,0.037767,3,339.899482,18.883305,113.299827,43.651484,1,0
0,0,3,3,9,8,17,16,11,27,0.000333,0.036787,4,441.445987,24.524777,110.361497,52.529325,2,0
0,0,4,4,12,11,23,24,15,39,0.000333,0.058806,6,1058.513498,58.806305,176.418916,81.073298,4,0
0,0,7,7,11,19,30,44,28,72,0.000333,0.117765,5,1766.480614,98.137812,353.296123,118.764371,2,0
0,0,4,4,8,7,15,16,11,27,0.000333,0.035162,4,421.944184,23.441344,105.486046,43.651484,1,0
0,0,4,4,4,7,11,13,11,24,0.000333,0.027675,2,166.052718,9.225151,83.026359,27.651484,3,0
0,0,7,7,11,19,30,44,28,72,0.000333,0.117765,5,1766.480614,98.137812,353.296123,118.764371,2,0
0,0,4,4,6,5,11,24,12,36,0.000333,0.041513,6,747.23723,41.513179,124.539538,27.119415,1,0
0,0,5,5,8,8,16,19,12,31,0.000333,0.041333,4,496,27.555556,124,48,1,0
0,0,10,10,16,19,35,59,46,105,0.000333,0.179525,16,8617.195468,478.733082,538.574717,144.710623,4,0
0,0,6,6,7,13,20,35,24,59,0.000333,0.084998,3,764.981273,42.49896,254.993758,67.757201,1,0
0,0,3,3,8,7,15,11,9,20,0.000333,0.026046,4,312.551248,17.363958,78.137812,43.651484,1,0
0,0,8,8,10,18,28,45,37,82,0.000333,0.131401,10,3942.031036,219.001724,394.203104,108.277931,1,0
0,0,5,5,10,12,22,26,19,45,0.000333,0.066891,5,1003.372114,55.742895,200.674423,76.238831,1,0
0,0,15,15,12,22,34,99,56,155,0.000333,0.262852,12,9462.680885,525.704494,788.55674,141.127046,2,0
0,0,7,7,11,14,25,57,32,89,0.000333,0.137768,10,4133.032009,229.612889,413.303201,91.356717,1,0
0,0,25,25,12,35,47,382,213,595,0.000333,1.10166,36,118979.2932,6609.960733,3304.980367,222.544456,4,0
0,0,5,5,11,12,23,33,21,54,0.000333,0.081424,5,1221.361728,67.853429,244.272346,81.073298,1,0
0,0,7,7,10,14,24,40,27,67,0.000333,0.102397,5,1535.962438,85.331247,307.192488,86.52225,1,0
0,0,4,4,4,7,11,13,11,24,0.000333,0.027675,2,166.052718,9.225151,83.026359,27.651484,3,0
0,0,3,3,8,7,15,20,12,32,0.000333,0.041673,4,500.081996,27.782333,125.020499,43.651484,1,0
0,0,3,3,9,8,17,16,11,27,0.000333,0.036787,4,441.445987,24.524777,110.361497,52.529325,2,0
0,0,9,9,15,19,34,68,35,103,0.000333,0.17467,7,3668.060709,203.78115,524.008673,139.313982,2,0
0,0,8,8,8,14,22,31,28,59,0.000333,0.087702,8,2104.851724,116.936207,263.106465,77.302969,1,0
0,0,8,8,15,18,33,66,34,100,0.000333,0.168146,7,3531.075884,196.170882,504.439412,133.662009,2,0
0,0,11,11,15,21,36,84,43,127,0.000333,0.21886,14,9192.126653,510.673703,656.580475,150.842025,2,0
0,0,3,3,8,6,14,11,9,20,0.000333,0.025382,4,304.588394,16.921577,76.147098,39.509775,1,0
0,0,11,11,15,21,36,84,43,127,0.000333,0.21886,14,9192.126653,510.673703,656.580475,150.842025,2,0
0,0,9,9,15,19,34,68,35,103,0.000333,0.17467,7,3668.060709,203.78115,524.008673,139.313982,2,0
0,0,11,11,15,21,36,84,43,127,0.000333,0.21886,14,9192.126653,510.673703,656.580475,150.842025,2,0
0,0,8,8,15,18,33,66,34,100,0.000333,0.168146,7,3531.075884,196.170882,504.439412,133.662009,2,0
0,0,9,9,15,19,34,68,35,103,0.000333,0.17467,7,3668.060709,203.78115,524.008673,139.313982,2,0
0,0,8,8,15,18,33,66,34,100,0.000333,0.168146,7,3531.075884,196.170882,504.439412,133.662009,2,0
0,0,6,6,14,12,26,38,24,62,0.000333,0.097142,14,4079.981675,226.665649,291.427263,96.322519,4,0
0,0,6,6,6,14,20,26,32,58,0.000333,0.083557,6,1504.030977,83.557277,250.67183,68.812744,1,0
0,0,4,4,6,8,14,23,14,37,0.000333,0.046957,3,422.616396,23.478689,140.872132,39.509775,1,0
0,0,11,11,15,21,36,84,43,127,0.000333,0.21886,14,9192.126653,510.673703,656.580475,150.842025,2,0
0,0,9,9,15,19,34,68,35,103,0.000333,0.17467,7,3668.060709,203.78115,524.008673,139.313982,2,0
0,0,5,5,11,12,23,33,21,54,0.000333,0.081424,5,1221.361728,67.853429,244.272346,81.073298,1,0
0,0,5,5,11,12,23,33,21,54,0.000333,0.081424,5,1221.361728,67.853429,244.272346,81.073298,1,0
0,0,25,25,12,35,47,382,213,595,0.000333,1.10166,36,118979.2932,6609.960733,3304.980367,222.544456,4,0
0,0,6,6,7,9,16,63,32,95,0.000333,0.126667,9,3420,190,380,48.180809,1,0
0,0,3,3,7,6,13,27,14,41,0.000333,0.050573,6,910.308171,50.572676,151.718028,35.161259,1,0
0,0,4,4,7,7,14,39,20,59,0.000333,0.074878,6,1347.803642,74.87798,224.63394,39.302969,1,0
0,0,5,5,7,8,15,51,26,77,0.000333,0.100277,9,2707.475183,150.415288,300.830576,43.651484,1,0
0,0,6,6,6,14,20,22,30,52,0.000333,0.074913,6,1348.441566,74.91342,224.740261,68.812744,1,0
0,0,4,4,11,9,20,35,15,50,0.000333,0.072032,5,1080.482024,60.026779,216.096405,66.583073,2,0
0,0,4,4,10,8,18,25,15,40,0.000333,0.055599,5,833.985,46.3325,166.797,57.219281,1,0
0,0,11,11,11,17,28,53,44,97,0.000333,0.155438,10,4663.134274,259.063015,466.313427,107.540616,1,0
0,0,4,4,4,7,11,13,11,24,0.000333,0.027675,2,166.052718,9.225151,83.026359,27.651484,3,0
0,0,5,5,11,12,23,33,21,54,0.000333,0.081424,5,1221.361728,67.853429,244.272346,81.073298,1,0
0,0,3,3,8,7,15,15,9,24,0.000333,0.031255,4,375.061497,20.83675,93.765374,43.651484,3,0
0,0,7,7,11,19,30,44,28,72,0.000333,0.117765,5,1766.480614,98.137812,353.296123,118.764371,2,0
0,0,14,14,11,21,32,79,40,119,0.000333,0.198333,5,2975,165.277778,595,130.292414,5,0
0,0,6,6,9,10,19,24,17,41,0.000333,0.058055,4,696.660112,38.70334,174.165028,61.748606,1,0
0,0,6,6,9,10,19,28,17,45,0.000333,0.063719,4,764.626952,42.479275,191.156738,61.748606,1,0
0,0,7,7,11,19,30,44,28,72,0.000333,0.117765,5,1766.480614,98.137812,353.296123,118.764371,2,0
0,0,19,19,21,26,47,149,82,231,0.000333,0.427703,30,38493.30074,2138.516708,1283.110025,214.450099,11,0
0,0,5,5,9,10,19,24,17,41,0.000333,0.058055,4,696.660112,38.70334,174.165028,61.748606,1,0
0,0,4,4,6,9,15,14,12,26,0.000333,0.03386,3,304.737466,16.929859,101.579155,44.0391,1,0
0,0,5,5,9,8,17,23,18,41,0.000333,0.055862,8,1340.687812,74.482656,167.585976,52.529325,1,0
0,0,4,4,10,7,17,16,12,28,0.000333,0.03815,5,572.244798,31.791378,114.44896,52.870765,1,0
0,0,5,5,9,16,25,26,25,51,0.000333,0.078946,4,947.346663,52.63037,236.836666,92.529325,1,0
0,0,3,3,6,5,11,11,9,20,0.000333,0.023063,3,207.565897,11.531439,69.188632,27.119415,1,0
0,0,3,3,7,8,15,23,12,35,0.000333,0.04558,3,410.223513,22.790195,136.741171,43.651484,1,0
0,0,8,8,15,18,33,66,34,100,0.000333,0.168146,7,3531.075884,196.170882,504.439412,133.662009,2,0
0,0,3,3,7,8,15,23,12,35,0.000333,0.04558,3,410.223513,22.790195,136.741171,43.651484,1,0
0,0,3,3,8,7,15,11,9,20,0.000333,0.026046,4,312.551248,17.363958,78.137812,43.651484,1,0
0,0,11,11,15,21,36,84,43,127,0.000333,0.21886,14,9192.126653,510.673703,656.580475,150.842025,2,0
0,0,4,4,4,7,11,13,11,24,0.000333,0.027675,2,166.052718,9.225151,83.026359,27.651484,3,0
0,0,5,5,11,12,23,33,21,54,0.000333,0.081424,5,1221.361728,67.853429,244.272346,81.073298,1,0
0,0,11,11,15,21,36,84,43,127,0.000333,0.21886,14,9192.126653,510.673703,656.580475,150.842025,2,0
0,0,4,4,8,10,18,18,16,34,0.000333,0.047259,4,567.1098,31.5061,141.77745,57.219281,1,0
0,0,8,8,15,18,33,66,34,100,0.000333,0.168146,7,3531.075884,196.170882,504.439412,133.662009,2,0
0,0,8,8,12,15,27,42,27,69,0.000333,0.109362,6,1968.523426,109.362413,328.087238,101.622909,2,0
0,0,9,9,15,19,34,68,35,103,0.000333,0.17467,7,3668.060709,203.78115,524.008673,139.313982,2,0
0,0,5,5,8,10,18,28,17,45,0.000333,0.062549,4,750.5865,41.69925,187.646625,57.219281,1,0
0,0,3,3,5,6,11,9,8,17,0.000333,0.019603,2,117.620675,6.534482,58.810338,27.119415,1,0
0,0,7,7,11,19,30,44,28,72,0.000333,0.117765,5,1766.480614,98.137812,353.296123,118.764371,2,0
0,0,27,27,13,19,32,175,83,258,0.000333,0.43,24,30960,1720,1290,128.816339,27,0
0,0,5,5,9,11,20,19,16,35,0.000333,0.050422,4,605.069933,33.614996,151.267483,66.583073,1,0
0,0,11,11,12,15,27,43,35,78,0.000333,0.123627,12,4450.574702,247.25415,370.881225,101.622909,1,0
0,0,3,3,7,8,15,23,12,35,0.000333,0.04558,3,410.223513,22.790195,136.741171,43.651484,1,0
0,0,5,5,7,8,15,17,12,29,0.000333,0.037767,3,339.899482,18.883305,113.299827,43.651484,1,0
0,0,9,9,15,19,34,68,35,103,0.000333,0.17467,7,3668.060709,203.78115,524.008673,139.313982,2,0
0,0,3,3,6,10,16,25,13,38,0.000333,0.050667,3,456,25.333333,152,48.729056,1,0
0,0,8,8,15,18,33,66,34,100,0.000333,0.168146,7,3531.075884,196.170882,504.439412,133.662009,2,0
0,0,11,11,15,21,36,84,43,127,0.000333,0.21886,14,9192.126653,510.673703,656.580475,150.842025,2,0
0,0,11,11,15,21,36,84,43,127,0.000333,0.21886,14,9192.126653,510.673703,656.580475,150.842025,2,0
0,0,8,8,15,18,33,66,34,100,0.000333,0.168146,7,3531.075884,196.170882,504.439412,133.662009,2,0
0,0,7,7,11,19,30,44,28,72,0.000333,0.117765,5,1766.480614,98.137812,353.296123,118.764371,2,0
0,0,6,6,9,18,27,38,31,69,0.000333,0.109362,4,1312.348951,72.908275,328.087238,103.587975,1,0
0,0,4,4,9,16,25,27,24,51,0.000333,0.078946,4,947.346663,52.63037,236.836666,92.529325,1,0
0,0,3,3,9,8,17,16,11,27,0.000333,0.036787,4,441.445987,24.524777,110.361497,52.529325,2,0
0,0,5,5,11,11,22,31,17,48,0.000333,0.071351,5,1070.263588,59.459088,214.052718,76.107496,1,0
0,0,3,3,7,8,15,23,12,35,0.000333,0.04558,3,410.223513,22.790195,136.741171,43.651484,1,0
0,0,9,9,15,19,34,68,35,103,0.000333,0.17467,7,3668.060709,203.78115,524.008673,139.313982,2,0
0,0,8,8,15,18,33,66,34,100,0.000333,0.168146,7,3531.075884,196.170882,504.439412,133.662009,2,0
0,0,4,4,4,7,11,13,11,24,0.000333,0.027675,2,166.052718,9.225151,83.026359,27.651484,3,0
0,0,11,11,15,21,36,84,43,127,0.000333,0.21886,14,9192.126653,510.673703,656.580475,150.842025,2,0
0,0,7,7,11,19,30,44,28,72,0.000333,0.117765,5,1766.480614,98.137812,353.296123,118.764371,2,0
0,0,5,5,12,10,22,25,14,39,0.000333,0.057973,6,1043.506999,57.972611,173.917833,76.238831,3,0
0,0,4,4,6,8,14,17,12,29,0.000333,0.036804,3,331.239878,18.402215,110.413293,39.509775,3,0
0,0,8,8,15,18,33,66,34,100,0.000333,0.168146,7,3531.075884,196.170882,504.439412,133.662009,2,0
0,0,5,5,8,9,17,25,15,40,0.000333,0.0545,4,653.994055,36.333003,163.498514,52.529325,1,0
0,0,4,4,12,11,23,24,15,39,0.000333,0.058806,6,1058.513498,58.806305,176.418916,81.073298,4,0
0,0,3,3,7,5,12,11,7,18,0.000333,0.02151,3,193.587975,10.754888,64.529325,31.261125,1,0
0,0,6,6,7,14,21,30,22,52,0.000333,0.076134,3,685.201518,38.066751,228.400506,72.954453,1,0
0,0,3,3,8,7,15,11,9,20,0.000333,0.026046,4,312.551248,17.363958,78.137812,43.651484,1,0
0,0,8,8,15,18,33,66,34,100,0.000333,0.168146,7,3531.075884,196.170882,504.439412,133.662009,2,0
0,0,11,11,15,21,36,84,43,127,0.000333,0.21886,14,9192.126653,510.673703,656.580475,150.842025,2,0
0,0,3,3,8,8,16,20,12,32,0.000333,0.042667,4,512,28.444444,128,48,1,0
0,0,3,3,8,8,16,20,12,32,0.000333,0.042667,4,512,28.444444,128,48,1,0
0,0,7,7,8,14,22,30,32,62,0.000333,0.092162,8,2211.878083,122.882116,276.48476,77.302969,1,0
0,0,4,4,8,7,15,16,12,28,0.000333,0.036464,4,437.571747,24.309541,109.392937,43.651484,1,0
0,0,3,3,5,6,11,9,8,17,0.000333,0.019603,2,117.620675,6.534482,58.810338,27.119415,1,0
0,0,3,3,7,8,15,23,12,35,0.000333,0.04558,3,410.223513,22.790195,136.741171,43.651484,1,0
0,0,10,10,15,20,35,80,41,121,0.000333,0.206881,14,8689.005431,482.722524,620.643245,145.041921,2,0
0,0,9,9,15,19,34,68,35,103,0.000333,0.17467,7,3668.060709,203.78115,524.008673,139.313982,2,0
0,0,8,8,15,18,33,66,34,100,0.000333,0.168146,7,3531.075884,196.170882,504.439412,133.662009,2,0
0,0,3,3,8,7,15,11,9,20,0.000333,0.026046,4,312.551248,17.363958,78.137812,43.651484,1,0
0,0,4,4,8,7,15,15,10,25,0.000333,0.032557,4,390.68906,21.704948,97.672265,43.651484,1,0
0,0,3,3,9,8,17,16,11,27,0.000333,0.036787,4,441.445987,24.524777,110.361497,52.529325,2,0
0,0,3,3,7,8,15,23,12,35,0.000333,0.04558,3,410.223513,22.790195,136.741171,43.651484,1,0
0,0,3,3,11,9,20,19,14,33,0.000333,0.047541,5,713.118136,39.617674,142.623627,66.583073,3,0
0,0,14,14,26,36,62,96,63,159,0.000333,0.315572,13,12307.32377,683.74021,946.717213,308.328733,9,0
0,0,3,3,8,6,14,11,9,20,0.000333,0.025382,4,304.588394,16.921577,76.147098,39.509775,1,0
0,0,3,3,7,14,21,20,20,40,0.000333,0.058564,3,527.078091,29.282116,175.692697,72.954453,1,0
0,0,5,5,7,16,23,31,27,58,0.000333,0.087456,3,787.09978,43.727766,262.366593,83.651484,1,0
0,0,9,9,15,19,34,68,35,103,0.000333,0.17467,7,3668.060709,203.78115,524.008673,139.313982,2,0
0,0,4,4,4,7,11,13,11,24,0.000333,0.027675,2,166.052718,9.225151,83.026359,27.651484,3,0
0,0,8,8,15,18,33,66,34,100,0.000333,0.168146,7,3531.075884,196.170882,504.439412,133.662009,2,0
0,0,11,11,15,21,36,84,43,127,0.000333,0.21886,14,9192.126653,510.673703,656.580475,150.842025,2,0
0,0,5,5,8,10,18,28,17,45,0.000333,0.062549,4,750.5865,41.69925,187.646625,57.219281,1,0
0,0,4,4,6,8,14,17,12,29,0.000333,0.036804,3,331.239878,18.402215,110.413293,39.509775,3,0
0,0,3,3,9,8,17,16,11,27,0.000333,0.036787,4,441.445987,24.524777,110.361497,52.529325,2,0
0,0,5,5,8,10,18,28,17,45,0.000333,0.062549,4,750.5865,41.69925,187.646625,57.219281,1,0
0,0,3,3,7,5,12,11,7,18,0.000333,0.02151,3,193.587975,10.754888,64.529325,31.261125,1,0
0,0,5,5,8,8,16,25,13,38,0.000333,0.050667,4,608,33.777778,152,48,3,0
0,0,4,4,4,7,11,13,11,24,0.000333,0.027675,2,166.052718,9.225151,83.026359,27.651484,3,0
0,0,3,3,10,8,18,16,13,29,0.000333,0.040309,5,604.639125,33.591063,120.927825,57.219281,3,0
0,0,8,8,15,18,33,66,34,100,0.000333,0.168146,7,3531.075884,196.170882,504.439412,133.662009,2,0
0,0,3,3,8,7,15,11,9,20,0.000333,0.026046,4,312.551248,17.363958,78.137812,43.651484,1,0
0,0,5,5,8,12,20,40,23,63,0.000333,0.09076,4,1089.12588,60.506993,272.28147,67.01955,1,0
0,0,11,11,13,18,31,72,51,123,0.000333,0.203122,12,7312.393754,406.244097,609.366146,123.164366,1,0
0,0,5,5,7,7,14,16,11,27,0.000333,0.034266,3,308.395749,17.133097,102.798583,39.302969,1,0
0,0,4,4,9,7,16,17,12,29,0.000333,0.038667,4,464,25.777778,116,48.180809,1,0
0,0,4,4,5,7,12,14,10,24,0.000333,0.02868,2,172.0782,9.5599,86.0391,31.261125,2,0
0,0,7,7,11,19,30,44,28,72,0.000333,0.117765,5,1766.480614,98.137812,353.296123,118.764371,2,0
0,0,14,14,11,23,34,85,48,133,0.000333,0.225544,10,6766.325579,375.906977,676.632558,142.095673,1,0
0,0,4,4,9,8,17,21,14,35,0.000333,0.047687,4,572.244798,31.791378,143.061199,52.529325,1,0
0,0,5,5,8,11,19,30,18,48,0.000333,0.067967,4,815.602083,45.311227,203.900521,62.053748,1,0
0,0,5,5,7,8,15,20,15,35,0.000333,0.04558,3,410.223513,22.790195,136.741171,43.651484,1,0
0,0,7,7,11,19,30,44,28,72,0.000333,0.117765,5,1766.480614,98.137812,353.296123,118.764371,2,0
0,0,9,9,8,14,22,38,32,70,0.000333,0.104053,8,2497.281706,138.737873,312.160213,77.302969,1,0
0,0,3,3,7,8,15,23,12,35,0.000333,0.04558,3,410.223513,22.790195,136.741171,43.651484,1,0
0,0,8,8,16,13,29,56,25,81,0.000333,0.131165,8,3147.971685,174.887316,393.496461,112.105716,3,0
0,0,7,7,14,16,30,42,33,75,0.000333,0.122672,14,5152.235125,286.235285,368.016795,117.302969,4,0
0,0,12,12,17,23,40,61,54,115,0.000333,0.204007,16,9792.347695,544.019316,612.021731,173.528793,4,0
0,0,5,5,7,7,14,17,13,30,0.000333,0.038074,3,342.661943,19.036775,114.220648,39.302969,1,0
0,0,6,6,6,14,20,26,32,58,0.000333,0.083557,6,1504.030977,83.557277,250.67183,68.812744,1,0
0,0,5,5,10,11,21,20,16,36,0.000333,0.052708,5,790.617136,43.923174,158.123427,71.273029,1,0
0,0,3,3,7,8,15,23,12,35,0.000333,0.04558,3,410.223513,22.790195,136.741171,43.651484,1,0
0,0,7,7,11,19,30,44,28,72,0.000333,0.117765,5,1766.480614,98.137812,353.296123,118.764371,2,0
0,0,3,3,9,8,17,16,11,27,0.000333,0.036787,4,441.445987,24.524777,110.361497,52.529325,2,0
0,0,5,5,10,11,21,33,18,51,0.000333,0.074669,5,1120.040943,62.224497,224.008189,71.273029,1,0
0,0,3,3,9,8,17,16,11,27,0.000333,0.036787,4,441.445987,24.524777,110.361497,52.529325,2,0
0,0,4,4,4,7,11,13,11,24,0.000333,0.027675,2,166.052718,9.225151,83.026359,27.651484,3,0
0,0,26,26,16,30,46,145,84,229,0.000333,0.421632,16,20238.33101,1124.351723,1264.895688,211.206718,1,0
0,0,6,6,10,15,25,28,27,55,0.000333,0.085137,5,1277.060452,70.947803,255.41209,91.82264,1,0
0,0,5,5,8,12,20,25,19,44,0.000333,0.063388,4,760.659345,42.258852,190.164836,67.01955,1,0
0,0,4,4,6,8,14,17,12,29,0.000333,0.036804,3,331.239878,18.402215,110.413293,39.509775,3,0
0,0,4,4,11,10,21,24,14,38,0.000333,0.055636,5,834.54031,46.363351,166.908062,71.273029,3,0
0,0,4,4,4,7,11,13,11,24,0.000333,0.027675,2,166.052718,9.225151,83.026359,27.651484,2,0
0,0,3,3,8,6,14,11,9,20,0.000333,0.025382,4,304.588394,16.921577,76.147098,39.509775,1,0
0,0,3,3,8,7,15,11,9,20,0.000333,0.026046,4,312.551248,17.363958,78.137812,43.651484,1,0
0,0,8,8,15,18,33,66,34,100,0.000333,0.168146,7,3531.075884,196.170882,504.439412,133.662009,2,0
0,0,11,11,15,21,36,84,43,127,0.000333,0.21886,14,9192.126653,510.673703,656.580475,150.842025,2,0
0,0,9,9,15,19,34,68,35,103,0.000333,0.17467,7,3668.060709,203.78115,524.008673,139.313982,2,0
0,0,26,26,12,24,36,113,75,188,0.000333,0.323982,18,17495.02621,971.9459,971.9459,153.05865,3,0
0,0,6,6,6,14,20,24,31,55,0.000333,0.079235,6,1426.236271,79.235348,237.706045,68.812744,1,0
0,0,9,9,11,15,26,47,29,76,0.000333,0.119078,5,1786.167093,99.231505,357.233419,96.657107,2,0
0,0,3,3,7,8,15,23,12,35,0.000333,0.04558,3,410.223513,22.790195,136.741171,43.651484,1,0
0,0,22,22,20,41,61,143,95,238,0.000333,0.470505,20,28230.30973,1568.35054,1411.515486,306.098194,5,0
0,0,5,5,7,8,15,17,12,29,0.000333,0.037767,3,339.899482,18.883305,113.299827,43.651484,1,0
0,0,5,5,12,16,28,39,25,64,0.000333,0.102557,6,1846.02429,102.556905,307.670715,107.01955,2,0
0,0,4,4,8,8,16,18,12,30,0.000333,0.04,4,480,26.666667,120,48,1,0
0,0,4,4,9,9,18,19,15,34,0.000333,0.047259,4,567.1098,31.5061,141.77745,57.05865,1,0
0,0,10,10,7,10,17,44,26,70,0.000333,0.095374,6,1716.734393,95.374133,286.122399,52.870765,3,0
0,0,5,5,8,10,18,28,17,45,0.000333,0.062549,4,750.5865,41.69925,187.646625,57.219281,1,0
0,0,7,7,11,18,29,48,28,76,0.000333,0.123069,5,1846.032778,102.557377,369.206556,113.112398,1,0
0,0,3,3,10,8,18,16,13,29,0.000333,0.040309,5,604.639125,33.591063,120.927825,57.219281,3,0
0,0,8,8,15,18,33,66,34,100,0.000333,0.168146,7,3531.075884,196.170882,504.439412,133.662009,2,0
0,0,11,11,15,21,36,84,43,127,0.000333,0.21886,14,9192.126653,510.673703,656.580475,150.842025,2,0
0,0,9,9,15,19,34,68,35,103,0.000333,0.17467,7,3668.060709,203.78115,524.008673,139.313982,2,0
0,0,3,3,7,13,20,20,19,39,0.000333,0.056185,3,505.665587,28.092533,168.555196,67.757201,1,0
0,0,5,5,7,15,22,31,26,57,0.000333,0.084729,3,762.562807,42.3646,254.187602,78.254843,1,0
0,0,5,5,8,10,18,28,17,45,0.000333,0.062549,4,750.5865,41.69925,187.646625,57.219281,1,0
0,0,4,4,4,7,11,13,11,24,0.000333,0.027675,2,166.052718,9.225151,83.026359,27.651484,2,0
0,0,5,5,11,11,22,31,17,48,0.000333,0.071351,5,1070.263588,59.459088,214.052718,76.107496,1,0
0,0,8,8,15,18,33,66,34,100,0.000333,0.168146,7,3531.075884,196.170882,504.439412,133.662009,2,0
0,0,14,14,26,36,62,96,63,159,0.000333,0.315572,13,12307.32377,683.74021,946.717213,308.328733,9,0
0,0,3,3,11,9,20,19,14,33,0.000333,0.047541,5,713.118136,39.617674,142.623627,66.583073,3,0
0,0,3,3,5,5,10,12,7,19,0.000333,0.021039,2,126.233268,7.012959,63.116634,23.219281,1,0
0,0,3,3,8,7,15,20,12,32,0.000333,0.041673,4,500.081996,27.782333,125.020499,43.651484,1,0
0,0,3,3,8,7,15,11,9,20,0.000333,0.026046,4,312.551248,17.363958,78.137812,43.651484,1,0
0,0,3,3,9,8,17,16,11,27,0.000333,0.036787,4,441.445987,24.524777,110.361497,52.529325,2,0
0,0,9,9,14,19,33,48,38,86,0.000333,0.144606,14,6073.45052,337.413918,433.817894,134.013592,2,0
0,0,5,5,8,10,18,28,17,45,0.000333,0.062549,4,750.5865,41.69925,187.646625,57.219281,1,0
0,0,7,7,11,19,30,44,28,72,0.000333,0.117765,5,1766.480614,98.137812,353.296123,118.764371,2,0
0,0,3,3,8,6,14,11,9,20,0.000333,0.025382,4,304.588394,16.921577,76.147098,39.509775,1,0
0,0,5,5,8,12,20,25,19,44,0.000333,0.063388,4,760.659345,42.258852,190.164836,67.01955,1,0
0,0,4,4,5,10,15,14,14,28,0.000333,0.036464,2,218.785873,12.154771,109.392937,44.828921,1,0
0,0,3,3,8,8,16,20,12,32,0.000333,0.042667,4,512,28.444444,128,48,1,0
0,0,7,7,9,16,25,36,30,66,0.000333,0.102165,4,1225.978034,68.109891,306.494509,92.529325,1,0
0,0,6,6,8,12,20,21,18,39,0.000333,0.056185,4,674.220783,37.45671,168.555196,67.01955,1,0
0,0,3,3,7,8,15,23,12,35,0.000333,0.04558,3,410.223513,22.790195,136.741171,43.651484,1,0
0,0,5,5,8,11,19,36,19,55,0.000333,0.077879,4,934.544053,51.919114,233.636013,62.053748,1,0
0,0,5,5,9,14,23,25,20,45,0.000333,0.067853,4,814.241152,45.23562,203.560288,81.832294,1,0
0,0,3,3,9,8,17,16,11,27,0.000333,0.036787,4,441.445987,24.524777,110.361497,52.529325,2,0
0,0,9,9,9,19,28,41,45,86,0.000333,0.137811,8,3307.460186,183.747788,413.432523,109.239948,1,0
0,0,5,5,8,10,18,28,17,45,0.000333,0.062549,4,750.5865,41.69925,187.646625,57.219281,1,0
0,0,8,8,15,18,33,66,34,100,0.000333,0.168146,7,3531.075884,196.170882,504.439412,133.662009,2,0
0,0,5,5,8,10,18,28,17,45,0.000333,0.062549,4,750.5865,41.69925,187.646625,57.219281,1,0
0,0,11,11,15,21,36,84,43,127,0.000333,0.21886,14,9192.126653,510.673703,656.580475,150.842025,2,0
0,0,5,5,8,8,16,19,12,31,0.000333,0.041333,4,496,27.555556,124,48,1,0
0,0,10,10,11,16,27,52,31,83,0.000333,0.131552,5,1973.278313,109.626573,394.655663,102.053748,1,0
0,0,5,5,8,10,18,28,17,45,0.000333,0.062549,4,750.5865,41.69925,187.646625,57.219281,1,0
0,0,5,5,11,11,22,31,17,48,0.000333,0.071351,5,1070.263588,59.459088,214.052718,76.107496,1,0
0,0,4,4,8,8,16,18,12,30,0.000333,0.04,4,480,26.666667,120,48,1,0
0,0,5,5,7,7,14,16,11,27,0.000333,0.034266,3,308.395749,17.133097,102.798583,39.302969,1,0
0,0,5,5,8,10,18,28,17,45,0.000333,0.062549,4,750.5865,41.69925,187.646625,57.219281,1,0
0,0,4,4,6,8,14,17,12,29,0.000333,0.036804,3,331.239878,18.402215,110.413293,39.509775,3,0
0,0,5,5,8,10,18,26,15,41,0.000333,0.056989,4,683.8677,37.99265,170.966925,57.219281,1,0
0,0,3,3,8,7,15,11,9,20,0.000333,0.026046,4,312.551248,17.363958,78.137812,43.651484,1,0
0,0,8,8,15,18,33,66,34,100,0.000333,0.168146,7,3531.075884,196.170882,504.439412,133.662009,2,0
0,0,3,3,7,8,15,23,12,35,0.000333,0.04558,3,410.223513,22.790195,136.741171,43.651484,1,0
0,0,14,14,11,23,34,85,48,133,0.000333,0.225544,10,6766.325579,375.906977,676.632558,142.095673,1,0
0,0,9,9,15,19,34,68,35,103,0.000333,0.17467,7,3668.060709,203.78115,524.008673,139.313982,2,0
0,0,4,4,11,8,19,20,16,36,0.000333,0.050975,10,1529.253905,84.95855,152.92539,62.053748,1,0
0,0,5,5,8,10,18,28,17,45,0.000333,0.062549,4,750.5865,41.69925,187.646625,57.219281,1,0
0,0,9,9,15,19,34,68,35,103,0.000333,0.17467,7,3668.060709,203.78115,524.008673,139.313982,2,0
0,0,11,11,15,21,36,84,43,127,0.000333,0.21886,14,9192.126653,510.673703,656.580475,150.842025,2,0
0,0,6,6,11,16,27,38,29,67,0.000333,0.106192,5,1592.887313,88.49374,318.577463,102.053748,1,0
0,0,3,3,9,8,17,16,11,27,0.000333,0.036787,4,441.445987,24.524777,110.361497,52.529325,2,0
0,0,6,6,8,8,16,20,14,34,0.000333,0.045333,4,544,30.222222,136,48,1,0
0,0,18,18,16,25,41,98,63,161,0.000333,0.287522,16,13801.05396,766.72522,862.565873,180.096405,4,0
0,0,3,3,13,10,23,21,15,36,0.000333,0.054283,6,977.089383,54.282743,162.84823,81.324997,3,0
0,0,11,11,12,18,30,69,40,109,0.000333,0.178284,12,6418.212899,356.567383,534.851075,118.0782,5,0
0,0,5,5,7,8,15,17,12,29,0.000333,0.037767,3,339.899482,18.883305,113.299827,43.651484,1,0
0,0,5,5,6,12,18,18,17,35,0.000333,0.048649,3,437.842125,24.324563,145.947375,58.529325,1,0
0,0,3,3,9,6,15,18,12,30,0.000333,0.039069,8,937.653743,52.091875,117.206718,44.0391,1,0
0,0,3,3,7,8,15,23,12,35,0.000333,0.04558,3,410.223513,22.790195,136.741171,43.651484,1,0
0,0,6,6,9,15,24,34,24,58,0.000333,0.088643,4,1063.7113,59.095072,265.927825,87.132684,1,0
0,0,3,3,8,7,15,15,9,24,0.000333,0.031255,4,375.061497,20.83675,93.765374,43.651484,3,0
0,0,4,4,4,7,11,13,11,24,0.000333,0.027675,2,166.052718,9.225151,83.026359,27.651484,3,0
0,0,3,3,9,13,22,20,16,36,0.000333,0.053513,4,642.158153,35.675453,160.539538,76.635041,3,0
0,0,7,7,11,19,30,44,28,72,0.000333,0.117765,5,1766.480614,98.137812,353.296123,118.764371,2,0
0,0,6,6,14,10,24,37,22,59,0.000333,0.090171,14,3787.179026,210.398835,270.512788,86.52225,4,0
0,0,5,5,10,11,21,33,18,51,0.000333,0.074669,5,1120.040943,62.224497,224.008189,71.273029,1,0
0,0,3,3,7,8,15,23,12,35,0.000333,0.04558,3,410.223513,22.790195,136.741171,43.651484,1,0
0,0,7,7,10,14,24,40,27,67,0.000333,0.102397,5,1535.962438,85.331247,307.192488,86.52225,1,0
0,0,3,3,9,6,15,16,10,26,0.000333,0.03386,4,406.316622,22.573146,101.579155,44.0391,1,0
0,0,3,3,8,8,16,20,12,32,0.000333,0.042667,4,512,28.444444,128,48,1,0
0,0,5,5,10,11,21,29,17,46,0.000333,0.067349,5,1010.233007,56.124056,202.046601,71.273029,1,0
0,0,5,5,12,16,28,39,25,64,0.000333,0.102557,6,1846.02429,102.556905,307.670715,107.01955,2,0
0,0,8,8,12,16,28,40,30,70,0.000333,0.112172,6,2019.089067,112.171615,336.514845,107.01955,1,0
0,0,4,4,4,7,11,13,11,24,0.000333,0.027675,2,166.052718,9.225151,83.026359,27.651484,3,0
0,0,11,11,12,16,28,56,40,96,0.000333,0.153835,12,5538.07287,307.670715,461.506073,107.01955,1,0
0,0,4,4,5,12,17,14,15,29,0.000333,0.039512,2,237.072845,13.170714,118.536422,54.62919,1,0
0,0,3,3,7,8,15,23,12,35,0.000333,0.04558,3,410.223513,22.790195,136.741171,43.651484,1,0
0,0,11,11,15,21,36,84,43,127,0.000333,0.21886,14,9192.126653,510.673703,656.580475,150.842025,2,0
0,0,8,8,15,18,33,66,34,100,0.000333,0.168146,7,3531.075884,196.170882,504.439412,133.662009,2,0
0,0,9,9,15,19,34,68,35,103,0.000333,0.17467,7,3668.060709,203.78115,524.008673,139.313982,2,0
0,0,7,7,11,19,30,44,28,72,0.000333,0.117765,5,1766.480614,98.137812,353.296123,118.764371,2,0
0,0,5,5,10,10,20,26,15,41,0.000333,0.059066,5,885.995259,49.221959,177.199052,66.438562,1,0
0,0,4,4,4,7,11,13,11,24,0.000333,0.027675,2,166.052718,9.225151,83.026359,27.651484,3,0
0,0,3,3,7,8,15,23,12,35,0.000333,0.04558,3,410.223513,22.790195,136.741171,43.651484,1,0
0,0,9,9,15,19,34,68,35,103,0.000333,0.17467,7,3668.060709,203.78115,524.008673,139.313982,2,0
0,0,5,5,10,11,21,29,17,46,0.000333,0.067349,5,1010.233007,56.124056,202.046601,71.273029,1,0
0,0,7,7,11,19,30,44,28,72,0.000333,0.117765,5,1766.480614,98.137812,353.296123,118.764371,2,0
0,0,11,11,12,17,29,55,44,99,0.000333,0.160313,12,5771.281422,320.626746,480.940119,112.506418,1,0
0,0,4,4,9,8,17,21,14,35,0.000333,0.047687,4,572.244798,31.791378,143.061199,52.529325,1,0
0,0,8,8,8,16,24,56,32,88,0.000333,0.134492,8,3227.813601,179.322978,403.4767,88,1,0
0,0,5,5,9,15,24,24,21,45,0.000333,0.068774,4,825.29325,45.849625,206.323313,87.132684,1,0
0,0,6,6,9,10,19,28,17,45,0.000333,0.063719,4,764.626952,42.479275,191.156738,61.748606,1,0
0,0,8,8,15,18,33,66,34,100,0.000333,0.168146,7,3531.075884,196.170882,504.439412,133.662009,2,0
0,0,3,3,8,7,15,20,12,32,0.000333,0.041673,4,500.081996,27.782333,125.020499,43.651484,1,0
0,0,7,7,11,13,24,31,26,57,0.000333,0.087114,10,2613.428625,145.190479,261.342863,86.159464,1,0
0,0,3,3,9,8,17,16,11,27,0.000333,0.036787,4,441.445987,24.524777,110.361497,52.529325,2,0
0,0,4,4,4,7,11,13,11,24,0.000333,0.027675,2,166.052718,9.225151,83.026359,27.651484,3,0
0,0,4,4,4,7,11,13,11,24,0.000333,0.027675,2,166.052718,9.225151,83.026359,27.651484,3,0
0,0,6,6,12,15,27,37,22,59,0.000333,0.093513,6,1683.230176,93.512788,280.538363,101.622909,4,0
0,0,7,7,8,14,22,30,32,62,0.000333,0.092162,8,2211.878083,122.882116,276.48476,77.302969,1,0
0,0,10,10,7,14,21,57,36,93,0.000333,0.136162,6,2450.913122,136.16184,408.48552,72.954453,1,0
0,0,7,7,11,19,30,44,28,72,0.000333,0.117765,5,1766.480614,98.137812,353.296123,118.764371,2,0
0,0,7,7,11,19,30,44,28,72,0.000333,0.117765,5,1766.480614,98.137812,353.296123,118.764371,2,0
0,0,5,5,8,12,20,25,19,44,0.000333,0.063388,4,760.659345,42.258852,190.164836,67.01955,1,0
0,0,3,3,10,8,18,16,13,29,0.000333,0.040309,5,604.639125,33.591063,120.927825,57.219281,3,0
0,0,7,7,11,19,30,44,28,72,0.000333,0.117765,5,1766.480614,98.137812,353.296123,118.764371,2,0
0,0,9,9,15,19,34,68,35,103,0.000333,0.17467,7,3668.060709,203.78115,524.008673,139.313982,2,0
0,0,5,5,9,10,19,29,21,50,0.000333,0.070799,8,1699.171005,94.398389,212.396376,61.748606,1,0
0,0,4,4,9,8,17,20,12,32,0.000333,0.0436,4,523.195244,29.066402,130.798811,52.529325,1,0
0,0,8,8,17,13,30,41,27,68,0.000333,0.111223,16,5338.696968,296.594276,333.668561,117.592585,4,0
0,0,5,5,9,11,20,19,22,41,0.000333,0.059066,8,1417.592415,78.755134,177.199052,66.583073,1,0
0,0,5,5,11,12,23,33,21,54,0.000333,0.081424,5,1221.361728,67.853429,244.272346,81.073298,1,0
0,0,25,25,12,35,47,382,213,595,0.000333,1.10166,36,118979.2932,6609.960733,3304.980367,222.544456,4,0
0,0,3,3,5,6,11,9,8,17,0.000333,0.019603,2,117.620675,6.534482,58.810338,27.119415,1,0
0,0,7,7,11,19,30,44,28,72,0.000333,0.117765,5,1766.480614,98.137812,353.296123,118.764371,2,0
0,0,6,6,6,14,20,24,31,55,0.000333,0.079235,6,1426.236271,79.235348,237.706045,68.812744,1,0
0,0,3,3,7,5,12,11,7,18,0.000333,0.02151,3,193.587975,10.754888,64.529325,31.261125,1,0
0,0,7,7,11,19,30,44,28,72,0.000333,0.117765,5,1766.480614,98.137812,353.296123,118.764371,2,0
0,0,4,4,6,12,18,20,17,37,0.000333,0.051429,3,462.861675,25.714538,154.287225,58.529325,1,0
0,0,11,11,7,15,22,59,38,97,0.000333,0.144188,6,2595.389202,144.188289,432.564867,78.254843,1,0
0,0,9,9,15,19,34,68,35,103,0.000333,0.17467,7,3668.060709,203.78115,524.008673,139.313982,2,0
0,0,4,4,10,10,20,25,17,42,0.000333,0.060507,5,907.6049,50.422494,181.52098,66.438562,1,0
0,0,4,4,5,9,14,15,13,28,0.000333,0.035535,2,213.211876,11.845104,106.605938,40.138965,1,0
0,0,5,5,8,10,18,26,15,41,0.000333,0.056989,4,683.8677,37.99265,170.966925,57.219281,1,0
0,0,4,4,4,7,11,13,11,24,0.000333,0.027675,2,166.052718,9.225151,83.026359,27.651484,2,0
0,0,4,4,9,8,17,15,12,27,0.000333,0.036787,4,441.445987,24.524777,110.361497,52.529325,1,0
0,0,6,6,10,11,21,24,21,45,0.000333,0.065885,5,988.27142,54.903968,197.654284,71.273029,1,0
0,0,3,3,8,7,15,11,9,20,0.000333,0.026046,4,312.551248,17.363958,78.137812,43.651484,1,0
0,0,10,10,11,14,25,79,44,123,0.000333,0.190398,15,8567.91467,475.995259,571.194311,91.356717,1,0
0,0,5,5,8,10,18,28,17,45,0.000333,0.062549,4,750.5865,41.69925,187.646625,57.219281,1,0
0,0,9,9,20,15,35,61,32,93,0.000333,0.159008,20,9540.466412,530.025912,477.023321,145.041921,5,0
0,0,3,3,7,8,15,23,12,35,0.000333,0.04558,3,410.223513,22.790195,136.741171,43.651484,1,0
0,0,11,11,15,21,36,84,43,127,0.000333,0.21886,14,9192.126653,510.673703,656.580475,150.842025,2,0
0,0,5,5,8,11,19,30,18,48,0.000333,0.067967,4,815.602083,45.311227,203.900521,62.053748,1,0
0,0,11,11,8,16,24,48,39,87,0.000333,0.132964,8,3191.133901,177.285217,398.891738,88,1,0
0,0,6,6,9,7,16,27,14,41,0.000333,0.054667,8,1312,72.888889,164,48.180809,3,0
0,0,8,8,16,13,29,56,25,81,0.000333,0.131165,8,3147.971685,174.887316,393.496461,112.105716,3,0
0,0,5,5,8,11,19,30,18,48,0.000333,0.067967,4,815.602083,45.311227,203.900521,62.053748,1,0
0,0,6,6,11,11,22,51,26,77,0.000333,0.114459,10,3433.762346,190.764575,343.376235,76.107496,2,0
0,0,6,6,11,11,22,51,26,77,0.000333,0.114459,10,3433.762346,190.764575,343.376235,76.107496,2,0
0,0,6,6,9,10,19,28,17,45,0.000333,0.063719,4,764.626952,42.479275,191.156738,61.748606,1,0
0,0,5,5,11,12,23,33,21,54,0.000333,0.081424,5,1221.361728,67.853429,244.272346,81.073298,1,0
0,0,3,3,13,10,23,21,15,36,0.000333,0.054283,6,977.089383,54.282743,162.84823,81.324997,3,0
0,0,3,3,8,7,15,11,9,20,0.000333,0.026046,4,312.551248,17.363958,78.137812,43.651484,1,0
0,0,11,11,11,16,27,52,43,95,0.000333,0.150571,10,4517.143127,250.952396,451.714313,102.053748,1,0
0,0,3,3,8,6,14,11,9,20,0.000333,0.025382,4,304.588394,16.921577,76.147098,39.509775,1,0
0,0,3,3,8,7,15,20,12,32,0.000333,0.041673,4,500.081996,27.782333,125.020499,43.651484,1,0
0,0,6,6,7,13,20,35,24,59,0.000333,0.084998,3,764.981273,42.49896,254.993758,67.757201,1,0
0,0,9,9,15,19,34,68,35,103,0.000333,0.17467,7,3668.060709,203.78115,524.008673,139.313982,2,0
0,0,6,6,6,13,19,27,21,48,0.000333,0.067967,3,611.701562,33.98342,203.900521,63.615491,1,0
0,0,7,7,11,19,30,44,28,72,0.000333,0.117765,5,1766.480614,98.137812,353.296123,118.764371,2,0
0,0,3,3,10,8,18,16,13,29,0.000333,0.040309,5,604.639125,33.591063,120.927825,57.219281,3,0
0,0,3,3,8,7,15,20,12,32,0.000333,0.041673,4,500.081996,27.782333,125.020499,43.651484,1,0
0,0,25,25,12,35,47,382,213,595,0.000333,1.10166,36,118979.2932,6609.960733,3304.980367,222.544456,4,0
0,0,6,6,9,12,21,34,21,55,0.000333,0.080526,4,966.309833,53.68388,241.577458,71.548875,1,0
0,0,6,6,14,11,25,40,23,63,0.000333,0.097521,14,4095.881159,227.548953,292.56294,91.356717,4,0
0,0,3,3,9,13,22,20,16,36,0.000333,0.053513,4,642.158153,35.675453,160.539538,76.635041,3,0
0,0,5,5,10,11,21,33,18,51,0.000333,0.074669,5,1120.040943,62.224497,224.008189,71.273029,1,0
0,0,4,4,4,7,11,13,11,24,0.000333,0.027675,2,166.052718,9.225151,83.026359,27.651484,3,0
0,0,5,5,10,12,22,24,21,45,0.000333,0.066891,5,1003.372114,55.742895,200.674423,76.238831,1,0
0,0,4,4,5,9,14,15,13,28,0.000333,0.035535,2,213.211876,11.845104,106.605938,40.138965,1,0
0,0,11,11,13,16,29,57,40,97,0.000333,0.157075,12,5654.689878,314.149438,471.224157,112.105716,1,0
0,0,5,5,8,10,18,28,17,45,0.000333,0.062549,4,750.5865,41.69925,187.646625,57.219281,1,0
0,0,4,4,4,7,11,13,11,24,0.000333,0.027675,2,166.052718,9.225151,83.026359,27.651484,3,0
0,0,7,7,8,12,20,27,24,51,0.000333,0.073473,8,1763.346663,97.963703,220.418333,67.01955,3,0
0,0,3,3,9,8,17,16,11,27,0.000333,0.036787,4,441.445987,24.524777,110.361497,52.529325,2,0
0,0,3,3,9,5,14,16,10,26,0.000333,0.032997,8,791.929824,43.996101,98.991228,40.138965,1,0
0,0,3,3,7,5,12,11,7,18,0.000333,0.02151,3,193.587975,10.754888,64.529325,31.261125,1,0
0,0,3,3,9,8,17,16,11,27,0.000333,0.036787,4,441.445987,24.524777,110.361497,52.529325,2,0
0,0,10,10,9,15,24,43,35,78,0.000333,0.119209,8,2861.0166,158.945367,357.627075,87.132684,1,0
0,0,4,4,7,7,14,15,10,25,0.000333,0.031728,3,285.551619,15.863979,95.183873,39.302969,1,0
0,0,5,5,11,11,22,31,17,48,0.000333,0.071351,5,1070.263588,59.459088,214.052718,76.107496,1,0
0,0,6,6,7,13,20,35,24,59,0.000333,0.084998,3,764.981273,42.49896,254.993758,67.757201,1,0
0,0,4,4,7,11,18,24,17,41,0.000333,0.056989,3,512.900775,28.494488,170.966925,57.705232,1,0
0,0,15,15,12,20,32,105,52,157,0.000333,0.261667,12,9420,523.333333,785,129.458112,2,0
0,0,5,5,9,16,25,26,25,51,0.000333,0.078946,4,947.346663,52.63037,236.836666,92.529325,1,0
0,0,7,7,10,13,23,37,19,56,0.000333,0.08444,5,1266.597348,70.366519,253.31947,81.324997,3,0
0,0,7,7,11,18,29,48,28,76,0.000333,0.123069,5,1846.032778,102.557377,369.206556,113.112398,1,0
0,0,5,5,8,15,23,29,34,63,0.000333,0.094995,8,2279.875226,126.659735,284.984403,82.603359,1,0
0,0,9,9,15,19,34,68,35,103,0.000333,0.17467,7,3668.060709,203.78115,524.008673,139.313982,2,0
0,0,8,8,15,18,33,66,34,100,0.000333,0.168146,7,3531.075884,196.170882,504.439412,133.662009,2,0
0,0,11,11,15,21,36,84,43,127,0.000333,0.21886,14,9192.126653,510.673703,656.580475,150.842025,2,0
0,0,5,5,8,8,16,25,13,38,0.000333,0.050667,4,608,33.777778,152,48,3,0
0,0,3,3,8,7,15,20,12,32,0.000333,0.041673,4,500.081996,27.782333,125.020499,43.651484,1,0
0,0,4,4,4,7,11,13,11,24,0.000333,0.027675,2,166.052718,9.225151,83.026359,27.651484,3,0
0,0,3,3,5,6,11,9,8,17,0.000333,0.019603,2,117.620675,6.534482,58.810338,27.119415,1,0
0,0,5,5,10,10,20,26,15,41,0.000333,0.059066,5,885.995259,49.221959,177.199052,66.438562,1,0
0,0,4,4,9,14,23,24,22,46,0.000333,0.069361,4,832.3354,46.240856,208.08385,81.832294,1,0
0,0,7,7,11,19,30,44,28,72,0.000333,0.117765,5,1766.480614,98.137812,353.296123,118.764371,2,0
0,0,5,5,7,8,15,17,12,29,0.000333,0.037767,3,339.899482,18.883305,113.299827,43.651484,1,0
0,0,11,11,15,21,36,84,43,127,0.000333,0.21886,14,9192.126653,510.673703,656.580475,150.842025,2,0
0,0,7,7,8,17,25,40,32,72,0.000333,0.111453,4,1337.430583,74.301699,334.357646,93.486868,1,0
0,0,11,11,15,21,36,84,43,127,0.000333,0.21886,14,9192.126653,510.673703,656.580475,150.842025,2,0
0,0,8,8,11,15,26,41,22,63,0.000333,0.098709,5,1480.638511,82.257695,296.127702,96.657107,4,0
0,0,7,7,11,18,29,48,28,76,0.000333,0.123069,5,1846.032778,102.557377,369.206556,113.112398,1,0
0,0,8,8,15,18,33,66,34,100,0.000333,0.168146,7,3531.075884,196.170882,504.439412,133.662009,2,0
0,0,9,9,15,19,34,68,35,103,0.000333,0.17467,7,3668.060709,203.78115,524.008673,139.313982,2,0
0,0,5,5,8,10,18,28,17,45,0.000333,0.062549,4,750.5865,41.69925,187.646625,57.219281,1,0
0,0,5,5,8,10,18,28,17,45,0.000333,0.062549,4,750.5865,41.69925,187.646625,57.219281,1,0
0,0,5,5,9,12,21,22,18,40,0.000333,0.058564,4,702.770788,39.042822,175.692697,71.548875,1,0
0,0,4,4,6,12,18,20,17,37,0.000333,0.051429,3,462.861675,25.714538,154.287225,58.529325,1,0
0,0,5,5,12,16,28,39,25,64,0.000333,0.102557,6,1846.02429,102.556905,307.670715,107.01955,2,0
0,0,4,4,4,7,11,13,11,24,0.000333,0.027675,2,166.052718,9.225151,83.026359,27.651484,3,0
0,0,5,5,8,10,18,28,17,45,0.000333,0.062549,4,750.5865,41.69925,187.646625,57.219281,1,0
0,0,3,3,8,7,15,15,9,24,0.000333,0.031255,4,375.061497,20.83675,93.765374,43.651484,3,0
0,0,11,11,15,21,36,84,43,127,0.000333,0.21886,14,9192.126653,510.673703,656.580475,150.842025,2,0
0,0,4,4,4,7,11,13,11,24,0.000333,0.027675,2,166.052718,9.225151,83.026359,27.651484,3,0
0,0,10,10,16,17,33,56,41,97,0.000333,0.163102,16,7828.899673,434.938871,489.30623,133.486868,4,0
0,0,3,3,10,8,18,16,13,29,0.000333,0.040309,5,604.639125,33.591063,120.927825,57.219281,3,0
0,0,5,5,10,13,23,24,19,43,0.000333,0.064838,5,972.565821,54.031434,194.513164,81.324997,1,0
0,0,6,6,13,11,24,38,23,61,0.000333,0.093228,12,3356.192551,186.455142,279.682713,86.159464,4,0
0,0,6,6,9,10,19,28,17,45,0.000333,0.063719,4,764.626952,42.479275,191.156738,61.748606,1,0
0,0,6,6,5,12,17,19,26,45,0.000333,0.061312,4,735.743311,40.874628,183.935828,54.62919,1,0
0,0,7,7,11,18,29,48,28,76,0.000333,0.123069,5,1846.032778,102.557377,369.206556,113.112398,1,0
0,0,8,8,13,16,29,38,23,61,0.000333,0.098779,6,1778.021044,98.778947,296.336841,112.105716,3,0
0,0,5,5,10,13,23,24,19,43,0.000333,0.064838,5,972.565821,54.031434,194.513164,81.324997,1,0
0,0,7,7,11,19,30,44,28,72,0.000333,0.117765,5,1766.480614,98.137812,353.296123,118.764371,2,0
0,0,5,5,9,9,18,34,14,48,0.000333,0.066719,4,800.6256,44.4792,200.1564,57.05865,3,0
0,0,5,5,7,15,22,17,22,39,0.000333,0.057973,3,521.753499,28.986306,173.917833,78.254843,1,0
0,0,8,8,11,15,26,59,34,93,0.000333,0.145714,10,4371.408938,242.856052,437.140894,96.657107,1,0
0,0,4,4,10,9,19,22,13,35,0.000333,0.049559,5,743.387315,41.299295,148.677463,61.748606,1,0
0,0,3,3,7,8,15,23,12,35,0.000333,0.04558,3,410.223513,22.790195,136.741171,43.651484,1,0
0,0,3,3,9,8,17,16,11,27,0.000333,0.036787,4,441.445987,24.524777,110.361497,52.529325,2,0
0,0,5,5,8,10,18,28,17,45,0.000333,0.062549,4,750.5865,41.69925,187.646625,57.219281,1,0
0,0,4,4,6,10,16,13,13,26,0.000333,0.034667,3,312,17.333333,104,48.729056,1,0
0,0,11,11,12,17,29,56,46,102,0.000333,0.165171,12,5946.168738,330.342708,495.514062,112.506418,1,0
0,0,4,4,8,11,19,27,17,44,0.000333,0.062303,4,747.635242,41.535291,186.908811,62.053748,1,0
0,0,5,5,11,12,23,33,21,54,0.000333,0.081424,5,1221.361728,67.853429,244.272346,81.073298,1,0
0,0,3,3,8,8,16,20,12,32,0.000333,0.042667,4,512,28.444444,128,48,1,0
0,0,5,5,8,10,18,28,17,45,0.000333,0.062549,4,750.5865,41.69925,187.646625,57.219281,1,0
0,0,16,16,11,26,37,113,60,173,0.000333,0.300412,10,9012.354323,500.686351,901.235432,160.26518,1,0
0,0,7,7,11,19,30,44,28,72,0.000333,0.117765,5,1766.480614,98.137812,353.296123,118.764371,2,0
0,0,10,10,7,14,21,57,36,93,0.000333,0.136162,6,2450.913122,136.16184,408.48552,72.954453,1,0
0,0,4,4,5,12,17,14,15,29,0.000333,0.039512,2,237.072845,13.170714,118.536422,54.62919,1,0
0,0,18,18,11,28,39,115,64,179,0.000333,0.315362,10,9460.869972,525.603887,946.086997,172.659686,1,0
0,0,11,11,15,21,36,84,43,127,0.000333,0.21886,14,9192.126653,510.673703,656.580475,150.842025,2,0
0,0,6,6,8,14,22,31,23,54,0.000333,0.08027,4,963.23723,53.513179,240.809307,77.302969,1,0
0,0,6,6,14,10,24,37,22,59,0.000333,0.090171,14,3787.179026,210.398835,270.512788,86.52225,4,0
0,0,5,5,9,15,24,31,23,54,0.000333,0.082529,4,990.3519,55.01955,247.587975,87.132684,1,0
0,0,11,11,15,21,36,84,43,127,0.000333,0.21886,14,9192.126653,510.673703,656.580475,150.842025,2,0
0,0,6,6,8,13,21,42,25,67,0.000333,0.098095,4,1177.141069,65.396726,294.285267,72.105716,1,0
0,0,9,9,15,19,34,68,35,103,0.000333,0.17467,7,3668.060709,203.78115,524.008673,139.313982,2,0
0,0,5,5,7,8,15,17,12,29,0.000333,0.037767,3,339.899482,18.883305,113.299827,43.651484,1,0
0,0,4,4,8,11,19,27,17,44,0.000333,0.062303,4,747.635242,41.535291,186.908811,62.053748,1,0
0,0,5,5,8,11,19,36,19,55,0.000333,0.077879,4,934.544053,51.919114,233.636013,62.053748,1,0
0,0,12,12,9,14,23,51,37,88,0.000333,0.132691,8,3184.587617,176.921534,398.073452,81.832294,5,0
0,0,5,5,11,11,22,31,17,48,0.000333,0.071351,5,1070.263588,59.459088,214.052718,76.107496,1,0
0,0,3,3,7,5,12,11,7,18,0.000333,0.02151,3,193.587975,10.754888,64.529325,31.261125,1,0
0,0,7,7,11,19,30,44,28,72,0.000333,0.117765,5,1766.480614,98.137812,353.296123,118.764371,2,0
0,0,4,4,5,11,16,13,14,27,0.000333,0.036,2,216,12,108,49.663388,1,0
0,0,7,7,11,19,30,44,28,72,0.000333,0.117765,5,1766.480614,98.137812,353.296123,118.764371,2,0
0,0,3,3,8,8,16,20,12,32,0.000333,0.042667,4,512,28.444444,128,48,1,0
0,0,4,4,4,7,11,13,11,24,0.000333,0.027675,2,166.052718,9.225151,83.026359,27.651484,3,0
0,0,5,5,7,7,14,16,11,27,0.000333,0.034266,3,308.395749,17.133097,102.798583,39.302969,1,0
0,0,7,7,11,19,30,44,28,72,0.000333,0.117765,5,1766.480614,98.137812,353.296123,118.764371,2,0
0,0,5,5,9,12,21,19,24,43,0.000333,0.062957,8,1510.957193,83.942066,188.869649,71.548875,1,0
0,0,4,4,4,7,11,13,11,24,0.000333,0.027675,2,166.052718,9.225151,83.026359,27.651484,3,0
0,0,3,3,8,7,15,15,9,24,0.000333,0.031255,4,375.061497,20.83675,93.765374,43.651484,3,0
0,0,3,3,9,8,17,16,11,27,0.000333,0.036787,4,441.445987,24.524777,110.361497,52.529325,2,0
0,0,9,9,15,19,34,68,35,103,0.000333,0.17467,7,3668.060709,203.78115,524.008673,139.313982,2,0
0,0,11,11,15,21,36,84,43,127,0.000333,0.21886,14,9192.126653,510.673703,656.580475,150.842025,2,0
0,0,6,6,14,11,25,40,23,63,0.000333,0.097521,14,4095.881159,227.548953,292.56294,91.356717,4,0
0,0,6,6,14,11,25,38,23,61,0.000333,0.094425,14,3965.853186,220.325177,283.275228,91.356717,4,0
0,0,3,3,9,8,17,16,11,27,0.000333,0.036787,4,441.445987,24.524777,110.361497,52.529325,2,0
0,0,5,5,8,8,16,19,12,31,0.000333,0.041333,4,496,27.555556,124,48,1,0
0,0,9,9,15,19,34,68,35,103,0.000333,0.17467,7,3668.060709,203.78115,524.008673,139.313982,2,0
0,0,3,3,8,7,15,11,9,20,0.000333,0.026046,4,312.551248,17.363958,78.137812,43.651484,1,0
0,0,11,11,15,21,36,84,43,127,0.000333,0.21886,14,9192.126653,510.673703,656.580475,150.842025,2,0
0,0,9,9,15,19,34,68,35,103,0.000333,0.17467,7,3668.060709,203.78115,524.008673,139.313982,2,0
0,0,3,3,10,8,18,16,13,29,0.000333,0.040309,5,604.639125,33.591063,120.927825,57.219281,3,0
0,0,8,8,15,18,33,66,34,100,0.000333,0.168146,7,3531.075884,196.170882,504.439412,133.662009,2,0
0,0,11,11,15,21,36,84,43,127,0.000333,0.21886,14,9192.126653,510.673703,656.580475,150.842025,2,0
0,0,9,9,15,19,34,68,35,103,0.000333,0.17467,7,3668.060709,203.78115,524.008673,139.313982,2,0
0,0,3,3,9,8,17,16,11,27,0.000333,0.036787,4,441.445987,24.524777,110.361497,52.529325,2,0
0,0,8,8,9,15,24,32,29,61,0.000333,0.093228,4,1118.73085,62.151714,279.682713,87.132684,1,0
0,0,5,5,9,14,23,25,20,45,0.000333,0.067853,4,814.241152,45.23562,203.560288,81.832294,1,0
0,0,55,55,28,89,117,543,376,919,0.000333,2.104622,56,353576.4499,19643.13611,6313.865177,710.946213,33,0
0,0,5,5,10,11,21,29,17,46,0.000333,0.067349,5,1010.233007,56.124056,202.046601,71.273029,1,0
0,0,4,4,8,8,16,23,14,37,0.000333,0.049333,4,592,32.888889,148,48,1,0
0,0,4,4,6,8,14,17,12,29,0.000333,0.036804,3,331.239878,18.402215,110.413293,39.509775,3,0
0,0,3,3,8,7,15,11,9,20,0.000333,0.026046,4,312.551248,17.363958,78.137812,43.651484,1,0
0,0,13,13,15,11,26,96,45,141,0.000333,0.220921,28,18557.33601,1030.963112,662.762,96.657107,5,0
0,0,3,3,8,7,15,11,9,20,0.000333,0.026046,4,312.551248,17.363958,78.137812,43.651484,1,0
0,0,17,17,21,26,47,131,75,206,0.000333,0.381415,20,22884.90607,1271.38367,1144.245303,214.450099,9,0
0,0,4,4,4,7,11,13,11,24,0.000333,0.027675,2,166.052718,9.225151,83.026359,27.651484,3,0
0,0,4,4,7,8,15,16,12,28,0.000333,0.036464,3,328.17881,18.232156,109.392937,43.651484,3,0
0,0,3,3,13,7,20,27,12,39,0.000333,0.056185,6,1011.331174,56.185065,168.555196,67.757201,3,0
0,0,4,4,8,7,15,17,10,27,0.000333,0.035162,4,421.944184,23.441344,105.486046,43.651484,1,0
0,0,7,7,11,19,30,44,28,72,0.000333,0.117765,5,1766.480614,98.137812,353.296123,118.764371,2,0
0,0,5,5,11,15,26,28,23,51,0.000333,0.079907,5,1198.612128,66.589563,239.722426,96.657107,1,0
0,0,9,9,15,19,34,68,35,103,0.000333,0.17467,7,3668.060709,203.78115,524.008673,139.313982,2,0
0,0,11,11,15,21,36,84,43,127,0.000333,0.21886,14,9192.126653,510.673703,656.580475,150.842025,2,0
0,0,3,3,8,7,15,11,9,20,0.000333,0.026046,4,312.551248,17.363958,78.137812,43.651484,1,0
0,0,3,3,9,8,17,16,11,27,0.000333,0.036787,4,441.445987,24.524777,110.361497,52.529325,2,0
0,0,11,11,15,21,36,84,43,127,0.000333,0.21886,14,9192.126653,510.673703,656.580475,150.842025,2,0
0,0,8,8,15,18,33,66,34,100,0.000333,0.168146,7,3531.075884,196.170882,504.439412,133.662009,2,0
0,0,4,4,10,15,25,32,21,53,0.000333,0.082041,5,1230.62189,68.367883,246.124378,91.82264,1,0
0,0,11,11,12,18,30,69,40,109,0.000333,0.178284,12,6418.212899,356.567383,534.851075,118.0782,2,0
0,0,4,4,4,7,11,13,11,24,0.000333,0.027675,2,166.052718,9.225151,83.026359,27.651484,3,0
0,0,3,3,8,6,14,11,9,20,0.000333,0.025382,4,304.588394,16.921577,76.147098,39.509775,1,0
0,0,7,7,8,12,20,29,20,49,0.000333,0.070591,4,847.097907,47.060995,211.774477,67.01955,1,0
0,0,3,3,10,8,18,19,11,30,0.000333,0.041699,5,625.48875,34.749375,125.09775,57.219281,1,0
0,0,4,4,7,7,14,15,10,25,0.000333,0.031728,3,285.551619,15.863979,95.183873,39.302969,1,0
0,0,3,3,8,7,15,11,9,20,0.000333,0.026046,4,312.551248,17.363958,78.137812,43.651484,1,0
0,0,5,5,9,8,17,23,18,41,0.000333,0.055862,8,1340.687812,74.482656,167.585976,52.529325,1,0
0,0,4,4,7,10,17,17,13,30,0.000333,0.040875,3,367.871656,20.437314,122.623885,52.870765,1,0
0,0,6,6,9,15,24,24,26,50,0.000333,0.076416,4,916.9925,50.944028,229.248125,87.132684,1,0
0,0,5,5,11,12,23,33,21,54,0.000333,0.081424,5,1221.361728,67.853429,244.272346,81.073298,1,0
0,0,25,25,12,35,47,382,213,595,0.000333,1.10166,36,118979.2932,6609.960733,3304.980367,222.544456,4,0
0,0,6,6,10,11,21,24,21,45,0.000333,0.065885,5,988.27142,54.903968,197.654284,71.273029,1,0
0,0,6,6,8,10,18,20,16,36,0.000333,0.050039,4,600.4692,33.3594,150.1173,57.219281,1,0
0,0,6,6,8,12,20,23,20,43,0.000333,0.061948,4,743.371632,41.298424,185.842908,67.01955,3,0
0,0,4,4,10,15,25,32,21,53,0.000333,0.082041,5,1230.62189,68.367883,246.124378,91.82264,1,0
0,0,3,3,7,5,12,11,7,18,0.000333,0.02151,3,193.587975,10.754888,64.529325,31.261125,1,0
0,0,4,4,6,8,14,17,12,29,0.000333,0.036804,3,331.239878,18.402215,110.413293,39.509775,3,0
0,0,4,4,8,8,16,18,12,30,0.000333,0.04,4,480,26.666667,120,48,1,0
0,0,4,4,7,7,14,39,20,59,0.000333,0.074878,6,1347.803642,74.87798,224.63394,39.302969,1,0
0,0,3,3,7,6,13,27,14,41,0.000333,0.050573,6,910.308171,50.572676,151.718028,35.161259,1,0
0,0,6,6,7,9,16,63,32,95,0.000333,0.126667,9,3420,190,380,48.180809,1,0
0,0,5,5,7,8,15,51,26,77,0.000333,0.100277,9,2707.475183,150.415288,300.830576,43.651484,1,0
0,0,7,7,10,16,26,26,30,56,0.000333,0.087742,5,1316.123121,73.117951,263.224624,97.219281,1,0
0,0,3,3,9,11,20,24,17,41,0.000333,0.059066,4,708.796208,39.377567,177.199052,66.583073,1,0
0,0,5,5,9,13,22,39,25,64,0.000333,0.095135,4,1141.614494,63.423027,285.403624,76.635041,1,0
0,0,7,7,11,19,30,44,28,72,0.000333,0.117765,5,1766.480614,98.137812,353.296123,118.764371,2,0
0,0,3,3,8,8,16,20,12,32,0.000333,0.042667,4,512,28.444444,128,48,1,0
0,0,6,6,11,12,23,29,17,46,0.000333,0.069361,5,1040.41925,57.801069,208.08385,81.073298,2,0
0,0,5,5,11,14,25,25,20,45,0.000333,0.069658,5,1044.867643,58.048202,208.973529,91.356717,1,0
0,0,9,9,15,19,34,68,35,103,0.000333,0.17467,7,3668.060709,203.78115,524.008673,139.313982,2,0
0,0,11,11,15,21,36,84,43,127,0.000333,0.21886,14,9192.126653,510.673703,656.580475,150.842025,2,0
0,0,8,8,15,18,33,66,34,100,0.000333,0.168146,7,3531.075884,196.170882,504.439412,133.662009,2,0
0,0,3,3,9,8,17,16,11,27,0.000333,0.036787,4,441.445987,24.524777,110.361497,52.529325,2,0
0,0,5,5,9,13,22,19,26,45,0.000333,0.066891,8,1605.395383,89.188632,200.674423,76.635041,1,0
0,0,5,5,8,10,18,28,17,45,0.000333,0.062549,4,750.5865,41.69925,187.646625,57.219281,1,0
0,0,4,4,4,7,11,13,11,24,0.000333,0.027675,2,166.052718,9.225151,83.026359,27.651484,3,0
0,0,3,3,7,5,12,11,7,18,0.000333,0.02151,3,193.587975,10.754888,64.529325,31.261125,1,0
0,0,5,5,10,12,22,21,17,38,0.000333,0.056486,5,847.292008,47.071778,169.458402,76.238831,1,0
0,0,6,6,9,14,23,30,21,51,0.000333,0.076901,4,922.806639,51.267036,230.70166,81.832294,1,0
0,0,5,5,10,9,19,20,18,38,0.000333,0.053807,10,1614.212455,89.67847,161.421246,61.748606,1,0
0,0,6,6,14,12,26,41,24,65,0.000333,0.101843,14,4277.400144,237.633341,305.528582,96.322519,5,0
0,0,4,4,9,7,16,16,11,27,0.000333,0.036,4,432,24,108,48.180809,1,0
0,0,10,10,14,16,30,51,35,86,0.000333,0.140664,14,5907.896277,328.21646,421.992591,117.302969,2,0
0,0,3,3,7,8,15,23,12,35,0.000333,0.04558,3,410.223513,22.790195,136.741171,43.651484,1,0
0,0,3,3,7,8,15,23,12,35,0.000333,0.04558,3,410.223513,22.790195,136.741171,43.651484,1,0
0,0,7,7,10,16,26,28,28,56,0.000333,0.087742,5,1316.123121,73.117951,263.224624,97.219281,1,0
0,0,9,9,15,19,34,68,35,103,0.000333,0.17467,7,3668.060709,203.78115,524.008673,139.313982,2,0
0,0,11,11,15,21,36,84,43,127,0.000333,0.21886,14,9192.126653,510.673703,656.580475,150.842025,2,0
0,0,48,48,12,20,32,263,154,417,0.000333,0.695,42,87570,4865,2085,129.458112,32,0
0,0,11,11,16,20,36,66,48,114,0.000333,0.196457,16,9429.943203,523.885733,589.37145,150.438562,5,0
0,0,4,4,4,7,11,13,11,24,0.000333,0.027675,2,166.052718,9.225151,83.026359,27.651484,3,0
0,0,8,8,15,18,33,66,34,100,0.000333,0.168146,7,3531.075884,196.170882,504.439412,133.662009,2,0
0,0,11,11,15,21,36,84,43,127,0.000333,0.21886,14,9192.126653,510.673703,656.580475,150.842025,2,0
0,0,3,3,9,8,17,16,11,27,0.000333,0.036787,4,441.445987,24.524777,110.361497,52.529325,2,0
0,0,3,3,10,8,18,19,11,30,0.000333,0.041699,5,625.48875,34.749375,125.09775,57.219281,1,0
0,0,4,4,8,7,15,17,12,29,0.000333,0.037767,4,453.199309,25.177739,113.299827,43.651484,1,0
0,0,5,5,11,13,24,29,20,49,0.000333,0.074888,5,1123.315813,62.406434,224.663163,86.159464,1,0
0,0,5,5,8,10,18,26,15,41,0.000333,0.056989,4,683.8677,37.99265,170.966925,57.219281,1,0
0,0,5,5,7,8,15,20,15,35,0.000333,0.04558,3,410.223513,22.790195,136.741171,43.651484,1,0
0,0,11,11,15,21,36,84,43,127,0.000333,0.21886,14,9192.126653,510.673703,656.580475,150.842025,2,0
0,0,8,8,15,18,33,66,34,100,0.000333,0.168146,7,3531.075884,196.170882,504.439412,133.662009,2,0
0,0,9,9,15,19,34,68,35,103,0.000333,0.17467,7,3668.060709,203.78115,524.008673,139.313982,2,0
0,0,4,4,7,11,18,24,17,41,0.000333,0.056989,3,512.900775,28.494488,170.966925,57.705232,1,0
0,0,3,3,8,6,14,13,9,22,0.000333,0.027921,4,335.047233,18.613735,83.761808,39.509775,1,0
0,0,3,3,8,7,15,11,9,20,0.000333,0.026046,4,312.551248,17.363958,78.137812,43.651484,1,0
0,0,3,3,8,7,15,11,9,20,0.000333,0.026046,4,312.551248,17.363958,78.137812,43.651484,1,0
0,0,8,8,13,12,25,39,25,64,0.000333,0.099069,12,3566.481554,198.137864,297.206796,91.125266,1,0
0,0,7,7,11,19,30,44,28,72,0.000333,0.117765,5,1766.480614,98.137812,353.296123,118.764371,2,0
0,0,4,4,9,9,18,19,15,34,0.000333,0.047259,4,567.1098,31.5061,141.77745,57.05865,1,0
0,0,7,7,6,9,15,37,23,60,0.000333,0.078138,6,1406.480614,78.137812,234.413436,44.0391,1,0
0,0,5,5,8,12,20,25,19,44,0.000333,0.063388,4,760.659345,42.258852,190.164836,67.01955,1,0
0,0,7,7,14,15,29,42,31,73,0.000333,0.118211,14,4964.856577,275.825365,354.632613,111.906328,4,0
0,0,3,3,7,8,15,23,12,35,0.000333,0.04558,3,410.223513,22.790195,136.741171,43.651484,1,0
0,0,4,4,10,15,25,32,21,53,0.000333,0.082041,5,1230.62189,68.367883,246.124378,91.82264,1,0
0,0,11,11,15,21,36,84,43,127,0.000333,0.21886,14,9192.126653,510.673703,656.580475,150.842025,2,0
0,0,5,5,8,10,18,28,17,45,0.000333,0.062549,4,750.5865,41.69925,187.646625,57.219281,1,0
0,0,8,8,15,18,33,66,34,100,0.000333,0.168146,7,3531.075884,196.170882,504.439412,133.662009,2,0
0,0,4,4,7,11,18,17,19,36,0.000333,0.050039,3,450.3519,25.01955,150.1173,57.705232,1,0
0,0,4,4,4,7,11,13,11,24,0.000333,0.027675,2,166.052718,9.225151,83.026359,27.651484,2,0
0,0,8,8,11,15,26,46,32,78,0.000333,0.122211,10,3666.34298,203.685721,366.634298,96.657107,1,0
0,0,6,6,8,17,25,31,30,61,0.000333,0.094425,4,1133.10091,62.950051,283.275228,93.486868,1,0
0,0,7,7,6,9,15,37,23,60,0.000333,0.078138,6,1406.480614,78.137812,234.413436,44.0391,1,0
0,0,8,8,9,17,26,35,33,68,0.000333,0.106543,4,1278.519603,71.028867,319.629901,98.016193,1,0
0,0,5,5,10,10,20,26,15,41,0.000333,0.059066,5,885.995259,49.221959,177.199052,66.438562,1,0
0,0,4,4,4,7,11,13,11,24,0.000333,0.027675,2,166.052718,9.225151,83.026359,27.651484,3,0
0,0,5,5,8,10,18,28,17,45,0.000333,0.062549,4,750.5865,41.69925,187.646625,57.219281,1,0
0,0,4,4,9,13,22,22,17,39,0.000333,0.057973,4,695.671333,38.648407,173.917833,76.635041,3,0
0,0,7,7,7,12,19,30,23,53,0.000333,0.075047,3,675.420475,37.52336,225.140158,62.671034,1,0
0,0,9,9,15,20,35,72,36,108,0.000333,0.184654,7,3877.737961,215.429887,553.962566,145.041921,2,0
0,0,5,5,9,13,22,20,24,44,0.000333,0.065405,4,784.859965,43.603331,196.214991,76.635041,1,0
0,0,4,4,5,9,14,15,13,28,0.000333,0.035535,2,213.211876,11.845104,106.605938,40.138965,1,0
0,0,8,8,15,18,33,66,34,100,0.000333,0.168146,7,3531.075884,196.170882,504.439412,133.662009,2,0
0,0,10,10,7,14,21,57,36,93,0.000333,0.136162,6,2450.913122,136.16184,408.48552,72.954453,1,0
0,0,3,3,8,8,16,20,12,32,0.000333,0.042667,4,512,28.444444,128,48,1,0
0,0,6,6,5,12,17,19,26,45,0.000333,0.061312,4,735.743311,40.874628,183.935828,54.62919,1,0
0,0,5,5,9,11,20,19,16,35,0.000333,0.050422,4,605.069933,33.614996,151.267483,66.583073,1,0
0,0,5,5,10,10,20,27,14,41,0.000333,0.059066,5,885.995259,49.221959,177.199052,66.438562,3,0
0,0,7,7,11,18,29,48,28,76,0.000333,0.123069,5,1846.032778,102.557377,369.206556,113.112398,1,0
0,0,6,6,5,12,17,19,26,45,0.000333,0.061312,4,735.743311,40.874628,183.935828,54.62919,1,0
0,0,3,3,7,8,15,23,12,35,0.000333,0.04558,3,410.223513,22.790195,136.741171,43.651484,1,0
0,0,5,5,11,12,23,33,21,54,0.000333,0.081424,5,1221.361728,67.853429,244.272346,81.073298,1,0
0,0,11,11,13,16,29,57,40,97,0.000333,0.157075,12,5654.689878,314.149438,471.224157,112.105716,1,0
0,0,3,3,7,8,15,23,12,35,0.000333,0.04558,3,410.223513,22.790195,136.741171,43.651484,1,0
0,0,5,5,8,10,18,28,17,45,0.000333,0.062549,4,750.5865,41.69925,187.646625,57.219281,1,0
0,0,4,4,4,7,11,13,11,24,0.000333,0.027675,2,166.052718,9.225151,83.026359,27.651484,3,0
0,0,4,4,7,9,16,30,17,47,0.000333,0.062667,3,564,31.333333,188,48.180809,1,0
0,0,8,8,12,15,27,42,27,69,0.000333,0.109362,6,1968.523426,109.362413,328.087238,101.622909,2,0
0,0,5,5,8,14,22,28,21,49,0.000333,0.072837,4,874.048597,48.558255,218.512149,77.302969,1,0
0,0,3,3,7,8,15,23,12,35,0.000333,0.04558,3,410.223513,22.790195,136.741171,43.651484,1,0
0,0,9,9,15,19,34,49,41,90,0.000333,0.152624,14,6410.20318,356.122399,457.871656,139.313982,4,0
0,0,4,4,8,10,18,34,17,51,0.000333,0.070889,4,850.6647,47.25915,212.666175,57.219281,1,0
0,0,8,8,8,14,22,31,28,59,0.000333,0.087702,8,2104.851724,116.936207,263.106465,77.302969,1,0
0,0,4,4,10,8,18,25,15,40,0.000333,0.055599,5,833.985,46.3325,166.797,57.219281,1,0
0,0,5,5,7,7,14,16,11,27,0.000333,0.034266,3,308.395749,17.133097,102.798583,39.302969,1,0
0,0,3,3,9,12,21,17,14,31,0.000333,0.045387,4,544.64736,30.258187,136.16184,71.548875,1,0
0,0,5,5,8,10,18,28,17,45,0.000333,0.062549,4,750.5865,41.69925,187.646625,57.219281,1,0
0,0,8,8,15,14,29,35,23,58,0.000333,0.093921,7,1972.340284,109.57446,281.762898,111.906328,3,0
0,0,4,4,5,9,14,15,13,28,0.000333,0.035535,2,213.211876,11.845104,106.605938,40.138965,1,0
0,0,7,7,10,14,24,40,27,67,0.000333,0.102397,5,1535.962438,85.331247,307.192488,86.52225,1,0
0,0,3,3,7,8,15,23,12,35,0.000333,0.04558,3,410.223513,22.790195,136.741171,43.651484,1,0
0,0,3,3,8,7,15,15,9,24,0.000333,0.031255,4,375.061497,20.83675,93.765374,43.651484,3,0
0,0,5,5,10,11,21,29,17,46,0.000333,0.067349,5,1010.233007,56.124056,202.046601,71.273029,1,0
0,0,4,4,10,15,25,32,21,53,0.000333,0.082041,5,1230.62189,68.367883,246.124378,91.82264,1,0
0,0,4,4,6,5,11,24,12,36,0.000333,0.041513,6,747.23723,41.513179,124.539538,27.119415,1,0
0,0,3,3,8,8,16,20,12,32,0.000333,0.042667,4,512,28.444444,128,48,1,0
0,0,10,10,14,18,32,51,39,90,0.000333,0.15,14,6300,350,450,128.361619,2,0
0,0,5,5,8,11,19,30,18,48,0.000333,0.067967,4,815.602083,45.311227,203.900521,62.053748,1,0
0,0,8,8,15,18,33,66,34,100,0.000333,0.168146,7,3531.075884,196.170882,504.439412,133.662009,2,0
0,0,11,11,15,21,36,84,43,127,0.000333,0.21886,14,9192.126653,510.673703,656.580475,150.842025,2,0
0,0,7,7,11,19,30,44,28,72,0.000333,0.117765,5,1766.480614,98.137812,353.296123,118.764371,2,0
0,0,9,9,15,19,34,68,35,103,0.000333,0.17467,7,3668.060709,203.78115,524.008673,139.313982,2,0
0,0,3,3,7,8,15,23,12,35,0.000333,0.04558,3,410.223513,22.790195,136.741171,43.651484,1,0
0,0,3,3,9,7,16,24,10,34,0.000333,0.045333,4,544,30.222222,136,48.180809,3,0
0,0,8,8,12,15,27,42,27,69,0.000333,0.109362,6,1968.523426,109.362413,328.087238,101.622909,2,0
0,0,24,24,15,29,44,595,86,681,0.000333,1.239291,14,52050.22105,2891.678947,3717.872932,199.484808,5,0
0,0,6,6,9,10,19,28,17,45,0.000333,0.063719,4,764.626952,42.479275,191.156738,61.748606,1,0
0,0,12,12,14,9,23,72,25,97,0.000333,0.146262,14,6142.997136,341.277619,438.78551,81.832294,7,0
0,0,9,9,9,16,25,40,41,81,0.000333,0.125384,8,3009.218811,167.178823,376.152351,92.529325,1,0
0,0,4,4,10,15,25,32,21,53,0.000333,0.082041,5,1230.62189,68.367883,246.124378,91.82264,1,0
0,0,3,3,9,8,17,16,10,26,0.000333,0.035425,4,425.096135,23.616452,106.274034,52.529325,3,0
0,0,4,4,4,7,11,13,11,24,0.000333,0.027675,2,166.052718,9.225151,83.026359,27.651484,3,0
0,0,7,7,11,19,30,44,28,72,0.000333,0.117765,5,1766.480614,98.137812,353.296123,118.764371,2,0
0,0,8,8,15,18,33,66,34,100,0.000333,0.168146,7,3531.075884,196.170882,504.439412,133.662009,2,0
0,0,3,3,9,8,17,16,11,27,0.000333,0.036787,4,441.445987,24.524777,110.361497,52.529325,2,0
0,0,9,9,15,19,34,68,35,103,0.000333,0.17467,7,3668.060709,203.78115,524.008673,139.313982,2,0
0,0,6,6,7,11,18,41,25,66,0.000333,0.091738,6,1651.290301,91.73835,275.21505,57.705232,1,0
0,0,11,11,15,21,36,84,43,127,0.000333,0.21886,14,9192.126653,510.673703,656.580475,150.842025,2,0
0,0,7,7,11,19,30,44,28,72,0.000333,0.117765,5,1766.480614,98.137812,353.296123,118.764371,2,0
0,0,4,4,4,7,11,13,11,24,0.000333,0.027675,2,166.052718,9.225151,83.026359,27.651484,3,0
0,0,19,19,9,22,31,125,69,194,0.000333,0.320371,12,11533.36901,640.742723,961.114084,126.636821,1,0
0,0,8,8,13,12,25,39,28,67,0.000333,0.103713,12,3733.660377,207.425576,311.138365,91.125266,1,0
0,0,3,3,9,8,17,16,11,27,0.000333,0.036787,4,441.445987,24.524777,110.361497,52.529325,2,0
0,0,7,7,11,19,30,44,28,72,0.000333,0.117765,5,1766.480614,98.137812,353.296123,118.764371,2,0
0,0,5,5,11,13,24,28,20,48,0.000333,0.073359,5,1100.391,61.132833,220.0782,86.159464,1,0
0,0,11,11,15,21,36,84,43,127,0.000333,0.21886,14,9192.126653,510.673703,656.580475,150.842025,2,0
0,0,3,3,8,7,15,11,9,20,0.000333,0.026046,4,312.551248,17.363958,78.137812,43.651484,1,0
0,0,9,9,15,19,34,68,35,103,0.000333,0.17467,7,3668.060709,203.78115,524.008673,139.313982,2,0
0,0,3,3,8,8,16,20,12,32,0.000333,0.042667,4,512,28.444444,128,48,1,0
0,0,7,7,11,19,30,44,28,72,0.000333,0.117765,5,1766.480614,98.137812,353.296123,118.764371,2,0
0,0,5,5,11,12,23,31,19,50,0.000333,0.075393,5,1130.890489,62.827249,226.178098,81.073298,2,0
0,0,6,6,14,12,26,41,24,65,0.000333,0.101843,14,4277.400144,237.633341,305.528582,96.322519,5,0
0,0,4,4,8,17,25,23,27,50,0.000333,0.077398,4,928.771238,51.598402,232.192809,93.486868,1,0
0,0,14,14,11,23,34,85,48,133,0.000333,0.225544,10,6766.325579,375.906977,676.632558,142.095673,1,0
0,0,3,3,9,8,17,16,11,27,0.000333,0.036787,4,441.445987,24.524777,110.361497,52.529325,2,0
0,0,3,3,8,7,15,11,9,20,0.000333,0.026046,4,312.551248,17.363958,78.137812,43.651484,1,0
0,0,25,25,12,35,47,382,213,595,0.000333,1.10166,36,118979.2932,6609.960733,3304.980367,222.544456,4,0
0,0,3,3,8,10,18,20,14,34,0.000333,0.047259,4,567.1098,31.5061,141.77745,57.219281,1,0
0,0,4,4,5,9,14,15,13,28,0.000333,0.035535,2,213.211876,11.845104,106.605938,40.138965,1,0
0,0,6,6,8,14,22,31,27,58,0.000333,0.086216,4,1034.588136,57.477119,258.647034,77.302969,1,0
0,0,3,3,7,6,13,9,8,17,0.000333,0.020969,3,188.722426,10.484579,62.907475,35.161259,1,0
0,0,3,3,7,5,12,11,7,18,0.000333,0.02151,3,193.587975,10.754888,64.529325,31.261125,1,0
0,0,9,9,15,19,34,68,35,103,0.000333,0.17467,7,3668.060709,203.78115,524.008673,139.313982,2,0
0,0,3,3,8,7,15,20,12,32,0.000333,0.041673,4,500.081996,27.782333,125.020499,43.651484,1,0
0,0,23,23,16,37,53,139,84,223,0.000333,0.425775,16,20437.22018,1135.401121,1277.326261,256.749775,1,0
0,0,5,5,11,12,23,33,21,54,0.000333,0.081424,5,1221.361728,67.853429,244.272346,81.073298,1,0
0,0,6,6,9,13,22,21,22,43,0.000333,0.063919,4,767.022238,42.612347,191.75556,76.635041,1,0
0,0,3,3,7,5,12,11,7,18,0.000333,0.02151,3,193.587975,10.754888,64.529325,31.261125,1,0
0,0,7,7,11,19,30,44,28,72,0.000333,0.117765,5,1766.480614,98.137812,353.296123,118.764371,2,0
0,0,9,9,11,16,27,41,33,74,0.000333,0.117287,10,3518.616752,195.478708,351.861675,102.053748,1,0
0,0,4,4,5,12,17,16,16,32,0.000333,0.0436,2,261.597622,14.533201,130.798811,54.62919,1,0
0,0,5,5,10,11,21,33,18,51,0.000333,0.074669,5,1120.040943,62.224497,224.008189,71.273029,1,0
0,0,14,14,11,23,34,85,48,133,0.000333,0.225544,10,6766.325579,375.906977,676.632558,142.095673,6,0
0,0,22,22,14,28,42,153,83,236,0.000333,0.424196,14,17816.21677,989.78982,1272.586912,187.908907,5,0
0,0,19,19,21,26,47,149,82,231,0.000333,0.427703,30,38493.30074,2138.516708,1283.110025,214.450099,11,0
0,0,3,3,8,8,16,20,12,32,0.000333,0.042667,4,512,28.444444,128,48,1,0
0,0,3,3,8,8,16,20,12,32,0.000333,0.042667,4,512,28.444444,128,48,1,0
0,0,5,5,8,10,18,28,17,45,0.000333,0.062549,4,750.5865,41.69925,187.646625,57.219281,1,0
0,0,3,3,10,9,19,26,14,40,0.000333,0.056639,5,849.585503,47.199195,169.917101,61.748606,1,0
0,0,3,3,7,8,15,23,12,35,0.000333,0.04558,3,410.223513,22.790195,136.741171,43.651484,1,0
0,0,3,3,7,8,15,23,12,35,0.000333,0.04558,3,410.223513,22.790195,136.741171,43.651484,1,0
0,0,5,5,7,7,14,19,13,32,0.000333,0.040612,3,365.506073,20.305893,121.835358,39.302969,1,0
0,0,4,4,7,8,15,16,12,28,0.000333,0.036464,3,328.17881,18.232156,109.392937,43.651484,3,0
0,0,6,6,7,12,19,23,31,54,0.000333,0.076463,6,1376.328514,76.462695,229.388086,62.671034,1,0
0,0,3,3,9,8,17,16,10,26,0.000333,0.035425,4,425.096135,23.616452,106.274034,52.529325,3,0
0,0,4,4,5,7,12,14,10,24,0.000333,0.02868,2,172.0782,9.5599,86.0391,31.261125,2,0
0,0,4,4,9,9,18,19,15,34,0.000333,0.047259,4,567.1098,31.5061,141.77745,57.05865,1,0
0,0,3,3,7,8,15,23,12,35,0.000333,0.04558,3,410.223513,22.790195,136.741171,43.651484,1,0
0,0,6,6,6,11,17,25,17,42,0.000333,0.057224,3,515.020318,28.61224,171.673439,53.563523,3,0
0,0,3,3,9,8,17,16,11,27,0.000333,0.036787,4,441.445987,24.524777,110.361497,52.529325,2,0
0,0,9,9,15,19,34,68,35,103,0.000333,0.17467,7,3668.060709,203.78115,524.008673,139.313982,2,0
0,0,5,5,8,10,18,28,17,45,0.000333,0.062549,4,750.5865,41.69925,187.646625,57.219281,1,0
0,0,5,5,8,10,18,28,17,45,0.000333,0.062549,4,750.5865,41.69925,187.646625,57.219281,1,0
0,0,3,3,8,8,16,15,10,25,0.000333,0.033333,4,400,22.222222,100,48,2,0
0,0,6,6,9,10,19,28,17,45,0.000333,0.063719,4,764.626952,42.479275,191.156738,61.748606,1,0
0,0,19,19,21,26,47,149,82,231,0.000333,0.427703,30,38493.30074,2138.516708,1283.110025,214.450099,11,0
0,0,11,11,15,21,36,84,43,127,0.000333,0.21886,14,9192.126653,510.673703,656.580475,150.842025,2,0
0,0,9,9,15,19,34,68,35,103,0.000333,0.17467,7,3668.060709,203.78115,524.008673,139.313982,2,0
0,0,11,11,15,21,36,84,43,127,0.000333,0.21886,14,9192.126653,510.673703,656.580475,150.842025,2,0
0,0,8,8,10,15,25,36,29,65,0.000333,0.100617,5,1509.253262,83.847403,301.850652,91.82264,1,0
0,0,3,3,7,8,15,23,12,35,0.000333,0.04558,3,410.223513,22.790195,136.741171,43.651484,1,0
0,0,25,25,12,35,47,382,213,595,0.000333,1.10166,36,118979.2932,6609.960733,3304.980367,222.544456,4,0
0,0,5,5,11,12,23,33,21,54,0.000333,0.081424,5,1221.361728,67.853429,244.272346,81.073298,1,0
0,0,7,7,11,19,30,44,28,72,0.000333,0.117765,5,1766.480614,98.137812,353.296123,118.764371,2,0
0,0,4,4,10,15,25,32,21,53,0.000333,0.082041,5,1230.62189,68.367883,246.124378,91.82264,1,0
0,0,5,5,8,8,16,26,16,42,0.000333,0.056,8,1344,74.666667,168,48,1,0
0,0,8,8,11,11,22,35,31,66,0.000333,0.098107,10,2943.224868,163.512493,294.322487,76.107496,1,0
0,0,5,5,7,15,22,34,26,60,0.000333,0.089189,3,802.697691,44.594316,267.565897,78.254843,1,0
0,0,4,4,9,10,19,24,17,41,0.000333,0.058055,4,696.660112,38.70334,174.165028,61.748606,1,0
0,0,4,4,9,8,17,15,12,27,0.000333,0.036787,4,441.445987,24.524777,110.361497,52.529325,1,0
0,0,20,20,13,28,41,112,64,176,0.000333,0.31431,12,11315.14983,628.619435,942.929153,182.711654,4,0
0,0,5,5,12,16,28,39,25,64,0.000333,0.102557,6,1846.02429,102.556905,307.670715,107.01955,3,0
0,0,3,3,12,9,21,21,11,32,0.000333,0.046851,6,843.324945,46.851386,140.554158,71.548875,3,0
0,0,4,4,6,8,14,17,12,29,0.000333,0.036804,3,331.239878,18.402215,110.413293,39.509775,3,0
0,0,3,3,5,5,10,12,7,19,0.000333,0.021039,2,126.233268,7.012959,63.116634,23.219281,1,0
0,0,8,8,14,17,31,48,34,82,0.000333,0.135415,14,5687.417364,315.967631,406.244097,122.789837,4,0
0,0,6,6,7,11,18,41,25,66,0.000333,0.091738,6,1651.290301,91.73835,275.21505,57.705232,1,0
0,0,3,3,8,8,16,20,12,32,0.000333,0.042667,4,512,28.444444,128,48,1,0
0,0,8,8,12,15,27,42,27,69,0.000333,0.109362,6,1968.523426,109.362413,328.087238,101.622909,2,0
0,0,5,5,7,7,14,16,11,27,0.000333,0.034266,3,308.395749,17.133097,102.798583,39.302969,1,0
0,0,5,5,8,8,16,25,13,38,0.000333,0.050667,4,608,33.777778,152,48,3,0
0,0,4,4,6,8,14,17,12,29,0.000333,0.036804,3,331.239878,18.402215,110.413293,39.509775,3,0
0,0,5,5,9,9,18,29,17,46,0.000333,0.063939,4,767.2662,42.6259,191.81655,57.05865,1,0
0,0,3,3,7,5,12,11,7,18,0.000333,0.02151,3,193.587975,10.754888,64.529325,31.261125,1,0
0,0,3,3,9,8,17,16,11,27,0.000333,0.036787,4,441.445987,24.524777,110.361497,52.529325,2,0
0,0,5,5,10,13,23,24,19,43,0.000333,0.064838,5,972.565821,54.031434,194.513164,81.324997,1,0
0,0,5,5,11,12,23,33,21,54,0.000333,0.081424,5,1221.361728,67.853429,244.272346,81.073298,1,0
0,0,7,7,11,19,30,44,28,72,0.000333,0.117765,5,1766.480614,98.137812,353.296123,118.764371,2,0
0,0,25,25,12,35,47,382,213,595,0.000333,1.10166,36,118979.2932,6609.960733,3304.980367,222.544456,4,0
0,0,3,3,9,8,17,16,11,27,0.000333,0.036787,4,441.445987,24.524777,110.361497,52.529325,2,0
0,0,4,4,6,14,20,17,18,35,0.000333,0.050422,3,453.80245,25.211247,151.267483,68.812744,1,0
0,0,5,5,12,16,28,39,25,64,0.000333,0.102557,6,1846.02429,102.556905,307.670715,107.01955,2,0
0,0,8,8,9,17,26,45,34,79,0.000333,0.123778,8,2970.677902,165.037661,371.334738,98.016193,1,0
0,0,7,7,11,14,25,57,32,89,0.000333,0.137768,10,4133.032009,229.612889,413.303201,91.356717,1,0
0,0,7,7,11,19,30,44,28,72,0.000333,0.117765,5,1766.480614,98.137812,353.296123,118.764371,2,0
0,0,6,6,13,10,23,33,20,53,0.000333,0.079916,12,2876.985404,159.832522,239.748784,81.324997,1,0
0,0,4,4,6,8,14,17,12,29,0.000333,0.036804,3,331.239878,18.402215,110.413293,39.509775,3,0
0,0,5,5,11,12,23,33,18,51,0.000333,0.076901,5,1153.508299,64.083794,230.70166,81.073298,3,0
0,0,23,23,13,33,46,120,76,196,0.000333,0.360873,12,12991.41772,721.745429,1082.618143,214.570722,5,0
0,0,10,10,7,14,21,57,36,93,0.000333,0.136162,6,2450.913122,136.16184,408.48552,72.954453,1,0
0,0,9,9,15,19,34,68,35,103,0.000333,0.17467,7,3668.060709,203.78115,524.008673,139.313982,2,0
0,0,8,8,15,18,33,66,34,100,0.000333,0.168146,7,3531.075884,196.170882,504.439412,133.662009,2,0
0,0,11,11,15,21,36,84,43,127,0.000333,0.21886,14,9192.126653,510.673703,656.580475,150.842025,2,0
0,0,7,7,11,19,30,44,28,72,0.000333,0.117765,5,1766.480614,98.137812,353.296123,118.764371,2,0
0,0,4,4,4,7,11,13,11,24,0.000333,0.027675,2,166.052718,9.225151,83.026359,27.651484,2,0
0,0,6,6,10,11,21,24,21,45,0.000333,0.065885,5,988.27142,54.903968,197.654284,71.273029,1,0
0,0,4,4,4,7,11,13,11,24,0.000333,0.027675,2,166.052718,9.225151,83.026359,27.651484,3,0
0,0,5,5,9,10,19,35,21,56,0.000333,0.079295,8,1903.071526,105.726196,237.883941,61.748606,4,0
0,0,8,8,11,11,22,48,28,76,0.000333,0.112972,10,3389.16803,188.287113,338.916803,76.107496,7,0
0,0,3,3,10,8,18,16,13,29,0.000333,0.040309,5,604.639125,33.591063,120.927825,57.219281,3,0
0,0,3,3,8,7,15,11,9,20,0.000333,0.026046,4,312.551248,17.363958,78.137812,43.651484,1,0
0,0,4,4,6,10,16,26,15,41,0.000333,0.054667,3,492,27.333333,164,48.729056,1,0
0,0,5,5,8,10,18,28,17,45,0.000333,0.062549,4,750.5865,41.69925,187.646625,57.219281,1,0
0,0,4,4,10,15,25,32,21,53,0.000333,0.082041,5,1230.62189,68.367883,246.124378,91.82264,1,0
0,0,3,3,7,8,15,23,12,35,0.000333,0.04558,3,410.223513,22.790195,136.741171,43.651484,1,0
0,0,3,3,5,6,11,9,8,17,0.000333,0.019603,2,117.620675,6.534482,58.810338,27.119415,1,0
0,0,3,3,8,7,15,11,9,20,0.000333,0.026046,4,312.551248,17.363958,78.137812,43.651484,1,0
0,0,4,4,9,13,22,22,17,39,0.000333,0.057973,4,695.671333,38.648407,173.917833,76.635041,3,0
0,0,4,4,4,7,11,13,11,24,0.000333,0.027675,2,166.052718,9.225151,83.026359,27.651484,3,0
0,0,5,5,7,8,15,17,12,29,0.000333,0.037767,3,339.899482,18.883305,113.299827,43.651484,1,0
0,0,7,7,11,19,30,44,28,72,0.000333,0.117765,5,1766.480614,98.137812,353.296123,118.764371,2,0
0,0,3,3,9,8,17,16,11,27,0.000333,0.036787,4,441.445987,24.524777,110.361497,52.529325,2,0
0,0,9,9,15,20,35,72,36,108,0.000333,0.184654,7,3877.737961,215.429887,553.962566,145.041921,2,0
0,0,7,7,11,19,30,44,28,72,0.000333,0.117765,5,1766.480614,98.137812,353.296123,118.764371,2,0
0,0,8,8,15,18,33,66,34,100,0.000333,0.168146,7,3531.075884,196.170882,504.439412,133.662009,2,0
0,0,11,11,15,21,36,84,43,127,0.000333,0.21886,14,9192.126653,510.673703,656.580475,150.842025,2,0
0,0,3,3,7,8,15,23,12,35,0.000333,0.04558,3,410.223513,22.790195,136.741171,43.651484,1,0
0,0,8,8,15,18,33,66,34,100,0.000333,0.168146,7,3531.075884,196.170882,504.439412,133.662009,2,0
0,0,5,5,10,11,21,29,17,46,0.000333,0.067349,5,1010.233007,56.124056,202.046601,71.273029,1,0
0,0,6,6,13,11,24,38,23,61,0.000333,0.093228,12,3356.192551,186.455142,279.682713,86.159464,4,0
0,0,3,3,8,6,14,11,9,20,0.000333,0.025382,4,304.588394,16.921577,76.147098,39.509775,1,0
0,0,3,3,9,8,17,16,11,27,0.000333,0.036787,4,441.445987,24.524777,110.361497,52.529325,2,0
0,0,3,3,8,7,15,11,9,20,0.000333,0.026046,4,312.551248,17.363958,78.137812,43.651484,1,0
0,0,5,5,8,10,18,28,17,45,0.000333,0.062549,4,750.5865,41.69925,187.646625,57.219281,1,0
0,0,5,5,11,12,23,33,21,54,0.000333,0.081424,5,1221.361728,67.853429,244.272346,81.073298,1,0
0,0,11,11,15,21,36,84,43,127,0.000333,0.21886,14,9192.126653,510.673703,656.580475,150.842025,2,0
0,0,9,9,15,19,34,68,35,103,0.000333,0.17467,7,3668.060709,203.78115,524.008673,139.313982,2,0
0,0,6,6,9,10,19,28,17,45,0.000333,0.063719,4,764.626952,42.479275,191.156738,61.748606,1,0
0,0,4,4,9,10,19,24,17,41,0.000333,0.058055,4,696.660112,38.70334,174.165028,61.748606,1,0
0,0,3,3,7,8,15,23,12,35,0.000333,0.04558,3,410.223513,22.790195,136.741171,43.651484,1,0
0,0,3,3,8,7,15,11,9,20,0.000333,0.026046,4,312.551248,17.363958,78.137812,43.651484,1,0
0,0,3,3,7,5,12,11,7,18,0.000333,0.02151,3,193.587975,10.754888,64.529325,31.261125,1,0
0,0,8,8,15,18,33,66,34,100,0.000333,0.168146,7,3531.075884,196.170882,504.439412,133.662009,2,0
0,0,11,11,9,16,25,51,39,90,0.000333,0.139316,8,3343.576457,185.754248,417.947057,92.529325,1,0
0,0,5,5,7,11,18,21,17,38,0.000333,0.052819,3,475.37145,26.409525,158.45715,57.705232,3,0
0,0,6,6,7,11,18,41,25,66,0.000333,0.091738,6,1651.290301,91.73835,275.21505,57.705232,1,0
0,0,3,3,7,8,15,23,12,35,0.000333,0.04558,3,410.223513,22.790195,136.741171,43.651484,1,0
0,0,7,7,11,19,30,44,28,72,0.000333,0.117765,5,1766.480614,98.137812,353.296123,118.764371,2,0
0,0,7,7,11,19,30,44,28,72,0.000333,0.117765,5,1766.480614,98.137812,353.296123,118.764371,2,0
0,0,5,5,12,10,22,25,14,39,0.000333,0.057973,6,1043.506999,57.972611,173.917833,76.238831,3,0
0,0,7,7,17,14,31,46,29,75,0.000333,0.123855,16,5945.035572,330.279754,371.564723,122.789837,4,0
0,0,25,25,15,30,45,163,91,254,0.000333,0.464977,21,29293.54442,1627.419134,1394.930686,205.810077,1,0
0,0,4,4,8,10,18,28,16,44,0.000333,0.061159,4,733.9068,40.7726,183.4767,57.219281,1,0
0,0,3,3,7,8,15,23,12,35,0.000333,0.04558,3,410.223513,22.790195,136.741171,43.651484,1,0
0,0,9,9,9,13,22,30,34,64,0.000333,0.095135,8,2283.228989,126.846055,285.403624,76.635041,1,0
0,0,4,4,4,7,11,13,11,24,0.000333,0.027675,2,166.052718,9.225151,83.026359,27.651484,3,0
0,0,7,7,11,19,30,44,28,72,0.000333,0.117765,5,1766.480614,98.137812,353.296123,118.764371,2,0
0,0,3,3,7,5,12,11,7,18,0.000333,0.02151,3,193.587975,10.754888,64.529325,31.261125,1,0
0,0,6,6,9,10,19,28,17,45,0.000333,0.063719,4,764.626952,42.479275,191.156738,61.748606,1,0
0,0,4,4,9,10,19,17,15,32,0.000333,0.045311,4,543.734722,30.207485,135.93368,61.748606,1,0
0,0,3,3,8,7,15,11,9,20,0.000333,0.026046,4,312.551248,17.363958,78.137812,43.651484,1,0
0,0,18,18,11,28,39,115,64,179,0.000333,0.315362,10,9460.869972,525.603887,946.086997,172.659686,1,0
0,0,3,3,5,6,11,9,8,17,0.000333,0.019603,2,117.620675,6.534482,58.810338,27.119415,1,0
0,0,3,3,8,7,15,11,9,20,0.000333,0.026046,4,312.551248,17.363958,78.137812,43.651484,1,0
0,0,5,5,8,10,18,28,17,45,0.000333,0.062549,4,750.5865,41.69925,187.646625,57.219281,1,0
0,0,4,4,8,12,20,17,19,36,0.000333,0.051863,4,622.357646,34.575425,155.589411,67.01955,1,0
0,0,5,5,11,12,23,33,21,54,0.000333,0.081424,5,1221.361728,67.853429,244.272346,81.073298,1,0
0,0,4,4,5,9,14,15,13,28,0.000333,0.035535,2,213.211876,11.845104,106.605938,40.138965,1,0
0,0,25,25,12,35,47,382,213,595,0.000333,1.10166,36,118979.2932,6609.960733,3304.980367,222.544456,4,0
0,0,3,3,8,6,14,13,9,22,0.000333,0.027921,4,335.047233,18.613735,83.761808,39.509775,2,0
0,0,5,5,11,12,23,33,18,51,0.000333,0.076901,5,1153.508299,64.083794,230.70166,81.073298,3,0
0,0,4,4,4,7,11,13,11,24,0.000333,0.027675,2,166.052718,9.225151,83.026359,27.651484,3,0
0,0,7,7,11,19,30,44,28,72,0.000333,0.117765,5,1766.480614,98.137812,353.296123,118.764371,2,0
0,0,5,5,10,10,20,26,15,41,0.000333,0.059066,5,885.995259,49.221959,177.199052,66.438562,1,0
0,0,3,3,8,7,15,11,9,20,0.000333,0.026046,4,312.551248,17.363958,78.137812,43.651484,1,0
0,0,5,5,10,11,21,29,17,46,0.000333,0.067349,5,1010.233007,56.124056,202.046601,71.273029,1,0
0,0,8,8,16,16,32,47,33,80,0.000333,0.133333,16,6400,355.555556,400,128,4,0
0,0,4,4,12,12,24,42,17,59,0.000333,0.090171,6,1623.076725,90.170929,270.512788,86.0391,5,0
0,0,4,4,5,11,16,13,14,27,0.000333,0.036,2,216,12,108,49.663388,1,0
0,0,7,7,11,19,30,44,28,72,0.000333,0.117765,5,1766.480614,98.137812,353.296123,118.764371,2,0
0,0,9,9,15,19,34,68,35,103,0.000333,0.17467,7,3668.060709,203.78115,524.008673,139.313982,2,0
0,0,10,10,15,20,35,80,41,121,0.000333,0.206881,14,8689.005431,482.722524,620.643245,145.041921,2,0
0,0,3,3,10,8,18,16,13,29,0.000333,0.040309,5,604.639125,33.591063,120.927825,57.219281,3,0
0,0,4,4,4,7,11,13,11,24,0.000333,0.027675,2,166.052718,9.225151,83.026359,27.651484,3,0
0,0,11,11,11,17,28,53,44,97,0.000333,0.155438,10,4663.134274,259.063015,466.313427,107.540616,1,0
0,0,8,8,11,15,26,41,22,63,0.000333,0.098709,5,1480.638511,82.257695,296.127702,96.657107,5,0
0,0,4,4,4,7,11,13,11,24,0.000333,0.027675,2,166.052718,9.225151,83.026359,27.651484,3,0
0,0,4,4,9,13,22,22,17,39,0.000333,0.057973,4,695.671333,38.648407,173.917833,76.635041,3,0
0,0,3,3,7,5,12,11,7,18,0.000333,0.02151,3,193.587975,10.754888,64.529325,31.261125,1,0
0,0,4,4,4,7,11,13,11,24,0.000333,0.027675,2,166.052718,9.225151,83.026359,27.651484,3,0
0,0,10,10,14,16,30,51,35,86,0.000333,0.140664,14,5907.896277,328.21646,421.992591,117.302969,2,0
0,0,4,4,11,10,21,36,17,53,0.000333,0.077598,5,1163.964117,64.664673,232.792823,71.273029,1,0
0,0,3,3,9,8,17,16,11,27,0.000333,0.036787,4,441.445987,24.524777,110.361497,52.529325,2,0
0,0,4,4,9,13,22,21,17,38,0.000333,0.056486,4,677.833606,37.657423,169.458402,76.635041,3,0
0,0,6,6,14,12,26,43,26,69,0.000333,0.10811,14,4540.624768,252.256932,324.330341,96.322519,4,0
0,0,4,4,4,7,11,13,11,24,0.000333,0.027675,2,166.052718,9.225151,83.026359,27.651484,3,0
0,0,7,7,11,19,30,44,28,72,0.000333,0.117765,5,1766.480614,98.137812,353.296123,118.764371,2,0
0,0,6,6,11,13,24,27,23,50,0.000333,0.076416,5,1146.240625,63.680035,229.248125,86.159464,1,0
0,0,4,4,5,7,12,14,10,24,0.000333,0.02868,2,172.0782,9.5599,86.0391,31.261125,2,0
0,0,10,10,14,18,32,51,39,90,0.000333,0.15,14,6300,350,450,128.361619,2,0
0,0,11,11,13,16,29,50,38,88,0.000333,0.142501,12,5130.027931,285.001552,427.502328,112.105716,1,0
0,0,5,5,11,12,23,27,19,46,0.000333,0.069361,5,1040.41925,57.801069,208.08385,81.073298,1,0
0,0,6,6,7,11,18,41,25,66,0.000333,0.091738,6,1651.290301,91.73835,275.21505,57.705232,1,0
0,0,4,4,5,11,16,13,14,27,0.000333,0.036,2,216,12,108,49.663388,1,0
0,0,5,5,8,10,18,28,17,45,0.000333,0.062549,4,750.5865,41.69925,187.646625,57.219281,1,0
0,0,5,5,12,16,28,39,25,64,0.000333,0.102557,6,1846.02429,102.556905,307.670715,107.01955,2,0
0,0,3,3,8,7,15,11,9,20,0.000333,0.026046,4,312.551248,17.363958,78.137812,43.651484,1,0
0,0,3,3,9,8,17,16,10,26,0.000333,0.035425,4,425.096135,23.616452,106.274034,52.529325,3,0
0,0,4,4,6,8,14,17,12,29,0.000333,0.036804,3,331.239878,18.402215,110.413293,39.509775,3,0
0,0,5,5,8,12,20,25,19,44,0.000333,0.063388,4,760.659345,42.258852,190.164836,67.01955,1,0
0,0,3,3,7,8,15,23,12,35,0.000333,0.04558,3,410.223513,22.790195,136.741171,43.651484,1,0
0,0,5,5,7,8,15,20,14,34,0.000333,0.044278,3,398.502841,22.139047,132.83428,43.651484,1,0
0,0,3,3,7,8,15,23,12,35,0.000333,0.04558,3,410.223513,22.790195,136.741171,43.651484,1,0
0,0,9,9,12,16,28,47,25,72,0.000333,0.115377,6,2076.777326,115.376518,346.129554,107.01955,5,0
0,0,5,5,8,10,18,28,17,45,0.000333,0.062549,4,750.5865,41.69925,187.646625,57.219281,1,0
0,0,7,7,11,18,29,48,28,76,0.000333,0.123069,5,1846.032778,102.557377,369.206556,113.112398,1,0
0,0,4,4,9,10,19,30,16,46,0.000333,0.065135,4,781.618662,43.423259,195.404666,61.748606,1,0
0,0,3,3,7,8,15,23,12,35,0.000333,0.04558,3,410.223513,22.790195,136.741171,43.651484,1,0
0,0,7,7,11,19,30,44,28,72,0.000333,0.117765,5,1766.480614,98.137812,353.296123,118.764371,2,0
0,0,5,5,8,11,19,30,18,48,0.000333,0.067967,4,815.602083,45.311227,203.900521,62.053748,1,0
0,0,6,6,7,17,24,28,30,58,0.000333,0.088643,3,797.783475,44.321304,265.927825,89.138353,1,0
0,0,4,4,4,7,11,13,11,24,0.000333,0.027675,2,166.052718,9.225151,83.026359,27.651484,3,0
0,0,8,8,7,19,26,39,37,76,0.000333,0.119078,3,1071.700256,59.538903,357.233419,100.362107,1,0
0,0,3,3,8,7,15,20,12,32,0.000333,0.041673,4,500.081996,27.782333,125.020499,43.651484,1,0
0,0,4,4,9,7,16,17,12,29,0.000333,0.038667,4,464,25.777778,116,48.180809,1,0
0,0,8,8,15,18,33,66,34,100,0.000333,0.168146,7,3531.075884,196.170882,504.439412,133.662009,2,0
0,0,11,11,15,21,36,84,43,127,0.000333,0.21886,14,9192.126653,510.673703,656.580475,150.842025,2,0
0,0,3,3,7,8,15,23,12,35,0.000333,0.04558,3,410.223513,22.790195,136.741171,43.651484,1,0
0,0,8,8,16,17,33,49,35,84,0.000333,0.141243,16,6779.665696,376.648094,423.729106,133.486868,4,0
0,0,7,7,17,14,31,46,29,75,0.000333,0.123855,16,5945.035572,330.279754,371.564723,122.789837,4,0
0,0,8,8,12,16,28,40,30,70,0.000333,0.112172,6,2019.089067,112.171615,336.514845,107.01955,1,0
0,0,36,36,16,62,78,272,185,457,0.000333,0.957476,16,45958.86102,2553.270057,2872.428814,433.160171,4,0
0,0,8,8,15,18,33,66,34,100,0.000333,0.168146,7,3531.075884,196.170882,504.439412,133.662009,2,0
0,0,5,5,9,10,19,35,21,56,0.000333,0.079295,8,1903.071526,105.726196,237.883941,61.748606,4,0
0,0,8,8,10,11,21,46,27,73,0.000333,0.10688,10,3206.391719,178.132873,320.639172,71.273029,6,0
0,0,3,3,7,9,16,36,18,54,0.000333,0.072,6,1296,72,216,48.180809,1,0
0,0,5,5,11,12,23,33,21,54,0.000333,0.081424,5,1221.361728,67.853429,244.272346,81.073298,1,0
0,0,3,3,8,6,14,11,9,20,0.000333,0.025382,4,304.588394,16.921577,76.147098,39.509775,1,0
0,0,4,4,6,12,18,18,16,34,0.000333,0.047259,3,425.33235,23.629575,141.77745,58.529325,1,0
0,0,4,4,10,15,25,32,21,53,0.000333,0.082041,5,1230.62189,68.367883,246.124378,91.82264,1,0
0,0,3,3,8,8,16,20,12,32,0.000333,0.042667,4,512,28.444444,128,48,1,0
0,0,7,7,10,14,24,40,27,67,0.000333,0.102397,5,1535.962438,85.331247,307.192488,86.52225,1,0
0,0,11,11,12,18,30,69,40,109,0.000333,0.178284,12,6418.212899,356.567383,534.851075,118.0782,2,0
0,0,9,9,15,19,34,68,35,103,0.000333,0.17467,7,3668.060709,203.78115,524.008673,139.313982,2,0
0,0,11,11,15,21,36,84,43,127,0.000333,0.21886,14,9192.126653,510.673703,656.580475,150.842025,2,0
0,0,5,5,8,10,18,28,17,45,0.000333,0.062549,4,750.5865,41.69925,187.646625,57.219281,1,0
0,0,4,4,4,7,11,13,11,24,0.000333,0.027675,2,166.052718,9.225151,83.026359,27.651484,3,0
0,0,3,3,7,8,15,23,12,35,0.000333,0.04558,3,410.223513,22.790195,136.741171,43.651484,1,0
0,0,6,6,8,16,24,34,30,64,0.000333,0.097813,4,1173.7504,65.208356,293.4376,88,1,0
0,0,4,4,7,10,17,17,13,30,0.000333,0.040875,3,367.871656,20.437314,122.623885,52.870765,1,0
0,0,3,3,7,8,15,23,12,35,0.000333,0.04558,3,410.223513,22.790195,136.741171,43.651484,1,0
0,0,8,8,15,18,33,66,34,100,0.000333,0.168146,7,3531.075884,196.170882,504.439412,133.662009,2,0
0,0,11,11,12,17,29,56,46,102,0.000333,0.165171,12,5946.168738,330.342708,495.514062,112.506418,1,0
0,0,11,11,15,21,36,84,43,127,0.000333,0.21886,14,9192.126653,510.673703,656.580475,150.842025,2,0
0,0,5,5,8,10,18,28,17,45,0.000333,0.062549,4,750.5865,41.69925,187.646625,57.219281,1,0
0,0,8,8,15,18,33,66,34,100,0.000333,0.168146,7,3531.075884,196.170882,504.439412,133.662009,2,0
0,0,7,7,11,19,30,44,28,72,0.000333,0.117765,5,1766.480614,98.137812,353.296123,118.764371,2,0
0,0,4,4,4,7,11,13,11,24,0.000333,0.027675,2,166.052718,9.225151,83.026359,27.651484,3,0
0,0,4,4,11,10,21,24,14,38,0.000333,0.055636,5,834.54031,46.363351,166.908062,71.273029,3,0
0,0,12,12,14,17,31,57,41,98,0.000333,0.161837,14,6797.157338,377.619852,485.511238,122.789837,2,0
0,0,3,3,7,8,15,23,12,35,0.000333,0.04558,3,410.223513,22.790195,136.741171,43.651484,1,0
0,0,4,4,10,15,25,32,21,53,0.000333,0.082041,5,1230.62189,68.367883,246.124378,91.82264,1,0
0,0,3,3,8,7,15,20,12,32,0.000333,0.041673,4,500.081996,27.782333,125.020499,43.651484,1,0
0,0,3,3,7,8,15,23,12,35,0.000333,0.04558,3,410.223513,22.790195,136.741171,43.651484,1,0
0,0,3,3,8,7,15,20,12,32,0.000333,0.041673,4,500.081996,27.782333,125.020499,43.651484,1,0
0,0,25,25,12,35,47,382,213,595,0.000333,1.10166,36,118979.2932,6609.960733,3304.980367,222.544456,4,0
0,0,5,5,11,12,23,33,21,54,0.000333,0.081424,5,1221.361728,67.853429,244.272346,81.073298,1,0
0,0,8,8,15,18,33,66,34,100,0.000333,0.168146,7,3531.075884,196.170882,504.439412,133.662009,2,0
0,0,5,5,7,8,15,17,12,29,0.000333,0.037767,3,339.899482,18.883305,113.299827,43.651484,1,0
0,0,9,9,15,20,35,72,36,108,0.000333,0.184654,7,3877.737961,215.429887,553.962566,145.041921,2,0
0,0,8,8,15,18,33,66,34,100,0.000333,0.168146,7,3531.075884,196.170882,504.439412,133.662009,2,0
0,0,11,11,15,21,36,84,43,127,0.000333,0.21886,14,9192.126653,510.673703,656.580475,150.842025,2,0
0,0,3,3,9,8,17,16,11,27,0.000333,0.036787,4,441.445987,24.524777,110.361497,52.529325,2,0
0,0,8,8,10,14,24,48,32,80,0.000333,0.122266,10,3667.970001,203.776111,366.797,86.52225,1,0
0,0,3,3,10,8,18,16,13,29,0.000333,0.040309,5,604.639125,33.591063,120.927825,57.219281,3,0
0,0,4,4,7,6,13,14,9,23,0.000333,0.02837,3,255.330341,14.185019,85.110114,35.161259,1,0
0,0,3,3,8,7,15,11,9,20,0.000333,0.026046,4,312.551248,17.363958,78.137812,43.651484,1,0
0,0,3,3,8,7,15,11,9,20,0.000333,0.026046,4,312.551248,17.363958,78.137812,43.651484,1,0
0,0,4,4,9,9,18,19,15,34,0.000333,0.047259,4,567.1098,31.5061,141.77745,57.05865,1,0
0,0,5,5,8,10,18,28,17,45,0.000333,0.062549,4,750.5865,41.69925,187.646625,57.219281,1,0
0,0,5,5,8,11,19,30,18,48,0.000333,0.067967,4,815.602083,45.311227,203.900521,62.053748,1,0
0,0,7,7,8,13,21,20,22,42,0.000333,0.061492,4,737.909327,40.994963,184.477332,72.105716,1,0
0,0,3,3,8,6,14,11,9,20,0.000333,0.025382,4,304.588394,16.921577,76.147098,39.509775,1,0
0,0,4,4,6,9,15,14,12,26,0.000333,0.03386,3,304.737466,16.929859,101.579155,44.0391,1,0
0,0,7,7,11,18,29,48,28,76,0.000333,0.123069,5,1846.032778,102.557377,369.206556,113.112398,1,0
0,0,5,5,10,10,20,27,14,41,0.000333,0.059066,5,885.995259,49.221959,177.199052,66.438562,3,0
0,0,4,4,4,7,11,13,11,24,0.000333,0.027675,2,166.052718,9.225151,83.026359,27.651484,3,0
0,0,4,4,6,13,19,17,17,34,0.000333,0.048143,3,433.288606,24.071589,144.429535,63.615491,1,0
0,0,9,9,15,19,34,68,35,103,0.000333,0.17467,7,3668.060709,203.78115,524.008673,139.313982,2,0
0,0,11,11,15,21,36,84,43,127,0.000333,0.21886,14,9192.126653,510.673703,656.580475,150.842025,2,0
0,0,22,22,15,29,44,108,72,180,0.000333,0.327566,14,13757.76768,764.320427,982.697691,199.484808,10,0
0,0,14,14,11,22,33,79,42,121,0.000333,0.203457,5,3051.858442,169.547691,610.371688,136.161243,10,0
0,0,11,11,15,21,36,84,43,127,0.000333,0.21886,14,9192.126653,510.673703,656.580475,150.842025,2,0
0,0,7,7,14,15,29,42,31,73,0.000333,0.118211,14,4964.856577,275.825365,354.632613,111.906328,4,0
0,0,6,6,8,13,21,42,25,67,0.000333,0.098095,4,1177.141069,65.396726,294.285267,72.105716,1,0
0,0,4,4,8,11,19,27,17,44,0.000333,0.062303,4,747.635242,41.535291,186.908811,62.053748,1,0
0,0,4,4,9,13,22,21,17,38,0.000333,0.056486,4,677.833606,37.657423,169.458402,76.635041,3,0
0,0,4,4,11,9,20,35,15,50,0.000333,0.072032,5,1080.482024,60.026779,216.096405,66.583073,2,0
0,0,3,3,9,6,15,18,12,30,0.000333,0.039069,8,937.653743,52.091875,117.206718,44.0391,1,0
0,0,4,4,5,7,12,23,14,37,0.000333,0.044215,4,530.57445,29.476358,132.643613,31.261125,1,0
0,0,3,3,7,8,15,23,12,35,0.000333,0.04558,3,410.223513,22.790195,136.741171,43.651484,1,0
0,0,3,3,7,5,12,11,7,18,0.000333,0.02151,3,193.587975,10.754888,64.529325,31.261125,1,0
0,0,5,5,8,8,16,19,12,31,0.000333,0.041333,4,496,27.555556,124,48,1,0
0,0,5,5,10,11,21,29,17,46,0.000333,0.067349,5,1010.233007,56.124056,202.046601,71.273029,1,0
0,0,3,3,10,8,18,16,13,29,0.000333,0.040309,5,604.639125,33.591063,120.927825,57.219281,3,0
0,0,9,9,15,19,34,68,35,103,0.000333,0.17467,7,3668.060709,203.78115,524.008673,139.313982,2,0
0,0,8,8,15,18,33,66,34,100,0.000333,0.168146,7,3531.075884,196.170882,504.439412,133.662009,2,0
0,0,4,4,4,7,11,13,11,24,0.000333,0.027675,2,166.052718,9.225151,83.026359,27.651484,2,0
0,0,7,7,11,19,30,44,28,72,0.000333,0.117765,5,1766.480614,98.137812,353.296123,118.764371,2,0
0,0,7,7,11,12,23,49,24,73,0.000333,0.110073,10,3302.200228,183.455568,330.220023,81.073298,1,0
0,0,3,3,7,6,13,16,12,28,0.000333,0.034537,6,621.673873,34.537437,103.612312,35.161259,1,0
0,0,6,6,8,10,18,25,21,46,0.000333,0.063939,8,1534.532401,85.2518,191.81655,57.219281,1,0
0,0,3,3,9,8,17,16,10,26,0.000333,0.035425,4,425.096135,23.616452,106.274034,52.529325,3,0
0,0,8,8,15,18,33,66,34,100,0.000333,0.168146,7,3531.075884,196.170882,504.439412,133.662009,2,0
0,0,11,11,15,21,36,84,43,127,0.000333,0.21886,14,9192.126653,510.673703,656.580475,150.842025,2,0
0,0,10,10,9,16,25,41,35,76,0.000333,0.117644,8,2823.464563,156.859142,352.93307,92.529325,8,0
0,0,5,5,7,8,15,17,12,29,0.000333,0.037767,3,339.899482,18.883305,113.299827,43.651484,1,0
0,0,8,8,15,18,33,66,34,100,0.000333,0.168146,7,3531.075884,196.170882,504.439412,133.662009,2,0
0,0,11,11,15,21,36,84,43,127,0.000333,0.21886,14,9192.126653,510.673703,656.580475,150.842025,2,0
0,0,11,11,12,15,27,43,35,78,0.000333,0.123627,12,4450.574702,247.25415,370.881225,101.622909,1,0
0,0,9,9,14,16,30,47,32,79,0.000333,0.129215,14,5427.020999,301.501167,387.644357,117.302969,2,0
0,0,6,6,9,9,18,28,19,47,0.000333,0.065329,8,1567.891801,87.1051,195.986475,57.05865,1,0
0,0,5,5,10,14,24,27,22,49,0.000333,0.074888,5,1123.315813,62.406434,224.663163,86.52225,3,0
0,0,4,4,9,8,17,21,14,35,0.000333,0.047687,4,572.244798,31.791378,143.061199,52.529325,1,0
0,0,6,6,14,11,25,40,23,63,0.000333,0.097521,14,4095.881159,227.548953,292.56294,91.356717,4,0
0,0,7,7,11,19,30,44,28,72,0.000333,0.117765,5,1766.480614,98.137812,353.296123,118.764371,2,0
0,0,8,8,13,14,27,39,29,68,0.000333,0.107777,12,3879.988202,215.5549,323.33235,101.408685,1,0
0,0,6,6,8,13,21,42,25,67,0.000333,0.098095,4,1177.141069,65.396726,294.285267,72.105716,1,0
0,0,4,4,8,11,19,27,17,44,0.000333,0.062303,4,747.635242,41.535291,186.908811,62.053748,1,0
0,0,5,5,8,10,18,28,17,45,0.000333,0.062549,4,750.5865,41.69925,187.646625,57.219281,1,0
0,0,3,3,9,8,17,16,11,27,0.000333,0.036787,4,441.445987,24.524777,110.361497,52.529325,2,0
0,0,4,4,5,7,12,14,10,24,0.000333,0.02868,2,172.0782,9.5599,86.0391,31.261125,2,0
0,0,4,4,6,9,15,16,12,28,0.000333,0.036464,3,328.17881,18.232156,109.392937,44.0391,1,0
0,0,3,3,9,8,17,16,11,27,0.000333,0.036787,4,441.445987,24.524777,110.361497,52.529325,2,0
0,0,7,7,11,19,30,44,28,72,0.000333,0.117765,5,1766.480614,98.137812,353.296123,118.764371,2,0
0,0,4,4,6,9,15,16,12,28,0.000333,0.036464,3,328.17881,18.232156,109.392937,44.0391,1,0
0,0,8,8,15,18,33,66,34,100,0.000333,0.168146,7,3531.075884,196.170882,504.439412,133.662009,2,0
0,0,8,8,11,11,22,31,28,59,0.000333,0.087702,10,2631.064655,146.170259,263.106465,76.107496,1,0
0,0,9,9,15,20,35,72,36,108,0.000333,0.184654,7,3877.737961,215.429887,553.962566,145.041921,2,0
0,0,3,3,8,7,15,11,9,20,0.000333,0.026046,4,312.551248,17.363958,78.137812,43.651484,1,0
0,0,3,3,8,10,18,20,14,34,0.000333,0.047259,4,567.1098,31.5061,141.77745,57.219281,1,0
0,0,5,5,11,12,23,33,21,54,0.000333,0.081424,5,1221.361728,67.853429,244.272346,81.073298,1,0
0,0,8,8,15,18,33,66,34,100,0.000333,0.168146,7,3531.075884,196.170882,504.439412,133.662009,2,0
0,0,9,9,15,20,35,72,36,108,0.000333,0.184654,7,3877.737961,215.429887,553.962566,145.041921,2,0
0,0,3,3,9,8,17,16,11,27,0.000333,0.036787,4,441.445987,24.524777,110.361497,52.529325,2,0
0,0,3,3,8,8,16,20,12,32,0.000333,0.042667,4,512,28.444444,128,48,1,0
0,0,8,8,16,13,29,56,25,81,0.000333,0.131165,8,3147.971685,174.887316,393.496461,112.105716,3,0
0,0,5,5,5,10,15,18,15,33,0.000333,0.042976,2,257.854779,14.325266,128.92739,44.828921,3,0
0,0,4,4,4,7,11,13,11,24,0.000333,0.027675,2,166.052718,9.225151,83.026359,27.651484,3,0
0,0,8,8,15,18,33,66,34,100,0.000333,0.168146,7,3531.075884,196.170882,504.439412,133.662009,2,0
0,0,11,11,15,21,36,84,43,127,0.000333,0.21886,14,9192.126653,510.673703,656.580475,150.842025,2,0
0,0,9,9,15,20,35,72,36,108,0.000333,0.184654,7,3877.737961,215.429887,553.962566,145.041921,2,0
0,0,8,8,15,18,33,66,34,100,0.000333,0.168146,7,3531.075884,196.170882,504.439412,133.662009,2,0
0,0,26,26,15,32,47,143,88,231,0.000333,0.427703,14,17963.54035,997.974464,1283.110025,218.603359,1,0
0,0,4,4,8,11,19,27,17,44,0.000333,0.062303,4,747.635242,41.535291,186.908811,62.053748,1,0
0,0,3,3,7,8,15,23,12,35,0.000333,0.04558,3,410.223513,22.790195,136.741171,43.651484,1,0
0,0,3,3,8,7,15,11,9,20,0.000333,0.026046,4,312.551248,17.363958,78.137812,43.651484,1,0
0,0,13,13,11,22,33,99,50,149,0.000333,0.250538,10,7516.147238,417.563735,751.614724,136.161243,3,0
0,0,18,18,11,28,39,115,64,179,0.000333,0.315362,10,9460.869972,525.603887,946.086997,172.659686,3,0
0,0,5,5,8,10,18,28,17,45,0.000333,0.062549,4,750.5865,41.69925,187.646625,57.219281,1,0
0,0,5,5,8,10,18,28,17,45,0.000333,0.062549,4,750.5865,41.69925,187.646625,57.219281,1,0
0,0,3,3,7,8,15,23,12,35,0.000333,0.04558,3,410.223513,22.790195,136.741171,43.651484,1,0
0,0,3,3,8,8,16,20,12,32,0.000333,0.042667,4,512,28.444444,128,48,1,0
0,0,5,5,10,10,20,26,15,41,0.000333,0.059066,5,885.995259,49.221959,177.199052,66.438562,1,0
0,0,3,3,8,7,15,15,9,24,0.000333,0.031255,4,375.061497,20.83675,93.765374,43.651484,3,0
0,0,5,5,10,11,21,29,17,46,0.000333,0.067349,5,1010.233007,56.124056,202.046601,71.273029,1,0
0,0,5,5,11,12,23,33,21,54,0.000333,0.081424,5,1221.361728,67.853429,244.272346,81.073298,1,0
0,0,25,25,12,35,47,382,213,595,0.000333,1.10166,36,118979.2932,6609.960733,3304.980367,222.544456,4,0
0,0,5,5,11,13,24,29,20,49,0.000333,0.074888,5,1123.315813,62.406434,224.663163,86.159464,1,0
0,0,3,3,9,8,17,16,11,27,0.000333,0.036787,4,441.445987,24.524777,110.361497,52.529325,2,0
0,0,3,3,8,8,16,20,12,32,0.000333,0.042667,4,512,28.444444,128,48,1,0
0,0,5,5,8,10,18,26,15,41,0.000333,0.056989,4,683.8677,37.99265,170.966925,57.219281,1,0
0,0,11,11,8,18,26,71,42,113,0.000333,0.17705,8,4249.197505,236.066528,531.149688,99.05865,1,0
0,0,4,4,9,8,17,21,14,35,0.000333,0.047687,4,572.244798,31.791378,143.061199,52.529325,1,0
0,0,4,4,7,6,13,14,9,23,0.000333,0.02837,3,255.330341,14.185019,85.110114,35.161259,1,0
0,0,3,3,9,8,17,16,11,27,0.000333,0.036787,4,441.445987,24.524777,110.361497,52.529325,2,0
0,0,3,3,7,5,12,11,7,18,0.000333,0.02151,3,193.587975,10.754888,64.529325,31.261125,1,0
0,0,8,8,15,18,33,66,34,100,0.000333,0.168146,7,3531.075884,196.170882,504.439412,133.662009,2,0
0,0,9,9,15,19,34,68,35,103,0.000333,0.17467,7,3668.060709,203.78115,524.008673,139.313982,2,0
0,0,11,11,15,21,36,84,43,127,0.000333,0.21886,14,9192.126653,510.673703,656.580475,150.842025,2,0
0,0,7,7,11,19,30,44,28,72,0.000333,0.117765,5,1766.480614,98.137812,353.296123,118.764371,2,0
0,0,4,4,9,9,18,19,15,34,0.000333,0.047259,4,567.1098,31.5061,141.77745,57.05865,1,0
0,0,3,3,8,6,14,11,9,20,0.000333,0.025382,4,304.588394,16.921577,76.147098,39.509775,1,0
0,0,9,9,15,19,34,68,35,103,0.000333,0.17467,7,3668.060709,203.78115,524.008673,139.313982,2,0
0,0,6,6,7,11,18,41,25,66,0.000333,0.091738,6,1651.290301,91.73835,275.21505,57.705232,1,0
0,0,8,8,15,18,33,66,34,100,0.000333,0.168146,7,3531.075884,196.170882,504.439412,133.662009,2,0
0,0,4,4,6,8,14,17,12,29,0.000333,0.036804,3,331.239878,18.402215,110.413293,39.509775,3,0
0,0,4,4,5,9,14,15,13,28,0.000333,0.035535,2,213.211876,11.845104,106.605938,40.138965,1,0
0,0,8,8,10,11,21,31,27,58,0.000333,0.084918,10,2547.544105,141.530228,254.754411,71.273029,1,0
0,0,4,4,4,7,11,13,11,24,0.000333,0.027675,2,166.052718,9.225151,83.026359,27.651484,3,0
0,0,9,9,15,19,34,68,35,103,0.000333,0.17467,7,3668.060709,203.78115,524.008673,139.313982,2,0
0,0,6,6,9,12,21,42,21,63,0.000333,0.092239,4,1106.863991,61.492444,276.715998,71.548875,1,0
0,0,5,5,8,10,18,28,17,45,0.000333,0.062549,4,750.5865,41.69925,187.646625,57.219281,1,0
0,0,9,9,15,19,34,68,35,103,0.000333,0.17467,7,3668.060709,203.78115,524.008673,139.313982,2,0
0,0,9,9,15,19,34,68,35,103,0.000333,0.17467,7,3668.060709,203.78115,524.008673,139.313982,2,0
0,0,5,5,10,11,21,20,16,36,0.000333,0.052708,5,790.617136,43.923174,158.123427,71.273029,1,0
0,0,11,11,15,21,36,84,43,127,0.000333,0.21886,14,9192.126653,510.673703,656.580475,150.842025,2,0
0,0,4,4,12,8,20,23,11,34,0.000333,0.048982,6,881.673331,48.981852,146.945555,67.01955,4,0
0,0,4,4,9,8,17,21,14,35,0.000333,0.047687,4,572.244798,31.791378,143.061199,52.529325,1,0
0,0,3,3,7,8,15,23,12,35,0.000333,0.04558,3,410.223513,22.790195,136.741171,43.651484,1,0
0,0,6,6,13,13,26,37,25,62,0.000333,0.097142,6,1748.563575,97.142421,291.427263,96.211433,4,0
0,0,8,8,15,18,33,66,34,100,0.000333,0.168146,7,3531.075884,196.170882,504.439412,133.662009,2,0
0,0,4,4,4,7,11,13,11,24,0.000333,0.027675,2,166.052718,9.225151,83.026359,27.651484,3,0
0,0,4,4,6,9,15,16,12,28,0.000333,0.036464,3,328.17881,18.232156,109.392937,44.0391,1,0
0,0,5,5,9,13,22,19,21,40,0.000333,0.059459,4,713.509059,39.639392,178.377265,76.635041,1,0
0,0,7,7,11,19,30,44,28,72,0.000333,0.117765,5,1766.480614,98.137812,353.296123,118.764371,2,0
0,0,7,7,11,12,23,49,24,73,0.000333,0.110073,10,3302.200228,183.455568,330.220023,81.073298,1,0
0,0,3,3,8,7,15,20,12,32,0.000333,0.041673,4,500.081996,27.782333,125.020499,43.651484,1,0
0,0,6,6,14,12,26,38,24,62,0.000333,0.097142,14,4079.981675,226.665649,291.427263,96.322519,4,0
0,0,4,4,9,9,18,19,15,34,0.000333,0.047259,4,567.1098,31.5061,141.77745,57.05865,1,0
0,0,3,3,10,8,18,16,13,29,0.000333,0.040309,5,604.639125,33.591063,120.927825,57.219281,3,0
0,0,3,3,9,8,17,16,11,27,0.000333,0.036787,4,441.445987,24.524777,110.361497,52.529325,2,0
0,0,19,19,11,19,30,121,68,189,0.000333,0.309134,15,13911.03484,772.835269,927.402323,118.764371,1,0
0,0,5,5,10,11,21,29,17,46,0.000333,0.067349,5,1010.233007,56.124056,202.046601,71.273029,1,0
0,0,8,8,10,17,27,41,34,75,0.000333,0.118872,10,3566.165627,198.120313,356.616563,102.706149,1,0
0,0,4,4,4,7,11,13,11,24,0.000333,0.027675,2,166.052718,9.225151,83.026359,27.651484,3,0
0,0,3,3,8,7,15,20,12,32,0.000333,0.041673,4,500.081996,27.782333,125.020499,43.651484,1,0
0,0,8,8,15,18,33,66,34,100,0.000333,0.168146,7,3531.075884,196.170882,504.439412,133.662009,2,0
0,0,11,11,15,21,36,84,43,127,0.000333,0.21886,14,9192.126653,510.673703,656.580475,150.842025,2,0
0,0,9,9,15,19,34,68,35,103,0.000333,0.17467,7,3668.060709,203.78115,524.008673,139.313982,2,0
0,0,3,3,11,11,22,26,15,41,0.000333,0.060946,5,914.183482,50.787971,182.836696,76.107496,3,0
0,0,6,6,9,10,19,28,17,45,0.000333,0.063719,4,764.626952,42.479275,191.156738,61.748606,1,0
0,0,25,25,15,32,47,159,93,252,0.000333,0.466585,14,19596.58947,1088.699415,1399.756391,218.603359,8,0
0,0,4,4,6,8,14,17,12,29,0.000333,0.036804,3,331.239878,18.402215,110.413293,39.509775,3,0
0,0,4,4,10,15,25,32,21,53,0.000333,0.082041,5,1230.62189,68.367883,246.124378,91.82264,1,0
0,0,8,8,12,15,27,42,27,69,0.000333,0.109362,6,1968.523426,109.362413,328.087238,101.622909,2,0
0,0,6,6,13,15,28,34,27,61,0.000333,0.09775,6,1759.491901,97.74955,293.24865,106.709075,10,0
0,0,3,3,5,6,11,9,8,17,0.000333,0.019603,2,117.620675,6.534482,58.810338,27.119415,1,0
0,0,4,4,7,9,16,46,28,74,0.000333,0.098667,9,2664,148,296,48.180809,1,0
0,0,6,6,8,15,23,30,27,57,0.000333,0.085948,4,1031.372126,57.298451,257.843031,82.603359,1,0
0,0,5,5,8,13,21,27,20,47,0.000333,0.068813,4,825.755675,45.875315,206.438919,72.105716,1,0
0,0,11,11,15,21,36,84,43,127,0.000333,0.21886,14,9192.126653,510.673703,656.580475,150.842025,2,0
0,0,9,9,15,19,34,68,35,103,0.000333,0.17467,7,3668.060709,203.78115,524.008673,139.313982,2,0
0,0,6,6,9,10,19,28,17,45,0.000333,0.063719,4,764.626952,42.479275,191.156738,61.748606,1,0
0,0,11,11,12,19,31,66,55,121,0.000333,0.199819,12,7193.493043,399.638502,599.457754,123.730173,1,0
0,0,15,15,12,22,34,100,56,156,0.000333,0.264548,12,9523.730439,529.096135,793.644203,141.127046,5,0
0,0,8,8,11,16,27,36,29,65,0.000333,0.103023,5,1545.338438,85.852135,309.067688,102.053748,1,0
0,0,7,7,11,13,24,27,20,47,0.000333,0.071831,5,1077.466188,59.859233,215.493238,86.159464,1,0
0,0,11,11,15,21,36,84,43,127,0.000333,0.21886,14,9192.126653,510.673703,656.580475,150.842025,2,0
0,0,8,8,15,18,33,66,34,100,0.000333,0.168146,7,3531.075884,196.170882,504.439412,133.662009,2,0
0,0,5,5,8,10,18,28,17,45,0.000333,0.062549,4,750.5865,41.69925,187.646625,57.219281,1,0
0,0,3,3,9,8,17,16,11,27,0.000333,0.036787,4,441.445987,24.524777,110.361497,52.529325,2,0
0,0,5,5,12,14,26,26,22,48,0.000333,0.075207,6,1353.726639,75.207035,225.621106,96.322519,1,0
0,0,8,8,13,12,25,39,25,64,0.000333,0.099069,12,3566.481554,198.137864,297.206796,91.125266,1,0
0,0,5,5,10,11,21,33,18,51,0.000333,0.074669,5,1120.040943,62.224497,224.008189,71.273029,1,0
0,0,11,11,15,21,36,84,43,127,0.000333,0.21886,14,9192.126653,510.673703,656.580475,150.842025,2,0
0,0,9,9,15,19,34,68,35,103,0.000333,0.17467,7,3668.060709,203.78115,524.008673,139.313982,2,0
0,0,18,18,13,25,38,129,71,200,0.000333,0.349862,12,12595.02603,699.723668,1049.585503,164.202121,16,0
0,0,7,7,11,19,30,44,28,72,0.000333,0.117765,5,1766.480614,98.137812,353.296123,118.764371,2,0
0,0,7,7,11,19,30,44,28,72,0.000333,0.117765,5,1766.480614,98.137812,353.296123,118.764371,2,0
0,0,6,6,14,12,26,38,24,62,0.000333,0.097142,14,4079.981675,226.665649,291.427263,96.322519,4,0
0,0,7,7,8,12,20,29,20,49,0.000333,0.070591,4,847.097907,47.060995,211.774477,67.01955,1,0
0,0,4,4,4,8,12,15,13,28,0.000333,0.03346,2,200.7579,11.153217,100.37895,32,1,0
0,0,9,9,15,19,34,68,35,103,0.000333,0.17467,7,3668.060709,203.78115,524.008673,139.313982,2,0
0,0,7,7,10,14,24,40,27,67,0.000333,0.102397,5,1535.962438,85.331247,307.192488,86.52225,1,0
0,0,7,7,11,19,30,44,28,72,0.000333,0.117765,5,1766.480614,98.137812,353.296123,118.764371,2,0
0,0,3,3,7,8,15,23,12,35,0.000333,0.04558,3,410.223513,22.790195,136.741171,43.651484,1,0
0,0,4,4,4,7,11,13,11,24,0.000333,0.027675,2,166.052718,9.225151,83.026359,27.651484,3,0
0,0,7,7,11,19,30,44,28,72,0.000333,0.117765,5,1766.480614,98.137812,353.296123,118.764371,2,0
0,0,7,7,11,19,30,44,28,72,0.000333,0.117765,5,1766.480614,98.137812,353.296123,118.764371,2,0
0,0,10,10,7,14,21,57,36,93,0.000333,0.136162,6,2450.913122,136.16184,408.48552,72.954453,1,0
0,0,3,3,8,6,14,11,9,20,0.000333,0.025382,4,304.588394,16.921577,76.147098,39.509775,1,0
0,0,3,3,8,7,15,15,9,24,0.000333,0.031255,4,375.061497,20.83675,93.765374,43.651484,3,0
0,0,8,8,15,18,33,66,34,100,0.000333,0.168146,7,3531.075884,196.170882,504.439412,133.662009,2,0
0,0,11,11,15,21,36,84,43,127,0.000333,0.21886,14,9192.126653,510.673703,656.580475,150.842025,2,0
0,0,3,3,7,5,12,11,7,18,0.000333,0.02151,3,193.587975,10.754888,64.529325,31.261125,1,0
0,0,7,7,11,19,30,44,28,72,0.000333,0.117765,5,1766.480614,98.137812,353.296123,118.764371,2,0
0,0,9,9,15,19,34,68,35,103,0.000333,0.17467,7,3668.060709,203.78115,524.008673,139.313982,2,0
0,0,5,5,10,11,21,29,17,46,0.000333,0.067349,5,1010.233007,56.124056,202.046601,71.273029,1,0
0,0,3,3,8,7,15,11,9,20,0.000333,0.026046,4,312.551248,17.363958,78.137812,43.651484,1,0
0,0,5,5,7,8,15,17,12,29,0.000333,0.037767,3,339.899482,18.883305,113.299827,43.651484,1,0
0,0,4,4,4,7,11,13,11,24,0.000333,0.027675,2,166.052718,9.225151,83.026359,27.651484,3,0
0,0,7,7,11,19,30,44,28,72,0.000333,0.117765,5,1766.480614,98.137812,353.296123,118.764371,2,0
0,0,4,4,5,9,14,15,13,28,0.000333,0.035535,2,213.211876,11.845104,106.605938,40.138965,1,0
0,0,6,6,10,11,21,24,21,45,0.000333,0.065885,5,988.27142,54.903968,197.654284,71.273029,1,0
0,0,3,3,7,8,15,23,12,35,0.000333,0.04558,3,410.223513,22.790195,136.741171,43.651484,1,0
0,0,25,25,12,35,47,382,213,595,0.000333,1.10166,36,118979.2932,6609.960733,3304.980367,222.544456,4,0
0,0,4,4,6,8,14,17,12,29,0.000333,0.036804,3,331.239878,18.402215,110.413293,39.509775,3,0
0,0,3,3,9,8,17,16,11,27,0.000333,0.036787,4,441.445987,24.524777,110.361497,52.529325,2,0
0,0,3,3,9,8,17,16,11,27,0.000333,0.036787,4,441.445987,24.524777,110.361497,52.529325,2,0
0,0,4,4,6,8,14,17,12,29,0.000333,0.036804,3,331.239878,18.402215,110.413293,39.509775,3,0
0,0,7,7,8,17,25,40,35,75,0.000333,0.116096,8,2786.313714,154.795206,348.289214,93.486868,1,0
0,0,6,6,8,13,21,31,26,57,0.000333,0.083454,8,2002.896745,111.272041,250.362093,72.105716,1,0
0,0,16,16,18,16,34,87,37,124,0.000333,0.210282,18,11355.21706,630.845392,630.845392,139.05865,8,0
0,0,7,7,11,18,29,48,28,76,0.000333,0.123069,5,1846.032778,102.557377,369.206556,113.112398,1,0
0,0,7,7,11,18,29,48,28,76,0.000333,0.123069,5,1846.032778,102.557377,369.206556,113.112398,1,0
0,0,5,5,10,10,20,27,14,41,0.000333,0.059066,5,885.995259,49.221959,177.199052,66.438562,3,0
0,0,4,4,6,8,14,17,12,29,0.000333,0.036804,3,331.239878,18.402215,110.413293,39.509775,3,0
0,0,4,4,9,10,19,24,17,41,0.000333,0.058055,4,696.660112,38.70334,174.165028,61.748606,1,0
0,0,5,5,11,12,23,33,21,54,0.000333,0.081424,5,1221.361728,67.853429,244.272346,81.073298,1,0
0,0,11,11,12,18,30,69,40,109,0.000333,0.178284,12,6418.212899,356.567383,534.851075,118.0782,2,0
0,0,3,3,8,8,16,20,12,32,0.000333,0.042667,4,512,28.444444,128,48,1,0
0,0,7,7,11,19,30,44,28,72,0.000333,0.117765,5,1766.480614,98.137812,353.296123,118.764371,2,0
0,0,9,9,15,19,34,68,35,103,0.000333,0.17467,7,3668.060709,203.78115,524.008673,139.313982,2,0
0,0,13,13,16,36,52,233,88,321,0.000333,0.609947,16,29277.45839,1626.525466,1829.84115,250.1173,14,0
0,0,5,5,8,11,19,30,18,48,0.000333,0.067967,4,815.602083,45.311227,203.900521,62.053748,1,0
0,0,5,5,12,16,28,39,25,64,0.000333,0.102557,6,1846.02429,102.556905,307.670715,107.01955,2,0
0,0,11,11,15,21,36,84,43,127,0.000333,0.21886,14,9192.126653,510.673703,656.580475,150.842025,2,0
0,0,3,3,8,6,14,11,9,20,0.000333,0.025382,4,304.588394,16.921577,76.147098,39.509775,1,0
0,0,8,8,12,16,28,42,30,72,0.000333,0.115377,6,2076.777326,115.376518,346.129554,107.01955,1,0
0,0,3,3,8,8,16,20,12,32,0.000333,0.042667,4,512,28.444444,128,48,1,0
0,0,5,5,8,10,18,28,17,45,0.000333,0.062549,4,750.5865,41.69925,187.646625,57.219281,1,0
0,0,7,7,11,12,23,49,24,73,0.000333,0.110073,10,3302.200228,183.455568,330.220023,81.073298,1,0
0,0,3,3,7,8,15,23,12,35,0.000333,0.04558,3,410.223513,22.790195,136.741171,43.651484,1,0
0,0,3,3,5,7,12,12,9,21,0.000333,0.025095,2,150.568425,8.364913,75.284213,31.261125,1,0
0,0,7,7,11,19,30,44,28,72,0.000333,0.117765,5,1766.480614,98.137812,353.296123,118.764371,2,0
0,0,3,3,8,8,16,20,12,32,0.000333,0.042667,4,512,28.444444,128,48,1,0
0,0,5,5,8,10,18,28,17,45,0.000333,0.062549,4,750.5865,41.69925,187.646625,57.219281,1,0
0,0,4,4,12,11,23,24,15,39,0.000333,0.058806,6,1058.513498,58.806305,176.418916,81.073298,4,0
0,0,3,3,9,8,17,16,11,27,0.000333,0.036787,4,441.445987,24.524777,110.361497,52.529325,2,0
0,0,3,3,7,5,12,11,7,18,0.000333,0.02151,3,193.587975,10.754888,64.529325,31.261125,1,0
0,0,5,5,11,12,23,27,19,46,0.000333,0.069361,5,1040.41925,57.801069,208.08385,81.073298,1,0
0,0,4,4,9,8,17,15,12,27,0.000333,0.036787,4,441.445987,24.524777,110.361497,52.529325,1,0
0,0,5,5,8,11,19,36,19,55,0.000333,0.077879,4,934.544053,51.919114,233.636013,62.053748,1,0
0,0,7,7,11,19,30,44,28,72,0.000333,0.117765,5,1766.480614,98.137812,353.296123,118.764371,2,0
0,0,4,4,4,7,11,13,11,24,0.000333,0.027675,2,166.052718,9.225151,83.026359,27.651484,3,0
0,0,5,5,8,8,16,25,13,38,0.000333,0.050667,4,608,33.777778,152,48,3,0
0,0,9,9,11,14,25,41,29,70,0.000333,0.108357,10,3250.699333,180.594407,325.069933,91.356717,4,0
0,0,8,8,11,15,26,59,34,93,0.000333,0.145714,10,4371.408938,242.856052,437.140894,96.657107,1,0
0,0,9,9,15,19,34,68,35,103,0.000333,0.17467,7,3668.060709,203.78115,524.008673,139.313982,2,0
0,0,6,6,5,14,19,22,31,53,0.000333,0.075047,4,900.560633,50.031146,225.140158,64.912609,1,0
0,0,5,5,7,7,14,16,11,27,0.000333,0.034266,3,308.395749,17.133097,102.798583,39.302969,1,0
0,0,3,3,8,7,15,15,9,24,0.000333,0.031255,4,375.061497,20.83675,93.765374,43.651484,3,0
0,0,3,3,8,6,14,11,9,20,0.000333,0.025382,4,304.588394,16.921577,76.147098,39.509775,1,0
0,0,9,9,15,19,34,68,35,103,0.000333,0.17467,7,3668.060709,203.78115,524.008673,139.313982,2,0
0,0,8,8,15,18,33,66,34,100,0.000333,0.168146,7,3531.075884,196.170882,504.439412,133.662009,2,0
0,0,3,3,8,7,15,20,12,32,0.000333,0.041673,4,500.081996,27.782333,125.020499,43.651484,1,0
0,0,25,25,12,35,47,382,213,595,0.000333,1.10166,36,118979.2932,6609.960733,3304.980367,222.544456,4,0
0,0,5,5,11,12,23,33,21,54,0.000333,0.081424,5,1221.361728,67.853429,244.272346,81.073298,1,0
0,0,6,6,9,10,19,28,17,45,0.000333,0.063719,4,764.626952,42.479275,191.156738,61.748606,1,0
0,0,9,9,12,18,30,58,40,98,0.000333,0.160292,12,5770.50334,320.583519,480.875278,118.0782,1,0
0,0,5,5,8,10,18,28,17,45,0.000333,0.062549,4,750.5865,41.69925,187.646625,57.219281,1,0
0,0,3,3,10,8,18,16,13,29,0.000333,0.040309,5,604.639125,33.591063,120.927825,57.219281,3,0
0,0,7,7,11,19,30,44,28,72,0.000333,0.117765,5,1766.480614,98.137812,353.296123,118.764371,2,0
0,0,3,3,7,8,15,23,12,35,0.000333,0.04558,3,410.223513,22.790195,136.741171,43.651484,1,0
0,0,5,5,10,11,21,29,17,46,0.000333,0.067349,5,1010.233007,56.124056,202.046601,71.273029,1,0
0,0,6,6,9,13,22,21,22,43,0.000333,0.063919,4,767.022238,42.612347,191.75556,76.635041,1,0
0,0,11,11,8,18,26,71,42,113,0.000333,0.17705,8,4249.197505,236.066528,531.149688,99.05865,1,0
0,0,5,5,10,10,20,26,15,41,0.000333,0.059066,5,885.995259,49.221959,177.199052,66.438562,1,0
0,0,8,8,15,15,30,47,35,82,0.000333,0.134122,14,5633.110404,312.950578,402.365029,117.206718,4,0
0,0,11,11,15,21,36,84,43,127,0.000333,0.21886,14,9192.126653,510.673703,656.580475,150.842025,2,0
0,0,6,6,14,12,26,43,26,69,0.000333,0.10811,14,4540.624768,252.256932,324.330341,96.322519,4,0
0,0,8,8,15,18,33,66,34,100,0.000333,0.168146,7,3531.075884,196.170882,504.439412,133.662009,2,0
0,0,5,5,8,10,18,28,17,45,0.000333,0.062549,4,750.5865,41.69925,187.646625,57.219281,1,0
0,0,3,3,7,8,15,23,12,35,0.000333,0.04558,3,410.223513,22.790195,136.741171,43.651484,1,0
0,0,4,4,10,15,25,32,21,53,0.000333,0.082041,5,1230.62189,68.367883,246.124378,91.82264,1,0
0,0,4,4,8,13,21,25,26,51,0.000333,0.074669,8,1792.065508,99.559195,224.008189,72.105716,1,0
0,0,6,6,9,10,19,28,17,45,0.000333,0.063719,4,764.626952,42.479275,191.156738,61.748606,1,0
0,0,9,9,15,19,34,68,35,103,0.000333,0.17467,7,3668.060709,203.78115,524.008673,139.313982,2,0
0,0,11,11,15,21,36,84,43,127,0.000333,0.21886,14,9192.126653,510.673703,656.580475,150.842025,2,0
0,0,8,8,15,18,33,66,34,100,0.000333,0.168146,7,3531.075884,196.170882,504.439412,133.662009,2,0
0,0,5,5,8,10,18,28,17,45,0.000333,0.062549,4,750.5865,41.69925,187.646625,57.219281,1,0
0,0,7,7,10,14,24,40,27,67,0.000333,0.102397,5,1535.962438,85.331247,307.192488,86.52225,1,0
0,0,3,3,7,5,12,11,7,18,0.000333,0.02151,3,193.587975,10.754888,64.529325,31.261125,1,0
0,0,5,5,10,9,19,24,16,40,0.000333,0.056639,5,849.585503,47.199195,169.917101,61.748606,1,0
0,0,5,5,8,10,18,28,17,45,0.000333,0.062549,4,750.5865,41.69925,187.646625,57.219281,1,0
0,0,6,6,14,13,27,36,24,60,0.000333,0.095098,7,1997.052751,110.947375,285.29325,101.408685,3,0
0,0,3,3,7,8,15,23,12,35,0.000333,0.04558,3,410.223513,22.790195,136.741171,43.651484,1,0
0,0,25,25,12,35,47,382,213,595,0.000333,1.10166,36,118979.2932,6609.960733,3304.980367,222.544456,4,0
0,0,8,8,11,15,26,33,27,60,0.000333,0.094009,5,1410.131915,78.340662,282.026383,96.657107,1,0
0,0,4,4,9,8,17,21,14,35,0.000333,0.047687,4,572.244798,31.791378,143.061199,52.529325,1,0
0,0,5,5,10,11,21,33,18,51,0.000333,0.074669,5,1120.040943,62.224497,224.008189,71.273029,1,0
0,0,10,10,7,14,21,57,36,93,0.000333,0.136162,6,2450.913122,136.16184,408.48552,72.954453,1,0
0,0,4,4,4,7,11,13,11,24,0.000333,0.027675,2,166.052718,9.225151,83.026359,27.651484,3,0
0,0,8,8,16,16,32,48,32,80,0.000333,0.133333,16,6400,355.555556,400,128,5,0
0,0,5,5,8,10,18,28,17,45,0.000333,0.062549,4,750.5865,41.69925,187.646625,57.219281,1,0
0,0,3,3,8,7,15,20,12,32,0.000333,0.041673,4,500.081996,27.782333,125.020499,43.651484,1,0
0,0,3,3,7,8,15,23,12,35,0.000333,0.04558,3,410.223513,22.790195,136.741171,43.651484,1,0
0,0,6,6,9,10,19,28,17,45,0.000333,0.063719,4,764.626952,42.479275,191.156738,61.748606,1,0
0,0,3,3,8,6,14,11,9,20,0.000333,0.025382,4,304.588394,16.921577,76.147098,39.509775,1,0
0,0,4,4,4,7,11,13,11,24,0.000333,0.027675,2,166.052718,9.225151,83.026359,27.651484,3,0
0,0,53,53,28,89,117,527,361,888,0.000333,2.033628,56,341649.4968,18980.5276,6100.883871,710.946213,30,0
0,0,3,3,7,13,20,15,16,31,0.000333,0.04466,3,401.939313,22.329962,133.979771,67.757201,4,0
0,0,5,5,8,11,19,36,19,55,0.000333,0.077879,4,934.544053,51.919114,233.636013,62.053748,1,0
0,0,8,8,16,13,29,56,25,81,0.000333,0.131165,8,3147.971685,174.887316,393.496461,112.105716,3,0
0,0,3,3,7,8,15,23,12,35,0.000333,0.04558,3,410.223513,22.790195,136.741171,43.651484,1,0
0,0,5,5,8,8,16,19,12,31,0.000333,0.041333,4,496,27.555556,124,48,1,0
0,0,4,4,4,7,11,13,11,24,0.000333,0.027675,2,166.052718,9.225151,83.026359,27.651484,3,0
0,0,3,3,8,7,15,15,9,24,0.000333,0.031255,4,375.061497,20.83675,93.765374,43.651484,3,0
0,0,8,8,11,15,26,59,34,93,0.000333,0.145714,10,4371.408938,242.856052,437.140894,96.657107,1,0
0,0,7,7,11,19,30,44,28,72,0.000333,0.117765,5,1766.480614,98.137812,353.296123,118.764371,2,0
0,0,8,8,8,15,23,30,30,60,0.000333,0.090471,8,2171.309739,120.628319,271.413717,82.603359,1,0
0,0,3,3,5,6,11,9,8,17,0.000333,0.019603,2,117.620675,6.534482,58.810338,27.119415,1,0
0,0,3,3,7,5,12,11,7,18,0.000333,0.02151,3,193.587975,10.754888,64.529325,31.261125,1,0
0,0,4,4,4,7,11,13,11,24,0.000333,0.027675,2,166.052718,9.225151,83.026359,27.651484,3,0
0,0,3,3,9,7,16,19,11,30,0.000333,0.04,4,480,26.666667,120,48.180809,1,0
0,0,9,9,15,19,34,68,35,103,0.000333,0.17467,7,3668.060709,203.78115,524.008673,139.313982,2,0
0,0,7,7,10,15,25,42,26,68,0.000333,0.105261,5,1578.911105,87.717284,315.782221,91.82264,1,0
0,0,4,4,4,7,11,13,11,24,0.000333,0.027675,2,166.052718,9.225151,83.026359,27.651484,3,0
0,0,5,5,11,12,23,33,18,51,0.000333,0.076901,5,1153.508299,64.083794,230.70166,81.073298,3,0
0,0,10,10,8,17,25,58,36,94,0.000333,0.145507,8,3492.179855,194.009992,436.522482,93.486868,1,0
0,0,7,7,11,19,30,44,28,72,0.000333,0.117765,5,1766.480614,98.137812,353.296123,118.764371,2,0
0,0,9,9,15,19,34,68,35,103,0.000333,0.17467,7,3668.060709,203.78115,524.008673,139.313982,2,0
0,0,11,11,15,21,36,84,43,127,0.000333,0.21886,14,9192.126653,510.673703,656.580475,150.842025,2,0
0,0,8,8,15,18,33,66,34,100,0.000333,0.168146,7,3531.075884,196.170882,504.439412,133.662009,2,0
0,0,3,3,5,6,11,9,8,17,0.000333,0.019603,2,117.620675,6.534482,58.810338,27.119415,1,0
0,0,4,4,9,8,17,20,12,32,0.000333,0.0436,4,523.195244,29.066402,130.798811,52.529325,1,0
0,0,4,4,4,7,11,13,11,24,0.000333,0.027675,2,166.052718,9.225151,83.026359,27.651484,3,0
0,0,6,6,9,10,19,24,18,42,0.000333,0.059471,4,713.651822,39.647323,178.412956,61.748606,1,0
0,0,3,3,8,6,14,11,9,20,0.000333,0.025382,4,304.588394,16.921577,76.147098,39.509775,1,0
0,0,5,5,10,9,19,20,18,38,0.000333,0.053807,10,1614.212455,89.67847,161.421246,61.748606,1,0
0,0,5,5,8,9,17,25,15,40,0.000333,0.0545,4,653.994055,36.333003,163.498514,52.529325,1,0
0,0,6,6,6,14,20,26,32,58,0.000333,0.083557,6,1504.030977,83.557277,250.67183,68.812744,1,0
0,0,4,4,6,5,11,24,12,36,0.000333,0.041513,6,747.23723,41.513179,124.539538,27.119415,1,0
0,0,6,6,7,13,20,35,24,59,0.000333,0.084998,3,764.981273,42.49896,254.993758,67.757201,1,0
0,0,3,3,14,14,28,29,19,48,0.000333,0.076918,7,1615.271254,89.737292,230.753036,106.605938,2,0
0,0,5,5,8,10,18,28,17,45,0.000333,0.062549,4,750.5865,41.69925,187.646625,57.219281,1,0
0,0,3,3,8,7,15,20,12,32,0.000333,0.041673,4,500.081996,27.782333,125.020499,43.651484,1,0
0,0,22,22,14,35,49,128,70,198,0.000333,0.370571,14,15563.97569,864.665316,1111.712549,232.827875,12,0
0,0,5,5,8,10,18,28,17,45,0.000333,0.062549,4,750.5865,41.69925,187.646625,57.219281,1,0
0,0,5,5,8,11,19,30,18,48,0.000333,0.067967,4,815.602083,45.311227,203.900521,62.053748,1,0
0,0,4,4,9,8,17,21,14,35,0.000333,0.047687,4,572.244798,31.791378,143.061199,52.529325,1,0
0,0,5,5,8,11,19,30,18,48,0.000333,0.067967,4,815.602083,45.311227,203.900521,62.053748,1,0
0,0,3,3,8,8,16,20,12,32,0.000333,0.042667,4,512,28.444444,128,48,1,0
0,0,5,5,11,12,23,31,19,50,0.000333,0.075393,5,1130.890489,62.827249,226.178098,81.073298,2,0
0,0,4,4,4,7,11,13,11,24,0.000333,0.027675,2,166.052718,9.225151,83.026359,27.651484,3,0
0,0,8,8,10,17,27,39,33,72,0.000333,0.114117,5,1711.759501,95.09775,342.3519,102.706149,1,0
0,0,3,3,7,5,12,11,7,18,0.000333,0.02151,3,193.587975,10.754888,64.529325,31.261125,1,0
0,0,9,9,15,19,34,68,35,103,0.000333,0.17467,7,3668.060709,203.78115,524.008673,139.313982,2,0
0,0,11,11,15,21,36,84,43,127,0.000333,0.21886,14,9192.126653,510.673703,656.580475,150.842025,2,0
0,0,8,8,15,18,33,66,34,100,0.000333,0.168146,7,3531.075884,196.170882,504.439412,133.662009,2,0
0,0,3,3,7,8,15,23,12,35,0.000333,0.04558,3,410.223513,22.790195,136.741171,43.651484,1,0
0,0,3,3,8,14,22,23,20,43,0.000333,0.063919,4,767.022238,42.612347,191.75556,77.302969,1,0
0,0,6,6,9,10,19,28,17,45,0.000333,0.063719,4,764.626952,42.479275,191.156738,61.748606,1,0
0,0,3,3,5,6,11,9,8,17,0.000333,0.019603,2,117.620675,6.534482,58.810338,27.119415,1,0
0,0,9,9,15,20,35,72,36,108,0.000333,0.184654,7,3877.737961,215.429887,553.962566,145.041921,2,0
0,0,8,8,14,13,27,52,33,85,0.000333,0.134722,14,5658.316128,314.350896,404.165438,101.408685,5,0
0,0,9,9,15,19,34,68,35,103,0.000333,0.17467,7,3668.060709,203.78115,524.008673,139.313982,2,0
0,0,8,8,15,18,33,66,34,100,0.000333,0.168146,7,3531.075884,196.170882,504.439412,133.662009,2,0
0,0,6,6,5,12,17,19,26,45,0.000333,0.061312,4,735.743311,40.874628,183.935828,54.62919,1,0
0,0,9,9,11,15,26,54,26,80,0.000333,0.125345,5,1880.175887,104.454216,376.035177,96.657107,4,0
0,0,7,7,11,19,30,44,28,72,0.000333,0.117765,5,1766.480614,98.137812,353.296123,118.764371,2,0
0,0,3,3,8,8,16,20,12,32,0.000333,0.042667,4,512,28.444444,128,48,1,0
0,0,5,5,10,11,21,29,17,46,0.000333,0.067349,5,1010.233007,56.124056,202.046601,71.273029,1,0
0,0,3,3,9,8,17,16,11,27,0.000333,0.036787,4,441.445987,24.524777,110.361497,52.529325,2,0
0,0,5,5,11,12,23,33,21,54,0.000333,0.081424,5,1221.361728,67.853429,244.272346,81.073298,1,0
0,0,5,5,8,9,17,21,16,37,0.000333,0.050412,4,604.944501,33.608028,151.236125,52.529325,1,0
0,0,9,9,15,19,34,68,35,103,0.000333,0.17467,7,3668.060709,203.78115,524.008673,139.313982,2,0
0,0,8,8,15,18,33,66,34,100,0.000333,0.168146,7,3531.075884,196.170882,504.439412,133.662009,2,0
0,0,11,11,15,21,36,84,43,127,0.000333,0.21886,14,9192.126653,510.673703,656.580475,150.842025,2,0
0,0,3,3,8,8,16,20,12,32,0.000333,0.042667,4,512,28.444444,128,48,1,0
0,0,7,7,11,12,23,49,24,73,0.000333,0.110073,10,3302.200228,183.455568,330.220023,81.073298,1,0
0,0,5,5,10,14,24,27,22,49,0.000333,0.074888,5,1123.315813,62.406434,224.663163,86.52225,3,0
0,0,5,5,8,9,17,25,15,40,0.000333,0.0545,4,653.994055,36.333003,163.498514,52.529325,1,0
0,0,7,7,11,19,30,44,28,72,0.000333,0.117765,5,1766.480614,98.137812,353.296123,118.764371,2,0
0,0,3,3,8,6,14,11,9,20,0.000333,0.025382,4,304.588394,16.921577,76.147098,39.509775,1,0
0,0,6,6,7,13,20,35,24,59,0.000333,0.084998,3,764.981273,42.49896,254.993758,67.757201,1,0
0,0,6,6,9,10,19,28,17,45,0.000333,0.063719,4,764.626952,42.479275,191.156738,61.748606,1,0
0,0,3,3,8,7,15,11,9,20,0.000333,0.026046,4,312.551248,17.363958,78.137812,43.651484,1,0
0,0,3,3,10,8,18,16,13,29,0.000333,0.040309,5,604.639125,33.591063,120.927825,57.219281,3,0
0,0,4,4,4,7,11,13,11,24,0.000333,0.027675,2,166.052718,9.225151,83.026359,27.651484,3,0
0,0,4,4,8,11,19,27,17,44,0.000333,0.062303,4,747.635242,41.535291,186.908811,62.053748,1,0
0,0,6,6,8,13,21,42,25,67,0.000333,0.098095,4,1177.141069,65.396726,294.285267,72.105716,1,0
0,0,5,5,7,8,15,22,15,37,0.000333,0.048185,3,433.664856,24.092492,144.554952,43.651484,1,0
0,0,8,8,13,11,24,39,26,65,0.000333,0.099341,12,3576.270751,198.681708,298.022563,86.159464,1,0
0,0,3,3,8,6,14,11,9,20,0.000333,0.025382,4,304.588394,16.921577,76.147098,39.509775,1,0
0,0,4,4,5,12,17,14,15,29,0.000333,0.039512,2,237.072845,13.170714,118.536422,54.62919,1,0
0,0,3,3,8,8,16,20,12,32,0.000333,0.042667,4,512,28.444444,128,48,1,0
0,0,5,5,13,9,22,25,14,39,0.000333,0.057973,6,1043.506999,57.972611,173.917833,76.635041,2,0
0,0,6,6,7,17,24,36,30,66,0.000333,0.100869,3,907.822575,50.434588,302.607525,89.138353,1,0
0,0,5,5,11,12,23,33,21,54,0.000333,0.081424,5,1221.361728,67.853429,244.272346,81.073298,1,0
0,0,4,4,6,8,14,17,12,29,0.000333,0.036804,3,331.239878,18.402215,110.413293,39.509775,3,0
0,0,11,11,15,21,36,84,43,127,0.000333,0.21886,14,9192.126653,510.673703,656.580475,150.842025,2,0
0,0,8,8,13,14,27,39,29,68,0.000333,0.107777,12,3879.988202,215.5549,323.33235,101.408685,1,0
0,0,4,4,6,9,15,16,12,28,0.000333,0.036464,3,328.17881,18.232156,109.392937,44.0391,1,0
0,0,8,8,15,18,33,66,34,100,0.000333,0.168146,7,3531.075884,196.170882,504.439412,133.662009,2,0
0,0,7,7,10,16,26,30,29,59,0.000333,0.092442,5,1386.629717,77.034984,277.325943,97.219281,1,0
0,0,3,3,8,6,14,11,9,20,0.000333,0.025382,4,304.588394,16.921577,76.147098,39.509775,1,0
0,0,5,5,7,7,14,16,11,27,0.000333,0.034266,3,308.395749,17.133097,102.798583,39.302969,1,0
0,0,25,25,12,35,47,382,213,595,0.000333,1.10166,36,118979.2932,6609.960733,3304.980367,222.544456,4,0
0,0,3,3,9,8,17,16,11,27,0.000333,0.036787,4,441.445987,24.524777,110.361497,52.529325,2,0
0,0,4,4,4,7,11,13,11,24,0.000333,0.027675,2,166.052718,9.225151,83.026359,27.651484,3,0
0,0,5,5,6,10,16,29,20,49,0.000333,0.065333,6,1176,65.333333,196,48.729056,1,0
0,0,18,18,14,28,42,99,61,160,0.000333,0.28759,14,12078.79103,671.043946,862.770788,187.908907,6,0
0,0,11,11,15,21,36,84,43,127,0.000333,0.21886,14,9192.126653,510.673703,656.580475,150.842025,2,0
0,0,9,9,15,19,34,68,35,103,0.000333,0.17467,7,3668.060709,203.78115,524.008673,139.313982,2,0
0,0,11,11,13,18,31,66,50,116,0.000333,0.191562,12,6896.241264,383.124515,574.686772,123.164366,1,0
0,0,4,4,9,13,22,22,17,39,0.000333,0.057973,4,695.671333,38.648407,173.917833,76.635041,2,0
0,0,9,9,15,20,35,72,36,108,0.000333,0.184654,7,3877.737961,215.429887,553.962566,145.041921,2,0
0,0,5,5,10,9,19,35,18,53,0.000333,0.075047,10,2251.401582,125.077866,225.140158,61.748606,4,0
0,0,3,3,7,8,15,23,12,35,0.000333,0.04558,3,410.223513,22.790195,136.741171,43.651484,1,0
0,0,41,41,13,39,52,184,129,313,0.000333,0.594746,18,32116.27737,1784.237632,1784.237632,254.236403,4,0
0,0,16,16,14,32,46,89,60,149,0.000333,0.274337,7,5761.07512,320.059729,823.010731,213.302969,3,0
0,0,4,4,4,7,11,13,11,24,0.000333,0.027675,2,166.052718,9.225151,83.026359,27.651484,3,0
0,0,7,7,11,19,30,44,28,72,0.000333,0.117765,5,1766.480614,98.137812,353.296123,118.764371,2,0
0,0,3,3,7,8,15,23,12,35,0.000333,0.04558,3,410.223513,22.790195,136.741171,43.651484,1,0
0,0,8,8,15,18,33,66,34,100,0.000333,0.168146,7,3531.075884,196.170882,504.439412,133.662009,2,0
0,0,11,11,15,21,36,84,43,127,0.000333,0.21886,14,9192.126653,510.673703,656.580475,150.842025,2,0
0,0,9,9,15,19,34,68,35,103,0.000333,0.17467,7,3668.060709,203.78115,524.008673,139.313982,2,0
0,0,3,3,8,7,15,11,9,20,0.000333,0.026046,4,312.551248,17.363958,78.137812,43.651484,1,0
0,0,3,3,8,7,15,11,9,20,0.000333,0.026046,4,312.551248,17.363958,78.137812,43.651484,1,0
0,0,4,4,4,7,11,13,11,24,0.000333,0.027675,2,166.052718,9.225151,83.026359,27.651484,3,0
0,0,9,9,15,19,34,68,35,103,0.000333,0.17467,7,3668.060709,203.78115,524.008673,139.313982,2,0
0,0,11,11,15,21,36,84,43,127,0.000333,0.21886,14,9192.126653,510.673703,656.580475,150.842025,2,0
0,0,11,11,15,21,36,84,43,127,0.000333,0.21886,14,9192.126653,510.673703,656.580475,150.842025,2,0
0,0,8,8,15,18,33,66,34,100,0.000333,0.168146,7,3531.075884,196.170882,504.439412,133.662009,2,0
0,0,3,3,9,8,17,16,11,27,0.000333,0.036787,4,441.445987,24.524777,110.361497,52.529325,2,0
0,0,3,3,9,8,17,16,11,27,0.000333,0.036787,4,441.445987,24.524777,110.361497,52.529325,2,0
0,0,5,5,8,11,19,36,19,55,0.000333,0.077879,4,934.544053,51.919114,233.636013,62.053748,1,0
0,0,9,9,15,19,34,68,35,103,0.000333,0.17467,7,3668.060709,203.78115,524.008673,139.313982,2,0
0,0,3,3,9,12,21,17,14,31,0.000333,0.045387,4,544.64736,30.258187,136.16184,71.548875,1,0
0,0,14,14,11,23,34,85,48,133,0.000333,0.225544,10,6766.325579,375.906977,676.632558,142.095673,1,0
0,0,17,17,10,19,29,111,64,175,0.000333,0.283382,15,12752.20011,708.455562,850.146674,113.929904,1,0
0,0,4,4,4,7,11,13,11,24,0.000333,0.027675,2,166.052718,9.225151,83.026359,27.651484,3,0
0,0,3,3,9,8,17,16,10,26,0.000333,0.035425,4,425.096135,23.616452,106.274034,52.529325,3,0
0,0,7,7,11,19,30,44,28,72,0.000333,0.117765,5,1766.480614,98.137812,353.296123,118.764371,2,0
0,0,9,9,10,17,27,30,39,69,0.000333,0.109362,10,3280.872376,182.270688,328.087238,102.706149,1,0
0,0,25,25,12,35,47,382,213,595,0.000333,1.10166,36,118979.2932,6609.960733,3304.980367,222.544456,4,0
0,0,5,5,11,12,23,33,21,54,0.000333,0.081424,5,1221.361728,67.853429,244.272346,81.073298,1,0
0,0,4,4,9,15,24,25,21,46,0.000333,0.070303,4,843.6331,46.868506,210.908275,87.132684,1,0
0,0,6,6,9,17,26,40,29,69,0.000333,0.10811,4,1297.321362,72.073409,324.330341,98.016193,1,0
0,0,7,7,11,19,30,44,28,72,0.000333,0.117765,5,1766.480614,98.137812,353.296123,118.764371,2,0
0,0,7,7,10,14,24,40,27,67,0.000333,0.102397,5,1535.962438,85.331247,307.192488,86.52225,1,0
0,0,6,6,14,12,26,41,24,65,0.000333,0.101843,14,4277.400144,237.633341,305.528582,96.322519,5,0
0,0,3,3,10,8,18,16,13,29,0.000333,0.040309,5,604.639125,33.591063,120.927825,57.219281,3,0
0,0,5,5,10,9,19,27,16,43,0.000333,0.060887,5,913.304415,50.739134,182.660883,61.748606,1,0
0,0,7,7,14,15,29,42,31,73,0.000333,0.118211,14,4964.856577,275.825365,354.632613,111.906328,4,0
0,0,6,6,5,14,19,22,31,53,0.000333,0.075047,4,900.560633,50.031146,225.140158,64.912609,1,0
0,0,4,4,9,7,16,16,11,27,0.000333,0.036,4,432,24,108,48.180809,1,0
0,0,4,4,9,8,17,15,12,27,0.000333,0.036787,4,441.445987,24.524777,110.361497,52.529325,1,0
0,0,3,3,8,8,16,20,12,32,0.000333,0.042667,4,512,28.444444,128,48,1,0
0,0,6,6,16,9,25,46,18,64,0.000333,0.099069,16,4755.308738,264.183819,297.206796,92.529325,2,0
0,0,9,9,15,19,34,68,35,103,0.000333,0.17467,7,3668.060709,203.78115,524.008673,139.313982,2,0
0,0,8,8,15,18,33,66,34,100,0.000333,0.168146,7,3531.075884,196.170882,504.439412,133.662009,2,0
0,0,11,11,15,21,36,84,43,127,0.000333,0.21886,14,9192.126653,510.673703,656.580475,150.842025,2,0
0,0,4,4,4,7,11,13,11,24,0.000333,0.027675,2,166.052718,9.225151,83.026359,27.651484,3,0
0,0,5,5,7,7,14,16,11,27,0.000333,0.034266,3,308.395749,17.133097,102.798583,39.302969,1,0
0,0,8,8,15,18,33,66,34,100,0.000333,0.168146,7,3531.075884,196.170882,504.439412,133.662009,2,0
0,0,3,3,8,6,14,11,9,20,0.000333,0.025382,4,304.588394,16.921577,76.147098,39.509775,1,0
0,0,11,11,12,18,30,69,40,109,0.000333,0.178284,12,6418.212899,356.567383,534.851075,118.0782,12,0
0,0,11,11,12,18,30,69,40,109,0.000333,0.178284,12,6418.212899,356.567383,534.851075,118.0782,2,0
0,0,4,4,5,9,14,15,13,28,0.000333,0.035535,2,213.211876,11.845104,106.605938,40.138965,1,0
0,0,5,5,8,15,23,29,34,63,0.000333,0.094995,8,2279.875226,126.659735,284.984403,82.603359,1,0
0,0,7,7,8,17,25,44,42,86,0.000333,0.133124,8,3194.973059,177.498503,399.371632,93.486868,1,0
0,0,7,7,11,19,30,44,28,72,0.000333,0.117765,5,1766.480614,98.137812,353.296123,118.764371,2,0
0,0,6,6,14,11,25,40,23,63,0.000333,0.097521,14,4095.881159,227.548953,292.56294,91.356717,4,0
0,0,20,20,14,20,34,106,58,164,0.000333,0.278115,14,11680.81468,648.934149,834.343906,139.741531,2,0
0,0,10,10,7,14,21,57,36,93,0.000333,0.136162,6,2450.913122,136.16184,408.48552,72.954453,1,0
0,0,3,3,8,10,18,20,14,34,0.000333,0.047259,4,567.1098,31.5061,141.77745,57.219281,1,0
0,0,5,5,8,10,18,26,15,41,0.000333,0.056989,4,683.8677,37.99265,170.966925,57.219281,1,0
0,0,7,7,16,14,30,45,29,74,0.000333,0.121037,16,5809.758465,322.764359,363.109904,117.302969,4,0
0,0,3,3,7,5,12,11,7,18,0.000333,0.02151,3,193.587975,10.754888,64.529325,31.261125,1,0
0,0,4,4,10,15,25,32,21,53,0.000333,0.082041,5,1230.62189,68.367883,246.124378,91.82264,1,0
0,0,9,9,15,19,34,68,35,103,0.000333,0.17467,7,3668.060709,203.78115,524.008673,139.313982,2,0
0,0,6,6,9,9,18,21,16,37,0.000333,0.051429,4,617.1489,34.28605,154.287225,57.05865,1,0
0,0,7,7,11,19,30,44,28,72,0.000333,0.117765,5,1766.480614,98.137812,353.296123,118.764371,2,0
0,0,4,4,4,7,11,13,11,24,0.000333,0.027675,2,166.052718,9.225151,83.026359,27.651484,3,0
0,0,4,4,4,7,11,13,11,24,0.000333,0.027675,2,166.052718,9.225151,83.026359,27.651484,3,0
0,0,5,5,8,10,18,28,17,45,0.000333,0.062549,4,750.5865,41.69925,187.646625,57.219281,1,0
0,0,14,14,11,23,34,85,48,133,0.000333,0.225544,10,6766.325579,375.906977,676.632558,142.095673,1,0
0,0,5,5,8,8,16,19,12,31,0.000333,0.041333,4,496,27.555556,124,48,1,0
0,0,6,6,7,11,18,41,25,66,0.000333,0.091738,6,1651.290301,91.73835,275.21505,57.705232,1,0
0,0,6,6,7,11,18,41,25,66,0.000333,0.091738,6,1651.290301,91.73835,275.21505,57.705232,1,0
0,0,5,5,7,7,14,19,12,31,0.000333,0.039343,3,354.084008,19.671334,118.028003,39.302969,1,0
0,0,7,7,11,19,30,44,28,72,0.000333,0.117765,5,1766.480614,98.137812,353.296123,118.764371,2,0
0,0,4,4,4,7,11,13,11,24,0.000333,0.027675,2,166.052718,9.225151,83.026359,27.651484,3,0
0,0,4,4,6,12,18,20,17,37,0.000333,0.051429,3,462.861675,25.714538,154.287225,58.529325,1,0
0,0,12,12,7,18,25,72,44,116,0.000333,0.179562,6,3232.123908,179.562439,538.687318,94.710134,1,0
0,0,3,3,7,5,12,11,7,18,0.000333,0.02151,3,193.587975,10.754888,64.529325,31.261125,1,0
0,0,8,8,15,18,33,66,34,100,0.000333,0.168146,7,3531.075884,196.170882,504.439412,133.662009,2,0
0,0,4,4,7,11,18,24,17,41,0.000333,0.056989,3,512.900775,28.494488,170.966925,57.705232,1,0
0,0,4,4,11,9,20,35,15,50,0.000333,0.072032,5,1080.482024,60.026779,216.096405,66.583073,2,0
0,0,6,6,8,12,20,23,20,43,0.000333,0.061948,4,743.371632,41.298424,185.842908,67.01955,3,0
0,0,5,5,11,12,23,33,21,54,0.000333,0.081424,5,1221.361728,67.853429,244.272346,81.073298,1,0
0,0,25,25,12,35,47,382,213,595,0.000333,1.10166,36,118979.2932,6609.960733,3304.980367,222.544456,4,0
0,0,8,8,16,17,33,49,35,84,0.000333,0.141243,16,6779.665696,376.648094,423.729106,133.486868,4,0
0,0,3,3,7,8,15,23,12,35,0.000333,0.04558,3,410.223513,22.790195,136.741171,43.651484,1,0
0,0,4,4,8,10,18,28,16,44,0.000333,0.061159,4,733.9068,40.7726,183.4767,57.219281,1,0
0,0,3,3,8,7,15,11,9,20,0.000333,0.026046,4,312.551248,17.363958,78.137812,43.651484,1,0
0,0,3,3,7,8,15,23,12,35,0.000333,0.04558,3,410.223513,22.790195,136.741171,43.651484,1,0
0,0,3,3,7,5,12,11,7,18,0.000333,0.02151,3,193.587975,10.754888,64.529325,31.261125,1,0
0,0,3,3,7,8,15,23,12,35,0.000333,0.04558,3,410.223513,22.790195,136.741171,43.651484,1,0
0,0,5,5,8,11,19,30,18,48,0.000333,0.067967,4,815.602083,45.311227,203.900521,62.053748,1,0
0,0,6,6,13,11,24,38,23,61,0.000333,0.093228,12,3356.192551,186.455142,279.682713,86.159464,4,0
0,0,6,6,8,13,21,42,25,67,0.000333,0.098095,4,1177.141069,65.396726,294.285267,72.105716,1,0
0,0,4,4,8,11,19,27,17,44,0.000333,0.062303,4,747.635242,41.535291,186.908811,62.053748,1,0
0,0,3,3,7,8,15,23,12,35,0.000333,0.04558,3,410.223513,22.790195,136.741171,43.651484,1,0
0,0,4,4,4,7,11,13,11,24,0.000333,0.027675,2,166.052718,9.225151,83.026359,27.651484,3,0
0,0,3,3,10,6,16,22,12,34,0.000333,0.045333,10,1360,75.555556,136,48.729056,1,0
0,0,4,4,5,12,17,14,15,29,0.000333,0.039512,2,237.072845,13.170714,118.536422,54.62919,1,0
0,0,5,5,8,12,20,28,20,48,0.000333,0.069151,4,829.810194,46.100566,207.452549,67.01955,1,0
0,0,3,3,5,6,11,9,8,17,0.000333,0.019603,2,117.620675,6.534482,58.810338,27.119415,1,0
0,0,9,9,10,12,22,32,29,61,0.000333,0.090675,10,2720.253287,151.125183,272.025329,76.238831,1,0
0,0,5,5,8,11,19,30,18,48,0.000333,0.067967,4,815.602083,45.311227,203.900521,62.053748,1,0
0,0,5,5,11,13,24,28,20,48,0.000333,0.073359,5,1100.391,61.132833,220.0782,86.159464,1,0
0,0,6,6,7,11,18,41,25,66,0.000333,0.091738,6,1651.290301,91.73835,275.21505,57.705232,1,0
0,0,3,3,7,8,15,23,12,35,0.000333,0.04558,3,410.223513,22.790195,136.741171,43.651484,1,0
0,0,8,8,15,18,33,66,34,100,0.000333,0.168146,7,3531.075884,196.170882,504.439412,133.662009,2,0
0,0,8,8,15,18,33,66,34,100,0.000333,0.168146,7,3531.075884,196.170882,504.439412,133.662009,2,0
0,0,5,5,10,10,20,26,15,41,0.000333,0.059066,5,885.995259,49.221959,177.199052,66.438562,1,0
0,0,3,3,14,8,22,29,14,43,0.000333,0.063919,7,1342.288917,74.571607,191.75556,77.302969,3,0
0,0,5,5,8,8,16,17,14,31,0.000333,0.041333,4,496,27.555556,124,48,1,0
0,0,7,7,11,19,30,44,28,72,0.000333,0.117765,5,1766.480614,98.137812,353.296123,118.764371,2,0
0,0,6,6,9,10,19,28,17,45,0.000333,0.063719,4,764.626952,42.479275,191.156738,61.748606,1,0
0,0,12,12,7,18,25,72,44,116,0.000333,0.179562,6,3232.123908,179.562439,538.687318,94.710134,3,0
0,0,11,11,8,18,26,71,42,113,0.000333,0.17705,8,4249.197505,236.066528,531.149688,99.05865,3,0
0,0,7,7,10,13,23,37,19,56,0.000333,0.08444,5,1266.597348,70.366519,253.31947,81.324997,3,0
0,0,22,22,17,35,52,129,69,198,0.000333,0.376229,8,9029.496514,501.638695,1128.687064,249.011774,8,0
0,0,3,3,7,8,15,23,12,35,0.000333,0.04558,3,410.223513,22.790195,136.741171,43.651484,1,0
0,0,3,3,7,10,17,22,15,37,0.000333,0.050412,3,453.708375,25.206021,151.236125,52.870765,1,0
0,0,4,4,9,7,16,17,12,29,0.000333,0.038667,4,464,25.777778,116,48.180809,1,0
0,0,3,3,9,13,22,20,16,36,0.000333,0.053513,4,642.158153,35.675453,160.539538,76.635041,3,0
0,0,5,5,8,10,18,28,17,45,0.000333,0.062549,4,750.5865,41.69925,187.646625,57.219281,1,0
0,0,5,5,7,8,15,32,16,48,0.000333,0.06251,6,1125.184492,62.51025,187.530749,43.651484,1,0
0,0,5,5,8,10,18,28,17,45,0.000333,0.062549,4,750.5865,41.69925,187.646625,57.219281,1,0
0,0,7,7,11,19,30,44,28,72,0.000333,0.117765,5,1766.480614,98.137812,353.296123,118.764371,2,0
0,0,7,7,11,19,30,44,28,72,0.000333,0.117765,5,1766.480614,98.137812,353.296123,118.764371,2,0
0,0,5,5,8,12,20,25,19,44,0.000333,0.063388,4,760.659345,42.258852,190.164836,67.01955,1,0
0,0,9,9,15,19,34,68,35,103,0.000333,0.17467,7,3668.060709,203.78115,524.008673,139.313982,2,0
0,0,4,4,4,7,11,13,11,24,0.000333,0.027675,2,166.052718,9.225151,83.026359,27.651484,3,0
0,0,23,23,13,34,47,157,98,255,0.000333,0.47214,12,16997.04189,944.280105,1416.420157,221.079453,1,0
0,0,3,3,7,5,12,11,7,18,0.000333,0.02151,3,193.587975,10.754888,64.529325,31.261125,1,0
0,0,8,8,9,16,25,36,31,67,0.000333,0.103713,4,1244.553459,69.141859,311.138365,92.529325,1,0
0,0,7,7,8,15,23,21,25,46,0.000333,0.069361,4,832.3354,46.240856,208.08385,82.603359,1,0
0,0,3,3,7,8,15,23,12,35,0.000333,0.04558,3,410.223513,22.790195,136.741171,43.651484,1,0
0,0,5,5,12,16,28,39,25,64,0.000333,0.102557,6,1846.02429,102.556905,307.670715,107.01955,2,0
0,0,10,10,11,14,25,79,44,123,0.000333,0.190398,15,8567.91467,475.995259,571.194311,91.356717,1,0
0,0,5,5,8,10,18,28,17,45,0.000333,0.062549,4,750.5865,41.69925,187.646625,57.219281,1,0
0,0,4,4,10,8,18,25,15,40,0.000333,0.055599,5,833.985,46.3325,166.797,57.219281,1,0
0,0,5,5,10,10,20,26,15,41,0.000333,0.059066,5,885.995259,49.221959,177.199052,66.438562,1,0
0,0,4,4,4,7,11,13,11,24,0.000333,0.027675,2,166.052718,9.225151,83.026359,27.651484,3,0
0,0,4,4,7,8,15,16,12,28,0.000333,0.036464,3,328.17881,18.232156,109.392937,43.651484,3,0
0,0,3,3,7,8,15,23,12,35,0.000333,0.04558,3,410.223513,22.790195,136.741171,43.651484,1,0
0,0,8,8,16,17,33,49,35,84,0.000333,0.141243,16,6779.665696,376.648094,423.729106,133.486868,4,0
0,0,7,7,11,19,30,44,28,72,0.000333,0.117765,5,1766.480614,98.137812,353.296123,118.764371,2,0
0,0,3,3,8,7,15,11,9,20,0.000333,0.026046,4,312.551248,17.363958,78.137812,43.651484,1,0
0,0,4,4,10,15,25,32,21,53,0.000333,0.082041,5,1230.62189,68.367883,246.124378,91.82264,1,0
0,0,4,4,6,8,14,17,12,29,0.000333,0.036804,3,331.239878,18.402215,110.413293,39.509775,3,0
0,0,7,7,11,19,30,44,28,72,0.000333,0.117765,5,1766.480614,98.137812,353.296123,118.764371,2,0
0,0,6,6,8,14,22,31,23,54,0.000333,0.08027,4,963.23723,53.513179,240.809307,77.302969,1,0
0,0,9,9,9,17,26,28,39,67,0.000333,0.104976,8,2519.435689,139.968649,314.929461,98.016193,1,0
0,0,3,3,7,8,15,23,12,35,0.000333,0.04558,3,410.223513,22.790195,136.741171,43.651484,1,0
0,0,9,9,14,25,39,156,54,210,0.000333,0.369978,14,15539.08252,863.282362,1109.934466,169.399374,5,0
0,0,3,3,7,8,15,23,12,35,0.000333,0.04558,3,410.223513,22.790195,136.741171,43.651484,1,0
0,0,3,3,9,8,17,16,11,27,0.000333,0.036787,4,441.445987,24.524777,110.361497,52.529325,2,0
0,0,3,3,8,8,16,20,12,32,0.000333,0.042667,4,512,28.444444,128,48,1,0
0,0,4,4,11,9,20,35,15,50,0.000333,0.072032,5,1080.482024,60.026779,216.096405,66.583073,2,0
0,0,3,3,9,8,17,16,11,27,0.000333,0.036787,4,441.445987,24.524777,110.361497,52.529325,2,0
0,0,7,7,11,19,30,44,28,72,0.000333,0.117765,5,1766.480614,98.137812,353.296123,118.764371,2,0
0,0,3,3,8,7,15,11,9,20,0.000333,0.026046,4,312.551248,17.363958,78.137812,43.651484,1,0
0,0,3,3,8,6,14,11,9,20,0.000333,0.025382,4,304.588394,16.921577,76.147098,39.509775,1,0
0,0,6,6,9,14,23,23,24,47,0.000333,0.070869,4,850.429648,47.246092,212.607412,81.832294,1,0
0,0,4,4,10,15,25,32,21,53,0.000333,0.082041,5,1230.62189,68.367883,246.124378,91.82264,1,0
0,0,6,6,7,14,21,30,22,52,0.000333,0.076134,3,685.201518,38.066751,228.400506,72.954453,1,0
0,0,4,4,4,7,11,13,11,24,0.000333,0.027675,2,166.052718,9.225151,83.026359,27.651484,3,0
0,0,5,5,12,13,25,28,18,46,0.000333,0.071206,6,1281.704308,71.205795,213.617385,91.125266,3,0
0,0,6,6,14,12,26,43,26,69,0.000333,0.10811,14,4540.624768,252.256932,324.330341,96.322519,4,0
0,0,13,13,15,30,45,71,57,128,0.000333,0.234319,7,4920.700374,273.372243,702.957196,205.810077,2,0
0,0,3,3,7,5,12,11,7,18,0.000333,0.02151,3,193.587975,10.754888,64.529325,31.261125,1,0
0,0,8,8,15,18,33,66,34,100,0.000333,0.168146,7,3531.075884,196.170882,504.439412,133.662009,2,0
0,0,11,11,15,21,36,84,43,127,0.000333,0.21886,14,9192.126653,510.673703,656.580475,150.842025,2,0
0,0,3,3,8,8,16,20,12,32,0.000333,0.042667,4,512,28.444444,128,48,1,0
0,0,4,4,5,9,14,15,13,28,0.000333,0.035535,2,213.211876,11.845104,106.605938,40.138965,1,0
0,0,5,5,10,14,24,24,24,48,0.000333,0.073359,5,1100.391,61.132833,220.0782,86.52225,1,0
0,0,9,9,11,18,29,35,42,77,0.000333,0.124688,10,3740.645366,207.813631,374.064537,113.112398,1,0
0,0,8,8,13,12,25,39,25,64,0.000333,0.099069,12,3566.481554,198.137864,297.206796,91.125266,1,0
0,0,6,6,9,10,19,28,17,45,0.000333,0.063719,4,764.626952,42.479275,191.156738,61.748606,1,0
0,0,3,3,7,8,15,23,12,35,0.000333,0.04558,3,410.223513,22.790195,136.741171,43.651484,1,0
0,0,6,6,7,11,18,41,25,66,0.000333,0.091738,6,1651.290301,91.73835,275.21505,57.705232,1,0
0,0,3,3,7,8,15,23,12,35,0.000333,0.04558,3,410.223513,22.790195,136.741171,43.651484,1,0
0,0,4,4,10,15,25,32,21,53,0.000333,0.082041,5,1230.62189,68.367883,246.124378,91.82264,1,0
0,0,3,3,9,8,17,16,11,27,0.000333,0.036787,4,441.445987,24.524777,110.361497,52.529325,2,0
0,0,7,7,11,19,30,44,28,72,0.000333,0.117765,5,1766.480614,98.137812,353.296123,118.764371,2,0
0,0,18,18,11,28,39,115,64,179,0.000333,0.315362,10,9460.869972,525.603887,946.086997,172.659686,1,0
0,0,8,8,11,15,26,59,34,93,0.000333,0.145714,10,4371.408938,242.856052,437.140894,96.657107,1,0
0,0,8,8,15,18,33,66,34,100,0.000333,0.168146,7,3531.075884,196.170882,504.439412,133.662009,2,0
0,0,7,7,11,19,30,44,28,72,0.000333,0.117765,5,1766.480614,98.137812,353.296123,118.764371,2,0
0,0,11,11,15,21,36,84,43,127,0.000333,0.21886,14,9192.126653,510.673703,656.580475,150.842025,2,0
0,0,6,6,8,16,24,40,31,71,0.000333,0.108511,4,1302.12935,72.340519,325.532338,88,1,0
0,0,4,4,11,10,21,24,14,38,0.000333,0.055636,5,834.54031,46.363351,166.908062,71.273029,3,0
0,0,7,7,11,19,30,44,28,72,0.000333,0.117765,5,1766.480614,98.137812,353.296123,118.764371,2,0
0,0,7,7,11,18,29,48,28,76,0.000333,0.123069,5,1846.032778,102.557377,369.206556,113.112398,1,0
0,0,3,3,7,8,15,23,12,35,0.000333,0.04558,3,410.223513,22.790195,136.741171,43.651484,1,0
0,0,3,3,7,8,15,23,12,35,0.000333,0.04558,3,410.223513,22.790195,136.741171,43.651484,1,0
0,0,9,9,15,19,34,68,35,103,0.000333,0.17467,7,3668.060709,203.78115,524.008673,139.313982,2,0
0,0,3,3,8,8,16,20,12,32,0.000333,0.042667,4,512,28.444444,128,48,1,0
0,0,9,9,14,25,39,156,54,210,0.000333,0.369978,14,15539.08252,863.282362,1109.934466,169.399374,5,0
0,0,4,4,4,7,11,13,11,24,0.000333,0.027675,2,166.052718,9.225151,83.026359,27.651484,2,0
0,0,9,9,10,15,25,30,32,62,0.000333,0.095973,10,2879.190838,159.955047,287.919084,91.82264,1,0
0,0,7,7,11,19,30,44,28,72,0.000333,0.117765,5,1766.480614,98.137812,353.296123,118.764371,2,0
0,0,8,8,15,18,33,66,34,100,0.000333,0.168146,7,3531.075884,196.170882,504.439412,133.662009,2,0
0,0,9,9,9,13,22,30,34,64,0.000333,0.095135,8,2283.228989,126.846055,285.403624,76.635041,1,0
0,0,6,6,5,14,19,20,30,50,0.000333,0.070799,4,849.585503,47.199195,212.396376,64.912609,1,0
0,0,19,19,21,26,47,149,82,231,0.000333,0.427703,30,38493.30074,2138.516708,1283.110025,214.450099,11,0
0,0,4,4,4,7,11,13,11,24,0.000333,0.027675,2,166.052718,9.225151,83.026359,27.651484,3,0
0,0,3,3,8,7,15,15,9,24,0.000333,0.031255,4,375.061497,20.83675,93.765374,43.651484,3,0
0,0,4,4,4,7,11,13,11,24,0.000333,0.027675,2,166.052718,9.225151,83.026359,27.651484,3,0
0,0,4,4,10,9,19,22,13,35,0.000333,0.049559,5,743.387315,41.299295,148.677463,61.748606,1,0
0,0,4,4,6,8,14,17,12,29,0.000333,0.036804,3,331.239878,18.402215,110.413293,39.509775,3,0
0,0,9,9,15,19,34,68,35,103,0.000333,0.17467,7,3668.060709,203.78115,524.008673,139.313982,2,0
0,0,11,11,15,21,36,84,43,127,0.000333,0.21886,14,9192.126653,510.673703,656.580475,150.842025,2,0
0,0,8,8,15,18,33,66,34,100,0.000333,0.168146,7,3531.075884,196.170882,504.439412,133.662009,2,0
0,0,11,11,11,14,25,42,34,76,0.000333,0.117644,10,3529.330704,196.073928,352.93307,91.356717,1,0
0,0,3,3,8,7,15,20,12,32,0.000333,0.041673,4,500.081996,27.782333,125.020499,43.651484,1,0
0,0,5,5,10,11,21,29,17,46,0.000333,0.067349,5,1010.233007,56.124056,202.046601,71.273029,1,0
0,0,7,7,11,19,30,44,28,72,0.000333,0.117765,5,1766.480614,98.137812,353.296123,118.764371,2,0
0,0,4,4,10,15,25,32,21,53,0.000333,0.082041,5,1230.62189,68.367883,246.124378,91.82264,1,0
0,0,3,3,7,5,12,11,7,18,0.000333,0.02151,3,193.587975,10.754888,64.529325,31.261125,1,0
0,0,9,9,15,19,34,68,35,103,0.000333,0.17467,7,3668.060709,203.78115,524.008673,139.313982,2,0
0,0,9,9,15,19,34,68,35,103,0.000333,0.17467,7,3668.060709,203.78115,524.008673,139.313982,2,0
0,0,11,11,15,21,36,84,43,127,0.000333,0.21886,14,9192.126653,510.673703,656.580475,150.842025,2,0
0,0,5,5,7,13,20,16,17,33,0.000333,0.047541,3,427.870881,23.770605,142.623627,67.757201,1,0
0,0,7,7,8,13,21,30,35,65,0.000333,0.095167,8,2284.00506,126.88917,285.500632,72.105716,1,0
0,0,4,4,9,8,17,20,12,32,0.000333,0.0436,4,523.195244,29.066402,130.798811,52.529325,1,0
0,0,3,3,6,9,15,26,11,37,0.000333,0.048185,3,433.664856,24.092492,144.554952,44.0391,1,0
0,0,5,5,8,11,19,36,19,55,0.000333,0.077879,4,934.544053,51.919114,233.636013,62.053748,1,0
0,0,5,5,12,16,28,39,25,64,0.000333,0.102557,6,1846.02429,102.556905,307.670715,107.01955,2,0
0,0,4,4,4,7,11,13,11,24,0.000333,0.027675,2,166.052718,9.225151,83.026359,27.651484,3,0
0,0,11,11,15,21,36,84,43,127,0.000333,0.21886,14,9192.126653,510.673703,656.580475,150.842025,2,0
0,0,8,8,15,18,33,66,34,100,0.000333,0.168146,7,3531.075884,196.170882,504.439412,133.662009,2,0
0,0,8,8,15,18,33,66,34,100,0.000333,0.168146,7,3531.075884,196.170882,504.439412,133.662009,2,0
0,0,9,9,15,19,34,68,35,103,0.000333,0.17467,7,3668.060709,203.78115,524.008673,139.313982,2,0
0,0,11,11,15,21,36,84,43,127,0.000333,0.21886,14,9192.126653,510.673703,656.580475,150.842025,2,0
0,0,11,11,12,16,28,53,44,97,0.000333,0.155438,12,5595.761129,310.875618,466.313427,107.01955,1,0
0,0,8,8,9,18,27,55,38,93,0.000333,0.147402,8,3537.636302,196.53535,442.204538,103.587975,1,0
0,0,10,10,14,16,30,51,35,86,0.000333,0.140664,14,5907.896277,328.21646,421.992591,117.302969,2,0
0,0,10,10,7,14,21,57,36,93,0.000333,0.136162,6,2450.913122,136.16184,408.48552,72.954453,1,0
0,0,5,5,8,10,18,28,17,45,0.000333,0.062549,4,750.5865,41.69925,187.646625,57.219281,1,0
0,0,4,4,11,9,20,18,15,33,0.000333,0.047541,5,713.118136,39.617674,142.623627,66.583073,1,0
0,0,4,4,4,7,11,13,11,24,0.000333,0.027675,2,166.052718,9.225151,83.026359,27.651484,3,0
0,0,11,11,13,18,31,72,51,123,0.000333,0.203122,12,7312.393754,406.244097,609.366146,123.164366,1,0
0,0,5,5,8,9,17,25,15,40,0.000333,0.0545,4,653.994055,36.333003,163.498514,52.529325,1,0
0,0,3,3,7,8,15,23,12,35,0.000333,0.04558,3,410.223513,22.790195,136.741171,43.651484,1,0
0,0,4,4,9,7,16,16,11,27,0.000333,0.036,4,432,24,108,48.180809,1,0
0,0,4,4,5,11,16,13,14,27,0.000333,0.036,2,216,12,108,49.663388,1,0
0,0,4,4,9,8,17,21,14,35,0.000333,0.047687,4,572.244798,31.791378,143.061199,52.529325,1,0
0,0,7,7,8,12,20,29,20,49,0.000333,0.070591,4,847.097907,47.060995,211.774477,67.01955,1,0
0,0,4,4,7,11,18,24,17,41,0.000333,0.056989,3,512.900775,28.494488,170.966925,57.705232,1,0
0,0,3,3,7,5,12,11,7,18,0.000333,0.02151,3,193.587975,10.754888,64.529325,31.261125,1,0
0,0,13,13,11,22,33,99,50,149,0.000333,0.250538,10,7516.147238,417.563735,751.614724,136.161243,1,0
0,0,3,3,7,8,15,23,12,35,0.000333,0.04558,3,410.223513,22.790195,136.741171,43.651484,1,0
0,0,11,11,15,21,36,84,43,127,0.000333,0.21886,14,9192.126653,510.673703,656.580475,150.842025,2,0
0,0,8,8,15,18,33,66,34,100,0.000333,0.168146,7,3531.075884,196.170882,504.439412,133.662009,2,0
0,0,5,5,8,10,18,28,17,45,0.000333,0.062549,4,750.5865,41.69925,187.646625,57.219281,1,0
0,0,4,4,4,7,11,13,11,24,0.000333,0.027675,2,166.052718,9.225151,83.026359,27.651484,3,0
0,0,4,4,4,7,11,13,11,24,0.000333,0.027675,2,166.052718,9.225151,83.026359,27.651484,3,0
0,0,8,8,15,18,33,66,34,100,0.000333,0.168146,7,3531.075884,196.170882,504.439412,133.662009,2,0
0,0,3,3,9,6,15,19,10,29,0.000333,0.037767,4,453.199309,25.177739,113.299827,44.0391,1,0
0,0,4,4,6,9,15,16,12,28,0.000333,0.036464,3,328.17881,18.232156,109.392937,44.0391,1,0
0,0,8,8,13,14,27,39,29,68,0.000333,0.107777,12,3879.988202,215.5549,323.33235,101.408685,1,0
0,0,3,3,7,8,15,23,12,35,0.000333,0.04558,3,410.223513,22.790195,136.741171,43.651484,1,0
0,0,4,4,8,7,15,16,12,28,0.000333,0.036464,4,437.571747,24.309541,109.392937,43.651484,1,0
0,0,10,10,14,18,32,51,39,90,0.000333,0.15,14,6300,350,450,128.361619,2,0
0,0,3,3,7,5,12,11,7,18,0.000333,0.02151,3,193.587975,10.754888,64.529325,31.261125,1,0
0,0,4,4,5,10,15,13,13,26,0.000333,0.03386,2,203.158311,11.286573,101.579155,44.828921,1,0
0,0,4,4,10,9,19,22,13,35,0.000333,0.049559,5,743.387315,41.299295,148.677463,61.748606,1,0
0,0,4,4,4,7,11,13,11,24,0.000333,0.027675,2,166.052718,9.225151,83.026359,27.651484,3,0
0,0,4,4,6,8,14,17,12,29,0.000333,0.036804,3,331.239878,18.402215,110.413293,39.509775,3,0
0,0,4,4,10,15,25,32,21,53,0.000333,0.082041,5,1230.62189,68.367883,246.124378,91.82264,1,0
0,0,10,10,7,14,21,57,36,93,0.000333,0.136162,6,2450.913122,136.16184,408.48552,72.954453,1,0
0,0,8,8,15,18,33,66,34,100,0.000333,0.168146,7,3531.075884,196.170882,504.439412,133.662009,2,0
0,0,11,11,15,21,36,84,43,127,0.000333,0.21886,14,9192.126653,510.673703,656.580475,150.842025,2,0
0,0,3,3,7,8,15,23,12,35,0.000333,0.04558,3,410.223513,22.790195,136.741171,43.651484,1,0
0,0,4,4,8,8,16,29,16,45,0.000333,0.06,8,1440,80,180,48,1,0
0,0,3,3,11,11,22,26,15,41,0.000333,0.060946,5,914.183482,50.787971,182.836696,76.107496,3,0
0,0,6,6,9,10,19,28,17,45,0.000333,0.063719,4,764.626952,42.479275,191.156738,61.748606,1,0
0,0,5,5,10,7,17,20,16,36,0.000333,0.04905,10,1471.486623,81.749257,147.148662,52.870765,1,0
0,0,14,14,9,17,26,76,65,141,0.000333,0.220921,12,7953.144003,441.841334,662.762,98.016193,1,0
0,0,3,3,9,8,17,16,11,27,0.000333,0.036787,4,441.445987,24.524777,110.361497,52.529325,2,0
0,0,3,3,7,8,15,23,12,35,0.000333,0.04558,3,410.223513,22.790195,136.741171,43.651484,1,0
0,0,7,7,10,16,26,28,31,59,0.000333,0.092442,5,1386.629717,77.034984,277.325943,97.219281,1,0
0,0,8,8,15,18,33,66,34,100,0.000333,0.168146,7,3531.075884,196.170882,504.439412,133.662009,2,0
0,0,9,9,15,19,34,68,35,103,0.000333,0.17467,7,3668.060709,203.78115,524.008673,139.313982,2,0
0,0,5,5,7,10,17,19,16,35,0.000333,0.047687,3,429.183598,23.843533,143.061199,52.870765,3,0
0,0,6,6,10,11,21,24,21,45,0.000333,0.065885,5,988.27142,54.903968,197.654284,71.273029,1,0
0,0,4,4,4,7,11,13,11,24,0.000333,0.027675,2,166.052718,9.225151,83.026359,27.651484,2,0
0,0,6,6,9,13,22,21,22,43,0.000333,0.063919,4,767.022238,42.612347,191.75556,76.635041,1,0
0,0,3,3,8,7,15,11,9,20,0.000333,0.026046,4,312.551248,17.363958,78.137812,43.651484,1,0
0,0,3,3,8,6,14,11,9,20,0.000333,0.025382,4,304.588394,16.921577,76.147098,39.509775,1,0
0,0,3,3,7,8,15,23,12,35,0.000333,0.04558,3,410.223513,22.790195,136.741171,43.651484,1,0
0,0,9,9,15,19,34,68,35,103,0.000333,0.17467,7,3668.060709,203.78115,524.008673,139.313982,2,0
0,0,11,11,15,21,36,84,43,127,0.000333,0.21886,14,9192.126653,510.673703,656.580475,150.842025,2,0
0,0,8,8,15,18,33,66,34,100,0.000333,0.168146,7,3531.075884,196.170882,504.439412,133.662009,2,0
0,0,5,5,8,8,16,19,12,31,0.000333,0.041333,4,496,27.555556,124,48,1,0
0,0,8,8,15,18,33,66,34,100,0.000333,0.168146,7,3531.075884,196.170882,504.439412,133.662009,2,0
0,0,13,13,13,22,35,97,52,149,0.000333,0.254754,12,9171.158034,509.50878,764.26317,146.213212,2,0
0,0,3,3,8,7,15,20,12,32,0.000333,0.041673,4,500.081996,27.782333,125.020499,43.651484,1,0
0,0,5,5,7,8,15,17,12,29,0.000333,0.037767,3,339.899482,18.883305,113.299827,43.651484,1,0
0,0,3,3,8,7,15,20,12,32,0.000333,0.041673,4,500.081996,27.782333,125.020499,43.651484,1,0
0,0,4,4,4,7,11,13,11,24,0.000333,0.027675,2,166.052718,9.225151,83.026359,27.651484,2,0
0,0,6,6,10,11,21,24,21,45,0.000333,0.065885,5,988.27142,54.903968,197.654284,71.273029,1,0
0,0,6,6,8,14,22,21,24,45,0.000333,0.066891,4,802.697691,44.594316,200.674423,77.302969,1,0
0,0,4,4,7,9,16,46,28,74,0.000333,0.098667,9,2664,148,296,48.180809,1,0
0,0,8,8,12,17,29,52,34,86,0.000333,0.139262,12,5013.436387,278.524244,417.786366,112.506418,1,0
0,0,3,3,8,6,14,11,9,20,0.000333,0.025382,4,304.588394,16.921577,76.147098,39.509775,1,0
0,0,3,3,7,5,12,11,7,18,0.000333,0.02151,3,193.587975,10.754888,64.529325,31.261125,1,0
0,0,5,5,7,13,20,21,18,39,0.000333,0.056185,3,505.665587,28.092533,168.555196,67.757201,1,0
0,0,5,5,8,8,16,19,12,31,0.000333,0.041333,4,496,27.555556,124,48,1,0
0,0,5,5,11,13,24,28,20,48,0.000333,0.073359,5,1100.391,61.132833,220.0782,86.159464,1,0
0,0,15,15,12,20,32,94,48,142,0.000333,0.236667,12,8520,473.333333,710,129.458112,2,0
0,0,11,11,12,18,30,69,40,109,0.000333,0.178284,12,6418.212899,356.567383,534.851075,118.0782,2,0
0,0,5,5,7,7,14,16,11,27,0.000333,0.034266,3,308.395749,17.133097,102.798583,39.302969,1,0
0,0,12,12,16,21,37,67,39,106,0.000333,0.184067,8,4417.616454,245.423136,552.202057,156.238666,4,0
0,0,9,9,11,15,26,40,38,78,0.000333,0.122211,10,3666.34298,203.685721,366.634298,96.657107,1,0
0,0,4,4,9,7,16,16,11,27,0.000333,0.036,4,432,24,108,48.180809,1,0
0,0,11,11,13,18,31,76,34,110,0.000333,0.181654,6,3269.769565,181.653865,544.961594,123.164366,8,0
0,0,25,25,12,35,47,382,213,595,0.000333,1.10166,36,118979.2932,6609.960733,3304.980367,222.544456,4,0
0,0,5,5,11,12,23,33,21,54,0.000333,0.081424,5,1221.361728,67.853429,244.272346,81.073298,1,0
0,0,15,15,12,22,34,99,56,155,0.000333,0.262852,12,9462.680885,525.704494,788.55674,141.127046,2,0
0,0,9,9,15,20,35,72,36,108,0.000333,0.184654,7,3877.737961,215.429887,553.962566,145.041921,2,0
0,0,4,4,6,8,14,17,12,29,0.000333,0.036804,3,331.239878,18.402215,110.413293,39.509775,3,0
0,0,4,4,4,7,11,13,11,24,0.000333,0.027675,2,166.052718,9.225151,83.026359,27.651484,3,0
0,0,3,3,7,8,15,23,12,35,0.000333,0.04558,3,410.223513,22.790195,136.741171,43.651484,1,0
0,0,4,4,12,12,24,42,17,59,0.000333,0.090171,6,1623.076725,90.170929,270.512788,86.0391,5,0
0,0,6,6,7,11,18,41,25,66,0.000333,0.091738,6,1651.290301,91.73835,275.21505,57.705232,1,0
0,0,5,5,12,16,28,39,25,64,0.000333,0.102557,6,1846.02429,102.556905,307.670715,107.01955,2,0
0,0,6,6,9,10,19,28,17,45,0.000333,0.063719,4,764.626952,42.479275,191.156738,61.748606,1,0
0,0,12,12,17,29,46,64,49,113,0.000333,0.208054,8,4993.300008,277.405556,624.162501,210.368317,4,0
0,0,7,7,17,14,31,46,29,75,0.000333,0.123855,16,5945.035572,330.279754,371.564723,122.789837,4,0
0,0,5,5,8,10,18,26,15,41,0.000333,0.056989,4,683.8677,37.99265,170.966925,57.219281,1,0
0,0,6,6,5,13,18,19,29,48,0.000333,0.066719,4,800.6256,44.4792,200.1564,59.715357,1,0
0,0,5,5,10,10,20,26,15,41,0.000333,0.059066,5,885.995259,49.221959,177.199052,66.438562,1,0
0,0,4,4,4,7,11,13,11,24,0.000333,0.027675,2,166.052718,9.225151,83.026359,27.651484,3,0
0,0,5,5,11,13,24,27,19,46,0.000333,0.070303,5,1054.541375,58.585632,210.908275,86.159464,1,0
0,0,8,8,15,18,33,66,34,100,0.000333,0.168146,7,3531.075884,196.170882,504.439412,133.662009,2,0
0,0,6,6,8,12,20,29,21,50,0.000333,0.072032,4,864.385619,48.021423,216.096405,67.01955,1,0
0,0,3,3,9,8,17,16,11,27,0.000333,0.036787,4,441.445987,24.524777,110.361497,52.529325,2,0
0,0,9,9,15,20,35,72,36,108,0.000333,0.184654,7,3877.737961,215.429887,553.962566,145.041921,2,0
0,0,9,9,15,19,34,68,35,103,0.000333,0.17467,7,3668.060709,203.78115,524.008673,139.313982,2,0
0,0,7,7,11,19,30,44,28,72,0.000333,0.117765,5,1766.480614,98.137812,353.296123,118.764371,2,0
0,0,8,8,15,18,33,66,34,100,0.000333,0.168146,7,3531.075884,196.170882,504.439412,133.662009,2,0
0,0,11,11,15,21,36,84,43,127,0.000333,0.21886,14,9192.126653,510.673703,656.580475,150.842025,2,0
0,0,8,8,10,14,24,32,26,58,0.000333,0.088643,5,1329.639125,73.86884,265.927825,86.52225,1,0
0,0,3,3,7,8,15,23,12,35,0.000333,0.04558,3,410.223513,22.790195,136.741171,43.651484,1,0
0,0,7,7,9,16,25,24,30,54,0.000333,0.083589,4,1003.072937,55.726274,250.768234,92.529325,1,0
0,0,3,3,8,6,14,11,9,20,0.000333,0.025382,4,304.588394,16.921577,76.147098,39.509775,1,0
0,0,5,5,6,11,17,18,16,34,0.000333,0.046325,3,416.92121,23.162289,138.973737,53.563523,1,0
0,0,3,3,8,6,14,11,9,20,0.000333,0.025382,4,304.588394,16.921577,76.147098,39.509775,1,0
0,0,7,7,12,17,29,47,29,76,0.000333,0.123069,6,2215.239334,123.068852,369.206556,112.506418,1,0
0,0,5,5,8,10,18,28,17,45,0.000333,0.062549,4,750.5865,41.69925,187.646625,57.219281,1,0
0,0,4,4,4,7,11,13,11,24,0.000333,0.027675,2,166.052718,9.225151,83.026359,27.651484,2,0
0,0,3,3,8,7,15,15,9,24,0.000333,0.031255,4,375.061497,20.83675,93.765374,43.651484,3,0
0,0,7,7,14,17,31,42,35,77,0.000333,0.127158,14,5340.623623,296.701312,381.473116,122.789837,4,0
0,0,4,4,4,7,11,13,11,24,0.000333,0.027675,2,166.052718,9.225151,83.026359,27.651484,3,0
0,0,5,5,8,10,18,28,17,45,0.000333,0.062549,4,750.5865,41.69925,187.646625,57.219281,1,0
0,0,5,5,10,10,20,26,15,41,0.000333,0.059066,5,885.995259,49.221959,177.199052,66.438562,1,0
0,0,5,5,7,8,15,17,12,29,0.000333,0.037767,3,339.899482,18.883305,113.299827,43.651484,1,0
0,0,5,5,8,10,18,28,17,45,0.000333,0.062549,4,750.5865,41.69925,187.646625,57.219281,1,0
0,0,7,7,11,19,30,44,28,72,0.000333,0.117765,5,1766.480614,98.137812,353.296123,118.764371,2,0
0,0,3,3,10,8,18,19,11,30,0.000333,0.041699,5,625.48875,34.749375,125.09775,57.219281,1,0
0,0,18,18,15,24,39,99,62,161,0.000333,0.28365,14,11913.2966,661.849811,850.949757,168.642459,2,0
0,0,3,3,8,7,15,11,9,20,0.000333,0.026046,4,312.551248,17.363958,78.137812,43.651484,1,0
0,0,9,9,15,19,34,68,35,103,0.000333,0.17467,7,3668.060709,203.78115,524.008673,139.313982,2,0
0,0,3,3,8,8,16,20,12,32,0.000333,0.042667,4,512,28.444444,128,48,1,0
0,0,9,9,8,14,22,38,32,70,0.000333,0.104053,8,2497.281706,138.737873,312.160213,77.302969,1,0
0,0,11,11,12,18,30,69,40,109,0.000333,0.178284,12,6418.212899,356.567383,534.851075,118.0782,2,0
0,0,5,5,11,12,23,33,21,54,0.000333,0.081424,5,1221.361728,67.853429,244.272346,81.073298,1,0
0,0,4,4,7,7,14,15,10,25,0.000333,0.031728,3,285.551619,15.863979,95.183873,39.302969,1,0
0,0,21,21,13,29,42,137,83,220,0.000333,0.395437,12,14235.718,790.873222,1186.309833,188.987165,7,0
0,0,10,10,14,18,32,51,39,90,0.000333,0.15,14,6300,350,450,128.361619,2,0
0,0,7,7,11,19,30,44,28,72,0.000333,0.117765,5,1766.480614,98.137812,353.296123,118.764371,2,0
0,0,4,4,4,7,11,13,11,24,0.000333,0.027675,2,166.052718,9.225151,83.026359,27.651484,3,0
0,0,3,3,8,7,15,11,9,20,0.000333,0.026046,4,312.551248,17.363958,78.137812,43.651484,1,0
0,0,5,5,11,12,23,33,21,54,0.000333,0.081424,5,1221.361728,67.853429,244.272346,81.073298,1,0
0,0,25,25,12,35,47,382,213,595,0.000333,1.10166,36,118979.2932,6609.960733,3304.980367,222.544456,4,0
0,0,6,6,7,11,18,41,25,66,0.000333,0.091738,6,1651.290301,91.73835,275.21505,57.705232,1,0
0,0,4,4,7,11,18,24,17,41,0.000333,0.056989,3,512.900775,28.494488,170.966925,57.705232,1,0
0,0,7,7,8,17,25,44,42,86,0.000333,0.133124,8,3194.973059,177.498503,399.371632,93.486868,1,0
0,0,5,5,8,10,18,28,17,45,0.000333,0.062549,4,750.5865,41.69925,187.646625,57.219281,1,0
0,0,5,5,9,8,17,29,19,48,0.000333,0.065399,8,1569.585731,87.199207,196.198216,52.529325,1,0
0,0,10,10,7,14,21,57,36,93,0.000333,0.136162,6,2450.913122,136.16184,408.48552,72.954453,1,0
0,0,3,3,7,8,15,23,12,35,0.000333,0.04558,3,410.223513,22.790195,136.741171,43.651484,1,0
0,0,5,5,7,7,14,16,11,27,0.000333,0.034266,3,308.395749,17.133097,102.798583,39.302969,1,0
0,0,3,3,8,7,15,11,9,20,0.000333,0.026046,4,312.551248,17.363958,78.137812,43.651484,1,0
0,0,3,3,8,6,14,11,9,20,0.000333,0.025382,4,304.588394,16.921577,76.147098,39.509775,1,0
0,0,4,4,9,9,18,26,18,44,0.000333,0.061159,8,1467.813601,81.5452,183.4767,57.05865,1,0
0,0,5,5,8,8,16,19,12,31,0.000333,0.041333,4,496,27.555556,124,48,1,0
0,0,6,6,5,12,17,19,26,45,0.000333,0.061312,4,735.743311,40.874628,183.935828,54.62919,1,0
0,0,5,5,8,12,20,39,23,62,0.000333,0.08932,4,1071.838168,59.546565,267.959542,67.01955,1,0
0,0,7,7,8,13,21,54,31,85,0.000333,0.124449,8,2986.775847,165.931992,373.346981,72.105716,1,0
0,0,25,25,12,35,47,382,213,595,0.000333,1.10166,36,118979.2932,6609.960733,3304.980367,222.544456,4,0
0,0,9,9,8,14,22,38,32,70,0.000333,0.104053,8,2497.281706,138.737873,312.160213,77.302969,1,0
0,0,8,8,15,18,33,66,34,100,0.000333,0.168146,7,3531.075884,196.170882,504.439412,133.662009,2,0
0,0,7,7,11,19,30,44,28,72,0.000333,0.117765,5,1766.480614,98.137812,353.296123,118.764371,2,0
0,0,9,9,15,19,34,68,35,103,0.000333,0.17467,7,3668.060709,203.78115,524.008673,139.313982,2,0
0,0,11,11,15,21,36,84,43,127,0.000333,0.21886,14,9192.126653,510.673703,656.580475,150.842025,2,0
0,0,11,11,15,21,36,84,43,127,0.000333,0.21886,14,9192.126653,510.673703,656.580475,150.842025,2,0
0,0,7,7,8,15,23,21,28,49,0.000333,0.073885,4,886.618143,49.256564,221.654536,82.603359,1,0
0,0,11,11,15,21,36,84,43,127,0.000333,0.21886,14,9192.126653,510.673703,656.580475,150.842025,2,0
0,0,8,8,15,18,33,66,34,100,0.000333,0.168146,7,3531.075884,196.170882,504.439412,133.662009,2,0
0,0,5,5,8,8,16,25,13,38,0.000333,0.050667,4,608,33.777778,152,48,3,0
0,0,4,4,4,7,11,13,11,24,0.000333,0.027675,2,166.052718,9.225151,83.026359,27.651484,3,0
0,0,7,7,11,19,30,44,28,72,0.000333,0.117765,5,1766.480614,98.137812,353.296123,118.764371,2,0
0,0,4,4,4,7,11,13,11,24,0.000333,0.027675,2,166.052718,9.225151,83.026359,27.651484,3,0
0,0,5,5,8,11,19,36,19,55,0.000333,0.077879,4,934.544053,51.919114,233.636013,62.053748,1,0
0,0,4,4,10,15,25,32,21,53,0.000333,0.082041,5,1230.62189,68.367883,246.124378,91.82264,1,0
0,0,8,8,15,18,33,66,34,100,0.000333,0.168146,7,3531.075884,196.170882,504.439412,133.662009,2,0
0,0,3,3,10,8,18,16,13,29,0.000333,0.040309,5,604.639125,33.591063,120.927825,57.219281,3,0
0,0,3,3,7,5,12,11,7,18,0.000333,0.02151,3,193.587975,10.754888,64.529325,31.261125,1,0
0,0,3,3,7,8,15,23,12,35,0.000333,0.04558,3,410.223513,22.790195,136.741171,43.651484,1,0
0,0,4,4,9,9,18,28,15,43,0.000333,0.059769,4,717.2271,39.84595,179.306775,57.05865,1,0
0,0,5,5,8,10,18,28,17,45,0.000333,0.062549,4,750.5865,41.69925,187.646625,57.219281,1,0
0,0,5,5,8,10,18,26,15,41,0.000333,0.056989,4,683.8677,37.99265,170.966925,57.219281,1,0
0,0,4,4,9,13,22,22,17,39,0.000333,0.057973,4,695.671333,38.648407,173.917833,76.635041,3,0
0,0,4,4,4,7,11,13,11,24,0.000333,0.027675,2,166.052718,9.225151,83.026359,27.651484,3,0
0,0,7,7,11,18,29,48,28,76,0.000333,0.123069,5,1846.032778,102.557377,369.206556,113.112398,1,0
0,0,16,16,12,22,34,61,37,98,0.000333,0.16619,6,2991.428151,166.190453,498.571358,141.127046,5,0
0,0,6,6,10,10,20,24,19,43,0.000333,0.061948,5,929.21454,51.62303,185.842908,66.438562,1,0
0,0,4,4,4,7,11,13,11,24,0.000333,0.027675,2,166.052718,9.225151,83.026359,27.651484,2,0
0,0,3,3,9,8,17,16,11,27,0.000333,0.036787,4,441.445987,24.524777,110.361497,52.529325,2,0
0,0,8,8,16,17,33,49,35,84,0.000333,0.141243,16,6779.665696,376.648094,423.729106,133.486868,4,0
0,0,9,9,10,16,26,28,35,63,0.000333,0.098709,10,2961.277022,164.51539,296.127702,97.219281,1,0
0,0,5,5,8,10,18,28,17,45,0.000333,0.062549,4,750.5865,41.69925,187.646625,57.219281,1,0
0,0,6,6,9,10,19,28,17,45,0.000333,0.063719,4,764.626952,42.479275,191.156738,61.748606,1,0
0,0,3,3,8,7,15,11,9,20,0.000333,0.026046,4,312.551248,17.363958,78.137812,43.651484,1,0
0,0,4,4,9,8,17,21,14,35,0.000333,0.047687,4,572.244798,31.791378,143.061199,52.529325,1,0
0,0,4,4,9,7,16,17,12,29,0.000333,0.038667,4,464,25.777778,116,48.180809,1,0
0,0,7,7,11,19,30,44,28,72,0.000333,0.117765,5,1766.480614,98.137812,353.296123,118.764371,2,0
0,0,4,4,5,10,15,13,13,26,0.000333,0.03386,2,203.158311,11.286573,101.579155,44.828921,1,0
0,0,5,5,10,14,24,27,22,49,0.000333,0.074888,5,1123.315813,62.406434,224.663163,86.52225,3,0
0,0,7,7,11,19,30,44,28,72,0.000333,0.117765,5,1766.480614,98.137812,353.296123,118.764371,2,0
0,0,25,25,12,35,47,382,213,595,0.000333,1.10166,36,118979.2932,6609.960733,3304.980367,222.544456,4,0
0,0,5,5,11,12,23,33,21,54,0.000333,0.081424,5,1221.361728,67.853429,244.272346,81.073298,1,0
0,0,4,4,10,15,25,32,21,53,0.000333,0.082041,5,1230.62189,68.367883,246.124378,91.82264,1,0
0,0,8,8,15,18,33,66,34,100,0.000333,0.168146,7,3531.075884,196.170882,504.439412,133.662009,2,0
0,0,11,11,15,21,36,84,43,127,0.000333,0.21886,14,9192.126653,510.673703,656.580475,150.842025,2,0
0,0,9,9,15,19,34,68,35,103,0.000333,0.17467,7,3668.060709,203.78115,524.008673,139.313982,2,0
0,0,5,5,7,14,21,16,21,37,0.000333,0.054172,3,487.547234,27.085957,162.515745,72.954453,1,0
0,0,7,7,10,12,22,39,19,58,0.000333,0.086216,5,1293.235169,71.846398,258.647034,76.238831,4,0
0,0,3,3,8,7,15,11,9,20,0.000333,0.026046,4,312.551248,17.363958,78.137812,43.651484,1,0
0,0,3,3,6,9,15,26,11,37,0.000333,0.048185,3,433.664856,24.092492,144.554952,44.0391,1,0
0,0,8,8,13,11,24,40,26,66,0.000333,0.100869,12,3631.290301,201.73835,302.607525,86.159464,1,0
0,0,5,5,8,13,21,20,18,38,0.000333,0.055636,4,667.632248,37.09068,166.908062,72.105716,1,0
0,0,9,9,15,19,34,68,35,103,0.000333,0.17467,7,3668.060709,203.78115,524.008673,139.313982,2,0
0,0,11,11,15,21,36,84,43,127,0.000333,0.21886,14,9192.126653,510.673703,656.580475,150.842025,2,0
0,0,8,8,15,18,33,66,34,100,0.000333,0.168146,7,3531.075884,196.170882,504.439412,133.662009,2,0
0,0,8,8,12,15,27,42,27,69,0.000333,0.109362,6,1968.523426,109.362413,328.087238,101.622909,2,0
0,0,4,4,6,13,19,18,18,36,0.000333,0.050975,3,458.776171,25.487565,152.92539,63.615491,1,0
0,0,11,11,15,21,36,84,43,127,0.000333,0.21886,14,9192.126653,510.673703,656.580475,150.842025,2,0
0,0,3,3,8,7,15,15,9,24,0.000333,0.031255,4,375.061497,20.83675,93.765374,43.651484,3,0
0,0,11,11,12,16,28,46,37,83,0.000333,0.133003,12,4788.125502,266.006972,399.010459,107.01955,1,0
0,0,8,8,15,18,33,66,34,100,0.000333,0.168146,7,3531.075884,196.170882,504.439412,133.662009,2,0
0,0,11,11,15,21,36,84,43,127,0.000333,0.21886,14,9192.126653,510.673703,656.580475,150.842025,2,0
0,0,8,8,11,17,28,43,34,77,0.000333,0.123389,10,3701.66329,205.647961,370.166329,107.540616,1,0
0,0,7,7,11,19,30,44,28,72,0.000333,0.117765,5,1766.480614,98.137812,353.296123,118.764371,2,0
0,0,5,5,8,10,18,28,17,45,0.000333,0.062549,4,750.5865,41.69925,187.646625,57.219281,1,0
0,0,8,8,15,18,33,66,34,100,0.000333,0.168146,7,3531.075884,196.170882,504.439412,133.662009,2,0
0,0,9,9,15,19,34,68,35,103,0.000333,0.17467,7,3668.060709,203.78115,524.008673,139.313982,2,0
0,0,4,4,5,9,14,20,14,34,0.000333,0.04315,2,258.900135,14.383341,129.450067,40.138965,1,0
0,0,6,6,14,11,25,40,23,63,0.000333,0.097521,14,4095.881159,227.548953,292.56294,91.356717,4,0
0,0,11,11,11,18,29,70,34,104,0.000333,0.16841,5,2526.150117,140.341673,505.230023,113.112398,5,0
0,0,6,6,16,19,35,37,26,63,0.000333,0.107715,8,2585.158641,143.619924,323.14483,144.710623,2,0
0,0,3,3,8,8,16,20,12,32,0.000333,0.042667,4,512,28.444444,128,48,1,0
0,0,6,6,8,16,24,40,31,71,0.000333,0.108511,4,1302.12935,72.340519,325.532338,88,1,0
0,0,3,3,8,7,15,11,9,20,0.000333,0.026046,4,312.551248,17.363958,78.137812,43.651484,1,0
0,0,22,22,13,30,43,124,72,196,0.000333,0.354516,12,12762.5747,709.031928,1063.547892,195.312434,1,0
0,0,4,4,4,7,11,13,11,24,0.000333,0.027675,2,166.052718,9.225151,83.026359,27.651484,3,0
0,0,3,3,8,7,15,15,9,24,0.000333,0.031255,4,375.061497,20.83675,93.765374,43.651484,3,0
0,0,5,5,9,9,18,29,17,46,0.000333,0.063939,4,767.2662,42.6259,191.81655,57.05865,1,0
0,0,10,10,15,20,35,80,41,121,0.000333,0.206881,14,8689.005431,482.722524,620.643245,145.041921,2,0
0,0,8,8,15,18,33,66,34,100,0.000333,0.168146,7,3531.075884,196.170882,504.439412,133.662009,2,0
0,0,14,14,11,23,34,85,48,133,0.000333,0.225544,10,6766.325579,375.906977,676.632558,142.095673,1,0
0,0,6,6,9,10,19,28,17,45,0.000333,0.063719,4,764.626952,42.479275,191.156738,61.748606,1,0
0,0,8,8,9,15,24,32,29,61,0.000333,0.093228,4,1118.73085,62.151714,279.682713,87.132684,1,0
0,0,9,9,15,19,34,68,35,103,0.000333,0.17467,7,3668.060709,203.78115,524.008673,139.313982,2,0
0,0,9,9,15,19,34,68,35,103,0.000333,0.17467,7,3668.060709,203.78115,524.008673,139.313982,2,0
0,0,11,11,15,21,36,84,43,127,0.000333,0.21886,14,9192.126653,510.673703,656.580475,150.842025,2,0
0,0,8,8,15,18,33,66,34,100,0.000333,0.168146,7,3531.075884,196.170882,504.439412,133.662009,2,0
0,0,3,3,7,8,15,23,12,35,0.000333,0.04558,3,410.223513,22.790195,136.741171,43.651484,1,0
0,0,8,8,15,18,33,66,34,100,0.000333,0.168146,7,3531.075884,196.170882,504.439412,133.662009,2,0
0,0,4,4,6,10,16,26,15,41,0.000333,0.054667,3,492,27.333333,164,48.729056,1,0
0,0,5,5,12,9,21,33,19,52,0.000333,0.076134,12,2740.806072,152.267004,228.400506,71.548875,2,0
0,0,5,5,10,10,20,27,14,41,0.000333,0.059066,5,885.995259,49.221959,177.199052,66.438562,3,0
0,0,7,7,11,19,30,44,28,72,0.000333,0.117765,5,1766.480614,98.137812,353.296123,118.764371,2,0
0,0,4,4,6,9,15,16,12,28,0.000333,0.036464,3,328.17881,18.232156,109.392937,44.0391,1,0
0,0,8,8,11,15,26,59,34,93,0.000333,0.145714,10,4371.408938,242.856052,437.140894,96.657107,1,0
0,0,9,9,15,19,34,68,35,103,0.000333,0.17467,7,3668.060709,203.78115,524.008673,139.313982,2,0
0,0,4,4,10,15,25,32,21,53,0.000333,0.082041,5,1230.62189,68.367883,246.124378,91.82264,1,0
0,0,3,3,8,7,15,11,9,20,0.000333,0.026046,4,312.551248,17.363958,78.137812,43.651484,1,0
0,0,9,9,15,20,35,72,36,108,0.000333,0.184654,7,3877.737961,215.429887,553.962566,145.041921,2,0
0,0,3,3,6,9,15,26,11,37,0.000333,0.048185,3,433.664856,24.092492,144.554952,44.0391,1,0
0,0,9,9,15,19,34,68,35,103,0.000333,0.17467,7,3668.060709,203.78115,524.008673,139.313982,2,0
0,0,3,3,7,8,15,23,12,35,0.000333,0.04558,3,410.223513,22.790195,136.741171,43.651484,1,0
0,0,3,3,7,5,12,11,7,18,0.000333,0.02151,3,193.587975,10.754888,64.529325,31.261125,1,0
0,0,3,3,9,8,17,16,11,27,0.000333,0.036787,4,441.445987,24.524777,110.361497,52.529325,2,0
0,0,3,3,8,7,15,20,12,32,0.000333,0.041673,4,500.081996,27.782333,125.020499,43.651484,1,0
0,0,6,6,8,17,25,33,28,61,0.000333,0.094425,4,1133.10091,62.950051,283.275228,93.486868,1,0
0,0,4,4,10,9,19,19,18,37,0.000333,0.052391,10,1571.73318,87.31851,157.173318,61.748606,1,0
0,0,4,4,4,7,11,13,11,24,0.000333,0.027675,2,166.052718,9.225151,83.026359,27.651484,3,0
0,0,3,3,11,11,22,26,15,41,0.000333,0.060946,5,914.183482,50.787971,182.836696,76.107496,3,0
0,0,5,5,8,11,19,36,19,55,0.000333,0.077879,4,934.544053,51.919114,233.636013,62.053748,1,0
0,0,5,5,8,8,16,22,15,37,0.000333,0.049333,4,592,32.888889,148,48,1,0
0,0,4,4,4,7,11,13,11,24,0.000333,0.027675,2,166.052718,9.225151,83.026359,27.651484,3,0
0,0,6,6,14,11,25,40,23,63,0.000333,0.097521,14,4095.881159,227.548953,292.56294,91.356717,4,0
0,0,6,6,14,11,25,40,23,63,0.000333,0.097521,14,4095.881159,227.548953,292.56294,91.356717,4,0
0,0,5,5,8,8,16,25,13,38,0.000333,0.050667,4,608,33.777778,152,48,3,0
0,0,4,4,4,7,11,13,11,24,0.000333,0.027675,2,166.052718,9.225151,83.026359,27.651484,3,0
0,0,12,12,12,18,30,60,49,109,0.000333,0.178284,12,6418.212899,356.567383,534.851075,118.0782,1,0
0,0,4,4,4,7,11,13,11,24,0.000333,0.027675,2,166.052718,9.225151,83.026359,27.651484,2,0
0,0,4,4,11,10,21,29,18,47,0.000333,0.068813,5,1032.194594,57.344144,206.438919,71.273029,1,0
0,0,4,4,12,12,24,42,17,59,0.000333,0.090171,6,1623.076725,90.170929,270.512788,86.0391,5,0
0,0,3,3,8,7,15,15,9,24,0.000333,0.031255,4,375.061497,20.83675,93.765374,43.651484,3,0
0,0,4,4,6,8,14,17,12,29,0.000333,0.036804,3,331.239878,18.402215,110.413293,39.509775,3,0
0,0,24,24,12,29,41,160,94,254,0.000333,0.453606,18,24494.72777,1360.818209,1360.818209,183.900999,3,0
0,0,4,4,8,10,18,34,17,51,0.000333,0.070889,4,850.6647,47.25915,212.666175,57.219281,1,0
0,0,10,10,15,20,35,80,41,121,0.000333,0.206881,14,8689.005431,482.722524,620.643245,145.041921,2,0
0,0,9,9,15,19,34,68,35,103,0.000333,0.17467,7,3668.060709,203.78115,524.008673,139.313982,2,0
0,0,8,8,15,18,33,66,34,100,0.000333,0.168146,7,3531.075884,196.170882,504.439412,133.662009,2,0
0,0,11,11,13,21,34,92,48,140,0.000333,0.237415,12,8546.937573,474.829865,712.244798,140.344382,9,0
0,0,3,3,8,7,15,11,9,20,0.000333,0.026046,4,312.551248,17.363958,78.137812,43.651484,1,0
0,0,8,8,14,17,31,48,34,82,0.000333,0.135415,14,5687.417364,315.967631,406.244097,122.789837,4,0
0,0,3,3,7,8,15,23,12,35,0.000333,0.04558,3,410.223513,22.790195,136.741171,43.651484,1,0
0,0,14,14,11,7,18,47,27,74,0.000333,0.102858,15,4628.616752,257.145375,308.57445,57.705232,6,0
0,0,5,5,9,7,16,40,20,60,0.000333,0.08,8,1920,106.666667,240,48.180809,6,0
0,0,9,9,15,19,34,68,35,103,0.000333,0.17467,7,3668.060709,203.78115,524.008673,139.313982,2,0
0,0,11,11,15,21,36,84,43,127,0.000333,0.21886,14,9192.126653,510.673703,656.580475,150.842025,2,0
0,0,4,4,4,7,11,13,11,24,0.000333,0.027675,2,166.052718,9.225151,83.026359,27.651484,3,0
0,0,9,9,15,19,34,68,35,103,0.000333,0.17467,7,3668.060709,203.78115,524.008673,139.313982,2,0
0,0,5,5,8,8,16,19,12,31,0.000333,0.041333,4,496,27.555556,124,48,1,0
0,0,5,5,8,10,18,28,17,45,0.000333,0.062549,4,750.5865,41.69925,187.646625,57.219281,1,0
0,0,5,5,7,15,22,28,29,57,0.000333,0.084729,3,762.562807,42.3646,254.187602,78.254843,1,0
0,0,4,4,4,7,11,13,11,24,0.000333,0.027675,2,166.052718,9.225151,83.026359,27.651484,3,0
0,0,9,9,7,17,24,50,43,93,0.000333,0.142134,6,2558.409075,142.133838,426.401513,89.138353,1,0
0,0,4,4,4,7,11,13,11,24,0.000333,0.027675,2,166.052718,9.225151,83.026359,27.651484,2,0
0,0,4,4,6,8,14,17,12,29,0.000333,0.036804,3,331.239878,18.402215,110.413293,39.509775,3,0
0,0,6,6,9,10,19,28,17,45,0.000333,0.063719,4,764.626952,42.479275,191.156738,61.748606,1,0
0,0,9,9,11,17,28,47,44,91,0.000333,0.145823,10,4374.692979,243.038499,437.469298,107.540616,1,0
0,0,7,7,11,19,30,44,28,72,0.000333,0.117765,5,1766.480614,98.137812,353.296123,118.764371,2,0
0,0,3,3,8,8,16,20,12,32,0.000333,0.042667,4,512,28.444444,128,48,1,0
0,0,7,7,7,17,24,45,33,78,0.000333,0.119209,3,1072.881225,59.604513,357.627075,89.138353,1,0
0,0,6,6,14,12,26,43,26,69,0.000333,0.10811,14,4540.624768,252.256932,324.330341,96.322519,4,0
0,0,8,8,11,15,26,59,34,93,0.000333,0.145714,10,4371.408938,242.856052,437.140894,96.657107,1,0
0,0,8,8,15,18,33,66,34,100,0.000333,0.168146,7,3531.075884,196.170882,504.439412,133.662009,2,0
0,0,3,3,7,8,15,23,12,35,0.000333,0.04558,3,410.223513,22.790195,136.741171,43.651484,1,0
0,0,3,3,7,8,15,23,12,35,0.000333,0.04558,3,410.223513,22.790195,136.741171,43.651484,1,0
0,0,36,36,12,19,31,211,116,327,0.000333,0.540007,36,58320.79897,3240.044387,1620.022193,123.730173,40,0
0,0,9,9,15,19,34,68,35,103,0.000333,0.17467,7,3668.060709,203.78115,524.008673,139.313982,2,0
0,0,8,8,15,18,33,66,34,100,0.000333,0.168146,7,3531.075884,196.170882,504.439412,133.662009,2,0
0,0,6,6,9,10,19,28,17,45,0.000333,0.063719,4,764.626952,42.479275,191.156738,61.748606,1,0
0,0,11,11,15,21,36,84,43,127,0.000333,0.21886,14,9192.126653,510.673703,656.580475,150.842025,2,0
0,0,4,4,10,15,25,32,21,53,0.000333,0.082041,5,1230.62189,68.367883,246.124378,91.82264,1,0
0,0,3,3,9,8,17,16,11,27,0.000333,0.036787,4,441.445987,24.524777,110.361497,52.529325,2,0
0,0,5,5,10,10,20,26,15,41,0.000333,0.059066,5,885.995259,49.221959,177.199052,66.438562,1,0
0,0,3,3,7,8,15,23,12,35,0.000333,0.04558,3,410.223513,22.790195,136.741171,43.651484,1,0
0,0,3,3,9,8,17,16,11,27,0.000333,0.036787,4,441.445987,24.524777,110.361497,52.529325,2,0
0,0,9,9,15,19,34,68,35,103,0.000333,0.17467,7,3668.060709,203.78115,524.008673,139.313982,2,0
0,0,7,7,7,10,17,30,20,50,0.000333,0.068124,6,1226.238852,68.124381,204.373142,52.870765,3,0
0,0,7,7,11,19,30,44,28,72,0.000333,0.117765,5,1766.480614,98.137812,353.296123,118.764371,2,0
0,0,3,3,7,8,15,23,12,35,0.000333,0.04558,3,410.223513,22.790195,136.741171,43.651484,1,0
0,0,4,4,9,7,16,17,12,29,0.000333,0.038667,4,464,25.777778,116,48.180809,1,0
0,0,11,11,15,21,36,84,43,127,0.000333,0.21886,14,9192.126653,510.673703,656.580475,150.842025,2,0
0,0,11,11,12,18,30,69,40,109,0.000333,0.178284,12,6418.212899,356.567383,534.851075,118.0782,2,0
0,0,10,10,9,15,24,43,35,78,0.000333,0.119209,8,2861.0166,158.945367,357.627075,87.132684,1,0
0,0,4,4,5,9,14,15,13,28,0.000333,0.035535,2,213.211876,11.845104,106.605938,40.138965,1,0
0,0,25,25,12,35,47,382,213,595,0.000333,1.10166,36,118979.2932,6609.960733,3304.980367,222.544456,4,0
0,0,6,6,10,11,21,24,21,45,0.000333,0.065885,5,988.27142,54.903968,197.654284,71.273029,1,0
0,0,4,4,4,7,11,13,11,24,0.000333,0.027675,2,166.052718,9.225151,83.026359,27.651484,2,0
0,0,4,4,8,10,18,19,14,33,0.000333,0.045869,4,550.4301,30.57945,137.607525,57.219281,1,0
0,0,5,5,8,10,18,26,15,41,0.000333,0.056989,4,683.8677,37.99265,170.966925,57.219281,1,0
0,0,9,9,15,19,34,68,35,103,0.000333,0.17467,7,3668.060709,203.78115,524.008673,139.313982,2,0
0,0,11,11,15,21,36,84,43,127,0.000333,0.21886,14,9192.126653,510.673703,656.580475,150.842025,2,0
0,0,4,4,4,7,11,13,11,24,0.000333,0.027675,2,166.052718,9.225151,83.026359,27.651484,2,0
0,0,4,4,6,13,19,17,17,34,0.000333,0.048143,3,433.288606,24.071589,144.429535,63.615491,1,0
0,0,3,3,8,8,16,20,12,32,0.000333,0.042667,4,512,28.444444,128,48,1,0
0,0,4,4,8,7,15,15,10,25,0.000333,0.032557,4,390.68906,21.704948,97.672265,43.651484,1,0
0,0,11,11,12,17,29,56,46,102,0.000333,0.165171,12,5946.168738,330.342708,495.514062,112.506418,1,0
0,0,10,10,15,27,42,169,61,230,0.000333,0.413411,14,17363.2621,964.625672,1240.233007,186.985321,7,0
0,0,4,4,10,7,17,16,12,28,0.000333,0.03815,5,572.244798,31.791378,114.44896,52.870765,1,0
0,0,3,3,8,6,14,11,9,20,0.000333,0.025382,4,304.588394,16.921577,76.147098,39.509775,1,0
0,0,5,5,9,9,18,27,17,44,0.000333,0.061159,4,733.9068,40.7726,183.4767,57.05865,1,0
0,0,11,11,12,18,30,69,40,109,0.000333,0.178284,12,6418.212899,356.567383,534.851075,118.0782,2,0
0,0,4,4,5,13,18,14,16,30,0.000333,0.041699,2,250.1955,13.89975,125.09775,59.715357,1,0
0,0,10,10,14,16,30,51,35,86,0.000333,0.140664,14,5907.896277,328.21646,421.992591,117.302969,2,0
0,0,9,9,15,19,34,68,35,103,0.000333,0.17467,7,3668.060709,203.78115,524.008673,139.313982,2,0
0,0,10,10,15,20,35,80,41,121,0.000333,0.206881,14,8689.005431,482.722524,620.643245,145.041921,2,0
0,0,4,4,5,9,14,15,13,28,0.000333,0.035535,2,213.211876,11.845104,106.605938,40.138965,1,0
0,0,5,5,8,9,17,21,16,37,0.000333,0.050412,4,604.944501,33.608028,151.236125,52.529325,1,0
0,0,3,3,8,7,15,15,9,24,0.000333,0.031255,4,375.061497,20.83675,93.765374,43.651484,3,0
0,0,4,4,4,7,11,13,11,24,0.000333,0.027675,2,166.052718,9.225151,83.026359,27.651484,3,0
0,0,4,4,4,7,11,13,11,24,0.000333,0.027675,2,166.052718,9.225151,83.026359,27.651484,3,0
0,0,6,6,9,10,19,28,17,45,0.000333,0.063719,4,764.626952,42.479275,191.156738,61.748606,1,0
0,0,5,5,7,10,17,19,16,35,0.000333,0.047687,3,429.183598,23.843533,143.061199,52.870765,3,0
0,0,24,24,18,28,46,110,71,181,0.000333,0.333255,18,17995.76485,999.764714,999.764714,209.664588,6,0
0,0,4,4,4,7,11,13,11,24,0.000333,0.027675,2,166.052718,9.225151,83.026359,27.651484,3,0
0,0,4,4,6,10,16,15,13,28,0.000333,0.037333,3,336,18.666667,112,48.729056,1,0
0,0,3,3,8,7,15,20,12,32,0.000333,0.041673,4,500.081996,27.782333,125.020499,43.651484,1,0
0,0,5,5,7,7,14,16,11,27,0.000333,0.034266,3,308.395749,17.133097,102.798583,39.302969,1,0
0,0,4,4,6,8,14,17,12,29,0.000333,0.036804,3,331.239878,18.402215,110.413293,39.509775,3,0
0,0,6,6,12,12,24,24,19,43,0.000333,0.065718,6,1182.920325,65.717796,197.153388,86.0391,2,0
0,0,11,11,15,21,36,84,43,127,0.000333,0.21886,14,9192.126653,510.673703,656.580475,150.842025,2,0
0,0,7,7,11,18,29,48,28,76,0.000333,0.123069,5,1846.032778,102.557377,369.206556,113.112398,1,0
0,0,4,4,4,7,11,13,11,24,0.000333,0.027675,2,166.052718,9.225151,83.026359,27.651484,3,0
0,0,4,4,5,8,13,23,14,37,0.000333,0.045639,2,273.832539,15.212919,136.91627,35.60964,1,0
0,0,5,5,10,9,19,25,16,41,0.000333,0.058055,5,870.82514,48.379174,174.165028,61.748606,1,0
0,0,7,7,11,13,24,33,19,52,0.000333,0.079473,5,1192.09025,66.227236,238.41805,86.159464,4,0
0,0,5,5,8,10,18,26,15,41,0.000333,0.056989,4,683.8677,37.99265,170.966925,57.219281,1,0
0,0,11,11,12,17,29,56,46,102,0.000333,0.165171,12,5946.168738,330.342708,495.514062,112.506418,1,0
0,0,5,5,10,11,21,29,17,46,0.000333,0.067349,5,1010.233007,56.124056,202.046601,71.273029,1,0
0,0,3,3,8,7,15,20,12,32,0.000333,0.041673,4,500.081996,27.782333,125.020499,43.651484,1,0
0,0,5,5,10,10,20,27,14,41,0.000333,0.059066,5,885.995259,49.221959,177.199052,66.438562,3,0
0,0,4,4,6,9,15,16,12,28,0.000333,0.036464,3,328.17881,18.232156,109.392937,44.0391,1,0
0,0,8,8,13,14,27,39,29,68,0.000333,0.107777,12,3879.988202,215.5549,323.33235,101.408685,1,0
0,0,8,8,15,18,33,66,34,100,0.000333,0.168146,7,3531.075884,196.170882,504.439412,133.662009,2,0
0,0,11,11,15,21,36,84,43,127,0.000333,0.21886,14,9192.126653,510.673703,656.580475,150.842025,2,0
0,0,25,25,12,35,47,382,213,595,0.000333,1.10166,36,118979.2932,6609.960733,3304.980367,222.544456,4,0
0,0,4,4,5,9,14,15,13,28,0.000333,0.035535,2,213.211876,11.845104,106.605938,40.138965,1,0
0,0,7,7,11,19,30,44,28,72,0.000333,0.117765,5,1766.480614,98.137812,353.296123,118.764371,2,0
0,0,6,6,10,11,21,24,21,45,0.000333,0.065885,5,988.27142,54.903968,197.654284,71.273029,1,0
0,0,3,3,7,8,15,23,12,35,0.000333,0.04558,3,410.223513,22.790195,136.741171,43.651484,1,0
0,0,6,6,14,11,25,40,23,63,0.000333,0.097521,14,4095.881159,227.548953,292.56294,91.356717,4,0
0,0,9,9,16,16,32,53,37,90,0.000333,0.15,16,7200,400,450,128,4,0
0,0,3,3,8,8,16,20,12,32,0.000333,0.042667,4,512,28.444444,128,48,1,0
0,0,5,5,10,9,19,27,16,43,0.000333,0.060887,5,913.304415,50.739134,182.660883,61.748606,1,0
0,0,13,13,13,22,35,98,52,150,0.000333,0.256464,12,9232.709431,512.928302,769.392453,146.213212,2,0
0,0,4,4,6,9,15,13,12,25,0.000333,0.032557,3,293.016795,16.278711,97.672265,44.0391,1,0
0,0,3,3,5,6,11,9,8,17,0.000333,0.019603,2,117.620675,6.534482,58.810338,27.119415,1,0
0,0,3,3,7,8,15,23,12,35,0.000333,0.04558,3,410.223513,22.790195,136.741171,43.651484,1,0
0,0,3,3,9,8,17,16,11,27,0.000333,0.036787,4,441.445987,24.524777,110.361497,52.529325,2,0
0,0,5,5,9,15,24,24,23,47,0.000333,0.071831,4,861.97295,47.887386,215.493238,87.132684,2,0
0,0,5,5,8,10,18,26,15,41,0.000333,0.056989,4,683.8677,37.99265,170.966925,57.219281,1,0
0,0,3,3,9,8,17,16,11,27,0.000333,0.036787,4,441.445987,24.524777,110.361497,52.529325,2,0
0,0,4,4,7,11,18,20,16,36,0.000333,0.050039,3,450.3519,25.01955,150.1173,57.705232,1,0
0,0,8,8,15,18,33,66,34,100,0.000333,0.168146,7,3531.075884,196.170882,504.439412,133.662009,2,0
0,0,11,11,15,21,36,84,43,127,0.000333,0.21886,14,9192.126653,510.673703,656.580475,150.842025,2,0
0,0,7,7,8,14,22,30,32,62,0.000333,0.092162,8,2211.878083,122.882116,276.48476,77.302969,1,0
0,0,3,3,8,7,15,20,12,32,0.000333,0.041673,4,500.081996,27.782333,125.020499,43.651484,1,0
0,0,5,5,8,10,18,28,17,45,0.000333,0.062549,4,750.5865,41.69925,187.646625,57.219281,1,0
0,0,5,5,17,15,32,38,23,61,0.000333,0.101667,8,2440,135.555556,305,128.090227,6,0
0,0,5,5,8,11,19,36,19,55,0.000333,0.077879,4,934.544053,51.919114,233.636013,62.053748,1,0
0,0,5,5,8,8,16,23,15,38,0.000333,0.050667,4,608,33.777778,152,48,1,0
0,0,7,7,11,19,30,44,28,72,0.000333,0.117765,5,1766.480614,98.137812,353.296123,118.764371,2,0
0,0,7,7,11,19,30,44,28,72,0.000333,0.117765,5,1766.480614,98.137812,353.296123,118.764371,2,0
0,0,8,8,16,16,32,47,33,80,0.000333,0.133333,16,6400,355.555556,400,128,4,0
0,0,13,13,17,22,39,74,57,131,0.000333,0.230796,16,11078.20305,615.455725,692.387691,167.594364,4,0
0,0,3,3,5,6,11,9,8,17,0.000333,0.019603,2,117.620675,6.534482,58.810338,27.119415,1,0
0,0,4,4,6,12,18,16,15,31,0.000333,0.043089,3,387.803025,21.544613,129.267675,58.529325,1,0
0,0,5,5,10,10,20,26,15,41,0.000333,0.059066,5,885.995259,49.221959,177.199052,66.438562,1,0
0,0,4,4,9,9,18,19,15,34,0.000333,0.047259,4,567.1098,31.5061,141.77745,57.05865,1,0
0,0,3,3,8,7,15,11,9,20,0.000333,0.026046,4,312.551248,17.363958,78.137812,43.651484,1,0
0,0,4,4,8,6,14,16,12,28,0.000333,0.035535,8,852.847503,47.380417,106.605938,39.509775,1,0
0,0,3,3,8,6,14,11,9,20,0.000333,0.025382,4,304.588394,16.921577,76.147098,39.509775,1,0
0,0,4,4,6,8,14,17,12,29,0.000333,0.036804,3,331.239878,18.402215,110.413293,39.509775,3,0
0,0,19,19,17,26,43,116,69,185,0.000333,0.33462,16,16061.74367,892.319093,1003.85898,191.698301,5,0
0,0,4,4,5,10,15,13,13,26,0.000333,0.03386,2,203.158311,11.286573,101.579155,44.828921,1,0
0,0,9,9,15,19,34,68,35,103,0.000333,0.17467,7,3668.060709,203.78115,524.008673,139.313982,2,0
0,0,4,4,10,15,25,32,21,53,0.000333,0.082041,5,1230.62189,68.367883,246.124378,91.82264,1,0
0,0,11,11,15,21,36,84,43,127,0.000333,0.21886,14,9192.126653,510.673703,656.580475,150.842025,2,0
0,0,9,9,15,19,34,68,35,103,0.000333,0.17467,7,3668.060709,203.78115,524.008673,139.313982,2,0
0,0,8,8,15,18,33,66,34,100,0.000333,0.168146,7,3531.075884,196.170882,504.439412,133.662009,2,0
0,0,4,4,4,7,11,13,11,24,0.000333,0.027675,2,166.052718,9.225151,83.026359,27.651484,2,0
0,0,11,11,15,21,36,84,43,127,0.000333,0.21886,14,9192.126653,510.673703,656.580475,150.842025,2,0
0,0,3,3,7,5,12,11,7,18,0.000333,0.02151,3,193.587975,10.754888,64.529325,31.261125,1,0
0,0,3,3,9,8,17,16,11,27,0.000333,0.036787,4,441.445987,24.524777,110.361497,52.529325,2,0
0,0,3,3,7,8,15,23,12,35,0.000333,0.04558,3,410.223513,22.790195,136.741171,43.651484,1,0
0,0,5,5,8,11,19,30,18,48,0.000333,0.067967,4,815.602083,45.311227,203.900521,62.053748,1,0
0,0,4,4,8,7,15,17,10,27,0.000333,0.035162,4,421.944184,23.441344,105.486046,43.651484,1,0
0,0,5,5,10,11,21,29,17,46,0.000333,0.067349,5,1010.233007,56.124056,202.046601,71.273029,1,0
0,0,5,5,7,8,15,51,26,77,0.000333,0.100277,9,2707.475183,150.415288,300.830576,43.651484,1,0
0,0,6,6,7,9,16,63,32,95,0.000333,0.126667,9,3420,190,380,48.180809,1,0
0,0,3,3,7,6,13,27,14,41,0.000333,0.050573,6,910.308171,50.572676,151.718028,35.161259,1,0
0,0,4,4,7,7,14,39,20,59,0.000333,0.074878,6,1347.803642,74.87798,224.63394,39.302969,1,0
0,0,5,5,7,7,14,16,11,27,0.000333,0.034266,3,308.395749,17.133097,102.798583,39.302969,1,0
0,0,9,9,15,19,34,68,35,103,0.000333,0.17467,7,3668.060709,203.78115,524.008673,139.313982,2,0
0,0,4,4,4,7,11,13,11,24,0.000333,0.027675,2,166.052718,9.225151,83.026359,27.651484,2,0
0,0,4,4,5,12,17,13,15,28,0.000333,0.03815,2,228.897919,12.716551,114.44896,54.62919,1,0
0,0,4,4,4,7,11,13,11,24,0.000333,0.027675,2,166.052718,9.225151,83.026359,27.651484,3,0
0,0,11,11,12,18,30,69,40,109,0.000333,0.178284,12,6418.212899,356.567383,534.851075,118.0782,7,0
0,0,5,5,9,11,20,19,16,35,0.000333,0.050422,4,605.069933,33.614996,151.267483,66.583073,1,0
0,0,4,4,5,7,12,14,10,24,0.000333,0.02868,2,172.0782,9.5599,86.0391,31.261125,2,0
0,0,7,7,11,19,30,44,28,72,0.000333,0.117765,5,1766.480614,98.137812,353.296123,118.764371,2,0
0,0,14,14,11,23,34,85,48,133,0.000333,0.225544,10,6766.325579,375.906977,676.632558,142.095673,1,0
0,0,5,5,11,12,23,33,21,54,0.000333,0.081424,5,1221.361728,67.853429,244.272346,81.073298,1,0
0,0,16,16,18,14,32,81,34,115,0.000333,0.191667,18,10350,575,575,128.361619,7,0
0,0,5,5,9,8,17,29,19,48,0.000333,0.065399,8,1569.585731,87.199207,196.198216,52.529325,1,0
0,0,7,7,11,19,30,44,28,72,0.000333,0.117765,5,1766.480614,98.137812,353.296123,118.764371,2,0
0,0,5,5,7,7,14,16,11,27,0.000333,0.034266,3,308.395749,17.133097,102.798583,39.302969,1,0
0,0,11,11,8,16,24,61,40,101,0.000333,0.15436,8,3704.649701,205.813872,463.081213,88,1,0
0,0,4,4,7,6,13,14,9,23,0.000333,0.02837,3,255.330341,14.185019,85.110114,35.161259,1,0
0,0,3,3,9,8,17,16,11,27,0.000333,0.036787,4,441.445987,24.524777,110.361497,52.529325,2,0
0,0,4,4,9,7,16,16,11,27,0.000333,0.036,4,432,24,108,48.180809,1,0
0,0,3,3,9,8,17,16,10,26,0.000333,0.035425,4,425.096135,23.616452,106.274034,52.529325,3,0
0,0,3,3,10,5,15,14,7,21,0.000333,0.027348,5,410.223513,22.790195,82.044703,44.828921,1,0
0,0,3,3,7,5,12,11,7,18,0.000333,0.02151,3,193.587975,10.754888,64.529325,31.261125,1,0
0,0,7,7,11,19,30,44,28,72,0.000333,0.117765,5,1766.480614,98.137812,353.296123,118.764371,2,0
0,0,3,3,9,7,16,19,11,30,0.000333,0.04,4,480,26.666667,120,48.180809,1,0
0,0,20,20,19,27,46,157,73,230,0.000333,0.423473,18,22867.5465,1270.41925,1270.41925,209.092585,10,0
0,0,3,3,7,8,15,23,12,35,0.000333,0.04558,3,410.223513,22.790195,136.741171,43.651484,1,0
0,0,8,8,15,18,33,66,34,100,0.000333,0.168146,7,3531.075884,196.170882,504.439412,133.662009,2,0
0,0,9,9,15,20,35,72,36,108,0.000333,0.184654,7,3877.737961,215.429887,553.962566,145.041921,2,0
0,0,3,3,7,8,15,23,12,35,0.000333,0.04558,3,410.223513,22.790195,136.741171,43.651484,1,0
0,0,3,3,7,8,15,23,12,35,0.000333,0.04558,3,410.223513,22.790195,136.741171,43.651484,1,0
0,0,3,3,9,8,17,16,10,26,0.000333,0.035425,4,425.096135,23.616452,106.274034,52.529325,3,0
0,0,4,4,10,7,17,25,15,40,0.000333,0.0545,10,1634.985137,90.832508,163.498514,52.870765,1,0
0,0,4,4,9,7,16,17,12,29,0.000333,0.038667,4,464,25.777778,116,48.180809,1,0
0,0,6,6,7,11,18,41,25,66,0.000333,0.091738,6,1651.290301,91.73835,275.21505,57.705232,1,0
0,0,9,9,15,19,34,68,35,103,0.000333,0.17467,7,3668.060709,203.78115,524.008673,139.313982,2,0
0,0,3,3,7,5,12,11,7,18,0.000333,0.02151,3,193.587975,10.754888,64.529325,31.261125,1,0
0,0,9,9,8,17,25,61,45,106,0.000333,0.164083,8,3937.990049,218.777225,492.248756,93.486868,1,0
0,0,5,5,8,15,23,31,29,60,0.000333,0.090471,4,1085.654869,60.314159,271.413717,82.603359,1,0
0,0,5,5,8,11,19,36,19,55,0.000333,0.077879,4,934.544053,51.919114,233.636013,62.053748,1,0
0,0,5,5,8,16,24,20,24,44,0.000333,0.067246,4,806.9534,44.830744,201.73835,88,1,0
0,0,8,8,12,16,28,52,36,88,0.000333,0.141016,12,5076.566798,282.031489,423.047233,107.01955,1,0
0,0,4,4,11,10,21,36,17,53,0.000333,0.077598,5,1163.964117,64.664673,232.792823,71.273029,1,0
0,0,7,7,10,14,24,40,27,67,0.000333,0.102397,5,1535.962438,85.331247,307.192488,86.52225,1,0
0,0,5,5,10,9,19,25,16,41,0.000333,0.058055,5,870.82514,48.379174,174.165028,61.748606,1,0
0,0,4,4,4,7,11,13,11,24,0.000333,0.027675,2,166.052718,9.225151,83.026359,27.651484,3,0
0,0,7,7,11,19,30,44,28,72,0.000333,0.117765,5,1766.480614,98.137812,353.296123,118.764371,2,0
0,0,5,5,12,16,28,39,25,64,0.000333,0.102557,6,1846.02429,102.556905,307.670715,107.01955,2,0
0,0,8,8,15,18,33,66,34,100,0.000333,0.168146,7,3531.075884,196.170882,504.439412,133.662009,2,0
0,0,6,6,14,12,26,38,24,62,0.000333,0.097142,14,4079.981675,226.665649,291.427263,96.322519,4,0
0,0,7,7,8,12,20,27,24,51,0.000333,0.073473,8,1763.346663,97.963703,220.418333,67.01955,3,0
0,0,4,4,4,7,11,13,11,24,0.000333,0.027675,2,166.052718,9.225151,83.026359,27.651484,3,0
0,0,4,4,5,9,14,15,13,28,0.000333,0.035535,2,213.211876,11.845104,106.605938,40.138965,1,0
0,0,4,4,4,7,11,13,11,24,0.000333,0.027675,2,166.052718,9.225151,83.026359,27.651484,3,0
0,0,5,5,11,12,23,33,21,54,0.000333,0.081424,5,1221.361728,67.853429,244.272346,81.073298,1,0
0,0,3,3,8,8,16,20,12,32,0.000333,0.042667,4,512,28.444444,128,48,1,0
0,0,11,11,15,21,36,84,43,127,0.000333,0.21886,14,9192.126653,510.673703,656.580475,150.842025,2,0
0,0,8,8,15,18,33,66,34,100,0.000333,0.168146,7,3531.075884,196.170882,504.439412,133.662009,2,0
0,0,4,4,5,9,14,15,13,28,0.000333,0.035535,2,213.211876,11.845104,106.605938,40.138965,1,0
0,0,7,7,11,19,30,44,28,72,0.000333,0.117765,5,1766.480614,98.137812,353.296123,118.764371,2,0
0,0,4,4,5,10,15,13,13,26,0.000333,0.03386,2,203.158311,11.286573,101.579155,44.828921,1,0
0,0,20,20,12,27,39,115,66,181,0.000333,0.318886,12,11479.89362,637.771868,956.657802,171.401513,5,0
0,0,3,3,8,7,15,20,12,32,0.000333,0.041673,4,500.081996,27.782333,125.020499,43.651484,1,0
0,0,3,3,7,8,15,23,12,35,0.000333,0.04558,3,410.223513,22.790195,136.741171,43.651484,1,0
0,0,8,8,13,16,29,36,25,61,0.000333,0.098779,6,1778.021044,98.778947,296.336841,112.105716,1,0
0,0,3,3,7,8,15,23,12,35,0.000333,0.04558,3,410.223513,22.790195,136.741171,43.651484,1,0
0,0,3,3,11,11,22,26,15,41,0.000333,0.060946,5,914.183482,50.787971,182.836696,76.107496,3,0
0,0,3,3,9,11,20,19,16,35,0.000333,0.050422,4,605.069933,33.614996,151.267483,66.583073,1,0
0,0,5,5,8,11,19,36,19,55,0.000333,0.077879,4,934.544053,51.919114,233.636013,62.053748,1,0
0,0,8,8,15,15,30,47,35,82,0.000333,0.134122,14,5633.110404,312.950578,402.365029,117.206718,4,0
0,0,7,7,11,19,30,44,28,72,0.000333,0.117765,5,1766.480614,98.137812,353.296123,118.764371,2,0
0,0,4,4,10,15,25,32,21,53,0.000333,0.082041,5,1230.62189,68.367883,246.124378,91.82264,1,0
0,0,5,5,8,14,22,19,19,38,0.000333,0.056486,4,677.833606,37.657423,169.458402,77.302969,1,0
0,0,4,4,10,15,25,32,21,53,0.000333,0.082041,5,1230.62189,68.367883,246.124378,91.82264,1,0
0,0,11,11,15,21,36,84,43,127,0.000333,0.21886,14,9192.126653,510.673703,656.580475,150.842025,2,0
0,0,4,4,4,7,11,13,11,24,0.000333,0.027675,2,166.052718,9.225151,83.026359,27.651484,3,0
0,0,4,4,11,10,21,24,14,38,0.000333,0.055636,5,834.54031,46.363351,166.908062,71.273029,3,0
0,0,11,11,15,21,36,84,43,127,0.000333,0.21886,14,9192.126653,510.673703,656.580475,150.842025,2,0
0,0,8,8,15,18,33,66,34,100,0.000333,0.168146,7,3531.075884,196.170882,504.439412,133.662009,2,0
0,0,5,5,11,12,23,33,21,54,0.000333,0.081424,5,1221.361728,67.853429,244.272346,81.073298,1,0
0,0,9,9,15,19,34,68,35,103,0.000333,0.17467,7,3668.060709,203.78115,524.008673,139.313982,2,0
0,0,5,5,8,8,16,19,12,31,0.000333,0.041333,4,496,27.555556,124,48,1,0
0,0,5,5,10,12,22,24,18,42,0.000333,0.062432,5,936.48064,52.026702,187.296128,76.238831,1,0
0,0,36,36,16,62,78,272,185,457,0.000333,0.957476,16,45958.86102,2553.270057,2872.428814,433.160171,4,0
0,0,3,3,8,8,16,20,12,32,0.000333,0.042667,4,512,28.444444,128,48,1,0
0,0,8,8,12,15,27,42,27,69,0.000333,0.109362,6,1968.523426,109.362413,328.087238,101.622909,2,0
0,0,5,5,12,16,28,39,25,64,0.000333,0.102557,6,1846.02429,102.556905,307.670715,107.01955,4,0
0,0,7,7,11,19,30,44,28,72,0.000333,0.117765,5,1766.480614,98.137812,353.296123,118.764371,2,0
0,0,4,4,4,7,11,13,11,24,0.000333,0.027675,2,166.052718,9.225151,83.026359,27.651484,3,0
0,0,11,11,13,21,34,92,48,140,0.000333,0.237415,12,8546.937573,474.829865,712.244798,140.344382,8,0
0,0,3,3,7,5,12,11,7,18,0.000333,0.02151,3,193.587975,10.754888,64.529325,31.261125,1,0
0,0,8,8,12,15,27,42,27,69,0.000333,0.109362,6,1968.523426,109.362413,328.087238,101.622909,2,0
0,0,9,9,12,14,26,47,40,87,0.000333,0.136313,12,4907.259066,272.625504,408.938255,96.322519,1,0
0,0,8,8,10,15,25,36,29,65,0.000333,0.100617,5,1509.253262,83.847403,301.850652,91.82264,1,0
0,0,6,6,9,13,22,27,21,48,0.000333,0.071351,4,856.210871,47.567271,214.052718,76.635041,1,0
0,0,8,8,16,17,33,49,35,84,0.000333,0.141243,16,6779.665696,376.648094,423.729106,133.486868,4,0
0,0,4,4,6,8,14,17,12,29,0.000333,0.036804,3,331.239878,18.402215,110.413293,39.509775,3,0
0,0,14,14,11,13,24,62,45,107,0.000333,0.16353,15,7358.864814,408.825823,490.590988,86.159464,1,0
0,0,7,7,11,19,30,44,28,72,0.000333,0.117765,5,1766.480614,98.137812,353.296123,118.764371,2,0
0,0,5,5,8,10,18,28,17,45,0.000333,0.062549,4,750.5865,41.69925,187.646625,57.219281,1,0
0,0,6,6,14,12,26,43,26,69,0.000333,0.10811,14,4540.624768,252.256932,324.330341,96.322519,4,0
0,0,5,5,10,10,20,26,15,41,0.000333,0.059066,5,885.995259,49.221959,177.199052,66.438562,1,0
0,0,3,3,7,8,15,23,12,35,0.000333,0.04558,3,410.223513,22.790195,136.741171,43.651484,1,0
0,0,9,9,15,19,34,68,35,103,0.000333,0.17467,7,3668.060709,203.78115,524.008673,139.313982,2,0
0,0,5,5,10,12,22,24,18,42,0.000333,0.062432,5,936.48064,52.026702,187.296128,76.238831,1,0
0,0,12,12,14,17,31,58,41,99,0.000333,0.163488,14,6866.516086,381.473116,490.465435,122.789837,2,0
0,0,5,5,7,8,15,17,12,29,0.000333,0.037767,3,339.899482,18.883305,113.299827,43.651484,1,0
0,0,7,7,7,13,20,39,28,67,0.000333,0.096523,6,1737.415094,96.523061,289.569182,67.757201,1,0
0,0,4,4,9,8,17,24,15,39,0.000333,0.053137,4,637.644203,35.424678,159.411051,52.529325,1,0
0,0,11,11,15,21,36,84,43,127,0.000333,0.21886,14,9192.126653,510.673703,656.580475,150.842025,2,0
0,0,8,8,15,18,33,66,34,100,0.000333,0.168146,7,3531.075884,196.170882,504.439412,133.662009,2,0
0,0,4,4,5,9,14,15,13,28,0.000333,0.035535,2,213.211876,11.845104,106.605938,40.138965,1,0
0,0,25,25,12,35,47,382,213,595,0.000333,1.10166,36,118979.2932,6609.960733,3304.980367,222.544456,4,0
0,0,9,9,15,19,34,68,35,103,0.000333,0.17467,7,3668.060709,203.78115,524.008673,139.313982,2,0
0,0,5,5,11,12,23,33,21,54,0.000333,0.081424,5,1221.361728,67.853429,244.272346,81.073298,1,0
0,0,6,6,12,15,27,37,22,59,0.000333,0.093513,6,1683.230176,93.512788,280.538363,101.622909,3,0
0,0,4,4,4,7,11,13,11,24,0.000333,0.027675,2,166.052718,9.225151,83.026359,27.651484,3,0
0,0,7,7,11,19,30,44,28,72,0.000333,0.117765,5,1766.480614,98.137812,353.296123,118.764371,2,0
0,0,3,3,7,5,12,11,7,18,0.000333,0.02151,3,193.587975,10.754888,64.529325,31.261125,1,0
0,0,5,5,10,10,20,20,20,40,0.000333,0.057626,10,1728.771238,96.042847,172.877124,66.438562,1,0
0,0,7,7,11,19,30,44,28,72,0.000333,0.117765,5,1766.480614,98.137812,353.296123,118.764371,2,0
0,0,5,5,8,10,18,28,17,45,0.000333,0.062549,4,750.5865,41.69925,187.646625,57.219281,1,0
0,0,9,9,15,19,34,68,35,103,0.000333,0.17467,7,3668.060709,203.78115,524.008673,139.313982,2,0
0,0,3,3,12,9,21,21,11,32,0.000333,0.046851,6,843.324945,46.851386,140.554158,71.548875,3,0
0,0,5,5,10,11,21,29,17,46,0.000333,0.067349,5,1010.233007,56.124056,202.046601,71.273029,1,0
0,0,3,3,9,8,17,16,11,27,0.000333,0.036787,4,441.445987,24.524777,110.361497,52.529325,2,0
0,0,3,3,8,6,14,11,9,20,0.000333,0.025382,4,304.588394,16.921577,76.147098,39.509775,1,0
0,0,12,12,12,18,30,60,49,109,0.000333,0.178284,12,6418.212899,356.567383,534.851075,118.0782,1,0
0,0,4,4,7,11,18,24,17,41,0.000333,0.056989,3,512.900775,28.494488,170.966925,57.705232,1,0
0,0,8,8,15,18,33,66,34,100,0.000333,0.168146,7,3531.075884,196.170882,504.439412,133.662009,2,0
0,0,4,4,13,12,25,25,15,40,0.000333,0.061918,6,1114.525486,61.918083,185.754248,91.125266,3,0
0,0,4,4,4,7,11,13,11,24,0.000333,0.027675,2,166.052718,9.225151,83.026359,27.651484,3,0
0,0,7,7,14,15,29,42,31,73,0.000333,0.118211,14,4964.856577,275.825365,354.632613,111.906328,4,0
0,0,9,9,15,19,34,68,35,103,0.000333,0.17467,7,3668.060709,203.78115,524.008673,139.313982,2,0
0,0,8,8,14,17,31,48,34,82,0.000333,0.135415,14,5687.417364,315.967631,406.244097,122.789837,4,0
0,0,5,5,12,9,21,24,14,38,0.000333,0.055636,6,1001.448372,55.636021,166.908062,71.548875,2,0
0,0,6,6,7,15,22,29,33,62,0.000333,0.092162,6,1658.908562,92.161587,276.48476,78.254843,1,0
0,0,4,4,10,15,25,32,21,53,0.000333,0.082041,5,1230.62189,68.367883,246.124378,91.82264,1,0
0,0,4,4,6,13,19,17,17,34,0.000333,0.048143,3,433.288606,24.071589,144.429535,63.615491,1,0
0,0,9,9,15,19,34,68,35,103,0.000333,0.17467,7,3668.060709,203.78115,524.008673,139.313982,2,0
0,0,3,3,9,8,17,16,11,27,0.000333,0.036787,4,441.445987,24.524777,110.361497,52.529325,2,0
0,0,6,6,9,10,19,28,17,45,0.000333,0.063719,4,764.626952,42.479275,191.156738,61.748606,1,0
0,0,11,11,12,16,28,56,40,96,0.000333,0.153835,12,5538.07287,307.670715,461.506073,107.01955,1,0
0,0,7,7,8,12,20,29,20,49,0.000333,0.070591,4,847.097907,47.060995,211.774477,67.01955,1,0
0,0,3,3,10,8,18,16,13,29,0.000333,0.040309,5,604.639125,33.591063,120.927825,57.219281,3,0
0,0,10,10,7,14,21,57,36,93,0.000333,0.136162,6,2450.913122,136.16184,408.48552,72.954453,1,0
0,0,7,7,11,19,30,44,28,72,0.000333,0.117765,5,1766.480614,98.137812,353.296123,118.764371,2,0
0,0,4,4,9,8,17,15,12,27,0.000333,0.036787,4,441.445987,24.524777,110.361497,52.529325,1,0
0,0,10,10,13,20,33,50,32,82,0.000333,0.13788,6,2481.841907,137.880106,413.640318,134.544278,4,0
0,0,3,3,7,8,15,23,12,35,0.000333,0.04558,3,410.223513,22.790195,136.741171,43.651484,1,0
0,0,4,4,11,10,21,36,17,53,0.000333,0.077598,5,1163.964117,64.664673,232.792823,71.273029,1,0
0,0,15,15,16,28,44,88,57,145,0.000333,0.263873,16,12665.88136,703.660075,791.617585,198.605938,3,0
0,0,9,9,15,19,34,68,35,103,0.000333,0.17467,7,3668.060709,203.78115,524.008673,139.313982,2,0
0,0,3,3,9,7,16,19,11,30,0.000333,0.04,4,480,26.666667,120,48.180809,1,0
0,0,6,6,14,11,25,40,23,63,0.000333,0.097521,14,4095.881159,227.548953,292.56294,91.356717,4,0
0,0,3,3,9,8,17,16,11,27,0.000333,0.036787,4,441.445987,24.524777,110.361497,52.529325,2,0
0,0,5,5,8,8,16,19,12,31,0.000333,0.041333,4,496,27.555556,124,48,1,0
0,0,6,6,7,11,18,41,25,66,0.000333,0.091738,6,1651.290301,91.73835,275.21505,57.705232,1,0
0,0,5,5,7,15,22,31,25,56,0.000333,0.083243,3,749.184512,41.621362,249.728171,78.254843,1,0
0,0,3,3,7,13,20,20,18,38,0.000333,0.054744,3,492.699803,27.372211,164.233268,67.757201,1,0
0,0,11,11,15,21,36,84,43,127,0.000333,0.21886,14,9192.126653,510.673703,656.580475,150.842025,2,0
0,0,5,5,8,14,22,23,20,43,0.000333,0.063919,4,767.022238,42.612347,191.75556,77.302969,1,0
0,0,3,3,7,5,12,11,7,18,0.000333,0.02151,3,193.587975,10.754888,64.529325,31.261125,1,0
0,0,4,4,4,7,11,13,11,24,0.000333,0.027675,2,166.052718,9.225151,83.026359,27.651484,3,0
0,0,7,7,11,19,30,44,28,72,0.000333,0.117765,5,1766.480614,98.137812,353.296123,118.764371,2,0
0,0,5,5,9,9,18,27,17,44,0.000333,0.061159,4,733.9068,40.7726,183.4767,57.05865,1,0
0,0,11,11,15,21,36,84,43,127,0.000333,0.21886,14,9192.126653,510.673703,656.580475,150.842025,2,0
0,0,9,9,10,13,23,41,32,73,0.000333,0.110073,10,3302.200228,183.455568,330.220023,81.324997,1,0
0,0,8,8,15,18,33,66,34,100,0.000333,0.168146,7,3531.075884,196.170882,504.439412,133.662009,2,0
0,0,3,3,7,8,15,23,12,35,0.000333,0.04558,3,410.223513,22.790195,136.741171,43.651484,1,0
0,0,5,5,10,10,20,26,15,41,0.000333,0.059066,5,885.995259,49.221959,177.199052,66.438562,1,0
0,0,4,4,4,7,11,13,11,24,0.000333,0.027675,2,166.052718,9.225151,83.026359,27.651484,3,0
0,0,7,7,9,17,26,40,33,73,0.000333,0.114377,4,1372.528398,76.251578,343.132099,98.016193,1,0
0,0,3,3,9,8,17,16,11,27,0.000333,0.036787,4,441.445987,24.524777,110.361497,52.529325,2,0
0,0,7,7,11,19,30,44,28,72,0.000333,0.117765,5,1766.480614,98.137812,353.296123,118.764371,2,0
0,0,8,8,12,15,27,42,27,69,0.000333,0.109362,6,1968.523426,109.362413,328.087238,101.622909,2,0
0,0,7,7,11,19,30,44,28,72,0.000333,0.117765,5,1766.480614,98.137812,353.296123,118.764371,2,0
0,0,4,4,4,7,11,27,15,42,0.000333,0.048432,4,581.184512,32.288028,145.296128,27.651484,2,0
0,0,5,5,11,14,25,25,20,45,0.000333,0.069658,5,1044.867643,58.048202,208.973529,91.356717,1,0
0,0,3,3,9,8,17,16,11,27,0.000333,0.036787,4,441.445987,24.524777,110.361497,52.529325,2,0
0,0,4,4,5,12,17,17,17,34,0.000333,0.046325,2,277.947473,15.441526,138.973737,54.62919,1,0
0,0,5,5,10,10,20,27,14,41,0.000333,0.059066,5,885.995259,49.221959,177.199052,66.438562,5,0
0,0,10,10,15,27,42,169,61,230,0.000333,0.413411,14,17363.2621,964.625672,1240.233007,186.985321,7,0
0,0,5,5,8,15,23,19,22,41,0.000333,0.061822,4,741.864161,41.214676,185.46604,82.603359,1,0
0,0,5,5,8,9,17,25,15,40,0.000333,0.0545,4,653.994055,36.333003,163.498514,52.529325,1,0
0,0,4,4,6,9,15,16,12,28,0.000333,0.036464,3,328.17881,18.232156,109.392937,44.0391,1,0
0,0,4,4,4,7,11,13,11,24,0.000333,0.027675,2,166.052718,9.225151,83.026359,27.651484,3,0
0,0,7,7,11,19,30,44,28,72,0.000333,0.117765,5,1766.480614,98.137812,353.296123,118.764371,2,0
0,0,5,5,8,10,18,28,17,45,0.000333,0.062549,4,750.5865,41.69925,187.646625,57.219281,1,0
0,0,3,3,8,7,15,20,12,32,0.000333,0.041673,4,500.081996,27.782333,125.020499,43.651484,1,0
0,0,8,8,15,18,33,66,34,100,0.000333,0.168146,7,3531.075884,196.170882,504.439412,133.662009,2,0
0,0,11,11,11,16,27,52,43,95,0.000333,0.150571,10,4517.143127,250.952396,451.714313,102.053748,1,0
0,0,3,3,7,8,15,23,12,35,0.000333,0.04558,3,410.223513,22.790195,136.741171,43.651484,1,0
0,0,3,3,8,7,15,11,9,20,0.000333,0.026046,4,312.551248,17.363958,78.137812,43.651484,1,0
0,0,11,11,15,21,36,84,43,127,0.000333,0.21886,14,9192.126653,510.673703,656.580475,150.842025,2,0
0,0,8,8,15,18,33,66,34,100,0.000333,0.168146,7,3531.075884,196.170882,504.439412,133.662009,2,0
0,0,9,9,15,19,34,68,35,103,0.000333,0.17467,7,3668.060709,203.78115,524.008673,139.313982,2,0
0,0,6,6,13,11,24,38,23,61,0.000333,0.093228,12,3356.192551,186.455142,279.682713,86.159464,4,0
0,0,4,4,9,8,17,15,12,27,0.000333,0.036787,4,441.445987,24.524777,110.361497,52.529325,1,0
0,0,3,3,9,8,17,16,11,27,0.000333,0.036787,4,441.445987,24.524777,110.361497,52.529325,2,0
0,0,4,4,6,8,14,23,14,37,0.000333,0.046957,3,422.616396,23.478689,140.872132,39.509775,1,0
0,0,4,4,4,7,11,13,11,24,0.000333,0.027675,2,166.052718,9.225151,83.026359,27.651484,3,0
0,0,3,3,8,7,15,15,9,24,0.000333,0.031255,4,375.061497,20.83675,93.765374,43.651484,3,0
0,0,3,3,8,7,15,20,12,32,0.000333,0.041673,4,500.081996,27.782333,125.020499,43.651484,1,0
0,0,3,3,7,8,15,23,12,35,0.000333,0.04558,3,410.223513,22.790195,136.741171,43.651484,1,0
0,0,3,3,7,5,12,11,7,18,0.000333,0.02151,3,193.587975,10.754888,64.529325,31.261125,1,0
0,0,7,7,11,19,30,44,28,72,0.000333,0.117765,5,1766.480614,98.137812,353.296123,118.764371,2,0
0,0,5,5,8,10,18,28,17,45,0.000333,0.062549,4,750.5865,41.69925,187.646625,57.219281,1,0
0,0,14,14,9,17,26,76,65,141,0.000333,0.220921,12,7953.144003,441.841334,662.762,98.016193,1,0
0,0,4,4,4,7,11,13,11,24,0.000333,0.027675,2,166.052718,9.225151,83.026359,27.651484,3,0
0,0,7,7,11,19,30,44,28,72,0.000333,0.117765,5,1766.480614,98.137812,353.296123,118.764371,2,0
0,0,4,4,6,12,18,16,15,31,0.000333,0.043089,3,387.803025,21.544613,129.267675,58.529325,1,0
0,0,3,3,9,8,17,16,11,27,0.000333,0.036787,4,441.445987,24.524777,110.361497,52.529325,2,0
0,0,4,4,4,7,11,13,11,24,0.000333,0.027675,2,166.052718,9.225151,83.026359,27.651484,3,0
0,0,11,11,12,18,30,66,49,115,0.000333,0.188097,12,6771.509022,376.194946,564.292418,118.0782,1,0
0,0,6,6,5,12,17,19,26,45,0.000333,0.061312,4,735.743311,40.874628,183.935828,54.62919,1,0
0,0,3,3,7,8,15,23,12,35,0.000333,0.04558,3,410.223513,22.790195,136.741171,43.651484,1,0
0,0,8,8,15,18,33,66,34,100,0.000333,0.168146,7,3531.075884,196.170882,504.439412,133.662009,2,0
0,0,14,14,11,23,34,85,48,133,0.000333,0.225544,10,6766.325579,375.906977,676.632558,142.095673,1,0
0,0,3,3,9,8,17,16,11,27,0.000333,0.036787,4,441.445987,24.524777,110.361497,52.529325,2,0
0,0,7,7,11,19,30,44,28,72,0.000333,0.117765,5,1766.480614,98.137812,353.296123,118.764371,2,0
0,0,9,9,12,14,26,44,34,78,0.000333,0.122211,12,4399.611576,244.422865,366.634298,96.322519,1,0
0,0,4,4,4,7,11,13,11,24,0.000333,0.027675,2,166.052718,9.225151,83.026359,27.651484,3,0
0,0,7,7,11,19,30,44,28,72,0.000333,0.117765,5,1766.480614,98.137812,353.296123,118.764371,2,0
0,0,8,8,10,18,28,51,38,89,0.000333,0.142618,10,4278.545881,237.696993,427.854588,108.277931,1,0
0,0,10,10,7,14,21,57,36,93,0.000333,0.136162,6,2450.913122,136.16184,408.48552,72.954453,1,0
0,0,5,5,12,13,25,26,19,45,0.000333,0.069658,6,1253.841171,69.657843,208.973529,91.125266,1,0
0,0,5,5,8,11,19,30,18,48,0.000333,0.067967,4,815.602083,45.311227,203.900521,62.053748,1,0
0,0,7,7,11,19,30,44,28,72,0.000333,0.117765,5,1766.480614,98.137812,353.296123,118.764371,2,0
0,0,7,7,11,19,30,44,28,72,0.000333,0.117765,5,1766.480614,98.137812,353.296123,118.764371,2,0
0,0,3,3,7,8,15,23,12,35,0.000333,0.04558,3,410.223513,22.790195,136.741171,43.651484,1,0
0,0,3,3,8,8,16,20,12,32,0.000333,0.042667,4,512,28.444444,128,48,1,0
0,0,8,8,15,18,33,66,34,100,0.000333,0.168146,7,3531.075884,196.170882,504.439412,133.662009,2,0
0,0,4,4,5,12,17,14,15,29,0.000333,0.039512,2,237.072845,13.170714,118.536422,54.62919,1,0
0,0,5,5,8,10,18,28,17,45,0.000333,0.062549,4,750.5865,41.69925,187.646625,57.219281,1,0
0,0,5,5,8,8,16,25,13,38,0.000333,0.050667,4,608,33.777778,152,48,3,0
0,0,4,4,6,8,14,17,12,29,0.000333,0.036804,3,331.239878,18.402215,110.413293,39.509775,3,0
0,0,7,7,9,13,22,31,22,53,0.000333,0.078783,4,945.399503,52.522195,236.349876,76.635041,1,0
0,0,5,5,8,9,17,78,14,92,0.000333,0.125349,4,1504.186326,83.565907,376.046581,52.529325,1,0
0,0,4,4,4,7,11,13,11,24,0.000333,0.027675,2,166.052718,9.225151,83.026359,27.651484,3,0
0,0,7,7,8,14,22,30,32,62,0.000333,0.092162,8,2211.878083,122.882116,276.48476,77.302969,1,0
0,0,3,3,7,8,15,23,12,35,0.000333,0.04558,3,410.223513,22.790195,136.741171,43.651484,1,0
0,0,3,3,7,8,15,23,12,35,0.000333,0.04558,3,410.223513,22.790195,136.741171,43.651484,1,0
0,0,5,5,8,9,17,32,15,47,0.000333,0.064037,4,768.443014,42.691279,192.110754,52.529325,3,0
0,0,5,5,8,12,20,29,23,52,0.000333,0.074913,4,898.961044,49.94228,224.740261,67.01955,1,0
0,0,7,7,8,10,18,29,21,50,0.000333,0.069499,8,1667.970001,92.665,208.49625,57.219281,1,0
0,0,3,3,9,8,17,16,11,27,0.000333,0.036787,4,441.445987,24.524777,110.361497,52.529325,2,0
0,0,3,3,9,5,14,16,10,26,0.000333,0.032997,8,791.929824,43.996101,98.991228,40.138965,1,0
0,0,3,3,7,5,12,11,7,18,0.000333,0.02151,3,193.587975,10.754888,64.529325,31.261125,1,0
0,0,3,3,7,8,15,23,12,35,0.000333,0.04558,3,410.223513,22.790195,136.741171,43.651484,1,0
0,0,8,8,11,15,26,59,34,93,0.000333,0.145714,10,4371.408938,242.856052,437.140894,96.657107,1,0
0,0,9,9,15,19,34,68,35,103,0.000333,0.17467,7,3668.060709,203.78115,524.008673,139.313982,2,0
0,0,6,6,8,12,20,23,20,43,0.000333,0.061948,4,743.371632,41.298424,185.842908,67.01955,3,0
0,0,4,4,4,7,11,13,11,24,0.000333,0.027675,2,166.052718,9.225151,83.026359,27.651484,3,0
0,0,3,3,7,5,12,11,7,18,0.000333,0.02151,3,193.587975,10.754888,64.529325,31.261125,1,0
0,0,11,11,11,17,28,62,42,104,0.000333,0.166655,10,4999.649119,277.758284,499.964912,107.540616,1,0
0,0,3,3,8,8,16,20,12,32,0.000333,0.042667,4,512,28.444444,128,48,1,0
0,0,12,12,16,22,38,66,52,118,0.000333,0.206418,16,9908.087145,550.449286,619.255447,162.107496,4,0
0,0,4,4,5,12,17,17,17,34,0.000333,0.046325,2,277.947473,15.441526,138.973737,54.62919,1,0
0,0,3,3,5,6,11,10,8,18,0.000333,0.020757,2,124.539538,6.918863,62.269769,27.119415,1,0
0,0,7,7,8,17,25,40,35,75,0.000333,0.116096,8,2786.313714,154.795206,348.289214,93.486868,1,0
0,0,6,6,12,10,22,51,26,77,0.000333,0.114459,12,4120.514816,228.91749,343.376235,76.238831,2,0
0,0,6,6,12,10,22,51,26,77,0.000333,0.114459,12,4120.514816,228.91749,343.376235,76.238831,2,0
0,0,3,3,7,5,12,11,7,18,0.000333,0.02151,3,193.587975,10.754888,64.529325,31.261125,1,0
0,0,3,3,5,6,11,9,8,17,0.000333,0.019603,2,117.620675,6.534482,58.810338,27.119415,1,0
0,0,11,11,12,21,33,58,55,113,0.000333,0.190006,12,6840.198426,380.011024,570.016535,135.258216,1,0
0,0,14,14,11,23,34,85,48,133,0.000333,0.225544,10,6766.325579,375.906977,676.632558,142.095673,1,0
0,0,3,3,7,8,15,23,12,35,0.000333,0.04558,3,410.223513,22.790195,136.741171,43.651484,1,0
0,0,9,9,11,15,26,54,26,80,0.000333,0.125345,5,1880.175887,104.454216,376.035177,96.657107,4,0
0,0,3,3,9,8,17,16,11,27,0.000333,0.036787,4,441.445987,24.524777,110.361497,52.529325,2,0
0,0,9,9,15,20,35,72,36,108,0.000333,0.184654,7,3877.737961,215.429887,553.962566,145.041921,2,0
0,0,5,5,14,10,24,27,14,41,0.000333,0.062661,7,1315.884238,73.10468,187.983463,86.52225,3,0
0,0,7,7,11,19,30,44,28,72,0.000333,0.117765,5,1766.480614,98.137812,353.296123,118.764371,2,0
0,0,7,7,11,19,30,44,28,72,0.000333,0.117765,5,1766.480614,98.137812,353.296123,118.764371,2,0
0,0,5,5,10,11,21,33,18,51,0.000333,0.074669,5,1120.040943,62.224497,224.008189,71.273029,1,0
0,0,7,7,11,18,29,48,28,76,0.000333,0.123069,5,1846.032778,102.557377,369.206556,113.112398,1,0
0,0,5,5,10,10,20,27,14,41,0.000333,0.059066,5,885.995259,49.221959,177.199052,66.438562,3,0
0,0,5,5,8,11,19,30,18,48,0.000333,0.067967,4,815.602083,45.311227,203.900521,62.053748,1,0
0,0,8,8,15,18,33,66,34,100,0.000333,0.168146,7,3531.075884,196.170882,504.439412,133.662009,2,0
0,0,5,5,9,10,19,35,21,56,0.000333,0.079295,8,1903.071526,105.726196,237.883941,61.748606,4,0
0,0,7,7,10,11,21,43,26,69,0.000333,0.101023,10,3030.699022,168.372168,303.069902,71.273029,6,0
0,0,3,3,9,8,17,16,11,27,0.000333,0.036787,4,441.445987,24.524777,110.361497,52.529325,2,0
0,0,5,5,9,10,19,33,21,54,0.000333,0.076463,8,1835.104686,101.95026,229.388086,61.748606,4,0
0,0,5,5,8,12,20,25,19,44,0.000333,0.063388,4,760.659345,42.258852,190.164836,67.01955,1,0
0,0,14,14,11,23,34,85,48,133,0.000333,0.225544,10,6766.325579,375.906977,676.632558,142.095673,1,0
0,0,3,3,5,5,10,12,7,19,0.000333,0.021039,2,126.233268,7.012959,63.116634,23.219281,1,0
0,0,3,3,9,8,17,16,11,27,0.000333,0.036787,4,441.445987,24.524777,110.361497,52.529325,2,0
0,0,5,5,8,11,19,30,18,48,0.000333,0.067967,4,815.602083,45.311227,203.900521,62.053748,1,0
0,0,3,3,7,5,12,11,7,18,0.000333,0.02151,3,193.587975,10.754888,64.529325,31.261125,1,0
0,0,5,5,7,15,22,31,26,57,0.000333,0.084729,3,762.562807,42.3646,254.187602,78.254843,1,0
0,0,4,4,4,7,11,13,11,24,0.000333,0.027675,2,166.052718,9.225151,83.026359,27.651484,3,0
0,0,4,4,8,7,15,16,12,28,0.000333,0.036464,4,437.571747,24.309541,109.392937,43.651484,1,0
0,0,3,3,9,8,17,16,11,27,0.000333,0.036787,4,441.445987,24.524777,110.361497,52.529325,2,0
0,0,5,5,8,10,18,28,17,45,0.000333,0.062549,4,750.5865,41.69925,187.646625,57.219281,1,0
0,0,11,11,12,16,28,53,44,97,0.000333,0.155438,12,5595.761129,310.875618,466.313427,107.01955,1,0
0,0,11,11,15,21,36,84,43,127,0.000333,0.21886,14,9192.126653,510.673703,656.580475,150.842025,2,0
0,0,9,9,15,19,34,68,35,103,0.000333,0.17467,7,3668.060709,203.78115,524.008673,139.313982,2,0
0,0,5,5,8,7,15,21,12,33,0.000333,0.042976,4,515.709559,28.650531,128.92739,43.651484,1,0
0,0,4,4,6,8,14,17,12,29,0.000333,0.036804,3,331.239878,18.402215,110.413293,39.509775,3,0
0,0,6,6,10,11,21,24,21,45,0.000333,0.065885,5,988.27142,54.903968,197.654284,71.273029,1,0
0,0,4,4,10,7,17,25,15,40,0.000333,0.0545,10,1634.985137,90.832508,163.498514,52.870765,1,0
0,0,5,5,7,7,14,16,11,27,0.000333,0.034266,3,308.395749,17.133097,102.798583,39.302969,1,0
0,0,7,7,11,19,30,44,28,72,0.000333,0.117765,5,1766.480614,98.137812,353.296123,118.764371,2,0
0,0,3,3,8,7,15,11,9,20,0.000333,0.026046,4,312.551248,17.363958,78.137812,43.651484,1,0
0,0,4,4,6,8,14,17,12,29,0.000333,0.036804,3,331.239878,18.402215,110.413293,39.509775,3,0
0,0,3,3,10,8,18,16,13,29,0.000333,0.040309,5,604.639125,33.591063,120.927825,57.219281,3,0
0,0,3,3,7,5,12,11,7,18,0.000333,0.02151,3,193.587975,10.754888,64.529325,31.261125,1,0
0,0,4,4,5,7,12,14,10,24,0.000333,0.02868,2,172.0782,9.5599,86.0391,31.261125,2,0
0,0,12,12,14,18,32,57,43,100,0.000333,0.166667,14,7000,388.888889,500,128.361619,2,0
0,0,4,4,6,9,15,16,12,28,0.000333,0.036464,3,328.17881,18.232156,109.392937,44.0391,1,0
0,0,8,8,14,16,30,39,30,69,0.000333,0.112858,7,2370.028158,131.668231,338.575451,117.302969,1,0
0,0,5,5,7,7,14,16,11,27,0.000333,0.034266,3,308.395749,17.133097,102.798583,39.302969,1,0
0,0,4,4,4,7,11,13,11,24,0.000333,0.027675,2,166.052718,9.225151,83.026359,27.651484,3,0
0,0,5,5,8,8,16,24,15,39,0.000333,0.052,4,624,34.666667,156,48,1,0
0,0,7,7,17,14,31,46,29,75,0.000333,0.123855,16,5945.035572,330.279754,371.564723,122.789837,4,0
0,0,3,3,7,5,12,11,7,18,0.000333,0.02151,3,193.587975,10.754888,64.529325,31.261125,1,0
0,0,6,6,9,15,24,40,25,65,0.000333,0.099341,4,1192.09025,66.227236,298.022563,87.132684,1,0
0,0,3,3,9,8,17,16,11,27,0.000333,0.036787,4,441.445987,24.524777,110.361497,52.529325,2,0
0,0,4,4,5,9,14,15,13,28,0.000333,0.035535,2,213.211876,11.845104,106.605938,40.138965,1,0
0,0,6,6,8,12,20,20,21,41,0.000333,0.059066,4,708.796208,39.377567,177.199052,67.01955,1,0
0,0,4,4,9,7,16,17,12,29,0.000333,0.038667,4,464,25.777778,116,48.180809,1,0
0,0,9,9,15,19,34,68,35,103,0.000333,0.17467,7,3668.060709,203.78115,524.008673,139.313982,2,0
0,0,11,11,15,21,36,84,43,127,0.000333,0.21886,14,9192.126653,510.673703,656.580475,150.842025,2,0
0,0,4,4,5,12,17,16,16,32,0.000333,0.0436,2,261.597622,14.533201,130.798811,54.62919,1,0
0,0,9,9,15,19,34,68,35,103,0.000333,0.17467,7,3668.060709,203.78115,524.008673,139.313982,2,0
0,0,8,8,16,19,35,72,39,111,0.000333,0.189783,16,9109.606638,506.089258,569.350415,144.710623,10,0
0,0,5,5,12,16,28,39,25,64,0.000333,0.102557,6,1846.02429,102.556905,307.670715,107.01955,2,0
0,0,3,3,7,8,15,23,12,35,0.000333,0.04558,3,410.223513,22.790195,136.741171,43.651484,1,0
0,0,3,3,8,8,16,20,12,32,0.000333,0.042667,4,512,28.444444,128,48,1,0
0,0,8,8,15,18,33,66,34,100,0.000333,0.168146,7,3531.075884,196.170882,504.439412,133.662009,2,0
0,0,5,5,10,14,24,27,22,49,0.000333,0.074888,5,1123.315813,62.406434,224.663163,86.52225,3,0
0,0,3,3,7,8,15,23,12,35,0.000333,0.04558,3,410.223513,22.790195,136.741171,43.651484,1,0
0,0,4,4,6,8,14,17,12,29,0.000333,0.036804,3,331.239878,18.402215,110.413293,39.509775,3,0
0,0,3,3,7,5,12,11,7,18,0.000333,0.02151,3,193.587975,10.754888,64.529325,31.261125,1,0
0,0,5,5,8,10,18,28,17,45,0.000333,0.062549,4,750.5865,41.69925,187.646625,57.219281,1,0
0,0,7,7,11,19,30,44,28,72,0.000333,0.117765,5,1766.480614,98.137812,353.296123,118.764371,2,0
0,0,5,5,10,10,20,26,15,41,0.000333,0.059066,5,885.995259,49.221959,177.199052,66.438562,1,0
0,0,4,4,6,8,14,17,12,29,0.000333,0.036804,3,331.239878,18.402215,110.413293,39.509775,3,0
0,0,3,3,9,8,17,16,10,26,0.000333,0.035425,4,425.096135,23.616452,106.274034,52.529325,3,0
0,0,5,5,10,11,21,33,18,51,0.000333,0.074669,5,1120.040943,62.224497,224.008189,71.273029,1,0
0,0,7,7,11,19,30,44,28,72,0.000333,0.117765,5,1766.480614,98.137812,353.296123,118.764371,2,0
0,0,3,3,8,7,15,11,9,20,0.000333,0.026046,4,312.551248,17.363958,78.137812,43.651484,1,0
0,0,3,3,7,5,12,11,7,18,0.000333,0.02151,3,193.587975,10.754888,64.529325,31.261125,1,0
0,0,3,3,7,8,15,23,12,35,0.000333,0.04558,3,410.223513,22.790195,136.741171,43.651484,1,0
0,0,4,4,11,10,21,36,17,53,0.000333,0.077598,5,1163.964117,64.664673,232.792823,71.273029,1,0
0,0,8,8,16,17,33,49,35,84,0.000333,0.141243,16,6779.665696,376.648094,423.729106,133.486868,4,0
0,0,9,9,15,19,34,68,35,103,0.000333,0.17467,7,3668.060709,203.78115,524.008673,139.313982,2,0
0,0,8,8,12,13,25,52,25,77,0.000333,0.119192,6,2145.46156,119.192309,357.576927,91.125266,2,0
0,0,3,3,8,8,16,20,12,32,0.000333,0.042667,4,512,28.444444,128,48,1,0
0,0,7,7,9,14,23,21,25,46,0.000333,0.069361,4,832.3354,46.240856,208.08385,81.832294,1,0
0,0,5,5,8,10,18,28,17,45,0.000333,0.062549,4,750.5865,41.69925,187.646625,57.219281,1,0
0,0,7,7,11,19,30,44,28,72,0.000333,0.117765,5,1766.480614,98.137812,353.296123,118.764371,2,0
0,0,13,13,10,17,27,53,41,94,0.000333,0.148986,10,4469.594252,248.310792,446.959425,102.706149,1,0
0,0,6,6,9,10,19,28,17,45,0.000333,0.063719,4,764.626952,42.479275,191.156738,61.748606,1,0
0,0,3,3,7,8,15,23,12,35,0.000333,0.04558,3,410.223513,22.790195,136.741171,43.651484,1,0
0,0,5,5,9,13,22,19,26,45,0.000333,0.066891,8,1605.395383,89.188632,200.674423,76.635041,1,0
0,0,5,5,7,7,14,16,11,27,0.000333,0.034266,3,308.395749,17.133097,102.798583,39.302969,1,0
0,0,11,11,15,21,36,84,43,127,0.000333,0.21886,14,9192.126653,510.673703,656.580475,150.842025,2,0
0,0,3,3,10,9,19,17,13,30,0.000333,0.042479,5,637.189127,35.399396,127.437825,61.748606,1,0
0,0,3,3,8,7,15,11,9,20,0.000333,0.026046,4,312.551248,17.363958,78.137812,43.651484,1,0
0,0,8,8,15,18,33,66,34,100,0.000333,0.168146,7,3531.075884,196.170882,504.439412,133.662009,2,0
0,0,25,25,12,35,47,382,213,595,0.000333,1.10166,36,118979.2932,6609.960733,3304.980367,222.544456,4,0
0,0,5,5,11,12,23,33,21,54,0.000333,0.081424,5,1221.361728,67.853429,244.272346,81.073298,1,0
0,0,21,21,15,27,42,117,68,185,0.000333,0.332526,14,13966.10213,775.894562,997.578723,186.985321,7,0
0,0,3,3,7,8,15,23,12,35,0.000333,0.04558,3,410.223513,22.790195,136.741171,43.651484,1,0
0,0,6,6,14,12,26,43,26,69,0.000333,0.10811,14,4540.624768,252.256932,324.330341,96.322519,4,0
0,0,4,4,12,12,24,42,17,59,0.000333,0.090171,6,1623.076725,90.170929,270.512788,86.0391,5,0
0,0,6,6,7,15,22,29,33,62,0.000333,0.092162,6,1658.908562,92.161587,276.48476,78.254843,1,0
0,0,3,3,7,8,15,15,10,25,0.000333,0.032557,3,293.016795,16.278711,97.672265,43.651484,2,0
0,0,3,3,9,8,17,16,11,27,0.000333,0.036787,4,441.445987,24.524777,110.361497,52.529325,2,0
0,0,4,4,5,12,17,16,16,32,0.000333,0.0436,2,261.597622,14.533201,130.798811,54.62919,1,0
0,0,3,3,7,8,15,23,12,35,0.000333,0.04558,3,410.223513,22.790195,136.741171,43.651484,1,0
0,0,6,6,8,10,18,30,21,51,0.000333,0.070889,8,1701.329401,94.5183,212.666175,57.219281,1,0
0,0,3,3,10,8,18,19,11,30,0.000333,0.041699,5,625.48875,34.749375,125.09775,57.219281,1,0
0,0,3,3,7,5,12,11,7,18,0.000333,0.02151,3,193.587975,10.754888,64.529325,31.261125,1,0
0,0,5,5,8,10,18,28,17,45,0.000333,0.062549,4,750.5865,41.69925,187.646625,57.219281,1,0
0,0,7,7,11,19,30,44,28,72,0.000333,0.117765,5,1766.480614,98.137812,353.296123,118.764371,2,0
0,0,6,6,7,16,23,36,29,65,0.000333,0.098011,3,882.094581,49.005255,294.031527,83.651484,1,0
0,0,3,3,7,8,15,23,12,35,0.000333,0.04558,3,410.223513,22.790195,136.741171,43.651484,1,0
0,0,4,4,10,15,25,32,21,53,0.000333,0.082041,5,1230.62189,68.367883,246.124378,91.82264,1,0
0,0,4,4,4,7,11,13,11,24,0.000333,0.027675,2,166.052718,9.225151,83.026359,27.651484,3,0
0,0,3,3,8,7,15,15,9,24,0.000333,0.031255,4,375.061497,20.83675,93.765374,43.651484,3,0
0,0,4,4,4,6,10,16,12,28,0.000333,0.031005,4,372.055947,20.669775,93.013987,23.509775,1,0
0,0,5,5,10,7,17,20,16,36,0.000333,0.04905,10,1471.486623,81.749257,147.148662,52.870765,1,0
0,0,6,6,8,11,19,34,22,56,0.000333,0.079295,8,1903.071526,105.726196,237.883941,62.053748,1,0
0,0,4,4,7,14,21,25,22,47,0.000333,0.068813,3,619.316757,34.406486,206.438919,72.954453,1,0
0,0,8,8,15,18,33,66,34,100,0.000333,0.168146,7,3531.075884,196.170882,504.439412,133.662009,2,0
0,0,5,5,8,10,18,28,17,45,0.000333,0.062549,4,750.5865,41.69925,187.646625,57.219281,1,0
0,0,4,4,8,9,17,24,13,37,0.000333,0.050412,4,604.944501,33.608028,151.236125,52.529325,1,0
0,0,11,11,15,21,36,84,43,127,0.000333,0.21886,14,9192.126653,510.673703,656.580475,150.842025,2,0
0,0,8,8,15,18,33,66,34,100,0.000333,0.168146,7,3531.075884,196.170882,504.439412,133.662009,2,0
0,0,4,4,8,8,16,23,14,37,0.000333,0.049333,4,592,32.888889,148,48,1,0
0,0,4,4,9,7,16,26,16,42,0.000333,0.056,8,1344,74.666667,168,48.180809,1,0
0,0,6,6,8,10,18,30,19,49,0.000333,0.068109,4,817.3053,45.40585,204.326325,57.219281,1,0
0,0,8,8,8,19,27,46,38,84,0.000333,0.133137,8,3195.284401,177.5158,399.41055,104.710623,1,0
0,0,4,4,9,7,16,17,12,29,0.000333,0.038667,4,464,25.777778,116,48.180809,1,0
0,0,9,9,12,17,29,45,43,88,0.000333,0.142501,12,5130.027931,285.001552,427.502328,112.506418,1,0
0,0,4,4,9,8,17,20,12,32,0.000333,0.0436,4,523.195244,29.066402,130.798811,52.529325,1,0
0,0,5,5,8,10,18,26,15,41,0.000333,0.056989,4,683.8677,37.99265,170.966925,57.219281,1,0
0,0,5,5,8,10,18,28,17,45,0.000333,0.062549,4,750.5865,41.69925,187.646625,57.219281,1,0
0,0,4,4,4,7,11,13,11,24,0.000333,0.027675,2,166.052718,9.225151,83.026359,27.651484,3,0
0,0,3,3,7,8,15,23,12,35,0.000333,0.04558,3,410.223513,22.790195,136.741171,43.651484,1,0
0,0,4,4,7,7,14,15,10,25,0.000333,0.031728,3,285.551619,15.863979,95.183873,39.302969,1,0
0,0,4,4,7,8,15,16,12,28,0.000333,0.036464,3,328.17881,18.232156,109.392937,43.651484,3,0
0,0,4,4,4,7,11,13,11,24,0.000333,0.027675,2,166.052718,9.225151,83.026359,27.651484,3,0
0,0,5,5,8,10,18,28,17,45,0.000333,0.062549,4,750.5865,41.69925,187.646625,57.219281,1,0
0,0,4,4,4,7,11,13,11,24,0.000333,0.027675,2,166.052718,9.225151,83.026359,27.651484,3,0
0,0,11,11,15,21,36,84,43,127,0.000333,0.21886,14,9192.126653,510.673703,656.580475,150.842025,2,0
0,0,3,3,7,8,15,23,12,35,0.000333,0.04558,3,410.223513,22.790195,136.741171,43.651484,1,0
0,0,5,5,8,10,18,28,17,45,0.000333,0.062549,4,750.5865,41.69925,187.646625,57.219281,1,0
0,0,6,6,8,13,21,42,25,67,0.000333,0.098095,4,1177.141069,65.396726,294.285267,72.105716,1,0
0,0,4,4,6,8,14,17,12,29,0.000333,0.036804,3,331.239878,18.402215,110.413293,39.509775,3,0
0,0,5,5,8,10,18,28,17,45,0.000333,0.062549,4,750.5865,41.69925,187.646625,57.219281,1,0
0,0,4,4,7,10,17,23,16,39,0.000333,0.053137,3,478.233152,26.568508,159.411051,52.870765,1,0
0,0,5,5,7,7,14,16,11,27,0.000333,0.034266,3,308.395749,17.133097,102.798583,39.302969,1,0
0,0,4,4,6,10,16,26,15,41,0.000333,0.054667,3,492,27.333333,164,48.729056,3,0
0,0,4,4,17,14,31,30,20,50,0.000333,0.08257,8,1981.678524,110.093251,247.709816,122.789837,1,0
0,0,3,3,9,8,17,16,11,27,0.000333,0.036787,4,441.445987,24.524777,110.361497,52.529325,2,0
0,0,25,25,12,35,47,382,213,595,0.000333,1.10166,36,118979.2932,6609.960733,3304.980367,222.544456,4,0
0,0,9,9,12,14,26,44,34,78,0.000333,0.122211,12,4399.611576,244.422865,366.634298,96.322519,1,0
0,0,3,3,7,5,12,11,7,18,0.000333,0.02151,3,193.587975,10.754888,64.529325,31.261125,1,0
0,0,21,21,13,28,41,118,69,187,0.000333,0.333954,12,12022.3467,667.90815,1001.862225,182.711654,1,0
0,0,25,25,12,35,47,382,213,595,0.000333,1.10166,36,118979.2932,6609.960733,3304.980367,222.544456,4,0
0,0,5,5,11,12,23,33,21,54,0.000333,0.081424,5,1221.361728,67.853429,244.272346,81.073298,1,0
0,0,8,8,15,18,33,66,34,100,0.000333,0.168146,7,3531.075884,196.170882,504.439412,133.662009,2,0
0,0,4,4,5,7,12,14,10,24,0.000333,0.02868,2,172.0782,9.5599,86.0391,31.261125,2,0
0,0,8,8,10,16,26,38,31,69,0.000333,0.10811,5,1621.651703,90.091761,324.330341,97.219281,1,0
0,0,3,3,8,7,15,11,9,20,0.000333,0.026046,4,312.551248,17.363958,78.137812,43.651484,1,0
0,0,7,7,11,19,30,44,28,72,0.000333,0.117765,5,1766.480614,98.137812,353.296123,118.764371,2,0
0,0,4,4,4,7,11,13,11,24,0.000333,0.027675,2,166.052718,9.225151,83.026359,27.651484,3,0
0,0,7,7,14,15,29,42,31,73,0.000333,0.118211,14,4964.856577,275.825365,354.632613,111.906328,4,0
0,0,5,5,10,10,20,26,15,41,0.000333,0.059066,5,885.995259,49.221959,177.199052,66.438562,1,0
0,0,3,3,7,5,12,11,7,18,0.000333,0.02151,3,193.587975,10.754888,64.529325,31.261125,1,0
0,0,3,3,8,7,15,11,9,20,0.000333,0.026046,4,312.551248,17.363958,78.137812,43.651484,1,0
0,0,3,3,8,8,16,20,12,32,0.000333,0.042667,4,512,28.444444,128,48,1,0
0,0,4,4,4,7,11,17,13,30,0.000333,0.034594,2,207.565897,11.531439,103.782949,27.651484,3,0
0,0,5,5,8,12,20,25,19,44,0.000333,0.063388,4,760.659345,42.258852,190.164836,67.01955,1,0
0,0,4,4,9,13,22,22,17,39,0.000333,0.057973,4,695.671333,38.648407,173.917833,76.635041,3,0
0,0,4,4,6,8,14,17,12,29,0.000333,0.036804,3,331.239878,18.402215,110.413293,39.509775,3,0
0,0,5,5,9,8,17,29,19,48,0.000333,0.065399,8,1569.585731,87.199207,196.198216,52.529325,1,0
0,0,3,3,14,9,23,26,12,38,0.000333,0.057298,7,1203.26748,66.848193,171.895354,81.832294,3,0
0,0,4,4,4,7,11,13,11,24,0.000333,0.027675,2,166.052718,9.225151,83.026359,27.651484,3,0
0,0,3,3,9,8,17,16,11,27,0.000333,0.036787,4,441.445987,24.524777,110.361497,52.529325,2,0
0,0,9,9,15,19,34,68,35,103,0.000333,0.17467,7,3668.060709,203.78115,524.008673,139.313982,2,0
0,0,5,5,6,11,17,24,18,42,0.000333,0.057224,3,515.020318,28.61224,171.673439,53.563523,1,0
0,0,3,3,10,8,18,16,13,29,0.000333,0.040309,5,604.639125,33.591063,120.927825,57.219281,3,0
0,0,4,4,5,7,12,14,10,24,0.000333,0.02868,2,172.0782,9.5599,86.0391,31.261125,2,0
0,0,9,9,14,17,31,47,34,81,0.000333,0.133763,14,5618.058616,312.114368,401.289901,122.789837,2,0
0,0,5,5,7,8,15,17,12,29,0.000333,0.037767,3,339.899482,18.883305,113.299827,43.651484,1,0
0,0,4,4,8,7,15,17,12,29,0.000333,0.037767,4,453.199309,25.177739,113.299827,43.651484,1,0
0,0,10,10,13,24,37,53,45,98,0.000333,0.170175,6,3063.158579,170.175477,510.52643,158.144816,1,0
0,0,3,3,8,7,15,11,9,20,0.000333,0.026046,4,312.551248,17.363958,78.137812,43.651484,1,0
0,0,7,7,10,14,24,27,25,52,0.000333,0.079473,5,1192.09025,66.227236,238.41805,86.52225,1,0
0,0,3,3,7,5,12,11,7,18,0.000333,0.02151,3,193.587975,10.754888,64.529325,31.261125,1,0
0,0,5,5,7,12,19,33,22,55,0.000333,0.077879,3,700.90804,38.939336,233.636013,62.671034,1,0
0,0,7,7,9,16,25,24,30,54,0.000333,0.083589,4,1003.072937,55.726274,250.768234,92.529325,1,0
0,0,6,6,9,10,19,28,17,45,0.000333,0.063719,4,764.626952,42.479275,191.156738,61.748606,1,0
0,0,7,7,11,19,30,44,28,72,0.000333,0.117765,5,1766.480614,98.137812,353.296123,118.764371,2,0
0,0,5,5,11,12,23,33,21,54,0.000333,0.081424,5,1221.361728,67.853429,244.272346,81.073298,1,0
0,0,10,10,14,18,32,49,38,87,0.000333,0.145,14,6090,338.333333,435,128.361619,2,0
0,0,16,16,11,26,37,113,60,173,0.000333,0.300412,10,9012.354323,500.686351,901.235432,160.26518,5,0
0,0,7,7,10,14,24,40,27,67,0.000333,0.102397,5,1535.962438,85.331247,307.192488,86.52225,1,0
0,0,6,6,9,12,21,42,26,68,0.000333,0.099559,8,2389.420678,132.745593,298.677585,71.548875,1,0
0,0,4,4,9,9,18,26,18,44,0.000333,0.061159,8,1467.813601,81.5452,183.4767,57.05865,1,0
0,0,5,5,7,15,22,19,23,42,0.000333,0.062432,3,561.888384,31.216021,187.296128,78.254843,1,0
0,0,4,4,4,7,11,13,11,24,0.000333,0.027675,2,166.052718,9.225151,83.026359,27.651484,3,0
0,0,4,4,5,12,17,17,17,34,0.000333,0.046325,2,277.947473,15.441526,138.973737,54.62919,1,0
0,0,4,4,10,9,19,19,18,37,0.000333,0.052391,10,1571.73318,87.31851,157.173318,61.748606,1,0
0,0,5,5,8,10,18,28,17,45,0.000333,0.062549,4,750.5865,41.69925,187.646625,57.219281,1,0
0,0,19,19,11,29,40,102,64,166,0.000333,0.29448,10,8834.400638,490.800035,883.440064,178.935197,1,0
0,0,6,6,7,13,20,35,24,59,0.000333,0.084998,3,764.981273,42.49896,254.993758,67.757201,1,0
0,0,4,4,7,11,18,24,17,41,0.000333,0.056989,3,512.900775,28.494488,170.966925,57.705232,1,0
0,0,6,6,9,10,19,28,17,45,0.000333,0.063719,4,764.626952,42.479275,191.156738,61.748606,1,0
0,0,17,17,14,22,36,681,56,737,0.000333,1.270078,14,53343.28617,2963.515898,3810.234726,151.410465,2,0
0,0,3,3,9,7,16,24,10,34,0.000333,0.045333,4,544,30.222222,136,48.180809,3,0
0,0,9,9,15,19,34,68,35,103,0.000333,0.17467,7,3668.060709,203.78115,524.008673,139.313982,2,0
0,0,10,10,10,22,32,54,39,93,0.000333,0.155,5,2325,129.166667,465,131.326777,4,0
0,0,6,6,8,12,20,20,21,41,0.000333,0.059066,4,708.796208,39.377567,177.199052,67.01955,1,0
0,0,8,8,15,18,33,66,34,100,0.000333,0.168146,7,3531.075884,196.170882,504.439412,133.662009,2,0
0,0,3,3,10,8,18,16,13,29,0.000333,0.040309,5,604.639125,33.591063,120.927825,57.219281,3,0
0,0,4,4,8,11,19,27,17,44,0.000333,0.062303,4,747.635242,41.535291,186.908811,62.053748,1,0
0,0,6,6,8,13,21,42,25,67,0.000333,0.098095,4,1177.141069,65.396726,294.285267,72.105716,1,0
0,0,4,4,11,10,21,29,18,47,0.000333,0.068813,5,1032.194594,57.344144,206.438919,71.273029,1,0
0,0,5,5,10,11,21,33,18,51,0.000333,0.074669,5,1120.040943,62.224497,224.008189,71.273029,1,0
0,0,3,3,7,8,15,23,12,35,0.000333,0.04558,3,410.223513,22.790195,136.741171,43.651484,1,0
0,0,7,7,10,18,28,42,30,72,0.000333,0.115377,5,1730.647772,96.147098,346.129554,108.277931,1,0
0,0,4,4,4,7,11,13,11,24,0.000333,0.027675,2,166.052718,9.225151,83.026359,27.651484,3,0
0,0,6,6,14,12,26,41,24,65,0.000333,0.101843,14,4277.400144,237.633341,305.528582,96.322519,5,0
0,0,4,4,4,7,11,13,11,24,0.000333,0.027675,2,166.052718,9.225151,83.026359,27.651484,3,0
0,0,3,3,7,8,15,23,12,35,0.000333,0.04558,3,410.223513,22.790195,136.741171,43.651484,1,0
0,0,5,5,11,11,22,31,17,48,0.000333,0.071351,5,1070.263588,59.459088,214.052718,76.107496,1,0
0,0,5,5,11,12,23,33,21,54,0.000333,0.081424,5,1221.361728,67.853429,244.272346,81.073298,1,0
0,0,3,3,9,8,17,16,11,27,0.000333,0.036787,4,441.445987,24.524777,110.361497,52.529325,2,0
0,0,3,3,7,8,15,23,12,35,0.000333,0.04558,3,410.223513,22.790195,136.741171,43.651484,1,0
0,0,6,6,7,11,18,41,25,66,0.000333,0.091738,6,1651.290301,91.73835,275.21505,57.705232,1,0
0,0,4,4,10,15,25,32,21,53,0.000333,0.082041,5,1230.62189,68.367883,246.124378,91.82264,1,0
0,0,3,3,7,5,12,11,7,18,0.000333,0.02151,3,193.587975,10.754888,64.529325,31.261125,1,0
0,0,3,3,8,8,16,20,12,32,0.000333,0.042667,4,512,28.444444,128,48,1,0
0,0,8,8,15,18,33,66,34,100,0.000333,0.168146,7,3531.075884,196.170882,504.439412,133.662009,2,0
0,0,11,11,15,21,36,84,43,127,0.000333,0.21886,14,9192.126653,510.673703,656.580475,150.842025,2,0
0,0,9,9,15,19,34,68,35,103,0.000333,0.17467,7,3668.060709,203.78115,524.008673,139.313982,2,0
0,0,7,7,11,19,30,44,28,72,0.000333,0.117765,5,1766.480614,98.137812,353.296123,118.764371,2,0
0,0,6,6,7,11,18,41,25,66,0.000333,0.091738,6,1651.290301,91.73835,275.21505,57.705232,1,0
0,0,3,3,8,8,16,20,12,32,0.000333,0.042667,4,512,28.444444,128,48,1,0
0,0,4,4,6,8,14,17,12,29,0.000333,0.036804,3,331.239878,18.402215,110.413293,39.509775,3,0
0,0,15,15,10,24,34,87,57,144,0.000333,0.244198,10,7325.946491,406.997027,732.594649,143.258381,1,0
0,0,3,3,10,10,20,16,13,29,0.000333,0.041779,5,626.679574,34.815532,125.335915,66.438562,1,0
0,0,6,6,14,12,26,43,26,69,0.000333,0.10811,14,4540.624768,252.256932,324.330341,96.322519,4,0
0,0,6,6,8,13,21,42,25,67,0.000333,0.098095,4,1177.141069,65.396726,294.285267,72.105716,1,0
0,0,4,4,8,11,19,27,17,44,0.000333,0.062303,4,747.635242,41.535291,186.908811,62.053748,1,0
0,0,7,7,11,19,30,44,28,72,0.000333,0.117765,5,1766.480614,98.137812,353.296123,118.764371,2,0
0,0,3,3,10,8,18,16,13,29,0.000333,0.040309,5,604.639125,33.591063,120.927825,57.219281,3,0
0,0,7,7,11,18,29,48,28,76,0.000333,0.123069,5,1846.032778,102.557377,369.206556,113.112398,1,0
0,0,3,3,7,8,15,23,12,35,0.000333,0.04558,3,410.223513,22.790195,136.741171,43.651484,1,0
0,0,4,4,4,7,11,13,11,24,0.000333,0.027675,2,166.052718,9.225151,83.026359,27.651484,3,0
0,0,3,3,7,5,12,11,7,18,0.000333,0.02151,3,193.587975,10.754888,64.529325,31.261125,1,0
0,0,5,5,7,16,23,31,27,58,0.000333,0.087456,3,787.09978,43.727766,262.366593,83.651484,1,0
0,0,4,4,10,15,25,32,21,53,0.000333,0.082041,5,1230.62189,68.367883,246.124378,91.82264,1,0
0,0,7,7,11,19,30,44,28,72,0.000333,0.117765,5,1766.480614,98.137812,353.296123,118.764371,2,0
0,0,5,5,8,10,18,28,17,45,0.000333,0.062549,4,750.5865,41.69925,187.646625,57.219281,1,0
0,0,11,11,11,16,27,52,38,90,0.000333,0.142647,10,4279.398752,237.744375,427.939875,102.053748,1,0
0,0,5,5,8,10,18,28,17,45,0.000333,0.062549,4,750.5865,41.69925,187.646625,57.219281,1,0
0,0,3,3,9,8,17,16,11,27,0.000333,0.036787,4,441.445987,24.524777,110.361497,52.529325,2,0
0,0,9,9,15,19,34,68,35,103,0.000333,0.17467,7,3668.060709,203.78115,524.008673,139.313982,2,0
0,0,11,11,15,21,36,84,43,127,0.000333,0.21886,14,9192.126653,510.673703,656.580475,150.842025,2,0
0,0,25,25,12,35,47,382,213,595,0.000333,1.10166,36,118979.2932,6609.960733,3304.980367,222.544456,4,0
0,0,8,8,15,18,33,66,34,100,0.000333,0.168146,7,3531.075884,196.170882,504.439412,133.662009,2,0
0,0,10,10,15,27,42,169,61,230,0.000333,0.413411,14,17363.2621,964.625672,1240.233007,186.985321,7,0
0,0,9,9,15,19,34,68,35,103,0.000333,0.17467,7,3668.060709,203.78115,524.008673,139.313982,2,0
0,0,11,11,15,21,36,84,43,127,0.000333,0.21886,14,9192.126653,510.673703,656.580475,150.842025,2,0
0,0,3,3,9,8,17,16,11,27,0.000333,0.036787,4,441.445987,24.524777,110.361497,52.529325,2,0
0,0,4,4,7,14,21,23,19,42,0.000333,0.061492,3,553.431995,30.746222,184.477332,72.954453,1,0
0,0,3,3,8,7,15,20,12,32,0.000333,0.041673,4,500.081996,27.782333,125.020499,43.651484,1,0
0,0,8,8,11,16,27,36,29,65,0.000333,0.103023,5,1545.338438,85.852135,309.067688,102.053748,1,0
0,0,3,3,8,7,15,15,9,24,0.000333,0.031255,4,375.061497,20.83675,93.765374,43.651484,3,0
0,0,11,11,15,21,36,84,43,127,0.000333,0.21886,14,9192.126653,510.673703,656.580475,150.842025,2,0
0,0,9,9,15,19,34,68,35,103,0.000333,0.17467,7,3668.060709,203.78115,524.008673,139.313982,2,0
0,0,8,8,15,18,33,66,34,100,0.000333,0.168146,7,3531.075884,196.170882,504.439412,133.662009,2,0
0,0,6,6,7,11,18,41,25,66,0.000333,0.091738,6,1651.290301,91.73835,275.21505,57.705232,1,0
0,0,9,9,15,19,34,68,35,103,0.000333,0.17467,7,3668.060709,203.78115,524.008673,139.313982,2,0
0,0,18,18,12,26,38,109,60,169,0.000333,0.295633,12,10642.797,591.2665,886.89975,165.230983,5,0
0,0,3,3,8,6,14,11,9,20,0.000333,0.025382,4,304.588394,16.921577,76.147098,39.509775,1,0
0,0,4,4,4,7,11,13,11,24,0.000333,0.027675,2,166.052718,9.225151,83.026359,27.651484,3,0
0,0,7,7,11,19,30,44,28,72,0.000333,0.117765,5,1766.480614,98.137812,353.296123,118.764371,2,0
0,0,3,3,8,7,15,15,9,24,0.000333,0.031255,4,375.061497,20.83675,93.765374,43.651484,3,0
0,0,4,4,8,7,15,16,11,27,0.000333,0.035162,4,421.944184,23.441344,105.486046,43.651484,1,0
0,0,6,6,7,11,18,41,25,66,0.000333,0.091738,6,1651.290301,91.73835,275.21505,57.705232,1,0
0,0,11,11,12,18,30,69,40,109,0.000333,0.178284,12,6418.212899,356.567383,534.851075,118.0782,2,0
0,0,5,5,8,10,18,28,17,45,0.000333,0.062549,4,750.5865,41.69925,187.646625,57.219281,1,0
0,0,3,3,8,7,15,11,9,20,0.000333,0.026046,4,312.551248,17.363958,78.137812,43.651484,1,0
0,0,6,6,9,10,19,28,17,45,0.000333,0.063719,4,764.626952,42.479275,191.156738,61.748606,1,0
0,0,3,3,7,5,12,11,7,18,0.000333,0.02151,3,193.587975,10.754888,64.529325,31.261125,1,0
0,0,6,6,14,12,26,41,24,65,0.000333,0.101843,14,4277.400144,237.633341,305.528582,96.322519,5,0
0,0,11,11,15,21,36,84,43,127,0.000333,0.21886,14,9192.126653,510.673703,656.580475,150.842025,2,0
0,0,8,8,15,18,33,66,34,100,0.000333,0.168146,7,3531.075884,196.170882,504.439412,133.662009,2,0
0,0,5,5,9,13,22,32,25,57,0.000333,0.084729,4,1016.750409,56.486134,254.187602,76.635041,1,0
0,0,4,4,6,8,14,17,12,29,0.000333,0.036804,3,331.239878,18.402215,110.413293,39.509775,3,0
0,0,7,7,14,16,30,42,33,75,0.000333,0.122672,14,5152.235125,286.235285,368.016795,117.302969,4,0
0,0,3,3,8,8,16,20,12,32,0.000333,0.042667,4,512,28.444444,128,48,1,0
0,0,7,7,11,19,30,44,28,72,0.000333,0.117765,5,1766.480614,98.137812,353.296123,118.764371,2,0
0,0,3,3,9,8,17,16,11,27,0.000333,0.036787,4,441.445987,24.524777,110.361497,52.529325,2,0
0,0,7,7,11,19,30,44,28,72,0.000333,0.117765,5,1766.480614,98.137812,353.296123,118.764371,2,0
0,0,3,3,8,6,14,11,9,20,0.000333,0.025382,4,304.588394,16.921577,76.147098,39.509775,1,0
0,0,4,4,7,13,20,23,18,41,0.000333,0.059066,3,531.597156,29.533175,177.199052,67.757201,1,0
0,0,5,5,8,10,18,28,17,45,0.000333,0.062549,4,750.5865,41.69925,187.646625,57.219281,1,0
0,0,13,13,9,18,27,123,44,167,0.000333,0.264689,8,6352.529703,352.918317,794.066213,103.587975,3,0
0,0,3,3,8,7,15,20,12,32,0.000333,0.041673,4,500.081996,27.782333,125.020499,43.651484,1,0
0,0,27,27,13,19,32,175,83,258,0.000333,0.43,24,30960,1720,1290,128.816339,27,0
0,0,8,8,15,18,33,66,34,100,0.000333,0.168146,7,3531.075884,196.170882,504.439412,133.662009,2,0
0,0,4,4,4,7,11,13,11,24,0.000333,0.027675,2,166.052718,9.225151,83.026359,27.651484,3,0
0,0,3,3,7,8,15,23,12,35,0.000333,0.04558,3,410.223513,22.790195,136.741171,43.651484,1,0
0,0,6,6,9,9,18,28,19,47,0.000333,0.065329,8,1567.891801,87.1051,195.986475,57.05865,1,0
0,0,4,4,9,7,16,16,11,27,0.000333,0.036,4,432,24,108,48.180809,1,0
0,0,6,6,8,13,21,42,25,67,0.000333,0.098095,4,1177.141069,65.396726,294.285267,72.105716,1,0
0,0,7,7,11,19,30,44,28,72,0.000333,0.117765,5,1766.480614,98.137812,353.296123,118.764371,2,0
0,0,4,4,8,11,19,27,17,44,0.000333,0.062303,4,747.635242,41.535291,186.908811,62.053748,1,0
0,0,3,3,5,6,11,9,8,17,0.000333,0.019603,2,117.620675,6.534482,58.810338,27.119415,1,0
0,0,4,4,4,7,11,13,11,24,0.000333,0.027675,2,166.052718,9.225151,83.026359,27.651484,3,0
0,0,3,3,8,7,15,20,12,32,0.000333,0.041673,4,500.081996,27.782333,125.020499,43.651484,1,0
0,0,6,6,9,12,21,40,22,62,0.000333,0.090775,4,1089.294721,60.516373,272.32368,71.548875,1,0
0,0,3,3,7,8,15,23,12,35,0.000333,0.04558,3,410.223513,22.790195,136.741171,43.651484,1,0
0,0,4,4,10,9,19,22,13,35,0.000333,0.049559,5,743.387315,41.299295,148.677463,61.748606,1,0
0,0,7,7,14,12,26,51,31,82,0.000333,0.128479,14,5396.104796,299.7836,385.436057,96.322519,4,0
0,0,5,5,9,11,20,19,16,35,0.000333,0.050422,4,605.069933,33.614996,151.267483,66.583073,1,0
0,0,3,3,7,5,12,11,7,18,0.000333,0.02151,3,193.587975,10.754888,64.529325,31.261125,1,0
0,0,3,3,6,9,15,26,11,37,0.000333,0.048185,3,433.664856,24.092492,144.554952,44.0391,1,0
0,0,5,5,7,7,14,16,11,27,0.000333,0.034266,3,308.395749,17.133097,102.798583,39.302969,1,0
0,0,4,4,6,13,19,17,17,34,0.000333,0.048143,3,433.288606,24.071589,144.429535,63.615491,1,0
0,0,7,7,11,19,30,44,28,72,0.000333,0.117765,5,1766.480614,98.137812,353.296123,118.764371,2,0
0,0,3,3,8,8,16,20,12,32,0.000333,0.042667,4,512,28.444444,128,48,1,0
0,0,4,4,9,7,16,17,12,29,0.000333,0.038667,4,464,25.777778,116,48.180809,1,0
0,0,3,3,11,11,22,26,15,41,0.000333,0.060946,5,914.183482,50.787971,182.836696,76.107496,3,0
0,0,8,8,15,18,33,66,34,100,0.000333,0.168146,7,3531.075884,196.170882,504.439412,133.662009,2,0
0,0,3,3,7,8,15,23,12,35,0.000333,0.04558,3,410.223513,22.790195,136.741171,43.651484,1,0
0,0,4,4,4,7,11,13,11,24,0.000333,0.027675,2,166.052718,9.225151,83.026359,27.651484,3,0
0,0,9,9,11,12,23,34,29,63,0.000333,0.094995,10,2849.844032,158.324668,284.984403,81.073298,1,0
0,0,3,3,12,9,21,21,11,32,0.000333,0.046851,6,843.324945,46.851386,140.554158,71.548875,3,0
0,0,7,7,11,19,30,44,28,72,0.000333,0.117765,5,1766.480614,98.137812,353.296123,118.764371,2,0
0,0,6,6,10,11,21,24,21,45,0.000333,0.065885,5,988.27142,54.903968,197.654284,71.273029,1,0
0,0,3,3,7,8,15,23,12,35,0.000333,0.04558,3,410.223513,22.790195,136.741171,43.651484,1,0
0,0,3,3,8,8,16,20,12,32,0.000333,0.042667,4,512,28.444444,128,48,1,0
0,0,25,25,12,35,47,382,213,595,0.000333,1.10166,36,118979.2932,6609.960733,3304.980367,222.544456,4,0
0,0,5,5,8,13,21,25,20,45,0.000333,0.065885,4,790.617136,43.923174,197.654284,72.105716,1,0
0,0,6,6,14,11,25,40,23,63,0.000333,0.097521,14,4095.881159,227.548953,292.56294,91.356717,4,0
0,0,3,3,8,7,15,11,9,20,0.000333,0.026046,4,312.551248,17.363958,78.137812,43.651484,1,0
0,0,7,7,13,12,25,52,32,84,0.000333,0.130028,12,4681.007039,260.055947,390.08392,91.125266,7,0
0,0,26,26,11,32,43,167,96,263,0.000333,0.475703,15,21406.61446,1189.256359,1427.10763,198.053748,7,0
0,0,7,7,8,13,21,20,22,42,0.000333,0.061492,4,737.909327,40.994963,184.477332,72.105716,1,0
0,0,6,6,8,9,17,27,17,44,0.000333,0.059949,4,719.39346,39.966303,179.848365,52.529325,1,0
0,0,6,6,9,10,19,28,17,45,0.000333,0.063719,4,764.626952,42.479275,191.156738,61.748606,1,0
0,0,4,4,6,8,14,17,12,29,0.000333,0.036804,3,331.239878,18.402215,110.413293,39.509775,3,0
0,0,3,3,9,8,17,16,10,26,0.000333,0.035425,4,425.096135,23.616452,106.274034,52.529325,3,0
0,0,3,3,6,9,15,26,11,37,0.000333,0.048185,3,433.664856,24.092492,144.554952,44.0391,1,0
0,0,3,3,7,8,15,23,12,35,0.000333,0.04558,3,410.223513,22.790195,136.741171,43.651484,1,0
0,0,8,8,15,18,33,66,34,100,0.000333,0.168146,7,3531.075884,196.170882,504.439412,133.662009,2,0
0,0,6,6,9,13,22,27,21,48,0.000333,0.071351,4,856.210871,47.567271,214.052718,76.635041,1,0
0,0,4,4,5,12,17,16,16,32,0.000333,0.0436,2,261.597622,14.533201,130.798811,54.62919,1,0
0,0,6,6,10,11,21,24,21,45,0.000333,0.065885,5,988.27142,54.903968,197.654284,71.273029,1,0
0,0,4,4,5,9,14,15,13,28,0.000333,0.035535,2,213.211876,11.845104,106.605938,40.138965,1,0
0,0,4,4,7,9,16,46,28,74,0.000333,0.098667,9,2664,148,296,48.180809,1,0
0,0,3,3,7,8,15,23,12,35,0.000333,0.04558,3,410.223513,22.790195,136.741171,43.651484,1,0
0,0,9,9,10,16,26,28,35,63,0.000333,0.098709,10,2961.277022,164.51539,296.127702,97.219281,1,0
0,0,3,3,8,6,14,11,9,20,0.000333,0.025382,4,304.588394,16.921577,76.147098,39.509775,1,0
0,0,3,3,8,8,16,20,12,32,0.000333,0.042667,4,512,28.444444,128,48,1,0
0,0,8,8,10,18,28,44,39,83,0.000333,0.133003,10,3990.104585,221.672477,399.010459,108.277931,1,0
0,0,5,5,8,13,21,28,27,55,0.000333,0.080526,8,1932.619666,107.367759,241.577458,72.105716,1,0
0,0,5,5,11,12,23,33,21,54,0.000333,0.081424,5,1221.361728,67.853429,244.272346,81.073298,1,0
0,0,21,21,13,31,44,107,71,178,0.000333,0.323926,12,11661.34594,647.852552,971.778828,201.685802,6,0
0,0,17,17,11,28,39,93,60,153,0.000333,0.269556,10,8086.665395,449.259189,808.666539,172.659686,1,0
0,0,7,7,11,19,30,44,28,72,0.000333,0.117765,5,1766.480614,98.137812,353.296123,118.764371,2,0
0,0,10,10,14,18,32,51,39,90,0.000333,0.15,14,6300,350,450,128.361619,2,0
0,0,4,4,5,7,12,14,10,24,0.000333,0.02868,2,172.0782,9.5599,86.0391,31.261125,2,0
0,0,5,5,8,10,18,28,17,45,0.000333,0.062549,4,750.5865,41.69925,187.646625,57.219281,1,0
0,0,9,9,15,19,34,68,35,103,0.000333,0.17467,7,3668.060709,203.78115,524.008673,139.313982,2,0
0,0,11,11,15,21,36,84,43,127,0.000333,0.21886,14,9192.126653,510.673703,656.580475,150.842025,2,0
0,0,3,3,8,7,15,15,9,24,0.000333,0.031255,4,375.061497,20.83675,93.765374,43.651484,3,0
0,0,5,5,10,14,24,27,22,49,0.000333,0.074888,5,1123.315813,62.406434,224.663163,86.52225,3,0
0,0,8,8,15,18,33,66,34,100,0.000333,0.168146,7,3531.075884,196.170882,504.439412,133.662009,2,0
0,0,4,4,7,11,18,24,17,41,0.000333,0.056989,3,512.900775,28.494488,170.966925,57.705232,1,0
0,0,6,6,7,13,20,35,24,59,0.000333,0.084998,3,764.981273,42.49896,254.993758,67.757201,1,0
0,0,3,3,7,8,15,23,12,35,0.000333,0.04558,3,410.223513,22.790195,136.741171,43.651484,1,0
0,0,7,7,11,19,30,44,28,72,0.000333,0.117765,5,1766.480614,98.137812,353.296123,118.764371,2,0
0,0,6,6,8,15,23,37,25,62,0.000333,0.093487,4,1121.843365,62.324631,280.460841,82.603359,1,0
0,0,3,3,9,8,17,16,11,27,0.000333,0.036787,4,441.445987,24.524777,110.361497,52.529325,2,0
0,0,8,8,16,17,33,49,35,84,0.000333,0.141243,16,6779.665696,376.648094,423.729106,133.486868,4,0
0,0,16,16,18,15,33,86,35,121,0.000333,0.203457,18,10986.69039,610.371688,610.371688,133.662009,7,0
0,0,3,3,7,5,12,11,7,18,0.000333,0.02151,3,193.587975,10.754888,64.529325,31.261125,1,0
0,0,4,4,6,6,12,14,12,26,0.000333,0.03107,6,559.25415,31.069675,93.209025,31.01955,1,0
0,0,5,5,8,10,18,26,15,41,0.000333,0.056989,4,683.8677,37.99265,170.966925,57.219281,1,0
0,0,4,4,4,7,11,13,11,24,0.000333,0.027675,2,166.052718,9.225151,83.026359,27.651484,3,0
0,0,6,6,9,15,24,28,25,53,0.000333,0.081001,4,972.01205,54.000669,243.003013,87.132684,1,0
0,0,9,9,10,11,21,31,28,59,0.000333,0.086382,10,2591.467279,143.970404,259.146728,71.273029,1,0
0,0,3,3,8,8,16,20,12,32,0.000333,0.042667,4,512,28.444444,128,48,1,0
0,0,3,3,7,8,15,23,12,35,0.000333,0.04558,3,410.223513,22.790195,136.741171,43.651484,1,0
0,0,11,11,15,21,36,84,43,127,0.000333,0.21886,14,9192.126653,510.673703,656.580475,150.842025,2,0
0,0,7,7,11,19,30,44,28,72,0.000333,0.117765,5,1766.480614,98.137812,353.296123,118.764371,2,0
0,0,9,9,15,19,34,68,35,103,0.000333,0.17467,7,3668.060709,203.78115,524.008673,139.313982,2,0
0,0,7,7,7,18,25,45,34,79,0.000333,0.122288,3,1100.593917,61.144106,366.864639,94.710134,1,0
0,0,5,5,12,13,25,30,20,50,0.000333,0.077398,6,1393.156857,77.397603,232.192809,91.125266,1,0
0,0,5,5,8,10,18,28,17,45,0.000333,0.062549,4,750.5865,41.69925,187.646625,57.219281,1,0
0,0,6,6,9,10,19,28,17,45,0.000333,0.063719,4,764.626952,42.479275,191.156738,61.748606,1,0
0,0,7,7,11,19,30,44,28,72,0.000333,0.117765,5,1766.480614,98.137812,353.296123,118.764371,2,0
0,0,4,4,6,8,14,17,12,29,0.000333,0.036804,3,331.239878,18.402215,110.413293,39.509775,3,0
0,0,7,7,16,14,30,45,29,74,0.000333,0.121037,16,5809.758465,322.764359,363.109904,117.302969,4,0
0,0,5,5,8,10,18,28,17,45,0.000333,0.062549,4,750.5865,41.69925,187.646625,57.219281,1,0
0,0,4,4,4,7,11,13,11,24,0.000333,0.027675,2,166.052718,9.225151,83.026359,27.651484,3,0
0,0,5,5,10,9,19,24,16,40,0.000333,0.056639,5,849.585503,47.199195,169.917101,61.748606,1,0
0,0,25,25,12,35,47,382,213,595,0.000333,1.10166,36,118979.2932,6609.960733,3304.980367,222.544456,4,0
0,0,8,8,15,18,33,66,34,100,0.000333,0.168146,7,3531.075884,196.170882,504.439412,133.662009,2,0
0,0,9,9,15,19,34,68,35,103,0.000333,0.17467,7,3668.060709,203.78115,524.008673,139.313982,2,0
0,0,11,11,15,21,36,84,43,127,0.000333,0.21886,14,9192.126653,510.673703,656.580475,150.842025,2,0
0,0,4,4,12,10,22,26,14,40,0.000333,0.059459,6,1070.263588,59.459088,178.377265,76.238831,2,0
0,0,5,5,11,11,22,31,17,48,0.000333,0.071351,5,1070.263588,59.459088,214.052718,76.107496,1,0
0,0,3,3,10,9,19,26,14,40,0.000333,0.056639,5,849.585503,47.199195,169.917101,61.748606,1,0
0,0,11,11,12,16,28,46,37,83,0.000333,0.133003,12,4788.125502,266.006972,399.010459,107.01955,1,0
0,0,9,9,15,19,34,68,35,103,0.000333,0.17467,7,3668.060709,203.78115,524.008673,139.313982,2,0
0,0,3,3,8,7,15,11,9,20,0.000333,0.026046,4,312.551248,17.363958,78.137812,43.651484,1,0
0,0,5,5,12,13,25,30,20,50,0.000333,0.077398,6,1393.156857,77.397603,232.192809,91.125266,1,0
0,0,6,6,14,12,26,43,26,69,0.000333,0.10811,14,4540.624768,252.256932,324.330341,96.322519,4,0
0,0,18,18,16,24,40,197,66,263,0.000333,0.466556,16,22394.67342,1244.148524,1399.667089,174.0391,6,0
0,0,10,10,15,20,35,80,41,121,0.000333,0.206881,14,8689.005431,482.722524,620.643245,145.041921,2,0
0,0,3,3,7,8,15,23,12,35,0.000333,0.04558,3,410.223513,22.790195,136.741171,43.651484,1,0
0,0,8,8,15,18,33,66,34,100,0.000333,0.168146,7,3531.075884,196.170882,504.439412,133.662009,2,0
0,0,9,9,15,19,34,68,35,103,0.000333,0.17467,7,3668.060709,203.78115,524.008673,139.313982,2,0
0,0,8,8,15,18,33,66,34,100,0.000333,0.168146,7,3531.075884,196.170882,504.439412,133.662009,2,0
0,0,7,7,11,13,24,28,21,49,0.000333,0.074888,5,1123.315813,62.406434,224.663163,86.159464,1,0
0,0,7,7,10,16,26,30,29,59,0.000333,0.092442,5,1386.629717,77.034984,277.325943,97.219281,1,0
0,0,4,4,13,12,25,25,15,40,0.000333,0.061918,6,1114.525486,61.918083,185.754248,91.125266,3,0
0,0,7,7,11,19,30,44,28,72,0.000333,0.117765,5,1766.480614,98.137812,353.296123,118.764371,2,0
0,0,5,5,7,7,14,16,11,27,0.000333,0.034266,3,308.395749,17.133097,102.798583,39.302969,1,0
0,0,4,4,8,10,18,28,16,44,0.000333,0.061159,4,733.9068,40.7726,183.4767,57.219281,1,0
0,0,4,4,5,11,16,13,14,27,0.000333,0.036,2,216,12,108,49.663388,1,0
0,0,3,3,7,8,15,23,12,35,0.000333,0.04558,3,410.223513,22.790195,136.741171,43.651484,1,0
0,0,5,5,12,16,28,39,25,64,0.000333,0.102557,6,1846.02429,102.556905,307.670715,107.01955,2,0
0,0,4,4,4,7,11,13,11,24,0.000333,0.027675,2,166.052718,9.225151,83.026359,27.651484,3,0
0,0,6,6,8,12,20,23,20,43,0.000333,0.061948,4,743.371632,41.298424,185.842908,67.01955,3,0
0,0,6,6,8,11,19,34,22,56,0.000333,0.079295,8,1903.071526,105.726196,237.883941,62.053748,1,0
0,0,5,5,8,10,18,28,17,45,0.000333,0.062549,4,750.5865,41.69925,187.646625,57.219281,1,0
0,0,8,8,12,16,28,41,23,64,0.000333,0.102557,6,1846.02429,102.556905,307.670715,107.01955,3,0
0,0,18,18,11,28,39,116,64,180,0.000333,0.317124,10,9513.723994,528.540222,951.372399,172.659686,1,0
0,0,7,7,11,18,29,48,28,76,0.000333,0.123069,5,1846.032778,102.557377,369.206556,113.112398,1,0
0,0,3,3,7,8,15,23,12,35,0.000333,0.04558,3,410.223513,22.790195,136.741171,43.651484,1,0
0,0,3,3,9,8,17,16,11,27,0.000333,0.036787,4,441.445987,24.524777,110.361497,52.529325,2,0
0,0,3,3,8,7,15,11,9,20,0.000333,0.026046,4,312.551248,17.363958,78.137812,43.651484,1,0
0,0,3,3,7,5,12,11,7,18,0.000333,0.02151,3,193.587975,10.754888,64.529325,31.261125,1,0
0,0,7,7,10,14,24,40,27,67,0.000333,0.102397,5,1535.962438,85.331247,307.192488,86.52225,1,0
0,0,4,4,7,8,15,16,12,28,0.000333,0.036464,3,328.17881,18.232156,109.392937,43.651484,3,0
0,0,4,4,4,7,11,13,11,24,0.000333,0.027675,2,166.052718,9.225151,83.026359,27.651484,3,0
0,0,11,11,15,21,36,84,43,127,0.000333,0.21886,14,9192.126653,510.673703,656.580475,150.842025,2,0
0,0,5,5,11,13,24,24,19,43,0.000333,0.065718,5,985.766938,54.76483,197.153388,86.159464,1,0
0,0,6,6,8,13,21,42,25,67,0.000333,0.098095,4,1177.141069,65.396726,294.285267,72.105716,1,0
0,0,3,3,8,7,15,20,12,32,0.000333,0.041673,4,500.081996,27.782333,125.020499,43.651484,1,0
0,0,10,10,14,18,32,51,39,90,0.000333,0.15,14,6300,350,450,128.361619,2,0
0,0,4,4,10,7,17,25,15,40,0.000333,0.0545,10,1634.985137,90.832508,163.498514,52.870765,1,0
0,0,6,6,9,10,19,28,17,45,0.000333,0.063719,4,764.626952,42.479275,191.156738,61.748606,1,0
0,0,6,6,9,10,19,28,17,45,0.000333,0.063719,4,764.626952,42.479275,191.156738,61.748606,1,0
0,0,7,7,8,13,21,30,35,65,0.000333,0.095167,8,2284.00506,126.88917,285.500632,72.105716,1,0
0,0,8,8,15,13,28,46,29,75,0.000333,0.120184,14,5047.722668,280.429037,360.551619,106.709075,4,0
0,0,3,3,8,8,16,20,12,32,0.000333,0.042667,4,512,28.444444,128,48,1,0
0,0,7,7,11,19,30,44,28,72,0.000333,0.117765,5,1766.480614,98.137812,353.296123,118.764371,2,0
0,0,4,4,6,9,15,16,12,28,0.000333,0.036464,3,328.17881,18.232156,109.392937,44.0391,1,0
0,0,8,8,13,16,29,39,36,75,0.000333,0.12145,12,4372.182896,242.89905,364.348575,112.105716,1,0
0,0,6,6,10,10,20,26,18,44,0.000333,0.063388,5,950.824181,52.823566,190.164836,66.438562,1,0
0,0,3,3,7,5,12,11,7,18,0.000333,0.02151,3,193.587975,10.754888,64.529325,31.261125,1,0
0,0,4,4,5,9,14,15,13,28,0.000333,0.035535,2,213.211876,11.845104,106.605938,40.138965,1,0
0,0,6,6,10,11,21,24,21,45,0.000333,0.065885,5,988.27142,54.903968,197.654284,71.273029,1,0
0,0,4,4,4,7,11,13,11,24,0.000333,0.027675,2,166.052718,9.225151,83.026359,27.651484,3,0
0,0,9,9,9,19,28,47,46,93,0.000333,0.149028,8,3576.672062,198.704003,447.084008,109.239948,1,0
0,0,3,3,9,9,18,18,15,33,0.000333,0.045869,4,550.4301,30.57945,137.607525,57.05865,1,0
0,0,3,3,5,6,11,13,11,24,0.000333,0.027675,2,166.052718,9.225151,83.026359,27.119415,1,0
0,0,8,8,11,11,22,35,31,66,0.000333,0.098107,10,2943.224868,163.512493,294.322487,76.107496,1,0
0,0,4,4,4,7,11,13,11,24,0.000333,0.027675,2,166.052718,9.225151,83.026359,27.651484,2,0
0,0,3,3,12,9,21,21,11,32,0.000333,0.046851,6,843.324945,46.851386,140.554158,71.548875,3,0
0,0,5,5,12,14,26,29,20,49,0.000333,0.076774,6,1381.929277,76.773849,230.321546,96.322519,1,0
0,0,3,3,9,8,17,16,11,27,0.000333,0.036787,4,441.445987,24.524777,110.361497,52.529325,2,0
0,0,9,9,15,19,34,68,35,103,0.000333,0.17467,7,3668.060709,203.78115,524.008673,139.313982,2,0
0,0,7,7,11,19,30,44,28,72,0.000333,0.117765,5,1766.480614,98.137812,353.296123,118.764371,2,0
0,0,4,4,4,7,11,13,11,24,0.000333,0.027675,2,166.052718,9.225151,83.026359,27.651484,3,0
0,0,10,10,14,16,30,51,35,86,0.000333,0.140664,14,5907.896277,328.21646,421.992591,117.302969,2,0
0,0,4,4,4,7,11,13,11,24,0.000333,0.027675,2,166.052718,9.225151,83.026359,27.651484,3,0
0,0,5,5,9,11,20,19,16,35,0.000333,0.050422,4,605.069933,33.614996,151.267483,66.583073,1,0
0,0,5,5,7,7,14,16,11,27,0.000333,0.034266,3,308.395749,17.133097,102.798583,39.302969,1,0
0,0,7,7,11,19,30,44,28,72,0.000333,0.117765,5,1766.480614,98.137812,353.296123,118.764371,2,0
0,0,5,5,8,10,18,28,17,45,0.000333,0.062549,4,750.5865,41.69925,187.646625,57.219281,1,0
0,0,3,3,9,13,22,20,16,36,0.000333,0.053513,4,642.158153,35.675453,160.539538,76.635041,3,0
0,0,7,7,16,14,30,45,29,74,0.000333,0.121037,16,5809.758465,322.764359,363.109904,117.302969,4,0
0,0,6,6,9,17,26,38,30,68,0.000333,0.106543,4,1278.519603,71.028867,319.629901,98.016193,1,0
0,0,3,3,9,8,17,16,11,27,0.000333,0.036787,4,441.445987,24.524777,110.361497,52.529325,2,0
0,0,3,3,9,8,17,16,11,27,0.000333,0.036787,4,441.445987,24.524777,110.361497,52.529325,2,0
0,0,3,3,9,8,17,16,11,27,0.000333,0.036787,4,441.445987,24.524777,110.361497,52.529325,2,0
0,0,3,3,7,5,12,11,7,18,0.000333,0.02151,3,193.587975,10.754888,64.529325,31.261125,1,0
0,0,5,5,9,13,22,24,25,49,0.000333,0.072837,4,874.048597,48.558255,218.512149,76.635041,2,0
0,0,8,8,15,18,33,66,34,100,0.000333,0.168146,7,3531.075884,196.170882,504.439412,133.662009,2,0
0,0,11,11,15,21,36,84,43,127,0.000333,0.21886,14,9192.126653,510.673703,656.580475,150.842025,2,0
0,0,9,9,15,19,34,68,35,103,0.000333,0.17467,7,3668.060709,203.78115,524.008673,139.313982,2,0
0,0,3,3,8,7,15,20,12,32,0.000333,0.041673,4,500.081996,27.782333,125.020499,43.651484,1,0
0,0,5,5,8,12,20,20,17,37,0.000333,0.053304,4,639.645358,35.535853,159.91134,67.01955,1,0
0,0,5,5,10,10,20,26,15,41,0.000333,0.059066,5,885.995259,49.221959,177.199052,66.438562,1,0
0,0,7,7,11,19,30,44,28,72,0.000333,0.117765,5,1766.480614,98.137812,353.296123,118.764371,2,0
0,0,3,3,7,5,12,11,7,18,0.000333,0.02151,3,193.587975,10.754888,64.529325,31.261125,1,0
0,0,6,6,9,10,19,24,18,42,0.000333,0.059471,4,713.651822,39.647323,178.412956,61.748606,1,0
0,0,3,3,7,8,15,23,12,35,0.000333,0.04558,3,410.223513,22.790195,136.741171,43.651484,1,0
0,0,5,5,8,11,19,36,19,55,0.000333,0.077879,4,934.544053,51.919114,233.636013,62.053748,1,0
0,0,6,6,9,10,19,28,17,45,0.000333,0.063719,4,764.626952,42.479275,191.156738,61.748606,1,0
0,0,6,6,8,9,17,21,15,36,0.000333,0.04905,4,588.594649,32.699703,147.148662,52.529325,1,0
0,0,5,5,10,10,20,27,14,41,0.000333,0.059066,5,885.995259,49.221959,177.199052,66.438562,3,0
0,0,3,3,9,8,17,16,11,27,0.000333,0.036787,4,441.445987,24.524777,110.361497,52.529325,2,0
0,0,5,5,8,10,18,28,17,45,0.000333,0.062549,4,750.5865,41.69925,187.646625,57.219281,1,0
0,0,3,3,7,8,15,23,12,35,0.000333,0.04558,3,410.223513,22.790195,136.741171,43.651484,1,0
0,0,12,12,14,17,31,61,46,107,0.000333,0.1767,14,7421.386073,412.299226,530.099005,122.789837,2,0
0,0,4,4,6,8,14,17,12,29,0.000333,0.036804,3,331.239878,18.402215,110.413293,39.509775,3,0
0,0,6,6,9,10,19,33,19,52,0.000333,0.073631,4,883.568923,49.087162,220.892231,61.748606,1,0
0,0,4,4,10,15,25,32,21,53,0.000333,0.082041,5,1230.62189,68.367883,246.124378,91.82264,1,0
0,0,7,7,11,19,30,44,28,72,0.000333,0.117765,5,1766.480614,98.137812,353.296123,118.764371,2,0
0,0,5,5,10,10,20,26,15,41,0.000333,0.059066,5,885.995259,49.221959,177.199052,66.438562,1,0
0,0,4,4,4,7,11,13,11,24,0.000333,0.027675,2,166.052718,9.225151,83.026359,27.651484,3,0
0,0,5,5,10,11,21,29,17,46,0.000333,0.067349,5,1010.233007,56.124056,202.046601,71.273029,1,0
0,0,6,6,14,12,26,38,24,62,0.000333,0.097142,14,4079.981675,226.665649,291.427263,96.322519,4,0
0,0,4,4,6,8,14,17,12,29,0.000333,0.036804,3,331.239878,18.402215,110.413293,39.509775,3,0
0,0,4,4,10,15,25,32,21,53,0.000333,0.082041,5,1230.62189,68.367883,246.124378,91.82264,1,0
0,0,5,5,11,11,22,31,17,48,0.000333,0.071351,5,1070.263588,59.459088,214.052718,76.107496,1,0
0,0,3,3,8,6,14,11,9,20,0.000333,0.025382,4,304.588394,16.921577,76.147098,39.509775,1,0
0,0,15,15,12,22,34,99,56,155,0.000333,0.262852,12,9462.680885,525.704494,788.55674,141.127046,2,0
0,0,5,5,10,11,21,33,18,51,0.000333,0.074669,5,1120.040943,62.224497,224.008189,71.273029,1,0
0,0,3,3,7,8,15,23,12,35,0.000333,0.04558,3,410.223513,22.790195,136.741171,43.651484,1,0
0,0,3,3,7,13,20,20,19,39,0.000333,0.056185,3,505.665587,28.092533,168.555196,67.757201,1,0
0,0,5,5,10,10,20,24,19,43,0.000333,0.061948,5,929.21454,51.62303,185.842908,66.438562,1,0
0,0,4,4,10,15,25,32,21,53,0.000333,0.082041,5,1230.62189,68.367883,246.124378,91.82264,1,0
0,0,9,9,15,19,34,68,35,103,0.000333,0.17467,7,3668.060709,203.78115,524.008673,139.313982,2,0
0,0,8,8,15,18,33,66,34,100,0.000333,0.168146,7,3531.075884,196.170882,504.439412,133.662009,2,0
0,0,11,11,15,21,36,84,43,127,0.000333,0.21886,14,9192.126653,510.673703,656.580475,150.842025,2,0
0,0,11,11,15,21,36,84,43,127,0.000333,0.21886,14,9192.126653,510.673703,656.580475,150.842025,2,0
0,0,8,8,15,18,33,66,34,100,0.000333,0.168146,7,3531.075884,196.170882,504.439412,133.662009,2,0
0,0,3,3,7,8,15,23,12,35,0.000333,0.04558,3,410.223513,22.790195,136.741171,43.651484,1,0
0,0,3,3,7,8,15,23,12,35,0.000333,0.04558,3,410.223513,22.790195,136.741171,43.651484,1,0
0,0,6,6,9,13,22,21,22,43,0.000333,0.063919,4,767.022238,42.612347,191.75556,76.635041,1,0
0,0,26,26,12,28,40,176,105,281,0.000333,0.498487,18,26918.3123,1495.461795,1495.461795,177.625488,1,0
0,0,3,3,8,8,16,20,12,32,0.000333,0.042667,4,512,28.444444,128,48,1,0
0,0,5,5,8,10,18,28,17,45,0.000333,0.062549,4,750.5865,41.69925,187.646625,57.219281,1,0
0,0,5,5,7,8,15,18,14,32,0.000333,0.041673,3,375.061497,20.83675,125.020499,43.651484,1,0
0,0,8,8,15,18,33,66,34,100,0.000333,0.168146,7,3531.075884,196.170882,504.439412,133.662009,2,0
0,0,4,4,8,7,15,17,12,29,0.000333,0.037767,4,453.199309,25.177739,113.299827,43.651484,1,0
0,0,11,11,15,21,36,84,43,127,0.000333,0.21886,14,9192.126653,510.673703,656.580475,150.842025,2,0
0,0,5,5,8,10,18,28,17,45,0.000333,0.062549,4,750.5865,41.69925,187.646625,57.219281,1,0
0,0,3,3,6,10,16,25,13,38,0.000333,0.050667,3,456,25.333333,152,48.729056,1,0
0,0,6,6,9,10,19,28,17,45,0.000333,0.063719,4,764.626952,42.479275,191.156738,61.748606,1,0
0,0,3,3,8,7,15,15,9,24,0.000333,0.031255,4,375.061497,20.83675,93.765374,43.651484,3,0
0,0,3,3,8,7,15,15,9,24,0.000333,0.031255,4,375.061497,20.83675,93.765374,43.651484,3,0
0,0,5,5,9,12,21,19,24,43,0.000333,0.062957,8,1510.957193,83.942066,188.869649,71.548875,1,0
0,0,4,4,8,11,19,19,15,34,0.000333,0.048143,4,577.718142,32.095452,144.429535,62.053748,1,0
0,0,5,5,8,10,18,28,17,45,0.000333,0.062549,4,750.5865,41.69925,187.646625,57.219281,1,0
0,0,11,11,15,21,36,84,43,127,0.000333,0.21886,14,9192.126653,510.673703,656.580475,150.842025,2,0
0,0,3,3,8,7,15,11,9,20,0.000333,0.026046,4,312.551248,17.363958,78.137812,43.651484,1,0
0,0,5,5,8,13,21,25,20,45,0.000333,0.065885,4,790.617136,43.923174,197.654284,72.105716,1,0
0,0,5,5,12,16,28,39,25,64,0.000333,0.102557,6,1846.02429,102.556905,307.670715,107.01955,2,0
0,0,10,10,7,14,21,57,36,93,0.000333,0.136162,6,2450.913122,136.16184,408.48552,72.954453,3,0
0,0,7,7,8,17,25,34,31,65,0.000333,0.100617,4,1207.402609,67.077923,301.850652,93.486868,1,0
0,0,4,4,4,7,11,13,11,24,0.000333,0.027675,2,166.052718,9.225151,83.026359,27.651484,2,0
0,0,3,3,8,6,14,11,9,20,0.000333,0.025382,4,304.588394,16.921577,76.147098,39.509775,1,0
0,0,15,15,10,15,25,65,58,123,0.000333,0.190398,15,8567.91467,475.995259,571.194311,91.82264,1,0
0,0,5,5,7,10,17,19,16,35,0.000333,0.047687,3,429.183598,23.843533,143.061199,52.870765,3,0
0,0,4,4,6,8,14,17,12,29,0.000333,0.036804,3,331.239878,18.402215,110.413293,39.509775,3,0
0,0,5,5,6,11,17,18,16,34,0.000333,0.046325,3,416.92121,23.162289,138.973737,53.563523,1,0
0,0,5,5,10,11,21,29,17,46,0.000333,0.067349,5,1010.233007,56.124056,202.046601,71.273029,1,0
0,0,4,4,9,7,16,16,11,27,0.000333,0.036,4,432,24,108,48.180809,1,0
0,0,24,24,13,38,51,132,85,217,0.000333,0.410305,12,14770.99559,820.610866,1230.916299,247.526962,1,0
0,0,3,3,8,7,15,11,9,20,0.000333,0.026046,4,312.551248,17.363958,78.137812,43.651484,1,0
0,0,4,4,4,7,11,13,11,24,0.000333,0.027675,2,166.052718,9.225151,83.026359,27.651484,3,0
0,0,5,5,10,10,20,27,14,41,0.000333,0.059066,5,885.995259,49.221959,177.199052,66.438562,3,0
0,0,6,6,9,15,24,40,25,65,0.000333,0.099341,4,1192.09025,66.227236,298.022563,87.132684,1,0
0,0,4,4,6,11,17,16,15,31,0.000333,0.042237,3,380.134044,21.118558,126.711348,53.563523,1,0
0,0,8,8,15,18,33,66,34,100,0.000333,0.168146,7,3531.075884,196.170882,504.439412,133.662009,2,0
0,0,11,11,15,21,36,84,43,127,0.000333,0.21886,14,9192.126653,510.673703,656.580475,150.842025,2,0
0,0,9,9,15,19,34,68,35,103,0.000333,0.17467,7,3668.060709,203.78115,524.008673,139.313982,2,0
0,0,4,4,6,8,14,17,12,29,0.000333,0.036804,3,331.239878,18.402215,110.413293,39.509775,3,0
0,0,3,3,8,7,15,11,9,20,0.000333,0.026046,4,312.551248,17.363958,78.137812,43.651484,1,0
0,0,3,3,9,8,17,16,11,27,0.000333,0.036787,4,441.445987,24.524777,110.361497,52.529325,2,0
0,0,3,3,8,7,15,20,12,32,0.000333,0.041673,4,500.081996,27.782333,125.020499,43.651484,1,0
0,0,3,3,7,5,12,11,7,18,0.000333,0.02151,3,193.587975,10.754888,64.529325,31.261125,1,0
0,0,7,7,11,16,27,34,30,64,0.000333,0.101438,5,1521.564001,84.531333,304.3128,102.053748,1,0
0,0,3,3,9,8,17,16,11,27,0.000333,0.036787,4,441.445987,24.524777,110.361497,52.529325,2,0
0,0,4,4,4,7,11,13,11,24,0.000333,0.027675,2,166.052718,9.225151,83.026359,27.651484,3,0
0,0,4,4,11,10,21,36,17,53,0.000333,0.077598,5,1163.964117,64.664673,232.792823,71.273029,1,0
0,0,3,3,9,8,17,16,10,26,0.000333,0.035425,4,425.096135,23.616452,106.274034,52.529325,3,0
0,0,5,5,7,8,15,17,12,29,0.000333,0.037767,3,339.899482,18.883305,113.299827,43.651484,1,0
0,0,7,7,14,16,30,42,33,75,0.000333,0.122672,14,5152.235125,286.235285,368.016795,117.302969,4,0
0,0,3,3,5,6,11,9,8,17,0.000333,0.019603,2,117.620675,6.534482,58.810338,27.119415,1,0
0,0,8,8,15,18,33,66,34,100,0.000333,0.168146,7,3531.075884,196.170882,504.439412,133.662009,2,0
0,0,3,3,7,8,15,23,12,35,0.000333,0.04558,3,410.223513,22.790195,136.741171,43.651484,1,0
0,0,3,3,7,5,12,11,7,18,0.000333,0.02151,3,193.587975,10.754888,64.529325,31.261125,1,0
0,0,3,3,6,9,15,26,11,37,0.000333,0.048185,3,433.664856,24.092492,144.554952,44.0391,1,0
0,0,3,3,9,8,17,16,11,27,0.000333,0.036787,4,441.445987,24.524777,110.361497,52.529325,2,0
0,0,19,19,20,28,48,120,70,190,0.000333,0.353714,20,21222.8575,1179.047639,1061.142875,221.0445,9,0
0,0,14,14,11,23,34,85,48,133,0.000333,0.225544,10,6766.325579,375.906977,676.632558,142.095673,1,0
0,0,3,3,7,8,15,23,12,35,0.000333,0.04558,3,410.223513,22.790195,136.741171,43.651484,1,0
0,0,8,8,15,18,33,66,34,100,0.000333,0.168146,7,3531.075884,196.170882,504.439412,133.662009,2,0
0,0,5,5,10,10,20,26,15,41,0.000333,0.059066,5,885.995259,49.221959,177.199052,66.438562,1,0
0,0,3,3,8,7,15,11,9,20,0.000333,0.026046,4,312.551248,17.363958,78.137812,43.651484,1,0
0,0,5,5,8,11,19,36,19,55,0.000333,0.077879,4,934.544053,51.919114,233.636013,62.053748,1,0
0,0,6,6,14,11,25,40,23,63,0.000333,0.097521,14,4095.881159,227.548953,292.56294,91.356717,4,0
0,0,4,4,7,9,16,46,28,74,0.000333,0.098667,9,2664,148,296,48.180809,1,0
0,0,6,6,6,14,20,24,31,55,0.000333,0.079235,6,1426.236271,79.235348,237.706045,68.812744,1,0
0,0,8,8,16,15,31,47,31,78,0.000333,0.128809,16,6182.836995,343.490944,386.427312,122.603359,4,0
0,0,5,5,12,16,28,39,25,64,0.000333,0.102557,6,1846.02429,102.556905,307.670715,107.01955,2,0
0,0,3,3,8,7,15,11,9,20,0.000333,0.026046,4,312.551248,17.363958,78.137812,43.651484,1,0
0,0,6,6,7,11,18,41,25,66,0.000333,0.091738,6,1651.290301,91.73835,275.21505,57.705232,1,0
0,0,3,3,7,8,15,23,12,35,0.000333,0.04558,3,410.223513,22.790195,136.741171,43.651484,1,0
0,0,5,5,7,16,23,31,27,58,0.000333,0.087456,3,787.09978,43.727766,262.366593,83.651484,1,0
0,0,4,4,9,9,18,17,13,30,0.000333,0.041699,4,500.391,27.7995,125.09775,57.05865,3,0
0,0,5,5,8,12,20,20,17,37,0.000333,0.053304,4,639.645358,35.535853,159.91134,67.01955,1,0
0,0,3,3,8,7,15,11,9,20,0.000333,0.026046,4,312.551248,17.363958,78.137812,43.651484,1,0
0,0,3,3,7,8,15,23,12,35,0.000333,0.04558,3,410.223513,22.790195,136.741171,43.651484,1,0
0,0,7,7,11,19,30,44,28,72,0.000333,0.117765,5,1766.480614,98.137812,353.296123,118.764371,2,0
0,0,7,7,11,19,30,44,28,72,0.000333,0.117765,5,1766.480614,98.137812,353.296123,118.764371,2,0
0,0,11,11,8,15,23,63,38,101,0.000333,0.152293,8,3655.03806,203.05767,456.879758,82.603359,1,0
0,0,5,5,11,14,25,27,22,49,0.000333,0.07585,5,1137.744766,63.208043,227.548953,91.356717,1,0
0,0,4,4,10,10,20,17,14,31,0.000333,0.04466,5,669.898855,37.216603,133.979771,66.438562,1,0
0,0,5,5,6,12,18,18,17,35,0.000333,0.048649,3,437.842125,24.324563,145.947375,58.529325,1,0
0,0,4,4,4,7,11,13,11,24,0.000333,0.027675,2,166.052718,9.225151,83.026359,27.651484,3,0
0,0,3,3,6,8,14,10,8,18,0.000333,0.022844,3,205.597166,11.422065,68.532389,39.509775,1,0
0,0,4,4,6,5,11,24,12,36,0.000333,0.041513,6,747.23723,41.513179,124.539538,27.119415,1,0
0,0,7,7,9,17,26,46,34,80,0.000333,0.125345,8,3008.28142,167.126746,376.035177,98.016193,1,0
0,0,8,8,8,15,23,30,30,60,0.000333,0.090471,8,2171.309739,120.628319,271.413717,82.603359,1,0
0,0,3,3,8,8,16,20,12,32,0.000333,0.042667,4,512,28.444444,128,48,1,0
0,0,5,5,10,10,20,26,15,41,0.000333,0.059066,5,885.995259,49.221959,177.199052,66.438562,1,0
0,0,4,4,5,9,14,15,13,28,0.000333,0.035535,2,213.211876,11.845104,106.605938,40.138965,1,0
0,0,3,3,9,8,17,16,11,27,0.000333,0.036787,4,441.445987,24.524777,110.361497,52.529325,2,0
0,0,3,3,8,6,14,11,9,20,0.000333,0.025382,4,304.588394,16.921577,76.147098,39.509775,1,0
0,0,4,4,5,7,12,14,10,24,0.000333,0.02868,2,172.0782,9.5599,86.0391,31.261125,2,0
0,0,5,5,11,12,23,33,21,54,0.000333,0.081424,5,1221.361728,67.853429,244.272346,81.073298,1,0
0,0,9,9,15,19,34,68,35,103,0.000333,0.17467,7,3668.060709,203.78115,524.008673,139.313982,2,0
0,0,4,4,4,7,11,13,11,24,0.000333,0.027675,2,166.052718,9.225151,83.026359,27.651484,3,0
0,0,6,6,9,10,19,28,17,45,0.000333,0.063719,4,764.626952,42.479275,191.156738,61.748606,1,0
0,0,5,5,8,10,18,28,17,45,0.000333,0.062549,4,750.5865,41.69925,187.646625,57.219281,1,0
0,0,4,4,4,7,11,13,11,24,0.000333,0.027675,2,166.052718,9.225151,83.026359,27.651484,3,0
0,0,4,4,6,9,15,16,12,28,0.000333,0.036464,3,328.17881,18.232156,109.392937,44.0391,1,0
0,0,8,8,13,12,25,40,30,70,0.000333,0.108357,12,3900.839199,216.713289,325.069933,91.125266,1,0
0,0,3,3,9,8,17,16,11,27,0.000333,0.036787,4,441.445987,24.524777,110.361497,52.529325,2,0
0,0,6,6,10,15,25,26,26,52,0.000333,0.080494,5,1207.402609,67.077923,241.480522,91.82264,1,0
0,0,6,6,11,15,26,38,28,66,0.000333,0.10341,5,1551.145107,86.174728,310.229021,96.657107,1,0
0,0,7,7,9,20,29,52,35,87,0.000333,0.140881,4,1690.577386,93.920966,422.644347,114.967887,1,0
0,0,11,11,15,21,36,84,43,127,0.000333,0.21886,14,9192.126653,510.673703,656.580475,150.842025,2,0
0,0,8,8,15,18,33,66,34,100,0.000333,0.168146,7,3531.075884,196.170882,504.439412,133.662009,2,0
0,0,5,5,10,10,20,24,19,43,0.000333,0.061948,5,929.21454,51.62303,185.842908,66.438562,1,0
0,0,9,9,15,19,34,68,35,103,0.000333,0.17467,7,3668.060709,203.78115,524.008673,139.313982,2,0
0,0,6,6,10,11,21,24,21,45,0.000333,0.065885,5,988.27142,54.903968,197.654284,71.273029,1,0
0,0,5,5,8,13,21,32,24,56,0.000333,0.08199,4,983.879103,54.65995,245.969776,72.105716,1,0
0,0,6,6,9,9,18,30,19,49,0.000333,0.068109,8,1634.610601,90.8117,204.326325,57.05865,1,0
0,0,3,3,9,8,17,16,11,27,0.000333,0.036787,4,441.445987,24.524777,110.361497,52.529325,2,0
0,0,5,5,8,8,16,24,16,40,0.000333,0.053333,8,1280,71.111111,160,48,1,0
0,0,4,4,12,11,23,24,15,39,0.000333,0.058806,6,1058.513498,58.806305,176.418916,81.073298,4,0
0,0,6,6,7,11,18,41,25,66,0.000333,0.091738,6,1651.290301,91.73835,275.21505,57.705232,1,0
0,0,4,4,10,15,25,32,21,53,0.000333,0.082041,5,1230.62189,68.367883,246.124378,91.82264,1,0
0,0,5,5,9,13,22,19,21,40,0.000333,0.059459,4,713.509059,39.639392,178.377265,76.635041,1,0
0,0,4,4,5,9,14,15,13,28,0.000333,0.035535,2,213.211876,11.845104,106.605938,40.138965,1,0
0,0,3,3,7,5,12,11,7,18,0.000333,0.02151,3,193.587975,10.754888,64.529325,31.261125,1,0
0,0,6,6,7,11,18,41,25,66,0.000333,0.091738,6,1651.290301,91.73835,275.21505,57.705232,1,0
0,0,11,11,8,16,24,48,39,87,0.000333,0.132964,8,3191.133901,177.285217,398.891738,88,1,0
0,0,3,3,10,8,18,16,13,29,0.000333,0.040309,5,604.639125,33.591063,120.927825,57.219281,3,0
0,0,6,6,7,11,18,41,25,66,0.000333,0.091738,6,1651.290301,91.73835,275.21505,57.705232,1,0
0,0,3,3,7,8,15,23,12,35,0.000333,0.04558,3,410.223513,22.790195,136.741171,43.651484,1,0
0,0,3,3,8,7,15,20,12,32,0.000333,0.041673,4,500.081996,27.782333,125.020499,43.651484,1,0
0,0,4,4,4,7,11,13,11,24,0.000333,0.027675,2,166.052718,9.225151,83.026359,27.651484,3,0
0,0,3,3,8,7,15,15,9,24,0.000333,0.031255,4,375.061497,20.83675,93.765374,43.651484,3,0
0,0,4,4,4,7,11,13,11,24,0.000333,0.027675,2,166.052718,9.225151,83.026359,27.651484,3,0
0,0,5,5,10,11,21,29,17,46,0.000333,0.067349,5,1010.233007,56.124056,202.046601,71.273029,1,0
0,0,3,3,9,8,17,16,11,27,0.000333,0.036787,4,441.445987,24.524777,110.361497,52.529325,2,0
0,0,5,5,11,13,24,28,20,48,0.000333,0.073359,5,1100.391,61.132833,220.0782,86.159464,1,0
0,0,4,4,11,10,21,24,14,38,0.000333,0.055636,5,834.54031,46.363351,166.908062,71.273029,3,0
0,0,4,4,4,7,11,13,11,24,0.000333,0.027675,2,166.052718,9.225151,83.026359,27.651484,3,0
0,0,3,3,8,7,15,20,12,32,0.000333,0.041673,4,500.081996,27.782333,125.020499,43.651484,1,0
0,0,5,5,8,10,18,26,15,41,0.000333,0.056989,4,683.8677,37.99265,170.966925,57.219281,1,0
0,0,9,9,15,19,34,68,35,103,0.000333,0.17467,7,3668.060709,203.78115,524.008673,139.313982,2,0
0,0,11,11,15,21,36,84,43,127,0.000333,0.21886,14,9192.126653,510.673703,656.580475,150.842025,2,0
0,0,5,5,8,12,20,25,19,44,0.000333,0.063388,4,760.659345,42.258852,190.164836,67.01955,1,0
0,0,3,3,7,8,15,23,12,35,0.000333,0.04558,3,410.223513,22.790195,136.741171,43.651484,1,0
0,0,10,10,14,18,32,51,39,90,0.000333,0.15,14,6300,350,450,128.361619,2,0
0,0,3,3,11,11,22,26,15,41,0.000333,0.060946,5,914.183482,50.787971,182.836696,76.107496,3,0
0,0,15,15,13,21,34,95,53,148,0.000333,0.250982,12,9035.334006,501.963,752.944501,140.344382,2,0
0,0,9,9,15,19,34,68,35,103,0.000333,0.17467,7,3668.060709,203.78115,524.008673,139.313982,2,0
0,0,5,5,11,11,22,31,17,48,0.000333,0.071351,5,1070.263588,59.459088,214.052718,76.107496,1,0
0,0,3,3,13,7,20,27,12,39,0.000333,0.056185,6,1011.331174,56.185065,168.555196,67.757201,3,0
0,0,5,5,7,7,14,16,11,27,0.000333,0.034266,3,308.395749,17.133097,102.798583,39.302969,1,0
0,0,5,5,11,12,23,33,21,54,0.000333,0.081424,5,1221.361728,67.853429,244.272346,81.073298,1,0
0,0,5,5,7,14,21,16,21,37,0.000333,0.054172,3,487.547234,27.085957,162.515745,72.954453,1,0
0,0,25,25,12,35,47,382,213,595,0.000333,1.10166,36,118979.2932,6609.960733,3304.980367,222.544456,4,0
0,0,5,5,8,10,18,28,17,45,0.000333,0.062549,4,750.5865,41.69925,187.646625,57.219281,1,0
0,0,9,9,15,19,34,68,35,103,0.000333,0.17467,7,3668.060709,203.78115,524.008673,139.313982,2,0
0,0,8,8,15,18,33,66,34,100,0.000333,0.168146,7,3531.075884,196.170882,504.439412,133.662009,2,0
0,0,11,11,15,21,36,84,43,127,0.000333,0.21886,14,9192.126653,510.673703,656.580475,150.842025,2,0
0,0,9,9,15,19,34,68,35,103,0.000333,0.17467,7,3668.060709,203.78115,524.008673,139.313982,2,0
0,0,5,5,8,10,18,26,15,41,0.000333,0.056989,4,683.8677,37.99265,170.966925,57.219281,1,0
0,0,3,3,7,8,15,23,12,35,0.000333,0.04558,3,410.223513,22.790195,136.741171,43.651484,1,0
0,0,3,3,8,6,14,11,9,20,0.000333,0.025382,4,304.588394,16.921577,76.147098,39.509775,1,0
0,0,7,7,9,14,23,21,25,46,0.000333,0.069361,4,832.3354,46.240856,208.08385,81.832294,1,0
0,0,3,3,7,5,12,11,7,18,0.000333,0.02151,3,193.587975,10.754888,64.529325,31.261125,1,0
0,0,3,3,8,7,15,11,9,20,0.000333,0.026046,4,312.551248,17.363958,78.137812,43.651484,1,0
0,0,4,4,4,7,11,13,11,24,0.000333,0.027675,2,166.052718,9.225151,83.026359,27.651484,1,0
0,0,10,10,13,37,50,54,51,105,0.000333,0.197535,6,3555.6294,197.534967,592.6049,240.855491,5,0
0,0,5,5,11,12,23,31,19,50,0.000333,0.075393,5,1130.890489,62.827249,226.178098,81.073298,2,0
0,0,18,18,15,24,39,89,60,149,0.000333,0.262508,14,11025.34903,612.51939,787.524931,168.642459,5,0
0,0,3,3,8,7,15,11,9,20,0.000333,0.026046,4,312.551248,17.363958,78.137812,43.651484,1,0
0,0,8,8,16,17,33,50,36,86,0.000333,0.144606,16,6941.086308,385.615906,433.817894,133.486868,4,0
0,0,5,5,8,10,18,28,17,45,0.000333,0.062549,4,750.5865,41.69925,187.646625,57.219281,1,0
0,0,3,3,9,11,20,19,16,35,0.000333,0.050422,4,605.069933,33.614996,151.267483,66.583073,1,0
0,0,4,4,8,11,19,27,17,44,0.000333,0.062303,4,747.635242,41.535291,186.908811,62.053748,1,0
0,0,6,6,8,13,21,42,25,67,0.000333,0.098095,4,1177.141069,65.396726,294.285267,72.105716,1,0
0,0,11,11,11,16,27,52,43,95,0.000333,0.150571,10,4517.143127,250.952396,451.714313,102.053748,1,0
0,0,5,5,8,10,18,28,17,45,0.000333,0.062549,4,750.5865,41.69925,187.646625,57.219281,1,0
0,0,5,5,7,15,22,31,25,56,0.000333,0.083243,3,749.184512,41.621362,249.728171,78.254843,1,0
0,0,5,5,10,7,17,20,16,36,0.000333,0.04905,10,1471.486623,81.749257,147.148662,52.870765,1,0
0,0,3,3,7,5,12,11,7,18,0.000333,0.02151,3,193.587975,10.754888,64.529325,31.261125,1,0
0,0,9,9,15,19,34,68,35,103,0.000333,0.17467,7,3668.060709,203.78115,524.008673,139.313982,2,0
0,0,3,3,7,6,13,16,12,28,0.000333,0.034537,6,621.673873,34.537437,103.612312,35.161259,1,0
0,0,3,3,8,10,18,20,14,34,0.000333,0.047259,4,567.1098,31.5061,141.77745,57.219281,1,0
0,0,4,4,9,8,17,15,12,27,0.000333,0.036787,4,441.445987,24.524777,110.361497,52.529325,1,0
0,0,11,11,15,21,36,84,43,127,0.000333,0.21886,14,9192.126653,510.673703,656.580475,150.842025,2,0
0,0,4,4,8,11,19,27,17,44,0.000333,0.062303,4,747.635242,41.535291,186.908811,62.053748,1,0
0,0,5,5,8,10,18,28,17,45,0.000333,0.062549,4,750.5865,41.69925,187.646625,57.219281,1,0
0,0,4,4,12,11,23,18,15,33,0.000333,0.049759,6,895.665267,49.759182,149.277545,81.073298,1,0
0,0,3,3,5,6,11,9,8,17,0.000333,0.019603,2,117.620675,6.534482,58.810338,27.119415,1,0
0,0,15,15,12,22,34,100,56,156,0.000333,0.264548,12,9523.730439,529.096135,793.644203,141.127046,9,0
0,0,4,4,8,12,20,25,24,49,0.000333,0.070591,8,1694.195813,94.12199,211.774477,67.01955,1,0
0,0,9,9,15,19,34,68,35,103,0.000333,0.17467,7,3668.060709,203.78115,524.008673,139.313982,2,0
0,0,7,7,11,19,30,44,28,72,0.000333,0.117765,5,1766.480614,98.137812,353.296123,118.764371,2,0
0,0,4,4,7,6,13,14,9,23,0.000333,0.02837,3,255.330341,14.185019,85.110114,35.161259,1,0
0,0,7,7,11,18,29,48,28,76,0.000333,0.123069,5,1846.032778,102.557377,369.206556,113.112398,1,0
0,0,5,5,8,10,18,28,17,45,0.000333,0.062549,4,750.5865,41.69925,187.646625,57.219281,1,0
0,0,10,10,11,12,23,70,46,116,0.000333,0.174911,15,7870.997804,437.277656,524.733187,81.073298,7,0
0,0,8,8,11,12,23,53,37,90,0.000333,0.135707,15,6106.808641,339.267147,407.120576,81.073298,8,0
0,0,6,6,8,12,20,37,25,62,0.000333,0.08932,8,2143.676335,119.09313,267.959542,67.01955,1,0
0,0,3,3,8,6,14,11,9,20,0.000333,0.025382,4,304.588394,16.921577,76.147098,39.509775,1,0
0,0,6,6,9,10,19,28,17,45,0.000333,0.063719,4,764.626952,42.479275,191.156738,61.748606,1,0
0,0,4,4,6,12,18,20,17,37,0.000333,0.051429,3,462.861675,25.714538,154.287225,58.529325,1,0
0,0,7,7,15,15,30,45,32,77,0.000333,0.125944,14,5289.628062,293.868226,377.830576,117.206718,4,0
0,0,19,19,21,26,47,149,82,231,0.000333,0.427703,30,38493.30074,2138.516708,1283.110025,214.450099,11,0
0,0,7,7,11,19,30,44,28,72,0.000333,0.117765,5,1766.480614,98.137812,353.296123,118.764371,2,0
0,0,8,8,15,18,33,66,34,100,0.000333,0.168146,7,3531.075884,196.170882,504.439412,133.662009,2,0
0,0,7,7,10,16,26,28,31,59,0.000333,0.092442,5,1386.629717,77.034984,277.325943,97.219281,1,0
0,0,3,3,8,7,15,11,9,20,0.000333,0.026046,4,312.551248,17.363958,78.137812,43.651484,1,0
0,0,4,4,7,13,20,21,18,39,0.000333,0.056185,3,505.665587,28.092533,168.555196,67.757201,1,0
0,0,5,5,11,12,23,33,21,54,0.000333,0.081424,5,1221.361728,67.853429,244.272346,81.073298,1,0
0,0,25,25,12,35,47,382,213,595,0.000333,1.10166,36,118979.2932,6609.960733,3304.980367,222.544456,4,0
0,0,3,3,6,10,16,25,13,38,0.000333,0.050667,3,456,25.333333,152,48.729056,1,0
0,0,4,4,10,7,17,25,15,40,0.000333,0.0545,10,1634.985137,90.832508,163.498514,52.870765,1,0
0,0,9,9,15,19,34,68,35,103,0.000333,0.17467,7,3668.060709,203.78115,524.008673,139.313982,2,0
0,0,4,4,6,12,18,18,16,34,0.000333,0.047259,3,425.33235,23.629575,141.77745,58.529325,1,0
0,0,9,9,9,14,23,62,39,101,0.000333,0.152293,8,3655.03806,203.05767,456.879758,81.832294,1,0
0,0,5,5,9,12,21,32,23,55,0.000333,0.080526,4,966.309833,53.68388,241.577458,71.548875,1,0
0,0,14,14,11,23,34,85,48,133,0.000333,0.225544,10,6766.325579,375.906977,676.632558,142.095673,1,0
0,0,5,5,13,13,26,27,19,46,0.000333,0.072073,6,1297.321362,72.073409,216.220227,96.211433,1,0
0,0,7,7,11,19,30,44,28,72,0.000333,0.117765,5,1766.480614,98.137812,353.296123,118.764371,2,0
0,0,3,3,7,5,12,11,7,18,0.000333,0.02151,3,193.587975,10.754888,64.529325,31.261125,1,0
0,0,4,4,8,10,18,34,17,51,0.000333,0.070889,4,850.6647,47.25915,212.666175,57.219281,1,0
0,0,3,3,7,5,12,11,7,18,0.000333,0.02151,3,193.587975,10.754888,64.529325,31.261125,1,0
0,0,5,5,10,11,21,33,18,51,0.000333,0.074669,5,1120.040943,62.224497,224.008189,71.273029,1,0
0,0,5,5,10,10,20,26,15,41,0.000333,0.059066,5,885.995259,49.221959,177.199052,66.438562,1,0
0,0,4,4,10,8,18,19,16,35,0.000333,0.048649,10,1459.473751,81.081875,145.947375,57.219281,1,0
0,0,5,5,7,15,22,31,26,57,0.000333,0.084729,3,762.562807,42.3646,254.187602,78.254843,1,0
0,0,4,4,5,7,12,14,10,24,0.000333,0.02868,2,172.0782,9.5599,86.0391,31.261125,2,0
0,0,10,10,14,18,32,51,39,90,0.000333,0.15,14,6300,350,450,128.361619,2,0
0,0,5,5,8,10,18,26,15,41,0.000333,0.056989,4,683.8677,37.99265,170.966925,57.219281,1,0
0,0,4,4,4,7,11,13,11,24,0.000333,0.027675,2,166.052718,9.225151,83.026359,27.651484,3,0
0,0,3,3,8,7,15,20,12,32,0.000333,0.041673,4,500.081996,27.782333,125.020499,43.651484,1,0
0,0,5,5,10,11,21,33,18,51,0.000333,0.074669,5,1120.040943,62.224497,224.008189,71.273029,1,0
0,0,3,3,9,8,17,16,11,27,0.000333,0.036787,4,441.445987,24.524777,110.361497,52.529325,2,0
0,0,6,6,7,11,18,41,25,66,0.000333,0.091738,6,1651.290301,91.73835,275.21505,57.705232,1,0
0,0,11,11,15,21,36,84,43,127,0.000333,0.21886,14,9192.126653,510.673703,656.580475,150.842025,2,0
0,0,11,11,15,21,36,84,43,127,0.000333,0.21886,14,9192.126653,510.673703,656.580475,150.842025,2,0
0,0,3,3,7,8,15,23,12,35,0.000333,0.04558,3,410.223513,22.790195,136.741171,43.651484,1,0
0,0,3,3,10,8,18,16,13,29,0.000333,0.040309,5,604.639125,33.591063,120.927825,57.219281,3,0
0,0,8,8,15,18,33,66,34,100,0.000333,0.168146,7,3531.075884,196.170882,504.439412,133.662009,2,0
0,0,4,4,11,6,17,20,14,34,0.000333,0.046325,10,1389.737366,77.207631,138.973737,53.563523,1,0
0,0,3,3,7,8,15,23,12,35,0.000333,0.04558,3,410.223513,22.790195,136.741171,43.651484,1,0
0,0,7,7,11,16,27,34,30,64,0.000333,0.101438,5,1521.564001,84.531333,304.3128,102.053748,1,0
0,0,6,6,14,11,25,40,23,63,0.000333,0.097521,14,4095.881159,227.548953,292.56294,91.356717,4,0
0,0,5,5,8,15,23,19,22,41,0.000333,0.061822,4,741.864161,41.214676,185.46604,82.603359,1,0
0,0,4,4,9,7,16,17,12,29,0.000333,0.038667,4,464,25.777778,116,48.180809,1,0
0,0,3,3,8,6,14,11,9,20,0.000333,0.025382,4,304.588394,16.921577,76.147098,39.509775,1,0
0,0,9,9,15,19,34,68,35,103,0.000333,0.17467,7,3668.060709,203.78115,524.008673,139.313982,2,0
0,0,5,5,9,9,18,29,18,47,0.000333,0.065329,8,1567.891801,87.1051,195.986475,57.05865,1,0
0,0,6,6,9,14,23,23,24,47,0.000333,0.070869,4,850.429648,47.246092,212.607412,81.832294,1,0
0,0,5,5,8,10,18,28,17,45,0.000333,0.062549,4,750.5865,41.69925,187.646625,57.219281,1,0
0,0,3,3,9,8,17,16,11,27,0.000333,0.036787,4,441.445987,24.524777,110.361497,52.529325,2,0
0,0,3,3,7,5,12,11,7,18,0.000333,0.02151,3,193.587975,10.754888,64.529325,31.261125,1,0
0,0,4,4,7,8,15,16,12,28,0.000333,0.036464,3,328.17881,18.232156,109.392937,43.651484,3,0
0,0,4,4,4,7,11,13,11,24,0.000333,0.027675,2,166.052718,9.225151,83.026359,27.651484,3,0
0,0,11,11,12,15,27,45,35,80,0.000333,0.126797,12,4564.692002,253.594,380.391,101.622909,1,0
0,0,3,3,7,8,15,23,12,35,0.000333,0.04558,3,410.223513,22.790195,136.741171,43.651484,1,0
0,0,7,7,11,19,30,44,28,72,0.000333,0.117765,5,1766.480614,98.137812,353.296123,118.764371,2,0
0,0,7,7,9,11,20,36,19,55,0.000333,0.079235,4,950.824181,52.823566,237.706045,66.583073,3,0
0,0,12,12,14,16,30,61,42,103,0.000333,0.16847,14,7075.736239,393.096458,505.409731,117.302969,2,0
0,0,8,8,11,16,27,36,29,65,0.000333,0.103023,5,1545.338438,85.852135,309.067688,102.053748,1,0
0,0,3,3,8,8,16,20,12,32,0.000333,0.042667,4,512,28.444444,128,48,1,0
0,0,3,3,8,7,15,11,9,20,0.000333,0.026046,4,312.551248,17.363958,78.137812,43.651484,1,0
0,0,9,9,9,17,26,28,39,67,0.000333,0.104976,8,2519.435689,139.968649,314.929461,98.016193,1,0
0,0,8,8,15,18,33,66,34,100,0.000333,0.168146,7,3531.075884,196.170882,504.439412,133.662009,2,0
0,0,9,9,15,19,34,68,35,103,0.000333,0.17467,7,3668.060709,203.78115,524.008673,139.313982,2,0
0,0,3,3,8,7,15,11,9,20,0.000333,0.026046,4,312.551248,17.363958,78.137812,43.651484,1,0
0,0,12,12,7,18,25,72,44,116,0.000333,0.179562,6,3232.123908,179.562439,538.687318,94.710134,1,0
0,0,11,11,8,18,26,71,42,113,0.000333,0.17705,8,4249.197505,236.066528,531.149688,99.05865,1,0
0,0,8,8,15,18,33,66,34,100,0.000333,0.168146,7,3531.075884,196.170882,504.439412,133.662009,2,0
0,0,11,11,15,21,36,84,43,127,0.000333,0.21886,14,9192.126653,510.673703,656.580475,150.842025,2,0
0,0,3,3,7,5,12,11,7,18,0.000333,0.02151,3,193.587975,10.754888,64.529325,31.261125,1,0
0,0,6,6,8,8,16,20,15,35,0.000333,0.046667,4,560,31.111111,140,48,1,0
0,0,5,5,10,12,22,23,18,41,0.000333,0.060946,5,914.183482,50.787971,182.836696,76.238831,1,0
0,0,9,9,8,14,22,38,32,70,0.000333,0.104053,8,2497.281706,138.737873,312.160213,77.302969,1,0
0,0,11,11,15,21,36,84,43,127,0.000333,0.21886,14,9192.126653,510.673703,656.580475,150.842025,2,0
0,0,7,7,9,10,19,31,22,53,0.000333,0.075047,8,1801.121266,100.062293,225.140158,61.748606,1,0
0,0,6,6,8,14,22,21,24,45,0.000333,0.066891,4,802.697691,44.594316,200.674423,77.302969,1,0
0,0,5,5,6,11,17,18,16,34,0.000333,0.046325,3,416.92121,23.162289,138.973737,53.563523,1,0
0,0,11,11,11,19,30,44,29,73,0.000333,0.119401,5,1791.015067,99.500837,358.203013,118.764371,4,0
0,0,7,7,8,14,22,51,25,76,0.000333,0.112972,4,1355.667212,75.314845,338.916803,77.302969,1,0
0,0,7,7,11,19,30,44,28,72,0.000333,0.117765,5,1766.480614,98.137812,353.296123,118.764371,2,0
0,0,8,8,15,18,33,66,34,100,0.000333,0.168146,7,3531.075884,196.170882,504.439412,133.662009,2,0
0,0,6,6,8,9,17,21,15,36,0.000333,0.04905,4,588.594649,32.699703,147.148662,52.529325,1,0
0,0,6,6,14,10,24,37,22,59,0.000333,0.090171,14,3787.179026,210.398835,270.512788,86.52225,4,0
0,0,25,25,12,35,47,382,213,595,0.000333,1.10166,36,118979.2932,6609.960733,3304.980367,222.544456,4,0
0,0,5,5,11,12,23,33,21,54,0.000333,0.081424,5,1221.361728,67.853429,244.272346,81.073298,1,0
0,0,25,25,12,35,47,382,213,595,0.000333,1.10166,36,118979.2932,6609.960733,3304.980367,222.544456,4,0
0,0,7,7,12,19,31,29,33,62,0.000333,0.102387,6,1842.961027,102.386724,307.160171,123.730173,4,0
0,0,6,6,9,10,19,24,18,42,0.000333,0.059471,4,713.651822,39.647323,178.412956,61.748606,1,0
0,0,5,5,10,10,20,20,20,40,0.000333,0.057626,10,1728.771238,96.042847,172.877124,66.438562,1,0
0,0,8,8,16,13,29,56,25,81,0.000333,0.131165,8,3147.971685,174.887316,393.496461,112.105716,3,0
0,0,3,3,8,8,16,20,12,32,0.000333,0.042667,4,512,28.444444,128,48,1,0
0,0,25,25,12,35,47,382,213,595,0.000333,1.10166,36,118979.2932,6609.960733,3304.980367,222.544456,4,0
0,0,5,5,11,12,23,33,21,54,0.000333,0.081424,5,1221.361728,67.853429,244.272346,81.073298,1,0
0,0,4,4,5,7,12,14,10,24,0.000333,0.02868,2,172.0782,9.5599,86.0391,31.261125,2,0
0,0,10,10,7,14,21,57,36,93,0.000333,0.136162,6,2450.913122,136.16184,408.48552,72.954453,1,0
0,0,10,10,14,18,32,51,39,90,0.000333,0.15,14,6300,350,450,128.361619,2,0
0,0,5,5,8,10,18,28,17,45,0.000333,0.062549,4,750.5865,41.69925,187.646625,57.219281,1,0
0,0,5,5,7,7,14,16,11,27,0.000333,0.034266,3,308.395749,17.133097,102.798583,39.302969,1,0
0,0,3,3,8,8,16,20,12,32,0.000333,0.042667,4,512,28.444444,128,48,1,0
0,0,8,8,15,18,33,66,34,100,0.000333,0.168146,7,3531.075884,196.170882,504.439412,133.662009,2,0
0,0,5,5,10,14,24,27,22,49,0.000333,0.074888,5,1123.315813,62.406434,224.663163,86.52225,3,0
0,0,11,11,15,21,36,84,43,127,0.000333,0.21886,14,9192.126653,510.673703,656.580475,150.842025,2,0
0,0,9,9,15,19,34,68,35,103,0.000333,0.17467,7,3668.060709,203.78115,524.008673,139.313982,2,0
0,0,9,9,11,15,26,40,38,78,0.000333,0.122211,10,3666.34298,203.685721,366.634298,96.657107,1,0
0,0,3,3,9,8,17,16,11,27,0.000333,0.036787,4,441.445987,24.524777,110.361497,52.529325,2,0
0,0,5,5,10,11,21,29,17,46,0.000333,0.067349,5,1010.233007,56.124056,202.046601,71.273029,1,0
0,0,3,3,8,8,16,20,12,32,0.000333,0.042667,4,512,28.444444,128,48,1,0
0,0,18,18,14,28,42,99,61,160,0.000333,0.28759,14,12078.79103,671.043946,862.770788,187.908907,5,0
0,0,18,18,11,28,39,115,64,179,0.000333,0.315362,10,9460.869972,525.603887,946.086997,172.659686,1,0
0,0,3,3,8,6,14,11,9,20,0.000333,0.025382,4,304.588394,16.921577,76.147098,39.509775,1,0
0,0,4,4,4,7,11,13,11,24,0.000333,0.027675,2,166.052718,9.225151,83.026359,27.651484,2,0
0,0,4,4,4,7,11,13,11,24,0.000333,0.027675,2,166.052718,9.225151,83.026359,27.651484,3,0
0,0,19,19,21,26,47,149,82,231,0.000333,0.427703,30,38493.30074,2138.516708,1283.110025,214.450099,11,0
0,0,17,17,21,26,47,131,75,206,0.000333,0.381415,20,22884.90607,1271.38367,1144.245303,214.450099,9,0
0,0,4,4,7,11,18,24,17,41,0.000333,0.056989,3,512.900775,28.494488,170.966925,57.705232,1,0
0,0,3,3,9,8,17,16,11,27,0.000333,0.036787,4,441.445987,24.524777,110.361497,52.529325,2,0
0,0,7,7,11,19,30,44,28,72,0.000333,0.117765,5,1766.480614,98.137812,353.296123,118.764371,2,0
0,0,3,3,14,14,28,29,19,48,0.000333,0.076918,7,1615.271254,89.737292,230.753036,106.605938,2,0
0,0,6,6,7,13,20,35,24,59,0.000333,0.084998,3,764.981273,42.49896,254.993758,67.757201,1,0
0,0,5,5,8,12,20,25,19,44,0.000333,0.063388,4,760.659345,42.258852,190.164836,67.01955,1,0
0,0,3,3,6,4,10,17,9,26,0.000333,0.02879,6,518.220783,28.790043,86.37013,23.509775,1,0
0,0,6,6,13,11,24,38,23,61,0.000333,0.093228,12,3356.192551,186.455142,279.682713,86.159464,4,0
0,0,4,4,6,12,18,18,16,34,0.000333,0.047259,3,425.33235,23.629575,141.77745,58.529325,1,0
0,0,7,7,11,19,30,44,28,72,0.000333,0.117765,5,1766.480614,98.137812,353.296123,118.764371,2,0
0,0,11,11,13,18,31,66,50,116,0.000333,0.191562,12,6896.241264,383.124515,574.686772,123.164366,1,0
0,0,26,26,19,35,54,242,100,342,0.000333,0.656057,18,35427.08746,1968.171526,1968.171526,260.235528,6,0
0,0,4,4,9,10,19,28,18,46,0.000333,0.065135,4,781.618662,43.423259,195.404666,61.748606,1,0
0,0,11,11,11,14,25,42,34,76,0.000333,0.117644,10,3529.330704,196.073928,352.93307,91.356717,1,0
0,0,6,6,7,11,18,41,25,66,0.000333,0.091738,6,1651.290301,91.73835,275.21505,57.705232,1,0
0,0,4,4,4,7,11,13,11,24,0.000333,0.027675,2,166.052718,9.225151,83.026359,27.651484,3,0
0,0,8,8,15,18,33,66,34,100,0.000333,0.168146,7,3531.075884,196.170882,504.439412,133.662009,2,0
0,0,9,9,15,20,35,72,36,108,0.000333,0.184654,7,3877.737961,215.429887,553.962566,145.041921,2,0
0,0,18,18,11,28,39,115,64,179,0.000333,0.315362,10,9460.869972,525.603887,946.086997,172.659686,10,0
0,0,6,6,14,11,25,40,23,63,0.000333,0.097521,14,4095.881159,227.548953,292.56294,91.356717,4,0
0,0,6,6,9,10,19,31,18,49,0.000333,0.069383,4,832.593793,46.255211,208.148448,61.748606,3,0
0,0,14,14,11,23,34,85,48,133,0.000333,0.225544,10,6766.325579,375.906977,676.632558,142.095673,1,0
0,0,5,5,8,10,18,28,17,45,0.000333,0.062549,4,750.5865,41.69925,187.646625,57.219281,1,0
0,0,5,5,8,10,18,28,17,45,0.000333,0.062549,4,750.5865,41.69925,187.646625,57.219281,1,0
0,0,5,5,12,16,28,39,25,64,0.000333,0.102557,6,1846.02429,102.556905,307.670715,107.01955,4,0
0,0,4,4,4,7,11,13,11,24,0.000333,0.027675,2,166.052718,9.225151,83.026359,27.651484,3,0
0,0,4,4,5,7,12,14,10,24,0.000333,0.02868,2,172.0782,9.5599,86.0391,31.261125,2,0
0,0,10,10,14,18,32,51,39,90,0.000333,0.15,14,6300,350,450,128.361619,2,0
0,0,7,7,11,19,30,44,28,72,0.000333,0.117765,5,1766.480614,98.137812,353.296123,118.764371,2,0
0,0,7,7,10,14,24,40,27,67,0.000333,0.102397,5,1535.962438,85.331247,307.192488,86.52225,1,0
0,0,4,4,6,12,18,20,17,37,0.000333,0.051429,3,462.861675,25.714538,154.287225,58.529325,1,0
0,0,4,4,5,10,15,13,13,26,0.000333,0.03386,2,203.158311,11.286573,101.579155,44.828921,1,0
0,0,3,3,8,7,15,11,9,20,0.000333,0.026046,4,312.551248,17.363958,78.137812,43.651484,1,0
0,0,6,6,14,12,26,43,26,69,0.000333,0.10811,14,4540.624768,252.256932,324.330341,96.322519,4,0
0,0,4,4,5,12,17,14,15,29,0.000333,0.039512,2,237.072845,13.170714,118.536422,54.62919,1,0
0,0,7,7,8,12,20,29,20,49,0.000333,0.070591,4,847.097907,47.060995,211.774477,67.01955,1,0
0,0,10,10,7,14,21,57,36,93,0.000333,0.136162,6,2450.913122,136.16184,408.48552,72.954453,1,0
0,0,5,5,10,8,18,37,19,56,0.000333,0.077839,10,2335.158001,129.731,233.5158,57.219281,6,0
0,0,3,3,8,8,16,20,12,32,0.000333,0.042667,4,512,28.444444,128,48,1,0
0,0,5,5,8,11,19,36,19,55,0.000333,0.077879,4,934.544053,51.919114,233.636013,62.053748,1,0
0,0,3,3,9,8,17,16,11,27,0.000333,0.036787,4,441.445987,24.524777,110.361497,52.529325,2,0
0,0,4,4,6,8,14,17,12,29,0.000333,0.036804,3,331.239878,18.402215,110.413293,39.509775,3,0
0,0,6,6,9,10,19,28,17,45,0.000333,0.063719,4,764.626952,42.479275,191.156738,61.748606,1,0
0,0,7,7,10,11,21,43,26,69,0.000333,0.101023,10,3030.699022,168.372168,303.069902,71.273029,6,0
0,0,8,8,10,11,21,46,27,73,0.000333,0.10688,10,3206.391719,178.132873,320.639172,71.273029,6,0
0,0,3,3,8,8,16,20,12,32,0.000333,0.042667,4,512,28.444444,128,48,1,0
0,0,5,5,9,10,19,35,21,56,0.000333,0.079295,8,1903.071526,105.726196,237.883941,61.748606,4,0
0,0,8,8,12,17,29,46,33,79,0.000333,0.127927,6,2302.682992,127.926833,383.780499,112.506418,1,0
0,0,4,4,4,7,11,13,11,24,0.000333,0.027675,2,166.052718,9.225151,83.026359,27.651484,3,0
0,0,4,4,6,8,14,17,12,29,0.000333,0.036804,3,331.239878,18.402215,110.413293,39.509775,3,0
0,0,9,9,15,19,34,68,35,103,0.000333,0.17467,7,3668.060709,203.78115,524.008673,139.313982,2,0
0,0,7,7,11,16,27,32,29,61,0.000333,0.096683,5,1450.240688,80.568927,290.048138,102.053748,1,0
0,0,4,4,5,10,15,13,13,26,0.000333,0.03386,2,203.158311,11.286573,101.579155,44.828921,1,0
0,0,8,8,14,12,26,49,30,79,0.000333,0.123778,14,5198.686328,288.815907,371.334738,96.322519,5,0
0,0,4,4,10,15,25,32,21,53,0.000333,0.082041,5,1230.62189,68.367883,246.124378,91.82264,1,0
0,0,7,7,11,19,30,44,28,72,0.000333,0.117765,5,1766.480614,98.137812,353.296123,118.764371,2,0
0,0,11,11,15,21,36,84,43,127,0.000333,0.21886,14,9192.126653,510.673703,656.580475,150.842025,2,0
0,0,8,8,15,18,33,66,34,100,0.000333,0.168146,7,3531.075884,196.170882,504.439412,133.662009,2,0
0,0,3,3,8,8,16,20,12,32,0.000333,0.042667,4,512,28.444444,128,48,1,0
0,0,5,5,12,13,25,28,18,46,0.000333,0.071206,6,1281.704308,71.205795,213.617385,91.125266,3,0
0,0,5,5,8,10,18,26,15,41,0.000333,0.056989,4,683.8677,37.99265,170.966925,57.219281,1,0
0,0,3,3,7,5,12,11,7,18,0.000333,0.02151,3,193.587975,10.754888,64.529325,31.261125,1,0
0,0,5,5,7,12,19,33,22,55,0.000333,0.077879,3,700.90804,38.939336,233.636013,62.671034,1,0
0,0,8,8,15,18,33,66,34,100,0.000333,0.168146,7,3531.075884,196.170882,504.439412,133.662009,2,0
0,0,4,4,10,15,25,32,21,53,0.000333,0.082041,5,1230.62189,68.367883,246.124378,91.82264,1,0
0,0,14,14,11,23,34,85,48,133,0.000333,0.225544,10,6766.325579,375.906977,676.632558,142.095673,1,0
0,0,9,9,15,20,35,72,36,108,0.000333,0.184654,7,3877.737961,215.429887,553.962566,145.041921,2,0
0,0,11,11,15,21,36,84,43,127,0.000333,0.21886,14,9192.126653,510.673703,656.580475,150.842025,2,0
0,0,9,9,15,19,34,68,35,103,0.000333,0.17467,7,3668.060709,203.78115,524.008673,139.313982,2,0
0,0,5,5,10,11,21,29,17,46,0.000333,0.067349,5,1010.233007,56.124056,202.046601,71.273029,1,0
0,0,9,9,12,14,26,44,34,78,0.000333,0.122211,12,4399.611576,244.422865,366.634298,96.322519,1,0
0,0,4,4,6,12,18,20,17,37,0.000333,0.051429,3,462.861675,25.714538,154.287225,58.529325,1,0
0,0,11,11,15,21,36,84,43,127,0.000333,0.21886,14,9192.126653,510.673703,656.580475,150.842025,2,0
0,0,25,25,12,35,47,382,213,595,0.000333,1.10166,36,118979.2932,6609.960733,3304.980367,222.544456,4,0
0,0,8,8,15,18,33,66,34,100,0.000333,0.168146,7,3531.075884,196.170882,504.439412,133.662009,2,0
0,0,3,3,7,8,15,23,12,35,0.000333,0.04558,3,410.223513,22.790195,136.741171,43.651484,1,0
0,0,4,4,9,7,16,16,11,27,0.000333,0.036,4,432,24,108,48.180809,1,0
0,0,5,5,8,9,17,23,16,39,0.000333,0.053137,4,637.644203,35.424678,159.411051,52.529325,1,0
0,0,3,3,7,8,15,23,12,35,0.000333,0.04558,3,410.223513,22.790195,136.741171,43.651484,1,0
0,0,13,13,14,20,34,82,48,130,0.000333,0.220457,14,9259.182371,514.399021,661.370169,139.741531,7,0
0,0,9,9,15,19,34,68,35,103,0.000333,0.17467,7,3668.060709,203.78115,524.008673,139.313982,2,0
0,0,8,8,12,17,29,52,34,86,0.000333,0.139262,12,5013.436387,278.524244,417.786366,112.506418,1,0
0,0,5,5,7,8,15,17,12,29,0.000333,0.037767,3,339.899482,18.883305,113.299827,43.651484,1,0
0,0,4,4,9,7,16,17,12,29,0.000333,0.038667,4,464,25.777778,116,48.180809,1,0
0,0,4,4,4,7,11,13,11,24,0.000333,0.027675,2,166.052718,9.225151,83.026359,27.651484,3,0
0,0,6,6,9,11,20,30,18,48,0.000333,0.069151,4,829.810194,46.100566,207.452549,66.583073,1,0
0,0,9,9,15,19,34,68,35,103,0.000333,0.17467,7,3668.060709,203.78115,524.008673,139.313982,2,0
0,0,14,14,11,23,34,85,48,133,0.000333,0.225544,10,6766.325579,375.906977,676.632558,142.095673,1,0
0,0,11,11,11,17,28,62,42,104,0.000333,0.166655,10,4999.649119,277.758284,499.964912,107.540616,1,0
0,0,3,3,11,11,22,29,15,44,0.000333,0.065405,5,981.074956,54.504164,196.214991,76.107496,3,0
0,0,4,4,4,7,11,13,11,24,0.000333,0.027675,2,166.052718,9.225151,83.026359,27.651484,3,0
0,0,5,5,8,10,18,28,17,45,0.000333,0.062549,4,750.5865,41.69925,187.646625,57.219281,1,0
0,0,7,7,11,12,23,49,24,73,0.000333,0.110073,10,3302.200228,183.455568,330.220023,81.073298,1,0
0,0,3,3,8,7,15,11,9,20,0.000333,0.026046,4,312.551248,17.363958,78.137812,43.651484,1,0
0,0,5,5,8,11,19,36,19,55,0.000333,0.077879,4,934.544053,51.919114,233.636013,62.053748,1,0
0,0,9,9,15,19,34,68,35,103,0.000333,0.17467,7,3668.060709,203.78115,524.008673,139.313982,2,0
0,0,4,4,4,7,11,13,11,24,0.000333,0.027675,2,166.052718,9.225151,83.026359,27.651484,2,0
0,0,5,5,10,11,21,33,18,51,0.000333,0.074669,5,1120.040943,62.224497,224.008189,71.273029,1,0
0,0,3,3,8,6,14,11,9,20,0.000333,0.025382,4,304.588394,16.921577,76.147098,39.509775,1,0
0,0,4,4,4,7,11,13,11,24,0.000333,0.027675,2,166.052718,9.225151,83.026359,27.651484,3,0
0,0,4,4,4,7,11,13,11,24,0.000333,0.027675,2,166.052718,9.225151,83.026359,27.651484,3,0
0,0,5,5,10,10,20,26,15,41,0.000333,0.059066,5,885.995259,49.221959,177.199052,66.438562,1,0
0,0,5,5,10,11,21,29,17,46,0.000333,0.067349,5,1010.233007,56.124056,202.046601,71.273029,1,0
0,0,7,7,8,14,22,30,32,62,0.000333,0.092162,8,2211.878083,122.882116,276.48476,77.302969,1,0
0,0,4,4,8,10,18,28,16,44,0.000333,0.061159,4,733.9068,40.7726,183.4767,57.219281,1,0
0,0,3,3,8,7,15,11,9,20,0.000333,0.026046,4,312.551248,17.363958,78.137812,43.651484,1,0
0,0,6,6,7,11,18,41,25,66,0.000333,0.091738,6,1651.290301,91.73835,275.21505,57.705232,1,0
0,0,3,3,11,11,22,29,15,44,0.000333,0.065405,5,981.074956,54.504164,196.214991,76.107496,3,0
0,0,6,6,9,10,19,28,17,45,0.000333,0.063719,4,764.626952,42.479275,191.156738,61.748606,1,0
0,0,5,5,8,10,18,28,17,45,0.000333,0.062549,4,750.5865,41.69925,187.646625,57.219281,1,0
0,0,7,7,11,19,30,44,28,72,0.000333,0.117765,5,1766.480614,98.137812,353.296123,118.764371,2,0
0,0,5,5,8,10,18,28,17,45,0.000333,0.062549,4,750.5865,41.69925,187.646625,57.219281,1,0
0,0,4,4,4,7,11,13,11,24,0.000333,0.027675,2,166.052718,9.225151,83.026359,27.651484,2,0
0,0,4,4,7,9,16,17,16,33,0.000333,0.044,3,396,22,132,48.180809,1,0
0,0,11,11,15,21,36,84,43,127,0.000333,0.21886,14,9192.126653,510.673703,656.580475,150.842025,2,0
0,0,9,9,15,19,34,68,35,103,0.000333,0.17467,7,3668.060709,203.78115,524.008673,139.313982,2,0
0,0,4,4,4,7,11,13,11,24,0.000333,0.027675,2,166.052718,9.225151,83.026359,27.651484,3,0
0,0,7,7,11,19,30,44,28,72,0.000333,0.117765,5,1766.480614,98.137812,353.296123,118.764371,2,0
0,0,4,4,10,10,20,25,17,42,0.000333,0.060507,5,907.6049,50.422494,181.52098,66.438562,1,0
0,0,5,5,8,10,18,28,17,45,0.000333,0.062549,4,750.5865,41.69925,187.646625,57.219281,1,0
0,0,11,11,15,21,36,84,43,127,0.000333,0.21886,14,9192.126653,510.673703,656.580475,150.842025,2,0
0,0,9,9,12,14,26,44,34,78,0.000333,0.122211,12,4399.611576,244.422865,366.634298,96.322519,1,0
0,0,25,25,12,35,47,382,213,595,0.000333,1.10166,36,118979.2932,6609.960733,3304.980367,222.544456,4,0
0,0,4,4,4,7,11,13,11,24,0.000333,0.027675,2,166.052718,9.225151,83.026359,27.651484,3,0
0,0,4,4,7,8,15,16,12,28,0.000333,0.036464,3,328.17881,18.232156,109.392937,43.651484,3,0
0,0,5,5,8,11,19,36,19,55,0.000333,0.077879,4,934.544053,51.919114,233.636013,62.053748,1,0
0,0,6,6,6,14,20,26,32,58,0.000333,0.083557,6,1504.030977,83.557277,250.67183,68.812744,1,0
0,0,4,4,11,10,21,24,14,38,0.000333,0.055636,5,834.54031,46.363351,166.908062,71.273029,3,0
0,0,4,4,4,7,11,13,11,24,0.000333,0.027675,2,166.052718,9.225151,83.026359,27.651484,3,0
0,0,3,3,7,5,12,11,7,18,0.000333,0.02151,3,193.587975,10.754888,64.529325,31.261125,1,0
0,0,8,8,15,18,33,66,34,100,0.000333,0.168146,7,3531.075884,196.170882,504.439412,133.662009,2,0
0,0,3,3,7,8,15,23,12,35,0.000333,0.04558,3,410.223513,22.790195,136.741171,43.651484,1,0
0,0,5,5,13,13,26,27,19,46,0.000333,0.072073,6,1297.321362,72.073409,216.220227,96.211433,1,0
0,0,3,3,9,12,21,17,14,31,0.000333,0.045387,4,544.64736,30.258187,136.16184,71.548875,1,0
0,0,4,4,9,11,20,26,16,42,0.000333,0.060507,4,726.08392,40.337996,181.52098,66.583073,1,0
0,0,11,11,15,21,36,84,43,127,0.000333,0.21886,14,9192.126653,510.673703,656.580475,150.842025,2,0
0,0,8,8,15,18,33,66,34,100,0.000333,0.168146,7,3531.075884,196.170882,504.439412,133.662009,2,0
0,0,3,3,7,5,12,11,7,18,0.000333,0.02151,3,193.587975,10.754888,64.529325,31.261125,1,0
0,0,4,4,6,13,19,17,17,34,0.000333,0.048143,3,433.288606,24.071589,144.429535,63.615491,1,0
0,0,9,9,15,19,34,68,35,103,0.000333,0.17467,7,3668.060709,203.78115,524.008673,139.313982,2,0
0,0,11,11,15,21,36,84,43,127,0.000333,0.21886,14,9192.126653,510.673703,656.580475,150.842025,2,0
0,0,8,8,15,18,33,66,34,100,0.000333,0.168146,7,3531.075884,196.170882,504.439412,133.662009,2,0
0,0,5,5,11,12,23,33,21,54,0.000333,0.081424,5,1221.361728,67.853429,244.272346,81.073298,1,0
0,0,4,4,10,11,21,19,16,35,0.000333,0.051244,5,768.655549,42.703086,153.73111,71.273029,1,0
0,0,4,4,6,11,17,14,14,28,0.000333,0.03815,3,343.346879,19.074827,114.44896,53.563523,1,0
0,0,4,4,6,8,14,17,12,29,0.000333,0.036804,3,331.239878,18.402215,110.413293,39.509775,3,0
0,0,7,7,14,12,26,47,27,74,0.000333,0.115944,14,4869.655548,270.536419,347.832539,96.322519,6,0
0,0,7,7,14,16,30,42,33,75,0.000333,0.122672,14,5152.235125,286.235285,368.016795,117.302969,4,0
0,0,3,3,8,7,15,11,9,20,0.000333,0.026046,4,312.551248,17.363958,78.137812,43.651484,1,0
0,0,6,6,9,12,21,23,18,41,0.000333,0.060028,4,720.340057,40.018892,180.085014,71.548875,1,0
0,0,7,7,11,19,30,44,28,72,0.000333,0.117765,5,1766.480614,98.137812,353.296123,118.764371,2,0
0,0,25,25,12,35,47,382,213,595,0.000333,1.10166,36,118979.2932,6609.960733,3304.980367,222.544456,4,0
0,0,5,5,11,12,23,33,21,54,0.000333,0.081424,5,1221.361728,67.853429,244.272346,81.073298,1,0
0,0,6,6,14,12,26,41,24,65,0.000333,0.101843,14,4277.400144,237.633341,305.528582,96.322519,5,0
0,0,4,4,4,7,11,13,11,24,0.000333,0.027675,2,166.052718,9.225151,83.026359,27.651484,3,0
0,0,11,11,15,21,36,84,43,127,0.000333,0.21886,14,9192.126653,510.673703,656.580475,150.842025,2,0
0,0,9,9,15,19,34,68,35,103,0.000333,0.17467,7,3668.060709,203.78115,524.008673,139.313982,2,0
0,0,8,8,15,18,33,66,34,100,0.000333,0.168146,7,3531.075884,196.170882,504.439412,133.662009,2,0
0,0,7,7,11,19,30,44,28,72,0.000333,0.117765,5,1766.480614,98.137812,353.296123,118.764371,2,0
0,0,3,3,8,8,16,20,12,32,0.000333,0.042667,4,512,28.444444,128,48,1,0
0,0,5,5,8,10,18,28,17,45,0.000333,0.062549,4,750.5865,41.69925,187.646625,57.219281,1,0
0,0,4,4,9,8,17,21,14,35,0.000333,0.047687,4,572.244798,31.791378,143.061199,52.529325,1,0
0,0,7,7,11,19,30,44,28,72,0.000333,0.117765,5,1766.480614,98.137812,353.296123,118.764371,2,0
0,0,16,16,12,25,37,93,56,149,0.000333,0.258736,12,9314.502618,517.472368,776.208551,159.115955,1,0
0,0,11,11,15,21,36,84,43,127,0.000333,0.21886,14,9192.126653,510.673703,656.580475,150.842025,2,0
0,0,4,4,4,7,11,13,11,24,0.000333,0.027675,2,166.052718,9.225151,83.026359,27.651484,3,0
0,0,8,8,15,18,33,66,34,100,0.000333,0.168146,7,3531.075884,196.170882,504.439412,133.662009,2,0
0,0,9,9,15,19,34,68,35,103,0.000333,0.17467,7,3668.060709,203.78115,524.008673,139.313982,2,0
0,0,4,4,4,7,11,13,11,24,0.000333,0.027675,2,166.052718,9.225151,83.026359,27.651484,3,0
0,0,9,9,15,19,34,68,35,103,0.000333,0.17467,7,3668.060709,203.78115,524.008673,139.313982,2,0
0,0,9,9,15,15,30,39,25,64,0.000333,0.10468,7,2198.286987,122.127055,314.040998,117.206718,3,0
0,0,9,9,15,19,34,68,35,103,0.000333,0.17467,7,3668.060709,203.78115,524.008673,139.313982,2,0
0,0,5,5,10,11,21,33,18,51,0.000333,0.074669,5,1120.040943,62.224497,224.008189,71.273029,1,0
0,0,11,11,15,21,36,84,43,127,0.000333,0.21886,14,9192.126653,510.673703,656.580475,150.842025,2,0
0,0,8,8,15,18,33,66,34,100,0.000333,0.168146,7,3531.075884,196.170882,504.439412,133.662009,2,0
0,0,5,5,8,11,19,30,18,48,0.000333,0.067967,4,815.602083,45.311227,203.900521,62.053748,1,0
0,0,3,3,8,6,14,11,9,20,0.000333,0.025382,4,304.588394,16.921577,76.147098,39.509775,1,0
0,0,3,3,8,7,15,11,9,20,0.000333,0.026046,4,312.551248,17.363958,78.137812,43.651484,1,0
0,0,10,10,14,16,30,51,35,86,0.000333,0.140664,14,5907.896277,328.21646,421.992591,117.302969,2,0
0,0,8,8,15,14,29,49,31,80,0.000333,0.129546,14,5440.938715,302.274373,388.63848,111.906328,4,0
0,0,5,5,8,10,18,28,17,45,0.000333,0.062549,4,750.5865,41.69925,187.646625,57.219281,1,0
0,0,5,5,7,8,15,17,12,29,0.000333,0.037767,3,339.899482,18.883305,113.299827,43.651484,1,0
0,0,8,8,15,18,33,66,34,100,0.000333,0.168146,7,3531.075884,196.170882,504.439412,133.662009,2,0
0,0,5,5,7,8,15,18,14,32,0.000333,0.041673,3,375.061497,20.83675,125.020499,43.651484,1,0
0,0,11,11,15,21,36,84,43,127,0.000333,0.21886,14,9192.126653,510.673703,656.580475,150.842025,2,0
0,0,8,8,15,18,33,66,34,100,0.000333,0.168146,7,3531.075884,196.170882,504.439412,133.662009,2,0
0,0,11,11,15,21,36,84,43,127,0.000333,0.21886,14,9192.126653,510.673703,656.580475,150.842025,2,0
0,0,25,25,12,35,47,382,213,595,0.000333,1.10166,36,118979.2932,6609.960733,3304.980367,222.544456,4,0
0,0,5,5,8,10,18,28,17,45,0.000333,0.062549,4,750.5865,41.69925,187.646625,57.219281,1,0
0,0,3,3,8,7,15,11,9,20,0.000333,0.026046,4,312.551248,17.363958,78.137812,43.651484,1,0
0,0,7,7,11,19,30,44,28,72,0.000333,0.117765,5,1766.480614,98.137812,353.296123,118.764371,2,0
0,0,4,4,7,13,20,23,18,41,0.000333,0.059066,3,531.597156,29.533175,177.199052,67.757201,1,0
0,0,5,5,11,12,23,33,21,54,0.000333,0.081424,5,1221.361728,67.853429,244.272346,81.073298,1,0
0,0,3,3,9,8,17,16,11,27,0.000333,0.036787,4,441.445987,24.524777,110.361497,52.529325,2,0
0,0,3,3,8,8,16,20,12,32,0.000333,0.042667,4,512,28.444444,128,48,1,0
0,0,11,11,15,21,36,84,43,127,0.000333,0.21886,14,9192.126653,510.673703,656.580475,150.842025,2,0
0,0,13,13,13,22,35,98,52,150,0.000333,0.256464,12,9232.709431,512.928302,769.392453,146.213212,6,0
0,0,10,10,16,20,36,52,44,96,0.000333,0.165438,16,7941.004802,441.166933,496.3128,150.438562,4,0
0,0,4,4,10,15,25,32,21,53,0.000333,0.082041,5,1230.62189,68.367883,246.124378,91.82264,1,0
0,0,4,4,5,9,14,15,13,28,0.000333,0.035535,2,213.211876,11.845104,106.605938,40.138965,1,0
0,0,3,3,7,8,15,23,12,35,0.000333,0.04558,3,410.223513,22.790195,136.741171,43.651484,1,0
0,0,5,5,7,8,15,17,12,29,0.000333,0.037767,3,339.899482,18.883305,113.299827,43.651484,1,0
0,0,6,6,14,11,25,40,23,63,0.000333,0.097521,14,4095.881159,227.548953,292.56294,91.356717,4,0
0,0,5,5,12,13,25,28,18,46,0.000333,0.071206,6,1281.704308,71.205795,213.617385,91.125266,3,0
0,0,4,4,4,7,11,13,11,24,0.000333,0.027675,2,166.052718,9.225151,83.026359,27.651484,3,0
0,0,3,3,9,8,17,16,11,27,0.000333,0.036787,4,441.445987,24.524777,110.361497,52.529325,2,0
0,0,19,19,11,22,33,164,82,246,0.000333,0.41364,15,18613.8143,1034.100794,1240.920953,136.161243,1,0
0,0,11,11,15,21,36,84,43,127,0.000333,0.21886,14,9192.126653,510.673703,656.580475,150.842025,2,0
0,0,8,8,15,18,33,66,34,100,0.000333,0.168146,7,3531.075884,196.170882,504.439412,133.662009,2,0
0,0,3,3,10,6,16,22,12,34,0.000333,0.045333,10,1360,75.555556,136,48.729056,1,0
0,0,5,5,8,10,18,28,17,45,0.000333,0.062549,4,750.5865,41.69925,187.646625,57.219281,1,0
0,0,3,3,7,8,15,23,12,35,0.000333,0.04558,3,410.223513,22.790195,136.741171,43.651484,1,0
0,0,3,3,10,8,18,16,13,29,0.000333,0.040309,5,604.639125,33.591063,120.927825,57.219281,3,0
0,0,4,4,5,7,12,14,10,24,0.000333,0.02868,2,172.0782,9.5599,86.0391,31.261125,2,0
0,0,4,4,7,9,16,17,16,33,0.000333,0.044,3,396,22,132,48.180809,1,0
0,0,6,6,9,10,19,28,17,45,0.000333,0.063719,4,764.626952,42.479275,191.156738,61.748606,1,0
0,0,3,3,8,8,16,20,12,32,0.000333,0.042667,4,512,28.444444,128,48,1,0
0,0,5,5,7,13,20,21,18,39,0.000333,0.056185,3,505.665587,28.092533,168.555196,67.757201,1,0
0,0,3,3,8,8,16,20,12,32,0.000333,0.042667,4,512,28.444444,128,48,1,0
0,0,3,3,8,7,15,20,12,32,0.000333,0.041673,4,500.081996,27.782333,125.020499,43.651484,1,0
0,0,5,5,11,11,22,31,17,48,0.000333,0.071351,5,1070.263588,59.459088,214.052718,76.107496,1,0
0,0,4,4,6,8,14,17,12,29,0.000333,0.036804,3,331.239878,18.402215,110.413293,39.509775,3,0
0,0,11,11,15,21,36,84,43,127,0.000333,0.21886,14,9192.126653,510.673703,656.580475,150.842025,2,0
0,0,4,4,6,8,14,17,12,29,0.000333,0.036804,3,331.239878,18.402215,110.413293,39.509775,3,0
0,0,4,4,9,13,22,22,17,39,0.000333,0.057973,4,695.671333,38.648407,173.917833,76.635041,3,0
0,0,4,4,7,9,16,17,16,33,0.000333,0.044,3,396,22,132,48.180809,1,0
0,0,5,5,7,10,17,19,16,35,0.000333,0.047687,3,429.183598,23.843533,143.061199,52.870765,3,0
0,0,3,3,8,8,16,20,12,32,0.000333,0.042667,4,512,28.444444,128,48,1,0
0,0,4,4,4,7,11,13,11,24,0.000333,0.027675,2,166.052718,9.225151,83.026359,27.651484,2,0
0,0,6,6,9,10,19,28,17,45,0.000333,0.063719,4,764.626952,42.479275,191.156738,61.748606,1,0
0,0,9,9,15,19,34,68,35,103,0.000333,0.17467,7,3668.060709,203.78115,524.008673,139.313982,2,0
0,0,4,4,10,15,25,32,21,53,0.000333,0.082041,5,1230.62189,68.367883,246.124378,91.82264,1,0
0,0,4,4,4,7,11,13,11,24,0.000333,0.027675,2,166.052718,9.225151,83.026359,27.651484,3,0
0,0,4,4,6,8,14,17,12,29,0.000333,0.036804,3,331.239878,18.402215,110.413293,39.509775,3,0
0,0,3,3,7,8,15,23,12,35,0.000333,0.04558,3,410.223513,22.790195,136.741171,43.651484,1,0
0,0,3,3,9,10,19,20,12,32,0.000333,0.045311,4,543.734722,30.207485,135.93368,61.748606,3,0
0,0,5,5,7,7,14,16,11,27,0.000333,0.034266,3,308.395749,17.133097,102.798583,39.302969,1,0
0,0,7,7,11,19,30,44,28,72,0.000333,0.117765,5,1766.480614,98.137812,353.296123,118.764371,2,0
0,0,5,5,8,11,19,30,18,48,0.000333,0.067967,4,815.602083,45.311227,203.900521,62.053748,1,0
0,0,11,11,11,17,28,62,42,104,0.000333,0.166655,10,4999.649119,277.758284,499.964912,107.540616,1,0
0,0,7,7,11,19,30,44,28,72,0.000333,0.117765,5,1766.480614,98.137812,353.296123,118.764371,2,0
0,0,3,3,7,8,15,23,12,35,0.000333,0.04558,3,410.223513,22.790195,136.741171,43.651484,1,0
0,0,9,9,15,19,34,68,35,103,0.000333,0.17467,7,3668.060709,203.78115,524.008673,139.313982,2,0
0,0,7,7,11,18,29,48,28,76,0.000333,0.123069,5,1846.032778,102.557377,369.206556,113.112398,1,0
0,0,3,3,8,7,15,11,9,20,0.000333,0.026046,4,312.551248,17.363958,78.137812,43.651484,1,0
0,0,3,3,7,5,12,11,7,18,0.000333,0.02151,3,193.587975,10.754888,64.529325,31.261125,1,0
0,0,5,5,8,11,19,30,18,48,0.000333,0.067967,4,815.602083,45.311227,203.900521,62.053748,1,0
0,0,3,3,8,8,16,20,12,32,0.000333,0.042667,4,512,28.444444,128,48,1,0
0,0,6,6,9,10,19,28,17,45,0.000333,0.063719,4,764.626952,42.479275,191.156738,61.748606,1,0
0,0,4,4,4,7,11,13,11,24,0.000333,0.027675,2,166.052718,9.225151,83.026359,27.651484,3,0
0,0,3,3,8,7,15,15,9,24,0.000333,0.031255,4,375.061497,20.83675,93.765374,43.651484,3,0
0,0,5,5,12,16,28,39,25,64,0.000333,0.102557,6,1846.02429,102.556905,307.670715,107.01955,2,0
0,0,5,5,8,11,19,36,19,55,0.000333,0.077879,4,934.544053,51.919114,233.636013,62.053748,1,0
0,0,3,3,7,8,15,23,12,35,0.000333,0.04558,3,410.223513,22.790195,136.741171,43.651484,1,0
0,0,4,4,5,12,17,16,16,32,0.000333,0.0436,2,261.597622,14.533201,130.798811,54.62919,1,0
0,0,9,9,15,19,34,68,35,103,0.000333,0.17467,7,3668.060709,203.78115,524.008673,139.313982,2,0
0,0,11,11,15,21,36,84,43,127,0.000333,0.21886,14,9192.126653,510.673703,656.580475,150.842025,2,0
0,0,8,8,15,18,33,66,34,100,0.000333,0.168146,7,3531.075884,196.170882,504.439412,133.662009,2,0
0,0,8,8,12,17,29,52,34,86,0.000333,0.139262,12,5013.436387,278.524244,417.786366,112.506418,1,0
0,0,7,7,11,19,30,44,28,72,0.000333,0.117765,5,1766.480614,98.137812,353.296123,118.764371,2,0
0,0,4,4,8,8,16,18,12,30,0.000333,0.04,4,480,26.666667,120,48,1,0
0,0,4,4,6,13,19,16,16,32,0.000333,0.045311,3,407.801041,22.655613,135.93368,63.615491,1,0
0,0,4,4,10,10,20,18,15,33,0.000333,0.047541,5,713.118136,39.617674,142.623627,66.438562,1,0
0,0,23,23,13,34,47,157,98,255,0.000333,0.47214,12,16997.04189,944.280105,1416.420157,221.079453,1,0
0,0,7,7,11,19,30,44,28,72,0.000333,0.117765,5,1766.480614,98.137812,353.296123,118.764371,2,0
0,0,5,5,10,10,20,26,15,41,0.000333,0.059066,5,885.995259,49.221959,177.199052,66.438562,1,0
0,0,5,5,8,10,18,26,15,41,0.000333,0.056989,4,683.8677,37.99265,170.966925,57.219281,1,0
0,0,9,9,15,19,34,68,35,103,0.000333,0.17467,7,3668.060709,203.78115,524.008673,139.313982,2,0
0,0,11,11,15,21,36,84,43,127,0.000333,0.21886,14,9192.126653,510.673703,656.580475,150.842025,2,0
0,0,5,5,8,10,18,28,17,45,0.000333,0.062549,4,750.5865,41.69925,187.646625,57.219281,1,0
0,0,5,5,11,13,24,24,18,42,0.000333,0.064189,5,962.842125,53.491229,192.568425,86.159464,1,0
0,0,8,8,8,14,22,33,38,71,0.000333,0.10554,8,2532.957159,140.719842,316.619645,77.302969,1,0
0,0,6,6,8,13,21,29,22,51,0.000333,0.074669,4,896.032754,49.779597,224.008189,72.105716,1,0
0,0,4,4,11,6,17,20,14,34,0.000333,0.046325,10,1389.737366,77.207631,138.973737,53.563523,1,0
0,0,4,4,8,7,15,17,10,27,0.000333,0.035162,4,421.944184,23.441344,105.486046,43.651484,1,0
0,0,5,5,8,10,18,28,17,45,0.000333,0.062549,4,750.5865,41.69925,187.646625,57.219281,1,0
0,0,4,4,6,8,14,17,12,29,0.000333,0.036804,3,331.239878,18.402215,110.413293,39.509775,3,0
0,0,3,3,8,8,16,20,12,32,0.000333,0.042667,4,512,28.444444,128,48,1,0
0,0,8,8,14,13,27,50,31,81,0.000333,0.128382,14,5392.042427,299.557913,385.145888,101.408685,6,0
0,0,3,3,11,11,22,26,15,41,0.000333,0.060946,5,914.183482,50.787971,182.836696,76.107496,3,0
0,0,4,4,9,9,18,19,15,34,0.000333,0.047259,4,567.1098,31.5061,141.77745,57.05865,1,0
0,0,4,4,8,7,15,15,10,25,0.000333,0.032557,4,390.68906,21.704948,97.672265,43.651484,1,0
0,0,13,13,10,14,24,73,48,121,0.000333,0.184927,15,8321.706939,462.317052,554.780463,86.52225,1,0
0,0,4,4,10,8,18,25,15,40,0.000333,0.055599,5,833.985,46.3325,166.797,57.219281,1,0
0,0,9,9,15,19,34,68,35,103,0.000333,0.17467,7,3668.060709,203.78115,524.008673,139.313982,2,0
0,0,3,3,9,8,17,16,11,27,0.000333,0.036787,4,441.445987,24.524777,110.361497,52.529325,2,0
0,0,8,8,15,18,33,66,34,100,0.000333,0.168146,7,3531.075884,196.170882,504.439412,133.662009,2,0
0,0,11,11,15,21,36,84,43,127,0.000333,0.21886,14,9192.126653,510.673703,656.580475,150.842025,2,0
0,0,3,3,8,7,15,11,9,20,0.000333,0.026046,4,312.551248,17.363958,78.137812,43.651484,1,0
0,0,5,5,10,10,20,26,15,41,0.000333,0.059066,5,885.995259,49.221959,177.199052,66.438562,1,0
0,0,3,3,7,8,15,23,12,35,0.000333,0.04558,3,410.223513,22.790195,136.741171,43.651484,1,0
0,0,5,5,8,10,18,28,17,45,0.000333,0.062549,4,750.5865,41.69925,187.646625,57.219281,1,0
0,0,10,10,14,18,32,51,39,90,0.000333,0.15,14,6300,350,450,128.361619,2,0
0,0,4,4,5,7,12,14,10,24,0.000333,0.02868,2,172.0782,9.5599,86.0391,31.261125,2,0
0,0,9,9,10,18,28,62,36,98,0.000333,0.15704,10,4711.207824,261.733768,471.120782,108.277931,1,0
0,0,3,3,8,8,16,20,12,32,0.000333,0.042667,4,512,28.444444,128,48,1,0
0,0,6,6,7,11,18,41,25,66,0.000333,0.091738,6,1651.290301,91.73835,275.21505,57.705232,1,0
0,0,5,5,8,10,18,28,17,45,0.000333,0.062549,4,750.5865,41.69925,187.646625,57.219281,1,0
0,0,10,10,16,17,33,55,39,94,0.000333,0.158058,16,7586.768756,421.487153,474.173047,133.486868,4,0
0,0,10,10,7,14,21,57,36,93,0.000333,0.136162,6,2450.913122,136.16184,408.48552,72.954453,3,0
0,0,3,3,8,8,16,20,12,32,0.000333,0.042667,4,512,28.444444,128,48,1,0
0,0,3,3,12,9,21,21,11,32,0.000333,0.046851,6,843.324945,46.851386,140.554158,71.548875,3,0
0,0,4,4,4,7,11,13,11,24,0.000333,0.027675,2,166.052718,9.225151,83.026359,27.651484,3,0
0,0,6,6,14,12,26,41,24,65,0.000333,0.101843,14,4277.400144,237.633341,305.528582,96.322519,5,0
0,0,4,4,5,9,14,18,12,30,0.000333,0.038074,2,228.441295,12.691183,114.220648,40.138965,1,0
0,0,5,5,8,10,18,28,17,45,0.000333,0.062549,4,750.5865,41.69925,187.646625,57.219281,1,0
0,0,3,3,7,8,15,23,12,35,0.000333,0.04558,3,410.223513,22.790195,136.741171,43.651484,1,0
0,0,8,8,14,13,27,50,31,81,0.000333,0.128382,14,5392.042427,299.557913,385.145888,101.408685,6,0
0,0,10,10,11,11,22,39,33,72,0.000333,0.107026,15,4816.186148,267.565897,321.079077,76.107496,1,0
0,0,7,7,11,18,29,48,28,76,0.000333,0.123069,5,1846.032778,102.557377,369.206556,113.112398,1,0
0,0,7,7,11,19,30,44,28,72,0.000333,0.117765,5,1766.480614,98.137812,353.296123,118.764371,2,0
0,0,8,8,15,18,33,66,34,100,0.000333,0.168146,7,3531.075884,196.170882,504.439412,133.662009,2,0
0,0,3,3,7,8,15,23,12,35,0.000333,0.04558,3,410.223513,22.790195,136.741171,43.651484,1,0
0,0,3,3,7,8,15,23,12,35,0.000333,0.04558,3,410.223513,22.790195,136.741171,43.651484,1,0
0,0,6,6,5,12,17,19,26,45,0.000333,0.061312,4,735.743311,40.874628,183.935828,54.62919,1,0
0,0,7,7,11,19,30,44,28,72,0.000333,0.117765,5,1766.480614,98.137812,353.296123,118.764371,2,0
0,0,4,4,6,8,14,17,12,29,0.000333,0.036804,3,331.239878,18.402215,110.413293,39.509775,3,0
0,0,4,4,6,8,14,17,12,29,0.000333,0.036804,3,331.239878,18.402215,110.413293,39.509775,3,0
0,0,7,7,11,19,30,44,28,72,0.000333,0.117765,5,1766.480614,98.137812,353.296123,118.764371,2,0
0,0,9,9,15,19,34,68,35,103,0.000333,0.17467,7,3668.060709,203.78115,524.008673,139.313982,2,0
0,0,3,3,9,8,17,16,10,26,0.000333,0.035425,4,425.096135,23.616452,106.274034,52.529325,3,0
0,0,4,4,4,7,11,13,11,24,0.000333,0.027675,2,166.052718,9.225151,83.026359,27.651484,3,0
0,0,5,5,10,11,21,33,18,51,0.000333,0.074669,5,1120.040943,62.224497,224.008189,71.273029,1,0
0,0,3,3,7,5,12,11,7,18,0.000333,0.02151,3,193.587975,10.754888,64.529325,31.261125,1,0
0,0,8,8,16,17,33,49,35,84,0.000333,0.141243,16,6779.665696,376.648094,423.729106,133.486868,4,0
0,0,3,3,8,7,15,20,12,32,0.000333,0.041673,4,500.081996,27.782333,125.020499,43.651484,1,0
0,0,5,5,12,13,25,28,19,47,0.000333,0.072754,6,1309.567446,72.753747,218.261241,91.125266,1,0
0,0,3,3,9,8,17,16,11,27,0.000333,0.036787,4,441.445987,24.524777,110.361497,52.529325,2,0
0,0,11,11,23,28,51,79,50,129,0.000333,0.243914,11,8049.17156,447.176198,731.742869,238.647863,9,0
0,0,9,9,15,19,34,68,35,103,0.000333,0.17467,7,3668.060709,203.78115,524.008673,139.313982,2,0
0,0,3,3,7,8,15,23,12,35,0.000333,0.04558,3,410.223513,22.790195,136.741171,43.651484,1,0
0,0,31,31,13,36,49,303,115,418,0.000333,0.782316,18,42245.07687,2346.948715,2346.948715,234.223016,7,0
0,0,6,6,14,11,25,40,23,63,0.000333,0.097521,14,4095.881159,227.548953,292.56294,91.356717,4,0
0,0,3,3,8,7,15,11,9,20,0.000333,0.026046,4,312.551248,17.363958,78.137812,43.651484,1,0
0,0,8,8,15,18,33,66,34,100,0.000333,0.168146,7,3531.075884,196.170882,504.439412,133.662009,2,0
0,0,3,3,8,6,14,11,9,20,0.000333,0.025382,4,304.588394,16.921577,76.147098,39.509775,1,0
0,0,4,4,5,9,14,15,13,28,0.000333,0.035535,2,213.211876,11.845104,106.605938,40.138965,1,0
0,0,6,6,10,8,18,37,22,59,0.000333,0.082009,10,2460.255751,136.680875,246.025575,57.219281,1,0
0,0,21,21,11,30,41,121,71,192,0.000333,0.342883,10,10286.49985,571.472214,1028.649985,185.260466,1,0
0,0,5,5,10,7,17,42,23,65,0.000333,0.088562,15,3985.27627,221.404237,265.685085,52.870765,1,0
0,0,6,6,7,11,18,41,25,66,0.000333,0.091738,6,1651.290301,91.73835,275.21505,57.705232,1,0
0,0,7,7,11,19,30,44,28,72,0.000333,0.117765,5,1766.480614,98.137812,353.296123,118.764371,2,0
0,0,5,5,10,7,17,20,16,36,0.000333,0.04905,10,1471.486623,81.749257,147.148662,52.870765,1,0
0,0,4,4,9,8,17,21,14,35,0.000333,0.047687,4,572.244798,31.791378,143.061199,52.529325,1,0
0,0,6,6,8,13,21,42,25,67,0.000333,0.098095,4,1177.141069,65.396726,294.285267,72.105716,1,0
0,0,3,3,8,6,14,11,9,20,0.000333,0.025382,4,304.588394,16.921577,76.147098,39.509775,1,0
0,0,3,3,8,8,16,20,12,32,0.000333,0.042667,4,512,28.444444,128,48,1,0
0,0,7,7,11,19,30,44,28,72,0.000333,0.117765,5,1766.480614,98.137812,353.296123,118.764371,2,0
0,0,15,15,13,21,34,80,51,131,0.000333,0.222153,12,7997.491586,444.305088,666.457632,140.344382,2,0
0,0,4,4,5,7,12,14,10,24,0.000333,0.02868,2,172.0782,9.5599,86.0391,31.261125,2,0
0,0,14,14,15,21,36,65,57,122,0.000333,0.210244,14,8830.231902,490.568439,630.73085,150.842025,2,0
0,0,8,8,11,15,26,59,34,93,0.000333,0.145714,10,4371.408938,242.856052,437.140894,96.657107,1,0
0,0,3,3,9,13,22,20,16,36,0.000333,0.053513,4,642.158153,35.675453,160.539538,76.635041,3,0
0,0,3,3,7,5,12,11,7,18,0.000333,0.02151,3,193.587975,10.754888,64.529325,31.261125,1,0
0,0,7,7,11,19,30,44,28,72,0.000333,0.117765,5,1766.480614,98.137812,353.296123,118.764371,2,0
0,0,4,4,8,10,18,34,17,51,0.000333,0.070889,4,850.6647,47.25915,212.666175,57.219281,1,0
0,0,9,9,15,19,34,68,35,103,0.000333,0.17467,7,3668.060709,203.78115,524.008673,139.313982,2,0
0,0,11,11,15,21,36,84,43,127,0.000333,0.21886,14,9192.126653,510.673703,656.580475,150.842025,2,0
0,0,6,6,13,11,24,38,23,61,0.000333,0.093228,12,3356.192551,186.455142,279.682713,86.159464,4,0
0,0,8,8,14,11,25,39,24,63,0.000333,0.097521,14,4095.881159,227.548953,292.56294,91.356717,1,0
0,0,3,3,9,8,17,16,11,27,0.000333,0.036787,4,441.445987,24.524777,110.361497,52.529325,2,0
0,0,11,11,13,17,30,60,47,107,0.000333,0.175012,12,6300.447525,350.024862,525.037294,117.592585,1,0
0,0,3,3,8,8,16,20,12,32,0.000333,0.042667,4,512,28.444444,128,48,1,0
0,0,5,5,11,12,23,33,21,54,0.000333,0.081424,5,1221.361728,67.853429,244.272346,81.073298,1,0
0,0,4,4,4,7,11,13,11,24,0.000333,0.027675,2,166.052718,9.225151,83.026359,27.651484,3,0
0,0,7,7,11,19,30,44,28,72,0.000333,0.117765,5,1766.480614,98.137812,353.296123,118.764371,2,0
0,0,7,7,11,19,30,44,28,72,0.000333,0.117765,5,1766.480614,98.137812,353.296123,118.764371,2,0
0,0,7,7,8,14,22,30,32,62,0.000333,0.092162,8,2211.878083,122.882116,276.48476,77.302969,1,0
0,0,5,5,10,11,21,33,18,51,0.000333,0.074669,5,1120.040943,62.224497,224.008189,71.273029,1,0
0,0,5,5,4,5,9,15,12,27,0.000333,0.028529,4,342.3519,19.01955,85.587975,19.60964,1,0
0,0,7,7,11,19,30,44,28,72,0.000333,0.117765,5,1766.480614,98.137812,353.296123,118.764371,2,0
0,0,9,9,9,15,24,27,34,61,0.000333,0.093228,8,2237.4617,124.303428,279.682713,87.132684,1,0
0,0,6,6,9,9,18,23,16,39,0.000333,0.054209,4,650.5083,36.13935,162.627075,57.05865,1,0
0,0,5,5,6,11,17,18,16,34,0.000333,0.046325,3,416.92121,23.162289,138.973737,53.563523,1,0
0,0,7,7,11,13,24,31,26,57,0.000333,0.087114,10,2613.428625,145.190479,261.342863,86.159464,1,0
0,0,3,3,7,8,15,23,12,35,0.000333,0.04558,3,410.223513,22.790195,136.741171,43.651484,1,0
0,0,6,6,5,12,17,19,26,45,0.000333,0.061312,4,735.743311,40.874628,183.935828,54.62919,1,0
0,0,3,3,8,8,16,20,12,32,0.000333,0.042667,4,512,28.444444,128,48,1,0
0,0,5,5,11,11,22,31,17,48,0.000333,0.071351,5,1070.263588,59.459088,214.052718,76.107496,1,0
0,0,4,4,11,10,21,36,17,53,0.000333,0.077598,5,1163.964117,64.664673,232.792823,71.273029,1,0
0,0,4,4,4,7,11,13,11,24,0.000333,0.027675,2,166.052718,9.225151,83.026359,27.651484,3,0
0,0,12,12,9,16,25,51,42,93,0.000333,0.14396,8,3455.029005,191.946056,431.878626,92.529325,1,0
0,0,5,5,8,9,17,25,15,40,0.000333,0.0545,4,653.994055,36.333003,163.498514,52.529325,1,0
0,0,10,10,7,14,21,57,36,93,0.000333,0.136162,6,2450.913122,136.16184,408.48552,72.954453,1,0
0,0,5,5,7,16,23,31,27,58,0.000333,0.087456,3,787.09978,43.727766,262.366593,83.651484,1,0
0,0,7,7,10,16,26,28,28,56,0.000333,0.087742,5,1316.123121,73.117951,263.224624,97.219281,1,0
0,0,5,5,11,13,24,28,20,48,0.000333,0.073359,5,1100.391,61.132833,220.0782,86.159464,1,0
0,0,3,3,8,7,15,21,11,32,0.000333,0.041673,4,500.081996,27.782333,125.020499,43.651484,1,0
0,0,3,3,10,9,19,20,15,35,0.000333,0.049559,5,743.387315,41.299295,148.677463,61.748606,1,0
0,0,3,3,7,13,20,20,19,39,0.000333,0.056185,3,505.665587,28.092533,168.555196,67.757201,1,0
0,0,5,5,7,15,22,31,26,57,0.000333,0.084729,3,762.562807,42.3646,254.187602,78.254843,1,0
0,0,4,4,10,15,25,32,21,53,0.000333,0.082041,5,1230.62189,68.367883,246.124378,91.82264,1,0
0,0,3,3,8,6,14,11,9,20,0.000333,0.025382,4,304.588394,16.921577,76.147098,39.509775,1,0
0,0,3,3,10,8,18,16,13,29,0.000333,0.040309,5,604.639125,33.591063,120.927825,57.219281,3,0
0,0,3,3,7,8,15,23,12,35,0.000333,0.04558,3,410.223513,22.790195,136.741171,43.651484,1,0
0,0,7,7,11,19,30,44,28,72,0.000333,0.117765,5,1766.480614,98.137812,353.296123,118.764371,2,0
0,0,3,3,8,7,15,20,12,32,0.000333,0.041673,4,500.081996,27.782333,125.020499,43.651484,1,0
0,0,3,3,8,7,15,11,9,20,0.000333,0.026046,4,312.551248,17.363958,78.137812,43.651484,1,0
0,0,5,5,8,10,18,28,17,45,0.000333,0.062549,4,750.5865,41.69925,187.646625,57.219281,1,0
0,0,4,4,4,7,11,13,11,24,0.000333,0.027675,2,166.052718,9.225151,83.026359,27.651484,3,0
0,0,3,3,7,5,12,11,7,18,0.000333,0.02151,3,193.587975,10.754888,64.529325,31.261125,1,0
0,0,3,3,11,11,22,26,15,41,0.000333,0.060946,5,914.183482,50.787971,182.836696,76.107496,3,0
0,0,8,8,11,15,26,59,34,93,0.000333,0.145714,10,4371.408938,242.856052,437.140894,96.657107,1,0
0,0,5,5,8,8,16,19,12,31,0.000333,0.041333,4,496,27.555556,124,48,1,0
0,0,7,7,11,18,29,48,28,76,0.000333,0.123069,5,1846.032778,102.557377,369.206556,113.112398,1,0
0,0,5,5,4,4,8,7,4,11,0.000333,0.011,2,66,3.666667,33,16,1,0
0,0,14,14,13,31,44,100,77,177,0.000333,0.322106,12,11595.83276,644.212931,966.319396,201.685802,1,0
0,0,3,3,11,11,22,26,15,41,0.000333,0.060946,5,914.183482,50.787971,182.836696,76.107496,3,0
0,0,13,13,10,18,28,71,44,115,0.000333,0.184282,10,5528.45816,307.136564,552.845816,108.277931,3,0
0,0,11,11,12,18,30,69,40,109,0.000333,0.178284,12,6418.212899,356.567383,534.851075,118.0782,2,0
0,0,4,4,5,9,14,15,13,28,0.000333,0.035535,2,213.211876,11.845104,106.605938,40.138965,1,0
0,0,3,3,8,6,14,11,9,20,0.000333,0.025382,4,304.588394,16.921577,76.147098,39.509775,1,0
0,0,5,5,6,10,16,22,15,37,0.000333,0.049333,3,444,24.666667,148,48.729056,1,0
0,0,7,7,11,19,30,44,28,72,0.000333,0.117765,5,1766.480614,98.137812,353.296123,118.764371,2,0
0,0,4,4,4,7,11,13,11,24,0.000333,0.027675,2,166.052718,9.225151,83.026359,27.651484,3,0
0,0,4,4,13,12,25,25,15,40,0.000333,0.061918,6,1114.525486,61.918083,185.754248,91.125266,3,0
0,0,4,4,8,14,22,24,19,43,0.000333,0.063919,4,767.022238,42.612347,191.75556,77.302969,1,0
0,0,11,11,15,21,36,84,43,127,0.000333,0.21886,14,9192.126653,510.673703,656.580475,150.842025,2,0
0,0,8,8,15,18,33,66,34,100,0.000333,0.168146,7,3531.075884,196.170882,504.439412,133.662009,2,0
0,0,5,5,10,13,23,22,18,40,0.000333,0.060314,5,904.712391,50.2618,180.942478,81.324997,1,0
0,0,8,8,8,11,19,36,25,61,0.000333,0.086375,8,2072.988627,115.166035,259.123578,62.053748,5,0
0,0,11,11,15,21,36,84,43,127,0.000333,0.21886,14,9192.126653,510.673703,656.580475,150.842025,2,0
0,0,3,3,7,5,12,11,7,18,0.000333,0.02151,3,193.587975,10.754888,64.529325,31.261125,1,0
0,0,6,6,7,15,22,29,33,62,0.000333,0.092162,6,1658.908562,92.161587,276.48476,78.254843,1,0
0,0,18,18,11,28,39,115,64,179,0.000333,0.315362,10,9460.869972,525.603887,946.086997,172.659686,1,0
0,0,4,4,6,9,15,16,12,28,0.000333,0.036464,3,328.17881,18.232156,109.392937,44.0391,1,0
0,0,4,4,5,7,12,14,10,24,0.000333,0.02868,2,172.0782,9.5599,86.0391,31.261125,2,0
0,0,4,4,10,15,25,32,21,53,0.000333,0.082041,5,1230.62189,68.367883,246.124378,91.82264,1,0
0,0,4,4,4,7,11,13,11,24,0.000333,0.027675,2,166.052718,9.225151,83.026359,27.651484,3,0
0,0,7,7,11,19,30,44,28,72,0.000333,0.117765,5,1766.480614,98.137812,353.296123,118.764371,2,0
0,0,5,5,8,10,18,28,17,45,0.000333,0.062549,4,750.5865,41.69925,187.646625,57.219281,1,0
0,0,5,5,10,11,21,33,18,51,0.000333,0.074669,5,1120.040943,62.224497,224.008189,71.273029,1,0
0,0,7,7,11,19,30,44,28,72,0.000333,0.117765,5,1766.480614,98.137812,353.296123,118.764371,2,0
0,0,3,3,7,8,15,23,12,35,0.000333,0.04558,3,410.223513,22.790195,136.741171,43.651484,1,0
0,0,8,8,15,16,31,49,33,82,0.000333,0.135415,14,5687.417364,315.967631,406.244097,122.603359,4,0
0,0,9,9,15,19,34,68,35,103,0.000333,0.17467,7,3668.060709,203.78115,524.008673,139.313982,2,0
0,0,11,11,15,21,36,84,43,127,0.000333,0.21886,14,9192.126653,510.673703,656.580475,150.842025,2,0
0,0,8,8,15,18,33,66,34,100,0.000333,0.168146,7,3531.075884,196.170882,504.439412,133.662009,2,0
0,0,4,4,6,8,14,17,12,29,0.000333,0.036804,3,331.239878,18.402215,110.413293,39.509775,3,0
0,0,6,6,9,10,19,28,17,45,0.000333,0.063719,4,764.626952,42.479275,191.156738,61.748606,1,0
0,0,4,4,6,9,15,16,12,28,0.000333,0.036464,3,328.17881,18.232156,109.392937,44.0391,1,0
0,0,3,3,8,8,16,20,12,32,0.000333,0.042667,4,512,28.444444,128,48,1,0
0,0,8,8,15,18,33,66,34,100,0.000333,0.168146,7,3531.075884,196.170882,504.439412,133.662009,2,0
0,0,11,11,15,21,36,84,43,127,0.000333,0.21886,14,9192.126653,510.673703,656.580475,150.842025,2,0
0,0,3,3,7,8,15,23,12,35,0.000333,0.04558,3,410.223513,22.790195,136.741171,43.651484,1,0
0,0,4,4,6,8,14,17,12,29,0.000333,0.036804,3,331.239878,18.402215,110.413293,39.509775,3,0
0,0,4,4,9,8,17,21,14,35,0.000333,0.047687,4,572.244798,31.791378,143.061199,52.529325,1,0
0,0,3,3,5,6,11,10,8,18,0.000333,0.020757,2,124.539538,6.918863,62.269769,27.119415,1,0
0,0,3,3,9,5,14,17,10,27,0.000333,0.034266,8,822.388663,45.688259,102.798583,40.138965,3,0
0,0,5,5,9,12,21,20,22,42,0.000333,0.061492,4,737.909327,40.994963,184.477332,71.548875,1,0
0,0,6,6,10,11,21,24,21,45,0.000333,0.065885,5,988.27142,54.903968,197.654284,71.273029,1,0
0,0,4,4,5,9,14,15,13,28,0.000333,0.035535,2,213.211876,11.845104,106.605938,40.138965,1,0
0,0,5,5,7,7,14,16,11,27,0.000333,0.034266,3,308.395749,17.133097,102.798583,39.302969,1,0
0,0,5,5,8,10,18,28,17,45,0.000333,0.062549,4,750.5865,41.69925,187.646625,57.219281,1,0
0,0,5,5,11,12,23,25,18,43,0.000333,0.064838,5,972.565821,54.031434,194.513164,81.073298,1,0
0,0,4,4,12,12,24,42,17,59,0.000333,0.090171,6,1623.076725,90.170929,270.512788,86.0391,5,0
0,0,18,18,11,28,39,115,64,179,0.000333,0.315362,10,9460.869972,525.603887,946.086997,172.659686,3,0
0,0,5,5,7,10,17,19,16,35,0.000333,0.047687,3,429.183598,23.843533,143.061199,52.870765,3,0
0,0,4,4,4,7,11,13,11,24,0.000333,0.027675,2,166.052718,9.225151,83.026359,27.651484,3,0
0,0,3,3,7,5,12,11,7,18,0.000333,0.02151,3,193.587975,10.754888,64.529325,31.261125,1,0
0,0,3,3,8,8,16,20,12,32,0.000333,0.042667,4,512,28.444444,128,48,1,0
0,0,3,3,9,8,17,16,11,27,0.000333,0.036787,4,441.445987,24.524777,110.361497,52.529325,2,0
0,0,3,3,7,8,15,23,12,35,0.000333,0.04558,3,410.223513,22.790195,136.741171,43.651484,1,0
0,0,3,3,9,8,17,16,11,27,0.000333,0.036787,4,441.445987,24.524777,110.361497,52.529325,2,0
0,0,3,3,7,8,15,23,12,35,0.000333,0.04558,3,410.223513,22.790195,136.741171,43.651484,1,0
0,0,7,7,14,16,30,42,33,75,0.000333,0.122672,14,5152.235125,286.235285,368.016795,117.302969,4,0
0,0,18,18,12,26,38,109,60,169,0.000333,0.295633,12,10642.797,591.2665,886.89975,165.230983,1,0
0,0,4,4,4,7,11,13,11,24,0.000333,0.027675,2,166.052718,9.225151,83.026359,27.651484,2,0
0,0,3,3,9,8,17,16,11,27,0.000333,0.036787,4,441.445987,24.524777,110.361497,52.529325,2,0
0,0,5,5,8,10,18,28,17,45,0.000333,0.062549,4,750.5865,41.69925,187.646625,57.219281,1,0
0,0,7,7,11,19,30,44,28,72,0.000333,0.117765,5,1766.480614,98.137812,353.296123,118.764371,2,0
0,0,4,4,4,7,11,13,11,24,0.000333,0.027675,2,166.052718,9.225151,83.026359,27.651484,3,0
0,0,8,8,15,18,33,66,34,100,0.000333,0.168146,7,3531.075884,196.170882,504.439412,133.662009,2,0
0,0,7,7,11,19,30,44,28,72,0.000333,0.117765,5,1766.480614,98.137812,353.296123,118.764371,2,0
0,0,6,6,14,12,26,43,26,69,0.000333,0.10811,14,4540.624768,252.256932,324.330341,96.322519,4,0
0,0,6,6,8,10,18,25,21,46,0.000333,0.063939,8,1534.532401,85.2518,191.81655,57.219281,1,0
0,0,5,5,7,8,15,17,12,29,0.000333,0.037767,3,339.899482,18.883305,113.299827,43.651484,1,0
0,0,4,4,8,7,15,17,12,29,0.000333,0.037767,4,453.199309,25.177739,113.299827,43.651484,1,0
0,0,3,3,10,8,18,16,13,29,0.000333,0.040309,5,604.639125,33.591063,120.927825,57.219281,3,0
0,0,3,3,7,5,12,11,7,18,0.000333,0.02151,3,193.587975,10.754888,64.529325,31.261125,1,0
0,0,28,28,12,32,44,191,103,294,0.000333,0.535024,18,28891.31213,1605.072896,1605.072896,203.01955,1,0
0,0,3,3,7,5,12,11,7,18,0.000333,0.02151,3,193.587975,10.754888,64.529325,31.261125,1,0
0,0,4,4,7,11,18,24,17,41,0.000333,0.056989,3,512.900775,28.494488,170.966925,57.705232,1,0
0,0,3,3,7,5,12,11,7,18,0.000333,0.02151,3,193.587975,10.754888,64.529325,31.261125,1,0
0,0,7,7,11,19,30,44,28,72,0.000333,0.117765,5,1766.480614,98.137812,353.296123,118.764371,2,0
0,0,7,7,11,19,30,44,28,72,0.000333,0.117765,5,1766.480614,98.137812,353.296123,118.764371,2,0
0,0,7,7,11,18,29,48,28,76,0.000333,0.123069,5,1846.032778,102.557377,369.206556,113.112398,1,0
0,0,8,8,12,15,27,36,22,58,0.000333,0.091928,6,1654.700851,91.927825,275.783475,101.622909,3,0
0,0,5,5,11,12,23,33,21,54,0.000333,0.081424,5,1221.361728,67.853429,244.272346,81.073298,1,0
0,0,4,4,10,10,20,25,17,42,0.000333,0.060507,5,907.6049,50.422494,181.52098,66.438562,1,0
0,0,3,3,9,8,17,16,11,27,0.000333,0.036787,4,441.445987,24.524777,110.361497,52.529325,2,0
0,0,7,7,8,12,20,41,25,66,0.000333,0.095082,8,2281.978034,126.776557,285.247254,67.01955,1,0
0,0,3,3,9,11,20,19,16,35,0.000333,0.050422,4,605.069933,33.614996,151.267483,66.583073,1,0
0,0,4,4,7,11,18,24,17,41,0.000333,0.056989,3,512.900775,28.494488,170.966925,57.705232,1,0
0,0,4,4,5,12,17,13,15,28,0.000333,0.03815,2,228.897919,12.716551,114.44896,54.62919,1,0
0,0,25,25,12,35,47,382,213,595,0.000333,1.10166,36,118979.2932,6609.960733,3304.980367,222.544456,4,0
0,0,5,5,8,10,18,26,15,41,0.000333,0.056989,4,683.8677,37.99265,170.966925,57.219281,1,0
0,0,3,3,9,8,17,16,11,27,0.000333,0.036787,4,441.445987,24.524777,110.361497,52.529325,2,0
0,0,4,4,9,7,16,17,12,29,0.000333,0.038667,4,464,25.777778,116,48.180809,1,0
0,0,7,7,11,19,30,44,28,72,0.000333,0.117765,5,1766.480614,98.137812,353.296123,118.764371,2,0
0,0,3,3,7,8,15,23,12,35,0.000333,0.04558,3,410.223513,22.790195,136.741171,43.651484,1,0
0,0,7,7,7,8,15,29,19,48,0.000333,0.06251,6,1125.184492,62.51025,187.530749,43.651484,2,0
0,0,3,3,7,8,15,23,12,35,0.000333,0.04558,3,410.223513,22.790195,136.741171,43.651484,1,0
0,0,4,4,4,7,11,13,11,24,0.000333,0.027675,2,166.052718,9.225151,83.026359,27.651484,3,0
0,0,5,5,7,15,22,31,26,57,0.000333,0.084729,3,762.562807,42.3646,254.187602,78.254843,1,0
0,0,8,8,15,18,33,66,34,100,0.000333,0.168146,7,3531.075884,196.170882,504.439412,133.662009,2,0
0,0,3,3,7,13,20,20,19,39,0.000333,0.056185,3,505.665587,28.092533,168.555196,67.757201,1,0
0,0,4,4,7,6,13,14,9,23,0.000333,0.02837,3,255.330341,14.185019,85.110114,35.161259,1,0
0,0,11,11,15,21,36,84,43,127,0.000333,0.21886,14,9192.126653,510.673703,656.580475,150.842025,2,0
0,0,3,3,9,8,17,16,11,27,0.000333,0.036787,4,441.445987,24.524777,110.361497,52.529325,2,0
0,0,5,5,11,12,23,33,21,54,0.000333,0.081424,5,1221.361728,67.853429,244.272346,81.073298,1,0
0,0,25,25,12,35,47,382,213,595,0.000333,1.10166,36,118979.2932,6609.960733,3304.980367,222.544456,4,0
0,0,9,9,15,19,34,68,35,103,0.000333,0.17467,7,3668.060709,203.78115,524.008673,139.313982,2,0
0,0,3,3,8,7,15,20,12,32,0.000333,0.041673,4,500.081996,27.782333,125.020499,43.651484,1,0
0,0,3,3,9,8,17,16,11,27,0.000333,0.036787,4,441.445987,24.524777,110.361497,52.529325,2,0
0,0,9,9,15,19,34,68,35,103,0.000333,0.17467,7,3668.060709,203.78115,524.008673,139.313982,2,0
0,0,7,7,11,19,30,44,28,72,0.000333,0.117765,5,1766.480614,98.137812,353.296123,118.764371,2,0
0,0,4,4,9,10,19,28,18,46,0.000333,0.065135,4,781.618662,43.423259,195.404666,61.748606,1,0
0,0,8,8,15,18,33,66,34,100,0.000333,0.168146,7,3531.075884,196.170882,504.439412,133.662009,2,0
0,0,23,23,13,34,47,157,98,255,0.000333,0.47214,12,16997.04189,944.280105,1416.420157,221.079453,1,0
0,0,11,11,15,21,36,84,43,127,0.000333,0.21886,14,9192.126653,510.673703,656.580475,150.842025,2,0
0,0,3,3,7,8,15,23,12,35,0.000333,0.04558,3,410.223513,22.790195,136.741171,43.651484,1,0
0,0,3,3,7,8,15,23,12,35,0.000333,0.04558,3,410.223513,22.790195,136.741171,43.651484,1,0
0,0,3,3,7,6,13,27,14,41,0.000333,0.050573,6,910.308171,50.572676,151.718028,35.161259,1,0
0,0,4,4,7,7,14,39,20,59,0.000333,0.074878,6,1347.803642,74.87798,224.63394,39.302969,1,0
0,0,5,5,7,8,15,51,26,77,0.000333,0.100277,9,2707.475183,150.415288,300.830576,43.651484,1,0
0,0,6,6,7,9,16,63,32,95,0.000333,0.126667,9,3420,190,380,48.180809,1,0
0,0,6,6,14,12,26,41,24,65,0.000333,0.101843,14,4277.400144,237.633341,305.528582,96.322519,5,0
0,0,9,9,9,14,23,45,27,72,0.000333,0.108565,4,1302.785843,72.376991,325.696461,81.832294,3,0
0,0,9,9,11,18,29,33,41,74,0.000333,0.11983,10,3594.905936,199.716996,359.490594,113.112398,1,0
0,0,4,4,4,7,11,13,11,24,0.000333,0.027675,2,166.052718,9.225151,83.026359,27.651484,3,0
0,0,4,4,7,11,18,24,17,41,0.000333,0.056989,3,512.900775,28.494488,170.966925,57.705232,1,0
0,0,6,6,7,13,20,35,24,59,0.000333,0.084998,3,764.981273,42.49896,254.993758,67.757201,1,0
0,0,4,4,6,8,14,17,12,29,0.000333,0.036804,3,331.239878,18.402215,110.413293,39.509775,3,0
0,0,4,4,5,10,15,13,13,26,0.000333,0.03386,2,203.158311,11.286573,101.579155,44.828921,1,0
0,0,3,3,7,8,15,23,12,35,0.000333,0.04558,3,410.223513,22.790195,136.741171,43.651484,1,0
0,0,7,7,11,19,30,44,28,72,0.000333,0.117765,5,1766.480614,98.137812,353.296123,118.764371,2,0
0,0,3,3,7,5,12,11,7,18,0.000333,0.02151,3,193.587975,10.754888,64.529325,31.261125,1,0
0,0,4,4,4,7,11,13,11,24,0.000333,0.027675,2,166.052718,9.225151,83.026359,27.651484,3,0
0,0,6,6,7,13,20,23,34,57,0.000333,0.082117,6,1478.099408,82.116634,246.349901,67.757201,1,0
0,0,7,7,11,19,30,44,28,72,0.000333,0.117765,5,1766.480614,98.137812,353.296123,118.764371,2,0
0,0,9,9,14,25,39,156,54,210,0.000333,0.369978,14,15539.08252,863.282362,1109.934466,169.399374,5,0
0,0,11,11,11,22,33,56,36,92,0.000333,0.154695,5,2320.421295,128.912294,464.084259,136.161243,3,0
0,0,8,8,11,15,26,59,34,93,0.000333,0.145714,10,4371.408938,242.856052,437.140894,96.657107,1,0
0,0,4,4,13,12,25,25,15,40,0.000333,0.061918,6,1114.525486,61.918083,185.754248,91.125266,3,0
0,0,7,7,11,18,29,48,28,76,0.000333,0.123069,5,1846.032778,102.557377,369.206556,113.112398,1,0
0,0,4,4,4,7,11,13,11,24,0.000333,0.027675,2,166.052718,9.225151,83.026359,27.651484,3,0
0,0,17,17,11,23,34,63,39,102,0.000333,0.172974,5,2594.606049,144.144781,518.92121,142.095673,4,0
0,0,6,6,8,13,21,42,25,67,0.000333,0.098095,4,1177.141069,65.396726,294.285267,72.105716,1,0
0,0,9,9,15,19,34,68,35,103,0.000333,0.17467,7,3668.060709,203.78115,524.008673,139.313982,2,0
0,0,4,4,10,15,25,32,21,53,0.000333,0.082041,5,1230.62189,68.367883,246.124378,91.82264,1,0
0,0,5,5,7,10,17,19,16,35,0.000333,0.047687,3,429.183598,23.843533,143.061199,52.870765,3,0
0,0,3,3,8,6,14,11,9,20,0.000333,0.025382,4,304.588394,16.921577,76.147098,39.509775,1,0
0,0,7,7,16,14,30,45,29,74,0.000333,0.121037,16,5809.758465,322.764359,363.109904,117.302969,4,0
0,0,25,25,12,35,47,382,213,595,0.000333,1.10166,36,118979.2932,6609.960733,3304.980367,222.544456,4,0
0,0,5,5,10,10,20,27,14,41,0.000333,0.059066,5,885.995259,49.221959,177.199052,66.438562,3,0
0,0,5,5,8,10,18,28,17,45,0.000333,0.062549,4,750.5865,41.69925,187.646625,57.219281,1,0
0,0,3,3,7,8,15,23,12,35,0.000333,0.04558,3,410.223513,22.790195,136.741171,43.651484,1,0
0,0,3,3,8,8,16,20,12,32,0.000333,0.042667,4,512,28.444444,128,48,1,0
0,0,3,3,7,8,15,23,12,35,0.000333,0.04558,3,410.223513,22.790195,136.741171,43.651484,1,0
0,0,9,9,15,18,33,46,36,82,0.000333,0.13788,14,5790.964449,321.720247,413.640318,133.662009,4,0
0,0,4,4,6,8,14,17,12,29,0.000333,0.036804,3,331.239878,18.402215,110.413293,39.509775,3,0
0,0,3,3,7,5,12,11,7,18,0.000333,0.02151,3,193.587975,10.754888,64.529325,31.261125,1,0
0,0,4,4,10,15,25,32,21,53,0.000333,0.082041,5,1230.62189,68.367883,246.124378,91.82264,1,0
0,0,9,9,15,19,34,68,35,103,0.000333,0.17467,7,3668.060709,203.78115,524.008673,139.313982,2,0
0,0,18,18,14,26,40,146,72,218,0.000333,0.386727,14,16242.52455,902.362475,1160.180325,175.514402,12,0
0,0,5,5,8,10,18,28,17,45,0.000333,0.062549,4,750.5865,41.69925,187.646625,57.219281,1,0
0,0,3,3,9,8,17,16,11,27,0.000333,0.036787,4,441.445987,24.524777,110.361497,52.529325,2,0
0,0,13,13,14,20,34,73,37,110,0.000333,0.18654,7,3917.346388,217.630355,559.620913,139.741531,5,0
0,0,5,5,8,10,18,28,17,45,0.000333,0.062549,4,750.5865,41.69925,187.646625,57.219281,1,0
0,0,3,3,9,8,17,16,10,26,0.000333,0.035425,4,425.096135,23.616452,106.274034,52.529325,3,0
0,0,4,4,4,7,11,13,11,24,0.000333,0.027675,2,166.052718,9.225151,83.026359,27.651484,3,0
0,0,5,5,11,12,23,33,21,54,0.000333,0.081424,5,1221.361728,67.853429,244.272346,81.073298,1,0
0,0,5,5,10,10,20,26,15,41,0.000333,0.059066,5,885.995259,49.221959,177.199052,66.438562,1,0
0,0,4,4,6,13,19,20,18,38,0.000333,0.053807,3,484.263737,26.903541,161.421246,63.615491,1,0
0,0,5,5,8,10,18,28,17,45,0.000333,0.062549,4,750.5865,41.69925,187.646625,57.219281,1,0
0,0,8,8,15,18,33,66,34,100,0.000333,0.168146,7,3531.075884,196.170882,504.439412,133.662009,2,0
0,0,3,3,8,4,12,12,6,18,0.000333,0.02151,4,258.1173,14.33985,64.529325,32,1,0
0,0,3,3,7,5,12,11,7,18,0.000333,0.02151,3,193.587975,10.754888,64.529325,31.261125,1,0
0,0,9,9,15,19,34,68,35,103,0.000333,0.17467,7,3668.060709,203.78115,524.008673,139.313982,2,0
0,0,9,9,15,19,34,68,35,103,0.000333,0.17467,7,3668.060709,203.78115,524.008673,139.313982,2,0
0,0,5,5,7,11,18,15,15,30,0.000333,0.041699,3,375.29325,20.849625,125.09775,57.705232,1,0
0,0,5,5,7,15,22,31,26,57,0.000333,0.084729,3,762.562807,42.3646,254.187602,78.254843,1,0
0,0,7,7,11,19,30,44,28,72,0.000333,0.117765,5,1766.480614,98.137812,353.296123,118.764371,2,0
0,0,4,4,9,9,18,19,15,34,0.000333,0.047259,4,567.1098,31.5061,141.77745,57.05865,1,0
0,0,3,3,8,7,15,11,9,20,0.000333,0.026046,4,312.551248,17.363958,78.137812,43.651484,1,0
0,0,3,3,9,8,17,16,10,26,0.000333,0.035425,4,425.096135,23.616452,106.274034,52.529325,3,0
0,0,4,4,4,7,11,13,11,24,0.000333,0.027675,2,166.052718,9.225151,83.026359,27.651484,3,0
0,0,15,15,14,17,31,82,58,140,0.000333,0.231196,21,14565.33715,809.185397,693.587483,122.789837,3,0
0,0,4,4,6,8,14,17,12,29,0.000333,0.036804,3,331.239878,18.402215,110.413293,39.509775,3,0
0,0,4,4,10,15,25,32,21,53,0.000333,0.082041,5,1230.62189,68.367883,246.124378,91.82264,1,0
0,0,3,3,8,7,15,15,9,24,0.000333,0.031255,4,375.061497,20.83675,93.765374,43.651484,3,0
0,0,5,5,9,11,20,26,18,44,0.000333,0.063388,4,760.659345,42.258852,190.164836,66.583073,1,0
0,0,5,5,10,11,21,33,18,51,0.000333,0.074669,5,1120.040943,62.224497,224.008189,71.273029,1,0
0,0,6,6,7,11,18,41,25,66,0.000333,0.091738,6,1651.290301,91.73835,275.21505,57.705232,1,0
0,0,5,5,11,11,22,31,17,48,0.000333,0.071351,5,1070.263588,59.459088,214.052718,76.107496,1,0
0,0,11,11,12,15,27,45,35,80,0.000333,0.126797,12,4564.692002,253.594,380.391,101.622909,1,0
0,0,8,8,15,18,33,66,34,100,0.000333,0.168146,7,3531.075884,196.170882,504.439412,133.662009,2,0
0,0,5,5,10,10,20,27,14,41,0.000333,0.059066,5,885.995259,49.221959,177.199052,66.438562,3,0
0,0,4,4,4,7,11,13,11,24,0.000333,0.027675,2,166.052718,9.225151,83.026359,27.651484,3,0
0,0,4,4,5,11,16,13,14,27,0.000333,0.036,2,216,12,108,49.663388,1,0
0,0,3,3,8,6,14,11,9,20,0.000333,0.025382,4,304.588394,16.921577,76.147098,39.509775,1,0
0,0,8,8,16,19,35,72,39,111,0.000333,0.189783,16,9109.606638,506.089258,569.350415,144.710623,10,0
0,0,3,3,10,8,18,16,13,29,0.000333,0.040309,5,604.639125,33.591063,120.927825,57.219281,3,0
0,0,8,8,15,18,33,66,34,100,0.000333,0.168146,7,3531.075884,196.170882,504.439412,133.662009,2,0
0,0,9,9,15,19,34,68,35,103,0.000333,0.17467,7,3668.060709,203.78115,524.008673,139.313982,2,0
0,0,3,3,7,5,12,11,7,18,0.000333,0.02151,3,193.587975,10.754888,64.529325,31.261125,1,0
0,0,6,6,14,12,26,41,24,65,0.000333,0.101843,14,4277.400144,237.633341,305.528582,96.322519,5,0
0,0,3,3,8,7,15,20,12,32,0.000333,0.041673,4,500.081996,27.782333,125.020499,43.651484,1,0
0,0,4,4,4,7,11,13,11,24,0.000333,0.027675,2,166.052718,9.225151,83.026359,27.651484,3,0
0,0,5,5,11,12,23,33,21,54,0.000333,0.081424,5,1221.361728,67.853429,244.272346,81.073298,1,0
0,0,25,25,12,35,47,382,213,595,0.000333,1.10166,36,118979.2932,6609.960733,3304.980367,222.544456,4,0
0,0,3,3,7,8,15,23,12,35,0.000333,0.04558,3,410.223513,22.790195,136.741171,43.651484,1,0
0,0,11,11,12,18,30,69,40,109,0.000333,0.178284,12,6418.212899,356.567383,534.851075,118.0782,2,0
0,0,7,7,11,19,30,44,28,72,0.000333,0.117765,5,1766.480614,98.137812,353.296123,118.764371,2,0
0,0,7,7,11,18,29,48,28,76,0.000333,0.123069,5,1846.032778,102.557377,369.206556,113.112398,1,0
0,0,3,3,9,8,17,16,11,27,0.000333,0.036787,4,441.445987,24.524777,110.361497,52.529325,2,0
0,0,3,3,7,8,15,15,10,25,0.000333,0.032557,3,293.016795,16.278711,97.672265,43.651484,2,0
0,0,5,5,11,12,23,33,21,54,0.000333,0.081424,5,1221.361728,67.853429,244.272346,81.073298,1,0
0,0,25,25,12,35,47,382,213,595,0.000333,1.10166,36,118979.2932,6609.960733,3304.980367,222.544456,4,0
0,0,19,19,21,26,47,149,82,231,0.000333,0.427703,30,38493.30074,2138.516708,1283.110025,214.450099,11,0
0,0,7,7,11,19,30,44,28,72,0.000333,0.117765,5,1766.480614,98.137812,353.296123,118.764371,2,0
0,0,8,8,15,18,33,66,34,100,0.000333,0.168146,7,3531.075884,196.170882,504.439412,133.662009,2,0
0,0,3,3,8,9,17,13,12,25,0.000333,0.034062,4,408.746284,22.708127,102.186571,52.529325,1,0
0,0,3,3,9,8,17,16,11,27,0.000333,0.036787,4,441.445987,24.524777,110.361497,52.529325,2,0
0,0,6,6,9,13,22,24,20,44,0.000333,0.065405,4,784.859965,43.603331,196.214991,76.635041,1,0
0,0,3,3,8,8,16,20,12,32,0.000333,0.042667,4,512,28.444444,128,48,1,0
0,0,3,3,8,7,15,11,9,20,0.000333,0.026046,4,312.551248,17.363958,78.137812,43.651484,1,0
0,0,5,5,10,11,21,27,16,43,0.000333,0.062957,5,944.348246,52.463791,188.869649,71.273029,1,0
0,0,3,3,7,8,15,23,12,35,0.000333,0.04558,3,410.223513,22.790195,136.741171,43.651484,1,0
0,0,7,7,11,19,30,44,28,72,0.000333,0.117765,5,1766.480614,98.137812,353.296123,118.764371,2,0
0,0,9,9,9,15,24,62,41,103,0.000333,0.157417,8,3778.009101,209.889394,472.251138,87.132684,1,0
0,0,5,5,9,13,22,32,25,57,0.000333,0.084729,4,1016.750409,56.486134,254.187602,76.635041,1,0
0,0,5,5,11,11,22,31,17,48,0.000333,0.071351,5,1070.263588,59.459088,214.052718,76.107496,1,0
0,0,3,3,10,8,18,19,11,30,0.000333,0.041699,5,625.48875,34.749375,125.09775,57.219281,1,0
0,0,5,5,12,16,28,39,25,64,0.000333,0.102557,6,1846.02429,102.556905,307.670715,107.01955,2,0
0,0,6,6,6,14,20,28,22,50,0.000333,0.072032,3,648.289214,36.016067,216.096405,68.812744,1,0
0,0,8,8,11,15,26,59,34,93,0.000333,0.145714,10,4371.408938,242.856052,437.140894,96.657107,1,0
0,0,3,3,7,5,12,11,7,18,0.000333,0.02151,3,193.587975,10.754888,64.529325,31.261125,1,0
0,0,4,4,10,15,25,32,21,53,0.000333,0.082041,5,1230.62189,68.367883,246.124378,91.82264,1,0
0,0,9,9,11,15,26,54,26,80,0.000333,0.125345,5,1880.175887,104.454216,376.035177,96.657107,4,0
0,0,5,5,8,17,25,38,29,67,0.000333,0.103713,4,1244.553459,69.141859,311.138365,93.486868,1,0
0,0,29,29,22,49,71,182,138,320,0.000333,0.655973,22,43294.21972,2405.234429,1967.919078,373.228278,5,0
0,0,7,7,13,12,25,52,32,84,0.000333,0.130028,12,4681.007039,260.055947,390.08392,91.125266,7,0
0,0,6,6,14,12,26,41,24,65,0.000333,0.101843,14,4277.400144,237.633341,305.528582,96.322519,5,0
0,0,4,4,10,15,25,32,21,53,0.000333,0.082041,5,1230.62189,68.367883,246.124378,91.82264,1,0
0,0,13,13,15,23,38,68,53,121,0.000333,0.211666,14,8889.989208,493.888289,634.999229,162.645284,2,0
0,0,6,6,7,11,18,41,25,66,0.000333,0.091738,6,1651.290301,91.73835,275.21505,57.705232,1,0
0,0,7,7,11,19,30,44,28,72,0.000333,0.117765,5,1766.480614,98.137812,353.296123,118.764371,2,0
0,0,5,5,8,10,18,28,17,45,0.000333,0.062549,4,750.5865,41.69925,187.646625,57.219281,1,0
0,0,4,4,10,15,25,32,21,53,0.000333,0.082041,5,1230.62189,68.367883,246.124378,91.82264,1,0
0,0,5,5,8,10,18,26,15,41,0.000333,0.056989,4,683.8677,37.99265,170.966925,57.219281,1,0
0,0,4,4,12,12,24,42,17,59,0.000333,0.090171,6,1623.076725,90.170929,270.512788,86.0391,5,0
0,0,4,4,9,10,19,24,17,41,0.000333,0.058055,4,696.660112,38.70334,174.165028,61.748606,1,0
0,0,3,3,9,8,17,16,11,27,0.000333,0.036787,4,441.445987,24.524777,110.361497,52.529325,2,0
0,0,17,17,21,26,47,131,75,206,0.000333,0.381415,20,22884.90607,1271.38367,1144.245303,214.450099,9,0
0,0,3,3,6,7,13,13,9,22,0.000333,0.027137,3,244.229021,13.568279,81.409674,35.161259,1,0
0,0,3,3,7,8,15,23,12,35,0.000333,0.04558,3,410.223513,22.790195,136.741171,43.651484,1,0
0,0,7,7,8,12,20,29,20,49,0.000333,0.070591,4,847.097907,47.060995,211.774477,67.01955,1,0
0,0,5,5,8,8,16,19,12,31,0.000333,0.041333,4,496,27.555556,124,48,1,0
0,0,5,5,10,12,22,21,17,38,0.000333,0.056486,5,847.292008,47.071778,169.458402,76.238831,1,0
0,0,5,5,11,12,23,27,19,46,0.000333,0.069361,5,1040.41925,57.801069,208.08385,81.073298,1,0
0,0,3,3,7,8,15,23,12,35,0.000333,0.04558,3,410.223513,22.790195,136.741171,43.651484,1,0
0,0,4,4,4,7,11,13,11,24,0.000333,0.027675,2,166.052718,9.225151,83.026359,27.651484,3,0
0,0,7,7,10,14,24,40,27,67,0.000333,0.102397,5,1535.962438,85.331247,307.192488,86.52225,1,0
0,0,3,3,7,5,12,11,7,18,0.000333,0.02151,3,193.587975,10.754888,64.529325,31.261125,1,0
0,0,4,4,7,11,18,24,17,41,0.000333,0.056989,3,512.900775,28.494488,170.966925,57.705232,1,0
0,0,8,8,10,16,26,38,31,69,0.000333,0.10811,5,1621.651703,90.091761,324.330341,97.219281,1,0
0,0,3,3,10,7,17,19,11,30,0.000333,0.040875,5,613.119426,34.06219,122.623885,52.870765,1,0
0,0,5,5,8,11,19,36,19,55,0.000333,0.077879,4,934.544053,51.919114,233.636013,62.053748,1,0
0,0,5,5,8,15,23,23,24,47,0.000333,0.070869,4,850.429648,47.246092,212.607412,82.603359,1,0
0,0,3,3,7,8,15,23,12,35,0.000333,0.04558,3,410.223513,22.790195,136.741171,43.651484,1,0
0,0,3,3,9,8,17,16,10,26,0.000333,0.035425,4,425.096135,23.616452,106.274034,52.529325,3,0
0,0,8,8,15,18,33,66,34,100,0.000333,0.168146,7,3531.075884,196.170882,504.439412,133.662009,2,0
0,0,3,3,9,8,17,16,11,27,0.000333,0.036787,4,441.445987,24.524777,110.361497,52.529325,2,0
0,0,7,7,9,17,26,40,33,73,0.000333,0.114377,4,1372.528398,76.251578,343.132099,98.016193,1,0
0,0,6,6,10,11,21,24,21,45,0.000333,0.065885,5,988.27142,54.903968,197.654284,71.273029,1,0
0,0,4,4,4,7,11,13,11,24,0.000333,0.027675,2,166.052718,9.225151,83.026359,27.651484,3,0
0,0,3,3,8,7,15,15,9,24,0.000333,0.031255,4,375.061497,20.83675,93.765374,43.651484,3,0
0,0,4,4,4,7,11,13,11,24,0.000333,0.027675,2,166.052718,9.225151,83.026359,27.651484,3,0
0,0,7,7,11,19,30,44,28,72,0.000333,0.117765,5,1766.480614,98.137812,353.296123,118.764371,2,0
0,0,8,8,15,18,33,66,34,100,0.000333,0.168146,7,3531.075884,196.170882,504.439412,133.662009,2,0
0,0,11,11,15,21,36,84,43,127,0.000333,0.21886,14,9192.126653,510.673703,656.580475,150.842025,2,0
0,0,9,9,15,19,34,68,35,103,0.000333,0.17467,7,3668.060709,203.78115,524.008673,139.313982,2,0
0,0,4,4,7,11,18,18,15,33,0.000333,0.045869,3,412.822575,22.934588,137.607525,57.705232,1,0
0,0,11,11,11,18,29,70,34,104,0.000333,0.16841,5,2526.150117,140.341673,505.230023,113.112398,5,0
0,0,4,4,10,15,25,32,21,53,0.000333,0.082041,5,1230.62189,68.367883,246.124378,91.82264,1,0
0,0,4,4,5,11,16,13,14,27,0.000333,0.036,2,216,12,108,49.663388,1,0
0,0,5,5,7,8,15,17,12,29,0.000333,0.037767,3,339.899482,18.883305,113.299827,43.651484,1,0
0,0,4,4,8,9,17,17,15,32,0.000333,0.0436,4,523.195244,29.066402,130.798811,52.529325,1,0
0,0,4,4,4,7,11,13,11,24,0.000333,0.027675,2,166.052718,9.225151,83.026359,27.651484,2,0
0,0,10,10,15,27,42,169,61,230,0.000333,0.413411,14,17363.2621,964.625672,1240.233007,186.985321,7,0
0,0,7,7,11,19,30,44,28,72,0.000333,0.117765,5,1766.480614,98.137812,353.296123,118.764371,2,0
0,0,5,5,10,11,21,29,17,46,0.000333,0.067349,5,1010.233007,56.124056,202.046601,71.273029,1,0
0,0,3,3,7,8,15,23,12,35,0.000333,0.04558,3,410.223513,22.790195,136.741171,43.651484,1,0
0,0,5,5,7,7,14,17,13,30,0.000333,0.038074,3,342.661943,19.036775,114.220648,39.302969,1,0
0,0,6,6,10,10,20,33,18,51,0.000333,0.073473,5,1102.091664,61.227315,220.418333,66.438562,1,0
0,0,11,11,15,21,36,84,43,127,0.000333,0.21886,14,9192.126653,510.673703,656.580475,150.842025,2,0
0,0,4,4,10,15,25,32,21,53,0.000333,0.082041,5,1230.62189,68.367883,246.124378,91.82264,1,0
0,0,3,3,8,8,16,20,12,32,0.000333,0.042667,4,512,28.444444,128,48,1,0
0,0,5,5,7,7,14,16,11,27,0.000333,0.034266,3,308.395749,17.133097,102.798583,39.302969,1,0
0,0,9,9,8,14,22,38,32,70,0.000333,0.104053,8,2497.281706,138.737873,312.160213,77.302969,1,0
0,0,15,15,14,21,35,86,52,138,0.000333,0.235947,14,9909.774789,550.543044,707.841056,145.541635,2,0
0,0,8,8,15,18,33,66,34,100,0.000333,0.168146,7,3531.075884,196.170882,504.439412,133.662009,2,0
0,0,4,4,9,7,16,17,12,29,0.000333,0.038667,4,464,25.777778,116,48.180809,1,0
0,0,3,3,10,8,18,16,13,29,0.000333,0.040309,5,604.639125,33.591063,120.927825,57.219281,3,0
0,0,3,3,8,10,18,25,15,40,0.000333,0.055599,4,667.188,37.066,166.797,57.219281,1,0
0,0,11,11,15,21,36,84,43,127,0.000333,0.21886,14,9192.126653,510.673703,656.580475,150.842025,2,0
0,0,8,8,15,18,33,66,34,100,0.000333,0.168146,7,3531.075884,196.170882,504.439412,133.662009,2,0
0,0,9,9,15,19,34,68,35,103,0.000333,0.17467,7,3668.060709,203.78115,524.008673,139.313982,2,0
0,0,11,11,15,21,36,84,43,127,0.000333,0.21886,14,9192.126653,510.673703,656.580475,150.842025,2,0
0,0,4,4,4,7,11,13,11,24,0.000333,0.027675,2,166.052718,9.225151,83.026359,27.651484,3,0
0,0,4,4,6,9,15,16,12,28,0.000333,0.036464,3,328.17881,18.232156,109.392937,44.0391,1,0
0,0,7,7,11,19,30,44,28,72,0.000333,0.117765,5,1766.480614,98.137812,353.296123,118.764371,2,0
0,0,6,6,14,12,26,43,26,69,0.000333,0.10811,14,4540.624768,252.256932,324.330341,96.322519,4,0
0,0,8,8,15,18,33,66,34,100,0.000333,0.168146,7,3531.075884,196.170882,504.439412,133.662009,2,0
0,0,6,6,10,14,24,33,21,54,0.000333,0.082529,5,1237.939875,68.774438,247.587975,86.52225,3,0
0,0,4,4,4,7,11,13,11,24,0.000333,0.027675,2,166.052718,9.225151,83.026359,27.651484,3,0
0,0,3,3,7,8,15,23,12,35,0.000333,0.04558,3,410.223513,22.790195,136.741171,43.651484,1,0
0,0,5,5,10,12,22,21,17,38,0.000333,0.056486,5,847.292008,47.071778,169.458402,76.238831,1,0
0,0,7,7,9,17,26,46,31,77,0.000333,0.120645,4,1447.735433,80.429746,361.933858,98.016193,1,0
0,0,3,3,10,8,18,16,13,29,0.000333,0.040309,5,604.639125,33.591063,120.927825,57.219281,3,0
0,0,5,5,8,10,18,28,17,45,0.000333,0.062549,4,750.5865,41.69925,187.646625,57.219281,1,0
0,0,3,3,8,7,15,20,12,32,0.000333,0.041673,4,500.081996,27.782333,125.020499,43.651484,1,0
0,0,3,3,9,8,17,16,11,27,0.000333,0.036787,4,441.445987,24.524777,110.361497,52.529325,2,0
0,0,9,9,15,19,34,68,35,103,0.000333,0.17467,7,3668.060709,203.78115,524.008673,139.313982,2,0
0,0,8,8,15,18,33,66,34,100,0.000333,0.168146,7,3531.075884,196.170882,504.439412,133.662009,2,0
0,0,11,11,15,21,36,84,43,127,0.000333,0.21886,14,9192.126653,510.673703,656.580475,150.842025,2,0
0,0,5,5,8,10,18,28,17,45,0.000333,0.062549,4,750.5865,41.69925,187.646625,57.219281,1,0
0,0,6,6,14,11,25,40,23,63,0.000333,0.097521,14,4095.881159,227.548953,292.56294,91.356717,4,0
0,0,4,4,8,10,18,28,16,44,0.000333,0.061159,4,733.9068,40.7726,183.4767,57.219281,1,0
0,0,11,11,15,21,36,84,43,127,0.000333,0.21886,14,9192.126653,510.673703,656.580475,150.842025,2,0
0,0,8,8,15,18,33,66,34,100,0.000333,0.168146,7,3531.075884,196.170882,504.439412,133.662009,2,0
0,0,9,9,15,19,34,68,35,103,0.000333,0.17467,7,3668.060709,203.78115,524.008673,139.313982,2,0
0,0,5,5,8,11,19,36,19,55,0.000333,0.077879,4,934.544053,51.919114,233.636013,62.053748,1,0
0,0,3,3,7,8,15,23,12,35,0.000333,0.04558,3,410.223513,22.790195,136.741171,43.651484,1,0
0,0,3,3,7,8,15,23,12,35,0.000333,0.04558,3,410.223513,22.790195,136.741171,43.651484,1,0
0,0,7,7,11,19,30,44,28,72,0.000333,0.117765,5,1766.480614,98.137812,353.296123,118.764371,2,0
0,0,5,5,10,11,21,33,18,51,0.000333,0.074669,5,1120.040943,62.224497,224.008189,71.273029,1,0
0,0,4,4,4,7,11,13,11,24,0.000333,0.027675,2,166.052718,9.225151,83.026359,27.651484,3,0
0,0,5,5,11,13,24,27,19,46,0.000333,0.070303,5,1054.541375,58.585632,210.908275,86.159464,1,0
0,0,11,11,12,18,30,69,40,109,0.000333,0.178284,12,6418.212899,356.567383,534.851075,118.0782,2,0
0,0,8,8,15,18,33,66,34,100,0.000333,0.168146,7,3531.075884,196.170882,504.439412,133.662009,2,0
0,0,11,11,15,21,36,84,43,127,0.000333,0.21886,14,9192.126653,510.673703,656.580475,150.842025,2,0
0,0,5,5,10,10,20,20,20,40,0.000333,0.057626,10,1728.771238,96.042847,172.877124,66.438562,1,0
0,0,5,5,8,10,18,26,15,41,0.000333,0.056989,4,683.8677,37.99265,170.966925,57.219281,1,0
0,0,4,4,9,13,22,22,17,39,0.000333,0.057973,4,695.671333,38.648407,173.917833,76.635041,3,0
0,0,8,8,13,14,27,39,29,68,0.000333,0.107777,12,3879.988202,215.5549,323.33235,101.408685,1,0
0,0,4,4,6,9,15,16,12,28,0.000333,0.036464,3,328.17881,18.232156,109.392937,44.0391,1,0
0,0,4,4,10,15,25,32,21,53,0.000333,0.082041,5,1230.62189,68.367883,246.124378,91.82264,1,0
0,0,3,3,8,7,15,11,9,20,0.000333,0.026046,4,312.551248,17.363958,78.137812,43.651484,1,0
0,0,5,5,8,10,18,28,17,45,0.000333,0.062549,4,750.5865,41.69925,187.646625,57.219281,1,0
0,0,4,4,6,8,14,17,12,29,0.000333,0.036804,3,331.239878,18.402215,110.413293,39.509775,3,0
0,0,27,27,15,31,46,155,104,259,0.000333,0.476868,21,30042.65348,1669.036304,1430.602547,212.183445,2,0
0,0,27,27,15,31,46,153,104,257,0.000333,0.473185,21,29810.66388,1656.147993,1419.555423,212.183445,2,0
0,0,3,3,7,8,15,23,12,35,0.000333,0.04558,3,410.223513,22.790195,136.741171,43.651484,1,0
0,0,4,4,9,8,17,15,12,27,0.000333,0.036787,4,441.445987,24.524777,110.361497,52.529325,1,0
0,0,6,6,7,11,18,41,25,66,0.000333,0.091738,6,1651.290301,91.73835,275.21505,57.705232,1,0
0,0,3,3,9,8,17,16,11,27,0.000333,0.036787,4,441.445987,24.524777,110.361497,52.529325,2,0
0,0,4,4,9,9,18,28,15,43,0.000333,0.059769,4,717.2271,39.84595,179.306775,57.05865,1,0
0,0,6,6,8,14,22,31,23,54,0.000333,0.08027,4,963.23723,53.513179,240.809307,77.302969,1,0
0,0,6,6,13,11,24,39,24,63,0.000333,0.096284,12,3466.231651,192.568425,288.852638,86.159464,4,0
0,0,3,3,8,7,15,11,9,20,0.000333,0.026046,4,312.551248,17.363958,78.137812,43.651484,1,0
0,0,3,3,7,8,15,23,12,35,0.000333,0.04558,3,410.223513,22.790195,136.741171,43.651484,1,0
0,0,3,3,10,8,18,16,13,29,0.000333,0.040309,5,604.639125,33.591063,120.927825,57.219281,3,0
0,0,9,9,15,19,34,68,35,103,0.000333,0.17467,7,3668.060709,203.78115,524.008673,139.313982,2,0
0,0,11,11,15,21,36,84,43,127,0.000333,0.21886,14,9192.126653,510.673703,656.580475,150.842025,2,0
0,0,3,3,8,8,16,20,12,32,0.000333,0.042667,4,512,28.444444,128,48,1,0
0,0,5,5,8,10,18,28,17,45,0.000333,0.062549,4,750.5865,41.69925,187.646625,57.219281,1,0
0,0,3,3,7,8,15,23,12,35,0.000333,0.04558,3,410.223513,22.790195,136.741171,43.651484,1,0
0,0,5,5,8,10,18,28,17,45,0.000333,0.062549,4,750.5865,41.69925,187.646625,57.219281,1,0
0,0,9,9,15,19,34,68,35,103,0.000333,0.17467,7,3668.060709,203.78115,524.008673,139.313982,2,0
0,0,7,7,11,19,30,44,28,72,0.000333,0.117765,5,1766.480614,98.137812,353.296123,118.764371,2,0
0,0,3,3,8,8,16,20,12,32,0.000333,0.042667,4,512,28.444444,128,48,1,0
0,0,7,7,11,19,30,44,28,72,0.000333,0.117765,5,1766.480614,98.137812,353.296123,118.764371,2,0
0,0,4,4,7,11,18,16,14,30,0.000333,0.041699,3,375.29325,20.849625,125.09775,57.705232,1,0
0,0,3,3,8,8,16,20,12,32,0.000333,0.042667,4,512,28.444444,128,48,1,0
0,0,5,5,11,12,23,33,21,54,0.000333,0.081424,5,1221.361728,67.853429,244.272346,81.073298,1,0
0,0,25,25,12,35,47,382,213,595,0.000333,1.10166,36,118979.2932,6609.960733,3304.980367,222.544456,4,0
0,0,5,5,8,10,18,28,17,45,0.000333,0.062549,4,750.5865,41.69925,187.646625,57.219281,1,0
0,0,4,4,4,7,11,13,11,24,0.000333,0.027675,2,166.052718,9.225151,83.026359,27.651484,3,0
0,0,3,3,9,8,17,16,11,27,0.000333,0.036787,4,441.445987,24.524777,110.361497,52.529325,2,0
0,0,4,4,12,11,23,24,15,39,0.000333,0.058806,6,1058.513498,58.806305,176.418916,81.073298,4,0
0,0,7,7,11,18,29,48,28,76,0.000333,0.123069,5,1846.032778,102.557377,369.206556,113.112398,1,0
0,0,10,10,15,21,36,54,31,85,0.000333,0.146481,7,3076.105376,170.894743,439.443625,150.842025,5,0
0,0,5,5,8,13,21,25,20,45,0.000333,0.065885,4,790.617136,43.923174,197.654284,72.105716,1,0
0,0,7,7,11,18,29,48,28,76,0.000333,0.123069,5,1846.032778,102.557377,369.206556,113.112398,1,0
0,0,3,3,8,7,15,11,9,20,0.000333,0.026046,4,312.551248,17.363958,78.137812,43.651484,1,0
0,0,5,5,7,15,22,31,26,57,0.000333,0.084729,3,762.562807,42.3646,254.187602,78.254843,1,0
0,0,3,3,7,8,15,23,12,35,0.000333,0.04558,3,410.223513,22.790195,136.741171,43.651484,1,0
0,0,5,5,10,10,20,27,14,41,0.000333,0.059066,5,885.995259,49.221959,177.199052,66.438562,3,0
0,0,3,3,9,8,17,16,11,27,0.000333,0.036787,4,441.445987,24.524777,110.361497,52.529325,2,0
0,0,3,3,7,8,15,23,12,35,0.000333,0.04558,3,410.223513,22.790195,136.741171,43.651484,1,0
0,0,3,3,8,7,15,15,9,24,0.000333,0.031255,4,375.061497,20.83675,93.765374,43.651484,3,0
0,0,4,4,4,7,11,13,11,24,0.000333,0.027675,2,166.052718,9.225151,83.026359,27.651484,3,0
0,0,8,8,15,18,33,66,34,100,0.000333,0.168146,7,3531.075884,196.170882,504.439412,133.662009,2,0
0,0,5,5,11,12,23,33,21,54,0.000333,0.081424,5,1221.361728,67.853429,244.272346,81.073298,1,0
0,0,11,11,15,21,36,84,43,127,0.000333,0.21886,14,9192.126653,510.673703,656.580475,150.842025,2,0
0,0,9,9,15,19,34,68,35,103,0.000333,0.17467,7,3668.060709,203.78115,524.008673,139.313982,2,0
0,0,5,5,11,12,23,33,21,54,0.000333,0.081424,5,1221.361728,67.853429,244.272346,81.073298,1,0
0,0,25,25,12,35,47,382,213,595,0.000333,1.10166,36,118979.2932,6609.960733,3304.980367,222.544456,4,0
0,0,7,7,11,19,30,44,28,72,0.000333,0.117765,5,1766.480614,98.137812,353.296123,118.764371,2,0
0,0,5,5,10,11,21,33,18,51,0.000333,0.074669,5,1120.040943,62.224497,224.008189,71.273029,1,0
0,0,6,6,11,15,26,39,25,64,0.000333,0.100276,5,1504.14071,83.563373,300.828142,96.657107,1,0
0,0,5,5,8,10,18,28,17,45,0.000333,0.062549,4,750.5865,41.69925,187.646625,57.219281,1,0
0,0,4,4,4,7,11,13,11,24,0.000333,0.027675,2,166.052718,9.225151,83.026359,27.651484,3,0
0,0,8,8,15,18,33,66,34,100,0.000333,0.168146,7,3531.075884,196.170882,504.439412,133.662009,2,0
0,0,9,9,15,19,34,68,35,103,0.000333,0.17467,7,3668.060709,203.78115,524.008673,139.313982,2,0
0,0,10,10,15,20,35,80,41,121,0.000333,0.206881,14,8689.005431,482.722524,620.643245,145.041921,2,0
0,0,7,7,11,19,30,44,28,72,0.000333,0.117765,5,1766.480614,98.137812,353.296123,118.764371,2,0
0,0,5,5,8,11,19,36,19,55,0.000333,0.077879,4,934.544053,51.919114,233.636013,62.053748,1,0
0,0,36,36,16,62,78,272,185,457,0.000333,0.957476,16,45958.86102,2553.270057,2872.428814,433.160171,4,0
0,0,5,5,10,11,21,29,17,46,0.000333,0.067349,5,1010.233007,56.124056,202.046601,71.273029,1,0
0,0,8,8,14,17,31,44,36,80,0.000333,0.132112,14,5548.699868,308.261104,396.335705,122.789837,4,0
0,0,3,3,8,7,15,11,9,20,0.000333,0.026046,4,312.551248,17.363958,78.137812,43.651484,1,0
0,0,7,7,6,9,15,37,23,60,0.000333,0.078138,6,1406.480614,78.137812,234.413436,44.0391,1,0
0,0,6,6,9,12,21,40,22,62,0.000333,0.090775,4,1089.294721,60.516373,272.32368,71.548875,1,0
0,0,6,6,14,12,26,41,24,65,0.000333,0.101843,14,4277.400144,237.633341,305.528582,96.322519,5,0
0,0,9,9,15,19,34,68,35,103,0.000333,0.17467,7,3668.060709,203.78115,524.008673,139.313982,2,0
0,0,11,11,15,21,36,84,43,127,0.000333,0.21886,14,9192.126653,510.673703,656.580475,150.842025,2,0
0,0,8,8,15,18,33,66,34,100,0.000333,0.168146,7,3531.075884,196.170882,504.439412,133.662009,2,0
0,0,3,3,8,7,15,11,9,20,0.000333,0.026046,4,312.551248,17.363958,78.137812,43.651484,1,0
0,0,4,4,8,6,14,16,12,28,0.000333,0.035535,8,852.847503,47.380417,106.605938,39.509775,1,0
0,0,4,4,8,11,19,27,17,44,0.000333,0.062303,4,747.635242,41.535291,186.908811,62.053748,1,0
0,0,3,3,10,8,18,16,13,29,0.000333,0.040309,5,604.639125,33.591063,120.927825,57.219281,3,0
0,0,6,6,8,15,23,37,25,62,0.000333,0.093487,4,1121.843365,62.324631,280.460841,82.603359,1,0
0,0,3,3,7,8,15,23,12,35,0.000333,0.04558,3,410.223513,22.790195,136.741171,43.651484,1,0
0,0,6,6,8,13,21,42,25,67,0.000333,0.098095,4,1177.141069,65.396726,294.285267,72.105716,1,0
0,0,6,6,9,13,22,27,21,48,0.000333,0.071351,4,856.210871,47.567271,214.052718,76.635041,1,0
0,0,3,3,8,7,15,11,9,20,0.000333,0.026046,4,312.551248,17.363958,78.137812,43.651484,1,0
0,0,9,9,11,20,31,51,41,92,0.000333,0.151929,10,4557.860606,253.214478,455.786061,124.49231,1,0
0,0,4,4,5,9,14,15,13,28,0.000333,0.035535,2,213.211876,11.845104,106.605938,40.138965,1,0
0,0,6,6,5,14,19,20,30,50,0.000333,0.070799,4,849.585503,47.199195,212.396376,64.912609,1,0
0,0,4,4,6,12,18,20,17,37,0.000333,0.051429,3,462.861675,25.714538,154.287225,58.529325,1,0
0,0,4,4,6,9,15,16,12,28,0.000333,0.036464,3,328.17881,18.232156,109.392937,44.0391,1,0
0,0,4,4,6,10,16,26,15,41,0.000333,0.054667,3,492,27.333333,164,48.729056,1,0
0,0,17,17,21,26,47,131,75,206,0.000333,0.381415,20,22884.90607,1271.38367,1144.245303,214.450099,9,0
0,0,6,6,7,11,18,41,25,66,0.000333,0.091738,6,1651.290301,91.73835,275.21505,57.705232,1,0
0,0,3,3,8,8,16,20,12,32,0.000333,0.042667,4,512,28.444444,128,48,1,0
0,0,5,5,8,8,16,19,12,31,0.000333,0.041333,4,496,27.555556,124,48,1,0
0,0,3,3,7,5,12,11,7,18,0.000333,0.02151,3,193.587975,10.754888,64.529325,31.261125,1,0
0,0,4,4,6,5,11,13,10,23,0.000333,0.026522,6,477.401563,26.522309,79.566927,27.119415,1,0
0,0,4,4,4,7,11,13,11,24,0.000333,0.027675,2,166.052718,9.225151,83.026359,27.651484,3,0
0,0,4,4,6,10,16,26,15,41,0.000333,0.054667,3,492,27.333333,164,48.729056,3,0
0,0,6,6,13,13,26,37,25,62,0.000333,0.097142,6,1748.563575,97.142421,291.427263,96.211433,4,0
0,0,7,7,11,19,30,44,28,72,0.000333,0.117765,5,1766.480614,98.137812,353.296123,118.764371,2,0
0,0,5,5,8,10,18,28,17,45,0.000333,0.062549,4,750.5865,41.69925,187.646625,57.219281,1,0
0,0,3,3,7,8,15,23,12,35,0.000333,0.04558,3,410.223513,22.790195,136.741171,43.651484,1,0
0,0,8,8,15,18,33,66,34,100,0.000333,0.168146,7,3531.075884,196.170882,504.439412,133.662009,2,0
0,0,5,5,7,10,17,19,16,35,0.000333,0.047687,3,429.183598,23.843533,143.061199,52.870765,3,0
0,0,6,6,11,13,24,32,23,55,0.000333,0.084058,5,1260.864688,70.048038,252.172938,86.159464,1,0
0,0,3,3,7,5,12,11,7,18,0.000333,0.02151,3,193.587975,10.754888,64.529325,31.261125,1,0
0,0,4,4,6,8,14,17,12,29,0.000333,0.036804,3,331.239878,18.402215,110.413293,39.509775,3,0
0,0,8,8,15,18,33,66,34,100,0.000333,0.168146,7,3531.075884,196.170882,504.439412,133.662009,2,0
0,0,11,11,15,21,36,84,43,127,0.000333,0.21886,14,9192.126653,510.673703,656.580475,150.842025,2,0
0,0,6,6,14,11,25,38,23,61,0.000333,0.094425,14,3965.853186,220.325177,283.275228,91.356717,4,0
0,0,6,6,8,12,20,20,21,41,0.000333,0.059066,4,708.796208,39.377567,177.199052,67.01955,1,0
0,0,3,3,7,8,15,23,12,35,0.000333,0.04558,3,410.223513,22.790195,136.741171,43.651484,1,0
0,0,29,29,6,31,37,242,59,301,0.000333,0.522682,3,4704.136389,261.340911,1568.045463,169.089861,13,0
0,0,11,11,15,21,36,84,43,127,0.000333,0.21886,14,9192.126653,510.673703,656.580475,150.842025,2,0
0,0,4,4,9,9,18,19,15,34,0.000333,0.047259,4,567.1098,31.5061,141.77745,57.05865,1,0
0,0,6,6,14,12,26,43,26,69,0.000333,0.10811,14,4540.624768,252.256932,324.330341,96.322519,4,0
0,0,11,11,15,21,36,84,43,127,0.000333,0.21886,14,9192.126653,510.673703,656.580475,150.842025,2,0
0,0,4,4,9,7,16,26,16,42,0.000333,0.056,8,1344,74.666667,168,48.180809,1,0
0,0,8,8,15,18,33,49,38,87,0.000333,0.146287,14,6144.072037,341.337335,438.862288,133.662009,4,0
0,0,3,3,8,7,15,11,9,20,0.000333,0.026046,4,312.551248,17.363958,78.137812,43.651484,1,0
0,0,3,3,7,5,12,11,7,18,0.000333,0.02151,3,193.587975,10.754888,64.529325,31.261125,1,0
0,0,7,7,11,19,30,44,28,72,0.000333,0.117765,5,1766.480614,98.137812,353.296123,118.764371,2,0
0,0,3,3,8,8,16,20,12,32,0.000333,0.042667,4,512,28.444444,128,48,1,0
0,0,4,4,7,12,19,17,20,37,0.000333,0.052391,3,471.519954,26.195553,157.173318,62.671034,1,0
0,0,22,22,22,28,50,123,76,199,0.000333,0.374376,22,24708.8024,1372.711244,1123.127382,232.713433,7,0
0,0,4,4,5,9,14,15,13,28,0.000333,0.035535,2,213.211876,11.845104,106.605938,40.138965,1,0
0,0,5,5,10,11,21,33,18,51,0.000333,0.074669,5,1120.040943,62.224497,224.008189,71.273029,1,0
0,0,3,3,10,10,20,31,17,48,0.000333,0.069151,5,1037.262743,57.625708,207.452549,66.438562,1,0
0,0,9,9,11,15,26,71,40,111,0.000333,0.173916,10,5217.488087,289.860449,521.748809,96.657107,1,0
0,0,6,6,7,11,18,41,25,66,0.000333,0.091738,6,1651.290301,91.73835,275.21505,57.705232,1,0
0,0,14,14,11,13,24,62,45,107,0.000333,0.16353,15,7358.864814,408.825823,490.590988,86.159464,1,0
0,0,3,3,9,8,17,16,11,27,0.000333,0.036787,4,441.445987,24.524777,110.361497,52.529325,2,0
0,0,4,4,6,5,11,24,12,36,0.000333,0.041513,6,747.23723,41.513179,124.539538,27.119415,1,0
0,0,7,7,11,19,30,44,28,72,0.000333,0.117765,5,1766.480614,98.137812,353.296123,118.764371,2,0
0,0,6,6,9,10,19,28,17,45,0.000333,0.063719,4,764.626952,42.479275,191.156738,61.748606,1,0
0,0,7,7,14,15,29,42,31,73,0.000333,0.118211,14,4964.856577,275.825365,354.632613,111.906328,4,0
0,0,4,4,10,15,25,32,21,53,0.000333,0.082041,5,1230.62189,68.367883,246.124378,91.82264,1,0
0,0,11,11,15,21,36,84,43,127,0.000333,0.21886,14,9192.126653,510.673703,656.580475,150.842025,2,0
0,0,8,8,8,16,24,32,31,63,0.000333,0.096284,4,1155.41055,64.189475,288.852638,88,1,0
0,0,9,9,15,19,34,68,35,103,0.000333,0.17467,7,3668.060709,203.78115,524.008673,139.313982,2,0
0,0,4,4,10,8,18,25,15,40,0.000333,0.055599,5,833.985,46.3325,166.797,57.219281,1,0
0,0,9,9,11,12,23,34,29,63,0.000333,0.094995,10,2849.844032,158.324668,284.984403,81.073298,1,0
0,0,14,14,11,23,34,85,48,133,0.000333,0.225544,10,6766.325579,375.906977,676.632558,142.095673,1,0
0,0,5,5,10,11,21,29,17,46,0.000333,0.067349,5,1010.233007,56.124056,202.046601,71.273029,1,0
0,0,7,7,11,19,30,44,28,72,0.000333,0.117765,5,1766.480614,98.137812,353.296123,118.764371,2,0
0,0,6,6,9,10,19,28,17,45,0.000333,0.063719,4,764.626952,42.479275,191.156738,61.748606,1,0
0,0,4,4,10,15,25,32,21,53,0.000333,0.082041,5,1230.62189,68.367883,246.124378,91.82264,1,0
0,0,29,29,22,49,71,182,138,320,0.000333,0.655973,22,43294.21972,2405.234429,1967.919078,373.228278,5,0
0,0,4,4,9,7,16,17,12,29,0.000333,0.038667,4,464,25.777778,116,48.180809,1,0
0,0,5,5,8,8,16,19,12,31,0.000333,0.041333,4,496,27.555556,124,48,1,0
0,0,3,3,8,8,16,20,12,32,0.000333,0.042667,4,512,28.444444,128,48,1,0
0,0,5,5,7,12,19,32,22,54,0.000333,0.076463,3,688.164257,38.231348,229.388086,62.671034,1,0
0,0,6,6,7,13,20,35,24,59,0.000333,0.084998,3,764.981273,42.49896,254.993758,67.757201,1,0
0,0,9,9,15,19,34,68,35,103,0.000333,0.17467,7,3668.060709,203.78115,524.008673,139.313982,2,0
0,0,11,11,15,21,36,84,43,127,0.000333,0.21886,14,9192.126653,510.673703,656.580475,150.842025,2,0
0,0,8,8,15,18,33,66,34,100,0.000333,0.168146,7,3531.075884,196.170882,504.439412,133.662009,2,0
0,0,11,11,12,18,30,69,40,109,0.000333,0.178284,12,6418.212899,356.567383,534.851075,118.0782,2,0
0,0,4,4,10,7,17,20,10,30,0.000333,0.040875,5,613.119426,34.06219,122.623885,52.870765,1,0
0,0,6,6,10,9,19,23,14,37,0.000333,0.052391,5,785.86659,43.659255,157.173318,61.748606,1,0
0,0,5,5,8,11,19,25,18,43,0.000333,0.060887,4,730.643532,40.591307,182.660883,62.053748,1,0
0,0,11,11,15,21,36,84,43,127,0.000333,0.21886,14,9192.126653,510.673703,656.580475,150.842025,2,0
0,0,9,9,15,19,34,68,35,103,0.000333,0.17467,7,3668.060709,203.78115,524.008673,139.313982,2,0
0,0,10,10,12,14,26,41,33,74,0.000333,0.115944,12,4173.99047,231.888359,347.832539,96.322519,1,0
0,0,3,3,7,8,15,23,12,35,0.000333,0.04558,3,410.223513,22.790195,136.741171,43.651484,1,0
0,0,5,5,7,7,14,16,11,27,0.000333,0.034266,3,308.395749,17.133097,102.798583,39.302969,1,0
0,0,11,11,15,21,36,84,43,127,0.000333,0.21886,14,9192.126653,510.673703,656.580475,150.842025,2,0
0,0,10,10,15,27,42,169,61,230,0.000333,0.413411,14,17363.2621,964.625672,1240.233007,186.985321,7,0
0,0,8,8,15,18,33,66,34,100,0.000333,0.168146,7,3531.075884,196.170882,504.439412,133.662009,2,0
0,0,7,7,8,14,22,37,26,63,0.000333,0.093648,4,1123.776768,62.432043,280.944192,77.302969,1,0
0,0,9,9,15,19,34,68,35,103,0.000333,0.17467,7,3668.060709,203.78115,524.008673,139.313982,2,0
0,0,5,5,8,11,19,25,18,43,0.000333,0.060887,4,730.643532,40.591307,182.660883,62.053748,1,0
0,0,3,3,9,8,17,16,11,27,0.000333,0.036787,4,441.445987,24.524777,110.361497,52.529325,2,0
0,0,3,3,7,8,15,23,12,35,0.000333,0.04558,3,410.223513,22.790195,136.741171,43.651484,1,0
0,0,7,7,11,19,30,44,28,72,0.000333,0.117765,5,1766.480614,98.137812,353.296123,118.764371,2,0
0,0,4,4,7,8,15,20,13,33,0.000333,0.042976,3,386.782169,21.487898,128.92739,43.651484,4,0
0,0,5,5,11,12,23,33,21,54,0.000333,0.081424,5,1221.361728,67.853429,244.272346,81.073298,1,0
0,0,25,25,12,35,47,382,213,595,0.000333,1.10166,36,118979.2932,6609.960733,3304.980367,222.544456,4,0
0,0,5,5,10,10,20,20,20,40,0.000333,0.057626,10,1728.771238,96.042847,172.877124,66.438562,1,0
0,0,6,6,10,11,21,24,21,45,0.000333,0.065885,5,988.27142,54.903968,197.654284,71.273029,1,0
0,0,4,4,4,7,11,13,11,24,0.000333,0.027675,2,166.052718,9.225151,83.026359,27.651484,2,0
0,0,3,3,8,7,15,11,9,20,0.000333,0.026046,4,312.551248,17.363958,78.137812,43.651484,1,0
0,0,7,7,14,15,29,42,31,73,0.000333,0.118211,14,4964.856577,275.825365,354.632613,111.906328,4,0
0,0,5,5,6,8,14,25,17,42,0.000333,0.053303,6,959.45344,53.302969,159.908907,39.509775,1,0
0,0,5,5,10,10,20,27,14,41,0.000333,0.059066,5,885.995259,49.221959,177.199052,66.438562,3,0
0,0,7,7,11,18,29,48,28,76,0.000333,0.123069,5,1846.032778,102.557377,369.206556,113.112398,1,0
0,0,5,5,7,13,20,16,19,35,0.000333,0.050422,3,453.80245,25.211247,151.267483,67.757201,1,0
0,0,4,4,4,7,11,13,11,24,0.000333,0.027675,2,166.052718,9.225151,83.026359,27.651484,3,0
0,0,3,3,8,7,15,11,9,20,0.000333,0.026046,4,312.551248,17.363958,78.137812,43.651484,1,0
0,0,3,3,9,8,17,16,10,26,0.000333,0.035425,4,425.096135,23.616452,106.274034,52.529325,3,0
0,0,4,4,6,8,14,17,12,29,0.000333,0.036804,3,331.239878,18.402215,110.413293,39.509775,3,0
0,0,5,5,8,10,18,28,17,45,0.000333,0.062549,4,750.5865,41.69925,187.646625,57.219281,1,0
0,0,6,6,7,14,21,34,24,58,0.000333,0.084918,3,764.263232,42.459068,254.754411,72.954453,1,0
0,0,9,9,9,15,24,27,34,61,0.000333,0.093228,8,2237.4617,124.303428,279.682713,87.132684,1,0
0,0,9,9,15,19,34,47,37,84,0.000333,0.142449,7,2991.428151,166.190453,427.346879,139.313982,5,0
0,0,3,3,7,8,15,23,12,35,0.000333,0.04558,3,410.223513,22.790195,136.741171,43.651484,1,0
0,0,3,3,9,8,17,16,11,27,0.000333,0.036787,4,441.445987,24.524777,110.361497,52.529325,2,0
0,0,25,25,12,35,47,382,213,595,0.000333,1.10166,36,118979.2932,6609.960733,3304.980367,222.544456,4,0
0,0,5,5,11,12,23,33,21,54,0.000333,0.081424,5,1221.361728,67.853429,244.272346,81.073298,1,0
0,0,3,3,7,7,14,22,14,36,0.000333,0.045688,6,822.388663,45.688259,137.064777,39.302969,1,0
0,0,3,3,8,8,16,20,12,32,0.000333,0.042667,4,512,28.444444,128,48,1,0
0,0,5,5,8,10,18,28,17,45,0.000333,0.062549,4,750.5865,41.69925,187.646625,57.219281,1,0
0,0,25,25,12,35,47,382,213,595,0.000333,1.10166,36,118979.2932,6609.960733,3304.980367,222.544456,4,0
0,0,5,5,11,12,23,33,21,54,0.000333,0.081424,5,1221.361728,67.853429,244.272346,81.073298,1,0
0,0,3,3,8,6,14,11,9,20,0.000333,0.025382,4,304.588394,16.921577,76.147098,39.509775,1,0
0,0,5,5,10,10,20,27,14,41,0.000333,0.059066,5,885.995259,49.221959,177.199052,66.438562,3,0
0,0,5,5,7,7,14,16,11,27,0.000333,0.034266,3,308.395749,17.133097,102.798583,39.302969,1,0
0,0,8,8,16,17,33,49,35,84,0.000333,0.141243,16,6779.665696,376.648094,423.729106,133.486868,4,0
0,0,8,8,15,18,33,66,34,100,0.000333,0.168146,7,3531.075884,196.170882,504.439412,133.662009,2,0
0,0,11,11,15,21,36,84,43,127,0.000333,0.21886,14,9192.126653,510.673703,656.580475,150.842025,2,0
0,0,9,9,15,19,34,68,35,103,0.000333,0.17467,7,3668.060709,203.78115,524.008673,139.313982,2,0
0,0,5,5,8,13,21,18,17,35,0.000333,0.051244,4,614.924439,34.162469,153.73111,72.105716,1,0
0,0,3,3,8,7,15,11,9,20,0.000333,0.026046,4,312.551248,17.363958,78.137812,43.651484,1,0
0,0,4,4,4,7,11,13,11,24,0.000333,0.027675,2,166.052718,9.225151,83.026359,27.651484,3,0
0,0,9,9,15,19,34,68,35,103,0.000333,0.17467,7,3668.060709,203.78115,524.008673,139.313982,2,0
0,0,7,7,8,17,25,34,34,68,0.000333,0.105261,8,2526.257767,140.347654,315.782221,93.486868,1,0
0,0,8,8,15,18,33,66,34,100,0.000333,0.168146,7,3531.075884,196.170882,504.439412,133.662009,2,0
0,0,8,8,15,16,31,48,35,83,0.000333,0.137066,14,5756.776113,319.820895,411.198294,122.603359,4,0
0,0,3,3,10,7,17,22,12,34,0.000333,0.046325,5,694.868683,38.603816,138.973737,52.870765,1,0
0,0,3,3,7,5,12,11,7,18,0.000333,0.02151,3,193.587975,10.754888,64.529325,31.261125,1,0
0,0,4,4,4,7,11,13,11,24,0.000333,0.027675,2,166.052718,9.225151,83.026359,27.651484,3,0
0,0,5,5,8,10,18,28,17,45,0.000333,0.062549,4,750.5865,41.69925,187.646625,57.219281,1,0
0,0,4,4,4,7,11,13,11,24,0.000333,0.027675,2,166.052718,9.225151,83.026359,27.651484,3,0
0,0,4,4,4,7,11,13,11,24,0.000333,0.027675,2,166.052718,9.225151,83.026359,27.651484,2,0
0,0,7,7,8,14,22,30,32,62,0.000333,0.092162,8,2211.878083,122.882116,276.48476,77.302969,1,0
0,0,5,5,8,10,18,22,19,41,0.000333,0.056989,4,683.8677,37.99265,170.966925,57.219281,1,0
0,0,3,3,11,10,21,19,14,33,0.000333,0.048315,5,724.732375,40.26291,144.946475,71.273029,1,0
0,0,11,11,15,21,36,84,43,127,0.000333,0.21886,14,9192.126653,510.673703,656.580475,150.842025,2,0
0,0,8,8,15,18,33,66,34,100,0.000333,0.168146,7,3531.075884,196.170882,504.439412,133.662009,2,0
0,0,5,5,7,8,15,17,12,29,0.000333,0.037767,3,339.899482,18.883305,113.299827,43.651484,1,0
0,0,4,4,7,11,18,17,19,36,0.000333,0.050039,3,450.3519,25.01955,150.1173,57.705232,1,0
0,0,4,4,10,15,25,32,21,53,0.000333,0.082041,5,1230.62189,68.367883,246.124378,91.82264,1,0
0,0,3,3,5,6,11,9,8,17,0.000333,0.019603,2,117.620675,6.534482,58.810338,27.119415,1,0
0,0,7,7,11,19,30,44,28,72,0.000333,0.117765,5,1766.480614,98.137812,353.296123,118.764371,2,0
0,0,3,3,7,8,15,23,12,35,0.000333,0.04558,3,410.223513,22.790195,136.741171,43.651484,1,0
0,0,10,10,7,14,21,57,36,93,0.000333,0.136162,6,2450.913122,136.16184,408.48552,72.954453,1,0
0,0,6,6,7,15,22,31,24,55,0.000333,0.081756,3,735.806217,40.878123,245.268739,78.254843,1,0
0,0,4,4,9,7,16,16,11,27,0.000333,0.036,4,432,24,108,48.180809,1,0
0,0,9,9,15,19,34,68,35,103,0.000333,0.17467,7,3668.060709,203.78115,524.008673,139.313982,2,0
0,0,5,5,8,10,18,28,17,45,0.000333,0.062549,4,750.5865,41.69925,187.646625,57.219281,1,0
0,0,6,6,8,12,20,23,20,43,0.000333,0.061948,4,743.371632,41.298424,185.842908,67.01955,3,0
0,0,11,11,15,21,36,84,43,127,0.000333,0.21886,14,9192.126653,510.673703,656.580475,150.842025,2,0
0,0,4,4,9,10,19,26,20,46,0.000333,0.065135,8,1563.237325,86.846518,195.404666,61.748606,1,0
0,0,4,4,7,8,15,23,20,43,0.000333,0.055999,6,1007.977774,55.998765,167.996296,43.651484,1,0
0,0,5,5,10,11,21,20,16,36,0.000333,0.052708,5,790.617136,43.923174,158.123427,71.273029,1,0
0,0,3,3,11,11,22,26,15,41,0.000333,0.060946,5,914.183482,50.787971,182.836696,76.107496,3,0
0,0,5,5,12,16,28,39,25,64,0.000333,0.102557,6,1846.02429,102.556905,307.670715,107.01955,2,0
0,0,3,3,5,6,11,9,8,17,0.000333,0.019603,2,117.620675,6.534482,58.810338,27.119415,1,0
0,0,7,7,8,12,20,29,20,49,0.000333,0.070591,4,847.097907,47.060995,211.774477,67.01955,1,0
0,0,7,7,6,10,16,25,20,45,0.000333,0.06,6,1080,60,180,48.729056,1,0
0,0,6,6,9,10,19,31,18,49,0.000333,0.069383,4,832.593793,46.255211,208.148448,61.748606,1,0
0,0,8,8,15,18,33,66,34,100,0.000333,0.168146,7,3531.075884,196.170882,504.439412,133.662009,2,0
0,0,5,5,7,10,17,19,16,35,0.000333,0.047687,3,429.183598,23.843533,143.061199,52.870765,3,0
0,0,10,10,15,20,35,80,41,121,0.000333,0.206881,14,8689.005431,482.722524,620.643245,145.041921,2,0
0,0,5,5,7,8,15,22,15,37,0.000333,0.048185,3,433.664856,24.092492,144.554952,43.651484,1,0
0,0,7,7,9,17,26,46,34,80,0.000333,0.125345,8,3008.28142,167.126746,376.035177,98.016193,1,0
0,0,6,6,8,18,26,34,33,67,0.000333,0.104976,4,1259.717844,69.984325,314.929461,99.05865,1,0
0,0,9,9,15,20,35,72,36,108,0.000333,0.184654,7,3877.737961,215.429887,553.962566,145.041921,2,0
0,0,8,8,15,18,33,66,34,100,0.000333,0.168146,7,3531.075884,196.170882,504.439412,133.662009,2,0
0,0,3,3,7,5,12,11,7,18,0.000333,0.02151,3,193.587975,10.754888,64.529325,31.261125,1,0
0,0,6,6,9,10,19,28,17,45,0.000333,0.063719,4,764.626952,42.479275,191.156738,61.748606,1,0
0,0,4,4,10,15,25,32,21,53,0.000333,0.082041,5,1230.62189,68.367883,246.124378,91.82264,1,0
0,0,4,4,11,10,21,24,14,38,0.000333,0.055636,5,834.54031,46.363351,166.908062,71.273029,3,0
0,0,4,4,6,8,14,17,12,29,0.000333,0.036804,3,331.239878,18.402215,110.413293,39.509775,3,0
0,0,7,7,11,19,30,44,28,72,0.000333,0.117765,5,1766.480614,98.137812,353.296123,118.764371,2,0
0,0,5,5,12,16,28,39,25,64,0.000333,0.102557,6,1846.02429,102.556905,307.670715,107.01955,2,0
0,0,11,11,15,21,36,84,43,127,0.000333,0.21886,14,9192.126653,510.673703,656.580475,150.842025,2,0
0,0,8,8,15,18,33,66,34,100,0.000333,0.168146,7,3531.075884,196.170882,504.439412,133.662009,2,0
0,0,3,3,9,8,17,16,11,27,0.000333,0.036787,4,441.445987,24.524777,110.361497,52.529325,2,0
0,0,7,7,11,19,30,44,28,72,0.000333,0.117765,5,1766.480614,98.137812,353.296123,118.764371,2,0
0,0,8,8,11,6,17,29,14,43,0.000333,0.058587,10,1757.609022,97.644946,175.760902,53.563523,4,0
0,0,6,6,5,13,18,19,29,48,0.000333,0.066719,4,800.6256,44.4792,200.1564,59.715357,1,0
0,0,7,7,11,18,29,48,28,76,0.000333,0.123069,5,1846.032778,102.557377,369.206556,113.112398,1,0
0,0,9,9,10,11,21,31,28,59,0.000333,0.086382,10,2591.467279,143.970404,259.146728,71.273029,1,0
0,0,10,10,14,18,32,51,39,90,0.000333,0.15,14,6300,350,450,128.361619,2,0
0,0,4,4,9,8,17,15,12,27,0.000333,0.036787,4,441.445987,24.524777,110.361497,52.529325,1,0
0,0,3,3,7,5,12,11,7,18,0.000333,0.02151,3,193.587975,10.754888,64.529325,31.261125,1,0
0,0,25,25,12,35,47,382,213,595,0.000333,1.10166,36,118979.2932,6609.960733,3304.980367,222.544456,4,0
0,0,6,6,7,11,18,41,25,66,0.000333,0.091738,6,1651.290301,91.73835,275.21505,57.705232,1,0
0,0,5,5,8,13,21,28,27,55,0.000333,0.080526,8,1932.619666,107.367759,241.577458,72.105716,1,0
0,0,14,14,11,23,34,85,48,133,0.000333,0.225544,10,6766.325579,375.906977,676.632558,142.095673,1,0
0,0,23,23,13,34,47,157,98,255,0.000333,0.47214,12,16997.04189,944.280105,1416.420157,221.079453,1,0
0,0,6,6,7,15,22,29,33,62,0.000333,0.092162,6,1658.908562,92.161587,276.48476,78.254843,1,0
0,0,5,5,8,10,18,28,17,45,0.000333,0.062549,4,750.5865,41.69925,187.646625,57.219281,1,0
0,0,5,5,8,10,18,28,17,45,0.000333,0.062549,4,750.5865,41.69925,187.646625,57.219281,1,0
0,0,5,5,9,11,20,26,18,44,0.000333,0.063388,4,760.659345,42.258852,190.164836,66.583073,1,0
0,0,7,7,11,19,30,44,28,72,0.000333,0.117765,5,1766.480614,98.137812,353.296123,118.764371,2,0
0,0,3,3,8,7,15,11,9,20,0.000333,0.026046,4,312.551248,17.363958,78.137812,43.651484,1,0
0,0,4,4,4,6,10,16,12,28,0.000333,0.031005,4,372.055947,20.669775,93.013987,23.509775,1,0
0,0,9,9,15,19,34,68,35,103,0.000333,0.17467,7,3668.060709,203.78115,524.008673,139.313982,2,0
0,0,4,4,11,10,21,36,17,53,0.000333,0.077598,5,1163.964117,64.664673,232.792823,71.273029,1,0
0,0,4,4,6,8,14,17,12,29,0.000333,0.036804,3,331.239878,18.402215,110.413293,39.509775,3,0
0,0,4,4,7,11,18,20,16,36,0.000333,0.050039,3,450.3519,25.01955,150.1173,57.705232,1,0
0,0,3,3,7,8,15,23,12,35,0.000333,0.04558,3,410.223513,22.790195,136.741171,43.651484,1,0
0,0,9,9,15,19,34,68,35,103,0.000333,0.17467,7,3668.060709,203.78115,524.008673,139.313982,2,0
0,0,3,3,7,5,12,11,7,18,0.000333,0.02151,3,193.587975,10.754888,64.529325,31.261125,1,0
0,0,3,3,7,8,15,23,12,35,0.000333,0.04558,3,410.223513,22.790195,136.741171,43.651484,1,0
0,0,4,4,4,7,11,13,11,24,0.000333,0.027675,2,166.052718,9.225151,83.026359,27.651484,3,0
0,0,3,3,6,5,11,14,8,22,0.000333,0.025369,3,228.322487,12.684583,76.107496,27.119415,4,0
0,0,5,5,8,10,18,28,17,45,0.000333,0.062549,4,750.5865,41.69925,187.646625,57.219281,1,0
0,0,5,5,8,10,18,28,17,45,0.000333,0.062549,4,750.5865,41.69925,187.646625,57.219281,1,0
0,0,3,3,8,8,16,20,12,32,0.000333,0.042667,4,512,28.444444,128,48,1,0
0,0,3,3,9,6,15,18,12,30,0.000333,0.039069,8,937.653743,52.091875,117.206718,44.0391,1,0
0,0,11,11,13,18,31,67,49,116,0.000333,0.191562,12,6896.241264,383.124515,574.686772,123.164366,1,0
0,0,11,11,11,17,28,56,41,97,0.000333,0.155438,10,4663.134274,259.063015,466.313427,107.540616,1,0
0,0,3,3,8,7,15,15,9,24,0.000333,0.031255,4,375.061497,20.83675,93.765374,43.651484,3,0
0,0,7,7,11,19,30,44,28,72,0.000333,0.117765,5,1766.480614,98.137812,353.296123,118.764371,2,0
0,0,4,4,11,10,21,24,14,38,0.000333,0.055636,5,834.54031,46.363351,166.908062,71.273029,3,0
0,0,3,3,7,8,15,23,12,35,0.000333,0.04558,3,410.223513,22.790195,136.741171,43.651484,1,0
0,0,4,4,4,7,11,13,11,24,0.000333,0.027675,2,166.052718,9.225151,83.026359,27.651484,3,0
0,0,6,6,9,10,19,28,17,45,0.000333,0.063719,4,764.626952,42.479275,191.156738,61.748606,1,0
0,0,9,9,15,19,34,68,35,103,0.000333,0.17467,7,3668.060709,203.78115,524.008673,139.313982,2,0
0,0,10,10,13,12,25,49,32,81,0.000333,0.125384,12,4513.828216,250.768234,376.152351,91.125266,1,0
0,0,9,9,13,17,30,39,37,76,0.000333,0.124308,12,4475.084223,248.61579,372.923685,117.592585,1,0
0,0,9,9,15,19,34,68,35,103,0.000333,0.17467,7,3668.060709,203.78115,524.008673,139.313982,2,0
0,0,11,11,15,21,36,84,43,127,0.000333,0.21886,14,9192.126653,510.673703,656.580475,150.842025,2,0
0,0,7,7,8,17,25,44,42,86,0.000333,0.133124,8,3194.973059,177.498503,399.371632,93.486868,1,0
0,0,7,7,11,19,30,44,28,72,0.000333,0.117765,5,1766.480614,98.137812,353.296123,118.764371,2,0
0,0,4,4,4,7,11,13,11,24,0.000333,0.027675,2,166.052718,9.225151,83.026359,27.651484,2,0
0,0,6,6,14,11,25,40,23,63,0.000333,0.097521,14,4095.881159,227.548953,292.56294,91.356717,4,0
0,0,5,5,17,15,32,38,23,61,0.000333,0.101667,8,2440,135.555556,305,128.090227,6,0
0,0,3,3,6,7,13,13,9,22,0.000333,0.027137,3,244.229021,13.568279,81.409674,35.161259,1,0
0,0,6,6,7,11,18,41,25,66,0.000333,0.091738,6,1651.290301,91.73835,275.21505,57.705232,1,0
0,0,3,3,9,8,17,16,10,26,0.000333,0.035425,4,425.096135,23.616452,106.274034,52.529325,3,0
0,0,5,5,9,11,20,26,18,44,0.000333,0.063388,4,760.659345,42.258852,190.164836,66.583073,1,0
0,0,5,5,8,10,18,28,17,45,0.000333,0.062549,4,750.5865,41.69925,187.646625,57.219281,1,0
0,0,15,15,12,23,35,74,49,123,0.000333,0.210301,12,7570.821733,420.601207,630.901811,147.061475,2,0
0,0,4,4,5,7,12,14,10,24,0.000333,0.02868,2,172.0782,9.5599,86.0391,31.261125,2,0
0,0,12,12,14,21,35,57,49,106,0.000333,0.181235,14,7611.855997,422.880889,543.704,145.541635,2,0
0,0,4,4,4,7,11,13,11,24,0.000333,0.027675,2,166.052718,9.225151,83.026359,27.651484,3,0
0,0,4,4,4,7,11,13,11,24,0.000333,0.027675,2,166.052718,9.225151,83.026359,27.651484,3,0
0,0,5,5,8,10,18,28,17,45,0.000333,0.062549,4,750.5865,41.69925,187.646625,57.219281,1,0
0,0,4,4,12,11,23,24,15,39,0.000333,0.058806,6,1058.513498,58.806305,176.418916,81.073298,4,0
0,0,3,3,9,8,17,16,11,27,0.000333,0.036787,4,441.445987,24.524777,110.361497,52.529325,2,0
0,0,11,11,15,21,36,84,43,127,0.000333,0.21886,14,9192.126653,510.673703,656.580475,150.842025,2,0
0,0,5,5,10,11,21,33,18,51,0.000333,0.074669,5,1120.040943,62.224497,224.008189,71.273029,1,0
0,0,25,25,11,26,37,162,92,254,0.000333,0.441067,15,19848.01732,1102.667629,1323.201155,160.26518,5,0
0,0,8,8,11,15,26,59,34,93,0.000333,0.145714,10,4371.408938,242.856052,437.140894,96.657107,1,0
0,0,4,4,9,8,17,15,12,27,0.000333,0.036787,4,441.445987,24.524777,110.361497,52.529325,1,0
0,0,4,4,4,7,11,13,11,24,0.000333,0.027675,2,166.052718,9.225151,83.026359,27.651484,3,0
0,0,3,3,8,7,15,15,9,24,0.000333,0.031255,4,375.061497,20.83675,93.765374,43.651484,3,0
0,0,15,15,12,22,34,100,56,156,0.000333,0.264548,12,9523.730439,529.096135,793.644203,141.127046,2,0
0,0,3,3,8,6,14,11,9,20,0.000333,0.025382,4,304.588394,16.921577,76.147098,39.509775,1,0
0,0,8,8,15,18,33,66,34,100,0.000333,0.168146,7,3531.075884,196.170882,504.439412,133.662009,2,0
0,0,11,11,15,21,36,84,43,127,0.000333,0.21886,14,9192.126653,510.673703,656.580475,150.842025,2,0
0,0,9,9,15,19,34,68,35,103,0.000333,0.17467,7,3668.060709,203.78115,524.008673,139.313982,2,0
0,0,5,5,8,10,18,28,17,45,0.000333,0.062549,4,750.5865,41.69925,187.646625,57.219281,1,0
0,0,3,3,9,8,17,16,11,27,0.000333,0.036787,4,441.445987,24.524777,110.361497,52.529325,2,0
0,0,5,5,7,8,15,17,12,29,0.000333,0.037767,3,339.899482,18.883305,113.299827,43.651484,1,0
0,0,7,7,8,12,20,29,20,49,0.000333,0.070591,4,847.097907,47.060995,211.774477,67.01955,1,0
0,0,21,21,13,22,35,128,75,203,0.000333,0.347081,18,18742.40014,1041.244452,1041.244452,146.213212,1,0
0,0,9,9,15,19,34,68,35,103,0.000333,0.17467,7,3668.060709,203.78115,524.008673,139.313982,2,0
0,0,3,3,7,8,15,23,12,35,0.000333,0.04558,3,410.223513,22.790195,136.741171,43.651484,1,0
0,0,5,5,8,10,18,28,17,45,0.000333,0.062549,4,750.5865,41.69925,187.646625,57.219281,1,0
0,0,5,5,8,10,18,28,17,45,0.000333,0.062549,4,750.5865,41.69925,187.646625,57.219281,1,0
0,0,4,4,4,7,11,13,11,24,0.000333,0.027675,2,166.052718,9.225151,83.026359,27.651484,3,0
0,0,10,10,14,16,30,51,35,86,0.000333,0.140664,14,5907.896277,328.21646,421.992591,117.302969,2,0
0,0,8,8,15,18,33,66,34,100,0.000333,0.168146,7,3531.075884,196.170882,504.439412,133.662009,2,0
0,0,3,3,9,8,17,16,11,27,0.000333,0.036787,4,441.445987,24.524777,110.361497,52.529325,2,0
0,0,11,11,15,21,36,84,43,127,0.000333,0.21886,14,9192.126653,510.673703,656.580475,150.842025,2,0
0,0,5,5,10,11,21,20,16,36,0.000333,0.052708,5,790.617136,43.923174,158.123427,71.273029,1,0
0,0,5,5,7,7,14,17,13,30,0.000333,0.038074,3,342.661943,19.036775,114.220648,39.302969,1,0
0,0,5,5,8,8,16,24,16,40,0.000333,0.053333,8,1280,71.111111,160,48,1,0
0,0,6,6,5,13,18,19,29,48,0.000333,0.066719,4,800.6256,44.4792,200.1564,59.715357,1,0
0,0,4,4,4,7,11,13,11,24,0.000333,0.027675,2,166.052718,9.225151,83.026359,27.651484,3,0
0,0,4,4,11,10,21,24,14,38,0.000333,0.055636,5,834.54031,46.363351,166.908062,71.273029,3,0
0,0,4,4,7,10,17,17,17,34,0.000333,0.046325,3,416.92121,23.162289,138.973737,52.870765,1,0
0,0,3,3,8,7,15,15,9,24,0.000333,0.031255,4,375.061497,20.83675,93.765374,43.651484,3,0
0,0,4,4,8,9,17,19,14,33,0.000333,0.044962,4,539.545095,29.974728,134.886274,52.529325,1,0
0,0,5,5,8,10,18,26,15,41,0.000333,0.056989,4,683.8677,37.99265,170.966925,57.219281,1,0
0,0,4,4,10,15,25,32,21,53,0.000333,0.082041,5,1230.62189,68.367883,246.124378,91.82264,1,0
0,0,11,11,15,21,36,84,43,127,0.000333,0.21886,14,9192.126653,510.673703,656.580475,150.842025,2,0
0,0,9,9,15,19,34,68,35,103,0.000333,0.17467,7,3668.060709,203.78115,524.008673,139.313982,2,0
0,0,4,4,9,9,18,19,15,34,0.000333,0.047259,4,567.1098,31.5061,141.77745,57.05865,1,0
0,0,3,3,7,8,15,23,12,35,0.000333,0.04558,3,410.223513,22.790195,136.741171,43.651484,1,0
0,0,5,5,8,10,18,28,17,45,0.000333,0.062549,4,750.5865,41.69925,187.646625,57.219281,1,0
0,0,7,7,11,19,30,44,28,72,0.000333,0.117765,5,1766.480614,98.137812,353.296123,118.764371,2,0
0,0,5,5,10,11,21,29,17,46,0.000333,0.067349,5,1010.233007,56.124056,202.046601,71.273029,1,0
0,0,5,5,7,11,18,15,15,30,0.000333,0.041699,3,375.29325,20.849625,125.09775,57.705232,1,0
0,0,4,4,8,9,17,16,13,29,0.000333,0.039512,4,474.14569,26.341427,118.536422,52.529325,3,0
0,0,5,5,11,11,22,31,17,48,0.000333,0.071351,5,1070.263588,59.459088,214.052718,76.107496,1,0
0,0,8,8,10,10,20,34,28,62,0.000333,0.08932,10,2679.595419,148.866412,267.959542,66.438562,1,0
0,0,7,7,11,19,30,44,28,72,0.000333,0.117765,5,1766.480614,98.137812,353.296123,118.764371,2,0
0,0,4,4,4,7,11,13,11,24,0.000333,0.027675,2,166.052718,9.225151,83.026359,27.651484,3,0
0,0,8,8,15,18,33,66,34,100,0.000333,0.168146,7,3531.075884,196.170882,504.439412,133.662009,2,0
0,0,5,5,9,12,21,19,24,43,0.000333,0.062957,8,1510.957193,83.942066,188.869649,71.548875,1,0
0,0,25,25,12,35,47,382,213,595,0.000333,1.10166,36,118979.2932,6609.960733,3304.980367,222.544456,4,0
0,0,5,5,11,12,23,33,21,54,0.000333,0.081424,5,1221.361728,67.853429,244.272346,81.073298,1,0
0,0,9,9,15,19,34,68,35,103,0.000333,0.17467,7,3668.060709,203.78115,524.008673,139.313982,2,0
0,0,8,8,15,18,33,66,34,100,0.000333,0.168146,7,3531.075884,196.170882,504.439412,133.662009,2,0
0,0,4,4,8,6,14,16,12,28,0.000333,0.035535,8,852.847503,47.380417,106.605938,39.509775,1,0
0,0,5,5,8,8,16,19,12,31,0.000333,0.041333,4,496,27.555556,124,48,1,0
0,0,30,30,13,34,47,193,107,300,0.000333,0.555459,18,29994.7798,1666.376656,1666.376656,221.079453,1,0
0,0,4,4,5,11,16,13,14,27,0.000333,0.036,2,216,12,108,49.663388,1,0
0,0,3,3,7,8,15,23,12,35,0.000333,0.04558,3,410.223513,22.790195,136.741171,43.651484,1,0
0,0,3,3,6,5,11,14,9,23,0.000333,0.026522,3,238.700782,13.261155,79.566927,27.119415,4,0
0,0,8,8,9,14,23,35,28,63,0.000333,0.094995,8,2279.875226,126.659735,284.984403,81.832294,1,0
0,0,3,3,7,8,15,23,12,35,0.000333,0.04558,3,410.223513,22.790195,136.741171,43.651484,1,0
0,0,8,8,15,15,30,47,35,82,0.000333,0.134122,14,5633.110404,312.950578,402.365029,117.206718,4,0
0,0,4,4,4,7,11,13,11,24,0.000333,0.027675,2,166.052718,9.225151,83.026359,27.651484,3,0
0,0,25,25,12,35,47,382,213,595,0.000333,1.10166,36,118979.2932,6609.960733,3304.980367,222.544456,4,0
0,0,5,5,10,11,21,33,18,51,0.000333,0.074669,5,1120.040943,62.224497,224.008189,71.273029,1,0
0,0,6,6,8,14,22,21,24,45,0.000333,0.066891,4,802.697691,44.594316,200.674423,77.302969,1,0
0,0,5,5,8,16,24,38,28,66,0.000333,0.100869,4,1210.4301,67.246117,302.607525,88,1,0
0,0,5,5,8,11,19,36,19,55,0.000333,0.077879,4,934.544053,51.919114,233.636013,62.053748,1,0
0,0,6,6,11,14,25,28,21,49,0.000333,0.07585,5,1137.744766,63.208043,227.548953,91.356717,1,0
0,0,5,5,7,8,15,51,26,77,0.000333,0.100277,9,2707.475183,150.415288,300.830576,43.651484,1,0
0,0,4,4,7,7,14,39,20,59,0.000333,0.074878,6,1347.803642,74.87798,224.63394,39.302969,1,0
0,0,6,6,7,9,16,63,32,95,0.000333,0.126667,9,3420,190,380,48.180809,1,0
0,0,29,29,22,49,71,182,138,320,0.000333,0.655973,22,43294.21972,2405.234429,1967.919078,373.228278,5,0
0,0,7,7,11,19,30,44,28,72,0.000333,0.117765,5,1766.480614,98.137812,353.296123,118.764371,2,0
0,0,9,9,15,19,34,68,35,103,0.000333,0.17467,7,3668.060709,203.78115,524.008673,139.313982,2,0
0,0,8,8,15,18,33,66,34,100,0.000333,0.168146,7,3531.075884,196.170882,504.439412,133.662009,2,0
0,0,11,11,15,21,36,84,43,127,0.000333,0.21886,14,9192.126653,510.673703,656.580475,150.842025,2,0
0,0,5,5,7,7,14,16,11,27,0.000333,0.034266,3,308.395749,17.133097,102.798583,39.302969,1,0
0,0,3,3,7,5,12,11,7,18,0.000333,0.02151,3,193.587975,10.754888,64.529325,31.261125,1,0
0,0,8,8,11,13,24,27,17,44,0.000333,0.067246,5,1008.69175,56.038431,201.73835,86.159464,2,0
0,0,3,3,8,6,14,11,9,20,0.000333,0.025382,4,304.588394,16.921577,76.147098,39.509775,1,0
0,0,5,5,8,10,18,28,17,45,0.000333,0.062549,4,750.5865,41.69925,187.646625,57.219281,1,0
0,0,5,5,9,12,21,20,17,37,0.000333,0.054172,4,650.062979,36.11461,162.515745,71.548875,1,0
0,0,3,3,7,8,15,23,12,35,0.000333,0.04558,3,410.223513,22.790195,136.741171,43.651484,1,0
0,0,5,5,11,12,23,33,21,54,0.000333,0.081424,5,1221.361728,67.853429,244.272346,81.073298,1,0
0,0,3,3,5,6,11,9,8,17,0.000333,0.019603,2,117.620675,6.534482,58.810338,27.119415,1,0
0,0,9,9,15,19,34,68,35,103,0.000333,0.17467,7,3668.060709,203.78115,524.008673,139.313982,2,0
0,0,7,7,10,14,24,40,27,67,0.000333,0.102397,5,1535.962438,85.331247,307.192488,86.52225,1,0
0,0,4,4,10,10,20,18,15,33,0.000333,0.047541,5,713.118136,39.617674,142.623627,66.438562,1,0
0,0,8,8,15,18,33,66,34,100,0.000333,0.168146,7,3531.075884,196.170882,504.439412,133.662009,2,0
0,0,11,11,15,21,36,84,43,127,0.000333,0.21886,14,9192.126653,510.673703,656.580475,150.842025,2,0
0,0,5,5,11,13,24,28,20,48,0.000333,0.073359,5,1100.391,61.132833,220.0782,86.159464,1,0
0,0,7,7,11,19,30,44,28,72,0.000333,0.117765,5,1766.480614,98.137812,353.296123,118.764371,2,0
0,0,8,8,15,18,33,66,34,100,0.000333,0.168146,7,3531.075884,196.170882,504.439412,133.662009,2,0
0,0,7,7,9,11,20,31,20,51,0.000333,0.073473,4,881.673331,48.981852,220.418333,66.583073,1,0
0,0,3,3,7,5,12,11,7,18,0.000333,0.02151,3,193.587975,10.754888,64.529325,31.261125,1,0
0,0,11,11,15,21,36,84,43,127,0.000333,0.21886,14,9192.126653,510.673703,656.580475,150.842025,2,0
0,0,4,4,8,7,15,15,10,25,0.000333,0.032557,4,390.68906,21.704948,97.672265,43.651484,1,0
0,0,11,11,12,18,30,69,40,109,0.000333,0.178284,12,6418.212899,356.567383,534.851075,118.0782,2,0
0,0,3,3,9,8,17,16,11,27,0.000333,0.036787,4,441.445987,24.524777,110.361497,52.529325,2,0
0,0,4,4,7,13,20,23,18,41,0.000333,0.059066,3,531.597156,29.533175,177.199052,67.757201,1,0
0,0,5,5,10,11,21,33,18,51,0.000333,0.074669,5,1120.040943,62.224497,224.008189,71.273029,1,0
0,0,5,5,12,14,26,31,21,52,0.000333,0.081474,6,1466.537192,81.474288,244.422865,96.322519,1,0
0,0,7,7,11,19,30,44,28,72,0.000333,0.117765,5,1766.480614,98.137812,353.296123,118.764371,2,0
0,0,7,7,11,18,29,48,28,76,0.000333,0.123069,5,1846.032778,102.557377,369.206556,113.112398,1,0
0,0,4,4,4,7,11,13,11,24,0.000333,0.027675,2,166.052718,9.225151,83.026359,27.651484,3,0
0,0,3,3,7,5,12,11,7,18,0.000333,0.02151,3,193.587975,10.754888,64.529325,31.261125,1,0
0,0,8,8,10,13,23,35,20,55,0.000333,0.082932,5,1243.979538,69.109974,248.795908,81.324997,4,0
0,0,24,24,15,30,45,156,87,243,0.000333,0.44484,14,18683.28423,1037.960235,1334.520302,205.810077,2,0
0,0,4,4,6,12,18,16,15,31,0.000333,0.043089,3,387.803025,21.544613,129.267675,58.529325,1,0
0,0,3,3,8,7,15,11,9,20,0.000333,0.026046,4,312.551248,17.363958,78.137812,43.651484,1,0
0,0,5,5,7,7,14,16,11,27,0.000333,0.034266,3,308.395749,17.133097,102.798583,39.302969,1,0
0,0,5,5,8,10,18,28,17,45,0.000333,0.062549,4,750.5865,41.69925,187.646625,57.219281,1,0
0,0,5,5,7,8,15,17,12,29,0.000333,0.037767,3,339.899482,18.883305,113.299827,43.651484,1,0
0,0,5,5,6,13,19,19,18,37,0.000333,0.052391,3,471.519954,26.195553,157.173318,63.615491,1,0
0,0,29,29,12,35,47,218,115,333,0.000333,0.616559,18,33294.20558,1849.678088,1849.678088,222.544456,7,0
0,0,3,3,11,11,22,26,15,41,0.000333,0.060946,5,914.183482,50.787971,182.836696,76.107496,3,0
0,0,4,4,9,7,16,16,11,27,0.000333,0.036,4,432,24,108,48.180809,1,0
0,0,8,8,12,16,28,40,30,70,0.000333,0.112172,6,2019.089067,112.171615,336.514845,107.01955,1,0
0,0,5,5,8,10,18,28,17,45,0.000333,0.062549,4,750.5865,41.69925,187.646625,57.219281,1,0
0,0,4,4,9,7,16,16,11,27,0.000333,0.036,4,432,24,108,48.180809,1,0
0,0,3,3,8,8,16,15,10,25,0.000333,0.033333,4,400,22.222222,100,48,2,0
0,0,5,5,8,8,16,22,14,36,0.000333,0.048,4,576,32,144,48,1,0
0,0,3,3,9,8,17,16,11,27,0.000333,0.036787,4,441.445987,24.524777,110.361497,52.529325,2,0
0,0,3,3,10,8,18,16,13,29,0.000333,0.040309,5,604.639125,33.591063,120.927825,57.219281,3,0
0,0,5,5,8,10,18,28,17,45,0.000333,0.062549,4,750.5865,41.69925,187.646625,57.219281,1,0
0,0,8,8,15,18,33,66,34,100,0.000333,0.168146,7,3531.075884,196.170882,504.439412,133.662009,2,0
0,0,7,7,11,19,30,44,28,72,0.000333,0.117765,5,1766.480614,98.137812,353.296123,118.764371,2,0
0,0,5,5,8,10,18,28,17,45,0.000333,0.062549,4,750.5865,41.69925,187.646625,57.219281,1,0
0,0,4,4,4,7,11,13,11,24,0.000333,0.027675,2,166.052718,9.225151,83.026359,27.651484,3,0
0,0,3,3,7,8,15,23,12,35,0.000333,0.04558,3,410.223513,22.790195,136.741171,43.651484,1,0
0,0,4,4,11,9,20,35,15,50,0.000333,0.072032,5,1080.482024,60.026779,216.096405,66.583073,2,0
0,0,5,5,12,16,28,39,25,64,0.000333,0.102557,6,1846.02429,102.556905,307.670715,107.01955,2,0
0,0,4,4,7,11,18,18,15,33,0.000333,0.045869,3,412.822575,22.934588,137.607525,57.705232,1,0
0,0,5,5,9,14,23,27,21,48,0.000333,0.072377,4,868.523896,48.251328,217.130974,81.832294,1,0
0,0,6,6,6,14,20,28,22,50,0.000333,0.072032,3,648.289214,36.016067,216.096405,68.812744,1,0
0,0,6,6,9,10,19,28,17,45,0.000333,0.063719,4,764.626952,42.479275,191.156738,61.748606,1,0
0,0,6,6,9,10,19,28,17,45,0.000333,0.063719,4,764.626952,42.479275,191.156738,61.748606,1,0
0,0,5,5,8,9,17,25,15,40,0.000333,0.0545,4,653.994055,36.333003,163.498514,52.529325,1,0
0,0,3,3,9,8,17,16,11,27,0.000333,0.036787,4,441.445987,24.524777,110.361497,52.529325,2,0
0,0,6,6,16,9,25,46,18,64,0.000333,0.099069,16,4755.308738,264.183819,297.206796,92.529325,2,0
0,0,5,5,8,8,16,19,12,31,0.000333,0.041333,4,496,27.555556,124,48,1,0
0,0,5,5,7,8,15,17,12,29,0.000333,0.037767,3,339.899482,18.883305,113.299827,43.651484,1,0
0,0,3,3,8,7,15,11,9,20,0.000333,0.026046,4,312.551248,17.363958,78.137812,43.651484,1,0
0,0,4,4,9,7,16,17,12,29,0.000333,0.038667,4,464,25.777778,116,48.180809,1,0
0,0,10,10,12,14,26,51,43,94,0.000333,0.14728,18,7953.144003,441.841334,441.841334,96.322519,1,0
0,0,5,5,12,9,21,33,19,52,0.000333,0.076134,12,2740.806072,152.267004,228.400506,71.548875,2,0
0,0,5,5,10,10,20,26,15,41,0.000333,0.059066,5,885.995259,49.221959,177.199052,66.438562,1,0
0,0,7,7,11,18,29,48,28,76,0.000333,0.123069,5,1846.032778,102.557377,369.206556,113.112398,1,0
0,0,3,3,8,7,15,11,9,20,0.000333,0.026046,4,312.551248,17.363958,78.137812,43.651484,1,0
0,0,33,33,10,39,49,115,71,186,0.000333,0.348112,5,5221.680155,290.093342,1044.336031,239.349967,13,0
0,0,5,5,8,10,18,28,17,45,0.000333,0.062549,4,750.5865,41.69925,187.646625,57.219281,1,0
0,0,7,7,11,19,30,44,28,72,0.000333,0.117765,5,1766.480614,98.137812,353.296123,118.764371,2,0
0,0,7,7,11,19,30,44,28,72,0.000333,0.117765,5,1766.480614,98.137812,353.296123,118.764371,2,0
0,0,4,4,6,8,14,17,12,29,0.000333,0.036804,3,331.239878,18.402215,110.413293,39.509775,3,0
0,0,8,8,15,18,33,66,34,100,0.000333,0.168146,7,3531.075884,196.170882,504.439412,133.662009,2,0
0,0,4,4,4,7,11,13,11,24,0.000333,0.027675,2,166.052718,9.225151,83.026359,27.651484,3,0
0,0,4,4,7,8,15,16,12,28,0.000333,0.036464,3,328.17881,18.232156,109.392937,43.651484,3,0
0,0,4,4,4,7,11,13,11,24,0.000333,0.027675,2,166.052718,9.225151,83.026359,27.651484,3,0
0,0,14,14,11,22,33,79,41,120,0.000333,0.201776,5,3026.636472,168.146471,605.327294,136.161243,5,0
0,0,8,8,15,18,33,66,34,100,0.000333,0.168146,7,3531.075884,196.170882,504.439412,133.662009,2,0
0,0,5,5,8,12,20,25,19,44,0.000333,0.063388,4,760.659345,42.258852,190.164836,67.01955,1,0
0,0,4,4,9,8,17,15,12,27,0.000333,0.036787,4,441.445987,24.524777,110.361497,52.529325,1,0
0,0,7,7,11,19,30,44,28,72,0.000333,0.117765,5,1766.480614,98.137812,353.296123,118.764371,2,0
0,0,5,5,12,16,28,39,25,64,0.000333,0.102557,6,1846.02429,102.556905,307.670715,107.01955,4,0
0,0,9,9,15,20,35,72,36,108,0.000333,0.184654,7,3877.737961,215.429887,553.962566,145.041921,2,0
0,0,36,36,12,19,31,211,116,327,0.000333,0.540007,36,58320.79897,3240.044387,1620.022193,123.730173,40,0
0,0,11,11,15,21,36,84,43,127,0.000333,0.21886,14,9192.126653,510.673703,656.580475,150.842025,2,0
0,0,9,9,15,19,34,68,35,103,0.000333,0.17467,7,3668.060709,203.78115,524.008673,139.313982,2,0
0,0,23,23,10,24,34,743,88,831,0.000333,1.409227,15,63415.22432,3523.068018,4227.681621,143.258381,1,0
0,0,3,3,9,8,17,16,11,27,0.000333,0.036787,4,441.445987,24.524777,110.361497,52.529325,2,0
0,0,5,5,8,11,19,36,19,55,0.000333,0.077879,4,934.544053,51.919114,233.636013,62.053748,1,0
0,0,5,5,7,7,14,16,11,27,0.000333,0.034266,3,308.395749,17.133097,102.798583,39.302969,1,0
0,0,4,4,4,7,11,13,11,24,0.000333,0.027675,2,166.052718,9.225151,83.026359,27.651484,2,0
0,0,8,8,10,10,20,34,28,62,0.000333,0.08932,10,2679.595419,148.866412,267.959542,66.438562,1,0
0,0,5,5,9,9,18,27,17,44,0.000333,0.061159,4,733.9068,40.7726,183.4767,57.05865,1,0
0,0,3,3,11,11,22,26,15,41,0.000333,0.060946,5,914.183482,50.787971,182.836696,76.107496,3,0
0,0,6,6,7,11,18,41,25,66,0.000333,0.091738,6,1651.290301,91.73835,275.21505,57.705232,1,0
0,0,6,6,14,12,26,43,26,69,0.000333,0.10811,14,4540.624768,252.256932,324.330341,96.322519,4,0
0,0,5,5,8,11,19,31,21,52,0.000333,0.073631,4,883.568923,49.087162,220.892231,62.053748,1,0
0,0,7,7,8,13,21,46,29,75,0.000333,0.109808,8,2635.390454,146.410581,329.423807,72.105716,1,0
0,0,8,8,15,18,33,66,34,100,0.000333,0.168146,7,3531.075884,196.170882,504.439412,133.662009,2,0
0,0,11,11,15,21,36,84,43,127,0.000333,0.21886,14,9192.126653,510.673703,656.580475,150.842025,2,0
0,0,8,8,15,18,33,66,34,100,0.000333,0.168146,7,3531.075884,196.170882,504.439412,133.662009,2,0
0,0,5,5,8,10,18,28,17,45,0.000333,0.062549,4,750.5865,41.69925,187.646625,57.219281,1,0
0,0,5,5,8,10,18,28,17,45,0.000333,0.062549,4,750.5865,41.69925,187.646625,57.219281,1,0
0,0,5,5,8,10,18,28,17,45,0.000333,0.062549,4,750.5865,41.69925,187.646625,57.219281,1,0
0,0,3,3,7,5,12,11,7,18,0.000333,0.02151,3,193.587975,10.754888,64.529325,31.261125,1,0
0,0,4,4,6,8,14,17,12,29,0.000333,0.036804,3,331.239878,18.402215,110.413293,39.509775,3,0
0,0,3,3,9,8,17,16,10,26,0.000333,0.035425,4,425.096135,23.616452,106.274034,52.529325,3,0
0,0,5,5,8,11,19,30,18,48,0.000333,0.067967,4,815.602083,45.311227,203.900521,62.053748,1,0
0,0,6,6,10,11,21,24,21,45,0.000333,0.065885,5,988.27142,54.903968,197.654284,71.273029,1,0
0,0,8,8,15,18,33,66,34,100,0.000333,0.168146,7,3531.075884,196.170882,504.439412,133.662009,2,0
0,0,8,8,15,18,33,66,34,100,0.000333,0.168146,7,3531.075884,196.170882,504.439412,133.662009,2,0
0,0,11,11,15,21,36,84,43,127,0.000333,0.21886,14,9192.126653,510.673703,656.580475,150.842025,2,0
0,0,9,9,15,19,34,68,35,103,0.000333,0.17467,7,3668.060709,203.78115,524.008673,139.313982,2,0
0,0,9,9,15,19,34,68,35,103,0.000333,0.17467,7,3668.060709,203.78115,524.008673,139.313982,2,0
0,0,3,3,7,5,12,11,7,18,0.000333,0.02151,3,193.587975,10.754888,64.529325,31.261125,1,0
0,0,7,7,8,12,20,27,24,51,0.000333,0.073473,8,1763.346663,97.963703,220.418333,67.01955,3,0
0,0,3,3,7,8,15,23,12,35,0.000333,0.04558,3,410.223513,22.790195,136.741171,43.651484,1,0
0,0,4,4,4,7,11,13,11,24,0.000333,0.027675,2,166.052718,9.225151,83.026359,27.651484,3,0
0,0,4,4,10,15,25,32,21,53,0.000333,0.082041,5,1230.62189,68.367883,246.124378,91.82264,1,0
0,0,6,6,9,10,19,28,17,45,0.000333,0.063719,4,764.626952,42.479275,191.156738,61.748606,1,0
0,0,3,3,8,7,15,20,12,32,0.000333,0.041673,4,500.081996,27.782333,125.020499,43.651484,1,0
0,0,8,8,8,13,21,48,27,75,0.000333,0.109808,8,2635.390454,146.410581,329.423807,72.105716,4,0
0,0,5,5,10,11,21,33,18,51,0.000333,0.074669,5,1120.040943,62.224497,224.008189,71.273029,1,0
0,0,5,5,8,13,21,25,20,45,0.000333,0.065885,4,790.617136,43.923174,197.654284,72.105716,1,0
0,0,5,5,8,10,18,28,17,45,0.000333,0.062549,4,750.5865,41.69925,187.646625,57.219281,1,0
0,0,3,3,8,8,16,20,12,32,0.000333,0.042667,4,512,28.444444,128,48,1,0
0,0,9,9,15,19,34,68,35,103,0.000333,0.17467,7,3668.060709,203.78115,524.008673,139.313982,2,0
0,0,6,6,7,12,19,23,31,54,0.000333,0.076463,6,1376.328514,76.462695,229.388086,62.671034,1,0
0,0,5,5,11,13,24,28,20,48,0.000333,0.073359,5,1100.391,61.132833,220.0782,86.159464,1,0
0,0,18,18,11,28,39,115,64,179,0.000333,0.315362,10,9460.869972,525.603887,946.086997,172.659686,1,0
0,0,9,9,15,19,34,49,39,88,0.000333,0.149232,14,6267.75422,348.208568,447.69673,139.313982,4,0
0,0,18,18,14,28,42,109,63,172,0.000333,0.30916,14,12984.70035,721.372242,927.478597,187.908907,1,0
0,0,8,8,13,12,25,39,25,64,0.000333,0.099069,12,3566.481554,198.137864,297.206796,91.125266,1,0
0,0,11,11,15,21,36,84,43,127,0.000333,0.21886,14,9192.126653,510.673703,656.580475,150.842025,2,0
0,0,8,8,15,18,33,66,34,100,0.000333,0.168146,7,3531.075884,196.170882,504.439412,133.662009,2,0
0,0,7,7,11,18,29,48,28,76,0.000333,0.123069,5,1846.032778,102.557377,369.206556,113.112398,1,0
0,0,7,7,11,13,24,33,19,52,0.000333,0.079473,5,1192.09025,66.227236,238.41805,86.159464,3,0
0,0,9,9,15,19,34,68,35,103,0.000333,0.17467,7,3668.060709,203.78115,524.008673,139.313982,2,0
0,0,9,9,15,19,34,68,35,103,0.000333,0.17467,7,3668.060709,203.78115,524.008673,139.313982,2,0
0,0,3,3,7,5,12,11,7,18,0.000333,0.02151,3,193.587975,10.754888,64.529325,31.261125,1,0
0,0,3,3,9,8,17,16,10,26,0.000333,0.035425,4,425.096135,23.616452,106.274034,52.529325,3,0
0,0,50,50,28,89,117,523,361,884,0.000333,2.024467,56,340110.5351,18895.02973,6073.402412,710.946213,33,0
0,0,4,4,10,15,25,32,21,53,0.000333,0.082041,5,1230.62189,68.367883,246.124378,91.82264,1,0
0,0,4,4,8,7,15,16,11,27,0.000333,0.035162,4,421.944184,23.441344,105.486046,43.651484,1,0
0,0,4,4,10,15,25,32,21,53,0.000333,0.082041,5,1230.62189,68.367883,246.124378,91.82264,1,0
0,0,4,4,4,7,11,13,11,24,0.000333,0.027675,2,166.052718,9.225151,83.026359,27.651484,3,0
0,0,3,3,7,5,12,11,7,18,0.000333,0.02151,3,193.587975,10.754888,64.529325,31.261125,1,0
0,0,8,8,12,16,28,52,36,88,0.000333,0.141016,12,5076.566798,282.031489,423.047233,107.01955,1,0
0,0,4,4,10,15,25,32,21,53,0.000333,0.082041,5,1230.62189,68.367883,246.124378,91.82264,1,0
0,0,3,3,7,5,12,11,7,18,0.000333,0.02151,3,193.587975,10.754888,64.529325,31.261125,1,0
0,0,4,4,4,7,11,13,11,24,0.000333,0.027675,2,166.052718,9.225151,83.026359,27.651484,3,0
0,0,6,6,8,12,20,23,20,43,0.000333,0.061948,4,743.371632,41.298424,185.842908,67.01955,3,0
0,0,10,10,13,12,25,49,32,81,0.000333,0.125384,12,4513.828216,250.768234,376.152351,91.125266,1,0
0,0,7,7,6,9,15,37,23,60,0.000333,0.078138,6,1406.480614,78.137812,234.413436,44.0391,1,0
0,0,8,8,11,15,26,59,34,93,0.000333,0.145714,10,4371.408938,242.856052,437.140894,96.657107,1,0
0,0,4,4,4,7,11,13,11,24,0.000333,0.027675,2,166.052718,9.225151,83.026359,27.651484,3,0
0,0,5,5,7,7,14,16,11,27,0.000333,0.034266,3,308.395749,17.133097,102.798583,39.302969,1,0
0,0,3,3,9,8,17,16,11,27,0.000333,0.036787,4,441.445987,24.524777,110.361497,52.529325,2,0
0,0,16,16,19,14,33,84,36,120,0.000333,0.201776,18,10895.8913,605.327294,605.327294,134.013592,8,0
0,0,3,3,7,5,12,11,7,18,0.000333,0.02151,3,193.587975,10.754888,64.529325,31.261125,1,0
0,0,6,6,14,12,26,41,24,65,0.000333,0.101843,14,4277.400144,237.633341,305.528582,96.322519,5,0
0,0,6,6,9,10,19,28,17,45,0.000333,0.063719,4,764.626952,42.479275,191.156738,61.748606,1,0
0,0,8,8,15,18,33,66,34,100,0.000333,0.168146,7,3531.075884,196.170882,504.439412,133.662009,2,0
0,0,11,11,15,21,36,84,43,127,0.000333,0.21886,14,9192.126653,510.673703,656.580475,150.842025,2,0
0,0,9,9,15,19,34,68,35,103,0.000333,0.17467,7,3668.060709,203.78115,524.008673,139.313982,2,0
0,0,7,7,11,19,30,44,28,72,0.000333,0.117765,5,1766.480614,98.137812,353.296123,118.764371,2,0
0,0,5,5,11,12,23,33,21,54,0.000333,0.081424,5,1221.361728,67.853429,244.272346,81.073298,1,0
0,0,25,25,12,35,47,382,213,595,0.000333,1.10166,36,118979.2932,6609.960733,3304.980367,222.544456,4,0
0,0,8,8,15,18,33,66,34,100,0.000333,0.168146,7,3531.075884,196.170882,504.439412,133.662009,2,0
0,0,3,3,7,5,12,11,7,18,0.000333,0.02151,3,193.587975,10.754888,64.529325,31.261125,1,0
0,0,9,9,9,15,24,62,41,103,0.000333,0.157417,8,3778.009101,209.889394,472.251138,87.132684,1,0
0,0,6,6,7,11,18,41,25,66,0.000333,0.091738,6,1651.290301,91.73835,275.21505,57.705232,1,0
0,0,5,5,11,12,23,33,21,54,0.000333,0.081424,5,1221.361728,67.853429,244.272346,81.073298,1,0
0,0,11,11,15,21,36,84,43,127,0.000333,0.21886,14,9192.126653,510.673703,656.580475,150.842025,2,0
0,0,7,7,8,12,20,29,20,49,0.000333,0.070591,4,847.097907,47.060995,211.774477,67.01955,1,0
0,0,9,9,15,19,34,68,35,103,0.000333,0.17467,7,3668.060709,203.78115,524.008673,139.313982,2,0
0,0,3,3,5,6,11,9,8,17,0.000333,0.019603,2,117.620675,6.534482,58.810338,27.119415,1,0
0,0,8,8,15,18,33,66,34,100,0.000333,0.168146,7,3531.075884,196.170882,504.439412,133.662009,2,0
0,0,8,8,15,16,31,47,31,78,0.000333,0.128809,7,2704.991185,150.277288,386.427312,122.603359,5,0
0,0,11,11,15,21,36,84,43,127,0.000333,0.21886,14,9192.126653,510.673703,656.580475,150.842025,2,0
0,0,9,9,15,19,34,68,35,103,0.000333,0.17467,7,3668.060709,203.78115,524.008673,139.313982,2,0
0,0,14,14,9,16,25,56,57,113,0.000333,0.174919,12,6297.068993,349.837166,524.755749,92.529325,1,0
0,0,5,5,12,14,26,31,21,52,0.000333,0.081474,6,1466.537192,81.474288,244.422865,96.322519,1,0
0,0,4,4,6,9,15,16,12,28,0.000333,0.036464,3,328.17881,18.232156,109.392937,44.0391,1,0
0,0,9,9,15,19,34,68,35,103,0.000333,0.17467,7,3668.060709,203.78115,524.008673,139.313982,2,0
0,0,3,3,9,8,17,16,11,27,0.000333,0.036787,4,441.445987,24.524777,110.361497,52.529325,2,0
0,0,9,9,15,19,34,68,35,103,0.000333,0.17467,7,3668.060709,203.78115,524.008673,139.313982,2,0
0,0,7,7,9,15,24,23,25,48,0.000333,0.073359,4,880.3128,48.906267,220.0782,87.132684,1,0
0,0,5,5,8,10,18,28,17,45,0.000333,0.062549,4,750.5865,41.69925,187.646625,57.219281,1,0
0,0,9,9,9,17,26,44,44,88,0.000333,0.13788,8,3309.109562,183.83942,413.638695,98.016193,1,0
0,0,5,5,8,10,18,28,17,45,0.000333,0.062549,4,750.5865,41.69925,187.646625,57.219281,1,0
0,0,6,6,9,13,22,24,20,44,0.000333,0.065405,4,784.859965,43.603331,196.214991,76.635041,1,0
0,0,4,4,5,8,13,23,14,37,0.000333,0.045639,2,273.832539,15.212919,136.91627,35.60964,1,0
0,0,8,8,15,18,33,66,34,100,0.000333,0.168146,7,3531.075884,196.170882,504.439412,133.662009,2,0
0,0,3,3,7,5,12,11,7,18,0.000333,0.02151,3,193.587975,10.754888,64.529325,31.261125,1,0
0,0,4,4,11,9,20,35,15,50,0.000333,0.072032,5,1080.482024,60.026779,216.096405,66.583073,2,0
0,0,7,7,9,14,23,21,23,44,0.000333,0.066346,4,796.146904,44.230384,199.036726,81.832294,1,0
0,0,3,3,7,5,12,11,7,18,0.000333,0.02151,3,193.587975,10.754888,64.529325,31.261125,1,0
0,0,7,7,11,18,29,48,28,76,0.000333,0.123069,5,1846.032778,102.557377,369.206556,113.112398,1,0
0,0,9,9,14,17,31,45,26,71,0.000333,0.117249,7,2462.235566,136.790865,351.747938,122.789837,3,0
0,0,7,7,11,19,30,44,28,72,0.000333,0.117765,5,1766.480614,98.137812,353.296123,118.764371,2,0
0,0,5,5,7,8,15,17,12,29,0.000333,0.037767,3,339.899482,18.883305,113.299827,43.651484,1,0
0,0,3,3,7,8,15,23,12,35,0.000333,0.04558,3,410.223513,22.790195,136.741171,43.651484,1,0
0,0,5,5,10,11,21,29,17,46,0.000333,0.067349,5,1010.233007,56.124056,202.046601,71.273029,1,0
0,0,3,3,8,7,15,15,9,24,0.000333,0.031255,4,375.061497,20.83675,93.765374,43.651484,3,0
0,0,5,5,7,14,21,22,20,42,0.000333,0.061492,3,553.431995,30.746222,184.477332,72.954453,1,0
0,0,4,4,4,7,11,13,11,24,0.000333,0.027675,2,166.052718,9.225151,83.026359,27.651484,3,0
0,0,8,8,8,15,23,30,28,58,0.000333,0.087456,4,1049.466374,58.303687,262.366593,82.603359,1,0
0,0,3,3,9,8,17,16,11,27,0.000333,0.036787,4,441.445987,24.524777,110.361497,52.529325,2,0
0,0,9,9,15,20,35,72,36,108,0.000333,0.184654,7,3877.737961,215.429887,553.962566,145.041921,2,0
0,0,4,4,11,10,21,24,14,38,0.000333,0.055636,5,834.54031,46.363351,166.908062,71.273029,3,0
0,0,4,4,6,9,15,13,12,25,0.000333,0.032557,3,293.016795,16.278711,97.672265,44.0391,1,0
0,0,3,3,7,8,15,23,12,35,0.000333,0.04558,3,410.223513,22.790195,136.741171,43.651484,1,0
0,0,8,8,15,18,33,66,34,100,0.000333,0.168146,7,3531.075884,196.170882,504.439412,133.662009,2,0
0,0,3,3,7,8,15,23,12,35,0.000333,0.04558,3,410.223513,22.790195,136.741171,43.651484,1,0
0,0,6,6,9,10,19,28,17,45,0.000333,0.063719,4,764.626952,42.479275,191.156738,61.748606,1,0
0,0,3,3,7,8,15,23,12,35,0.000333,0.04558,3,410.223513,22.790195,136.741171,43.651484,1,0
0,0,7,7,11,19,30,44,28,72,0.000333,0.117765,5,1766.480614,98.137812,353.296123,118.764371,2,0
0,0,5,5,7,7,14,16,11,27,0.000333,0.034266,3,308.395749,17.133097,102.798583,39.302969,1,0
0,0,4,4,9,13,22,22,17,39,0.000333,0.057973,4,695.671333,38.648407,173.917833,76.635041,3,0
0,0,4,4,4,7,11,13,11,24,0.000333,0.027675,2,166.052718,9.225151,83.026359,27.651484,3,0
0,0,9,9,15,19,34,68,35,103,0.000333,0.17467,7,3668.060709,203.78115,524.008673,139.313982,2,0
0,0,8,8,15,18,33,66,34,100,0.000333,0.168146,7,3531.075884,196.170882,504.439412,133.662009,2,0
0,0,11,11,15,21,36,84,43,127,0.000333,0.21886,14,9192.126653,510.673703,656.580475,150.842025,2,0
0,0,3,3,8,8,16,20,12,32,0.000333,0.042667,4,512,28.444444,128,48,1,0
0,0,21,21,14,29,43,104,68,172,0.000333,0.311106,14,13066.44553,725.913641,933.317538,194.184418,10,0
0,0,5,5,7,11,18,15,15,30,0.000333,0.041699,3,375.29325,20.849625,125.09775,57.705232,1,0
0,0,6,6,5,14,19,20,30,50,0.000333,0.070799,4,849.585503,47.199195,212.396376,64.912609,1,0
0,0,5,5,8,12,20,20,17,37,0.000333,0.053304,4,639.645358,35.535853,159.91134,67.01955,1,0
0,0,4,4,6,13,19,17,17,34,0.000333,0.048143,3,433.288606,24.071589,144.429535,63.615491,1,0
0,0,3,3,9,8,17,16,11,27,0.000333,0.036787,4,441.445987,24.524777,110.361497,52.529325,2,0
0,0,5,5,10,11,21,29,17,46,0.000333,0.067349,5,1010.233007,56.124056,202.046601,71.273029,1,0
0,0,5,5,8,11,19,30,18,48,0.000333,0.067967,4,815.602083,45.311227,203.900521,62.053748,1,0
0,0,3,3,10,8,18,16,13,29,0.000333,0.040309,5,604.639125,33.591063,120.927825,57.219281,3,0
0,0,4,4,9,8,17,21,14,35,0.000333,0.047687,4,572.244798,31.791378,143.061199,52.529325,1,0
0,0,4,4,4,7,11,13,11,24,0.000333,0.027675,2,166.052718,9.225151,83.026359,27.651484,2,0
0,0,6,6,9,14,23,23,24,47,0.000333,0.070869,4,850.429648,47.246092,212.607412,81.832294,1,0
0,0,11,11,17,17,34,61,43,104,0.000333,0.176365,16,8465.538168,470.307676,529.096135,138.973737,2,0
0,0,6,6,9,9,18,21,15,36,0.000333,0.050039,4,600.4692,33.3594,150.1173,57.05865,1,0
0,0,8,8,15,18,33,66,34,100,0.000333,0.168146,7,3531.075884,196.170882,504.439412,133.662009,2,0
0,0,11,11,15,21,36,84,43,127,0.000333,0.21886,14,9192.126653,510.673703,656.580475,150.842025,2,0
0,0,3,3,7,5,12,11,7,18,0.000333,0.02151,3,193.587975,10.754888,64.529325,31.261125,1,0
0,0,3,3,8,7,15,20,12,32,0.000333,0.041673,4,500.081996,27.782333,125.020499,43.651484,1,0
0,0,7,7,9,11,20,31,20,51,0.000333,0.073473,4,881.673331,48.981852,220.418333,66.583073,1,0
0,0,10,10,8,16,24,59,34,93,0.000333,0.142134,8,3411.212101,189.511783,426.401513,88,5,0
0,0,10,10,15,20,35,80,41,121,0.000333,0.206881,14,8689.005431,482.722524,620.643245,145.041921,2,0
0,0,9,9,15,19,34,68,35,103,0.000333,0.17467,7,3668.060709,203.78115,524.008673,139.313982,2,0
0,0,8,8,15,18,33,66,34,100,0.000333,0.168146,7,3531.075884,196.170882,504.439412,133.662009,2,0
0,0,3,3,9,8,17,16,11,27,0.000333,0.036787,4,441.445987,24.524777,110.361497,52.529325,2,0
0,0,8,8,15,18,33,66,34,100,0.000333,0.168146,7,3531.075884,196.170882,504.439412,133.662009,2,0
0,0,25,25,12,35,47,382,213,595,0.000333,1.10166,36,118979.2932,6609.960733,3304.980367,222.544456,4,0
0,0,4,4,4,7,11,13,11,24,0.000333,0.027675,2,166.052718,9.225151,83.026359,27.651484,3,0
0,0,7,7,11,19,30,44,28,72,0.000333,0.117765,5,1766.480614,98.137812,353.296123,118.764371,2,0
0,0,3,3,7,6,13,12,8,20,0.000333,0.02467,3,222.026383,12.334799,74.008794,35.161259,1,0
0,0,6,6,14,11,25,34,19,53,0.000333,0.082041,7,1722.870646,95.715036,246.124378,91.356717,4,0
0,0,5,5,8,9,17,25,15,40,0.000333,0.0545,4,653.994055,36.333003,163.498514,52.529325,1,0
0,0,8,8,15,18,33,66,34,100,0.000333,0.168146,7,3531.075884,196.170882,504.439412,133.662009,2,0
0,0,18,18,11,28,39,115,64,179,0.000333,0.315362,10,9460.869972,525.603887,946.086997,172.659686,10,0
0,0,3,3,7,8,15,23,12,35,0.000333,0.04558,3,410.223513,22.790195,136.741171,43.651484,1,0
0,0,27,27,17,39,56,145,77,222,0.000333,0.429744,8,10313.86234,572.992352,1289.232793,275.617555,10,0
0,0,3,3,7,8,15,23,12,35,0.000333,0.04558,3,410.223513,22.790195,136.741171,43.651484,1,0
0,0,5,5,8,17,25,38,29,67,0.000333,0.103713,4,1244.553459,69.141859,311.138365,93.486868,1,0
0,0,3,3,8,15,23,23,21,44,0.000333,0.066346,4,796.146904,44.230384,199.036726,82.603359,1,0
0,0,17,17,21,26,47,131,75,206,0.000333,0.381415,20,22884.90607,1271.38367,1144.245303,214.450099,9,0
0,0,3,3,8,7,15,11,9,20,0.000333,0.026046,4,312.551248,17.363958,78.137812,43.651484,1,0
0,0,3,3,8,8,16,20,12,32,0.000333,0.042667,4,512,28.444444,128,48,1,0
0,0,13,13,16,36,52,233,88,321,0.000333,0.609947,16,29277.45839,1626.525466,1829.84115,250.1173,14,0
0,0,6,6,6,8,14,36,22,58,0.000333,0.073609,6,1324.959513,73.608862,220.826585,39.509775,1,0
0,0,3,3,9,8,17,16,11,27,0.000333,0.036787,4,441.445987,24.524777,110.361497,52.529325,2,0
0,0,8,8,15,18,33,66,34,100,0.000333,0.168146,7,3531.075884,196.170882,504.439412,133.662009,2,0
0,0,3,3,7,8,15,23,12,35,0.000333,0.04558,3,410.223513,22.790195,136.741171,43.651484,1,0
0,0,4,4,6,8,14,17,12,29,0.000333,0.036804,3,331.239878,18.402215,110.413293,39.509775,3,0
0,0,25,25,12,35,47,382,213,595,0.000333,1.10166,36,118979.2932,6609.960733,3304.980367,222.544456,4,0
0,0,5,5,11,12,23,33,21,54,0.000333,0.081424,5,1221.361728,67.853429,244.272346,81.073298,1,0
0,0,6,6,9,15,24,28,25,53,0.000333,0.081001,4,972.01205,54.000669,243.003013,87.132684,1,0
0,0,8,8,15,18,33,66,34,100,0.000333,0.168146,7,3531.075884,196.170882,504.439412,133.662009,2,0
0,0,5,5,8,8,16,22,15,37,0.000333,0.049333,4,592,32.888889,148,48,1,0
0,0,3,3,7,8,15,23,12,35,0.000333,0.04558,3,410.223513,22.790195,136.741171,43.651484,1,0
0,0,8,8,15,14,29,49,32,81,0.000333,0.131165,14,5508.950448,306.052803,393.496461,111.906328,4,0
0,0,3,3,8,7,15,20,12,32,0.000333,0.041673,4,500.081996,27.782333,125.020499,43.651484,1,0
0,0,3,3,9,8,17,16,11,27,0.000333,0.036787,4,441.445987,24.524777,110.361497,52.529325,2,0
0,0,6,6,9,9,18,22,16,38,0.000333,0.052819,4,633.8286,35.2127,158.45715,57.05865,1,0
0,0,3,3,7,8,15,23,12,35,0.000333,0.04558,3,410.223513,22.790195,136.741171,43.651484,1,0
0,0,3,3,8,7,15,11,9,20,0.000333,0.026046,4,312.551248,17.363958,78.137812,43.651484,1,0
0,0,5,5,10,11,21,33,18,51,0.000333,0.074669,5,1120.040943,62.224497,224.008189,71.273029,1,0
0,0,7,7,12,9,21,43,19,62,0.000333,0.090775,12,3267.884163,181.54912,272.32368,71.548875,5,0
0,0,4,4,11,11,22,19,15,34,0.000333,0.05054,5,758.103375,42.116854,151.620675,76.107496,1,0
0,0,7,7,11,19,30,44,28,72,0.000333,0.117765,5,1766.480614,98.137812,353.296123,118.764371,2,0
0,0,3,3,6,9,15,26,11,37,0.000333,0.048185,3,433.664856,24.092492,144.554952,44.0391,1,0
0,0,3,3,8,7,15,20,12,32,0.000333,0.041673,4,500.081996,27.782333,125.020499,43.651484,1,0
0,0,6,6,8,13,21,29,22,51,0.000333,0.074669,4,896.032754,49.779597,224.008189,72.105716,1,0
0,0,3,3,8,6,14,13,9,22,0.000333,0.027921,4,335.047233,18.613735,83.761808,39.509775,1,0
0,0,5,5,12,16,28,39,25,64,0.000333,0.102557,6,1846.02429,102.556905,307.670715,107.01955,2,0
0,0,11,11,8,18,26,71,42,113,0.000333,0.17705,8,4249.197505,236.066528,531.149688,99.05865,1,0
0,0,8,8,15,18,33,66,34,100,0.000333,0.168146,7,3531.075884,196.170882,504.439412,133.662009,2,0
0,0,4,4,11,10,21,36,17,53,0.000333,0.077598,5,1163.964117,64.664673,232.792823,71.273029,1,0
0,0,11,11,15,21,36,84,43,127,0.000333,0.21886,14,9192.126653,510.673703,656.580475,150.842025,2,0
0,0,5,5,8,10,18,28,17,45,0.000333,0.062549,4,750.5865,41.69925,187.646625,57.219281,1,0
0,0,7,7,11,19,30,44,28,72,0.000333,0.117765,5,1766.480614,98.137812,353.296123,118.764371,2,0
0,0,6,6,7,11,18,41,25,66,0.000333,0.091738,6,1651.290301,91.73835,275.21505,57.705232,1,0
0,0,3,3,8,8,16,20,12,32,0.000333,0.042667,4,512,28.444444,128,48,1,0
0,0,8,8,13,12,25,39,25,64,0.000333,0.099069,12,3566.481554,198.137864,297.206796,91.125266,1,0
0,0,20,20,17,26,43,124,70,194,0.000333,0.350898,16,16843.1258,935.729211,1052.695362,191.698301,2,0
0,0,7,7,14,15,29,42,31,73,0.000333,0.118211,14,4964.856577,275.825365,354.632613,111.906328,4,0
0,0,5,5,9,10,19,35,21,56,0.000333,0.079295,8,1903.071526,105.726196,237.883941,61.748606,4,0
0,0,8,8,10,11,21,46,27,73,0.000333,0.10688,10,3206.391719,178.132873,320.639172,71.273029,6,0
0,0,24,24,13,33,46,141,84,225,0.000333,0.414267,12,14913.61728,828.534293,1242.80144,214.570722,12,0
0,0,3,3,9,8,17,16,11,27,0.000333,0.036787,4,441.445987,24.524777,110.361497,52.529325,2,0
0,0,14,14,11,13,24,62,45,107,0.000333,0.16353,15,7358.864814,408.825823,490.590988,86.159464,1,0
0,0,3,3,6,10,16,25,13,38,0.000333,0.050667,3,456,25.333333,152,48.729056,1,0
0,0,7,7,11,19,30,44,28,72,0.000333,0.117765,5,1766.480614,98.137812,353.296123,118.764371,2,0
0,0,5,5,12,16,28,39,25,64,0.000333,0.102557,6,1846.02429,102.556905,307.670715,107.01955,2,0
0,0,4,4,11,10,21,24,14,38,0.000333,0.055636,5,834.54031,46.363351,166.908062,71.273029,3,0
0,0,3,3,7,5,12,11,7,18,0.000333,0.02151,3,193.587975,10.754888,64.529325,31.261125,1,0
0,0,10,10,7,14,21,57,36,93,0.000333,0.136162,6,2450.913122,136.16184,408.48552,72.954453,1,0
0,0,4,4,5,12,17,16,16,32,0.000333,0.0436,2,261.597622,14.533201,130.798811,54.62919,1,0
0,0,5,5,8,10,18,26,15,41,0.000333,0.056989,4,683.8677,37.99265,170.966925,57.219281,1,0
0,0,11,11,15,21,36,84,43,127,0.000333,0.21886,14,9192.126653,510.673703,656.580475,150.842025,2,0
0,0,4,4,6,8,14,28,15,43,0.000333,0.054572,3,491.148785,27.286044,163.716262,39.509775,1,0
0,0,8,8,15,18,33,66,34,100,0.000333,0.168146,7,3531.075884,196.170882,504.439412,133.662009,2,0
0,0,9,9,15,19,34,68,35,103,0.000333,0.17467,7,3668.060709,203.78115,524.008673,139.313982,2,0
0,0,4,4,5,7,12,14,10,24,0.000333,0.02868,2,172.0782,9.5599,86.0391,31.261125,2,0
0,0,9,9,14,16,30,47,32,79,0.000333,0.129215,14,5427.020999,301.501167,387.644357,117.302969,2,0
0,0,13,13,14,22,36,57,50,107,0.000333,0.184394,14,7744.547652,430.252647,553.181975,151.410465,2,0
0,0,3,3,8,8,16,20,12,32,0.000333,0.042667,4,512,28.444444,128,48,1,0
0,0,9,9,15,19,34,68,35,103,0.000333,0.17467,7,3668.060709,203.78115,524.008673,139.313982,2,0
0,0,11,11,15,21,36,84,43,127,0.000333,0.21886,14,9192.126653,510.673703,656.580475,150.842025,2,0
0,0,6,6,14,12,26,43,26,69,0.000333,0.10811,14,4540.624768,252.256932,324.330341,96.322519,4,0
0,0,9,9,10,18,28,31,41,72,0.000333,0.115377,10,3461.295544,192.294197,346.129554,108.277931,1,0
0,0,3,3,7,5,12,11,7,18,0.000333,0.02151,3,193.587975,10.754888,64.529325,31.261125,1,0
0,0,5,5,8,12,20,25,19,44,0.000333,0.063388,4,760.659345,42.258852,190.164836,67.01955,1,0
0,0,7,7,14,15,29,42,31,73,0.000333,0.118211,14,4964.856577,275.825365,354.632613,111.906328,4,0
0,0,8,8,11,15,26,41,22,63,0.000333,0.098709,5,1480.638511,82.257695,296.127702,96.657107,5,0
0,0,7,7,11,19,30,44,28,72,0.000333,0.117765,5,1766.480614,98.137812,353.296123,118.764371,2,0
0,0,6,6,9,18,27,38,31,69,0.000333,0.109362,4,1312.348951,72.908275,328.087238,103.587975,1,0
0,0,11,11,15,21,36,84,43,127,0.000333,0.21886,14,9192.126653,510.673703,656.580475,150.842025,2,0
0,0,9,9,15,19,34,68,35,103,0.000333,0.17467,7,3668.060709,203.78115,524.008673,139.313982,2,0
0,0,3,3,8,7,15,20,12,32,0.000333,0.041673,4,500.081996,27.782333,125.020499,43.651484,1,0
0,0,4,4,6,8,14,17,12,29,0.000333,0.036804,3,331.239878,18.402215,110.413293,39.509775,3,0
0,0,4,4,6,8,14,17,12,29,0.000333,0.036804,3,331.239878,18.402215,110.413293,39.509775,3,0
0,0,5,5,8,10,18,28,17,45,0.000333,0.062549,4,750.5865,41.69925,187.646625,57.219281,1,0
0,0,4,4,4,7,11,13,11,24,0.000333,0.027675,2,166.052718,9.225151,83.026359,27.651484,3,0
0,0,5,5,10,11,21,33,18,51,0.000333,0.074669,5,1120.040943,62.224497,224.008189,71.273029,1,0
0,0,4,4,6,10,16,26,15,41,0.000333,0.054667,3,492,27.333333,164,48.729056,1,0
0,0,4,4,5,7,12,14,10,24,0.000333,0.02868,2,172.0782,9.5599,86.0391,31.261125,2,0
0,0,5,5,12,9,21,24,14,38,0.000333,0.055636,6,1001.448372,55.636021,166.908062,71.548875,2,0
0,0,4,4,10,8,18,25,15,40,0.000333,0.055599,5,833.985,46.3325,166.797,57.219281,1,0
0,0,6,6,14,12,26,43,26,69,0.000333,0.10811,14,4540.624768,252.256932,324.330341,96.322519,4,0
0,0,4,4,7,11,18,16,14,30,0.000333,0.041699,3,375.29325,20.849625,125.09775,57.705232,1,0
0,0,5,5,8,10,18,28,17,45,0.000333,0.062549,4,750.5865,41.69925,187.646625,57.219281,1,0
0,0,3,3,8,7,15,20,12,32,0.000333,0.041673,4,500.081996,27.782333,125.020499,43.651484,1,0
0,0,4,4,7,7,14,15,10,25,0.000333,0.031728,3,285.551619,15.863979,95.183873,39.302969,1,0
0,0,3,3,8,7,15,11,9,20,0.000333,0.026046,4,312.551248,17.363958,78.137812,43.651484,1,0
0,0,7,7,8,14,22,30,32,62,0.000333,0.092162,8,2211.878083,122.882116,276.48476,77.302969,1,0
0,0,7,7,16,14,30,45,29,74,0.000333,0.121037,16,5809.758465,322.764359,363.109904,117.302969,4,0
0,0,3,3,8,8,16,20,12,32,0.000333,0.042667,4,512,28.444444,128,48,1,0
0,0,4,4,4,7,11,13,11,24,0.000333,0.027675,2,166.052718,9.225151,83.026359,27.651484,3,0
0,0,4,4,11,10,21,24,14,38,0.000333,0.055636,5,834.54031,46.363351,166.908062,71.273029,3,0
0,0,7,7,8,14,22,30,32,62,0.000333,0.092162,8,2211.878083,122.882116,276.48476,77.302969,1,0
0,0,4,4,6,8,14,17,12,29,0.000333,0.036804,3,331.239878,18.402215,110.413293,39.509775,3,0
0,0,4,4,4,7,11,13,11,24,0.000333,0.027675,2,166.052718,9.225151,83.026359,27.651484,3,0
0,0,4,4,9,7,16,33,17,50,0.000333,0.066667,8,1600,88.888889,200,48.180809,1,0
0,0,10,10,14,18,32,51,39,90,0.000333,0.15,14,6300,350,450,128.361619,2,0
0,0,5,5,10,11,21,29,17,46,0.000333,0.067349,5,1010.233007,56.124056,202.046601,71.273029,1,0
0,0,4,4,9,8,17,31,17,48,0.000333,0.065399,8,1569.585731,87.199207,196.198216,52.529325,1,0
0,0,4,4,7,7,14,39,20,59,0.000333,0.074878,6,1347.803642,74.87798,224.63394,39.302969,1,0
0,0,5,5,7,8,15,51,26,77,0.000333,0.100277,9,2707.475183,150.415288,300.830576,43.651484,1,0
0,0,6,6,7,9,16,63,32,95,0.000333,0.126667,9,3420,190,380,48.180809,1,0
0,0,9,9,11,15,26,71,40,111,0.000333,0.173916,10,5217.488087,289.860449,521.748809,96.657107,1,0
0,0,4,4,9,6,15,15,12,27,0.000333,0.035162,8,843.888369,46.882687,105.486046,44.0391,1,0
0,0,7,7,11,19,30,44,28,72,0.000333,0.117765,5,1766.480614,98.137812,353.296123,118.764371,2,0
0,0,7,7,11,19,30,44,28,72,0.000333,0.117765,5,1766.480614,98.137812,353.296123,118.764371,2,0
0,0,3,3,9,8,17,16,11,27,0.000333,0.036787,4,441.445987,24.524777,110.361497,52.529325,2,0
0,0,12,12,12,18,30,61,51,112,0.000333,0.183191,12,6594.86096,366.381164,549.571747,118.0782,1,0
0,0,3,3,8,8,16,20,12,32,0.000333,0.042667,4,512,28.444444,128,48,1,0
0,0,4,4,6,8,14,17,12,29,0.000333,0.036804,3,331.239878,18.402215,110.413293,39.509775,3,0
0,0,4,4,9,7,16,17,12,29,0.000333,0.038667,4,464,25.777778,116,48.180809,1,0
0,0,6,6,11,16,27,39,29,68,0.000333,0.107777,5,1616.661751,89.814542,323.33235,102.053748,1,0
0,0,3,3,8,7,15,11,9,20,0.000333,0.026046,4,312.551248,17.363958,78.137812,43.651484,1,0
0,0,3,3,8,8,16,20,12,32,0.000333,0.042667,4,512,28.444444,128,48,1,0
0,0,8,8,11,15,26,33,27,60,0.000333,0.094009,5,1410.131915,78.340662,282.026383,96.657107,1,0
0,0,3,3,8,7,15,20,12,32,0.000333,0.041673,4,500.081996,27.782333,125.020499,43.651484,1,0
0,0,3,3,7,8,15,23,12,35,0.000333,0.04558,3,410.223513,22.790195,136.741171,43.651484,1,0
0,0,3,3,8,7,15,20,12,32,0.000333,0.041673,4,500.081996,27.782333,125.020499,43.651484,1,0
0,0,9,9,15,19,34,68,35,103,0.000333,0.17467,7,3668.060709,203.78115,524.008673,139.313982,2,0
0,0,3,3,6,7,13,13,9,22,0.000333,0.027137,3,244.229021,13.568279,81.409674,35.161259,3,0
0,0,16,16,11,26,37,113,60,173,0.000333,0.300412,10,9012.354323,500.686351,901.235432,160.26518,6,0
0,0,3,3,8,7,15,11,9,20,0.000333,0.026046,4,312.551248,17.363958,78.137812,43.651484,1,0
0,0,11,11,12,17,29,55,44,99,0.000333,0.160313,12,5771.281422,320.626746,480.940119,112.506418,1,0
0,0,9,9,15,19,34,68,35,103,0.000333,0.17467,7,3668.060709,203.78115,524.008673,139.313982,2,0
0,0,3,3,7,8,15,23,12,35,0.000333,0.04558,3,410.223513,22.790195,136.741171,43.651484,1,0
0,0,3,3,8,7,15,15,9,24,0.000333,0.031255,4,375.061497,20.83675,93.765374,43.651484,3,0
0,0,3,3,7,8,15,23,12,35,0.000333,0.04558,3,410.223513,22.790195,136.741171,43.651484,1,0
0,0,4,4,9,10,19,29,18,47,0.000333,0.066551,4,798.610373,44.367243,199.652593,61.748606,1,0
0,0,6,6,9,12,21,44,26,70,0.000333,0.102487,8,2459.697757,136.649875,307.46222,71.548875,1,0
0,0,5,5,7,8,15,17,12,29,0.000333,0.037767,3,339.899482,18.883305,113.299827,43.651484,1,0
0,0,7,7,11,14,25,48,25,73,0.000333,0.113001,5,1695.007509,94.167084,339.001502,91.356717,1,0
0,0,3,3,9,8,17,16,11,27,0.000333,0.036787,4,441.445987,24.524777,110.361497,52.529325,2,0
0,0,3,3,9,8,17,16,11,27,0.000333,0.036787,4,441.445987,24.524777,110.361497,52.529325,2,0
0,0,9,9,15,19,34,68,35,103,0.000333,0.17467,7,3668.060709,203.78115,524.008673,139.313982,2,0
0,0,5,5,8,8,16,19,12,31,0.000333,0.041333,4,496,27.555556,124,48,1,0
0,0,3,3,8,6,14,11,9,20,0.000333,0.025382,4,304.588394,16.921577,76.147098,39.509775,1,0
0,0,7,7,11,19,30,44,28,72,0.000333,0.117765,5,1766.480614,98.137812,353.296123,118.764371,2,0
0,0,5,5,11,12,23,33,21,54,0.000333,0.081424,5,1221.361728,67.853429,244.272346,81.073298,1,0
0,0,25,25,12,35,47,382,213,595,0.000333,1.10166,36,118979.2932,6609.960733,3304.980367,222.544456,4,0
0,0,5,5,7,13,20,23,19,42,0.000333,0.060507,3,544.56294,30.253497,181.52098,67.757201,1,0
0,0,8,8,11,15,26,59,34,93,0.000333,0.145714,10,4371.408938,242.856052,437.140894,96.657107,1,0
0,0,3,3,7,5,12,11,7,18,0.000333,0.02151,3,193.587975,10.754888,64.529325,31.261125,1,0
0,0,3,3,7,8,15,23,12,35,0.000333,0.04558,3,410.223513,22.790195,136.741171,43.651484,1,0
0,0,6,6,9,10,19,28,17,45,0.000333,0.063719,4,764.626952,42.479275,191.156738,61.748606,1,0
0,0,3,3,8,6,14,11,9,20,0.000333,0.025382,4,304.588394,16.921577,76.147098,39.509775,1,0
0,0,5,5,8,10,18,28,17,45,0.000333,0.062549,4,750.5865,41.69925,187.646625,57.219281,1,0
0,0,5,5,7,7,14,16,11,27,0.000333,0.034266,3,308.395749,17.133097,102.798583,39.302969,1,0
0,0,11,11,15,21,36,84,43,127,0.000333,0.21886,14,9192.126653,510.673703,656.580475,150.842025,2,0
0,0,3,3,9,8,17,16,11,27,0.000333,0.036787,4,441.445987,24.524777,110.361497,52.529325,2,0
0,0,9,9,15,19,34,68,35,103,0.000333,0.17467,7,3668.060709,203.78115,524.008673,139.313982,2,0
0,0,6,6,14,12,26,41,24,65,0.000333,0.101843,14,4277.400144,237.633341,305.528582,96.322519,5,0
0,0,3,3,8,8,16,20,12,32,0.000333,0.042667,4,512,28.444444,128,48,1,0
0,0,4,4,4,7,11,13,11,24,0.000333,0.027675,2,166.052718,9.225151,83.026359,27.651484,3,0
0,0,22,22,12,30,42,124,71,195,0.000333,0.350501,12,12618.02277,701.001265,1051.501897,190.226268,1,0
0,0,5,5,9,12,21,26,19,45,0.000333,0.065885,4,790.617136,43.923174,197.654284,71.548875,1,0
0,0,7,7,9,14,23,21,23,44,0.000333,0.066346,4,796.146904,44.230384,199.036726,81.832294,1,0
0,0,9,9,15,19,34,68,35,103,0.000333,0.17467,7,3668.060709,203.78115,524.008673,139.313982,2,0
0,0,11,11,15,21,36,84,43,127,0.000333,0.21886,14,9192.126653,510.673703,656.580475,150.842025,2,0
0,0,5,5,8,12,20,25,19,44,0.000333,0.063388,4,760.659345,42.258852,190.164836,67.01955,1,0
0,0,5,5,8,11,19,30,18,48,0.000333,0.067967,4,815.602083,45.311227,203.900521,62.053748,1,0
0,0,3,3,8,7,15,15,9,24,0.000333,0.031255,4,375.061497,20.83675,93.765374,43.651484,3,0
0,0,5,5,10,11,21,29,17,46,0.000333,0.067349,5,1010.233007,56.124056,202.046601,71.273029,1,0
0,0,4,4,6,8,14,17,12,29,0.000333,0.036804,3,331.239878,18.402215,110.413293,39.509775,3,0
0,0,7,7,14,12,26,47,27,74,0.000333,0.115944,14,4869.655548,270.536419,347.832539,96.322519,6,0
0,0,3,3,8,7,15,11,9,20,0.000333,0.026046,4,312.551248,17.363958,78.137812,43.651484,1,0
0,0,7,7,11,19,30,44,28,72,0.000333,0.117765,5,1766.480614,98.137812,353.296123,118.764371,2,0
0,0,3,3,10,8,18,16,13,29,0.000333,0.040309,5,604.639125,33.591063,120.927825,57.219281,3,0
0,0,5,5,10,10,20,26,15,41,0.000333,0.059066,5,885.995259,49.221959,177.199052,66.438562,1,0
0,0,11,11,15,21,36,84,43,127,0.000333,0.21886,14,9192.126653,510.673703,656.580475,150.842025,2,0
0,0,8,8,15,18,33,66,34,100,0.000333,0.168146,7,3531.075884,196.170882,504.439412,133.662009,2,0
0,0,3,3,8,7,15,20,12,32,0.000333,0.041673,4,500.081996,27.782333,125.020499,43.651484,1,0
0,0,8,8,15,18,33,66,34,100,0.000333,0.168146,7,3531.075884,196.170882,504.439412,133.662009,2,0
0,0,4,4,7,8,15,19,14,33,0.000333,0.042976,3,386.782169,21.487898,128.92739,43.651484,3,0
0,0,5,5,7,7,14,16,11,27,0.000333,0.034266,3,308.395749,17.133097,102.798583,39.302969,1,0
0,0,9,9,15,19,34,68,35,103,0.000333,0.17467,7,3668.060709,203.78115,524.008673,139.313982,2,0
0,0,4,4,10,15,25,32,21,53,0.000333,0.082041,5,1230.62189,68.367883,246.124378,91.82264,1,0
0,0,5,5,10,13,23,23,19,42,0.000333,0.06333,5,949.948011,52.774889,189.989602,81.324997,1,0
0,0,9,9,15,19,34,68,35,103,0.000333,0.17467,7,3668.060709,203.78115,524.008673,139.313982,2,0
0,0,11,11,15,21,36,84,43,127,0.000333,0.21886,14,9192.126653,510.673703,656.580475,150.842025,2,0
0,0,3,3,8,8,16,20,12,32,0.000333,0.042667,4,512,28.444444,128,48,1,0
0,0,3,3,7,5,12,11,7,18,0.000333,0.02151,3,193.587975,10.754888,64.529325,31.261125,1,0
0,0,12,12,12,18,30,60,49,109,0.000333,0.178284,12,6418.212899,356.567383,534.851075,118.0782,1,0
0,0,4,4,6,11,17,16,15,31,0.000333,0.042237,3,380.134044,21.118558,126.711348,53.563523,1,0
0,0,4,4,10,15,25,32,21,53,0.000333,0.082041,5,1230.62189,68.367883,246.124378,91.82264,1,0
0,0,8,8,15,18,33,66,34,100,0.000333,0.168146,7,3531.075884,196.170882,504.439412,133.662009,2,0
0,0,25,25,12,35,47,382,213,595,0.000333,1.10166,36,118979.2932,6609.960733,3304.980367,222.544456,4,0
0,0,5,5,11,12,23,33,21,54,0.000333,0.081424,5,1221.361728,67.853429,244.272346,81.073298,1,0
0,0,5,5,9,11,20,29,23,52,0.000333,0.074913,8,1797.922087,99.88456,224.740261,66.583073,1,0
0,0,4,4,4,7,11,13,11,24,0.000333,0.027675,2,166.052718,9.225151,83.026359,27.651484,3,0
0,0,5,5,8,8,16,25,13,38,0.000333,0.050667,4,608,33.777778,152,48,3,0
0,0,25,25,12,35,47,382,213,595,0.000333,1.10166,36,118979.2932,6609.960733,3304.980367,222.544456,4,0
0,0,5,5,11,12,23,33,21,54,0.000333,0.081424,5,1221.361728,67.853429,244.272346,81.073298,1,0
0,0,6,6,7,14,21,32,23,55,0.000333,0.080526,3,724.732375,40.26291,241.577458,72.954453,1,0
0,0,8,8,10,15,25,33,27,60,0.000333,0.092877,5,1393.156857,77.397603,278.631371,91.82264,1,0
0,0,9,9,15,19,34,68,35,103,0.000333,0.17467,7,3668.060709,203.78115,524.008673,139.313982,2,0
0,0,3,3,8,7,15,15,9,24,0.000333,0.031255,4,375.061497,20.83675,93.765374,43.651484,3,0
0,0,7,7,14,15,29,42,31,73,0.000333,0.118211,14,4964.856577,275.825365,354.632613,111.906328,4,0
0,0,9,9,15,19,34,68,35,103,0.000333,0.17467,7,3668.060709,203.78115,524.008673,139.313982,2,0
0,0,7,7,11,19,30,44,28,72,0.000333,0.117765,5,1766.480614,98.137812,353.296123,118.764371,2,0
0,0,4,4,4,7,11,13,11,24,0.000333,0.027675,2,166.052718,9.225151,83.026359,27.651484,3,0
0,0,5,5,8,10,18,28,17,45,0.000333,0.062549,4,750.5865,41.69925,187.646625,57.219281,1,0
0,0,3,3,7,8,15,23,12,35,0.000333,0.04558,3,410.223513,22.790195,136.741171,43.651484,1,0
0,0,3,3,8,8,16,20,12,32,0.000333,0.042667,4,512,28.444444,128,48,1,0
0,0,5,5,8,8,16,19,12,31,0.000333,0.041333,4,496,27.555556,124,48,1,0
0,0,11,11,13,16,29,48,37,85,0.000333,0.137643,12,4955.140615,275.28559,412.928385,112.105716,1,0
0,0,7,7,11,19,30,44,28,72,0.000333,0.117765,5,1766.480614,98.137812,353.296123,118.764371,2,0
0,0,5,5,7,7,14,16,11,27,0.000333,0.034266,3,308.395749,17.133097,102.798583,39.302969,1,0
0,0,4,4,10,8,18,25,15,40,0.000333,0.055599,5,833.985,46.3325,166.797,57.219281,1,0
0,0,5,5,8,10,18,28,17,45,0.000333,0.062549,4,750.5865,41.69925,187.646625,57.219281,1,0
0,0,5,5,9,11,20,29,23,52,0.000333,0.074913,8,1797.922087,99.88456,224.740261,66.583073,1,0
0,0,5,5,8,10,18,28,17,45,0.000333,0.062549,4,750.5865,41.69925,187.646625,57.219281,1,0
0,0,4,4,8,7,15,17,12,29,0.000333,0.037767,4,453.199309,25.177739,113.299827,43.651484,1,0
0,0,5,5,7,8,15,20,14,34,0.000333,0.044278,3,398.502841,22.139047,132.83428,43.651484,1,0
0,0,4,4,4,7,11,13,11,24,0.000333,0.027675,2,166.052718,9.225151,83.026359,27.651484,3,0
0,0,8,8,15,18,33,66,34,100,0.000333,0.168146,7,3531.075884,196.170882,504.439412,133.662009,2,0
0,0,11,11,15,21,36,84,43,127,0.000333,0.21886,14,9192.126653,510.673703,656.580475,150.842025,2,0
0,0,9,9,15,19,34,68,35,103,0.000333,0.17467,7,3668.060709,203.78115,524.008673,139.313982,2,0
0,0,6,6,14,12,26,41,24,65,0.000333,0.101843,14,4277.400144,237.633341,305.528582,96.322519,5,0
0,0,6,6,6,12,18,27,20,47,0.000333,0.065329,3,587.959425,32.664413,195.986475,58.529325,1,0
0,0,7,7,11,19,30,44,28,72,0.000333,0.117765,5,1766.480614,98.137812,353.296123,118.764371,2,0
0,0,3,3,7,5,12,11,7,18,0.000333,0.02151,3,193.587975,10.754888,64.529325,31.261125,1,0
0,0,4,4,5,7,12,14,10,24,0.000333,0.02868,2,172.0782,9.5599,86.0391,31.261125,2,0
0,0,10,10,14,18,32,51,39,90,0.000333,0.15,14,6300,350,450,128.361619,2,0
0,0,8,8,15,18,33,66,34,100,0.000333,0.168146,7,3531.075884,196.170882,504.439412,133.662009,2,0
0,0,3,3,7,8,15,23,12,35,0.000333,0.04558,3,410.223513,22.790195,136.741171,43.651484,1,0
0,0,3,3,8,8,16,20,12,32,0.000333,0.042667,4,512,28.444444,128,48,1,0
0,0,3,3,11,11,22,26,15,41,0.000333,0.060946,5,914.183482,50.787971,182.836696,76.107496,3,0
0,0,4,4,8,7,15,17,12,29,0.000333,0.037767,4,453.199309,25.177739,113.299827,43.651484,1,0
0,0,7,7,11,19,30,44,28,72,0.000333,0.117765,5,1766.480614,98.137812,353.296123,118.764371,2,0
0,0,5,5,8,10,18,28,17,45,0.000333,0.062549,4,750.5865,41.69925,187.646625,57.219281,1,0
0,0,5,5,7,8,15,17,12,29,0.000333,0.037767,3,339.899482,18.883305,113.299827,43.651484,1,0
0,0,5,5,9,11,20,25,19,44,0.000333,0.063388,4,760.659345,42.258852,190.164836,66.583073,1,0
0,0,8,8,15,18,33,66,34,100,0.000333,0.168146,7,3531.075884,196.170882,504.439412,133.662009,2,0
0,0,9,9,15,19,34,68,35,103,0.000333,0.17467,7,3668.060709,203.78115,524.008673,139.313982,2,0
0,0,11,11,15,21,36,84,43,127,0.000333,0.21886,14,9192.126653,510.673703,656.580475,150.842025,2,0
0,0,11,11,15,21,36,84,43,127,0.000333,0.21886,14,9192.126653,510.673703,656.580475,150.842025,2,0
0,0,4,4,11,9,20,18,15,33,0.000333,0.047541,5,713.118136,39.617674,142.623627,66.583073,1,0
0,0,4,4,6,9,15,16,12,28,0.000333,0.036464,3,328.17881,18.232156,109.392937,44.0391,1,0
0,0,9,9,11,17,28,43,43,86,0.000333,0.137811,10,4134.325233,229.684735,413.432523,107.540616,1,0
0,0,11,11,13,16,29,48,37,85,0.000333,0.137643,12,4955.140615,275.28559,412.928385,112.105716,1,0
0,0,3,3,7,8,15,23,12,35,0.000333,0.04558,3,410.223513,22.790195,136.741171,43.651484,1,0
0,0,4,4,8,10,18,26,18,44,0.000333,0.061159,4,733.9068,40.7726,183.4767,57.219281,1,0
0,0,6,6,8,12,20,37,25,62,0.000333,0.08932,8,2143.676335,119.09313,267.959542,67.01955,1,0
0,0,6,6,7,13,20,35,24,59,0.000333,0.084998,3,764.981273,42.49896,254.993758,67.757201,1,0
0,0,4,4,7,11,18,24,17,41,0.000333,0.056989,3,512.900775,28.494488,170.966925,57.705232,1,0
0,0,5,5,9,13,22,26,21,47,0.000333,0.069864,4,838.373144,46.576286,209.593286,76.635041,3,0
0,0,4,4,4,7,11,13,11,24,0.000333,0.027675,2,166.052718,9.225151,83.026359,27.651484,3,0
0,0,5,5,9,11,20,29,23,52,0.000333,0.074913,8,1797.922087,99.88456,224.740261,66.583073,1,0
0,0,7,7,11,19,30,44,28,72,0.000333,0.117765,5,1766.480614,98.137812,353.296123,118.764371,2,0
0,0,8,8,15,18,33,66,34,100,0.000333,0.168146,7,3531.075884,196.170882,504.439412,133.662009,2,0
0,0,5,5,8,10,18,26,15,41,0.000333,0.056989,4,683.8677,37.99265,170.966925,57.219281,1,0
0,0,7,7,11,19,30,44,28,72,0.000333,0.117765,5,1766.480614,98.137812,353.296123,118.764371,2,0
0,0,9,9,15,19,34,68,35,103,0.000333,0.17467,7,3668.060709,203.78115,524.008673,139.313982,2,0
0,0,9,9,15,20,35,72,36,108,0.000333,0.184654,7,3877.737961,215.429887,553.962566,145.041921,2,0
0,0,21,21,14,30,44,142,82,224,0.000333,0.407638,14,17120.77756,951.154309,1222.912683,200.509687,2,0
0,0,3,3,7,8,15,23,12,35,0.000333,0.04558,3,410.223513,22.790195,136.741171,43.651484,1,0
0,0,4,4,6,14,20,17,18,35,0.000333,0.050422,3,453.80245,25.211247,151.267483,68.812744,1,0
0,0,3,3,7,8,15,23,12,35,0.000333,0.04558,3,410.223513,22.790195,136.741171,43.651484,1,0
0,0,3,3,8,7,15,11,9,20,0.000333,0.026046,4,312.551248,17.363958,78.137812,43.651484,1,0
0,0,3,3,7,5,12,11,7,18,0.000333,0.02151,3,193.587975,10.754888,64.529325,31.261125,1,0
0,0,6,6,10,13,23,31,22,53,0.000333,0.079916,5,1198.743918,66.596884,239.748784,81.324997,1,0
0,0,8,8,13,14,27,39,29,68,0.000333,0.107777,12,3879.988202,215.5549,323.33235,101.408685,1,0
0,0,3,3,7,8,15,23,12,35,0.000333,0.04558,3,410.223513,22.790195,136.741171,43.651484,1,0
0,0,9,9,8,14,22,38,32,70,0.000333,0.104053,8,2497.281706,138.737873,312.160213,77.302969,1,0
0,0,5,5,8,11,19,30,18,48,0.000333,0.067967,4,815.602083,45.311227,203.900521,62.053748,1,0
0,0,6,6,9,10,19,28,17,45,0.000333,0.063719,4,764.626952,42.479275,191.156738,61.748606,1,0
0,0,4,4,5,7,12,14,10,24,0.000333,0.02868,2,172.0782,9.5599,86.0391,31.261125,2,0
0,0,10,10,14,18,32,51,39,90,0.000333,0.15,14,6300,350,450,128.361619,2,0
0,0,4,4,4,7,11,13,11,24,0.000333,0.027675,2,166.052718,9.225151,83.026359,27.651484,3,0
0,0,3,3,9,8,17,16,11,27,0.000333,0.036787,4,441.445987,24.524777,110.361497,52.529325,2,0
0,0,3,3,8,7,15,15,9,24,0.000333,0.031255,4,375.061497,20.83675,93.765374,43.651484,3,0
0,0,11,11,15,21,36,84,43,127,0.000333,0.21886,14,9192.126653,510.673703,656.580475,150.842025,2,0
0,0,7,7,9,13,22,26,24,50,0.000333,0.074324,4,891.886324,49.54924,222.971581,76.635041,1,0
0,0,3,3,7,8,15,23,12,35,0.000333,0.04558,3,410.223513,22.790195,136.741171,43.651484,1,0
0,0,3,3,7,8,15,23,12,35,0.000333,0.04558,3,410.223513,22.790195,136.741171,43.651484,1,0
0,0,5,5,9,13,22,39,25,64,0.000333,0.095135,4,1141.614494,63.423027,285.403624,76.635041,1,0
0,0,4,4,4,7,11,13,11,24,0.000333,0.027675,2,166.052718,9.225151,83.026359,27.651484,3,0
0,0,6,6,9,10,19,28,17,45,0.000333,0.063719,4,764.626952,42.479275,191.156738,61.748606,1,0
0,0,11,11,11,16,27,52,38,90,0.000333,0.142647,10,4279.398752,237.744375,427.939875,102.053748,1,0
0,0,5,5,6,8,14,25,17,42,0.000333,0.053303,6,959.45344,53.302969,159.908907,39.509775,1,0
0,0,5,5,7,8,15,17,12,29,0.000333,0.037767,3,339.899482,18.883305,113.299827,43.651484,1,0
0,0,3,3,9,8,17,16,11,27,0.000333,0.036787,4,441.445987,24.524777,110.361497,52.529325,2,0
0,0,4,4,4,7,11,13,11,24,0.000333,0.027675,2,166.052718,9.225151,83.026359,27.651484,3,0
0,0,13,13,14,23,37,64,53,117,0.000333,0.203169,14,8533.084613,474.060256,609.506044,157.344894,2,0
0,0,25,25,12,35,47,382,213,595,0.000333,1.10166,36,118979.2932,6609.960733,3304.980367,222.544456,4,0
0,0,5,5,10,11,21,29,17,46,0.000333,0.067349,5,1010.233007,56.124056,202.046601,71.273029,1,0
0,0,7,7,11,19,30,44,28,72,0.000333,0.117765,5,1766.480614,98.137812,353.296123,118.764371,2,0
0,0,4,4,6,8,14,17,12,29,0.000333,0.036804,3,331.239878,18.402215,110.413293,39.509775,3,0
0,0,3,3,9,8,17,16,10,26,0.000333,0.035425,4,425.096135,23.616452,106.274034,52.529325,3,0
0,0,4,4,4,7,11,13,11,24,0.000333,0.027675,2,166.052718,9.225151,83.026359,27.651484,3,0
0,0,3,3,9,8,17,16,10,26,0.000333,0.035425,4,425.096135,23.616452,106.274034,52.529325,3,0
0,0,6,6,8,8,16,20,14,34,0.000333,0.045333,4,544,30.222222,136,48,1,0
0,0,6,6,9,11,20,21,17,38,0.000333,0.054744,4,656.93307,36.496282,164.233268,66.583073,1,0
0,0,7,7,11,19,30,44,28,72,0.000333,0.117765,5,1766.480614,98.137812,353.296123,118.764371,2,0
0,0,3,3,8,6,14,11,9,20,0.000333,0.025382,4,304.588394,16.921577,76.147098,39.509775,1,0
0,0,5,5,8,11,19,30,18,48,0.000333,0.067967,4,815.602083,45.311227,203.900521,62.053748,1,0
0,0,4,4,10,15,25,32,21,53,0.000333,0.082041,5,1230.62189,68.367883,246.124378,91.82264,1,0
0,0,10,10,15,20,35,58,43,101,0.000333,0.172686,14,7252.806186,402.933677,518.057585,145.041921,5,0
0,0,7,7,11,19,30,44,28,72,0.000333,0.117765,5,1766.480614,98.137812,353.296123,118.764371,2,0
0,0,4,4,11,10,21,17,15,32,0.000333,0.046851,5,702.770788,39.042822,140.554158,71.273029,1,0
0,0,5,5,8,8,16,19,12,31,0.000333,0.041333,4,496,27.555556,124,48,1,0
0,0,3,3,9,8,17,16,11,27,0.000333,0.036787,4,441.445987,24.524777,110.361497,52.529325,2,0
0,0,3,3,8,8,16,20,12,32,0.000333,0.042667,4,512,28.444444,128,48,1,0
0,0,8,8,15,18,33,66,34,100,0.000333,0.168146,7,3531.075884,196.170882,504.439412,133.662009,2,0
0,0,7,7,11,19,30,44,28,72,0.000333,0.117765,5,1766.480614,98.137812,353.296123,118.764371,2,0
0,0,11,11,15,21,36,84,43,127,0.000333,0.21886,14,9192.126653,510.673703,656.580475,150.842025,2,0
0,0,4,4,4,7,11,13,11,24,0.000333,0.027675,2,166.052718,9.225151,83.026359,27.651484,3,0
0,0,3,3,9,8,17,16,11,27,0.000333,0.036787,4,441.445987,24.524777,110.361497,52.529325,2,0
0,0,4,4,4,7,11,13,11,24,0.000333,0.027675,2,166.052718,9.225151,83.026359,27.651484,3,0
0,0,4,4,10,15,25,32,21,53,0.000333,0.082041,5,1230.62189,68.367883,246.124378,91.82264,1,0
0,0,4,4,7,11,18,24,17,41,0.000333,0.056989,3,512.900775,28.494488,170.966925,57.705232,1,0
0,0,11,11,15,21,36,84,43,127,0.000333,0.21886,14,9192.126653,510.673703,656.580475,150.842025,2,0
0,0,8,8,15,18,33,66,34,100,0.000333,0.168146,7,3531.075884,196.170882,504.439412,133.662009,2,0
0,0,3,3,9,7,16,19,11,30,0.000333,0.04,4,480,26.666667,120,48.180809,1,0
0,0,5,5,8,8,16,19,12,31,0.000333,0.041333,4,496,27.555556,124,48,1,0
0,0,11,11,12,18,30,69,40,109,0.000333,0.178284,12,6418.212899,356.567383,534.851075,118.0782,2,0
0,0,8,8,16,17,33,49,35,84,0.000333,0.141243,16,6779.665696,376.648094,423.729106,133.486868,4,0
0,0,6,6,14,11,25,40,23,63,0.000333,0.097521,14,4095.881159,227.548953,292.56294,91.356717,4,0
0,0,7,7,11,19,30,44,28,72,0.000333,0.117765,5,1766.480614,98.137812,353.296123,118.764371,2,0
0,0,4,4,9,8,17,15,12,27,0.000333,0.036787,4,441.445987,24.524777,110.361497,52.529325,1,0
0,0,8,8,12,17,29,46,33,79,0.000333,0.127927,6,2302.682992,127.926833,383.780499,112.506418,1,0
0,0,7,7,11,19,30,44,28,72,0.000333,0.117765,5,1766.480614,98.137812,353.296123,118.764371,2,0
0,0,7,7,10,16,26,30,29,59,0.000333,0.092442,5,1386.629717,77.034984,277.325943,97.219281,1,0
0,0,5,5,6,8,14,25,17,42,0.000333,0.053303,6,959.45344,53.302969,159.908907,39.509775,1,0
0,0,3,3,8,7,15,20,12,32,0.000333,0.041673,4,500.081996,27.782333,125.020499,43.651484,1,0
0,0,7,7,11,19,30,44,28,72,0.000333,0.117765,5,1766.480614,98.137812,353.296123,118.764371,2,0
0,0,4,4,4,7,11,13,11,24,0.000333,0.027675,2,166.052718,9.225151,83.026359,27.651484,3,0
0,0,5,5,10,10,20,26,15,41,0.000333,0.059066,5,885.995259,49.221959,177.199052,66.438562,1,0
0,0,4,4,9,10,19,19,13,32,0.000333,0.045311,4,543.734722,30.207485,135.93368,61.748606,3,0
0,0,3,3,9,8,17,16,11,27,0.000333,0.036787,4,441.445987,24.524777,110.361497,52.529325,2,0
0,0,4,4,4,7,11,13,11,24,0.000333,0.027675,2,166.052718,9.225151,83.026359,27.651484,3,0
0,0,4,4,12,11,23,24,15,39,0.000333,0.058806,6,1058.513498,58.806305,176.418916,81.073298,4,0
0,0,6,6,9,10,19,28,17,45,0.000333,0.063719,4,764.626952,42.479275,191.156738,61.748606,1,0
0,0,6,6,8,15,23,30,27,57,0.000333,0.085948,4,1031.372126,57.298451,257.843031,82.603359,1,0
0,0,11,11,15,21,36,84,43,127,0.000333,0.21886,14,9192.126653,510.673703,656.580475,150.842025,2,0
0,0,9,9,15,19,34,68,35,103,0.000333,0.17467,7,3668.060709,203.78115,524.008673,139.313982,2,0
0,0,8,8,15,18,33,66,34,100,0.000333,0.168146,7,3531.075884,196.170882,504.439412,133.662009,2,0
0,0,9,9,15,19,34,68,35,103,0.000333,0.17467,7,3668.060709,203.78115,524.008673,139.313982,2,0
0,0,10,10,14,16,30,51,35,86,0.000333,0.140664,14,5907.896277,328.21646,421.992591,117.302969,2,0
0,0,4,4,7,8,15,16,12,28,0.000333,0.036464,3,328.17881,18.232156,109.392937,43.651484,3,0
0,0,4,4,4,7,11,13,11,24,0.000333,0.027675,2,166.052718,9.225151,83.026359,27.651484,3,0
0,0,5,5,8,12,20,25,19,44,0.000333,0.063388,4,760.659345,42.258852,190.164836,67.01955,1,0
0,0,3,3,7,5,12,11,7,18,0.000333,0.02151,3,193.587975,10.754888,64.529325,31.261125,1,0
0,0,8,8,15,18,33,66,34,100,0.000333,0.168146,7,3531.075884,196.170882,504.439412,133.662009,2,0
0,0,9,9,15,20,35,72,36,108,0.000333,0.184654,7,3877.737961,215.429887,553.962566,145.041921,2,0
0,0,6,6,8,9,17,21,16,37,0.000333,0.050412,4,604.944501,33.608028,151.236125,52.529325,1,0
0,0,5,5,7,10,17,19,16,35,0.000333,0.047687,3,429.183598,23.843533,143.061199,52.870765,3,0
0,0,5,5,9,12,21,20,17,37,0.000333,0.054172,4,650.062979,36.11461,162.515745,71.548875,1,0
0,0,5,5,11,15,26,28,23,51,0.000333,0.079907,5,1198.612128,66.589563,239.722426,96.657107,1,0
0,0,9,9,15,19,34,68,35,103,0.000333,0.17467,7,3668.060709,203.78115,524.008673,139.313982,2,0
0,0,3,3,7,5,12,11,7,18,0.000333,0.02151,3,193.587975,10.754888,64.529325,31.261125,1,0
0,0,7,7,11,19,30,44,28,72,0.000333,0.117765,5,1766.480614,98.137812,353.296123,118.764371,2,0
0,0,5,5,10,11,21,29,17,46,0.000333,0.067349,5,1010.233007,56.124056,202.046601,71.273029,1,0
0,0,5,5,7,16,23,32,26,58,0.000333,0.087456,3,787.09978,43.727766,262.366593,83.651484,1,0
0,0,5,5,10,11,21,29,17,46,0.000333,0.067349,5,1010.233007,56.124056,202.046601,71.273029,1,0
0,0,4,4,7,9,16,46,28,74,0.000333,0.098667,9,2664,148,296,48.180809,1,0
0,0,7,7,11,19,30,44,28,72,0.000333,0.117765,5,1766.480614,98.137812,353.296123,118.764371,2,0
0,0,5,5,7,7,14,17,13,30,0.000333,0.038074,3,342.661943,19.036775,114.220648,39.302969,1,0
0,0,3,3,8,7,15,11,9,20,0.000333,0.026046,4,312.551248,17.363958,78.137812,43.651484,1,0
0,0,4,4,6,8,14,17,12,29,0.000333,0.036804,3,331.239878,18.402215,110.413293,39.509775,3,0
0,0,8,8,15,18,33,66,34,100,0.000333,0.168146,7,3531.075884,196.170882,504.439412,133.662009,2,0
0,0,11,11,15,21,36,84,43,127,0.000333,0.21886,14,9192.126653,510.673703,656.580475,150.842025,2,0
0,0,8,8,15,18,33,66,34,100,0.000333,0.168146,7,3531.075884,196.170882,504.439412,133.662009,2,0
0,0,11,11,15,21,36,84,43,127,0.000333,0.21886,14,9192.126653,510.673703,656.580475,150.842025,2,0
0,0,9,9,15,19,34,68,35,103,0.000333,0.17467,7,3668.060709,203.78115,524.008673,139.313982,2,0
0,0,5,5,8,9,17,25,15,40,0.000333,0.0545,4,653.994055,36.333003,163.498514,52.529325,1,0
0,0,7,7,8,17,25,44,42,86,0.000333,0.133124,8,3194.973059,177.498503,399.371632,93.486868,1,0
0,0,8,8,13,14,27,39,29,68,0.000333,0.107777,12,3879.988202,215.5549,323.33235,101.408685,1,0
0,0,4,4,6,9,15,16,12,28,0.000333,0.036464,3,328.17881,18.232156,109.392937,44.0391,1,0
0,0,14,14,9,17,26,64,63,127,0.000333,0.198985,12,7163.47013,397.970563,596.955844,98.016193,1,0
0,0,11,11,15,21,36,84,43,127,0.000333,0.21886,14,9192.126653,510.673703,656.580475,150.842025,2,0
0,0,5,5,8,8,16,25,13,38,0.000333,0.050667,4,608,33.777778,152,48,3,0
0,0,8,8,15,18,33,66,34,100,0.000333,0.168146,7,3531.075884,196.170882,504.439412,133.662009,2,0
0,0,6,6,9,10,19,28,17,45,0.000333,0.063719,4,764.626952,42.479275,191.156738,61.748606,1,0
0,0,5,5,11,14,25,27,22,49,0.000333,0.07585,5,1137.744766,63.208043,227.548953,91.356717,1,0
0,0,5,5,9,14,23,24,25,49,0.000333,0.073885,4,886.618143,49.256564,221.654536,81.832294,2,0
0,0,3,3,8,7,15,20,12,32,0.000333,0.041673,4,500.081996,27.782333,125.020499,43.651484,1,0
0,0,8,8,9,15,24,37,27,64,0.000333,0.097813,4,1173.7504,65.208356,293.4376,87.132684,4,0
0,0,5,5,9,13,22,26,21,47,0.000333,0.069864,4,838.373144,46.576286,209.593286,76.635041,3,0
0,0,4,4,4,7,11,13,11,24,0.000333,0.027675,2,166.052718,9.225151,83.026359,27.651484,3,0
0,0,3,3,9,8,17,16,11,27,0.000333,0.036787,4,441.445987,24.524777,110.361497,52.529325,2,0
0,0,4,4,9,8,17,21,14,35,0.000333,0.047687,4,572.244798,31.791378,143.061199,52.529325,1,0
0,0,4,4,4,7,11,13,11,24,0.000333,0.027675,2,166.052718,9.225151,83.026359,27.651484,3,0
0,0,6,6,8,12,20,23,20,43,0.000333,0.061948,4,743.371632,41.298424,185.842908,67.01955,3,0
0,0,5,5,8,10,18,28,17,45,0.000333,0.062549,4,750.5865,41.69925,187.646625,57.219281,1,0
0,0,6,6,9,10,19,28,17,45,0.000333,0.063719,4,764.626952,42.479275,191.156738,61.748606,1,0
0,0,6,6,6,15,21,23,32,55,0.000333,0.080526,6,1449.46475,80.525819,241.577458,74.113134,1,0
0,0,7,7,8,13,21,20,24,44,0.000333,0.064421,4,773.047866,42.947104,193.261967,72.105716,1,0
0,0,9,9,15,19,34,68,35,103,0.000333,0.17467,7,3668.060709,203.78115,524.008673,139.313982,2,0
0,0,7,7,11,19,30,44,28,72,0.000333,0.117765,5,1766.480614,98.137812,353.296123,118.764371,2,0
0,0,3,3,7,8,15,23,12,35,0.000333,0.04558,3,410.223513,22.790195,136.741171,43.651484,1,0
0,0,5,5,8,10,18,28,17,45,0.000333,0.062549,4,750.5865,41.69925,187.646625,57.219281,1,0
0,0,8,8,15,18,33,66,34,100,0.000333,0.168146,7,3531.075884,196.170882,504.439412,133.662009,2,0
0,0,13,13,10,14,24,73,48,121,0.000333,0.184927,15,8321.706939,462.317052,554.780463,86.52225,1,0
0,0,5,5,10,11,21,33,18,51,0.000333,0.074669,5,1120.040943,62.224497,224.008189,71.273029,1,0
0,0,5,5,11,11,22,31,17,48,0.000333,0.071351,5,1070.263588,59.459088,214.052718,76.107496,1,0
0,0,7,7,14,17,31,42,35,77,0.000333,0.127158,14,5340.623623,296.701312,381.473116,122.789837,4,0
0,0,9,9,15,19,34,68,35,103,0.000333,0.17467,7,3668.060709,203.78115,524.008673,139.313982,2,0
0,0,11,11,15,21,36,84,43,127,0.000333,0.21886,14,9192.126653,510.673703,656.580475,150.842025,2,0
0,0,9,9,15,19,34,68,35,103,0.000333,0.17467,7,3668.060709,203.78115,524.008673,139.313982,2,0
0,0,5,5,11,13,24,29,20,49,0.000333,0.074888,5,1123.315813,62.406434,224.663163,86.159464,1,0
0,0,9,9,15,20,35,72,36,108,0.000333,0.184654,7,3877.737961,215.429887,553.962566,145.041921,2,0
0,0,6,6,7,11,18,41,25,66,0.000333,0.091738,6,1651.290301,91.73835,275.21505,57.705232,1,0
0,0,4,4,9,7,16,17,12,29,0.000333,0.038667,4,464,25.777778,116,48.180809,1,0
0,0,3,3,9,8,17,16,11,27,0.000333,0.036787,4,441.445987,24.524777,110.361497,52.529325,2,0
0,0,3,3,7,5,12,11,7,18,0.000333,0.02151,3,193.587975,10.754888,64.529325,31.261125,1,0
0,0,4,4,7,8,15,16,12,28,0.000333,0.036464,3,328.17881,18.232156,109.392937,43.651484,3,0
0,0,3,3,9,8,17,16,11,27,0.000333,0.036787,4,441.445987,24.524777,110.361497,52.529325,2,0
0,0,5,5,8,10,18,28,17,45,0.000333,0.062549,4,750.5865,41.69925,187.646625,57.219281,1,0
0,0,7,7,11,19,30,44,28,72,0.000333,0.117765,5,1766.480614,98.137812,353.296123,118.764371,2,0
0,0,8,8,16,19,35,72,39,111,0.000333,0.189783,16,9109.606638,506.089258,569.350415,144.710623,10,0
0,0,4,4,4,7,11,13,11,24,0.000333,0.027675,2,166.052718,9.225151,83.026359,27.651484,3,0
0,0,3,3,7,8,15,23,12,35,0.000333,0.04558,3,410.223513,22.790195,136.741171,43.651484,1,0
0,0,4,4,12,11,23,32,19,51,0.000333,0.076901,6,1384.209959,76.900553,230.70166,81.073298,1,0
0,0,12,12,8,16,24,75,42,117,0.000333,0.178814,8,4291.524901,238.41805,536.440613,88,1,0
0,0,3,3,8,7,15,15,9,24,0.000333,0.031255,4,375.061497,20.83675,93.765374,43.651484,3,0
0,0,4,4,4,7,11,13,11,24,0.000333,0.027675,2,166.052718,9.225151,83.026359,27.651484,3,0
0,0,8,8,15,18,33,66,34,100,0.000333,0.168146,7,3531.075884,196.170882,504.439412,133.662009,2,0
0,0,6,6,7,11,18,41,25,66,0.000333,0.091738,6,1651.290301,91.73835,275.21505,57.705232,1,0
0,0,11,11,8,15,23,63,38,101,0.000333,0.152293,8,3655.03806,203.05767,456.879758,82.603359,1,0
0,0,3,3,7,5,12,11,7,18,0.000333,0.02151,3,193.587975,10.754888,64.529325,31.261125,1,0
0,0,4,4,4,7,11,13,11,24,0.000333,0.027675,2,166.052718,9.225151,83.026359,27.651484,3,0
0,0,3,3,8,7,15,15,9,24,0.000333,0.031255,4,375.061497,20.83675,93.765374,43.651484,3,0
0,0,7,7,8,14,22,30,32,62,0.000333,0.092162,8,2211.878083,122.882116,276.48476,77.302969,1,0
0,0,3,3,7,5,12,11,7,18,0.000333,0.02151,3,193.587975,10.754888,64.529325,31.261125,1,0
0,0,7,7,11,19,30,44,28,72,0.000333,0.117765,5,1766.480614,98.137812,353.296123,118.764371,2,0
0,0,4,4,9,7,16,17,12,29,0.000333,0.038667,4,464,25.777778,116,48.180809,1,0
0,0,4,4,7,11,18,24,17,41,0.000333,0.056989,3,512.900775,28.494488,170.966925,57.705232,1,0
0,0,4,4,9,8,17,15,12,27,0.000333,0.036787,4,441.445987,24.524777,110.361497,52.529325,1,0
0,0,5,5,10,11,21,20,16,36,0.000333,0.052708,5,790.617136,43.923174,158.123427,71.273029,1,0
0,0,25,25,12,35,47,382,213,595,0.000333,1.10166,36,118979.2932,6609.960733,3304.980367,222.544456,4,0
0,0,11,11,15,21,36,84,43,127,0.000333,0.21886,14,9192.126653,510.673703,656.580475,150.842025,2,0
0,0,4,4,9,7,16,16,11,27,0.000333,0.036,4,432,24,108,48.180809,1,0
0,0,9,9,9,19,28,47,46,93,0.000333,0.149028,8,3576.672062,198.704003,447.084008,109.239948,1,0
0,0,25,25,12,35,47,382,213,595,0.000333,1.10166,36,118979.2932,6609.960733,3304.980367,222.544456,4,0
0,0,6,6,8,11,19,40,23,63,0.000333,0.089206,8,2140.955467,118.94197,267.619433,62.053748,1,0
0,0,3,3,7,5,12,11,7,18,0.000333,0.02151,3,193.587975,10.754888,64.529325,31.261125,1,0
0,0,8,8,15,18,33,66,34,100,0.000333,0.168146,7,3531.075884,196.170882,504.439412,133.662009,2,0
0,0,9,9,15,19,34,68,35,103,0.000333,0.17467,7,3668.060709,203.78115,524.008673,139.313982,2,0
0,0,8,8,13,14,27,39,29,68,0.000333,0.107777,12,3879.988202,215.5549,323.33235,101.408685,1,0
0,0,3,3,7,8,15,23,12,35,0.000333,0.04558,3,410.223513,22.790195,136.741171,43.651484,1,0
0,0,11,11,13,18,31,72,51,123,0.000333,0.203122,12,7312.393754,406.244097,609.366146,123.164366,1,0
0,0,5,5,10,11,21,29,17,46,0.000333,0.067349,5,1010.233007,56.124056,202.046601,71.273029,1,0
0,0,7,7,11,19,30,44,28,72,0.000333,0.117765,5,1766.480614,98.137812,353.296123,118.764371,2,0
0,0,5,5,8,10,18,28,17,45,0.000333,0.062549,4,750.5865,41.69925,187.646625,57.219281,1,0
0,0,7,7,11,19,30,44,28,72,0.000333,0.117765,5,1766.480614,98.137812,353.296123,118.764371,2,0
0,0,5,5,8,13,21,28,27,55,0.000333,0.080526,8,1932.619666,107.367759,241.577458,72.105716,1,0
0,0,5,5,7,7,14,16,11,27,0.000333,0.034266,3,308.395749,17.133097,102.798583,39.302969,1,0
0,0,5,5,8,10,18,28,17,45,0.000333,0.062549,4,750.5865,41.69925,187.646625,57.219281,1,0
0,0,6,6,8,13,21,42,25,67,0.000333,0.098095,4,1177.141069,65.396726,294.285267,72.105716,1,0
0,0,7,7,11,19,30,44,28,72,0.000333,0.117765,5,1766.480614,98.137812,353.296123,118.764371,2,0
0,0,4,4,6,8,14,17,12,29,0.000333,0.036804,3,331.239878,18.402215,110.413293,39.509775,3,0
0,0,5,5,7,10,17,19,16,35,0.000333,0.047687,3,429.183598,23.843533,143.061199,52.870765,3,0
0,0,8,8,11,15,26,59,34,93,0.000333,0.145714,10,4371.408938,242.856052,437.140894,96.657107,1,0
0,0,7,7,11,19,30,44,28,72,0.000333,0.117765,5,1766.480614,98.137812,353.296123,118.764371,2,0
0,0,4,4,6,8,14,17,12,29,0.000333,0.036804,3,331.239878,18.402215,110.413293,39.509775,3,0
0,0,3,3,8,7,15,15,9,24,0.000333,0.031255,4,375.061497,20.83675,93.765374,43.651484,3,0
0,0,3,3,7,8,15,23,12,35,0.000333,0.04558,3,410.223513,22.790195,136.741171,43.651484,1,0
0,0,17,17,15,23,38,89,58,147,0.000333,0.257148,14,10800.23482,600.013046,771.445344,162.645284,2,0
0,0,3,3,8,8,16,20,12,32,0.000333,0.042667,4,512,28.444444,128,48,1,0
0,0,11,11,15,21,36,84,43,127,0.000333,0.21886,14,9192.126653,510.673703,656.580475,150.842025,2,0
0,0,9,9,15,19,34,68,35,103,0.000333,0.17467,7,3668.060709,203.78115,524.008673,139.313982,2,0
0,0,3,3,7,8,15,23,12,35,0.000333,0.04558,3,410.223513,22.790195,136.741171,43.651484,1,0
0,0,7,7,8,14,22,37,26,63,0.000333,0.093648,4,1123.776768,62.432043,280.944192,77.302969,1,0
0,0,6,6,7,13,20,35,24,59,0.000333,0.084998,3,764.981273,42.49896,254.993758,67.757201,1,0
0,0,4,4,9,10,19,28,18,46,0.000333,0.065135,4,781.618662,43.423259,195.404666,61.748606,1,0
0,0,3,3,8,7,15,15,9,24,0.000333,0.031255,4,375.061497,20.83675,93.765374,43.651484,3,0
0,0,4,4,4,7,11,13,11,24,0.000333,0.027675,2,166.052718,9.225151,83.026359,27.651484,3,0
0,0,7,7,8,14,22,38,29,67,0.000333,0.099594,8,2390.255348,132.791964,298.781918,77.302969,1,0
0,0,5,5,6,11,17,24,18,42,0.000333,0.057224,3,515.020318,28.61224,171.673439,53.563523,4,0
0,0,5,5,8,10,18,28,17,45,0.000333,0.062549,4,750.5865,41.69925,187.646625,57.219281,1,0
0,0,3,3,7,8,15,23,12,35,0.000333,0.04558,3,410.223513,22.790195,136.741171,43.651484,1,0
0,0,4,4,6,8,14,17,12,29,0.000333,0.036804,3,331.239878,18.402215,110.413293,39.509775,3,0
0,0,3,3,7,8,15,23,12,35,0.000333,0.04558,3,410.223513,22.790195,136.741171,43.651484,1,0
0,0,3,3,8,8,16,20,12,32,0.000333,0.042667,4,512,28.444444,128,48,1,0
0,0,7,7,11,19,30,44,28,72,0.000333,0.117765,5,1766.480614,98.137812,353.296123,118.764371,2,0
0,0,4,4,11,6,17,20,14,34,0.000333,0.046325,10,1389.737366,77.207631,138.973737,53.563523,1,0
0,0,4,4,10,10,20,18,14,32,0.000333,0.046101,5,691.508495,38.417139,138.301699,66.438562,3,0
0,0,9,9,9,15,24,31,38,69,0.000333,0.105454,8,2530.8993,140.605517,316.362413,87.132684,1,0
0,0,3,3,8,7,15,11,9,20,0.000333,0.026046,4,312.551248,17.363958,78.137812,43.651484,1,0
0,0,8,8,16,17,33,49,35,84,0.000333,0.141243,16,6779.665696,376.648094,423.729106,133.486868,4,0
0,0,5,5,8,8,16,19,12,31,0.000333,0.041333,4,496,27.555556,124,48,1,0
0,0,4,4,7,10,17,19,13,32,0.000333,0.0436,3,392.396433,21.799802,130.798811,52.870765,2,0
0,0,5,5,8,10,18,28,17,45,0.000333,0.062549,4,750.5865,41.69925,187.646625,57.219281,1,0
0,0,5,5,10,11,21,33,18,51,0.000333,0.074669,5,1120.040943,62.224497,224.008189,71.273029,1,0
0,0,7,7,11,19,30,44,28,72,0.000333,0.117765,5,1766.480614,98.137812,353.296123,118.764371,2,0
0,0,11,11,15,21,36,84,43,127,0.000333,0.21886,14,9192.126653,510.673703,656.580475,150.842025,2,0
0,0,8,8,10,17,27,41,34,75,0.000333,0.118872,10,3566.165627,198.120313,356.616563,102.706149,1,0
0,0,6,6,9,10,19,28,17,45,0.000333,0.063719,4,764.626952,42.479275,191.156738,61.748606,1,0
0,0,4,4,4,7,11,13,11,24,0.000333,0.027675,2,166.052718,9.225151,83.026359,27.651484,3,0
0,0,7,7,14,16,30,42,33,75,0.000333,0.122672,14,5152.235125,286.235285,368.016795,117.302969,4,0
0,0,3,3,8,8,16,20,12,32,0.000333,0.042667,4,512,28.444444,128,48,1,0
0,0,3,3,7,10,17,22,15,37,0.000333,0.050412,3,453.708375,25.206021,151.236125,52.870765,1,0
0,0,4,4,8,11,19,27,17,44,0.000333,0.062303,4,747.635242,41.535291,186.908811,62.053748,1,0
0,0,3,3,7,5,12,11,7,18,0.000333,0.02151,3,193.587975,10.754888,64.529325,31.261125,1,0
0,0,5,5,8,10,18,28,17,45,0.000333,0.062549,4,750.5865,41.69925,187.646625,57.219281,1,0
0,0,4,4,8,7,15,16,11,27,0.000333,0.035162,4,421.944184,23.441344,105.486046,43.651484,1,0
0,0,12,12,14,16,30,61,42,103,0.000333,0.16847,14,7075.736239,393.096458,505.409731,117.302969,2,0
0,0,4,4,11,12,23,28,18,46,0.000333,0.069361,5,1040.41925,57.801069,208.08385,81.073298,1,0
0,0,3,3,7,5,12,11,7,18,0.000333,0.02151,3,193.587975,10.754888,64.529325,31.261125,1,0
0,0,7,7,11,18,29,48,28,76,0.000333,0.123069,5,1846.032778,102.557377,369.206556,113.112398,2,0
0,0,10,10,15,23,38,51,33,84,0.000333,0.146942,7,3085.781378,171.432299,440.825911,162.645284,12,0
0,0,5,5,7,8,15,17,12,29,0.000333,0.037767,3,339.899482,18.883305,113.299827,43.651484,1,0
0,0,9,9,15,19,34,68,35,103,0.000333,0.17467,7,3668.060709,203.78115,524.008673,139.313982,2,0
0,0,8,8,15,18,33,66,34,100,0.000333,0.168146,7,3531.075884,196.170882,504.439412,133.662009,2,0
0,0,11,11,15,21,36,84,43,127,0.000333,0.21886,14,9192.126653,510.673703,656.580475,150.842025,2,0
0,0,3,3,8,6,14,11,9,20,0.000333,0.025382,4,304.588394,16.921577,76.147098,39.509775,1,0
0,0,25,25,15,30,45,162,91,253,0.000333,0.463146,21,29178.2155,1621.011972,1389.438833,205.810077,8,0
0,0,3,3,12,9,21,21,11,32,0.000333,0.046851,6,843.324945,46.851386,140.554158,71.548875,3,0
0,0,4,4,4,7,11,13,11,24,0.000333,0.027675,2,166.052718,9.225151,83.026359,27.651484,3,0
0,0,7,7,11,19,30,44,28,72,0.000333,0.117765,5,1766.480614,98.137812,353.296123,118.764371,2,0
0,0,3,3,8,7,15,11,9,20,0.000333,0.026046,4,312.551248,17.363958,78.137812,43.651484,1,0
0,0,3,3,7,8,15,23,12,35,0.000333,0.04558,3,410.223513,22.790195,136.741171,43.651484,1,0
0,0,25,25,12,35,47,382,213,595,0.000333,1.10166,36,118979.2932,6609.960733,3304.980367,222.544456,4,0
0,0,8,8,15,18,33,66,34,100,0.000333,0.168146,7,3531.075884,196.170882,504.439412,133.662009,2,0
0,0,7,7,11,19,30,44,28,72,0.000333,0.117765,5,1766.480614,98.137812,353.296123,118.764371,2,0
0,0,4,4,6,8,14,17,12,29,0.000333,0.036804,3,331.239878,18.402215,110.413293,39.509775,3,0
0,0,3,3,11,11,22,26,15,41,0.000333,0.060946,5,914.183482,50.787971,182.836696,76.107496,3,0
0,0,6,6,10,11,21,24,21,45,0.000333,0.065885,5,988.27142,54.903968,197.654284,71.273029,1,0
0,0,4,4,4,7,11,13,11,24,0.000333,0.027675,2,166.052718,9.225151,83.026359,27.651484,2,0
0,0,4,4,7,13,20,19,19,38,0.000333,0.054744,3,492.699803,27.372211,164.233268,67.757201,5,0
0,0,4,4,9,8,17,21,14,35,0.000333,0.047687,4,572.244798,31.791378,143.061199,52.529325,1,0
0,0,6,6,7,11,18,41,25,66,0.000333,0.091738,6,1651.290301,91.73835,275.21505,57.705232,1,0
0,0,4,4,7,10,17,21,15,36,0.000333,0.04905,3,441.445987,24.524777,147.148662,52.870765,1,0
0,0,4,4,10,15,25,32,21,53,0.000333,0.082041,5,1230.62189,68.367883,246.124378,91.82264,1,0
0,0,5,5,10,10,20,27,14,41,0.000333,0.059066,5,885.995259,49.221959,177.199052,66.438562,3,0
0,0,5,5,10,10,20,27,14,41,0.000333,0.059066,5,885.995259,49.221959,177.199052,66.438562,3,0
0,0,7,7,11,18,29,48,28,76,0.000333,0.123069,5,1846.032778,102.557377,369.206556,113.112398,1,0
0,0,7,7,11,19,30,44,28,72,0.000333,0.117765,5,1766.480614,98.137812,353.296123,118.764371,2,0
0,0,34,34,12,18,30,223,114,337,0.000333,0.551207,36,59530.39671,3307.244261,1653.622131,118.0782,36,0
0,0,5,5,7,7,14,16,11,27,0.000333,0.034266,3,308.395749,17.133097,102.798583,39.302969,1,0
0,0,5,5,8,10,18,28,17,45,0.000333,0.062549,4,750.5865,41.69925,187.646625,57.219281,1,0
0,0,25,25,12,35,47,382,213,595,0.000333,1.10166,36,118979.2932,6609.960733,3304.980367,222.544456,4,0
0,0,5,5,10,7,17,20,16,36,0.000333,0.04905,10,1471.486623,81.749257,147.148662,52.870765,1,0
0,0,8,8,15,18,33,66,34,100,0.000333,0.168146,7,3531.075884,196.170882,504.439412,133.662009,2,0
0,0,11,11,15,21,36,84,43,127,0.000333,0.21886,14,9192.126653,510.673703,656.580475,150.842025,2,0
0,0,9,9,15,19,34,68,35,103,0.000333,0.17467,7,3668.060709,203.78115,524.008673,139.313982,2,0
0,0,4,4,9,8,17,15,12,27,0.000333,0.036787,4,441.445987,24.524777,110.361497,52.529325,1,0
0,0,3,3,8,6,14,11,9,20,0.000333,0.025382,4,304.588394,16.921577,76.147098,39.509775,1,0
0,0,3,3,11,11,22,26,15,41,0.000333,0.060946,5,914.183482,50.787971,182.836696,76.107496,3,0
0,0,3,3,8,7,15,15,9,24,0.000333,0.031255,4,375.061497,20.83675,93.765374,43.651484,3,0
0,0,4,4,4,7,11,13,11,24,0.000333,0.027675,2,166.052718,9.225151,83.026359,27.651484,3,0
0,0,22,22,13,32,45,139,84,223,0.000333,0.408228,12,14696.19889,816.455494,1224.68324,208.105716,1,0
0,0,4,4,7,9,16,30,17,47,0.000333,0.062667,3,564,31.333333,188,48.180809,1,0
0,0,3,3,11,11,22,26,15,41,0.000333,0.060946,5,914.183482,50.787971,182.836696,76.107496,3,0
0,0,5,5,8,10,18,28,17,45,0.000333,0.062549,4,750.5865,41.69925,187.646625,57.219281,1,0
0,0,4,4,5,9,14,15,13,28,0.000333,0.035535,2,213.211876,11.845104,106.605938,40.138965,1,0
0,0,8,8,10,10,20,34,28,62,0.000333,0.08932,10,2679.595419,148.866412,267.959542,66.438562,1,0
0,0,5,5,7,16,23,31,27,58,0.000333,0.087456,3,787.09978,43.727766,262.366593,83.651484,1,0
0,0,11,11,15,21,36,84,43,127,0.000333,0.21886,14,9192.126653,510.673703,656.580475,150.842025,2,0
0,0,5,5,7,8,15,17,12,29,0.000333,0.037767,3,339.899482,18.883305,113.299827,43.651484,1,0
0,0,4,4,4,7,11,13,11,24,0.000333,0.027675,2,166.052718,9.225151,83.026359,27.651484,3,0
0,0,3,3,8,7,15,15,9,24,0.000333,0.031255,4,375.061497,20.83675,93.765374,43.651484,3,0
0,0,4,4,6,8,14,17,12,29,0.000333,0.036804,3,331.239878,18.402215,110.413293,39.509775,3,0
0,0,4,4,7,13,20,23,18,41,0.000333,0.059066,3,531.597156,29.533175,177.199052,67.757201,1,0
0,0,3,3,8,7,15,11,9,20,0.000333,0.026046,4,312.551248,17.363958,78.137812,43.651484,1,0
0,0,9,9,15,19,34,68,35,103,0.000333,0.17467,7,3668.060709,203.78115,524.008673,139.313982,2,0
0,0,8,8,15,18,33,66,34,100,0.000333,0.168146,7,3531.075884,196.170882,504.439412,133.662009,2,0
0,0,5,5,8,10,18,28,17,45,0.000333,0.062549,4,750.5865,41.69925,187.646625,57.219281,1,0
0,0,11,11,15,21,36,84,43,127,0.000333,0.21886,14,9192.126653,510.673703,656.580475,150.842025,2,0
0,0,3,3,7,5,12,11,7,18,0.000333,0.02151,3,193.587975,10.754888,64.529325,31.261125,1,0
0,0,3,3,8,6,14,11,9,20,0.000333,0.025382,4,304.588394,16.921577,76.147098,39.509775,1,0
0,0,9,9,15,19,34,68,35,103,0.000333,0.17467,7,3668.060709,203.78115,524.008673,139.313982,2,0
0,0,11,11,15,21,36,84,43,127,0.000333,0.21886,14,9192.126653,510.673703,656.580475,150.842025,2,0
0,0,8,8,15,18,33,66,34,100,0.000333,0.168146,7,3531.075884,196.170882,504.439412,133.662009,2,0
0,0,3,3,7,8,15,23,12,35,0.000333,0.04558,3,410.223513,22.790195,136.741171,43.651484,1,0
0,0,4,4,9,13,22,22,17,39,0.000333,0.057973,4,695.671333,38.648407,173.917833,76.635041,3,0
0,0,4,4,6,8,14,17,12,29,0.000333,0.036804,3,331.239878,18.402215,110.413293,39.509775,3,0
0,0,5,5,8,10,18,28,17,45,0.000333,0.062549,4,750.5865,41.69925,187.646625,57.219281,1,0
0,0,5,5,11,12,23,33,21,54,0.000333,0.081424,5,1221.361728,67.853429,244.272346,81.073298,1,0
0,0,3,3,9,8,17,16,11,27,0.000333,0.036787,4,441.445987,24.524777,110.361497,52.529325,2,0
0,0,6,6,14,12,26,43,26,69,0.000333,0.10811,14,4540.624768,252.256932,324.330341,96.322519,4,0
0,0,4,4,4,7,11,13,11,24,0.000333,0.027675,2,166.052718,9.225151,83.026359,27.651484,3,0
0,0,7,7,11,18,29,48,28,76,0.000333,0.123069,5,1846.032778,102.557377,369.206556,113.112398,1,0
0,0,7,7,12,13,25,34,19,53,0.000333,0.082041,6,1476.746268,82.041459,246.124378,91.125266,3,0
0,0,3,3,9,7,16,19,11,30,0.000333,0.04,4,480,26.666667,120,48.180809,1,0
0,0,5,5,8,10,18,28,17,45,0.000333,0.062549,4,750.5865,41.69925,187.646625,57.219281,1,0
0,0,4,4,9,15,24,27,23,50,0.000333,0.076416,4,916.9925,50.944028,229.248125,87.132684,1,0
0,0,5,5,8,10,18,28,17,45,0.000333,0.062549,4,750.5865,41.69925,187.646625,57.219281,1,0
0,0,3,3,9,8,17,16,11,27,0.000333,0.036787,4,441.445987,24.524777,110.361497,52.529325,2,0
0,0,8,8,15,18,33,66,34,100,0.000333,0.168146,7,3531.075884,196.170882,504.439412,133.662009,2,0
0,0,5,5,8,10,18,28,17,45,0.000333,0.062549,4,750.5865,41.69925,187.646625,57.219281,1,0
0,0,7,7,9,16,25,24,27,51,0.000333,0.078946,4,947.346663,52.63037,236.836666,92.529325,1,0
0,0,4,4,6,10,16,26,15,41,0.000333,0.054667,3,492,27.333333,164,48.729056,1,0
0,0,3,3,6,10,16,25,13,38,0.000333,0.050667,3,456,25.333333,152,48.729056,1,0
0,0,4,4,12,10,22,26,14,40,0.000333,0.059459,6,1070.263588,59.459088,178.377265,76.238831,2,0
0,0,3,3,8,7,15,20,12,32,0.000333,0.041673,4,500.081996,27.782333,125.020499,43.651484,1,0
0,0,6,6,10,11,21,24,21,45,0.000333,0.065885,5,988.27142,54.903968,197.654284,71.273029,1,0
0,0,6,6,5,14,19,22,31,53,0.000333,0.075047,4,900.560633,50.031146,225.140158,64.912609,1,0
0,0,7,7,10,14,24,40,27,67,0.000333,0.102397,5,1535.962438,85.331247,307.192488,86.52225,1,0
0,0,6,6,8,12,20,35,25,60,0.000333,0.086439,8,2074.525486,115.251416,259.315686,67.01955,1,0
0,0,6,6,10,10,20,26,17,43,0.000333,0.061948,5,929.21454,51.62303,185.842908,66.438562,1,0
0,0,9,9,10,18,28,31,41,72,0.000333,0.115377,10,3461.295544,192.294197,346.129554,108.277931,1,0
0,0,9,9,15,19,34,68,35,103,0.000333,0.17467,7,3668.060709,203.78115,524.008673,139.313982,2,0
0,0,6,6,14,12,26,43,26,69,0.000333,0.10811,14,4540.624768,252.256932,324.330341,96.322519,4,0
0,0,3,3,8,8,16,20,12,32,0.000333,0.042667,4,512,28.444444,128,48,1,0
0,0,3,3,8,7,15,11,9,20,0.000333,0.026046,4,312.551248,17.363958,78.137812,43.651484,1,0
0,0,12,12,11,16,27,50,40,90,0.000333,0.142647,10,4279.398752,237.744375,427.939875,102.053748,1,0
0,0,3,3,7,8,15,23,12,35,0.000333,0.04558,3,410.223513,22.790195,136.741171,43.651484,1,0
0,0,8,8,12,15,27,42,27,69,0.000333,0.109362,6,1968.523426,109.362413,328.087238,101.622909,2,0
0,0,5,5,8,11,19,36,19,55,0.000333,0.077879,4,934.544053,51.919114,233.636013,62.053748,1,0
0,0,4,4,5,10,15,13,13,26,0.000333,0.03386,2,203.158311,11.286573,101.579155,44.828921,1,0
0,0,3,3,7,8,15,23,12,35,0.000333,0.04558,3,410.223513,22.790195,136.741171,43.651484,1,0
0,0,5,5,8,10,18,28,17,45,0.000333,0.062549,4,750.5865,41.69925,187.646625,57.219281,1,0
0,0,7,7,11,14,25,31,25,56,0.000333,0.086685,5,1300.279733,72.237763,260.055947,91.356717,1,0
0,0,6,6,8,8,16,20,15,35,0.000333,0.046667,4,560,31.111111,140,48,1,0
0,0,3,3,8,7,15,15,9,24,0.000333,0.031255,4,375.061497,20.83675,93.765374,43.651484,3,0
0,0,5,5,7,7,14,16,11,27,0.000333,0.034266,3,308.395749,17.133097,102.798583,39.302969,1,0
0,0,7,7,11,19,30,44,28,72,0.000333,0.117765,5,1766.480614,98.137812,353.296123,118.764371,2,0
0,0,11,11,15,21,36,84,43,127,0.000333,0.21886,14,9192.126653,510.673703,656.580475,150.842025,2,0
0,0,8,8,15,18,33,66,34,100,0.000333,0.168146,7,3531.075884,196.170882,504.439412,133.662009,2,0
0,0,5,5,10,11,21,33,18,51,0.000333,0.074669,5,1120.040943,62.224497,224.008189,71.273029,1,0
0,0,4,4,5,12,17,16,16,32,0.000333,0.0436,2,261.597622,14.533201,130.798811,54.62919,1,0
0,0,5,5,8,8,16,19,12,31,0.000333,0.041333,4,496,27.555556,124,48,1,0
0,0,9,9,12,13,25,41,32,73,0.000333,0.113001,12,4068.018022,226.001001,339.001502,91.125266,1,0
0,0,5,5,9,12,21,19,24,43,0.000333,0.062957,8,1510.957193,83.942066,188.869649,71.548875,1,0
0,0,9,9,15,19,34,68,35,103,0.000333,0.17467,7,3668.060709,203.78115,524.008673,139.313982,2,0
0,0,11,11,15,21,36,84,43,127,0.000333,0.21886,14,9192.126653,510.673703,656.580475,150.842025,2,0
0,0,8,8,15,18,33,66,34,100,0.000333,0.168146,7,3531.075884,196.170882,504.439412,133.662009,2,0
0,0,4,4,4,7,11,13,11,24,0.000333,0.027675,2,166.052718,9.225151,83.026359,27.651484,3,0
0,0,9,9,15,19,34,68,35,103,0.000333,0.17467,7,3668.060709,203.78115,524.008673,139.313982,2,0
0,0,3,3,7,8,15,23,12,35,0.000333,0.04558,3,410.223513,22.790195,136.741171,43.651484,1,0
0,0,3,3,7,8,15,23,12,35,0.000333,0.04558,3,410.223513,22.790195,136.741171,43.651484,1,0
0,0,9,9,15,19,34,68,35,103,0.000333,0.17467,7,3668.060709,203.78115,524.008673,139.313982,2,0
0,0,3,3,5,6,11,9,8,17,0.000333,0.019603,2,117.620675,6.534482,58.810338,27.119415,2,0
0,0,8,8,10,15,25,33,27,60,0.000333,0.092877,5,1393.156857,77.397603,278.631371,91.82264,1,0
0,0,4,4,6,8,14,17,12,29,0.000333,0.036804,3,331.239878,18.402215,110.413293,39.509775,3,0
0,0,5,5,8,11,19,36,19,55,0.000333,0.077879,4,934.544053,51.919114,233.636013,62.053748,1,0
0,0,4,4,4,7,11,13,11,24,0.000333,0.027675,2,166.052718,9.225151,83.026359,27.651484,3,0
0,0,4,4,6,8,14,17,12,29,0.000333,0.036804,3,331.239878,18.402215,110.413293,39.509775,3,0
0,0,9,9,15,19,34,68,35,103,0.000333,0.17467,7,3668.060709,203.78115,524.008673,139.313982,2,0
0,0,6,6,7,11,18,41,25,66,0.000333,0.091738,6,1651.290301,91.73835,275.21505,57.705232,1,0
0,0,3,3,8,8,16,20,12,32,0.000333,0.042667,4,512,28.444444,128,48,1,0
0,0,3,3,7,5,12,11,7,18,0.000333,0.02151,3,193.587975,10.754888,64.529325,31.261125,1,0
0,0,4,4,7,7,14,15,10,25,0.000333,0.031728,3,285.551619,15.863979,95.183873,39.302969,1,0
0,0,5,5,7,7,14,16,11,27,0.000333,0.034266,3,308.395749,17.133097,102.798583,39.302969,1,0
0,0,4,4,8,7,15,16,11,27,0.000333,0.035162,4,421.944184,23.441344,105.486046,43.651484,1,0
0,0,10,10,11,20,31,62,47,109,0.000333,0.180002,10,5400.073978,300.00411,540.007398,124.49231,1,0
0,0,5,5,7,7,14,19,13,32,0.000333,0.040612,3,365.506073,20.305893,121.835358,39.302969,1,0
0,0,4,4,5,10,15,17,12,29,0.000333,0.037767,2,226.599655,12.58887,113.299827,44.828921,2,0
0,0,3,3,9,8,17,16,10,26,0.000333,0.035425,4,425.096135,23.616452,106.274034,52.529325,3,0
0,0,9,9,15,19,34,68,35,103,0.000333,0.17467,7,3668.060709,203.78115,524.008673,139.313982,2,0
0,0,11,11,15,21,36,84,43,127,0.000333,0.21886,14,9192.126653,510.673703,656.580475,150.842025,2,0
0,0,8,8,15,18,33,66,34,100,0.000333,0.168146,7,3531.075884,196.170882,504.439412,133.662009,2,0
0,0,25,25,12,35,47,382,213,595,0.000333,1.10166,36,118979.2932,6609.960733,3304.980367,222.544456,4,0
0,0,5,5,11,12,23,33,21,54,0.000333,0.081424,5,1221.361728,67.853429,244.272346,81.073298,1,0
0,0,23,23,13,34,47,157,98,255,0.000333,0.47214,12,16997.04189,944.280105,1416.420157,221.079453,1,0
0,0,5,5,8,8,16,19,12,31,0.000333,0.041333,4,496,27.555556,124,48,1,0
0,0,9,9,15,19,34,68,35,103,0.000333,0.17467,7,3668.060709,203.78115,524.008673,139.313982,2,0
0,0,11,11,15,21,36,84,43,127,0.000333,0.21886,14,9192.126653,510.673703,656.580475,150.842025,2,0
0,0,4,4,9,9,18,16,13,29,0.000333,0.040309,4,483.7113,26.87285,120.927825,57.05865,1,0
0,0,8,8,10,11,21,30,25,55,0.000333,0.080526,10,2415.774583,134.209699,241.577458,71.273029,1,0
0,0,4,4,4,7,11,13,11,24,0.000333,0.027675,2,166.052718,9.225151,83.026359,27.651484,2,0
0,0,7,7,14,15,29,42,31,73,0.000333,0.118211,14,4964.856577,275.825365,354.632613,111.906328,4,0
0,0,8,8,14,12,26,49,30,79,0.000333,0.123778,14,5198.686328,288.815907,371.334738,96.322519,5,0
0,0,7,7,11,19,30,44,28,72,0.000333,0.117765,5,1766.480614,98.137812,353.296123,118.764371,2,0
0,0,9,9,15,19,34,68,35,103,0.000333,0.17467,7,3668.060709,203.78115,524.008673,139.313982,2,0
0,0,10,10,15,27,42,169,61,230,0.000333,0.413411,14,17363.2621,964.625672,1240.233007,186.985321,7,0
0,0,7,7,11,19,30,44,28,72,0.000333,0.117765,5,1766.480614,98.137812,353.296123,118.764371,2,0
0,0,7,7,11,19,30,44,28,72,0.000333,0.117765,5,1766.480614,98.137812,353.296123,118.764371,2,0
0,0,9,9,11,15,26,41,32,73,0.000333,0.114377,10,3431.320994,190.628944,343.132099,96.657107,1,0
0,0,5,5,8,12,20,25,19,44,0.000333,0.063388,4,760.659345,42.258852,190.164836,67.01955,1,0
0,0,4,4,7,10,17,19,14,33,0.000333,0.044962,3,404.658821,22.481046,134.886274,52.870765,1,0
0,0,3,3,7,8,15,23,12,35,0.000333,0.04558,3,410.223513,22.790195,136.741171,43.651484,1,0
0,0,3,3,7,8,15,23,12,35,0.000333,0.04558,3,410.223513,22.790195,136.741171,43.651484,1,0
0,0,14,14,11,23,34,85,48,133,0.000333,0.225544,10,6766.325579,375.906977,676.632558,142.095673,6,0
0,0,9,9,15,19,34,68,35,103,0.000333,0.17467,7,3668.060709,203.78115,524.008673,139.313982,2,0
0,0,3,3,5,6,11,9,8,17,0.000333,0.019603,2,117.620675,6.534482,58.810338,27.119415,1,0
0,0,4,4,4,7,11,13,11,24,0.000333,0.027675,2,166.052718,9.225151,83.026359,27.651484,2,0
0,0,6,6,10,11,21,24,21,45,0.000333,0.065885,5,988.27142,54.903968,197.654284,71.273029,1,0
0,0,3,3,8,10,18,20,14,34,0.000333,0.047259,4,567.1098,31.5061,141.77745,57.219281,1,0
0,0,3,3,9,8,17,16,11,27,0.000333,0.036787,4,441.445987,24.524777,110.361497,52.529325,2,0
0,0,4,4,4,7,11,13,11,24,0.000333,0.027675,2,166.052718,9.225151,83.026359,27.651484,2,0
0,0,3,3,8,8,16,20,12,32,0.000333,0.042667,4,512,28.444444,128,48,1,0
0,0,3,3,8,6,14,11,9,20,0.000333,0.025382,4,304.588394,16.921577,76.147098,39.509775,1,0
0,0,11,11,13,17,30,58,46,104,0.000333,0.170106,12,6123.799463,340.211081,510.316622,117.592585,1,0
0,0,3,3,8,8,16,20,12,32,0.000333,0.042667,4,512,28.444444,128,48,1,0
0,0,6,6,13,11,24,38,23,61,0.000333,0.093228,12,3356.192551,186.455142,279.682713,86.159464,4,0
0,0,11,11,8,18,26,71,42,113,0.000333,0.17705,8,4249.197505,236.066528,531.149688,99.05865,1,0
0,0,5,5,9,14,23,27,21,48,0.000333,0.072377,4,868.523896,48.251328,217.130974,81.832294,1,0
0,0,11,11,15,21,36,84,43,127,0.000333,0.21886,14,9192.126653,510.673703,656.580475,150.842025,2,0
0,0,9,9,15,19,34,68,35,103,0.000333,0.17467,7,3668.060709,203.78115,524.008673,139.313982,2,0
0,0,4,4,4,7,11,13,11,24,0.000333,0.027675,2,166.052718,9.225151,83.026359,27.651484,3,0
0,0,9,9,15,19,34,68,35,103,0.000333,0.17467,7,3668.060709,203.78115,524.008673,139.313982,2,0
0,0,4,4,10,15,25,32,21,53,0.000333,0.082041,5,1230.62189,68.367883,246.124378,91.82264,1,0
0,0,8,8,15,18,33,66,34,100,0.000333,0.168146,7,3531.075884,196.170882,504.439412,133.662009,2,0
0,0,5,5,8,10,18,28,17,45,0.000333,0.062549,4,750.5865,41.69925,187.646625,57.219281,1,0
0,0,3,3,9,8,17,16,11,27,0.000333,0.036787,4,441.445987,24.524777,110.361497,52.529325,2,0
0,0,8,8,15,18,33,66,34,100,0.000333,0.168146,7,3531.075884,196.170882,504.439412,133.662009,2,0
0,0,3,3,7,5,12,11,7,18,0.000333,0.02151,3,193.587975,10.754888,64.529325,31.261125,1,0
0,0,11,11,15,21,36,84,43,127,0.000333,0.21886,14,9192.126653,510.673703,656.580475,150.842025,2,0
0,0,8,8,11,15,26,45,33,78,0.000333,0.122211,10,3666.34298,203.685721,366.634298,96.657107,1,0
0,0,8,8,11,15,26,46,32,78,0.000333,0.122211,10,3666.34298,203.685721,366.634298,96.657107,1,0
0,0,7,7,8,14,22,39,27,66,0.000333,0.098107,4,1177.289947,65.404997,294.322487,77.302969,1,0
0,0,20,20,16,27,43,116,68,184,0.000333,0.332811,16,15974.92344,887.495747,998.432715,192.381963,6,0
0,0,6,6,13,13,26,37,25,62,0.000333,0.097142,6,1748.563575,97.142421,291.427263,96.211433,4,0
0,0,12,12,11,16,27,50,40,90,0.000333,0.142647,10,4279.398752,237.744375,427.939875,102.053748,1,0
0,0,5,5,10,10,20,26,15,41,0.000333,0.059066,5,885.995259,49.221959,177.199052,66.438562,1,0
0,0,5,5,7,7,14,16,11,27,0.000333,0.034266,3,308.395749,17.133097,102.798583,39.302969,1,0
0,0,4,4,4,7,11,13,11,24,0.000333,0.027675,2,166.052718,9.225151,83.026359,27.651484,3,0
0,0,7,7,11,19,30,44,28,72,0.000333,0.117765,5,1766.480614,98.137812,353.296123,118.764371,2,0
0,0,3,3,8,7,15,20,12,32,0.000333,0.041673,4,500.081996,27.782333,125.020499,43.651484,1,0
0,0,4,4,6,12,18,18,16,34,0.000333,0.047259,3,425.33235,23.629575,141.77745,58.529325,1,0
0,0,11,11,15,21,36,84,43,127,0.000333,0.21886,14,9192.126653,510.673703,656.580475,150.842025,2,0
0,0,9,9,15,19,34,68,35,103,0.000333,0.17467,7,3668.060709,203.78115,524.008673,139.313982,2,0
0,0,4,4,5,12,17,16,16,32,0.000333,0.0436,2,261.597622,14.533201,130.798811,54.62919,1,0
0,0,3,3,8,7,15,11,9,20,0.000333,0.026046,4,312.551248,17.363958,78.137812,43.651484,1,0
0,0,4,4,5,9,14,15,13,28,0.000333,0.035535,2,213.211876,11.845104,106.605938,40.138965,1,0
0,0,6,6,10,11,21,24,21,45,0.000333,0.065885,5,988.27142,54.903968,197.654284,71.273029,1,0
0,0,7,7,11,19,30,44,28,72,0.000333,0.117765,5,1766.480614,98.137812,353.296123,118.764371,2,0
0,0,4,4,5,9,14,15,13,28,0.000333,0.035535,2,213.211876,11.845104,106.605938,40.138965,1,0
0,0,5,5,8,10,18,28,17,45,0.000333,0.062549,4,750.5865,41.69925,187.646625,57.219281,1,0
0,0,3,3,8,7,15,11,9,20,0.000333,0.026046,4,312.551248,17.363958,78.137812,43.651484,1,0
0,0,3,3,8,8,16,20,12,32,0.000333,0.042667,4,512,28.444444,128,48,1,0
0,0,5,5,11,11,22,31,17,48,0.000333,0.071351,5,1070.263588,59.459088,214.052718,76.107496,1,0
0,0,3,3,9,8,17,16,11,27,0.000333,0.036787,4,441.445987,24.524777,110.361497,52.529325,2,0
0,0,11,11,13,21,34,91,48,139,0.000333,0.235719,12,8485.888019,471.438223,707.157335,140.344382,12,0
0,0,4,4,10,11,21,19,16,35,0.000333,0.051244,5,768.655549,42.703086,153.73111,71.273029,1,0
0,0,7,7,11,19,30,44,28,72,0.000333,0.117765,5,1766.480614,98.137812,353.296123,118.764371,2,0
0,0,3,3,11,11,22,26,15,41,0.000333,0.060946,5,914.183482,50.787971,182.836696,76.107496,3,0
0,0,4,4,10,9,19,22,13,35,0.000333,0.049559,5,743.387315,41.299295,148.677463,61.748606,1,0
0,0,7,7,11,18,29,48,28,76,0.000333,0.123069,5,1846.032778,102.557377,369.206556,113.112398,1,0
0,0,11,11,12,17,29,80,32,112,0.000333,0.181365,6,3264.563229,181.364624,544.093871,112.506418,4,0
0,0,3,3,7,8,15,23,12,35,0.000333,0.04558,3,410.223513,22.790195,136.741171,43.651484,1,0
0,0,3,3,7,8,15,23,12,35,0.000333,0.04558,3,410.223513,22.790195,136.741171,43.651484,1,0
0,0,9,9,15,19,34,68,35,103,0.000333,0.17467,7,3668.060709,203.78115,524.008673,139.313982,2,0
0,0,13,13,14,20,34,82,48,130,0.000333,0.220457,14,9259.182371,514.399021,661.370169,139.741531,2,0
0,0,6,6,6,12,18,27,20,47,0.000333,0.065329,3,587.959425,32.664413,195.986475,58.529325,1,0
0,0,17,17,21,26,47,131,75,206,0.000333,0.381415,20,22884.90607,1271.38367,1144.245303,214.450099,9,0
0,0,7,7,11,19,30,44,28,72,0.000333,0.117765,5,1766.480614,98.137812,353.296123,118.764371,2,0
0,0,3,3,8,8,16,20,12,32,0.000333,0.042667,4,512,28.444444,128,48,1,0
0,0,3,3,8,8,16,20,12,32,0.000333,0.042667,4,512,28.444444,128,48,1,0
0,0,11,11,9,16,25,51,39,90,0.000333,0.139316,8,3343.576457,185.754248,417.947057,92.529325,1,0
0,0,4,4,4,7,11,13,11,24,0.000333,0.027675,2,166.052718,9.225151,83.026359,27.651484,3,0
0,0,6,6,10,10,20,28,19,47,0.000333,0.06771,5,1015.653102,56.425172,203.13062,66.438562,1,0
0,0,9,9,15,19,34,68,35,103,0.000333,0.17467,7,3668.060709,203.78115,524.008673,139.313982,2,0
0,0,3,3,7,8,15,23,12,35,0.000333,0.04558,3,410.223513,22.790195,136.741171,43.651484,1,0
0,0,3,3,8,8,16,20,12,32,0.000333,0.042667,4,512,28.444444,128,48,1,0
0,0,3,3,7,5,12,11,7,18,0.000333,0.02151,3,193.587975,10.754888,64.529325,31.261125,1,0
0,0,3,3,7,5,12,11,7,18,0.000333,0.02151,3,193.587975,10.754888,64.529325,31.261125,1,0
0,0,5,5,10,11,21,33,18,51,0.000333,0.074669,5,1120.040943,62.224497,224.008189,71.273029,1,0
0,0,4,4,4,7,11,13,11,24,0.000333,0.027675,2,166.052718,9.225151,83.026359,27.651484,2,0
0,0,3,3,10,5,15,14,7,21,0.000333,0.027348,5,410.223513,22.790195,82.044703,44.828921,1,0
0,0,4,4,4,7,11,13,11,24,0.000333,0.027675,2,166.052718,9.225151,83.026359,27.651484,3,0
0,0,5,5,7,10,17,19,16,35,0.000333,0.047687,3,429.183598,23.843533,143.061199,52.870765,3,0
0,0,11,11,12,18,30,69,40,109,0.000333,0.178284,12,6418.212899,356.567383,534.851075,118.0782,2,0
0,0,5,5,10,10,20,26,15,41,0.000333,0.059066,5,885.995259,49.221959,177.199052,66.438562,1,0
0,0,5,5,8,12,20,25,19,44,0.000333,0.063388,4,760.659345,42.258852,190.164836,67.01955,1,0
0,0,3,3,7,8,15,23,12,35,0.000333,0.04558,3,410.223513,22.790195,136.741171,43.651484,1,0
0,0,23,23,13,34,47,157,98,255,0.000333,0.47214,12,16997.04189,944.280105,1416.420157,221.079453,1,0
0,0,5,5,9,6,15,22,13,35,0.000333,0.04558,8,1093.929367,60.773854,136.741171,44.0391,3,0
0,0,3,3,7,5,12,11,7,18,0.000333,0.02151,3,193.587975,10.754888,64.529325,31.261125,1,0
0,0,5,5,11,12,23,33,21,54,0.000333,0.081424,5,1221.361728,67.853429,244.272346,81.073298,1,0
0,0,5,5,8,10,18,28,17,45,0.000333,0.062549,4,750.5865,41.69925,187.646625,57.219281,1,0
0,0,3,3,11,11,22,26,15,41,0.000333,0.060946,5,914.183482,50.787971,182.836696,76.107496,3,0
0,0,4,4,4,6,10,16,12,28,0.000333,0.031005,4,372.055947,20.669775,93.013987,23.509775,1,0
0,0,5,5,7,11,18,15,15,30,0.000333,0.041699,3,375.29325,20.849625,125.09775,57.705232,1,0
0,0,4,4,8,8,16,18,12,30,0.000333,0.04,4,480,26.666667,120,48,1,0
0,0,4,4,6,9,15,13,12,25,0.000333,0.032557,3,293.016795,16.278711,97.672265,44.0391,1,0
0,0,3,3,9,13,22,20,16,36,0.000333,0.053513,4,642.158153,35.675453,160.539538,76.635041,3,0
0,0,9,9,10,14,24,45,35,80,0.000333,0.122266,10,3667.970001,203.776111,366.797,86.52225,1,0
0,0,3,3,8,7,15,15,9,24,0.000333,0.031255,4,375.061497,20.83675,93.765374,43.651484,3,0
0,0,9,9,15,19,34,68,35,103,0.000333,0.17467,7,3668.060709,203.78115,524.008673,139.313982,2,0
0,0,5,5,10,11,21,29,17,46,0.000333,0.067349,5,1010.233007,56.124056,202.046601,71.273029,1,0
0,0,5,5,8,10,18,28,17,45,0.000333,0.062549,4,750.5865,41.69925,187.646625,57.219281,1,0
0,0,5,5,8,11,19,30,18,48,0.000333,0.067967,4,815.602083,45.311227,203.900521,62.053748,1,0
0,0,7,7,11,19,30,44,28,72,0.000333,0.117765,5,1766.480614,98.137812,353.296123,118.764371,2,0
0,0,5,5,8,11,19,36,19,55,0.000333,0.077879,4,934.544053,51.919114,233.636013,62.053748,1,0
0,0,16,16,11,26,37,113,60,173,0.000333,0.300412,10,9012.354323,500.686351,901.235432,160.26518,1,0
0,0,3,3,9,8,17,16,11,27,0.000333,0.036787,4,441.445987,24.524777,110.361497,52.529325,2,0
0,0,9,9,15,19,34,68,35,103,0.000333,0.17467,7,3668.060709,203.78115,524.008673,139.313982,2,0
0,0,8,8,15,18,33,66,34,100,0.000333,0.168146,7,3531.075884,196.170882,504.439412,133.662009,2,0
0,0,11,11,15,21,36,84,43,127,0.000333,0.21886,14,9192.126653,510.673703,656.580475,150.842025,2,0
0,0,3,3,9,5,14,17,10,27,0.000333,0.034266,8,822.388663,45.688259,102.798583,40.138965,3,0
0,0,8,8,9,16,25,57,29,86,0.000333,0.133124,4,1597.486529,88.749252,399.371632,92.529325,1,0
0,0,7,7,8,12,20,29,20,49,0.000333,0.070591,4,847.097907,47.060995,211.774477,67.01955,1,0
0,0,7,7,11,19,30,44,28,72,0.000333,0.117765,5,1766.480614,98.137812,353.296123,118.764371,2,0
0,0,7,7,11,19,30,44,28,72,0.000333,0.117765,5,1766.480614,98.137812,353.296123,118.764371,2,0
0,0,4,4,4,7,11,13,11,24,0.000333,0.027675,2,166.052718,9.225151,83.026359,27.651484,2,0
0,0,3,3,7,8,15,23,12,35,0.000333,0.04558,3,410.223513,22.790195,136.741171,43.651484,1,0
0,0,6,6,10,11,21,24,21,45,0.000333,0.065885,5,988.27142,54.903968,197.654284,71.273029,1,0
0,0,7,7,11,19,30,44,28,72,0.000333,0.117765,5,1766.480614,98.137812,353.296123,118.764371,2,0
0,0,3,3,9,8,17,16,11,27,0.000333,0.036787,4,441.445987,24.524777,110.361497,52.529325,2,0
0,0,3,3,9,8,17,16,11,27,0.000333,0.036787,4,441.445987,24.524777,110.361497,52.529325,2,0
0,0,4,4,4,7,11,13,11,24,0.000333,0.027675,2,166.052718,9.225151,83.026359,27.651484,3,0
0,0,3,3,8,6,14,11,9,20,0.000333,0.025382,4,304.588394,16.921577,76.147098,39.509775,1,0
0,0,5,5,8,10,18,28,17,45,0.000333,0.062549,4,750.5865,41.69925,187.646625,57.219281,1,0
0,0,3,3,8,8,16,20,12,32,0.000333,0.042667,4,512,28.444444,128,48,1,0
0,0,7,7,11,19,30,44,28,72,0.000333,0.117765,5,1766.480614,98.137812,353.296123,118.764371,2,0
0,0,5,5,8,10,18,28,17,45,0.000333,0.062549,4,750.5865,41.69925,187.646625,57.219281,1,0
0,0,5,5,8,14,22,23,20,43,0.000333,0.063919,4,767.022238,42.612347,191.75556,77.302969,1,0
0,0,13,13,11,22,33,99,50,149,0.000333,0.250538,10,7516.147238,417.563735,751.614724,136.161243,1,0
0,0,8,8,14,17,31,44,36,80,0.000333,0.132112,14,5548.699868,308.261104,396.335705,122.789837,4,0
0,0,8,8,11,15,26,44,30,74,0.000333,0.115944,10,3478.325391,193.2403,347.832539,96.657107,1,0
0,0,11,11,15,21,36,84,43,127,0.000333,0.21886,14,9192.126653,510.673703,656.580475,150.842025,2,0
0,0,8,8,15,18,33,66,34,100,0.000333,0.168146,7,3531.075884,196.170882,504.439412,133.662009,2,0
0,0,5,5,7,7,14,16,11,27,0.000333,0.034266,3,308.395749,17.133097,102.798583,39.302969,1,0
0,0,6,6,7,11,18,41,25,66,0.000333,0.091738,6,1651.290301,91.73835,275.21505,57.705232,1,0
0,0,4,4,4,7,11,13,11,24,0.000333,0.027675,2,166.052718,9.225151,83.026359,27.651484,2,0
0,0,6,6,10,11,21,24,21,45,0.000333,0.065885,5,988.27142,54.903968,197.654284,71.273029,1,0
0,0,4,4,4,7,11,13,11,24,0.000333,0.027675,2,166.052718,9.225151,83.026359,27.651484,3,0
0,0,8,8,15,18,33,66,34,100,0.000333,0.168146,7,3531.075884,196.170882,504.439412,133.662009,2,0
0,0,5,5,10,10,20,27,14,41,0.000333,0.059066,5,885.995259,49.221959,177.199052,66.438562,3,0
0,0,11,11,15,21,36,84,43,127,0.000333,0.21886,14,9192.126653,510.673703,656.580475,150.842025,2,0
0,0,5,5,8,10,18,28,17,45,0.000333,0.062549,4,750.5865,41.69925,187.646625,57.219281,1,0
0,0,5,5,12,16,28,39,25,64,0.000333,0.102557,6,1846.02429,102.556905,307.670715,107.01955,2,0
0,0,8,8,11,15,26,35,27,62,0.000333,0.097142,5,1457.136313,80.952017,291.427263,96.657107,1,0
0,0,8,8,10,14,24,48,32,80,0.000333,0.122266,10,3667.970001,203.776111,366.797,86.52225,1,0
0,0,3,3,7,5,12,11,7,18,0.000333,0.02151,3,193.587975,10.754888,64.529325,31.261125,1,0
0,0,4,4,4,7,11,13,11,24,0.000333,0.027675,2,166.052718,9.225151,83.026359,27.651484,3,0
0,0,3,3,7,8,15,23,12,35,0.000333,0.04558,3,410.223513,22.790195,136.741171,43.651484,1,0
0,0,3,3,8,7,15,11,9,20,0.000333,0.026046,4,312.551248,17.363958,78.137812,43.651484,1,0
0,0,7,7,11,19,30,44,28,72,0.000333,0.117765,5,1766.480614,98.137812,353.296123,118.764371,2,0
0,0,5,5,11,12,23,33,21,54,0.000333,0.081424,5,1221.361728,67.853429,244.272346,81.073298,1,0
0,0,5,5,8,10,18,28,17,45,0.000333,0.062549,4,750.5865,41.69925,187.646625,57.219281,1,0
0,0,5,5,8,10,18,26,15,41,0.000333,0.056989,4,683.8677,37.99265,170.966925,57.219281,1,0
0,0,4,4,5,7,12,14,10,24,0.000333,0.02868,2,172.0782,9.5599,86.0391,31.261125,2,0
0,0,10,10,14,17,31,51,37,88,0.000333,0.145323,14,6103.569854,339.087214,435.969275,122.789837,2,0
0,0,17,17,21,26,47,131,75,206,0.000333,0.381415,20,22884.90607,1271.38367,1144.245303,214.450099,9,0
0,0,6,6,7,11,18,41,25,66,0.000333,0.091738,6,1651.290301,91.73835,275.21505,57.705232,1,0
0,0,3,3,9,7,16,19,11,30,0.000333,0.04,4,480,26.666667,120,48.180809,4,0
0,0,3,3,9,8,17,16,11,27,0.000333,0.036787,4,441.445987,24.524777,110.361497,52.529325,2,0
0,0,9,9,15,19,34,68,35,103,0.000333,0.17467,7,3668.060709,203.78115,524.008673,139.313982,2,0
0,0,6,6,9,15,24,24,26,50,0.000333,0.076416,4,916.9925,50.944028,229.248125,87.132684,1,0
0,0,3,3,12,9,21,21,11,32,0.000333,0.046851,6,843.324945,46.851386,140.554158,71.548875,3,0
0,0,4,4,7,14,21,23,19,42,0.000333,0.061492,3,553.431995,30.746222,184.477332,72.954453,1,0
0,0,7,7,11,19,30,44,28,72,0.000333,0.117765,5,1766.480614,98.137812,353.296123,118.764371,2,0
0,0,4,4,10,15,25,32,21,53,0.000333,0.082041,5,1230.62189,68.367883,246.124378,91.82264,1,0
0,0,8,8,15,18,33,66,34,100,0.000333,0.168146,7,3531.075884,196.170882,504.439412,133.662009,2,0
0,0,3,3,9,8,17,16,11,27,0.000333,0.036787,4,441.445987,24.524777,110.361497,52.529325,2,0
0,0,11,11,15,21,36,84,43,127,0.000333,0.21886,14,9192.126653,510.673703,656.580475,150.842025,2,0
0,0,11,11,15,21,36,84,43,127,0.000333,0.21886,14,9192.126653,510.673703,656.580475,150.842025,2,0
0,0,8,8,15,18,33,66,34,100,0.000333,0.168146,7,3531.075884,196.170882,504.439412,133.662009,2,0
0,0,8,8,15,18,33,66,34,100,0.000333,0.168146,7,3531.075884,196.170882,504.439412,133.662009,2,0
0,0,8,8,15,18,33,66,34,100,0.000333,0.168146,7,3531.075884,196.170882,504.439412,133.662009,2,0
0,0,7,7,8,12,20,29,20,49,0.000333,0.070591,4,847.097907,47.060995,211.774477,67.01955,1,0
0,0,4,4,9,9,18,24,17,41,0.000333,0.056989,4,683.8677,37.99265,170.966925,57.05865,1,0
0,0,4,4,4,7,11,13,11,24,0.000333,0.027675,2,166.052718,9.225151,83.026359,27.651484,3,0
0,0,4,4,7,12,19,17,20,37,0.000333,0.052391,3,471.519954,26.195553,157.173318,62.671034,1,0
0,0,4,4,10,15,25,32,21,53,0.000333,0.082041,5,1230.62189,68.367883,246.124378,91.82264,1,0
0,0,11,11,15,21,36,84,43,127,0.000333,0.21886,14,9192.126653,510.673703,656.580475,150.842025,2,0
0,0,8,8,15,18,33,66,34,100,0.000333,0.168146,7,3531.075884,196.170882,504.439412,133.662009,2,0
0,0,8,8,15,18,33,66,34,100,0.000333,0.168146,7,3531.075884,196.170882,504.439412,133.662009,2,0
0,0,11,11,15,21,36,84,43,127,0.000333,0.21886,14,9192.126653,510.673703,656.580475,150.842025,2,0
0,0,7,7,11,18,29,48,28,76,0.000333,0.123069,5,1846.032778,102.557377,369.206556,113.112398,1,0
0,0,7,7,11,14,25,38,20,58,0.000333,0.089781,5,1346.718295,74.817683,269.343659,91.356717,3,0
0,0,3,3,8,8,16,20,12,32,0.000333,0.042667,4,512,28.444444,128,48,1,0
0,0,12,12,11,16,27,50,40,90,0.000333,0.142647,10,4279.398752,237.744375,427.939875,102.053748,1,0
0,0,6,6,9,10,19,28,17,45,0.000333,0.063719,4,764.626952,42.479275,191.156738,61.748606,1,0
0,0,8,8,15,18,33,66,34,100,0.000333,0.168146,7,3531.075884,196.170882,504.439412,133.662009,2,0
0,0,5,5,8,8,16,19,12,31,0.000333,0.041333,4,496,27.555556,124,48,1,0
0,0,3,3,9,8,17,16,11,27,0.000333,0.036787,4,441.445987,24.524777,110.361497,52.529325,2,0
0,0,4,4,4,7,11,13,11,24,0.000333,0.027675,2,166.052718,9.225151,83.026359,27.651484,3,0
0,0,9,9,12,17,29,49,34,83,0.000333,0.134404,12,4838.549071,268.808282,403.212423,112.506418,1,0
0,0,3,3,7,8,15,23,12,35,0.000333,0.04558,3,410.223513,22.790195,136.741171,43.651484,1,0
0,0,4,4,7,8,15,16,12,28,0.000333,0.036464,3,328.17881,18.232156,109.392937,43.651484,3,0
0,0,3,3,9,8,17,16,11,27,0.000333,0.036787,4,441.445987,24.524777,110.361497,52.529325,2,0
0,0,7,7,11,19,30,44,28,72,0.000333,0.117765,5,1766.480614,98.137812,353.296123,118.764371,2,0
0,0,10,10,7,14,21,57,36,93,0.000333,0.136162,6,2450.913122,136.16184,408.48552,72.954453,1,0
0,0,3,3,7,5,12,11,7,18,0.000333,0.02151,3,193.587975,10.754888,64.529325,31.261125,1,0
0,0,5,5,8,10,18,28,17,45,0.000333,0.062549,4,750.5865,41.69925,187.646625,57.219281,1,0
0,0,13,13,16,22,38,379,42,421,0.000333,0.736459,8,17675.01987,981.945548,2209.377483,162.107496,7,0
0,0,3,3,8,7,15,20,12,32,0.000333,0.041673,4,500.081996,27.782333,125.020499,43.651484,1,0
0,0,3,3,9,6,15,18,12,30,0.000333,0.039069,8,937.653743,52.091875,117.206718,44.0391,1,0
0,0,3,3,7,5,12,11,7,18,0.000333,0.02151,3,193.587975,10.754888,64.529325,31.261125,1,0
0,0,8,8,15,18,33,66,34,100,0.000333,0.168146,7,3531.075884,196.170882,504.439412,133.662009,2,0
0,0,4,4,11,7,18,18,13,31,0.000333,0.043089,5,646.338375,35.907688,129.267675,57.705232,1,0
0,0,5,5,10,15,25,30,22,52,0.000333,0.080494,5,1207.402609,67.077923,241.480522,91.82264,1,0
0,0,4,4,10,15,25,32,21,53,0.000333,0.082041,5,1230.62189,68.367883,246.124378,91.82264,1,0
0,0,3,3,8,10,18,25,15,40,0.000333,0.055599,4,667.188,37.066,166.797,57.219281,1,0
0,0,3,3,8,7,15,20,12,32,0.000333,0.041673,4,500.081996,27.782333,125.020499,43.651484,1,0
0,0,4,4,5,7,12,14,10,24,0.000333,0.02868,2,172.0782,9.5599,86.0391,31.261125,2,0
0,0,3,3,7,8,15,23,12,35,0.000333,0.04558,3,410.223513,22.790195,136.741171,43.651484,1,0
0,0,17,17,11,21,32,136,72,208,0.000333,0.346667,15,15600,866.666667,1040,130.292414,4,0
0,0,7,7,14,15,29,35,22,57,0.000333,0.092302,7,1938.334417,107.685245,276.904917,111.906328,3,0
0,0,3,3,7,5,12,11,7,18,0.000333,0.02151,3,193.587975,10.754888,64.529325,31.261125,1,0
0,0,10,10,12,15,27,51,42,93,0.000333,0.147402,12,5306.454452,294.803025,442.204538,101.622909,1,0
0,0,4,4,6,8,14,17,12,29,0.000333,0.036804,3,331.239878,18.402215,110.413293,39.509775,3,0
0,0,3,3,8,7,15,11,9,20,0.000333,0.026046,4,312.551248,17.363958,78.137812,43.651484,1,0
0,0,3,3,7,5,12,11,7,18,0.000333,0.02151,3,193.587975,10.754888,64.529325,31.261125,1,0
0,0,11,11,11,15,26,43,35,78,0.000333,0.122211,10,3666.34298,203.685721,366.634298,96.657107,1,0
0,0,5,5,8,10,18,28,17,45,0.000333,0.062549,4,750.5865,41.69925,187.646625,57.219281,1,0
0,0,14,14,11,13,24,62,45,107,0.000333,0.16353,15,7358.864814,408.825823,490.590988,86.159464,1,0
0,0,4,4,10,15,25,32,21,53,0.000333,0.082041,5,1230.62189,68.367883,246.124378,91.82264,1,0
0,0,4,4,4,7,11,13,11,24,0.000333,0.027675,2,166.052718,9.225151,83.026359,27.651484,3,0
0,0,6,6,14,11,25,38,23,61,0.000333,0.094425,14,3965.853186,220.325177,283.275228,91.356717,4,0
0,0,3,3,8,8,16,20,12,32,0.000333,0.042667,4,512,28.444444,128,48,1,0
0,0,4,4,4,7,11,13,11,24,0.000333,0.027675,2,166.052718,9.225151,83.026359,27.651484,3,0
0,0,25,25,12,35,47,382,213,595,0.000333,1.10166,36,118979.2932,6609.960733,3304.980367,222.544456,4,0
0,0,5,5,11,12,23,33,21,54,0.000333,0.081424,5,1221.361728,67.853429,244.272346,81.073298,1,0
0,0,6,6,7,11,18,41,25,66,0.000333,0.091738,6,1651.290301,91.73835,275.21505,57.705232,1,0
0,0,11,11,15,21,36,84,43,127,0.000333,0.21886,14,9192.126653,510.673703,656.580475,150.842025,2,0
0,0,6,6,7,11,18,41,25,66,0.000333,0.091738,6,1651.290301,91.73835,275.21505,57.705232,1,0
0,0,25,25,12,35,47,382,213,595,0.000333,1.10166,36,118979.2932,6609.960733,3304.980367,222.544456,4,0
0,0,4,4,4,7,11,13,11,24,0.000333,0.027675,2,166.052718,9.225151,83.026359,27.651484,3,0
0,0,5,5,8,10,18,28,17,45,0.000333,0.062549,4,750.5865,41.69925,187.646625,57.219281,1,0
0,0,8,8,11,15,26,59,34,93,0.000333,0.145714,10,4371.408938,242.856052,437.140894,96.657107,1,0
0,0,7,7,11,19,30,44,28,72,0.000333,0.117765,5,1766.480614,98.137812,353.296123,118.764371,2,0
0,0,3,3,9,8,17,16,11,27,0.000333,0.036787,4,441.445987,24.524777,110.361497,52.529325,2,0
0,0,5,5,12,13,25,30,20,50,0.000333,0.077398,6,1393.156857,77.397603,232.192809,91.125266,1,0
0,0,5,5,11,12,23,33,18,51,0.000333,0.076901,5,1153.508299,64.083794,230.70166,81.073298,3,0
0,0,4,4,4,7,11,13,11,24,0.000333,0.027675,2,166.052718,9.225151,83.026359,27.651484,3,0
0,0,5,5,10,10,20,26,15,41,0.000333,0.059066,5,885.995259,49.221959,177.199052,66.438562,1,0
0,0,3,3,8,8,16,20,12,32,0.000333,0.042667,4,512,28.444444,128,48,1,0
0,0,3,3,9,11,20,19,16,35,0.000333,0.050422,4,605.069933,33.614996,151.267483,66.583073,1,0
0,0,4,4,4,7,11,13,11,24,0.000333,0.027675,2,166.052718,9.225151,83.026359,27.651484,3,0
0,0,8,8,15,18,33,66,34,100,0.000333,0.168146,7,3531.075884,196.170882,504.439412,133.662009,2,0
0,0,4,4,10,15,25,32,21,53,0.000333,0.082041,5,1230.62189,68.367883,246.124378,91.82264,1,0
0,0,5,5,8,9,17,25,15,40,0.000333,0.0545,4,653.994055,36.333003,163.498514,52.529325,1,0
0,0,5,5,8,10,18,28,17,45,0.000333,0.062549,4,750.5865,41.69925,187.646625,57.219281,1,0
0,0,4,4,4,7,11,13,11,24,0.000333,0.027675,2,166.052718,9.225151,83.026359,27.651484,3,0
0,0,4,4,4,7,11,13,11,24,0.000333,0.027675,2,166.052718,9.225151,83.026359,27.651484,3,0
0,0,3,3,7,8,15,23,12,35,0.000333,0.04558,3,410.223513,22.790195,136.741171,43.651484,1,0
0,0,5,5,7,8,15,17,12,29,0.000333,0.037767,3,339.899482,18.883305,113.299827,43.651484,1,0
0,0,5,5,8,11,19,36,19,55,0.000333,0.077879,4,934.544053,51.919114,233.636013,62.053748,1,0
0,0,4,4,8,7,15,16,11,27,0.000333,0.035162,4,421.944184,23.441344,105.486046,43.651484,1,0
0,0,7,7,11,19,30,44,28,72,0.000333,0.117765,5,1766.480614,98.137812,353.296123,118.764371,2,0
0,0,7,7,11,19,30,44,28,72,0.000333,0.117765,5,1766.480614,98.137812,353.296123,118.764371,2,0
0,0,3,3,9,8,17,16,11,27,0.000333,0.036787,4,441.445987,24.524777,110.361497,52.529325,2,0
0,0,3,3,7,8,15,23,12,35,0.000333,0.04558,3,410.223513,22.790195,136.741171,43.651484,1,0
0,0,5,5,8,10,18,28,17,45,0.000333,0.062549,4,750.5865,41.69925,187.646625,57.219281,1,0
0,0,4,4,9,9,18,19,15,34,0.000333,0.047259,4,567.1098,31.5061,141.77745,57.05865,1,0
0,0,10,10,17,17,34,55,38,93,0.000333,0.157711,16,7570.144708,420.563595,473.134044,138.973737,4,0
0,0,9,9,15,19,34,68,35,103,0.000333,0.17467,7,3668.060709,203.78115,524.008673,139.313982,2,0
0,0,5,5,8,13,21,27,20,47,0.000333,0.068813,4,825.755675,45.875315,206.438919,72.105716,1,0
0,0,8,8,10,17,27,39,33,72,0.000333,0.114117,5,1711.759501,95.09775,342.3519,102.706149,1,0
0,0,4,4,9,8,17,21,14,35,0.000333,0.047687,4,572.244798,31.791378,143.061199,52.529325,1,0
0,0,5,5,7,7,14,17,13,30,0.000333,0.038074,3,342.661943,19.036775,114.220648,39.302969,1,0
0,0,3,3,8,8,16,20,12,32,0.000333,0.042667,4,512,28.444444,128,48,1,0
0,0,3,3,7,5,12,11,7,18,0.000333,0.02151,3,193.587975,10.754888,64.529325,31.261125,1,0
0,0,10,10,7,14,21,57,36,93,0.000333,0.136162,6,2450.913122,136.16184,408.48552,72.954453,1,0
0,0,10,10,7,14,21,57,36,93,0.000333,0.136162,6,2450.913122,136.16184,408.48552,72.954453,1,0
0,0,4,4,10,15,25,32,21,53,0.000333,0.082041,5,1230.62189,68.367883,246.124378,91.82264,1,0
0,0,9,9,15,19,34,68,35,103,0.000333,0.17467,7,3668.060709,203.78115,524.008673,139.313982,2,0
0,0,3,3,7,8,15,23,12,35,0.000333,0.04558,3,410.223513,22.790195,136.741171,43.651484,1,0
0,0,4,4,5,12,17,16,16,32,0.000333,0.0436,2,261.597622,14.533201,130.798811,54.62919,1,0
0,0,25,25,12,35,47,382,213,595,0.000333,1.10166,36,118979.2932,6609.960733,3304.980367,222.544456,4,0
0,0,5,5,11,12,23,33,21,54,0.000333,0.081424,5,1221.361728,67.853429,244.272346,81.073298,1,0
0,0,3,3,9,8,17,16,11,27,0.000333,0.036787,4,441.445987,24.524777,110.361497,52.529325,2,0
0,0,4,4,12,9,21,19,15,34,0.000333,0.04978,6,896.032754,49.779597,149.338792,71.548875,1,0
0,0,7,7,9,13,22,26,24,50,0.000333,0.074324,4,891.886324,49.54924,222.971581,76.635041,1,0
0,0,3,3,9,8,17,16,11,27,0.000333,0.036787,4,441.445987,24.524777,110.361497,52.529325,2,0
0,0,6,6,8,13,21,42,25,67,0.000333,0.098095,4,1177.141069,65.396726,294.285267,72.105716,1,0
0,0,5,5,10,10,20,27,14,41,0.000333,0.059066,5,885.995259,49.221959,177.199052,66.438562,3,0
0,0,4,4,8,11,19,27,17,44,0.000333,0.062303,4,747.635242,41.535291,186.908811,62.053748,1,0
0,0,4,4,4,7,11,13,11,24,0.000333,0.027675,2,166.052718,9.225151,83.026359,27.651484,3,0
0,0,4,4,5,7,12,14,10,24,0.000333,0.02868,2,172.0782,9.5599,86.0391,31.261125,2,0
0,0,10,10,16,20,36,55,45,100,0.000333,0.172331,16,8271.880002,459.548889,516.9925,150.438562,4,0
0,0,7,7,11,18,29,48,28,76,0.000333,0.123069,5,1846.032778,102.557377,369.206556,113.112398,1,0
0,0,4,4,9,10,19,28,18,46,0.000333,0.065135,4,781.618662,43.423259,195.404666,61.748606,1,0
0,0,5,5,10,10,20,27,14,41,0.000333,0.059066,5,885.995259,49.221959,177.199052,66.438562,3,0
0,0,6,6,9,10,19,28,17,45,0.000333,0.063719,4,764.626952,42.479275,191.156738,61.748606,1,0
0,0,5,5,8,17,25,38,29,67,0.000333,0.103713,4,1244.553459,69.141859,311.138365,93.486868,1,0
0,0,3,3,8,15,23,23,21,44,0.000333,0.066346,4,796.146904,44.230384,199.036726,82.603359,1,0
0,0,3,3,9,8,17,16,11,27,0.000333,0.036787,4,441.445987,24.524777,110.361497,52.529325,2,0
0,0,5,5,11,11,22,31,17,48,0.000333,0.071351,5,1070.263588,59.459088,214.052718,76.107496,1,0
0,0,3,3,7,8,15,23,12,35,0.000333,0.04558,3,410.223513,22.790195,136.741171,43.651484,1,0
0,0,4,4,9,7,16,16,11,27,0.000333,0.036,4,432,24,108,48.180809,1,0
0,0,8,8,15,18,33,66,34,100,0.000333,0.168146,7,3531.075884,196.170882,504.439412,133.662009,2,0
0,0,3,3,9,8,17,16,11,27,0.000333,0.036787,4,441.445987,24.524777,110.361497,52.529325,2,0
0,0,6,6,7,11,18,41,25,66,0.000333,0.091738,6,1651.290301,91.73835,275.21505,57.705232,1,0
0,0,6,6,7,11,18,41,25,66,0.000333,0.091738,6,1651.290301,91.73835,275.21505,57.705232,1,0
0,0,4,4,10,15,25,32,21,53,0.000333,0.082041,5,1230.62189,68.367883,246.124378,91.82264,1,0
0,0,6,6,8,12,20,25,20,45,0.000333,0.064829,4,777.947057,43.219281,194.486764,67.01955,5,0
0,0,6,6,10,10,20,28,19,47,0.000333,0.06771,5,1015.653102,56.425172,203.13062,66.438562,1,0
0,0,10,10,7,14,21,57,36,93,0.000333,0.136162,6,2450.913122,136.16184,408.48552,72.954453,1,0
0,0,5,5,8,11,19,36,19,55,0.000333,0.077879,4,934.544053,51.919114,233.636013,62.053748,1,0
0,0,3,3,7,5,12,11,7,18,0.000333,0.02151,3,193.587975,10.754888,64.529325,31.261125,1,0
0,0,7,7,11,19,30,44,28,72,0.000333,0.117765,5,1766.480614,98.137812,353.296123,118.764371,2,0
0,0,8,8,12,16,28,42,30,72,0.000333,0.115377,6,2076.777326,115.376518,346.129554,107.01955,1,0
0,0,3,3,7,8,15,23,12,35,0.000333,0.04558,3,410.223513,22.790195,136.741171,43.651484,1,0
0,0,9,9,15,19,34,68,35,103,0.000333,0.17467,7,3668.060709,203.78115,524.008673,139.313982,2,0
0,0,8,8,15,18,33,66,34,100,0.000333,0.168146,7,3531.075884,196.170882,504.439412,133.662009,2,0
0,0,3,3,7,6,13,9,8,17,0.000333,0.020969,3,188.722426,10.484579,62.907475,35.161259,1,0
0,0,11,11,15,21,36,84,43,127,0.000333,0.21886,14,9192.126653,510.673703,656.580475,150.842025,2,0
0,0,3,3,7,5,12,11,7,18,0.000333,0.02151,3,193.587975,10.754888,64.529325,31.261125,1,0
0,0,5,5,8,10,18,28,17,45,0.000333,0.062549,4,750.5865,41.69925,187.646625,57.219281,1,0
0,0,6,6,9,10,19,28,17,45,0.000333,0.063719,4,764.626952,42.479275,191.156738,61.748606,1,0
0,0,7,7,8,15,23,21,28,49,0.000333,0.073885,4,886.618143,49.256564,221.654536,82.603359,1,0
0,0,3,3,7,5,12,11,7,18,0.000333,0.02151,3,193.587975,10.754888,64.529325,31.261125,1,0
0,0,4,4,5,12,17,16,16,32,0.000333,0.0436,2,261.597622,14.533201,130.798811,54.62919,1,0
0,0,4,4,7,9,16,46,28,74,0.000333,0.098667,9,2664,148,296,48.180809,1,0
0,0,9,9,15,19,34,68,35,103,0.000333,0.17467,7,3668.060709,203.78115,524.008673,139.313982,2,0
0,0,4,4,4,7,11,13,11,24,0.000333,0.027675,2,166.052718,9.225151,83.026359,27.651484,3,0
0,0,5,5,8,10,18,26,15,41,0.000333,0.056989,4,683.8677,37.99265,170.966925,57.219281,1,0
0,0,4,4,10,15,25,32,21,53,0.000333,0.082041,5,1230.62189,68.367883,246.124378,91.82264,1,0
0,0,9,9,15,19,34,68,35,103,0.000333,0.17467,7,3668.060709,203.78115,524.008673,139.313982,2,0
0,0,5,5,11,12,23,33,21,54,0.000333,0.081424,5,1221.361728,67.853429,244.272346,81.073298,1,0
0,0,5,5,7,10,17,19,16,35,0.000333,0.047687,3,429.183598,23.843533,143.061199,52.870765,3,0
0,0,5,5,8,11,19,30,18,48,0.000333,0.067967,4,815.602083,45.311227,203.900521,62.053748,1,0
0,0,7,7,11,19,30,44,28,72,0.000333,0.117765,5,1766.480614,98.137812,353.296123,118.764371,2,0
0,0,5,5,8,10,18,28,17,45,0.000333,0.062549,4,750.5865,41.69925,187.646625,57.219281,1,0
0,0,3,3,9,8,17,16,11,27,0.000333,0.036787,4,441.445987,24.524777,110.361497,52.529325,2,0
0,0,3,3,8,7,15,20,12,32,0.000333,0.041673,4,500.081996,27.782333,125.020499,43.651484,1,0
0,0,25,25,12,35,47,382,213,595,0.000333,1.10166,36,118979.2932,6609.960733,3304.980367,222.544456,4,0
0,0,5,5,11,12,23,33,21,54,0.000333,0.081424,5,1221.361728,67.853429,244.272346,81.073298,1,0
0,0,4,4,10,9,19,22,13,35,0.000333,0.049559,5,743.387315,41.299295,148.677463,61.748606,1,0
0,0,4,4,6,8,14,17,12,29,0.000333,0.036804,3,331.239878,18.402215,110.413293,39.509775,3,0
0,0,7,7,11,19,30,44,28,72,0.000333,0.117765,5,1766.480614,98.137812,353.296123,118.764371,2,0
0,0,5,5,8,8,16,26,16,42,0.000333,0.056,8,1344,74.666667,168,48,1,0
0,0,9,9,15,19,34,68,35,103,0.000333,0.17467,7,3668.060709,203.78115,524.008673,139.313982,2,0
0,0,11,11,15,21,36,84,43,127,0.000333,0.21886,14,9192.126653,510.673703,656.580475,150.842025,2,0
0,0,8,8,15,18,33,66,34,100,0.000333,0.168146,7,3531.075884,196.170882,504.439412,133.662009,2,0
0,0,12,12,16,17,33,68,49,117,0.000333,0.196731,16,9443.105791,524.616988,590.194112,133.486868,5,0
0,0,4,4,7,6,13,14,9,23,0.000333,0.02837,3,255.330341,14.185019,85.110114,35.161259,1,0
0,0,14,14,11,23,34,85,48,133,0.000333,0.225544,10,6766.325579,375.906977,676.632558,142.095673,1,0
0,0,11,11,15,21,36,84,43,127,0.000333,0.21886,14,9192.126653,510.673703,656.580475,150.842025,2,0
0,0,5,5,9,8,17,29,19,48,0.000333,0.065399,8,1569.585731,87.199207,196.198216,52.529325,1,0
0,0,5,5,8,10,18,28,17,45,0.000333,0.062549,4,750.5865,41.69925,187.646625,57.219281,1,0
0,0,3,3,8,7,15,11,9,20,0.000333,0.026046,4,312.551248,17.363958,78.137812,43.651484,1,0
0,0,5,5,11,15,26,30,23,53,0.000333,0.083041,5,1245.616525,69.200918,249.123305,96.657107,1,0
0,0,3,3,7,5,12,11,7,18,0.000333,0.02151,3,193.587975,10.754888,64.529325,31.261125,1,0
0,0,9,9,9,18,27,37,42,79,0.000333,0.125212,8,3005.088901,166.949383,375.636113,103.587975,1,0
0,0,6,6,10,11,21,24,21,45,0.000333,0.065885,5,988.27142,54.903968,197.654284,71.273029,1,0
0,0,5,5,7,10,17,19,16,35,0.000333,0.047687,3,429.183598,23.843533,143.061199,52.870765,3,0
0,0,5,5,10,11,21,29,17,46,0.000333,0.067349,5,1010.233007,56.124056,202.046601,71.273029,1,0
0,0,4,4,11,10,21,24,14,38,0.000333,0.055636,5,834.54031,46.363351,166.908062,71.273029,3,0
0,0,4,4,4,7,11,13,11,24,0.000333,0.027675,2,166.052718,9.225151,83.026359,27.651484,3,0
0,0,7,7,11,19,30,44,28,72,0.000333,0.117765,5,1766.480614,98.137812,353.296123,118.764371,2,0
0,0,8,8,15,18,33,66,34,100,0.000333,0.168146,7,3531.075884,196.170882,504.439412,133.662009,2,0
0,0,11,11,15,21,36,84,43,127,0.000333,0.21886,14,9192.126653,510.673703,656.580475,150.842025,2,0
0,0,3,3,7,5,12,11,7,18,0.000333,0.02151,3,193.587975,10.754888,64.529325,31.261125,1,0
0,0,4,4,5,11,16,13,14,27,0.000333,0.036,2,216,12,108,49.663388,1,0
0,0,6,6,9,10,19,28,17,45,0.000333,0.063719,4,764.626952,42.479275,191.156738,61.748606,1,0
0,0,8,8,8,15,23,30,28,58,0.000333,0.087456,4,1049.466374,58.303687,262.366593,82.603359,1,0
0,0,7,7,11,19,30,44,28,72,0.000333,0.117765,5,1766.480614,98.137812,353.296123,118.764371,2,0
0,0,3,3,8,7,15,15,9,24,0.000333,0.031255,4,375.061497,20.83675,93.765374,43.651484,3,0
0,0,4,4,6,8,14,17,12,29,0.000333,0.036804,3,331.239878,18.402215,110.413293,39.509775,3,0
0,0,6,6,8,12,20,23,20,43,0.000333,0.061948,4,743.371632,41.298424,185.842908,67.01955,3,0
0,0,3,3,5,6,11,9,8,17,0.000333,0.019603,2,117.620675,6.534482,58.810338,27.119415,1,0
0,0,7,7,11,19,30,44,28,72,0.000333,0.117765,5,1766.480614,98.137812,353.296123,118.764371,2,0
0,0,3,3,7,8,15,23,12,35,0.000333,0.04558,3,410.223513,22.790195,136.741171,43.651484,1,0
0,0,6,6,9,10,19,28,17,45,0.000333,0.063719,4,764.626952,42.479275,191.156738,61.748606,1,0
0,0,9,9,15,20,35,72,36,108,0.000333,0.184654,7,3877.737961,215.429887,553.962566,145.041921,2,0
0,0,8,8,15,18,33,66,34,100,0.000333,0.168146,7,3531.075884,196.170882,504.439412,133.662009,2,0
0,0,3,3,7,8,15,23,12,35,0.000333,0.04558,3,410.223513,22.790195,136.741171,43.651484,1,0
0,0,5,5,9,8,17,23,18,41,0.000333,0.055862,8,1340.687812,74.482656,167.585976,52.529325,1,0
0,0,4,4,5,7,12,14,10,24,0.000333,0.02868,2,172.0782,9.5599,86.0391,31.261125,2,0
0,0,5,5,8,11,19,36,19,55,0.000333,0.077879,4,934.544053,51.919114,233.636013,62.053748,1,0
0,0,3,3,7,8,15,23,12,35,0.000333,0.04558,3,410.223513,22.790195,136.741171,43.651484,1,0
0,0,3,3,7,8,15,23,12,35,0.000333,0.04558,3,410.223513,22.790195,136.741171,43.651484,1,0
0,0,5,5,7,8,15,17,12,29,0.000333,0.037767,3,339.899482,18.883305,113.299827,43.651484,1,0
0,0,3,3,8,8,16,20,12,32,0.000333,0.042667,4,512,28.444444,128,48,1,0
0,0,5,5,9,9,18,34,14,48,0.000333,0.066719,4,800.6256,44.4792,200.1564,57.05865,3,0
0,0,3,3,8,8,16,20,12,32,0.000333,0.042667,4,512,28.444444,128,48,1,0
0,0,5,5,8,10,18,28,17,45,0.000333,0.062549,4,750.5865,41.69925,187.646625,57.219281,1,0
0,0,5,5,8,10,18,28,17,45,0.000333,0.062549,4,750.5865,41.69925,187.646625,57.219281,1,0
0,0,5,5,8,8,16,19,12,31,0.000333,0.041333,4,496,27.555556,124,48,1,0
0,0,4,4,11,10,21,36,17,53,0.000333,0.077598,5,1163.964117,64.664673,232.792823,71.273029,1,0
0,0,7,7,11,19,30,44,28,72,0.000333,0.117765,5,1766.480614,98.137812,353.296123,118.764371,2,0
0,0,4,4,4,7,11,13,11,24,0.000333,0.027675,2,166.052718,9.225151,83.026359,27.651484,3,0
0,0,3,3,8,6,14,11,9,20,0.000333,0.025382,4,304.588394,16.921577,76.147098,39.509775,1,0
0,0,11,11,13,17,30,62,47,109,0.000333,0.178284,12,6418.212899,356.567383,534.851075,117.592585,1,0
0,0,4,4,8,7,15,15,10,25,0.000333,0.032557,4,390.68906,21.704948,97.672265,43.651484,1,0
0,0,3,3,6,10,16,25,13,38,0.000333,0.050667,3,456,25.333333,152,48.729056,1,0
0,0,5,5,8,11,19,36,19,55,0.000333,0.077879,4,934.544053,51.919114,233.636013,62.053748,1,0
0,0,7,7,9,15,24,27,27,54,0.000333,0.082529,4,990.3519,55.01955,247.587975,87.132684,1,0
0,0,5,5,8,8,16,19,12,31,0.000333,0.041333,4,496,27.555556,124,48,1,0
0,0,6,6,13,11,24,38,23,61,0.000333,0.093228,12,3356.192551,186.455142,279.682713,86.159464,4,0
0,0,7,7,13,12,25,52,32,84,0.000333,0.130028,12,4681.007039,260.055947,390.08392,91.125266,7,0
0,0,18,18,11,28,39,115,64,179,0.000333,0.315362,10,9460.869972,525.603887,946.086997,172.659686,5,0
0,0,3,3,7,8,15,23,12,35,0.000333,0.04558,3,410.223513,22.790195,136.741171,43.651484,1,0
0,0,5,5,7,12,19,32,22,54,0.000333,0.076463,3,688.164257,38.231348,229.388086,62.671034,1,0
0,0,6,6,7,13,20,35,24,59,0.000333,0.084998,3,764.981273,42.49896,254.993758,67.757201,1,0
0,0,25,25,12,35,47,382,213,595,0.000333,1.10166,36,118979.2932,6609.960733,3304.980367,222.544456,4,0
0,0,5,5,11,12,23,33,21,54,0.000333,0.081424,5,1221.361728,67.853429,244.272346,81.073298,1,0
0,0,8,8,15,18,33,66,34,100,0.000333,0.168146,7,3531.075884,196.170882,504.439412,133.662009,2,0
0,0,8,8,15,18,33,66,34,100,0.000333,0.168146,7,3531.075884,196.170882,504.439412,133.662009,2,0
0,0,11,11,15,21,36,84,43,127,0.000333,0.21886,14,9192.126653,510.673703,656.580475,150.842025,2,0
0,0,7,7,11,19,30,44,28,72,0.000333,0.117765,5,1766.480614,98.137812,353.296123,118.764371,2,0
0,0,11,11,15,21,36,84,43,127,0.000333,0.21886,14,9192.126653,510.673703,656.580475,150.842025,2,0
0,0,3,3,9,7,16,19,11,30,0.000333,0.04,4,480,26.666667,120,48.180809,1,0
0,0,8,8,15,18,33,66,34,100,0.000333,0.168146,7,3531.075884,196.170882,504.439412,133.662009,2,0
0,0,3,3,7,5,12,11,7,18,0.000333,0.02151,3,193.587975,10.754888,64.529325,31.261125,1,0
0,0,7,7,11,18,29,48,28,76,0.000333,0.123069,5,1846.032778,102.557377,369.206556,113.112398,1,0
0,0,3,3,7,8,15,23,12,35,0.000333,0.04558,3,410.223513,22.790195,136.741171,43.651484,1,0
0,0,5,5,10,10,20,27,14,41,0.000333,0.059066,5,885.995259,49.221959,177.199052,66.438562,3,0
0,0,7,7,11,19,30,44,28,72,0.000333,0.117765,5,1766.480614,98.137812,353.296123,118.764371,2,0
0,0,5,5,7,9,16,19,16,35,0.000333,0.046667,3,420,23.333333,140,48.180809,2,0
0,0,3,3,10,7,17,22,12,34,0.000333,0.046325,5,694.868683,38.603816,138.973737,52.870765,1,0
0,0,5,5,8,9,17,25,15,40,0.000333,0.0545,4,653.994055,36.333003,163.498514,52.529325,1,0
0,0,3,3,7,8,15,23,12,35,0.000333,0.04558,3,410.223513,22.790195,136.741171,43.651484,1,0
0,0,5,5,10,11,21,33,18,51,0.000333,0.074669,5,1120.040943,62.224497,224.008189,71.273029,1,0
0,0,9,9,15,19,34,68,35,103,0.000333,0.17467,7,3668.060709,203.78115,524.008673,139.313982,2,0
0,0,4,4,11,15,26,25,19,44,0.000333,0.06894,5,1034.096738,57.449819,206.819348,96.657107,2,0
0,0,5,5,7,16,23,31,26,57,0.000333,0.085948,3,773.529094,42.973839,257.843031,83.651484,1,0
0,0,11,11,8,18,26,71,42,113,0.000333,0.17705,8,4249.197505,236.066528,531.149688,99.05865,8,0
0,0,12,12,7,18,25,72,44,116,0.000333,0.179562,6,3232.123908,179.562439,538.687318,94.710134,12,0
0,0,3,3,7,8,15,23,12,35,0.000333,0.04558,3,410.223513,22.790195,136.741171,43.651484,1,0
0,0,6,6,8,10,18,25,21,46,0.000333,0.063939,8,1534.532401,85.2518,191.81655,57.219281,1,0
0,0,5,5,8,11,19,30,18,48,0.000333,0.067967,4,815.602083,45.311227,203.900521,62.053748,1,0
0,0,3,3,10,10,20,16,13,29,0.000333,0.041779,5,626.679574,34.815532,125.335915,66.438562,1,0
0,0,6,6,9,12,21,34,21,55,0.000333,0.080526,4,966.309833,53.68388,241.577458,71.548875,1,0
0,0,5,5,8,12,20,25,19,44,0.000333,0.063388,4,760.659345,42.258852,190.164836,67.01955,1,0
0,0,5,5,8,11,19,30,18,48,0.000333,0.067967,4,815.602083,45.311227,203.900521,62.053748,1,0
0,0,3,3,8,7,15,11,9,20,0.000333,0.026046,4,312.551248,17.363958,78.137812,43.651484,1,0
0,0,7,7,11,19,30,44,28,72,0.000333,0.117765,5,1766.480614,98.137812,353.296123,118.764371,2,0
0,0,6,6,9,10,19,28,17,45,0.000333,0.063719,4,764.626952,42.479275,191.156738,61.748606,1,0
0,0,4,4,4,7,11,13,11,24,0.000333,0.027675,2,166.052718,9.225151,83.026359,27.651484,3,0
0,0,3,3,9,8,17,16,10,26,0.000333,0.035425,4,425.096135,23.616452,106.274034,52.529325,3,0
0,0,11,11,9,19,28,76,52,128,0.000333,0.205114,8,4922.73144,273.48508,615.34143,109.239948,1,0
0,0,5,5,8,10,18,26,15,41,0.000333,0.056989,4,683.8677,37.99265,170.966925,57.219281,1,0
0,0,7,7,9,17,26,46,36,82,0.000333,0.128479,8,3083.488455,171.304914,385.436057,98.016193,1,0
0,0,5,5,8,10,18,26,15,41,0.000333,0.056989,4,683.8677,37.99265,170.966925,57.219281,1,0
0,0,5,5,8,10,18,28,17,45,0.000333,0.062549,4,750.5865,41.69925,187.646625,57.219281,1,0
0,0,5,5,11,12,23,33,21,54,0.000333,0.081424,5,1221.361728,67.853429,244.272346,81.073298,1,0
0,0,25,25,12,35,47,382,213,595,0.000333,1.10166,36,118979.2932,6609.960733,3304.980367,222.544456,4,0
0,0,3,3,8,6,14,11,9,20,0.000333,0.025382,4,304.588394,16.921577,76.147098,39.509775,1,0
0,0,4,4,9,7,16,17,12,29,0.000333,0.038667,4,464,25.777778,116,48.180809,1,0
0,0,7,7,10,16,26,41,28,69,0.000333,0.10811,5,1621.651703,90.091761,324.330341,97.219281,1,0
0,0,5,5,8,10,18,28,17,45,0.000333,0.062549,4,750.5865,41.69925,187.646625,57.219281,1,0
0,0,5,5,10,11,21,33,18,51,0.000333,0.074669,5,1120.040943,62.224497,224.008189,71.273029,1,0
0,0,9,9,11,15,26,63,38,101,0.000333,0.158248,10,4747.444115,263.746895,474.744412,96.657107,1,0
0,0,5,5,11,12,23,33,21,54,0.000333,0.081424,5,1221.361728,67.853429,244.272346,81.073298,1,0
0,0,9,9,10,18,28,31,41,72,0.000333,0.115377,10,3461.295544,192.294197,346.129554,108.277931,1,0
0,0,3,3,8,8,16,20,12,32,0.000333,0.042667,4,512,28.444444,128,48,1,0
0,0,3,3,8,6,14,11,9,20,0.000333,0.025382,4,304.588394,16.921577,76.147098,39.509775,1,0
0,0,3,3,7,5,12,11,7,18,0.000333,0.02151,3,193.587975,10.754888,64.529325,31.261125,1,0
0,0,4,4,10,15,25,32,21,53,0.000333,0.082041,5,1230.62189,68.367883,246.124378,91.82264,1,0
0,0,4,4,6,8,14,17,12,29,0.000333,0.036804,3,331.239878,18.402215,110.413293,39.509775,3,0
0,0,3,3,7,5,12,11,7,18,0.000333,0.02151,3,193.587975,10.754888,64.529325,31.261125,1,0
0,0,7,7,14,15,29,42,31,73,0.000333,0.118211,14,4964.856577,275.825365,354.632613,111.906328,4,0
0,0,3,3,7,8,15,23,12,35,0.000333,0.04558,3,410.223513,22.790195,136.741171,43.651484,1,0
0,0,4,4,6,9,15,14,12,26,0.000333,0.03386,3,304.737466,16.929859,101.579155,44.0391,1,0
0,0,6,6,9,10,19,28,17,45,0.000333,0.063719,4,764.626952,42.479275,191.156738,61.748606,1,0
0,0,4,4,7,9,16,46,28,74,0.000333,0.098667,9,2664,148,296,48.180809,1,0
0,0,3,3,7,5,12,11,7,18,0.000333,0.02151,3,193.587975,10.754888,64.529325,31.261125,1,0
0,0,5,5,11,11,22,31,17,48,0.000333,0.071351,5,1070.263588,59.459088,214.052718,76.107496,1,0
0,0,3,3,9,8,17,16,11,27,0.000333,0.036787,4,441.445987,24.524777,110.361497,52.529325,2,0
0,0,5,5,7,7,14,16,11,27,0.000333,0.034266,3,308.395749,17.133097,102.798583,39.302969,1,0
0,0,8,8,15,18,33,66,34,100,0.000333,0.168146,7,3531.075884,196.170882,504.439412,133.662009,2,0
0,0,4,4,8,9,17,24,13,37,0.000333,0.050412,4,604.944501,33.608028,151.236125,52.529325,1,0
0,0,4,4,4,7,11,13,11,24,0.000333,0.027675,2,166.052718,9.225151,83.026359,27.651484,3,0
0,0,4,4,4,7,11,13,11,24,0.000333,0.027675,2,166.052718,9.225151,83.026359,27.651484,3,0
0,0,4,4,9,9,18,19,15,34,0.000333,0.047259,4,567.1098,31.5061,141.77745,57.05865,1,0
0,0,25,25,12,35,47,382,213,595,0.000333,1.10166,36,118979.2932,6609.960733,3304.980367,222.544456,4,0
0,0,9,9,15,19,34,68,35,103,0.000333,0.17467,7,3668.060709,203.78115,524.008673,139.313982,2,0
0,0,4,4,5,7,12,14,10,24,0.000333,0.02868,2,172.0782,9.5599,86.0391,31.261125,2,0
0,0,7,7,11,19,30,44,28,72,0.000333,0.117765,5,1766.480614,98.137812,353.296123,118.764371,2,0
0,0,8,8,12,16,28,38,29,67,0.000333,0.107364,6,1932.556679,107.36426,322.09278,107.01955,1,0
0,0,4,4,10,15,25,32,21,53,0.000333,0.082041,5,1230.62189,68.367883,246.124378,91.82264,1,0
0,0,10,10,9,15,24,43,35,78,0.000333,0.119209,8,2861.0166,158.945367,357.627075,87.132684,1,0
0,0,6,6,8,10,18,30,21,51,0.000333,0.070889,8,1701.329401,94.5183,212.666175,57.219281,1,0
0,0,9,9,11,15,26,54,26,80,0.000333,0.125345,5,1880.175887,104.454216,376.035177,96.657107,4,0
0,0,5,5,7,7,14,16,11,27,0.000333,0.034266,3,308.395749,17.133097,102.798583,39.302969,1,0
0,0,3,3,9,8,17,16,11,27,0.000333,0.036787,4,441.445987,24.524777,110.361497,52.529325,2,0
0,0,7,7,11,19,30,44,28,72,0.000333,0.117765,5,1766.480614,98.137812,353.296123,118.764371,2,0
0,0,3,3,8,7,15,15,9,24,0.000333,0.031255,4,375.061497,20.83675,93.765374,43.651484,3,0
0,0,4,4,4,7,11,13,11,24,0.000333,0.027675,2,166.052718,9.225151,83.026359,27.651484,3,0
0,0,5,5,8,10,18,28,17,45,0.000333,0.062549,4,750.5865,41.69925,187.646625,57.219281,1,0
0,0,5,5,10,12,22,22,17,39,0.000333,0.057973,5,869.589166,48.310509,173.917833,76.238831,1,0
0,0,5,5,11,12,23,33,21,54,0.000333,0.081424,5,1221.361728,67.853429,244.272346,81.073298,1,0
0,0,25,25,12,35,47,382,213,595,0.000333,1.10166,36,118979.2932,6609.960733,3304.980367,222.544456,4,0
0,0,3,3,5,5,10,12,7,19,0.000333,0.021039,2,126.233268,7.012959,63.116634,23.219281,1,0
0,0,7,7,11,19,30,44,28,72,0.000333,0.117765,5,1766.480614,98.137812,353.296123,118.764371,2,0
0,0,4,4,6,10,16,13,13,26,0.000333,0.034667,3,312,17.333333,104,48.729056,1,0
0,0,8,8,15,18,33,66,34,100,0.000333,0.168146,7,3531.075884,196.170882,504.439412,133.662009,2,0
0,0,9,9,8,14,22,38,32,70,0.000333,0.104053,8,2497.281706,138.737873,312.160213,77.302969,1,0
0,0,3,3,10,8,18,16,13,29,0.000333,0.040309,5,604.639125,33.591063,120.927825,57.219281,3,0
0,0,8,8,15,18,33,66,34,100,0.000333,0.168146,7,3531.075884,196.170882,504.439412,133.662009,2,0
0,0,4,4,4,7,11,13,11,24,0.000333,0.027675,2,166.052718,9.225151,83.026359,27.651484,3,0
0,0,6,6,9,10,19,28,17,45,0.000333,0.063719,4,764.626952,42.479275,191.156738,61.748606,1,0
0,0,5,5,12,13,25,28,18,46,0.000333,0.071206,6,1281.704308,71.205795,213.617385,91.125266,3,0
0,0,3,3,7,5,12,11,7,18,0.000333,0.02151,3,193.587975,10.754888,64.529325,31.261125,1,0
0,0,3,3,8,7,15,11,9,20,0.000333,0.026046,4,312.551248,17.363958,78.137812,43.651484,1,0
0,0,3,3,8,8,16,20,12,32,0.000333,0.042667,4,512,28.444444,128,48,1,0
0,0,4,4,6,5,11,24,12,36,0.000333,0.041513,6,747.23723,41.513179,124.539538,27.119415,1,0
0,0,3,3,7,8,15,23,12,35,0.000333,0.04558,3,410.223513,22.790195,136.741171,43.651484,1,0
0,0,3,3,6,5,11,11,9,20,0.000333,0.023063,3,207.565897,11.531439,69.188632,27.119415,1,0
0,0,5,5,10,11,21,29,17,46,0.000333,0.067349,5,1010.233007,56.124056,202.046601,71.273029,1,0
0,0,5,5,8,8,16,19,12,31,0.000333,0.041333,4,496,27.555556,124,48,1,0
0,0,7,7,10,16,26,49,38,87,0.000333,0.136313,10,4089.382555,227.18792,408.938255,97.219281,2,0
0,0,3,3,8,8,16,20,12,32,0.000333,0.042667,4,512,28.444444,128,48,1,0
0,0,3,3,8,8,16,20,12,32,0.000333,0.042667,4,512,28.444444,128,48,1,0
0,0,4,4,8,11,19,27,17,44,0.000333,0.062303,4,747.635242,41.535291,186.908811,62.053748,1,0
0,0,4,4,4,7,11,13,11,24,0.000333,0.027675,2,166.052718,9.225151,83.026359,27.651484,3,0
0,0,4,4,10,15,25,32,21,53,0.000333,0.082041,5,1230.62189,68.367883,246.124378,91.82264,1,0
0,0,5,5,10,11,21,29,17,46,0.000333,0.067349,5,1010.233007,56.124056,202.046601,71.273029,1,0
0,0,3,3,9,8,17,16,11,27,0.000333,0.036787,4,441.445987,24.524777,110.361497,52.529325,2,0
0,0,5,5,10,12,22,21,17,38,0.000333,0.056486,5,847.292008,47.071778,169.458402,76.238831,1,0
0,0,3,3,7,8,15,23,12,35,0.000333,0.04558,3,410.223513,22.790195,136.741171,43.651484,1,0
0,0,5,5,10,10,20,27,14,41,0.000333,0.059066,5,885.995259,49.221959,177.199052,66.438562,3,0
0,0,5,5,8,13,21,22,19,41,0.000333,0.060028,4,720.340057,40.018892,180.085014,72.105716,1,0
0,0,9,9,12,17,29,49,34,83,0.000333,0.134404,12,4838.549071,268.808282,403.212423,112.506418,1,0
0,0,9,9,15,19,34,68,35,103,0.000333,0.17467,7,3668.060709,203.78115,524.008673,139.313982,2,0
0,0,11,11,15,21,36,84,43,127,0.000333,0.21886,14,9192.126653,510.673703,656.580475,150.842025,2,0
0,0,3,3,9,8,17,16,11,27,0.000333,0.036787,4,441.445987,24.524777,110.361497,52.529325,2,0
0,0,4,4,4,7,11,13,11,24,0.000333,0.027675,2,166.052718,9.225151,83.026359,27.651484,2,0
0,0,3,3,8,8,16,20,12,32,0.000333,0.042667,4,512,28.444444,128,48,1,0
0,0,4,4,4,7,11,13,11,24,0.000333,0.027675,2,166.052718,9.225151,83.026359,27.651484,3,0
0,0,4,4,11,10,21,24,14,38,0.000333,0.055636,5,834.54031,46.363351,166.908062,71.273029,3,0
0,0,4,4,6,8,14,17,12,29,0.000333,0.036804,3,331.239878,18.402215,110.413293,39.509775,3,0
0,0,4,4,11,10,21,24,14,38,0.000333,0.055636,5,834.54031,46.363351,166.908062,71.273029,3,0
0,0,3,3,8,7,15,20,12,32,0.000333,0.041673,4,500.081996,27.782333,125.020499,43.651484,1,0
0,0,5,5,10,11,21,29,17,46,0.000333,0.067349,5,1010.233007,56.124056,202.046601,71.273029,1,0
0,0,3,3,10,8,18,16,13,29,0.000333,0.040309,5,604.639125,33.591063,120.927825,57.219281,3,0
0,0,3,3,7,8,15,23,12,35,0.000333,0.04558,3,410.223513,22.790195,136.741171,43.651484,1,0
0,0,7,7,11,19,30,44,28,72,0.000333,0.117765,5,1766.480614,98.137812,353.296123,118.764371,2,0
0,0,4,4,8,7,15,16,11,27,0.000333,0.035162,4,421.944184,23.441344,105.486046,43.651484,1,0
0,0,9,9,15,19,34,68,35,103,0.000333,0.17467,7,3668.060709,203.78115,524.008673,139.313982,2,0
0,0,8,8,15,18,33,66,34,100,0.000333,0.168146,7,3531.075884,196.170882,504.439412,133.662009,2,0
0,0,4,4,6,8,14,17,12,29,0.000333,0.036804,3,331.239878,18.402215,110.413293,39.509775,3,0
0,0,11,11,15,21,36,84,43,127,0.000333,0.21886,14,9192.126653,510.673703,656.580475,150.842025,2,0
0,0,5,5,7,11,18,15,15,30,0.000333,0.041699,3,375.29325,20.849625,125.09775,57.705232,1,0
0,0,4,4,11,16,27,27,21,48,0.000333,0.076078,5,1141.173001,63.3985,228.2346,102.053748,2,0
0,0,6,6,10,15,25,28,27,55,0.000333,0.085137,5,1277.060452,70.947803,255.41209,91.82264,1,0
0,0,7,7,11,19,30,44,28,72,0.000333,0.117765,5,1766.480614,98.137812,353.296123,118.764371,2,0
0,0,3,3,10,8,18,16,13,29,0.000333,0.040309,5,604.639125,33.591063,120.927825,57.219281,3,0
0,0,4,4,6,12,18,16,15,31,0.000333,0.043089,3,387.803025,21.544613,129.267675,58.529325,1,0
0,0,6,6,8,9,17,21,16,37,0.000333,0.050412,4,604.944501,33.608028,151.236125,52.529325,1,0
0,0,5,5,7,7,14,16,11,27,0.000333,0.034266,3,308.395749,17.133097,102.798583,39.302969,1,0
0,0,3,3,9,13,22,20,16,36,0.000333,0.053513,4,642.158153,35.675453,160.539538,76.635041,3,0
0,0,3,3,7,8,15,23,12,35,0.000333,0.04558,3,410.223513,22.790195,136.741171,43.651484,1,0
0,0,3,3,8,8,16,20,12,32,0.000333,0.042667,4,512,28.444444,128,48,1,0
0,0,13,13,12,19,31,73,44,117,0.000333,0.193214,12,6955.69162,386.427312,579.640968,123.730173,2,0
0,0,4,4,6,8,14,17,12,29,0.000333,0.036804,3,331.239878,18.402215,110.413293,39.509775,3,0
0,0,5,5,8,10,18,26,15,41,0.000333,0.056989,4,683.8677,37.99265,170.966925,57.219281,1,0
0,0,9,9,10,12,22,32,29,61,0.000333,0.090675,10,2720.253287,151.125183,272.025329,76.238831,1,0
0,0,8,8,13,14,27,39,29,68,0.000333,0.107777,12,3879.988202,215.5549,323.33235,101.408685,1,0
0,0,4,4,6,9,15,16,12,28,0.000333,0.036464,3,328.17881,18.232156,109.392937,44.0391,1,0
0,0,19,19,15,29,44,123,76,199,0.000333,0.362142,14,15209.97649,844.998694,1086.426892,199.484808,2,0
0,0,36,36,16,62,78,272,185,457,0.000333,0.957476,16,45958.86102,2553.270057,2872.428814,433.160171,4,0
0,0,3,3,8,7,15,20,12,32,0.000333,0.041673,4,500.081996,27.782333,125.020499,43.651484,1,0
0,0,3,3,8,7,15,11,9,20,0.000333,0.026046,4,312.551248,17.363958,78.137812,43.651484,1,0
0,0,3,3,9,8,17,16,11,27,0.000333,0.036787,4,441.445987,24.524777,110.361497,52.529325,2,0
0,0,5,5,10,11,21,33,18,51,0.000333,0.074669,5,1120.040943,62.224497,224.008189,71.273029,1,0
0,0,4,4,10,16,26,28,22,50,0.000333,0.078341,5,1175.10993,65.283885,235.021986,97.219281,1,0
0,0,3,3,7,5,12,11,7,18,0.000333,0.02151,3,193.587975,10.754888,64.529325,31.261125,1,0
0,0,3,3,8,10,18,20,14,34,0.000333,0.047259,4,567.1098,31.5061,141.77745,57.219281,1,0
0,0,4,4,9,9,18,19,15,34,0.000333,0.047259,4,567.1098,31.5061,141.77745,57.05865,1,0
0,0,4,4,4,7,11,13,11,24,0.000333,0.027675,2,166.052718,9.225151,83.026359,27.651484,3,0
0,0,5,5,11,12,23,33,21,54,0.000333,0.081424,5,1221.361728,67.853429,244.272346,81.073298,1,0
0,0,25,25,12,35,47,382,213,595,0.000333,1.10166,36,118979.2932,6609.960733,3304.980367,222.544456,4,0
0,0,8,8,16,17,33,49,35,84,0.000333,0.141243,16,6779.665696,376.648094,423.729106,133.486868,4,0
0,0,6,6,10,11,21,24,21,45,0.000333,0.065885,5,988.27142,54.903968,197.654284,71.273029,1,0
0,0,4,4,4,7,11,13,11,24,0.000333,0.027675,2,166.052718,9.225151,83.026359,27.651484,2,0
0,0,5,5,9,8,17,29,19,48,0.000333,0.065399,8,1569.585731,87.199207,196.198216,52.529325,1,0
0,0,5,5,8,11,19,36,19,55,0.000333,0.077879,4,934.544053,51.919114,233.636013,62.053748,1,0
0,0,15,15,15,23,38,93,55,148,0.000333,0.258898,14,10873.70581,604.094767,776.693272,162.645284,6,0
0,0,3,3,7,8,15,23,12,35,0.000333,0.04558,3,410.223513,22.790195,136.741171,43.651484,1,0
0,0,6,6,9,9,18,30,19,49,0.000333,0.068109,8,1634.610601,90.8117,204.326325,57.05865,1,0
0,0,4,4,4,7,11,13,11,24,0.000333,0.027675,2,166.052718,9.225151,83.026359,27.651484,3,0
0,0,4,4,6,5,11,24,12,36,0.000333,0.041513,6,747.23723,41.513179,124.539538,27.119415,1,0
0,0,5,5,7,7,14,19,13,32,0.000333,0.040612,3,365.506073,20.305893,121.835358,39.302969,1,0
0,0,4,4,5,9,14,15,13,28,0.000333,0.035535,2,213.211876,11.845104,106.605938,40.138965,1,0
0,0,3,3,8,7,15,11,9,20,0.000333,0.026046,4,312.551248,17.363958,78.137812,43.651484,1,0
0,0,3,3,7,8,15,23,12,35,0.000333,0.04558,3,410.223513,22.790195,136.741171,43.651484,1,0
0,0,4,4,5,13,18,14,16,30,0.000333,0.041699,2,250.1955,13.89975,125.09775,59.715357,1,0
0,0,3,3,7,6,13,12,8,20,0.000333,0.02467,3,222.026383,12.334799,74.008794,35.161259,1,0
0,0,4,4,4,7,11,13,11,24,0.000333,0.027675,2,166.052718,9.225151,83.026359,27.651484,3,0
0,0,4,4,6,12,18,19,17,36,0.000333,0.050039,3,450.3519,25.01955,150.1173,58.529325,1,0
0,0,9,9,15,19,34,68,35,103,0.000333,0.17467,7,3668.060709,203.78115,524.008673,139.313982,2,0
0,0,4,4,9,8,17,21,14,35,0.000333,0.047687,4,572.244798,31.791378,143.061199,52.529325,1,0
0,0,6,6,6,12,18,27,20,47,0.000333,0.065329,3,587.959425,32.664413,195.986475,58.529325,1,0
0,0,6,6,6,14,20,22,30,52,0.000333,0.074913,6,1348.441566,74.91342,224.740261,68.812744,1,0
0,0,9,9,9,15,24,31,38,69,0.000333,0.105454,8,2530.8993,140.605517,316.362413,87.132684,1,0
0,0,3,3,9,8,17,16,11,27,0.000333,0.036787,4,441.445987,24.524777,110.361497,52.529325,2,0
0,0,3,3,9,7,16,19,11,30,0.000333,0.04,4,480,26.666667,120,48.180809,4,0
0,0,4,4,5,7,12,14,10,24,0.000333,0.02868,2,172.0782,9.5599,86.0391,31.261125,2,0
0,0,10,10,14,18,32,51,39,90,0.000333,0.15,14,6300,350,450,128.361619,2,0
0,0,5,5,7,7,14,17,13,30,0.000333,0.038074,3,342.661943,19.036775,114.220648,39.302969,1,0
0,0,6,6,7,11,18,41,25,66,0.000333,0.091738,6,1651.290301,91.73835,275.21505,57.705232,1,0
0,0,4,4,6,8,14,17,12,29,0.000333,0.036804,3,331.239878,18.402215,110.413293,39.509775,3,0
0,0,7,7,11,19,30,44,28,72,0.000333,0.117765,5,1766.480614,98.137812,353.296123,118.764371,2,0
0,0,4,4,9,8,17,15,12,27,0.000333,0.036787,4,441.445987,24.524777,110.361497,52.529325,1,0
0,0,7,7,11,19,30,44,28,72,0.000333,0.117765,5,1766.480614,98.137812,353.296123,118.764371,2,0
0,0,13,13,13,22,35,97,52,149,0.000333,0.254754,12,9171.158034,509.50878,764.26317,146.213212,2,0
0,0,3,3,8,7,15,11,9,20,0.000333,0.026046,4,312.551248,17.363958,78.137812,43.651484,1,0
0,0,3,3,7,14,21,20,20,40,0.000333,0.058564,3,527.078091,29.282116,175.692697,72.954453,1,0
0,0,5,5,7,16,23,31,27,58,0.000333,0.087456,3,787.09978,43.727766,262.366593,83.651484,1,0
0,0,8,8,15,18,33,66,34,100,0.000333,0.168146,7,3531.075884,196.170882,504.439412,133.662009,2,0
0,0,5,5,8,11,19,36,19,55,0.000333,0.077879,4,934.544053,51.919114,233.636013,62.053748,1,0
0,0,11,11,15,21,36,84,43,127,0.000333,0.21886,14,9192.126653,510.673703,656.580475,150.842025,2,0
0,0,5,5,8,11,19,30,18,48,0.000333,0.067967,4,815.602083,45.311227,203.900521,62.053748,1,0
0,0,3,3,8,7,15,11,9,20,0.000333,0.026046,4,312.551248,17.363958,78.137812,43.651484,1,0
0,0,10,10,7,14,21,57,36,93,0.000333,0.136162,6,2450.913122,136.16184,408.48552,72.954453,1,0
0,0,4,4,5,7,12,14,10,24,0.000333,0.02868,2,172.0782,9.5599,86.0391,31.261125,2,0
0,0,4,4,5,12,17,16,16,32,0.000333,0.0436,2,261.597622,14.533201,130.798811,54.62919,1,0
0,0,4,4,4,7,11,13,11,24,0.000333,0.027675,2,166.052718,9.225151,83.026359,27.651484,3,0
0,0,5,5,8,8,16,19,12,31,0.000333,0.041333,4,496,27.555556,124,48,1,0
0,0,4,4,4,7,11,13,11,24,0.000333,0.027675,2,166.052718,9.225151,83.026359,27.651484,3,0
0,0,3,3,9,8,17,16,10,26,0.000333,0.035425,4,425.096135,23.616452,106.274034,52.529325,3,0
0,0,4,4,7,10,17,17,17,34,0.000333,0.046325,3,416.92121,23.162289,138.973737,52.870765,1,0
0,0,3,3,7,8,15,23,12,35,0.000333,0.04558,3,410.223513,22.790195,136.741171,43.651484,1,0
0,0,4,4,6,5,11,24,12,36,0.000333,0.041513,6,747.23723,41.513179,124.539538,27.119415,1,0
0,0,6,6,10,13,23,31,22,53,0.000333,0.079916,5,1198.743918,66.596884,239.748784,81.324997,1,0
0,0,7,7,9,16,25,24,30,54,0.000333,0.083589,4,1003.072937,55.726274,250.768234,92.529325,1,0
0,0,5,5,8,10,18,28,17,45,0.000333,0.062549,4,750.5865,41.69925,187.646625,57.219281,1,0
0,0,18,18,11,27,38,106,60,166,0.000333,0.290385,10,8711.559672,483.975537,871.155967,166.43571,3,0
0,0,7,7,11,19,30,44,28,72,0.000333,0.117765,5,1766.480614,98.137812,353.296123,118.764371,2,0
0,0,4,4,10,15,25,32,21,53,0.000333,0.082041,5,1230.62189,68.367883,246.124378,91.82264,1,0
0,0,4,4,10,15,25,32,21,53,0.000333,0.082041,5,1230.62189,68.367883,246.124378,91.82264,1,0
0,0,4,4,6,9,15,16,12,28,0.000333,0.036464,3,328.17881,18.232156,109.392937,44.0391,1,0
0,0,9,9,15,19,34,68,35,103,0.000333,0.17467,7,3668.060709,203.78115,524.008673,139.313982,2,0
0,0,3,3,10,8,18,16,13,29,0.000333,0.040309,5,604.639125,33.591063,120.927825,57.219281,3,0
0,0,5,5,7,14,21,22,20,42,0.000333,0.061492,3,553.431995,30.746222,184.477332,72.954453,1,0
0,0,5,5,12,14,26,31,21,52,0.000333,0.081474,6,1466.537192,81.474288,244.422865,96.322519,1,0
0,0,3,3,9,8,17,16,11,27,0.000333,0.036787,4,441.445987,24.524777,110.361497,52.529325,2,0
0,0,5,5,8,10,18,28,17,45,0.000333,0.062549,4,750.5865,41.69925,187.646625,57.219281,1,0
0,0,8,8,15,18,33,66,34,100,0.000333,0.168146,7,3531.075884,196.170882,504.439412,133.662009,2,0
0,0,11,11,15,21,36,84,43,127,0.000333,0.21886,14,9192.126653,510.673703,656.580475,150.842025,2,0
0,0,5,5,7,6,13,27,13,40,0.000333,0.049339,6,888.105532,49.339196,148.017589,35.161259,2,0
0,0,7,7,11,19,30,44,28,72,0.000333,0.117765,5,1766.480614,98.137812,353.296123,118.764371,2,0
0,0,5,5,8,11,19,36,19,55,0.000333,0.077879,4,934.544053,51.919114,233.636013,62.053748,1,0
0,0,3,3,7,5,12,11,7,18,0.000333,0.02151,3,193.587975,10.754888,64.529325,31.261125,1,0
0,0,3,3,7,8,15,23,12,35,0.000333,0.04558,3,410.223513,22.790195,136.741171,43.651484,1,0
0,0,9,9,15,19,34,68,35,103,0.000333,0.17467,7,3668.060709,203.78115,524.008673,139.313982,2,0
0,0,3,3,7,8,15,23,12,35,0.000333,0.04558,3,410.223513,22.790195,136.741171,43.651484,1,0
0,0,5,5,8,13,21,28,27,55,0.000333,0.080526,8,1932.619666,107.367759,241.577458,72.105716,1,0
0,0,25,25,12,35,47,382,213,595,0.000333,1.10166,36,118979.2932,6609.960733,3304.980367,222.544456,4,0
0,0,4,4,7,7,14,15,10,25,0.000333,0.031728,3,285.551619,15.863979,95.183873,39.302969,1,0
0,0,9,9,15,19,34,68,35,103,0.000333,0.17467,7,3668.060709,203.78115,524.008673,139.313982,2,0
0,0,8,8,15,18,33,66,34,100,0.000333,0.168146,7,3531.075884,196.170882,504.439412,133.662009,2,0
0,0,5,5,10,10,20,26,15,41,0.000333,0.059066,5,885.995259,49.221959,177.199052,66.438562,1,0
0,0,11,11,15,21,36,84,43,127,0.000333,0.21886,14,9192.126653,510.673703,656.580475,150.842025,2,0
0,0,4,4,4,7,11,13,11,24,0.000333,0.027675,2,166.052718,9.225151,83.026359,27.651484,3,0
0,0,7,7,11,19,30,44,28,72,0.000333,0.117765,5,1766.480614,98.137812,353.296123,118.764371,2,0
0,0,4,4,5,10,15,13,13,26,0.000333,0.03386,2,203.158311,11.286573,101.579155,44.828921,1,0
0,0,3,3,7,8,15,23,12,35,0.000333,0.04558,3,410.223513,22.790195,136.741171,43.651484,1,0
0,0,5,5,8,10,18,28,17,45,0.000333,0.062549,4,750.5865,41.69925,187.646625,57.219281,1,0
0,0,6,6,6,8,14,25,18,43,0.000333,0.054572,6,982.29757,54.572087,163.716262,39.509775,1,0
0,0,9,9,15,19,34,68,35,103,0.000333,0.17467,7,3668.060709,203.78115,524.008673,139.313982,2,0
0,0,11,11,15,21,36,84,43,127,0.000333,0.21886,14,9192.126653,510.673703,656.580475,150.842025,2,0
0,0,9,9,15,19,34,68,35,103,0.000333,0.17467,7,3668.060709,203.78115,524.008673,139.313982,2,0
0,0,3,3,7,8,15,23,12,35,0.000333,0.04558,3,410.223513,22.790195,136.741171,43.651484,1,0
0,0,8,8,13,19,32,50,27,77,0.000333,0.128333,6,2310,128.333333,385,128.816339,4,0
0,0,3,3,8,7,15,20,12,32,0.000333,0.041673,4,500.081996,27.782333,125.020499,43.651484,1,0
0,0,3,3,8,6,14,11,9,20,0.000333,0.025382,4,304.588394,16.921577,76.147098,39.509775,1,0
0,0,5,5,8,10,18,28,17,45,0.000333,0.062549,4,750.5865,41.69925,187.646625,57.219281,1,0
0,0,3,3,11,11,22,26,15,41,0.000333,0.060946,5,914.183482,50.787971,182.836696,76.107496,3,0
0,0,4,4,10,9,19,22,13,35,0.000333,0.049559,5,743.387315,41.299295,148.677463,61.748606,1,0
0,0,4,4,7,8,15,16,12,28,0.000333,0.036464,3,328.17881,18.232156,109.392937,43.651484,3,0
0,0,9,9,10,20,30,44,40,84,0.000333,0.137393,10,4121.7881,228.988228,412.17881,119.657843,1,0
0,0,7,7,9,15,24,23,25,48,0.000333,0.073359,4,880.3128,48.906267,220.0782,87.132684,1,0
0,0,11,11,11,18,29,70,34,104,0.000333,0.16841,5,2526.150117,140.341673,505.230023,113.112398,8,0
0,0,6,6,7,11,18,41,25,66,0.000333,0.091738,6,1651.290301,91.73835,275.21505,57.705232,1,0
0,0,5,5,7,7,14,19,13,32,0.000333,0.040612,3,365.506073,20.305893,121.835358,39.302969,1,0
0,0,10,10,9,18,27,67,48,115,0.000333,0.182271,8,4374.496502,243.027583,546.812063,103.587975,1,0
0,0,29,29,22,49,71,182,138,320,0.000333,0.655973,22,43294.21972,2405.234429,1967.919078,373.228278,5,0
0,0,3,3,8,8,16,20,12,32,0.000333,0.042667,4,512,28.444444,128,48,1,0
0,0,11,11,14,19,33,46,51,97,0.000333,0.163102,14,6850.287214,380.571512,489.30623,134.013592,1,0
0,0,3,3,8,6,14,11,9,20,0.000333,0.025382,4,304.588394,16.921577,76.147098,39.509775,1,0
0,0,5,5,7,13,20,18,18,36,0.000333,0.051863,3,466.768234,25.931569,155.589411,67.757201,1,0
0,0,3,3,7,8,15,23,12,35,0.000333,0.04558,3,410.223513,22.790195,136.741171,43.651484,1,0
0,0,5,5,11,12,23,33,18,51,0.000333,0.076901,5,1153.508299,64.083794,230.70166,81.073298,3,0
0,0,3,3,8,6,14,13,9,22,0.000333,0.027921,4,335.047233,18.613735,83.761808,39.509775,1,0
0,0,4,4,4,7,11,13,11,24,0.000333,0.027675,2,166.052718,9.225151,83.026359,27.651484,3,0
0,0,4,4,4,7,11,13,11,24,0.000333,0.027675,2,166.052718,9.225151,83.026359,27.651484,3,0
0,0,4,4,4,7,11,13,11,24,0.000333,0.027675,2,166.052718,9.225151,83.026359,27.651484,3,0
0,0,4,4,5,9,14,23,13,36,0.000333,0.045688,2,274.129554,15.22942,137.064777,40.138965,1,0
0,0,7,7,11,19,30,44,28,72,0.000333,0.117765,5,1766.480614,98.137812,353.296123,118.764371,2,0
0,0,8,8,11,15,26,45,33,78,0.000333,0.122211,10,3666.34298,203.685721,366.634298,96.657107,1,0
0,0,4,4,4,7,11,13,11,24,0.000333,0.027675,2,166.052718,9.225151,83.026359,27.651484,3,0
0,0,5,5,8,8,16,19,12,31,0.000333,0.041333,4,496,27.555556,124,48,1,0
0,0,7,7,8,17,25,34,34,68,0.000333,0.105261,8,2526.257767,140.347654,315.782221,93.486868,1,0
0,0,6,6,9,10,19,28,17,45,0.000333,0.063719,4,764.626952,42.479275,191.156738,61.748606,1,0
0,0,10,10,12,16,28,60,43,103,0.000333,0.165053,12,5941.890684,330.105038,495.157557,107.01955,9,0
0,0,5,5,7,7,14,19,13,32,0.000333,0.040612,3,365.506073,20.305893,121.835358,39.302969,1,0
0,0,3,3,7,8,15,23,12,35,0.000333,0.04558,3,410.223513,22.790195,136.741171,43.651484,1,0
0,0,23,23,13,34,47,157,98,255,0.000333,0.47214,12,16997.04189,944.280105,1416.420157,221.079453,1,0
0,0,5,5,8,10,18,28,17,45,0.000333,0.062549,4,750.5865,41.69925,187.646625,57.219281,1,0
0,0,6,6,16,9,25,46,18,64,0.000333,0.099069,16,4755.308738,264.183819,297.206796,92.529325,2,0
0,0,5,5,12,13,25,26,19,45,0.000333,0.069658,6,1253.841171,69.657843,208.973529,91.125266,1,0
0,0,8,8,11,11,22,32,29,61,0.000333,0.090675,10,2720.253287,151.125183,272.025329,76.107496,1,0
0,0,4,4,8,7,15,15,10,25,0.000333,0.032557,4,390.68906,21.704948,97.672265,43.651484,1,0
0,0,36,36,16,62,78,272,185,457,0.000333,0.957476,16,45958.86102,2553.270057,2872.428814,433.160171,4,0
0,0,3,3,7,5,12,11,7,18,0.000333,0.02151,3,193.587975,10.754888,64.529325,31.261125,1,0
0,0,4,4,6,10,16,17,14,31,0.000333,0.041333,3,372,20.666667,124,48.729056,1,0
0,0,7,7,11,19,30,44,28,72,0.000333,0.117765,5,1766.480614,98.137812,353.296123,118.764371,2,0
0,0,5,5,8,10,18,28,17,45,0.000333,0.062549,4,750.5865,41.69925,187.646625,57.219281,1,0
0,0,3,3,9,8,17,16,11,27,0.000333,0.036787,4,441.445987,24.524777,110.361497,52.529325,2,0
0,0,7,7,11,19,30,44,28,72,0.000333,0.117765,5,1766.480614,98.137812,353.296123,118.764371,2,0
0,0,3,3,9,8,17,16,11,27,0.000333,0.036787,4,441.445987,24.524777,110.361497,52.529325,2,0
0,0,8,8,15,18,33,66,34,100,0.000333,0.168146,7,3531.075884,196.170882,504.439412,133.662009,2,0
0,0,4,4,10,15,25,32,21,53,0.000333,0.082041,5,1230.62189,68.367883,246.124378,91.82264,1,0
0,0,3,3,7,8,15,23,12,35,0.000333,0.04558,3,410.223513,22.790195,136.741171,43.651484,1,0
0,0,3,3,8,8,16,20,12,32,0.000333,0.042667,4,512,28.444444,128,48,1,0
0,0,5,5,8,10,18,28,17,45,0.000333,0.062549,4,750.5865,41.69925,187.646625,57.219281,1,0
0,0,6,6,13,13,26,37,25,62,0.000333,0.097142,6,1748.563575,97.142421,291.427263,96.211433,4,0
0,0,5,5,8,14,22,21,19,40,0.000333,0.059459,4,713.509059,39.639392,178.377265,77.302969,1,0
0,0,11,11,12,18,30,69,40,109,0.000333,0.178284,12,6418.212899,356.567383,534.851075,118.0782,2,0
0,0,7,7,11,19,30,44,28,72,0.000333,0.117765,5,1766.480614,98.137812,353.296123,118.764371,2,0
0,0,4,4,8,6,14,22,12,34,0.000333,0.04315,8,1035.600539,57.533363,129.450067,39.509775,1,0
0,0,11,11,12,17,29,56,46,102,0.000333,0.165171,12,5946.168738,330.342708,495.514062,112.506418,1,0
0,0,5,5,8,10,18,28,17,45,0.000333,0.062549,4,750.5865,41.69925,187.646625,57.219281,1,0
0,0,9,9,15,19,34,68,35,103,0.000333,0.17467,7,3668.060709,203.78115,524.008673,139.313982,2,0
0,0,10,10,12,13,25,41,34,75,0.000333,0.116096,12,4179.470571,232.192809,348.289214,91.125266,1,0
0,0,3,3,8,7,15,21,11,32,0.000333,0.041673,4,500.081996,27.782333,125.020499,43.651484,1,0
0,0,10,10,13,19,32,47,28,75,0.000333,0.125,6,2250,125,375,128.816339,3,0
0,0,7,7,11,19,30,44,28,72,0.000333,0.117765,5,1766.480614,98.137812,353.296123,118.764371,2,0
0,0,6,6,14,12,26,43,26,69,0.000333,0.10811,14,4540.624768,252.256932,324.330341,96.322519,4,0
0,0,4,4,10,15,25,32,21,53,0.000333,0.082041,5,1230.62189,68.367883,246.124378,91.82264,1,0
0,0,7,7,11,19,30,44,28,72,0.000333,0.117765,5,1766.480614,98.137812,353.296123,118.764371,2,0
0,0,3,3,9,8,17,16,11,27,0.000333,0.036787,4,441.445987,24.524777,110.361497,52.529325,2,0
0,0,9,9,15,19,34,43,29,72,0.000333,0.122099,7,2564.081272,142.44896,366.297325,139.313982,2,0
0,0,3,3,5,7,12,12,9,21,0.000333,0.025095,2,150.568425,8.364913,75.284213,31.261125,2,0
0,0,4,4,4,7,11,13,11,24,0.000333,0.027675,2,166.052718,9.225151,83.026359,27.651484,3,0
0,0,7,7,11,19,30,44,28,72,0.000333,0.117765,5,1766.480614,98.137812,353.296123,118.764371,2,0
0,0,3,3,9,8,17,16,11,27,0.000333,0.036787,4,441.445987,24.524777,110.361497,52.529325,2,0
0,0,3,3,7,8,15,23,12,35,0.000333,0.04558,3,410.223513,22.790195,136.741171,43.651484,1,0
0,0,7,7,11,19,30,44,28,72,0.000333,0.117765,5,1766.480614,98.137812,353.296123,118.764371,2,0
0,0,6,6,8,17,25,31,33,64,0.000333,0.099069,4,1188.827185,66.045955,297.206796,93.486868,1,0
0,0,3,3,7,5,12,11,7,18,0.000333,0.02151,3,193.587975,10.754888,64.529325,31.261125,1,0
0,0,3,3,8,7,15,11,9,20,0.000333,0.026046,4,312.551248,17.363958,78.137812,43.651484,1,0
0,0,4,4,4,7,11,13,11,24,0.000333,0.027675,2,166.052718,9.225151,83.026359,27.651484,2,0
0,0,5,5,8,12,20,22,22,44,0.000333,0.063388,4,760.659345,42.258852,190.164836,67.01955,1,0
0,0,3,3,7,5,12,11,7,18,0.000333,0.02151,3,193.587975,10.754888,64.529325,31.261125,1,0
0,0,5,5,8,10,18,26,15,41,0.000333,0.056989,4,683.8677,37.99265,170.966925,57.219281,1,0
0,0,5,5,8,12,20,40,23,63,0.000333,0.09076,4,1089.12588,60.506993,272.28147,67.01955,1,0
0,0,7,7,11,19,30,44,28,72,0.000333,0.117765,5,1766.480614,98.137812,353.296123,118.764371,2,0
0,0,3,3,9,8,17,16,11,27,0.000333,0.036787,4,441.445987,24.524777,110.361497,52.529325,2,0
0,0,3,3,8,6,14,11,9,20,0.000333,0.025382,4,304.588394,16.921577,76.147098,39.509775,1,0
0,0,15,15,12,22,34,100,56,156,0.000333,0.264548,12,9523.730439,529.096135,793.644203,141.127046,6,0
0,0,3,3,8,6,14,11,9,20,0.000333,0.025382,4,304.588394,16.921577,76.147098,39.509775,1,0
0,0,15,15,12,22,34,99,56,155,0.000333,0.262852,12,9462.680885,525.704494,788.55674,141.127046,2,0
0,0,7,7,11,19,30,44,28,72,0.000333,0.117765,5,1766.480614,98.137812,353.296123,118.764371,2,0
0,0,8,8,15,18,33,66,34,100,0.000333,0.168146,7,3531.075884,196.170882,504.439412,133.662009,2,0
0,0,3,3,7,8,15,23,12,35,0.000333,0.04558,3,410.223513,22.790195,136.741171,43.651484,1,0
0,0,13,13,11,22,33,100,50,150,0.000333,0.25222,10,7566.591179,420.366177,756.659118,136.161243,5,0
0,0,9,9,11,17,28,47,44,91,0.000333,0.145823,10,4374.692979,243.038499,437.469298,107.540616,1,0
0,0,7,7,11,19,30,44,28,72,0.000333,0.117765,5,1766.480614,98.137812,353.296123,118.764371,2,0
0,0,10,10,14,16,30,51,35,86,0.000333,0.140664,14,5907.896277,328.21646,421.992591,117.302969,2,0
0,0,5,5,7,8,15,17,12,29,0.000333,0.037767,3,339.899482,18.883305,113.299827,43.651484,1,0
0,0,3,3,11,11,22,26,15,41,0.000333,0.060946,5,914.183482,50.787971,182.836696,76.107496,3,0
0,0,11,11,11,15,26,43,35,78,0.000333,0.122211,10,3666.34298,203.685721,366.634298,96.657107,1,0
0,0,7,7,14,16,30,42,33,75,0.000333,0.122672,14,5152.235125,286.235285,368.016795,117.302969,4,0
0,0,4,4,5,7,12,14,10,24,0.000333,0.02868,2,172.0782,9.5599,86.0391,31.261125,2,0
0,0,12,12,14,23,37,53,49,102,0.000333,0.177121,14,7439.099406,413.2833,531.364243,157.344894,2,0
0,0,5,5,8,10,18,28,17,45,0.000333,0.062549,4,750.5865,41.69925,187.646625,57.219281,1,0
0,0,8,8,16,17,33,49,35,84,0.000333,0.141243,16,6779.665696,376.648094,423.729106,133.486868,4,0
0,0,5,5,7,8,15,17,12,29,0.000333,0.037767,3,339.899482,18.883305,113.299827,43.651484,1,0
0,0,4,4,7,6,13,14,9,23,0.000333,0.02837,3,255.330341,14.185019,85.110114,35.161259,1,0
0,0,7,7,10,15,25,29,27,56,0.000333,0.086685,5,1300.279733,72.237763,260.055947,91.82264,1,0
0,0,11,11,15,21,36,84,43,127,0.000333,0.21886,14,9192.126653,510.673703,656.580475,150.842025,2,0
0,0,3,3,8,6,14,11,9,20,0.000333,0.025382,4,304.588394,16.921577,76.147098,39.509775,1,0
0,0,8,8,15,18,33,66,34,100,0.000333,0.168146,7,3531.075884,196.170882,504.439412,133.662009,2,0
0,0,9,9,15,19,34,68,35,103,0.000333,0.17467,7,3668.060709,203.78115,524.008673,139.313982,2,0
0,0,4,4,4,7,11,13,11,24,0.000333,0.027675,2,166.052718,9.225151,83.026359,27.651484,3,0
0,0,4,4,4,7,11,13,11,24,0.000333,0.027675,2,166.052718,9.225151,83.026359,27.651484,3,0
0,0,3,3,7,8,15,23,12,35,0.000333,0.04558,3,410.223513,22.790195,136.741171,43.651484,1,0
0,0,5,5,7,16,23,31,27,58,0.000333,0.087456,3,787.09978,43.727766,262.366593,83.651484,1,0
0,0,5,5,11,12,23,31,19,50,0.000333,0.075393,5,1130.890489,62.827249,226.178098,81.073298,2,0
0,0,15,15,15,23,38,93,55,148,0.000333,0.258898,14,10873.70581,604.094767,776.693272,162.645284,12,0
0,0,3,3,7,8,15,23,12,35,0.000333,0.04558,3,410.223513,22.790195,136.741171,43.651484,1,0
0,0,4,4,10,15,25,32,21,53,0.000333,0.082041,5,1230.62189,68.367883,246.124378,91.82264,1,0
0,0,5,5,7,7,14,16,11,27,0.000333,0.034266,3,308.395749,17.133097,102.798583,39.302969,1,0
0,0,5,5,8,8,16,19,12,31,0.000333,0.041333,4,496,27.555556,124,48,1,0
0,0,3,3,7,5,12,11,7,18,0.000333,0.02151,3,193.587975,10.754888,64.529325,31.261125,1,0
0,0,3,3,8,8,16,20,12,32,0.000333,0.042667,4,512,28.444444,128,48,1,0
0,0,3,3,8,8,16,20,12,32,0.000333,0.042667,4,512,28.444444,128,48,1,0
0,0,6,6,9,10,19,28,17,45,0.000333,0.063719,4,764.626952,42.479275,191.156738,61.748606,1,0
0,0,11,11,12,18,30,69,40,109,0.000333,0.178284,12,6418.212899,356.567383,534.851075,118.0782,2,0
0,0,5,5,10,11,21,29,17,46,0.000333,0.067349,5,1010.233007,56.124056,202.046601,71.273029,1,0
0,0,4,4,9,13,22,21,17,38,0.000333,0.056486,4,677.833606,37.657423,169.458402,76.635041,3,0
0,0,4,4,5,10,15,13,13,26,0.000333,0.03386,2,203.158311,11.286573,101.579155,44.828921,1,0
0,0,9,9,15,19,34,68,35,103,0.000333,0.17467,7,3668.060709,203.78115,524.008673,139.313982,2,0
0,0,11,11,15,21,36,84,43,127,0.000333,0.21886,14,9192.126653,510.673703,656.580475,150.842025,2,0
0,0,8,8,15,18,33,66,34,100,0.000333,0.168146,7,3531.075884,196.170882,504.439412,133.662009,2,0
0,0,4,4,6,7,13,20,10,30,0.000333,0.037004,3,333.039575,18.502199,111.013192,35.161259,1,0
0,0,5,5,11,12,23,31,19,50,0.000333,0.075393,5,1130.890489,62.827249,226.178098,81.073298,2,0
0,0,3,3,9,8,17,16,11,27,0.000333,0.036787,4,441.445987,24.524777,110.361497,52.529325,2,0
0,0,4,4,11,10,21,24,14,38,0.000333,0.055636,5,834.54031,46.363351,166.908062,71.273029,3,0
0,0,5,5,8,8,16,25,13,38,0.000333,0.050667,4,608,33.777778,152,48,3,0
0,0,5,5,11,13,24,29,20,49,0.000333,0.074888,5,1123.315813,62.406434,224.663163,86.159464,1,0
0,0,9,9,15,19,34,68,35,103,0.000333,0.17467,7,3668.060709,203.78115,524.008673,139.313982,2,0
0,0,9,9,15,19,34,68,35,103,0.000333,0.17467,7,3668.060709,203.78115,524.008673,139.313982,2,0
0,0,11,11,15,21,36,84,43,127,0.000333,0.21886,14,9192.126653,510.673703,656.580475,150.842025,2,0
0,0,4,4,8,6,14,16,12,28,0.000333,0.035535,8,852.847503,47.380417,106.605938,39.509775,1,0
0,0,8,8,14,17,31,44,36,80,0.000333,0.132112,14,5548.699868,308.261104,396.335705,122.789837,4,0
0,0,5,5,8,11,19,36,19,55,0.000333,0.077879,4,934.544053,51.919114,233.636013,62.053748,1,0
0,0,3,3,9,7,16,19,11,30,0.000333,0.04,4,480,26.666667,120,48.180809,1,0
0,0,7,7,9,15,24,56,32,88,0.000333,0.134492,8,3227.813601,179.322978,403.4767,87.132684,1,0
0,0,3,3,8,7,15,11,9,20,0.000333,0.026046,4,312.551248,17.363958,78.137812,43.651484,1,0
0,0,6,6,5,12,17,19,26,45,0.000333,0.061312,4,735.743311,40.874628,183.935828,54.62919,1,0
0,0,5,5,8,10,18,26,15,41,0.000333,0.056989,4,683.8677,37.99265,170.966925,57.219281,1,0
0,0,4,4,8,8,16,18,12,30,0.000333,0.04,4,480,26.666667,120,48,1,0
0,0,13,13,14,21,35,82,41,123,0.000333,0.210301,7,4416.312678,245.350704,630.901811,145.541635,5,0
0,0,3,3,7,5,12,11,7,18,0.000333,0.02151,3,193.587975,10.754888,64.529325,31.261125,1,0
0,0,8,8,12,15,27,42,27,69,0.000333,0.109362,6,1968.523426,109.362413,328.087238,101.622909,2,0
0,0,5,5,8,10,18,28,17,45,0.000333,0.062549,4,750.5865,41.69925,187.646625,57.219281,1,0
0,0,6,6,7,11,18,41,25,66,0.000333,0.091738,6,1651.290301,91.73835,275.21505,57.705232,1,0
0,0,9,9,8,14,22,51,37,88,0.000333,0.13081,8,3139.43986,174.413326,392.429982,77.302969,1,0
0,0,4,4,8,7,15,16,11,27,0.000333,0.035162,4,421.944184,23.441344,105.486046,43.651484,1,0
0,0,10,10,12,20,32,66,47,113,0.000333,0.188333,12,6780,376.666667,565,129.458112,1,0
0,0,3,3,6,9,15,26,11,37,0.000333,0.048185,3,433.664856,24.092492,144.554952,44.0391,1,0
0,0,4,4,4,7,11,13,11,24,0.000333,0.027675,2,166.052718,9.225151,83.026359,27.651484,3,0
0,0,9,9,15,19,34,68,35,103,0.000333,0.17467,7,3668.060709,203.78115,524.008673,139.313982,2,0
0,0,19,19,19,27,46,152,72,224,0.000333,0.412426,18,22271.00181,1237.277878,1237.277878,209.092585,9,0
0,0,5,5,12,14,26,31,21,52,0.000333,0.081474,6,1466.537192,81.474288,244.422865,96.322519,1,0
0,0,6,6,14,10,24,30,16,46,0.000333,0.070303,7,1476.357925,82.019885,210.908275,86.52225,3,0
0,0,5,5,8,10,18,28,17,45,0.000333,0.062549,4,750.5865,41.69925,187.646625,57.219281,1,0
0,0,4,4,4,7,11,13,11,24,0.000333,0.027675,2,166.052718,9.225151,83.026359,27.651484,3,0
0,0,7,7,8,12,20,31,23,54,0.000333,0.077795,4,933.536468,51.863137,233.384117,67.01955,1,0
0,0,5,5,7,7,14,17,13,30,0.000333,0.038074,3,342.661943,19.036775,114.220648,39.302969,1,0
0,0,10,10,15,19,34,57,42,99,0.000333,0.167886,14,7051.223498,391.734639,503.658821,139.313982,4,0
0,0,8,8,16,17,33,49,35,84,0.000333,0.141243,16,6779.665696,376.648094,423.729106,133.486868,4,0
0,0,3,3,8,7,15,11,9,20,0.000333,0.026046,4,312.551248,17.363958,78.137812,43.651484,1,0
0,0,4,4,9,8,17,15,12,27,0.000333,0.036787,4,441.445987,24.524777,110.361497,52.529325,1,0
0,0,4,4,5,7,12,14,10,24,0.000333,0.02868,2,172.0782,9.5599,86.0391,31.261125,2,0
0,0,6,6,8,12,20,20,21,41,0.000333,0.059066,4,708.796208,39.377567,177.199052,67.01955,1,0
0,0,11,11,15,21,36,84,43,127,0.000333,0.21886,14,9192.126653,510.673703,656.580475,150.842025,2,0
0,0,3,3,9,8,17,16,11,27,0.000333,0.036787,4,441.445987,24.524777,110.361497,52.529325,2,0
0,0,4,4,11,10,21,24,14,38,0.000333,0.055636,5,834.54031,46.363351,166.908062,71.273029,3,0
0,0,3,3,8,8,16,20,12,32,0.000333,0.042667,4,512,28.444444,128,48,1,0
0,0,4,4,4,7,11,13,11,24,0.000333,0.027675,2,166.052718,9.225151,83.026359,27.651484,3,0
0,0,7,7,11,19,30,44,28,72,0.000333,0.117765,5,1766.480614,98.137812,353.296123,118.764371,2,0
0,0,3,3,8,8,16,20,12,32,0.000333,0.042667,4,512,28.444444,128,48,1,0
0,0,3,3,9,8,17,16,11,27,0.000333,0.036787,4,441.445987,24.524777,110.361497,52.529325,2,0
0,0,7,7,11,19,30,44,28,72,0.000333,0.117765,5,1766.480614,98.137812,353.296123,118.764371,2,0
0,0,5,5,10,11,21,24,20,44,0.000333,0.064421,5,966.309833,53.68388,193.261967,71.273029,1,0
0,0,7,7,11,12,23,49,24,73,0.000333,0.110073,10,3302.200228,183.455568,330.220023,81.073298,1,0
0,0,8,8,8,14,22,33,38,71,0.000333,0.10554,8,2532.957159,140.719842,316.619645,77.302969,1,0
0,0,4,4,4,7,11,13,11,24,0.000333,0.027675,2,166.052718,9.225151,83.026359,27.651484,3,0
0,0,6,6,8,19,27,34,34,68,0.000333,0.107777,4,1293.329401,71.851633,323.33235,104.710623,1,0
0,0,8,8,11,15,26,35,27,62,0.000333,0.097142,5,1457.136313,80.952017,291.427263,96.657107,1,0
0,0,4,4,9,8,17,15,12,27,0.000333,0.036787,4,441.445987,24.524777,110.361497,52.529325,1,0
0,0,3,3,8,8,16,20,12,32,0.000333,0.042667,4,512,28.444444,128,48,1,0
0,0,5,5,11,11,22,31,17,48,0.000333,0.071351,5,1070.263588,59.459088,214.052718,76.107496,1,0
0,0,5,5,7,7,14,16,11,27,0.000333,0.034266,3,308.395749,17.133097,102.798583,39.302969,1,0
0,0,22,22,12,31,43,108,68,176,0.000333,0.318341,12,11460.27116,636.681731,955.022597,196.599636,2,0
0,0,4,4,8,11,19,27,17,44,0.000333,0.062303,4,747.635242,41.535291,186.908811,62.053748,1,0
0,0,5,5,10,10,20,26,15,41,0.000333,0.059066,5,885.995259,49.221959,177.199052,66.438562,1,0
0,0,11,11,13,16,29,50,38,88,0.000333,0.142501,12,5130.027931,285.001552,427.502328,112.105716,1,0
0,0,3,3,11,11,22,26,15,41,0.000333,0.060946,5,914.183482,50.787971,182.836696,76.107496,3,0
0,0,10,10,14,16,30,51,35,86,0.000333,0.140664,14,5907.896277,328.21646,421.992591,117.302969,2,0
0,0,4,4,9,7,16,16,11,27,0.000333,0.036,4,432,24,108,48.180809,1,0
0,0,4,4,8,10,18,34,17,51,0.000333,0.070889,4,850.6647,47.25915,212.666175,57.219281,1,0
0,0,5,5,7,7,14,16,11,27,0.000333,0.034266,3,308.395749,17.133097,102.798583,39.302969,1,0
0,0,9,9,15,20,35,72,36,108,0.000333,0.184654,7,3877.737961,215.429887,553.962566,145.041921,2,0
0,0,10,10,9,13,22,41,32,73,0.000333,0.108513,8,2604.308065,144.683781,325.538508,76.635041,1,0
0,0,5,5,8,10,18,28,17,45,0.000333,0.062549,4,750.5865,41.69925,187.646625,57.219281,1,0
0,0,4,4,10,15,25,32,21,53,0.000333,0.082041,5,1230.62189,68.367883,246.124378,91.82264,1,0
0,0,8,8,11,18,29,51,40,91,0.000333,0.147359,10,4420.762706,245.597928,442.076271,113.112398,1,0
0,0,3,3,7,5,12,11,7,18,0.000333,0.02151,3,193.587975,10.754888,64.529325,31.261125,1,0
0,0,4,4,8,6,14,16,12,28,0.000333,0.035535,8,852.847503,47.380417,106.605938,39.509775,1,0
0,0,8,8,9,17,26,35,33,68,0.000333,0.106543,4,1278.519603,71.028867,319.629901,98.016193,1,0
0,0,3,3,7,8,15,23,12,35,0.000333,0.04558,3,410.223513,22.790195,136.741171,43.651484,1,0
0,0,5,5,7,15,22,17,22,39,0.000333,0.057973,3,521.753499,28.986306,173.917833,78.254843,1,0
0,0,3,3,8,7,15,11,9,20,0.000333,0.026046,4,312.551248,17.363958,78.137812,43.651484,1,0
0,0,3,3,9,8,17,16,11,27,0.000333,0.036787,4,441.445987,24.524777,110.361497,52.529325,2,0
0,0,6,6,8,13,21,42,25,67,0.000333,0.098095,4,1177.141069,65.396726,294.285267,72.105716,1,0
0,0,4,4,8,11,19,27,17,44,0.000333,0.062303,4,747.635242,41.535291,186.908811,62.053748,1,0
0,0,6,6,8,13,21,42,25,67,0.000333,0.098095,4,1177.141069,65.396726,294.285267,72.105716,1,0
0,0,3,3,7,8,15,23,12,35,0.000333,0.04558,3,410.223513,22.790195,136.741171,43.651484,1,0
0,0,6,6,8,10,18,20,16,36,0.000333,0.050039,4,600.4692,33.3594,150.1173,57.219281,1,0
0,0,8,8,15,14,29,47,29,76,0.000333,0.123069,14,5168.891779,287.160654,369.206556,111.906328,5,0
0,0,11,11,15,21,36,84,43,127,0.000333,0.21886,14,9192.126653,510.673703,656.580475,150.842025,2,0
0,0,9,9,15,19,34,68,35,103,0.000333,0.17467,7,3668.060709,203.78115,524.008673,139.313982,2,0
0,0,9,9,9,15,24,27,34,61,0.000333,0.093228,8,2237.4617,124.303428,279.682713,87.132684,1,0
0,0,9,9,15,19,34,68,35,103,0.000333,0.17467,7,3668.060709,203.78115,524.008673,139.313982,2,0
0,0,3,3,8,8,16,20,12,32,0.000333,0.042667,4,512,28.444444,128,48,1,0
0,0,25,25,12,35,47,382,213,595,0.000333,1.10166,36,118979.2932,6609.960733,3304.980367,222.544456,4,0
0,0,5,5,11,12,23,33,21,54,0.000333,0.081424,5,1221.361728,67.853429,244.272346,81.073298,1,0
0,0,3,3,7,5,12,13,7,20,0.000333,0.0239,3,215.09775,11.949875,71.69925,31.261125,1,0
0,0,6,6,7,11,18,41,25,66,0.000333,0.091738,6,1651.290301,91.73835,275.21505,57.705232,1,0
0,0,3,3,10,8,18,16,13,29,0.000333,0.040309,5,604.639125,33.591063,120.927825,57.219281,3,0
0,0,9,9,15,19,34,68,35,103,0.000333,0.17467,7,3668.060709,203.78115,524.008673,139.313982,2,0
0,0,9,9,15,19,34,68,35,103,0.000333,0.17467,7,3668.060709,203.78115,524.008673,139.313982,2,0
0,0,11,11,15,21,36,84,43,127,0.000333,0.21886,14,9192.126653,510.673703,656.580475,150.842025,2,0
0,0,8,8,15,18,33,66,34,100,0.000333,0.168146,7,3531.075884,196.170882,504.439412,133.662009,2,0
0,0,3,3,9,8,17,16,11,27,0.000333,0.036787,4,441.445987,24.524777,110.361497,52.529325,2,0
0,0,9,9,15,19,34,68,35,103,0.000333,0.17467,7,3668.060709,203.78115,524.008673,139.313982,2,0
0,0,4,4,9,9,18,19,15,34,0.000333,0.047259,4,567.1098,31.5061,141.77745,57.05865,1,0
0,0,7,7,11,19,30,44,28,72,0.000333,0.117765,5,1766.480614,98.137812,353.296123,118.764371,2,0
0,0,4,4,10,10,20,25,17,42,0.000333,0.060507,5,907.6049,50.422494,181.52098,66.438562,1,0
0,0,5,5,9,9,18,34,14,48,0.000333,0.066719,4,800.6256,44.4792,200.1564,57.05865,3,0
0,0,16,16,11,26,37,113,60,173,0.000333,0.300412,10,9012.354323,500.686351,901.235432,160.26518,1,0
0,0,5,5,10,11,21,27,16,43,0.000333,0.062957,5,944.348246,52.463791,188.869649,71.273029,1,0
0,0,9,9,10,11,21,31,28,59,0.000333,0.086382,10,2591.467279,143.970404,259.146728,71.273029,1,0
0,0,4,4,5,10,15,14,14,28,0.000333,0.036464,2,218.785873,12.154771,109.392937,44.828921,1,0
0,0,3,3,12,9,21,21,11,32,0.000333,0.046851,6,843.324945,46.851386,140.554158,71.548875,3,0
0,0,4,4,6,8,14,17,12,29,0.000333,0.036804,3,331.239878,18.402215,110.413293,39.509775,3,0
0,0,4,4,6,12,18,20,17,37,0.000333,0.051429,3,462.861675,25.714538,154.287225,58.529325,1,0
0,0,4,4,6,8,14,17,12,29,0.000333,0.036804,3,331.239878,18.402215,110.413293,39.509775,3,0
0,0,3,3,7,5,12,11,7,18,0.000333,0.02151,3,193.587975,10.754888,64.529325,31.261125,1,0
0,0,3,3,7,8,15,23,12,35,0.000333,0.04558,3,410.223513,22.790195,136.741171,43.651484,1,0
0,0,7,7,11,19,30,44,28,72,0.000333,0.117765,5,1766.480614,98.137812,353.296123,118.764371,2,0
0,0,6,6,9,10,19,28,17,45,0.000333,0.063719,4,764.626952,42.479275,191.156738,61.748606,1,0
0,0,7,7,11,19,30,44,28,72,0.000333,0.117765,5,1766.480614,98.137812,353.296123,118.764371,2,0
0,0,5,5,7,7,14,16,11,27,0.000333,0.034266,3,308.395749,17.133097,102.798583,39.302969,1,0
0,0,9,9,15,19,34,68,35,103,0.000333,0.17467,7,3668.060709,203.78115,524.008673,139.313982,2,0
0,0,5,5,11,12,23,33,21,54,0.000333,0.081424,5,1221.361728,67.853429,244.272346,81.073298,1,0
0,0,7,7,11,19,30,44,28,72,0.000333,0.117765,5,1766.480614,98.137812,353.296123,118.764371,2,0
0,0,4,4,10,15,25,32,21,53,0.000333,0.082041,5,1230.62189,68.367883,246.124378,91.82264,1,0
0,0,3,3,8,6,14,11,9,20,0.000333,0.025382,4,304.588394,16.921577,76.147098,39.509775,1,0
0,0,9,9,15,19,34,68,35,103,0.000333,0.17467,7,3668.060709,203.78115,524.008673,139.313982,2,0
0,0,5,5,8,10,18,28,17,45,0.000333,0.062549,4,750.5865,41.69925,187.646625,57.219281,1,0
0,0,3,3,5,6,11,9,8,17,0.000333,0.019603,2,117.620675,6.534482,58.810338,27.119415,1,0
0,0,5,5,8,8,16,20,14,34,0.000333,0.045333,4,544,30.222222,136,48,1,0
0,0,8,8,15,18,33,66,34,100,0.000333,0.168146,7,3531.075884,196.170882,504.439412,133.662009,2,0
0,0,7,7,11,18,29,48,28,76,0.000333,0.123069,5,1846.032778,102.557377,369.206556,113.112398,1,0
0,0,9,9,13,16,29,39,24,63,0.000333,0.102018,6,1836.316816,102.017601,306.052803,112.105716,3,0
0,0,4,4,4,7,11,13,11,24,0.000333,0.027675,2,166.052718,9.225151,83.026359,27.651484,3,0
0,0,8,8,16,17,33,49,35,84,0.000333,0.141243,16,6779.665696,376.648094,423.729106,133.486868,4,0
0,0,3,3,7,8,15,23,12,35,0.000333,0.04558,3,410.223513,22.790195,136.741171,43.651484,1,0
0,0,5,5,8,9,17,25,15,40,0.000333,0.0545,4,653.994055,36.333003,163.498514,52.529325,1,0
0,0,10,10,15,27,42,169,61,230,0.000333,0.413411,14,17363.2621,964.625672,1240.233007,186.985321,7,0
0,0,5,5,8,10,18,28,17,45,0.000333,0.062549,4,750.5865,41.69925,187.646625,57.219281,1,0
0,0,3,3,9,8,17,16,11,27,0.000333,0.036787,4,441.445987,24.524777,110.361497,52.529325,2,0
0,0,8,8,15,18,33,66,34,100,0.000333,0.168146,7,3531.075884,196.170882,504.439412,133.662009,2,0
0,0,5,5,11,12,23,33,21,54,0.000333,0.081424,5,1221.361728,67.853429,244.272346,81.073298,1,0
0,0,11,11,15,21,36,84,43,127,0.000333,0.21886,14,9192.126653,510.673703,656.580475,150.842025,2,0
0,0,8,8,15,18,33,66,34,100,0.000333,0.168146,7,3531.075884,196.170882,504.439412,133.662009,2,0
0,0,7,7,11,19,30,44,28,72,0.000333,0.117765,5,1766.480614,98.137812,353.296123,118.764371,2,0
0,0,3,3,8,7,15,11,9,20,0.000333,0.026046,4,312.551248,17.363958,78.137812,43.651484,1,0
0,0,5,5,7,13,20,16,19,35,0.000333,0.050422,3,453.80245,25.211247,151.267483,67.757201,1,0
0,0,5,5,12,13,25,28,18,46,0.000333,0.071206,6,1281.704308,71.205795,213.617385,91.125266,3,0
0,0,4,4,4,7,11,13,11,24,0.000333,0.027675,2,166.052718,9.225151,83.026359,27.651484,3,0
0,0,6,6,6,15,21,23,32,55,0.000333,0.080526,6,1449.46475,80.525819,241.577458,74.113134,1,0
0,0,9,9,15,19,34,68,35,103,0.000333,0.17467,7,3668.060709,203.78115,524.008673,139.313982,2,0
0,0,5,5,10,10,20,26,15,41,0.000333,0.059066,5,885.995259,49.221959,177.199052,66.438562,1,0
0,0,16,16,15,23,38,97,57,154,0.000333,0.269394,14,11314.53172,628.585095,808.180837,162.645284,10,0
0,0,4,4,8,9,17,24,13,37,0.000333,0.050412,4,604.944501,33.608028,151.236125,52.529325,1,0
0,0,5,5,12,16,28,39,25,64,0.000333,0.102557,6,1846.02429,102.556905,307.670715,107.01955,2,0
0,0,25,25,12,35,47,382,213,595,0.000333,1.10166,36,118979.2932,6609.960733,3304.980367,222.544456,4,0
0,0,5,5,8,16,24,38,28,66,0.000333,0.100869,4,1210.4301,67.246117,302.607525,88,1,0
0,0,3,3,9,7,16,19,11,30,0.000333,0.04,4,480,26.666667,120,48.180809,1,0
0,0,5,5,11,12,23,33,21,54,0.000333,0.081424,5,1221.361728,67.853429,244.272346,81.073298,1,0
0,0,3,3,8,7,15,11,9,20,0.000333,0.026046,4,312.551248,17.363958,78.137812,43.651484,1,0
0,0,4,4,6,8,14,17,12,29,0.000333,0.036804,3,331.239878,18.402215,110.413293,39.509775,3,0
0,0,3,3,12,9,21,21,11,32,0.000333,0.046851,6,843.324945,46.851386,140.554158,71.548875,3,0
0,0,25,25,12,35,47,382,213,595,0.000333,1.10166,36,118979.2932,6609.960733,3304.980367,222.544456,4,0
0,0,5,5,11,12,23,33,21,54,0.000333,0.081424,5,1221.361728,67.853429,244.272346,81.073298,1,0
0,0,9,9,10,12,22,32,29,61,0.000333,0.090675,10,2720.253287,151.125183,272.025329,76.238831,1,0
0,0,9,9,15,19,34,68,35,103,0.000333,0.17467,7,3668.060709,203.78115,524.008673,139.313982,2,0
0,0,4,4,10,15,25,32,21,53,0.000333,0.082041,5,1230.62189,68.367883,246.124378,91.82264,1,0
0,0,17,17,14,22,36,98,56,154,0.000333,0.265389,14,11146.3583,619.242128,796.16845,151.410465,2,0
0,0,3,3,7,8,15,23,12,35,0.000333,0.04558,3,410.223513,22.790195,136.741171,43.651484,1,0
0,0,7,7,11,19,30,44,28,72,0.000333,0.117765,5,1766.480614,98.137812,353.296123,118.764371,2,0
0,0,4,4,4,7,11,13,11,24,0.000333,0.027675,2,166.052718,9.225151,83.026359,27.651484,2,0
0,0,6,6,14,12,26,41,24,65,0.000333,0.101843,14,4277.400144,237.633341,305.528582,96.322519,5,0
0,0,3,3,7,5,12,11,7,18,0.000333,0.02151,3,193.587975,10.754888,64.529325,31.261125,1,0
0,0,3,3,6,10,16,25,13,38,0.000333,0.050667,3,456,25.333333,152,48.729056,3,0
0,0,6,6,12,13,25,28,21,49,0.000333,0.07585,6,1365.29372,75.849651,227.548953,91.125266,4,0
0,0,5,5,9,9,18,34,14,48,0.000333,0.066719,4,800.6256,44.4792,200.1564,57.05865,3,0
0,0,11,11,15,21,36,84,43,127,0.000333,0.21886,14,9192.126653,510.673703,656.580475,150.842025,2,0
0,0,3,3,9,8,17,16,11,27,0.000333,0.036787,4,441.445987,24.524777,110.361497,52.529325,2,0
0,0,11,11,15,21,36,84,43,127,0.000333,0.21886,14,9192.126653,510.673703,656.580475,150.842025,2,0
0,0,6,6,14,11,25,40,23,63,0.000333,0.097521,14,4095.881159,227.548953,292.56294,91.356717,4,0
0,0,4,4,5,10,15,13,13,26,0.000333,0.03386,2,203.158311,11.286573,101.579155,44.828921,1,0
0,0,4,4,10,7,17,25,15,40,0.000333,0.0545,10,1634.985137,90.832508,163.498514,52.870765,1,0
0,0,4,4,11,9,20,20,18,38,0.000333,0.054744,10,1642.332676,91.240704,164.233268,66.583073,1,0
0,0,4,4,11,10,21,36,17,53,0.000333,0.077598,5,1163.964117,64.664673,232.792823,71.273029,1,0
0,0,7,7,6,9,15,37,23,60,0.000333,0.078138,6,1406.480614,78.137812,234.413436,44.0391,1,0
0,0,4,4,10,15,25,32,21,53,0.000333,0.082041,5,1230.62189,68.367883,246.124378,91.82264,1,0
0,0,3,3,8,7,15,11,9,20,0.000333,0.026046,4,312.551248,17.363958,78.137812,43.651484,1,0
0,0,6,6,7,12,19,29,32,61,0.000333,0.086375,6,1554.74147,86.374526,259.123578,62.671034,1,0
0,0,6,6,14,12,26,43,26,69,0.000333,0.10811,14,4540.624768,252.256932,324.330341,96.322519,4,0
0,0,6,6,10,13,23,26,20,46,0.000333,0.069361,5,1040.41925,57.801069,208.08385,81.324997,1,0
0,0,5,5,10,11,21,33,18,51,0.000333,0.074669,5,1120.040943,62.224497,224.008189,71.273029,1,0
0,0,7,7,11,19,30,44,28,72,0.000333,0.117765,5,1766.480614,98.137812,353.296123,118.764371,2,0
0,0,6,6,7,13,20,35,24,59,0.000333,0.084998,3,764.981273,42.49896,254.993758,67.757201,1,0
0,0,11,11,15,21,36,84,43,127,0.000333,0.21886,14,9192.126653,510.673703,656.580475,150.842025,2,0
0,0,8,8,15,18,33,66,34,100,0.000333,0.168146,7,3531.075884,196.170882,504.439412,133.662009,2,0
0,0,5,5,8,10,18,28,17,45,0.000333,0.062549,4,750.5865,41.69925,187.646625,57.219281,1,0
0,0,7,7,11,19,30,44,28,72,0.000333,0.117765,5,1766.480614,98.137812,353.296123,118.764371,2,0
0,0,7,7,8,12,20,29,20,49,0.000333,0.070591,4,847.097907,47.060995,211.774477,67.01955,1,0
0,0,4,4,7,13,20,23,18,41,0.000333,0.059066,3,531.597156,29.533175,177.199052,67.757201,1,0
0,0,7,7,11,19,30,44,28,72,0.000333,0.117765,5,1766.480614,98.137812,353.296123,118.764371,2,0
0,0,7,7,11,19,30,44,28,72,0.000333,0.117765,5,1766.480614,98.137812,353.296123,118.764371,2,0
0,0,5,5,7,8,15,17,12,29,0.000333,0.037767,3,339.899482,18.883305,113.299827,43.651484,1,0
0,0,8,8,12,15,27,42,27,69,0.000333,0.109362,6,1968.523426,109.362413,328.087238,101.622909,2,0
0,0,8,8,9,18,27,55,38,93,0.000333,0.147402,8,3537.636302,196.53535,442.204538,103.587975,1,0
0,0,7,7,11,19,30,44,28,72,0.000333,0.117765,5,1766.480614,98.137812,353.296123,118.764371,2,0
0,0,3,3,7,5,12,11,7,18,0.000333,0.02151,3,193.587975,10.754888,64.529325,31.261125,1,0
0,0,7,7,11,19,30,44,28,72,0.000333,0.117765,5,1766.480614,98.137812,353.296123,118.764371,2,0
0,0,5,5,8,10,18,28,17,45,0.000333,0.062549,4,750.5865,41.69925,187.646625,57.219281,1,0
0,0,5,5,11,12,23,25,18,43,0.000333,0.064838,5,972.565821,54.031434,194.513164,81.073298,1,0
0,0,11,11,13,17,30,58,46,104,0.000333,0.170106,12,6123.799463,340.211081,510.316622,117.592585,1,0
0,0,6,6,11,13,24,30,22,52,0.000333,0.079473,5,1192.09025,66.227236,238.41805,86.159464,1,0
0,0,4,4,9,8,17,15,12,27,0.000333,0.036787,4,441.445987,24.524777,110.361497,52.529325,1,0
0,0,3,3,8,7,15,11,9,20,0.000333,0.026046,4,312.551248,17.363958,78.137812,43.651484,1,0
0,0,11,11,15,21,36,84,43,127,0.000333,0.21886,14,9192.126653,510.673703,656.580475,150.842025,2,0
0,0,9,9,15,19,34,68,35,103,0.000333,0.17467,7,3668.060709,203.78115,524.008673,139.313982,2,0
0,0,4,4,8,7,15,16,11,27,0.000333,0.035162,4,421.944184,23.441344,105.486046,43.651484,1,0
0,0,4,4,6,12,18,20,17,37,0.000333,0.051429,3,462.861675,25.714538,154.287225,58.529325,1,0
0,0,8,8,11,11,22,48,28,76,0.000333,0.112972,10,3389.16803,188.287113,338.916803,76.107496,7,0
0,0,11,11,11,17,28,62,42,104,0.000333,0.166655,10,4999.649119,277.758284,499.964912,107.540616,1,0
0,0,4,4,12,9,21,19,15,34,0.000333,0.04978,6,896.032754,49.779597,149.338792,71.548875,1,0
0,0,4,4,4,7,11,13,11,24,0.000333,0.027675,2,166.052718,9.225151,83.026359,27.651484,2,0
0,0,6,6,10,11,21,24,21,45,0.000333,0.065885,5,988.27142,54.903968,197.654284,71.273029,1,0
0,0,3,3,8,6,14,11,9,20,0.000333,0.025382,4,304.588394,16.921577,76.147098,39.509775,1,0
0,0,7,7,14,15,29,42,31,73,0.000333,0.118211,14,4964.856577,275.825365,354.632613,111.906328,4,0
0,0,5,5,8,10,18,28,17,45,0.000333,0.062549,4,750.5865,41.69925,187.646625,57.219281,1,0
0,0,5,5,8,10,18,28,17,45,0.000333,0.062549,4,750.5865,41.69925,187.646625,57.219281,1,0
0,0,4,4,4,7,11,13,11,24,0.000333,0.027675,2,166.052718,9.225151,83.026359,27.651484,3,0
0,0,7,7,11,19,30,44,28,72,0.000333,0.117765,5,1766.480614,98.137812,353.296123,118.764371,2,0
0,0,5,5,11,12,23,31,19,50,0.000333,0.075393,5,1130.890489,62.827249,226.178098,81.073298,2,0
0,0,7,7,11,19,30,44,28,72,0.000333,0.117765,5,1766.480614,98.137812,353.296123,118.764371,2,0
0,0,5,5,11,12,23,33,18,51,0.000333,0.076901,5,1153.508299,64.083794,230.70166,81.073298,3,0
0,0,4,4,5,7,12,14,10,24,0.000333,0.02868,2,172.0782,9.5599,86.0391,31.261125,2,0
0,0,5,5,8,10,18,28,17,45,0.000333,0.062549,4,750.5865,41.69925,187.646625,57.219281,1,0
0,0,5,5,12,16,28,39,25,64,0.000333,0.102557,6,1846.02429,102.556905,307.670715,107.01955,2,0
0,0,3,3,8,7,15,20,12,32,0.000333,0.041673,4,500.081996,27.782333,125.020499,43.651484,1,0
0,0,11,11,11,18,29,70,34,104,0.000333,0.16841,5,2526.150117,140.341673,505.230023,113.112398,5,0
0,0,4,4,4,7,11,13,11,24,0.000333,0.027675,2,166.052718,9.225151,83.026359,27.651484,3,0
0,0,5,5,8,11,19,36,19,55,0.000333,0.077879,4,934.544053,51.919114,233.636013,62.053748,1,0
0,0,4,4,5,7,12,14,10,24,0.000333,0.02868,2,172.0782,9.5599,86.0391,31.261125,2,0
0,0,3,3,7,5,12,11,7,18,0.000333,0.02151,3,193.587975,10.754888,64.529325,31.261125,1,0
0,0,4,4,4,7,11,13,11,24,0.000333,0.027675,2,166.052718,9.225151,83.026359,27.651484,3,0
0,0,5,5,8,11,19,30,18,48,0.000333,0.067967,4,815.602083,45.311227,203.900521,62.053748,1,0
0,0,5,5,11,11,22,31,17,48,0.000333,0.071351,5,1070.263588,59.459088,214.052718,76.107496,1,0
0,0,4,4,5,10,15,13,13,26,0.000333,0.03386,2,203.158311,11.286573,101.579155,44.828921,1,0
0,0,8,8,14,17,31,48,34,82,0.000333,0.135415,14,5687.417364,315.967631,406.244097,122.789837,4,0
0,0,3,3,7,8,15,23,12,35,0.000333,0.04558,3,410.223513,22.790195,136.741171,43.651484,1,0
0,0,4,4,8,11,19,27,17,44,0.000333,0.062303,4,747.635242,41.535291,186.908811,62.053748,1,0
0,0,6,6,8,13,21,42,25,67,0.000333,0.098095,4,1177.141069,65.396726,294.285267,72.105716,1,0
0,0,6,6,9,10,19,28,17,45,0.000333,0.063719,4,764.626952,42.479275,191.156738,61.748606,1,0
0,0,5,5,8,11,19,30,18,48,0.000333,0.067967,4,815.602083,45.311227,203.900521,62.053748,1,0
0,0,4,4,5,7,12,14,10,24,0.000333,0.02868,2,172.0782,9.5599,86.0391,31.261125,2,0
0,0,6,6,13,11,24,38,23,61,0.000333,0.093228,12,3356.192551,186.455142,279.682713,86.159464,4,0
0,0,4,4,10,9,19,22,13,35,0.000333,0.049559,5,743.387315,41.299295,148.677463,61.748606,1,0
0,0,3,3,9,8,17,16,11,27,0.000333,0.036787,4,441.445987,24.524777,110.361497,52.529325,2,0
0,0,4,4,12,11,23,24,15,39,0.000333,0.058806,6,1058.513498,58.806305,176.418916,81.073298,4,0
0,0,4,4,10,15,25,32,21,53,0.000333,0.082041,5,1230.62189,68.367883,246.124378,91.82264,1,0
0,0,10,10,16,24,40,84,58,142,0.000333,0.251905,16,12091.42063,671.745591,755.713789,174.0391,2,0
0,0,7,7,11,19,30,44,28,72,0.000333,0.117765,5,1766.480614,98.137812,353.296123,118.764371,2,0
0,0,4,4,4,7,11,13,11,24,0.000333,0.027675,2,166.052718,9.225151,83.026359,27.651484,3,0
0,0,4,4,10,15,25,32,21,53,0.000333,0.082041,5,1230.62189,68.367883,246.124378,91.82264,1,0
0,0,6,6,9,10,19,24,17,41,0.000333,0.058055,4,696.660112,38.70334,174.165028,61.748606,1,0
0,0,6,6,5,14,19,22,31,53,0.000333,0.075047,4,900.560633,50.031146,225.140158,64.912609,1,0
0,0,13,13,13,22,35,97,52,149,0.000333,0.254754,12,9171.158034,509.50878,764.26317,146.213212,6,0
0,0,3,3,9,8,17,16,11,27,0.000333,0.036787,4,441.445987,24.524777,110.361497,52.529325,2,0
0,0,3,3,10,7,17,22,12,34,0.000333,0.046325,5,694.868683,38.603816,138.973737,52.870765,1,0
0,0,3,3,7,8,15,23,12,35,0.000333,0.04558,3,410.223513,22.790195,136.741171,43.651484,1,0
0,0,7,7,11,19,30,44,28,72,0.000333,0.117765,5,1766.480614,98.137812,353.296123,118.764371,2,0
0,0,5,5,7,8,15,17,12,29,0.000333,0.037767,3,339.899482,18.883305,113.299827,43.651484,1,0
0,0,20,20,13,27,40,226,68,294,0.000333,0.521549,12,18775.76232,1043.097907,1564.64686,176.487679,5,0
0,0,4,4,10,7,17,25,15,40,0.000333,0.0545,10,1634.985137,90.832508,163.498514,52.870765,1,0
0,0,10,10,14,16,30,51,35,86,0.000333,0.140664,14,5907.896277,328.21646,421.992591,117.302969,2,0
0,0,5,5,10,11,21,29,17,46,0.000333,0.067349,5,1010.233007,56.124056,202.046601,71.273029,1,0
0,0,5,5,8,11,19,30,18,48,0.000333,0.067967,4,815.602083,45.311227,203.900521,62.053748,1,0
0,0,5,5,10,10,20,27,14,41,0.000333,0.059066,5,885.995259,49.221959,177.199052,66.438562,3,0
0,0,3,3,7,5,12,11,7,18,0.000333,0.02151,3,193.587975,10.754888,64.529325,31.261125,1,0
0,0,3,3,7,5,12,11,7,18,0.000333,0.02151,3,193.587975,10.754888,64.529325,31.261125,1,0
0,0,4,4,5,12,17,16,16,32,0.000333,0.0436,2,261.597622,14.533201,130.798811,54.62919,1,0
0,0,5,5,8,15,23,21,23,44,0.000333,0.066346,4,796.146904,44.230384,199.036726,82.603359,1,0
0,0,3,3,7,5,12,11,7,18,0.000333,0.02151,3,193.587975,10.754888,64.529325,31.261125,1,0
0,0,7,7,8,12,20,29,20,49,0.000333,0.070591,4,847.097907,47.060995,211.774477,67.01955,1,0
0,0,8,8,8,15,23,30,30,60,0.000333,0.090471,8,2171.309739,120.628319,271.413717,82.603359,1,0
0,0,14,14,11,23,34,85,48,133,0.000333,0.225544,10,6766.325579,375.906977,676.632558,142.095673,1,0
0,0,5,5,7,13,20,16,17,33,0.000333,0.047541,3,427.870881,23.770605,142.623627,67.757201,1,0
0,0,6,6,7,11,18,41,25,66,0.000333,0.091738,6,1651.290301,91.73835,275.21505,57.705232,1,0
0,0,7,7,11,19,30,44,28,72,0.000333,0.117765,5,1766.480614,98.137812,353.296123,118.764371,2,0
0,0,6,6,5,14,19,20,30,50,0.000333,0.070799,4,849.585503,47.199195,212.396376,64.912609,1,0
0,0,3,3,7,13,20,20,19,39,0.000333,0.056185,3,505.665587,28.092533,168.555196,67.757201,1,0
0,0,11,11,15,21,36,84,43,127,0.000333,0.21886,14,9192.126653,510.673703,656.580475,150.842025,2,0
0,0,5,5,7,15,22,31,26,57,0.000333,0.084729,3,762.562807,42.3646,254.187602,78.254843,1,0
0,0,9,9,15,19,34,68,35,103,0.000333,0.17467,7,3668.060709,203.78115,524.008673,139.313982,2,0
0,0,3,3,7,5,12,11,7,18,0.000333,0.02151,3,193.587975,10.754888,64.529325,31.261125,1,0
0,0,3,3,10,9,19,18,12,30,0.000333,0.042479,5,637.189127,35.399396,127.437825,61.748606,3,0
0,0,5,5,8,10,18,28,17,45,0.000333,0.062549,4,750.5865,41.69925,187.646625,57.219281,1,0
0,0,4,4,4,7,11,13,11,24,0.000333,0.027675,2,166.052718,9.225151,83.026359,27.651484,3,0
0,0,5,5,9,14,23,23,19,42,0.000333,0.06333,4,759.958409,42.219912,189.989602,81.832294,1,0
0,0,7,7,11,18,29,48,28,76,0.000333,0.123069,5,1846.032778,102.557377,369.206556,113.112398,1,0
0,0,3,3,7,5,12,11,7,18,0.000333,0.02151,3,193.587975,10.754888,64.529325,31.261125,1,0
0,0,5,5,10,10,20,27,14,41,0.000333,0.059066,5,885.995259,49.221959,177.199052,66.438562,3,0
0,0,5,5,6,13,19,19,18,37,0.000333,0.052391,3,471.519954,26.195553,157.173318,63.615491,1,0
0,0,7,7,6,9,15,37,23,60,0.000333,0.078138,6,1406.480614,78.137812,234.413436,44.0391,1,0
0,0,5,5,8,10,18,28,17,45,0.000333,0.062549,4,750.5865,41.69925,187.646625,57.219281,1,0
0,0,7,7,11,19,30,44,28,72,0.000333,0.117765,5,1766.480614,98.137812,353.296123,118.764371,2,0
0,0,40,40,11,39,50,253,114,367,0.000333,0.690432,10,20712.95222,1150.719568,2071.295222,244.184434,11,0
0,0,9,9,11,15,26,67,38,105,0.000333,0.164515,10,4935.461704,274.192317,493.54617,96.657107,1,0
0,0,3,3,7,8,15,23,12,35,0.000333,0.04558,3,410.223513,22.790195,136.741171,43.651484,1,0
0,0,3,3,7,8,15,23,12,35,0.000333,0.04558,3,410.223513,22.790195,136.741171,43.651484,1,0
0,0,7,7,14,16,30,42,33,75,0.000333,0.122672,14,5152.235125,286.235285,368.016795,117.302969,4,0
0,0,4,4,4,7,11,13,11,24,0.000333,0.027675,2,166.052718,9.225151,83.026359,27.651484,3,0
0,0,6,6,8,12,20,23,20,43,0.000333,0.061948,4,743.371632,41.298424,185.842908,67.01955,3,0
0,0,4,4,4,7,11,13,11,24,0.000333,0.027675,2,166.052718,9.225151,83.026359,27.651484,3,0
0,0,7,7,11,14,25,31,25,56,0.000333,0.086685,5,1300.279733,72.237763,260.055947,91.356717,1,0
0,0,9,9,10,19,29,72,36,108,0.000333,0.174887,5,2623.309737,145.73943,524.661947,113.929904,1,0
0,0,5,5,10,10,20,26,15,41,0.000333,0.059066,5,885.995259,49.221959,177.199052,66.438562,1,0
0,0,4,4,9,9,18,19,15,34,0.000333,0.047259,4,567.1098,31.5061,141.77745,57.05865,1,0
0,0,3,3,8,7,15,20,12,32,0.000333,0.041673,4,500.081996,27.782333,125.020499,43.651484,1,0
0,0,4,4,6,9,15,14,12,26,0.000333,0.03386,3,304.737466,16.929859,101.579155,44.0391,1,0
0,0,4,4,6,10,16,17,14,31,0.000333,0.041333,3,372,20.666667,124,48.729056,1,0
0,0,11,11,15,21,36,84,43,127,0.000333,0.21886,14,9192.126653,510.673703,656.580475,150.842025,2,0
0,0,9,9,15,19,34,68,35,103,0.000333,0.17467,7,3668.060709,203.78115,524.008673,139.313982,2,0
0,0,25,25,12,35,47,382,213,595,0.000333,1.10166,36,118979.2932,6609.960733,3304.980367,222.544456,4,0
0,0,3,3,8,8,16,20,12,32,0.000333,0.042667,4,512,28.444444,128,48,1,0
0,0,3,3,9,8,17,16,11,27,0.000333,0.036787,4,441.445987,24.524777,110.361497,52.529325,2,0
0,0,7,7,11,19,30,44,28,72,0.000333,0.117765,5,1766.480614,98.137812,353.296123,118.764371,2,0
0,0,8,8,15,18,33,66,34,100,0.000333,0.168146,7,3531.075884,196.170882,504.439412,133.662009,2,0
0,0,3,3,11,11,22,26,15,41,0.000333,0.060946,5,914.183482,50.787971,182.836696,76.107496,3,0
0,0,5,5,10,11,21,33,18,51,0.000333,0.074669,5,1120.040943,62.224497,224.008189,71.273029,1,0
0,0,4,4,5,10,15,14,14,28,0.000333,0.036464,2,218.785873,12.154771,109.392937,44.828921,1,0
0,0,3,3,8,8,16,20,12,32,0.000333,0.042667,4,512,28.444444,128,48,1,0
0,0,5,5,10,11,21,33,18,51,0.000333,0.074669,5,1120.040943,62.224497,224.008189,71.273029,1,0
0,0,4,4,6,8,14,17,12,29,0.000333,0.036804,3,331.239878,18.402215,110.413293,39.509775,3,0
0,0,4,4,12,11,23,24,15,39,0.000333,0.058806,6,1058.513498,58.806305,176.418916,81.073298,4,0
0,0,3,3,9,8,17,16,11,27,0.000333,0.036787,4,441.445987,24.524777,110.361497,52.529325,2,0
0,0,5,5,10,10,20,26,15,41,0.000333,0.059066,5,885.995259,49.221959,177.199052,66.438562,1,0
0,0,3,3,7,8,15,23,12,35,0.000333,0.04558,3,410.223513,22.790195,136.741171,43.651484,1,0
0,0,3,3,7,8,15,23,12,35,0.000333,0.04558,3,410.223513,22.790195,136.741171,43.651484,1,0
0,0,5,5,8,10,18,28,17,45,0.000333,0.062549,4,750.5865,41.69925,187.646625,57.219281,1,0
0,0,5,5,10,12,22,22,17,39,0.000333,0.057973,5,869.589166,48.310509,173.917833,76.238831,1,0
0,0,6,6,9,10,19,28,17,45,0.000333,0.063719,4,764.626952,42.479275,191.156738,61.748606,1,0
0,0,5,5,7,7,14,16,11,27,0.000333,0.034266,3,308.395749,17.133097,102.798583,39.302969,1,0
0,0,3,3,7,8,15,23,12,35,0.000333,0.04558,3,410.223513,22.790195,136.741171,43.651484,1,0
0,0,5,5,12,16,28,39,25,64,0.000333,0.102557,6,1846.02429,102.556905,307.670715,107.01955,2,0
0,0,7,7,11,19,30,44,28,72,0.000333,0.117765,5,1766.480614,98.137812,353.296123,118.764371,2,0
0,0,3,3,7,8,15,23,12,35,0.000333,0.04558,3,410.223513,22.790195,136.741171,43.651484,1,0
0,0,7,7,14,15,29,42,31,73,0.000333,0.118211,14,4964.856577,275.825365,354.632613,111.906328,4,0
0,0,3,3,9,8,17,16,11,27,0.000333,0.036787,4,441.445987,24.524777,110.361497,52.529325,2,0
0,0,6,6,14,11,25,40,23,63,0.000333,0.097521,14,4095.881159,227.548953,292.56294,91.356717,4,0
0,0,3,3,8,7,15,11,9,20,0.000333,0.026046,4,312.551248,17.363958,78.137812,43.651484,1,0
0,0,4,4,6,9,15,16,12,28,0.000333,0.036464,3,328.17881,18.232156,109.392937,44.0391,1,0
0,0,6,6,13,12,25,33,24,57,0.000333,0.088233,12,3176.397634,176.466535,264.699803,91.125266,1,0
0,0,4,4,9,8,17,21,14,35,0.000333,0.047687,4,572.244798,31.791378,143.061199,52.529325,1,0
0,0,9,9,15,19,34,68,35,103,0.000333,0.17467,7,3668.060709,203.78115,524.008673,139.313982,2,0
0,0,11,11,15,21,36,84,43,127,0.000333,0.21886,14,9192.126653,510.673703,656.580475,150.842025,2,0
0,0,8,8,15,18,33,66,34,100,0.000333,0.168146,7,3531.075884,196.170882,504.439412,133.662009,2,0
0,0,3,3,8,8,16,20,12,32,0.000333,0.042667,4,512,28.444444,128,48,1,0
0,0,7,7,10,14,24,40,27,67,0.000333,0.102397,5,1535.962438,85.331247,307.192488,86.52225,1,0
0,0,6,6,13,11,24,38,23,61,0.000333,0.093228,12,3356.192551,186.455142,279.682713,86.159464,4,0
0,0,8,8,15,18,33,66,34,100,0.000333,0.168146,7,3531.075884,196.170882,504.439412,133.662009,2,0
0,0,5,5,8,10,18,28,17,45,0.000333,0.062549,4,750.5865,41.69925,187.646625,57.219281,1,0
0,0,4,4,4,7,11,13,11,24,0.000333,0.027675,2,166.052718,9.225151,83.026359,27.651484,3,0
0,0,4,4,6,5,11,14,10,24,0.000333,0.027675,6,498.158153,27.675453,83.026359,27.119415,3,0
0,0,7,7,11,19,30,44,28,72,0.000333,0.117765,5,1766.480614,98.137812,353.296123,118.764371,2,0
0,0,3,3,7,8,15,23,12,35,0.000333,0.04558,3,410.223513,22.790195,136.741171,43.651484,1,0
0,0,11,11,15,21,36,84,43,127,0.000333,0.21886,14,9192.126653,510.673703,656.580475,150.842025,2,0
0,0,9,9,15,19,34,68,35,103,0.000333,0.17467,7,3668.060709,203.78115,524.008673,139.313982,2,0
0,0,3,3,7,8,15,23,12,35,0.000333,0.04558,3,410.223513,22.790195,136.741171,43.651484,1,0
0,0,9,9,15,19,34,68,35,103,0.000333,0.17467,7,3668.060709,203.78115,524.008673,139.313982,2,0
0,0,25,25,12,35,47,382,213,595,0.000333,1.10166,36,118979.2932,6609.960733,3304.980367,222.544456,4,0
0,0,5,5,11,12,23,33,21,54,0.000333,0.081424,5,1221.361728,67.853429,244.272346,81.073298,1,0
0,0,4,4,6,8,14,17,12,29,0.000333,0.036804,3,331.239878,18.402215,110.413293,39.509775,3,0
0,0,3,3,7,8,15,23,12,35,0.000333,0.04558,3,410.223513,22.790195,136.741171,43.651484,1,0
0,0,5,5,10,10,20,26,15,41,0.000333,0.059066,5,885.995259,49.221959,177.199052,66.438562,1,0
0,0,5,5,7,12,19,15,16,31,0.000333,0.043895,3,395.057259,21.947625,131.685753,62.671034,1,0
0,0,5,5,10,11,21,29,17,46,0.000333,0.067349,5,1010.233007,56.124056,202.046601,71.273029,1,0
0,0,5,5,8,10,18,28,17,45,0.000333,0.062549,4,750.5865,41.69925,187.646625,57.219281,1,0
0,0,7,7,8,12,20,29,20,49,0.000333,0.070591,4,847.097907,47.060995,211.774477,67.01955,1,0
0,0,3,3,9,8,17,16,10,26,0.000333,0.035425,4,425.096135,23.616452,106.274034,52.529325,3,0
0,0,5,5,8,8,16,19,12,31,0.000333,0.041333,4,496,27.555556,124,48,1,0
0,0,9,9,15,19,34,68,35,103,0.000333,0.17467,7,3668.060709,203.78115,524.008673,139.313982,2,0
0,0,12,12,7,18,25,72,44,116,0.000333,0.179562,6,3232.123908,179.562439,538.687318,94.710134,1,0
0,0,5,5,11,12,23,33,21,54,0.000333,0.081424,5,1221.361728,67.853429,244.272346,81.073298,1,0
0,0,5,5,8,8,16,22,14,36,0.000333,0.048,4,576,32,144,48,1,0
0,0,3,3,8,7,15,20,12,32,0.000333,0.041673,4,500.081996,27.782333,125.020499,43.651484,1,0
0,0,7,7,8,14,22,37,26,63,0.000333,0.093648,4,1123.776768,62.432043,280.944192,77.302969,1,0
0,0,5,5,8,12,20,29,23,52,0.000333,0.074913,4,898.961044,49.94228,224.740261,67.01955,1,0
0,0,8,8,11,16,27,40,29,69,0.000333,0.109362,5,1640.436188,91.135344,328.087238,102.053748,1,0
0,0,4,4,11,12,23,28,18,46,0.000333,0.069361,5,1040.41925,57.801069,208.08385,81.073298,1,0
0,0,9,9,11,12,23,34,29,63,0.000333,0.094995,10,2849.844032,158.324668,284.984403,81.073298,1,0
0,0,5,5,8,10,18,26,15,41,0.000333,0.056989,4,683.8677,37.99265,170.966925,57.219281,1,0
0,0,5,5,7,8,15,22,15,37,0.000333,0.048185,3,433.664856,24.092492,144.554952,43.651484,1,0
0,0,5,5,8,8,16,25,13,38,0.000333,0.050667,4,608,33.777778,152,48,3,0
0,0,4,4,4,7,11,13,11,24,0.000333,0.027675,2,166.052718,9.225151,83.026359,27.651484,3,0
0,0,11,11,15,21,36,84,43,127,0.000333,0.21886,14,9192.126653,510.673703,656.580475,150.842025,2,0
0,0,9,9,15,19,34,68,35,103,0.000333,0.17467,7,3668.060709,203.78115,524.008673,139.313982,2,0
0,0,5,5,8,10,18,28,17,45,0.000333,0.062549,4,750.5865,41.69925,187.646625,57.219281,1,0
0,0,5,5,7,15,22,31,26,57,0.000333,0.084729,3,762.562807,42.3646,254.187602,78.254843,1,0
0,0,4,4,10,15,25,32,21,53,0.000333,0.082041,5,1230.62189,68.367883,246.124378,91.82264,1,0
0,0,25,25,12,35,47,382,213,595,0.000333,1.10166,36,118979.2932,6609.960733,3304.980367,222.544456,4,0
0,0,5,5,11,12,23,33,21,54,0.000333,0.081424,5,1221.361728,67.853429,244.272346,81.073298,1,0
0,0,25,25,12,35,47,382,213,595,0.000333,1.10166,36,118979.2932,6609.960733,3304.980367,222.544456,4,0
0,0,4,4,4,7,11,13,11,24,0.000333,0.027675,2,166.052718,9.225151,83.026359,27.651484,3,0
0,0,5,5,9,8,17,29,19,48,0.000333,0.065399,8,1569.585731,87.199207,196.198216,52.529325,1,0
0,0,5,5,10,11,21,29,17,46,0.000333,0.067349,5,1010.233007,56.124056,202.046601,71.273029,1,0
0,0,6,6,9,10,19,28,17,45,0.000333,0.063719,4,764.626952,42.479275,191.156738,61.748606,1,0
0,0,3,3,7,5,12,11,7,18,0.000333,0.02151,3,193.587975,10.754888,64.529325,31.261125,1,0
0,0,6,6,6,14,20,26,32,58,0.000333,0.083557,6,1504.030977,83.557277,250.67183,68.812744,1,0
0,0,9,9,10,15,25,33,38,71,0.000333,0.109905,10,3297.137895,183.174327,329.713789,91.82264,1,0
0,0,6,6,10,16,26,37,29,66,0.000333,0.10341,5,1551.145107,86.174728,310.229021,97.219281,1,0
0,0,25,25,12,35,47,382,213,595,0.000333,1.10166,36,118979.2932,6609.960733,3304.980367,222.544456,4,0
0,0,9,9,15,19,34,68,35,103,0.000333,0.17467,7,3668.060709,203.78115,524.008673,139.313982,2,0
0,0,11,11,15,21,36,84,43,127,0.000333,0.21886,14,9192.126653,510.673703,656.580475,150.842025,2,0
0,0,8,8,15,18,33,66,34,100,0.000333,0.168146,7,3531.075884,196.170882,504.439412,133.662009,2,0
0,0,4,4,9,9,18,19,15,34,0.000333,0.047259,4,567.1098,31.5061,141.77745,57.05865,1,0
0,0,5,5,8,12,20,28,25,53,0.000333,0.076354,8,1832.497512,101.805417,229.062189,67.01955,1,0
0,0,8,8,15,18,33,66,34,100,0.000333,0.168146,7,3531.075884,196.170882,504.439412,133.662009,2,0
0,0,11,11,15,21,36,84,43,127,0.000333,0.21886,14,9192.126653,510.673703,656.580475,150.842025,2,0
0,0,16,16,11,26,37,113,60,173,0.000333,0.300412,10,9012.354323,500.686351,901.235432,160.26518,1,0
0,0,7,7,11,19,30,44,28,72,0.000333,0.117765,5,1766.480614,98.137812,353.296123,118.764371,2,0
0,0,21,21,13,29,42,125,73,198,0.000333,0.355893,12,12812.1462,711.7859,1067.67885,188.987165,1,0
0,0,8,8,15,17,32,46,35,81,0.000333,0.135,14,5670,315,405,128.090227,4,0
0,0,9,9,15,19,34,68,35,103,0.000333,0.17467,7,3668.060709,203.78115,524.008673,139.313982,2,0
0,0,4,4,9,13,22,21,17,38,0.000333,0.056486,4,677.833606,37.657423,169.458402,76.635041,3,0
0,0,6,6,10,11,21,24,21,45,0.000333,0.065885,5,988.27142,54.903968,197.654284,71.273029,1,0
0,0,4,4,5,9,14,15,13,28,0.000333,0.035535,2,213.211876,11.845104,106.605938,40.138965,1,0
0,0,18,18,14,25,39,91,63,154,0.000333,0.271317,14,11395.32718,633.073732,813.951942,169.399374,2,0
0,0,6,6,5,12,17,19,26,45,0.000333,0.061312,4,735.743311,40.874628,183.935828,54.62919,1,0
0,0,3,3,7,5,12,11,7,18,0.000333,0.02151,3,193.587975,10.754888,64.529325,31.261125,1,0
0,0,3,3,8,7,15,20,12,32,0.000333,0.041673,4,500.081996,27.782333,125.020499,43.651484,1,0
0,0,3,3,9,8,17,16,11,27,0.000333,0.036787,4,441.445987,24.524777,110.361497,52.529325,2,0
0,0,4,4,8,10,18,28,16,44,0.000333,0.061159,4,733.9068,40.7726,183.4767,57.219281,1,0
0,0,4,4,4,7,11,13,11,24,0.000333,0.027675,2,166.052718,9.225151,83.026359,27.651484,3,0
0,0,4,4,10,15,25,32,21,53,0.000333,0.082041,5,1230.62189,68.367883,246.124378,91.82264,1,0
0,0,11,11,13,17,30,60,47,107,0.000333,0.175012,12,6300.447525,350.024862,525.037294,117.592585,1,0
0,0,11,11,15,21,36,84,43,127,0.000333,0.21886,14,9192.126653,510.673703,656.580475,150.842025,2,0
0,0,9,9,15,19,34,68,35,103,0.000333,0.17467,7,3668.060709,203.78115,524.008673,139.313982,2,0
0,0,5,5,8,8,16,19,12,31,0.000333,0.041333,4,496,27.555556,124,48,1,0
0,0,5,5,7,10,17,19,16,35,0.000333,0.047687,3,429.183598,23.843533,143.061199,52.870765,3,0
0,0,3,3,9,8,17,16,11,27,0.000333,0.036787,4,441.445987,24.524777,110.361497,52.529325,2,0
0,0,3,3,8,7,15,20,12,32,0.000333,0.041673,4,500.081996,27.782333,125.020499,43.651484,1,0
0,0,8,8,15,18,33,66,34,100,0.000333,0.168146,7,3531.075884,196.170882,504.439412,133.662009,2,0
0,0,4,4,4,7,11,13,11,24,0.000333,0.027675,2,166.052718,9.225151,83.026359,27.651484,3,0
0,0,3,3,7,5,12,11,7,18,0.000333,0.02151,3,193.587975,10.754888,64.529325,31.261125,1,0
0,0,3,3,9,8,17,16,11,27,0.000333,0.036787,4,441.445987,24.524777,110.361497,52.529325,2,0
0,0,4,4,9,7,16,16,11,27,0.000333,0.036,4,432,24,108,48.180809,1,0
0,0,3,3,9,8,17,16,11,27,0.000333,0.036787,4,441.445987,24.524777,110.361497,52.529325,2,0
0,0,4,4,6,12,18,16,15,31,0.000333,0.043089,3,387.803025,21.544613,129.267675,58.529325,1,0
0,0,3,3,9,6,15,19,10,29,0.000333,0.037767,4,453.199309,25.177739,113.299827,44.0391,1,0
0,0,5,5,8,10,18,26,15,41,0.000333,0.056989,4,683.8677,37.99265,170.966925,57.219281,1,0
0,0,6,6,7,11,18,41,25,66,0.000333,0.091738,6,1651.290301,91.73835,275.21505,57.705232,1,0
0,0,8,8,8,15,23,30,28,58,0.000333,0.087456,4,1049.466374,58.303687,262.366593,82.603359,1,0
0,0,4,4,9,9,18,19,15,34,0.000333,0.047259,4,567.1098,31.5061,141.77745,57.05865,1,0
0,0,6,6,5,13,18,19,29,48,0.000333,0.066719,4,800.6256,44.4792,200.1564,59.715357,1,0
0,0,13,13,13,22,35,97,52,149,0.000333,0.254754,12,9171.158034,509.50878,764.26317,146.213212,2,0
0,0,4,4,11,8,19,20,16,36,0.000333,0.050975,10,1529.253905,84.95855,152.92539,62.053748,1,0
0,0,3,3,7,8,15,23,12,35,0.000333,0.04558,3,410.223513,22.790195,136.741171,43.651484,1,0
0,0,5,5,8,11,19,36,19,55,0.000333,0.077879,4,934.544053,51.919114,233.636013,62.053748,1,0
0,0,11,11,15,21,36,84,43,127,0.000333,0.21886,14,9192.126653,510.673703,656.580475,150.842025,2,0
0,0,3,3,9,8,17,16,11,27,0.000333,0.036787,4,441.445987,24.524777,110.361497,52.529325,2,0
0,0,6,6,14,12,26,43,26,69,0.000333,0.10811,14,4540.624768,252.256932,324.330341,96.322519,4,0
0,0,4,4,7,11,18,24,17,41,0.000333,0.056989,3,512.900775,28.494488,170.966925,57.705232,1,0
0,0,11,11,15,21,36,84,43,127,0.000333,0.21886,14,9192.126653,510.673703,656.580475,150.842025,2,0
0,0,4,4,5,10,15,13,13,26,0.000333,0.03386,2,203.158311,11.286573,101.579155,44.828921,1,0
0,0,9,9,15,19,34,68,35,103,0.000333,0.17467,7,3668.060709,203.78115,524.008673,139.313982,2,0
0,0,3,3,8,7,15,11,9,20,0.000333,0.026046,4,312.551248,17.363958,78.137812,43.651484,1,0
0,0,4,4,4,7,11,13,11,24,0.000333,0.027675,2,166.052718,9.225151,83.026359,27.651484,3,0
0,0,4,4,4,7,11,13,11,24,0.000333,0.027675,2,166.052718,9.225151,83.026359,27.651484,3,0
0,0,11,11,15,21,36,84,43,127,0.000333,0.21886,14,9192.126653,510.673703,656.580475,150.842025,2,0
0,0,8,8,15,18,33,66,34,100,0.000333,0.168146,7,3531.075884,196.170882,504.439412,133.662009,2,0
0,0,9,9,15,19,34,68,35,103,0.000333,0.17467,7,3668.060709,203.78115,524.008673,139.313982,2,0
0,0,5,5,8,10,18,26,15,41,0.000333,0.056989,4,683.8677,37.99265,170.966925,57.219281,1,0
0,0,9,9,15,19,34,68,35,103,0.000333,0.17467,7,3668.060709,203.78115,524.008673,139.313982,2,0
0,0,7,7,6,9,15,37,23,60,0.000333,0.078138,6,1406.480614,78.137812,234.413436,44.0391,1,0
0,0,5,5,6,13,19,21,19,40,0.000333,0.056639,3,509.751302,28.319517,169.917101,63.615491,1,0
0,0,4,4,5,8,13,16,12,28,0.000333,0.034537,2,207.224624,11.512479,103.612312,35.60964,2,0
0,0,4,4,4,7,11,13,11,24,0.000333,0.027675,2,166.052718,9.225151,83.026359,27.651484,3,0
0,0,3,3,8,8,16,20,12,32,0.000333,0.042667,4,512,28.444444,128,48,1,0
0,0,23,23,13,34,47,157,98,255,0.000333,0.47214,12,16997.04189,944.280105,1416.420157,221.079453,1,0
0,0,6,6,10,11,21,24,21,45,0.000333,0.065885,5,988.27142,54.903968,197.654284,71.273029,1,0
0,0,4,4,4,7,11,13,11,24,0.000333,0.027675,2,166.052718,9.225151,83.026359,27.651484,2,0
0,0,25,25,10,25,35,174,98,272,0.000333,0.465055,15,20927.47471,1162.637484,1395.164981,149.315686,1,0
0,0,3,3,9,8,17,16,11,27,0.000333,0.036787,4,441.445987,24.524777,110.361497,52.529325,2,0
0,0,6,6,14,12,26,41,24,65,0.000333,0.101843,14,4277.400144,237.633341,305.528582,96.322519,5,0
0,0,7,7,11,19,30,44,28,72,0.000333,0.117765,5,1766.480614,98.137812,353.296123,118.764371,2,0
0,0,4,4,9,13,22,21,17,38,0.000333,0.056486,4,677.833606,37.657423,169.458402,76.635041,3,0
0,0,8,8,10,13,23,48,31,79,0.000333,0.11912,10,3573.613945,198.534108,357.361395,81.324997,1,0
0,0,8,8,15,18,33,66,34,100,0.000333,0.168146,7,3531.075884,196.170882,504.439412,133.662009,2,0
0,0,3,3,6,5,11,11,9,20,0.000333,0.023063,3,207.565897,11.531439,69.188632,27.119415,1,0
0,0,5,5,12,16,28,39,25,64,0.000333,0.102557,6,1846.02429,102.556905,307.670715,107.01955,2,0
0,0,6,6,9,10,19,28,17,45,0.000333,0.063719,4,764.626952,42.479275,191.156738,61.748606,1,0
0,0,9,9,15,19,34,68,35,103,0.000333,0.17467,7,3668.060709,203.78115,524.008673,139.313982,2,0
0,0,4,4,6,12,18,16,15,31,0.000333,0.043089,3,387.803025,21.544613,129.267675,58.529325,1,0
0,0,10,10,16,9,25,65,27,92,0.000333,0.142412,24,10253.63447,569.646359,427.234769,92.529325,7,0
0,0,8,8,11,15,26,59,34,93,0.000333,0.145714,10,4371.408938,242.856052,437.140894,96.657107,1,0
0,0,15,15,14,24,38,77,52,129,0.000333,0.225661,14,9477.757089,526.542061,676.982649,163.342069,7,0
0,0,19,19,20,28,48,120,70,190,0.000333,0.353714,20,21222.8575,1179.047639,1061.142875,221.0445,11,0
0,0,5,5,8,11,19,36,19,55,0.000333,0.077879,4,934.544053,51.919114,233.636013,62.053748,1,0
0,0,4,4,8,11,19,18,18,36,0.000333,0.050975,4,611.701562,33.98342,152.92539,62.053748,1,0
0,0,5,5,12,16,28,39,25,64,0.000333,0.102557,6,1846.02429,102.556905,307.670715,107.01955,2,0
0,0,4,4,4,7,11,13,11,24,0.000333,0.027675,2,166.052718,9.225151,83.026359,27.651484,2,0
0,0,5,5,11,11,22,31,17,48,0.000333,0.071351,5,1070.263588,59.459088,214.052718,76.107496,1,0
0,0,4,4,8,6,14,16,12,28,0.000333,0.035535,8,852.847503,47.380417,106.605938,39.509775,1,0
0,0,3,3,7,8,15,23,12,35,0.000333,0.04558,3,410.223513,22.790195,136.741171,43.651484,1,0
0,0,6,6,14,11,25,40,23,63,0.000333,0.097521,14,4095.881159,227.548953,292.56294,91.356717,4,0
0,0,9,9,15,19,34,68,35,103,0.000333,0.17467,7,3668.060709,203.78115,524.008673,139.313982,2,0
0,0,11,11,15,21,36,84,43,127,0.000333,0.21886,14,9192.126653,510.673703,656.580475,150.842025,2,0
0,0,9,9,15,19,34,68,35,103,0.000333,0.17467,7,3668.060709,203.78115,524.008673,139.313982,2,0
0,0,3,3,10,8,18,19,11,30,0.000333,0.041699,5,625.48875,34.749375,125.09775,57.219281,1,0
0,0,8,8,15,15,30,46,30,76,0.000333,0.124308,14,5220.931594,290.051755,372.923685,117.206718,4,0
0,0,9,9,15,19,34,68,35,103,0.000333,0.17467,7,3668.060709,203.78115,524.008673,139.313982,2,0
0,0,16,16,11,24,35,89,52,141,0.000333,0.241076,10,7232.289054,401.793836,723.228905,148.092848,1,0
0,0,4,4,4,7,11,13,11,24,0.000333,0.027675,2,166.052718,9.225151,83.026359,27.651484,3,0
0,0,5,5,8,8,16,25,13,38,0.000333,0.050667,4,608,33.777778,152,48,3,0
0,0,3,3,7,8,15,23,12,35,0.000333,0.04558,3,410.223513,22.790195,136.741171,43.651484,1,0
0,0,9,9,16,24,40,75,54,129,0.000333,0.228843,16,10984.45959,610.247755,686.528724,174.0391,2,0
0,0,5,5,11,11,22,31,17,48,0.000333,0.071351,5,1070.263588,59.459088,214.052718,76.107496,1,0
0,0,14,14,11,23,34,85,48,133,0.000333,0.225544,10,6766.325579,375.906977,676.632558,142.095673,1,0
0,0,11,11,10,19,29,72,52,124,0.000333,0.200797,10,6023.896434,334.660913,602.389643,113.929904,1,0
0,0,7,7,10,17,27,42,36,78,0.000333,0.123627,10,3708.812252,206.045125,370.881225,102.706149,1,0
0,0,26,26,21,69,90,193,149,342,0.000333,0.740071,20,44404.27518,2466.904177,2220.213759,513.726853,16,0
0,0,8,8,15,13,28,46,28,74,0.000333,0.118581,14,4980.419699,276.689983,355.744264,106.709075,4,0
0,0,25,25,12,19,31,159,81,240,0.000333,0.396336,24,28536.17075,1585.342819,1189.007114,123.730173,25,0
0,0,3,3,7,5,12,11,7,18,0.000333,0.02151,3,193.587975,10.754888,64.529325,31.261125,1,0
0,0,5,5,8,8,16,25,13,38,0.000333,0.050667,4,608,33.777778,152,48,3,0
0,0,4,4,6,8,14,17,12,29,0.000333,0.036804,3,331.239878,18.402215,110.413293,39.509775,3,0
0,0,3,3,7,5,12,11,7,18,0.000333,0.02151,3,193.587975,10.754888,64.529325,31.261125,1,0
0,0,9,9,15,19,34,68,35,103,0.000333,0.17467,7,3668.060709,203.78115,524.008673,139.313982,2,0
0,0,14,14,11,23,34,85,48,133,0.000333,0.225544,10,6766.325579,375.906977,676.632558,142.095673,1,0
0,0,5,5,11,12,23,31,19,50,0.000333,0.075393,5,1130.890489,62.827249,226.178098,81.073298,2,0
0,0,4,4,6,8,14,17,12,29,0.000333,0.036804,3,331.239878,18.402215,110.413293,39.509775,3,0
0,0,5,5,11,12,23,33,21,54,0.000333,0.081424,5,1221.361728,67.853429,244.272346,81.073298,1,0
0,0,25,25,12,35,47,382,213,595,0.000333,1.10166,36,118979.2932,6609.960733,3304.980367,222.544456,4,0
0,0,3,3,8,7,15,20,12,32,0.000333,0.041673,4,500.081996,27.782333,125.020499,43.651484,1,0
0,0,4,4,9,13,22,22,17,39,0.000333,0.057973,4,695.671333,38.648407,173.917833,76.635041,3,0
0,0,11,11,8,16,24,48,39,87,0.000333,0.132964,8,3191.133901,177.285217,398.891738,88,1,0
0,0,4,4,6,9,15,13,12,25,0.000333,0.032557,3,293.016795,16.278711,97.672265,44.0391,1,0
0,0,4,4,4,7,11,13,11,24,0.000333,0.027675,2,166.052718,9.225151,83.026359,27.651484,3,0
0,0,5,5,11,12,23,33,18,51,0.000333,0.076901,5,1153.508299,64.083794,230.70166,81.073298,3,0
0,0,7,7,11,19,30,44,28,72,0.000333,0.117765,5,1766.480614,98.137812,353.296123,118.764371,2,0
0,0,5,5,12,9,21,24,14,38,0.000333,0.055636,6,1001.448372,55.636021,166.908062,71.548875,2,0
0,0,12,12,10,25,35,57,42,99,0.000333,0.169266,5,2538.995093,141.055283,507.799019,149.315686,1,0
0,0,5,5,8,11,19,36,19,55,0.000333,0.077879,4,934.544053,51.919114,233.636013,62.053748,1,0
0,0,25,25,12,35,47,382,213,595,0.000333,1.10166,36,118979.2932,6609.960733,3304.980367,222.544456,4,0
0,0,3,3,7,8,15,23,12,35,0.000333,0.04558,3,410.223513,22.790195,136.741171,43.651484,1,0
0,0,4,4,9,8,17,15,12,27,0.000333,0.036787,4,441.445987,24.524777,110.361497,52.529325,1,0
0,0,5,5,8,11,19,30,18,48,0.000333,0.067967,4,815.602083,45.311227,203.900521,62.053748,1,0
0,0,7,7,9,15,24,23,28,51,0.000333,0.077944,4,935.33235,51.962908,233.833088,87.132684,1,0
0,0,3,3,7,8,15,23,12,35,0.000333,0.04558,3,410.223513,22.790195,136.741171,43.651484,1,0
0,0,3,3,7,5,12,11,7,18,0.000333,0.02151,3,193.587975,10.754888,64.529325,31.261125,1,0
0,0,5,5,8,10,18,28,17,45,0.000333,0.062549,4,750.5865,41.69925,187.646625,57.219281,1,0
0,0,5,5,8,11,19,20,16,36,0.000333,0.050975,4,611.701562,33.98342,152.92539,62.053748,3,0
0,0,5,5,8,8,16,19,12,31,0.000333,0.041333,4,496,27.555556,124,48,1,0
0,0,3,3,9,8,17,16,11,27,0.000333,0.036787,4,441.445987,24.524777,110.361497,52.529325,2,0
0,0,5,5,8,10,18,28,17,45,0.000333,0.062549,4,750.5865,41.69925,187.646625,57.219281,1,0
0,0,5,5,9,7,16,23,16,39,0.000333,0.052,8,1248,69.333333,156,48.180809,1,0
0,0,8,8,15,18,33,66,34,100,0.000333,0.168146,7,3531.075884,196.170882,504.439412,133.662009,2,0
0,0,5,5,11,12,23,33,21,54,0.000333,0.081424,5,1221.361728,67.853429,244.272346,81.073298,1,0
0,0,25,25,12,35,47,382,213,595,0.000333,1.10166,36,118979.2932,6609.960733,3304.980367,222.544456,4,0
0,0,11,11,15,21,36,84,43,127,0.000333,0.21886,14,9192.126653,510.673703,656.580475,150.842025,2,0
0,0,9,9,15,19,34,68,35,103,0.000333,0.17467,7,3668.060709,203.78115,524.008673,139.313982,2,0
0,0,5,5,8,11,19,30,18,48,0.000333,0.067967,4,815.602083,45.311227,203.900521,62.053748,1,0
0,0,8,8,15,18,33,66,34,100,0.000333,0.168146,7,3531.075884,196.170882,504.439412,133.662009,2,0
0,0,11,11,15,21,36,84,43,127,0.000333,0.21886,14,9192.126653,510.673703,656.580475,150.842025,2,0
0,0,9,9,15,19,34,68,35,103,0.000333,0.17467,7,3668.060709,203.78115,524.008673,139.313982,2,0
0,0,3,3,7,5,12,11,7,18,0.000333,0.02151,3,193.587975,10.754888,64.529325,31.261125,1,0
0,0,4,4,4,7,11,13,11,24,0.000333,0.027675,2,166.052718,9.225151,83.026359,27.651484,3,0
0,0,4,4,9,7,16,16,11,27,0.000333,0.036,4,432,24,108,48.180809,1,0
0,0,5,5,10,10,20,27,14,41,0.000333,0.059066,5,885.995259,49.221959,177.199052,66.438562,3,0
0,0,8,8,15,18,33,66,34,100,0.000333,0.168146,7,3531.075884,196.170882,504.439412,133.662009,2,0
0,0,7,7,11,18,29,48,28,76,0.000333,0.123069,5,1846.032778,102.557377,369.206556,113.112398,1,0
0,0,13,13,10,14,24,61,46,107,0.000333,0.16353,15,7358.864814,408.825823,490.590988,86.52225,1,0
0,0,3,3,7,8,15,23,12,35,0.000333,0.04558,3,410.223513,22.790195,136.741171,43.651484,1,0
0,0,9,9,15,19,34,68,35,103,0.000333,0.17467,7,3668.060709,203.78115,524.008673,139.313982,2,0
0,0,3,3,7,8,15,23,12,35,0.000333,0.04558,3,410.223513,22.790195,136.741171,43.651484,1,0
0,0,4,4,11,9,20,20,18,38,0.000333,0.054744,10,1642.332676,91.240704,164.233268,66.583073,1,0
0,0,4,4,6,8,14,17,12,29,0.000333,0.036804,3,331.239878,18.402215,110.413293,39.509775,3,0
0,0,11,11,15,21,36,84,43,127,0.000333,0.21886,14,9192.126653,510.673703,656.580475,150.842025,2,0
0,0,7,7,11,19,30,44,28,72,0.000333,0.117765,5,1766.480614,98.137812,353.296123,118.764371,2,0
0,0,4,4,5,7,12,14,10,24,0.000333,0.02868,2,172.0782,9.5599,86.0391,31.261125,2,0
0,0,14,14,15,18,33,66,51,117,0.000333,0.196731,14,8262.717568,459.039865,590.194112,133.662009,2,0
0,0,9,9,10,14,24,45,35,80,0.000333,0.122266,10,3667.970001,203.776111,366.797,86.52225,1,0
0,0,10,10,14,14,28,51,27,78,0.000333,0.124991,7,2624.815787,145.823099,374.973684,106.605938,5,0
0,0,4,4,8,7,15,16,12,28,0.000333,0.036464,4,437.571747,24.309541,109.392937,43.651484,1,0
0,0,3,3,7,8,15,23,12,35,0.000333,0.04558,3,410.223513,22.790195,136.741171,43.651484,1,0
0,0,4,4,4,7,11,13,11,24,0.000333,0.027675,2,166.052718,9.225151,83.026359,27.651484,3,0
0,0,5,5,11,12,23,33,18,51,0.000333,0.076901,5,1153.508299,64.083794,230.70166,81.073298,4,0
0,0,4,4,6,8,14,17,12,29,0.000333,0.036804,3,331.239878,18.402215,110.413293,39.509775,3,0
0,0,4,4,6,8,14,17,12,29,0.000333,0.036804,3,331.239878,18.402215,110.413293,39.509775,3,0
0,0,3,3,8,8,16,20,12,32,0.000333,0.042667,4,512,28.444444,128,48,1,0
0,0,4,4,10,10,20,20,14,34,0.000333,0.048982,5,734.727776,40.81821,146.945555,66.438562,2,0
0,0,4,4,4,7,11,13,11,24,0.000333,0.027675,2,166.052718,9.225151,83.026359,27.651484,2,0
0,0,8,8,10,17,27,39,34,73,0.000333,0.115702,10,3471.067877,192.837104,347.106788,102.706149,1,0
0,0,8,8,10,10,20,32,25,57,0.000333,0.082117,10,2463.499014,136.861056,246.349901,66.438562,1,0
0,0,7,7,11,19,30,44,28,72,0.000333,0.117765,5,1766.480614,98.137812,353.296123,118.764371,2,0
0,0,9,9,13,24,37,44,39,83,0.000333,0.144128,6,2594.307776,144.12821,432.384629,158.144816,1,0
0,0,3,3,9,8,17,16,11,27,0.000333,0.036787,4,441.445987,24.524777,110.361497,52.529325,2,0
0,0,8,8,15,18,33,66,34,100,0.000333,0.168146,7,3531.075884,196.170882,504.439412,133.662009,2,0
0,0,5,5,11,12,23,31,19,50,0.000333,0.075393,5,1130.890489,62.827249,226.178098,81.073298,2,0
0,0,9,9,15,19,34,68,35,103,0.000333,0.17467,7,3668.060709,203.78115,524.008673,139.313982,2,0
0,0,8,8,7,16,23,51,29,80,0.000333,0.120628,3,1085.654869,60.314159,361.884956,83.651484,3,0
0,0,9,9,14,19,33,43,32,75,0.000333,0.12611,7,2648.306913,147.128162,378.329559,134.013592,2,0
0,0,9,9,12,13,25,34,25,59,0.000333,0.091329,6,1643.925091,91.329172,273.987515,91.125266,1,0
0,0,8,8,10,17,27,37,33,70,0.000333,0.110947,5,1664.210626,92.456146,332.842125,102.706149,1,0
0,0,3,3,7,5,12,11,7,18,0.000333,0.02151,3,193.587975,10.754888,64.529325,31.261125,1,0
0,0,14,14,13,23,36,85,43,128,0.000333,0.220583,6,3970.502401,220.583467,661.7504,152.147641,11,0
0,0,6,6,9,13,22,24,20,44,0.000333,0.065405,4,784.859965,43.603331,196.214991,76.635041,1,0
0,0,4,4,5,12,17,14,15,29,0.000333,0.039512,2,237.072845,13.170714,118.536422,54.62919,1,0
0,0,4,4,12,12,24,42,17,59,0.000333,0.090171,6,1623.076725,90.170929,270.512788,86.0391,5,0
0,0,4,4,4,7,11,13,11,24,0.000333,0.027675,2,166.052718,9.225151,83.026359,27.651484,3,0
0,0,3,3,8,7,15,15,9,24,0.000333,0.031255,4,375.061497,20.83675,93.765374,43.651484,3,0
0,0,4,4,6,9,15,14,12,26,0.000333,0.03386,3,304.737466,16.929859,101.579155,44.0391,1,0
0,0,6,6,7,11,18,41,25,66,0.000333,0.091738,6,1651.290301,91.73835,275.21505,57.705232,1,0
0,0,3,3,7,8,15,23,12,35,0.000333,0.04558,3,410.223513,22.790195,136.741171,43.651484,1,0
0,0,3,3,8,6,14,11,9,20,0.000333,0.025382,4,304.588394,16.921577,76.147098,39.509775,1,0
0,0,7,7,11,19,30,44,28,72,0.000333,0.117765,5,1766.480614,98.137812,353.296123,118.764371,2,0
0,0,3,3,8,7,15,20,12,32,0.000333,0.041673,4,500.081996,27.782333,125.020499,43.651484,1,0
0,0,4,4,6,12,18,18,16,34,0.000333,0.047259,3,425.33235,23.629575,141.77745,58.529325,1,0
0,0,3,3,10,6,16,22,12,34,0.000333,0.045333,10,1360,75.555556,136,48.729056,1,0
0,0,5,5,10,10,20,26,15,41,0.000333,0.059066,5,885.995259,49.221959,177.199052,66.438562,1,0
0,0,5,5,10,10,20,27,14,41,0.000333,0.059066,5,885.995259,49.221959,177.199052,66.438562,3,0
0,0,3,3,7,8,15,23,12,35,0.000333,0.04558,3,410.223513,22.790195,136.741171,43.651484,1,0
0,0,3,3,11,11,22,26,15,41,0.000333,0.060946,5,914.183482,50.787971,182.836696,76.107496,3,0
0,0,3,3,9,8,17,16,11,27,0.000333,0.036787,4,441.445987,24.524777,110.361497,52.529325,2,0
0,0,3,3,7,8,15,23,12,35,0.000333,0.04558,3,410.223513,22.790195,136.741171,43.651484,1,0
0,0,7,7,11,19,30,44,28,72,0.000333,0.117765,5,1766.480614,98.137812,353.296123,118.764371,2,0
0,0,9,9,15,19,34,68,35,103,0.000333,0.17467,7,3668.060709,203.78115,524.008673,139.313982,2,0
0,0,11,11,15,21,36,84,43,127,0.000333,0.21886,14,9192.126653,510.673703,656.580475,150.842025,2,0
0,0,3,3,7,8,15,23,12,35,0.000333,0.04558,3,410.223513,22.790195,136.741171,43.651484,1,0
0,0,3,3,8,7,15,20,12,32,0.000333,0.041673,4,500.081996,27.782333,125.020499,43.651484,1,0
0,0,5,5,11,12,23,33,21,54,0.000333,0.081424,5,1221.361728,67.853429,244.272346,81.073298,1,0
0,0,25,25,12,35,47,382,213,595,0.000333,1.10166,36,118979.2932,6609.960733,3304.980367,222.544456,4,0
0,0,3,3,7,5,12,11,7,18,0.000333,0.02151,3,193.587975,10.754888,64.529325,31.261125,1,0
0,0,9,9,11,15,26,41,32,73,0.000333,0.114377,10,3431.320994,190.628944,343.132099,96.657107,1,0
0,0,11,11,15,21,36,84,43,127,0.000333,0.21886,14,9192.126653,510.673703,656.580475,150.842025,2,0
0,0,10,10,12,16,28,43,33,76,0.000333,0.121786,12,4384.307689,243.572649,365.358974,107.01955,1,0
0,0,3,3,9,8,17,16,11,27,0.000333,0.036787,4,441.445987,24.524777,110.361497,52.529325,2,0
0,0,8,8,15,18,33,66,34,100,0.000333,0.168146,7,3531.075884,196.170882,504.439412,133.662009,2,0
0,0,4,4,9,6,15,15,12,27,0.000333,0.035162,8,843.888369,46.882687,105.486046,44.0391,1,0
0,0,3,3,8,8,16,20,12,32,0.000333,0.042667,4,512,28.444444,128,48,1,0
0,0,4,4,7,12,19,17,20,37,0.000333,0.052391,3,471.519954,26.195553,157.173318,62.671034,1,0
0,0,3,3,9,8,17,16,11,27,0.000333,0.036787,4,441.445987,24.524777,110.361497,52.529325,2,0
0,0,6,6,8,16,24,40,31,71,0.000333,0.108511,4,1302.12935,72.340519,325.532338,88,1,0
0,0,5,5,7,7,14,16,11,27,0.000333,0.034266,3,308.395749,17.133097,102.798583,39.302969,1,0
0,0,5,5,8,13,21,18,17,35,0.000333,0.051244,4,614.924439,34.162469,153.73111,72.105716,1,0
0,0,7,7,11,19,30,44,28,72,0.000333,0.117765,5,1766.480614,98.137812,353.296123,118.764371,2,0
0,0,9,9,15,19,34,68,35,103,0.000333,0.17467,7,3668.060709,203.78115,524.008673,139.313982,2,0
0,0,11,11,15,21,36,84,43,127,0.000333,0.21886,14,9192.126653,510.673703,656.580475,150.842025,2,0
0,0,3,3,9,8,17,16,11,27,0.000333,0.036787,4,441.445987,24.524777,110.361497,52.529325,2,0
0,0,12,12,14,17,31,57,41,98,0.000333,0.161837,14,6797.157338,377.619852,485.511238,122.789837,2,0
0,0,4,4,4,7,11,13,11,24,0.000333,0.027675,2,166.052718,9.225151,83.026359,27.651484,3,0
0,0,4,4,6,9,15,16,12,28,0.000333,0.036464,3,328.17881,18.232156,109.392937,44.0391,1,0
0,0,8,8,13,14,27,39,29,68,0.000333,0.107777,12,3879.988202,215.5549,323.33235,101.408685,1,0
0,0,3,3,7,8,15,23,12,35,0.000333,0.04558,3,410.223513,22.790195,136.741171,43.651484,1,0
0,0,3,3,9,8,17,16,11,27,0.000333,0.036787,4,441.445987,24.524777,110.361497,52.529325,2,0
0,0,3,3,8,6,14,11,9,20,0.000333,0.025382,4,304.588394,16.921577,76.147098,39.509775,1,0
0,0,25,25,12,35,47,382,213,595,0.000333,1.10166,36,118979.2932,6609.960733,3304.980367,222.544456,4,0
0,0,3,3,9,8,17,16,11,27,0.000333,0.036787,4,441.445987,24.524777,110.361497,52.529325,2,0
0,0,6,6,8,13,21,42,25,67,0.000333,0.098095,4,1177.141069,65.396726,294.285267,72.105716,1,0
0,0,3,3,8,8,16,20,12,32,0.000333,0.042667,4,512,28.444444,128,48,1,0
0,0,4,4,8,11,19,27,17,44,0.000333,0.062303,4,747.635242,41.535291,186.908811,62.053748,1,0
0,0,9,9,10,15,25,33,38,71,0.000333,0.109905,10,3297.137895,183.174327,329.713789,91.82264,1,0
0,0,25,25,12,35,47,382,213,595,0.000333,1.10166,36,118979.2932,6609.960733,3304.980367,222.544456,4,0
0,0,9,9,15,19,34,68,35,103,0.000333,0.17467,7,3668.060709,203.78115,524.008673,139.313982,2,0
0,0,5,5,8,11,19,30,18,48,0.000333,0.067967,4,815.602083,45.311227,203.900521,62.053748,1,0
0,0,3,3,8,7,15,20,12,32,0.000333,0.041673,4,500.081996,27.782333,125.020499,43.651484,1,0
0,0,4,4,7,9,16,46,28,74,0.000333,0.098667,9,2664,148,296,48.180809,1,0
0,0,12,12,13,19,32,78,57,135,0.000333,0.225,18,12150,675,675,128.816339,1,0
0,0,3,3,9,8,17,16,11,27,0.000333,0.036787,4,441.445987,24.524777,110.361497,52.529325,2,0
0,0,3,3,7,8,15,23,12,35,0.000333,0.04558,3,410.223513,22.790195,136.741171,43.651484,1,0
0,0,5,5,12,16,28,39,25,64,0.000333,0.102557,6,1846.02429,102.556905,307.670715,107.01955,2,0
0,0,11,11,15,21,36,84,43,127,0.000333,0.21886,14,9192.126653,510.673703,656.580475,150.842025,2,0
0,0,8,8,15,18,33,66,34,100,0.000333,0.168146,7,3531.075884,196.170882,504.439412,133.662009,2,0
0,0,5,5,8,10,18,28,17,45,0.000333,0.062549,4,750.5865,41.69925,187.646625,57.219281,1,0
0,0,9,9,15,19,34,68,35,103,0.000333,0.17467,7,3668.060709,203.78115,524.008673,139.313982,2,0
0,0,8,8,15,18,33,66,34,100,0.000333,0.168146,7,3531.075884,196.170882,504.439412,133.662009,2,0
0,0,8,8,15,18,33,66,34,100,0.000333,0.168146,7,3531.075884,196.170882,504.439412,133.662009,2,0
0,0,8,8,15,16,31,48,35,83,0.000333,0.137066,14,5756.776113,319.820895,411.198294,122.603359,4,0
0,0,8,8,11,17,28,43,34,77,0.000333,0.123389,10,3701.66329,205.647961,370.166329,107.540616,1,0
0,0,8,8,15,18,33,66,34,100,0.000333,0.168146,7,3531.075884,196.170882,504.439412,133.662009,2,0
0,0,5,5,10,11,21,33,18,51,0.000333,0.074669,5,1120.040943,62.224497,224.008189,71.273029,1,0
0,0,5,5,10,10,20,26,15,41,0.000333,0.059066,5,885.995259,49.221959,177.199052,66.438562,1,0
0,0,25,25,11,27,38,198,105,303,0.000333,0.530041,15,23851.83055,1325.101697,1590.122037,166.43571,1,0
0,0,10,10,14,16,30,51,35,86,0.000333,0.140664,14,5907.896277,328.21646,421.992591,117.302969,2,0
0,0,5,5,8,8,16,25,13,38,0.000333,0.050667,4,608,33.777778,152,48,3,0
0,0,3,3,7,8,15,23,12,35,0.000333,0.04558,3,410.223513,22.790195,136.741171,43.651484,1,0
0,0,11,11,15,21,36,84,43,127,0.000333,0.21886,14,9192.126653,510.673703,656.580475,150.842025,2,0
0,0,8,8,15,18,33,66,34,100,0.000333,0.168146,7,3531.075884,196.170882,504.439412,133.662009,2,0
0,0,4,4,11,6,17,20,14,34,0.000333,0.046325,10,1389.737366,77.207631,138.973737,53.563523,1,0
0,0,9,9,15,19,34,68,35,103,0.000333,0.17467,7,3668.060709,203.78115,524.008673,139.313982,2,0
0,0,11,11,23,28,51,79,50,129,0.000333,0.243914,11,8049.17156,447.176198,731.742869,238.647863,9,0
0,0,8,8,15,18,33,66,34,100,0.000333,0.168146,7,3531.075884,196.170882,504.439412,133.662009,2,0
0,0,5,5,7,8,15,17,12,29,0.000333,0.037767,3,339.899482,18.883305,113.299827,43.651484,1,0
0,0,25,25,12,35,47,382,213,595,0.000333,1.10166,36,118979.2932,6609.960733,3304.980367,222.544456,4,0
0,0,4,4,7,12,19,17,16,33,0.000333,0.046727,3,420.544824,23.363601,140.181608,62.671034,1,0
0,0,9,9,15,19,34,68,35,103,0.000333,0.17467,7,3668.060709,203.78115,524.008673,139.313982,2,0
0,0,11,11,15,21,36,84,43,127,0.000333,0.21886,14,9192.126653,510.673703,656.580475,150.842025,2,0
0,0,7,7,10,14,24,40,27,67,0.000333,0.102397,5,1535.962438,85.331247,307.192488,86.52225,1,0
0,0,4,4,12,12,24,42,17,59,0.000333,0.090171,6,1623.076725,90.170929,270.512788,86.0391,5,0
0,0,4,4,4,7,11,13,11,24,0.000333,0.027675,2,166.052718,9.225151,83.026359,27.651484,3,0
0,0,6,6,9,10,19,28,17,45,0.000333,0.063719,4,764.626952,42.479275,191.156738,61.748606,1,0
0,0,9,9,15,20,35,72,36,108,0.000333,0.184654,7,3877.737961,215.429887,553.962566,145.041921,2,0
0,0,8,8,15,18,33,66,34,100,0.000333,0.168146,7,3531.075884,196.170882,504.439412,133.662009,2,0
0,0,6,6,9,10,19,28,17,45,0.000333,0.063719,4,764.626952,42.479275,191.156738,61.748606,1,0
0,0,5,5,12,13,25,26,19,45,0.000333,0.069658,6,1253.841171,69.657843,208.973529,91.125266,1,0
0,0,4,4,12,11,23,24,15,39,0.000333,0.058806,6,1058.513498,58.806305,176.418916,81.073298,4,0
0,0,3,3,9,8,17,16,11,27,0.000333,0.036787,4,441.445987,24.524777,110.361497,52.529325,2,0
0,0,4,4,5,7,12,14,10,24,0.000333,0.02868,2,172.0782,9.5599,86.0391,31.261125,2,0
0,0,10,10,14,18,32,51,39,90,0.000333,0.15,14,6300,350,450,128.361619,2,0
0,0,7,7,8,14,22,30,32,62,0.000333,0.092162,8,2211.878083,122.882116,276.48476,77.302969,1,0
0,0,6,6,14,11,25,38,23,61,0.000333,0.094425,14,3965.853186,220.325177,283.275228,91.356717,4,0
0,0,5,5,7,7,14,16,11,27,0.000333,0.034266,3,308.395749,17.133097,102.798583,39.302969,1,0
0,0,4,4,9,8,17,15,12,27,0.000333,0.036787,4,441.445987,24.524777,110.361497,52.529325,1,0
0,0,11,11,15,21,36,84,43,127,0.000333,0.21886,14,9192.126653,510.673703,656.580475,150.842025,2,0
0,0,9,9,15,19,34,68,35,103,0.000333,0.17467,7,3668.060709,203.78115,524.008673,139.313982,2,0
0,0,25,25,10,25,35,174,98,272,0.000333,0.465055,15,20927.47471,1162.637484,1395.164981,149.315686,7,0
0,0,3,3,10,8,18,19,11,30,0.000333,0.041699,5,625.48875,34.749375,125.09775,57.219281,1,0
0,0,4,4,10,15,25,32,21,53,0.000333,0.082041,5,1230.62189,68.367883,246.124378,91.82264,1,0
0,0,9,9,12,14,26,44,34,78,0.000333,0.122211,12,4399.611576,244.422865,366.634298,96.322519,1,0
0,0,7,7,11,19,30,44,28,72,0.000333,0.117765,5,1766.480614,98.137812,353.296123,118.764371,2,0
0,0,7,7,11,19,30,44,28,72,0.000333,0.117765,5,1766.480614,98.137812,353.296123,118.764371,2,0
0,0,9,9,9,18,27,37,42,79,0.000333,0.125212,8,3005.088901,166.949383,375.636113,103.587975,1,0
0,0,5,5,7,8,15,17,12,29,0.000333,0.037767,3,339.899482,18.883305,113.299827,43.651484,1,0
0,0,4,4,11,9,20,18,15,33,0.000333,0.047541,5,713.118136,39.617674,142.623627,66.583073,1,0
0,0,5,5,10,11,21,29,17,46,0.000333,0.067349,5,1010.233007,56.124056,202.046601,71.273029,1,0
0,0,3,3,8,7,15,11,9,20,0.000333,0.026046,4,312.551248,17.363958,78.137812,43.651484,1,0
0,0,4,4,4,7,11,13,11,24,0.000333,0.027675,2,166.052718,9.225151,83.026359,27.651484,3,0
0,0,5,5,8,14,22,28,21,49,0.000333,0.072837,4,874.048597,48.558255,218.512149,77.302969,1,0
0,0,7,7,11,12,23,49,24,73,0.000333,0.110073,10,3302.200228,183.455568,330.220023,81.073298,1,0
0,0,14,14,11,13,24,62,45,107,0.000333,0.16353,15,7358.864814,408.825823,490.590988,86.159464,1,0
0,0,4,4,8,7,15,16,11,27,0.000333,0.035162,4,421.944184,23.441344,105.486046,43.651484,1,0
0,0,5,5,8,8,16,19,12,31,0.000333,0.041333,4,496,27.555556,124,48,1,0
0,0,8,8,8,14,22,31,28,59,0.000333,0.087702,8,2104.851724,116.936207,263.106465,77.302969,1,0
0,0,5,5,7,8,15,17,12,29,0.000333,0.037767,3,339.899482,18.883305,113.299827,43.651484,1,0
0,0,3,3,7,5,12,11,7,18,0.000333,0.02151,3,193.587975,10.754888,64.529325,31.261125,1,0
0,0,4,4,8,12,20,25,24,49,0.000333,0.070591,8,1694.195813,94.12199,211.774477,67.01955,1,0
0,0,7,7,8,17,25,44,42,86,0.000333,0.133124,8,3194.973059,177.498503,399.371632,93.486868,1,0
0,0,4,4,9,8,17,21,14,35,0.000333,0.047687,4,572.244798,31.791378,143.061199,52.529325,1,0
0,0,3,3,9,8,17,16,11,27,0.000333,0.036787,4,441.445987,24.524777,110.361497,52.529325,2,0
0,0,3,3,7,5,12,11,7,18,0.000333,0.02151,3,193.587975,10.754888,64.529325,31.261125,1,0
0,0,5,5,10,11,21,29,17,46,0.000333,0.067349,5,1010.233007,56.124056,202.046601,71.273029,1,0
0,0,8,8,10,13,23,48,31,79,0.000333,0.11912,10,3573.613945,198.534108,357.361395,81.324997,1,0
0,0,6,6,11,11,22,28,18,46,0.000333,0.068378,5,1025.669272,56.981626,205.133854,76.107496,1,0
0,0,4,4,9,8,17,20,12,32,0.000333,0.0436,4,523.195244,29.066402,130.798811,52.529325,1,0
0,0,23,23,15,29,44,158,88,246,0.000333,0.447673,21,28203.42374,1566.856875,1343.020178,199.484808,14,0
0,0,6,6,9,10,19,28,17,45,0.000333,0.063719,4,764.626952,42.479275,191.156738,61.748606,1,0
0,0,3,3,7,5,12,11,7,18,0.000333,0.02151,3,193.587975,10.754888,64.529325,31.261125,1,0
0,0,3,3,8,7,15,11,9,20,0.000333,0.026046,4,312.551248,17.363958,78.137812,43.651484,1,0
0,0,3,3,8,7,15,11,9,20,0.000333,0.026046,4,312.551248,17.363958,78.137812,43.651484,1,0
0,0,3,3,7,5,12,11,7,18,0.000333,0.02151,3,193.587975,10.754888,64.529325,31.261125,1,0
0,0,5,5,10,11,21,33,18,51,0.000333,0.074669,5,1120.040943,62.224497,224.008189,71.273029,1,0
0,0,11,11,23,28,51,79,50,129,0.000333,0.243914,11,8049.17156,447.176198,731.742869,238.647863,9,0
0,0,10,10,12,14,26,41,33,74,0.000333,0.115944,12,4173.99047,231.888359,347.832539,96.322519,1,0
0,0,3,3,7,5,12,11,7,18,0.000333,0.02151,3,193.587975,10.754888,64.529325,31.261125,1,0
0,0,3,3,8,7,15,20,12,32,0.000333,0.041673,4,500.081996,27.782333,125.020499,43.651484,1,0
0,0,5,5,9,14,23,23,19,42,0.000333,0.06333,4,759.958409,42.219912,189.989602,81.832294,1,0
0,0,5,5,8,10,18,28,17,45,0.000333,0.062549,4,750.5865,41.69925,187.646625,57.219281,1,0
0,0,17,17,21,26,47,131,75,206,0.000333,0.381415,20,22884.90607,1271.38367,1144.245303,214.450099,9,0
0,0,5,5,10,11,21,20,16,36,0.000333,0.052708,5,790.617136,43.923174,158.123427,71.273029,1,0
0,0,5,5,8,10,18,26,15,41,0.000333,0.056989,4,683.8677,37.99265,170.966925,57.219281,1,0
0,0,4,4,9,8,17,21,14,35,0.000333,0.047687,4,572.244798,31.791378,143.061199,52.529325,1,0
0,0,3,3,8,7,15,15,9,24,0.000333,0.031255,4,375.061497,20.83675,93.765374,43.651484,3,0
0,0,3,3,10,8,18,16,13,29,0.000333,0.040309,5,604.639125,33.591063,120.927825,57.219281,3,0
0,0,12,12,7,18,25,72,44,116,0.000333,0.179562,6,3232.123908,179.562439,538.687318,94.710134,1,0
0,0,7,7,7,17,24,45,33,78,0.000333,0.119209,3,1072.881225,59.604513,357.627075,89.138353,1,0
0,0,6,6,7,11,18,41,25,66,0.000333,0.091738,6,1651.290301,91.73835,275.21505,57.705232,1,0
0,0,4,4,12,12,24,33,20,53,0.000333,0.081001,6,1458.018075,81.001004,243.003013,86.0391,1,0
0,0,3,3,9,8,17,16,11,27,0.000333,0.036787,4,441.445987,24.524777,110.361497,52.529325,2,0
0,0,3,3,8,8,16,20,12,32,0.000333,0.042667,4,512,28.444444,128,48,1,0
0,0,8,8,16,19,35,72,39,111,0.000333,0.189783,16,9109.606638,506.089258,569.350415,144.710623,10,0
0,0,5,5,8,10,18,28,17,45,0.000333,0.062549,4,750.5865,41.69925,187.646625,57.219281,1,0
0,0,5,5,8,10,18,26,15,41,0.000333,0.056989,4,683.8677,37.99265,170.966925,57.219281,1,0
0,0,3,3,9,8,17,16,11,27,0.000333,0.036787,4,441.445987,24.524777,110.361497,52.529325,2,0
0,0,5,5,10,13,23,23,19,42,0.000333,0.06333,5,949.948011,52.774889,189.989602,81.324997,1,0
0,0,5,5,7,12,19,15,16,31,0.000333,0.043895,3,395.057259,21.947625,131.685753,62.671034,1,0
0,0,4,4,6,8,14,17,12,29,0.000333,0.036804,3,331.239878,18.402215,110.413293,39.509775,3,0
0,0,5,5,8,10,18,28,17,45,0.000333,0.062549,4,750.5865,41.69925,187.646625,57.219281,1,0
0,0,3,3,7,14,21,20,20,40,0.000333,0.058564,3,527.078091,29.282116,175.692697,72.954453,1,0
0,0,5,5,7,16,23,31,27,58,0.000333,0.087456,3,787.09978,43.727766,262.366593,83.651484,1,0
0,0,3,3,8,7,15,20,12,32,0.000333,0.041673,4,500.081996,27.782333,125.020499,43.651484,1,0
0,0,8,8,15,18,33,66,34,100,0.000333,0.168146,7,3531.075884,196.170882,504.439412,133.662009,2,0
0,0,23,23,13,34,47,157,98,255,0.000333,0.47214,12,16997.04189,944.280105,1416.420157,221.079453,1,0
0,0,9,9,15,20,35,72,36,108,0.000333,0.184654,7,3877.737961,215.429887,553.962566,145.041921,2,0
0,0,7,7,10,17,27,35,25,60,0.000333,0.095098,5,1426.466251,79.248125,285.29325,102.706149,3,0
0,0,6,6,7,11,18,41,25,66,0.000333,0.091738,6,1651.290301,91.73835,275.21505,57.705232,1,0
0,0,11,11,15,21,36,84,43,127,0.000333,0.21886,14,9192.126653,510.673703,656.580475,150.842025,2,0
0,0,4,4,4,7,11,13,11,24,0.000333,0.027675,2,166.052718,9.225151,83.026359,27.651484,2,0
0,0,4,4,7,11,18,17,19,36,0.000333,0.050039,3,450.3519,25.01955,150.1173,57.705232,1,0
0,0,7,7,11,12,23,49,24,73,0.000333,0.110073,10,3302.200228,183.455568,330.220023,81.073298,1,0
0,0,9,9,15,19,34,68,35,103,0.000333,0.17467,7,3668.060709,203.78115,524.008673,139.313982,2,0
0,0,5,5,7,13,20,25,20,45,0.000333,0.064829,3,583.460293,32.414461,194.486764,67.757201,1,0
0,0,5,5,8,10,18,28,17,45,0.000333,0.062549,4,750.5865,41.69925,187.646625,57.219281,1,0
0,0,9,9,15,19,34,68,35,103,0.000333,0.17467,7,3668.060709,203.78115,524.008673,139.313982,2,0
0,0,3,3,8,8,16,20,12,32,0.000333,0.042667,4,512,28.444444,128,48,1,0
0,0,3,3,9,8,17,16,10,26,0.000333,0.035425,4,425.096135,23.616452,106.274034,52.529325,3,0
0,0,4,4,6,9,15,16,12,28,0.000333,0.036464,3,328.17881,18.232156,109.392937,44.0391,1,0
0,0,4,4,4,7,11,13,11,24,0.000333,0.027675,2,166.052718,9.225151,83.026359,27.651484,3,0
0,0,6,6,10,15,25,28,27,55,0.000333,0.085137,5,1277.060452,70.947803,255.41209,91.82264,1,0
0,0,5,5,9,15,24,24,21,45,0.000333,0.068774,4,825.29325,45.849625,206.323313,87.132684,1,0
0,0,5,5,8,10,18,28,17,45,0.000333,0.062549,4,750.5865,41.69925,187.646625,57.219281,1,0
0,0,3,3,8,7,15,15,9,24,0.000333,0.031255,4,375.061497,20.83675,93.765374,43.651484,3,0
0,0,3,3,6,5,11,11,9,20,0.000333,0.023063,3,207.565897,11.531439,69.188632,27.119415,1,0
0,0,7,7,11,19,30,44,28,72,0.000333,0.117765,5,1766.480614,98.137812,353.296123,118.764371,2,0
0,0,8,8,13,11,24,39,26,65,0.000333,0.099341,12,3576.270751,198.681708,298.022563,86.159464,1,0
0,0,5,5,7,8,15,17,12,29,0.000333,0.037767,3,339.899482,18.883305,113.299827,43.651484,1,0
0,0,3,3,8,7,15,20,12,32,0.000333,0.041673,4,500.081996,27.782333,125.020499,43.651484,1,0
0,0,4,4,10,15,25,32,21,53,0.000333,0.082041,5,1230.62189,68.367883,246.124378,91.82264,1,0
0,0,8,8,13,14,27,39,29,68,0.000333,0.107777,12,3879.988202,215.5549,323.33235,101.408685,1,0
0,0,5,5,8,10,18,28,17,45,0.000333,0.062549,4,750.5865,41.69925,187.646625,57.219281,1,0
0,0,4,4,10,7,17,25,13,38,0.000333,0.051775,5,776.61794,43.145441,155.323588,52.870765,2,0
0,0,17,17,14,21,35,85,64,149,0.000333,0.254754,21,16049.52656,891.640364,764.26317,145.541635,1,0
0,0,3,3,9,8,17,16,11,27,0.000333,0.036787,4,441.445987,24.524777,110.361497,52.529325,2,0
0,0,3,3,7,8,15,23,12,35,0.000333,0.04558,3,410.223513,22.790195,136.741171,43.651484,1,0
0,0,3,3,7,8,15,23,12,35,0.000333,0.04558,3,410.223513,22.790195,136.741171,43.651484,1,0
0,0,4,4,4,7,11,13,11,24,0.000333,0.027675,2,166.052718,9.225151,83.026359,27.651484,3,0
0,0,4,4,5,11,16,13,14,27,0.000333,0.036,2,216,12,108,49.663388,1,0
0,0,7,7,11,19,30,44,28,72,0.000333,0.117765,5,1766.480614,98.137812,353.296123,118.764371,2,0
0,0,5,5,11,12,23,33,21,54,0.000333,0.081424,5,1221.361728,67.853429,244.272346,81.073298,1,0
0,0,5,5,8,10,18,28,17,45,0.000333,0.062549,4,750.5865,41.69925,187.646625,57.219281,1,0
0,0,3,3,7,14,21,21,19,40,0.000333,0.058564,3,527.078091,29.282116,175.692697,72.954453,1,0
0,0,5,5,7,16,23,32,26,58,0.000333,0.087456,3,787.09978,43.727766,262.366593,83.651484,1,0
0,0,3,3,7,8,15,23,12,35,0.000333,0.04558,3,410.223513,22.790195,136.741171,43.651484,1,0
0,0,8,8,15,18,33,47,36,83,0.000333,0.139562,14,5861.585967,325.643665,418.684712,133.662009,5,0
0,0,3,3,7,8,15,23,12,35,0.000333,0.04558,3,410.223513,22.790195,136.741171,43.651484,1,0
0,0,8,8,15,18,33,66,34,100,0.000333,0.168146,7,3531.075884,196.170882,504.439412,133.662009,2,0
0,0,4,4,10,15,25,32,21,53,0.000333,0.082041,5,1230.62189,68.367883,246.124378,91.82264,1,0
0,0,5,5,8,8,16,19,12,31,0.000333,0.041333,4,496,27.555556,124,48,1,0
0,0,3,3,7,5,12,11,7,18,0.000333,0.02151,3,193.587975,10.754888,64.529325,31.261125,1,0
0,0,5,5,8,10,18,26,15,41,0.000333,0.056989,4,683.8677,37.99265,170.966925,57.219281,1,0
0,0,3,3,8,6,14,11,9,20,0.000333,0.025382,4,304.588394,16.921577,76.147098,39.509775,1,0
0,0,16,16,10,23,33,116,63,179,0.000333,0.300982,10,9029.465474,501.636971,902.946547,137.261206,1,0
0,0,3,3,8,7,15,15,9,24,0.000333,0.031255,4,375.061497,20.83675,93.765374,43.651484,3,0
0,0,7,7,8,10,18,29,21,50,0.000333,0.069499,8,1667.970001,92.665,208.49625,57.219281,1,0
0,0,5,5,8,10,18,28,17,45,0.000333,0.062549,4,750.5865,41.69925,187.646625,57.219281,1,0
0,0,3,3,8,7,15,11,9,20,0.000333,0.026046,4,312.551248,17.363958,78.137812,43.651484,1,0
0,0,5,5,12,16,28,39,25,64,0.000333,0.102557,6,1846.02429,102.556905,307.670715,107.01955,2,0
0,0,5,5,8,10,18,28,17,45,0.000333,0.062549,4,750.5865,41.69925,187.646625,57.219281,1,0
0,0,3,3,7,5,12,11,7,18,0.000333,0.02151,3,193.587975,10.754888,64.529325,31.261125,1,0
0,0,7,7,11,19,30,44,28,72,0.000333,0.117765,5,1766.480614,98.137812,353.296123,118.764371,2,0
0,0,9,9,12,12,24,47,29,76,0.000333,0.116152,12,4181.485801,232.304767,348.45715,86.0391,4,0
0,0,9,9,12,12,24,45,29,74,0.000333,0.113096,12,4071.446701,226.191483,339.287225,86.0391,4,0
0,0,3,3,8,8,16,20,12,32,0.000333,0.042667,4,512,28.444444,128,48,1,0
0,0,4,4,17,14,31,30,20,50,0.000333,0.08257,8,1981.678524,110.093251,247.709816,122.789837,1,0
0,0,7,7,14,16,30,42,33,75,0.000333,0.122672,14,5152.235125,286.235285,368.016795,117.302969,4,0
0,0,4,4,9,10,19,19,13,32,0.000333,0.045311,4,543.734722,30.207485,135.93368,61.748606,3,0
0,0,3,3,6,4,10,17,9,26,0.000333,0.02879,6,518.220783,28.790043,86.37013,23.509775,1,0
0,0,18,18,12,26,38,109,60,169,0.000333,0.295633,12,10642.797,591.2665,886.89975,165.230983,5,0
0,0,8,8,10,10,20,34,28,62,0.000333,0.08932,10,2679.595419,148.866412,267.959542,66.438562,1,0
0,0,5,5,8,10,18,26,15,41,0.000333,0.056989,4,683.8677,37.99265,170.966925,57.219281,1,0
0,0,6,6,8,15,23,30,27,57,0.000333,0.085948,4,1031.372126,57.298451,257.843031,82.603359,1,0
0,0,4,4,4,7,11,13,11,24,0.000333,0.027675,2,166.052718,9.225151,83.026359,27.651484,3,0
0,0,6,6,7,11,18,41,25,66,0.000333,0.091738,6,1651.290301,91.73835,275.21505,57.705232,1,0
0,0,4,4,8,11,19,24,16,40,0.000333,0.056639,4,679.668402,37.759356,169.917101,62.053748,1,0
0,0,5,5,8,12,20,40,23,63,0.000333,0.09076,4,1089.12588,60.506993,272.28147,67.01955,1,0
0,0,5,5,8,10,18,28,17,45,0.000333,0.062549,4,750.5865,41.69925,187.646625,57.219281,1,0
0,0,8,8,11,17,28,46,37,83,0.000333,0.133003,10,3990.104585,221.672477,399.010459,107.540616,1,0
0,0,7,7,11,19,30,44,28,72,0.000333,0.117765,5,1766.480614,98.137812,353.296123,118.764371,2,0
0,0,4,4,5,7,12,14,10,24,0.000333,0.02868,2,172.0782,9.5599,86.0391,31.261125,2,0
0,0,10,10,14,18,32,51,39,90,0.000333,0.15,14,6300,350,450,128.361619,2,0
0,0,7,7,6,14,20,27,21,48,0.000333,0.069151,3,622.357646,34.575425,207.452549,68.812744,1,0
0,0,8,8,15,18,33,66,34,100,0.000333,0.168146,7,3531.075884,196.170882,504.439412,133.662009,2,0
0,0,5,5,8,8,16,24,16,40,0.000333,0.053333,8,1280,71.111111,160,48,1,0
0,0,4,4,4,7,11,13,11,24,0.000333,0.027675,2,166.052718,9.225151,83.026359,27.651484,3,0
0,0,25,25,12,35,47,382,213,595,0.000333,1.10166,36,118979.2932,6609.960733,3304.980367,222.544456,4,0
0,0,5,5,11,12,23,33,21,54,0.000333,0.081424,5,1221.361728,67.853429,244.272346,81.073298,1,0
0,0,4,4,6,8,14,17,12,29,0.000333,0.036804,3,331.239878,18.402215,110.413293,39.509775,3,0
0,0,7,7,11,19,30,44,28,72,0.000333,0.117765,5,1766.480614,98.137812,353.296123,118.764371,2,0
0,0,16,16,19,14,33,84,36,120,0.000333,0.201776,18,10895.8913,605.327294,605.327294,134.013592,8,0
0,0,9,9,13,15,28,39,32,71,0.000333,0.113774,12,4095.866394,227.548133,341.322199,106.709075,1,0
0,0,7,7,11,19,30,44,28,72,0.000333,0.117765,5,1766.480614,98.137812,353.296123,118.764371,2,0
0,0,10,10,15,27,42,169,61,230,0.000333,0.413411,14,17363.2621,964.625672,1240.233007,186.985321,7,0
0,0,5,5,10,11,21,33,18,51,0.000333,0.074669,5,1120.040943,62.224497,224.008189,71.273029,1,0
0,0,10,10,12,14,26,51,43,94,0.000333,0.14728,18,7953.144003,441.841334,441.841334,96.322519,1,0
0,0,4,4,5,12,17,16,16,32,0.000333,0.0436,2,261.597622,14.533201,130.798811,54.62919,1,0
0,0,3,3,10,8,18,16,13,29,0.000333,0.040309,5,604.639125,33.591063,120.927825,57.219281,3,0
0,0,11,11,15,21,36,84,43,127,0.000333,0.21886,14,9192.126653,510.673703,656.580475,150.842025,2,0
0,0,5,5,9,11,20,29,23,52,0.000333,0.074913,8,1797.922087,99.88456,224.740261,66.583073,1,0
0,0,5,5,11,12,23,33,21,54,0.000333,0.081424,5,1221.361728,67.853429,244.272346,81.073298,1,0
0,0,25,25,12,35,47,382,213,595,0.000333,1.10166,36,118979.2932,6609.960733,3304.980367,222.544456,4,0
0,0,15,15,12,23,35,82,44,126,0.000333,0.21543,6,3877.737961,215.429887,646.28966,147.061475,5,0
0,0,7,7,9,15,24,27,27,54,0.000333,0.082529,4,990.3519,55.01955,247.587975,87.132684,1,0
0,0,4,4,12,11,23,24,15,39,0.000333,0.058806,6,1058.513498,58.806305,176.418916,81.073298,4,0
0,0,4,4,9,7,16,16,11,27,0.000333,0.036,4,432,24,108,48.180809,1,0
0,0,11,11,15,21,36,84,43,127,0.000333,0.21886,14,9192.126653,510.673703,656.580475,150.842025,2,0
0,0,8,8,15,18,33,66,34,100,0.000333,0.168146,7,3531.075884,196.170882,504.439412,133.662009,2,0
0,0,9,9,15,19,34,68,35,103,0.000333,0.17467,7,3668.060709,203.78115,524.008673,139.313982,2,0
0,0,6,6,9,11,20,30,18,48,0.000333,0.069151,4,829.810194,46.100566,207.452549,66.583073,1,0
0,0,5,5,8,10,18,28,17,45,0.000333,0.062549,4,750.5865,41.69925,187.646625,57.219281,1,0
0,0,5,5,6,10,16,28,19,47,0.000333,0.062667,3,564,31.333333,188,48.729056,1,0
0,0,7,7,11,18,29,48,28,76,0.000333,0.123069,5,1846.032778,102.557377,369.206556,113.112398,1,0
0,0,5,5,10,10,20,27,14,41,0.000333,0.059066,5,885.995259,49.221959,177.199052,66.438562,3,0
0,0,5,5,8,9,17,25,15,40,0.000333,0.0545,4,653.994055,36.333003,163.498514,52.529325,1,0
0,0,6,6,7,11,18,41,25,66,0.000333,0.091738,6,1651.290301,91.73835,275.21505,57.705232,1,0
0,0,3,3,11,11,22,26,15,41,0.000333,0.060946,5,914.183482,50.787971,182.836696,76.107496,3,0
0,0,3,3,7,5,12,11,7,18,0.000333,0.02151,3,193.587975,10.754888,64.529325,31.261125,1,0
0,0,4,4,6,8,14,17,12,29,0.000333,0.036804,3,331.239878,18.402215,110.413293,39.509775,3,0
0,0,5,5,7,10,17,19,16,35,0.000333,0.047687,3,429.183598,23.843533,143.061199,52.870765,3,0
0,0,4,4,8,10,18,34,17,51,0.000333,0.070889,4,850.6647,47.25915,212.666175,57.219281,1,0
0,0,5,5,11,12,23,31,19,50,0.000333,0.075393,5,1130.890489,62.827249,226.178098,81.073298,2,0
0,0,25,25,12,35,47,382,213,595,0.000333,1.10166,36,118979.2932,6609.960733,3304.980367,222.544456,4,0
0,0,4,4,4,7,11,13,11,24,0.000333,0.027675,2,166.052718,9.225151,83.026359,27.651484,3,0
0,0,5,5,11,12,23,33,21,54,0.000333,0.081424,5,1221.361728,67.853429,244.272346,81.073298,1,0
0,0,4,4,7,8,15,16,12,28,0.000333,0.036464,3,328.17881,18.232156,109.392937,43.651484,3,0
0,0,8,8,9,16,25,36,31,67,0.000333,0.103713,4,1244.553459,69.141859,311.138365,92.529325,1,0
0,0,4,4,6,9,15,13,12,25,0.000333,0.032557,3,293.016795,16.278711,97.672265,44.0391,1,0
0,0,5,5,8,11,19,30,18,48,0.000333,0.067967,4,815.602083,45.311227,203.900521,62.053748,1,0
0,0,3,3,5,7,12,12,9,21,0.000333,0.025095,2,150.568425,8.364913,75.284213,31.261125,1,0
0,0,6,6,14,12,26,41,24,65,0.000333,0.101843,14,4277.400144,237.633341,305.528582,96.322519,5,0
0,0,3,3,8,7,15,11,9,20,0.000333,0.026046,4,312.551248,17.363958,78.137812,43.651484,1,0
0,0,11,11,12,18,30,69,40,109,0.000333,0.178284,12,6418.212899,356.567383,534.851075,118.0782,2,0
0,0,5,5,7,12,19,41,24,65,0.000333,0.092038,6,1656.69173,92.038429,276.115288,62.671034,1,0
0,0,9,9,15,19,34,68,35,103,0.000333,0.17467,7,3668.060709,203.78115,524.008673,139.313982,2,0
0,0,3,3,8,7,15,11,9,20,0.000333,0.026046,4,312.551248,17.363958,78.137812,43.651484,1,0
0,0,5,5,11,12,23,33,21,54,0.000333,0.081424,5,1221.361728,67.853429,244.272346,81.073298,1,0
0,0,25,25,12,35,47,382,213,595,0.000333,1.10166,36,118979.2932,6609.960733,3304.980367,222.544456,4,0
0,0,3,3,9,11,20,19,16,35,0.000333,0.050422,4,605.069933,33.614996,151.267483,66.583073,1,0
0,0,3,3,7,5,12,11,7,18,0.000333,0.02151,3,193.587975,10.754888,64.529325,31.261125,1,0
0,0,3,3,8,8,16,20,12,32,0.000333,0.042667,4,512,28.444444,128,48,1,0
0,0,3,3,7,5,12,11,7,18,0.000333,0.02151,3,193.587975,10.754888,64.529325,31.261125,1,0
0,0,6,6,7,11,18,41,25,66,0.000333,0.091738,6,1651.290301,91.73835,275.21505,57.705232,1,0
0,0,8,8,15,18,33,66,34,100,0.000333,0.168146,7,3531.075884,196.170882,504.439412,133.662009,2,0
0,0,4,4,4,7,11,13,11,24,0.000333,0.027675,2,166.052718,9.225151,83.026359,27.651484,3,0
0,0,5,5,9,13,22,26,21,47,0.000333,0.069864,4,838.373144,46.576286,209.593286,76.635041,3,0
0,0,4,4,6,9,15,16,12,28,0.000333,0.036464,3,328.17881,18.232156,109.392937,44.0391,1,0
0,0,3,3,7,8,15,23,12,35,0.000333,0.04558,3,410.223513,22.790195,136.741171,43.651484,1,0
0,0,7,7,8,15,23,21,25,46,0.000333,0.069361,4,832.3354,46.240856,208.08385,82.603359,1,0
0,0,9,9,13,14,27,46,34,80,0.000333,0.126797,12,4564.692002,253.594,380.391,101.408685,1,0
0,0,7,7,11,19,30,44,28,72,0.000333,0.117765,5,1766.480614,98.137812,353.296123,118.764371,2,0
0,0,4,4,4,7,11,13,11,24,0.000333,0.027675,2,166.052718,9.225151,83.026359,27.651484,3,0
0,0,9,9,15,19,34,68,35,103,0.000333,0.17467,7,3668.060709,203.78115,524.008673,139.313982,2,0
0,0,11,11,12,18,30,69,40,109,0.000333,0.178284,12,6418.212899,356.567383,534.851075,118.0782,7,0
0,0,8,8,15,18,33,66,34,100,0.000333,0.168146,7,3531.075884,196.170882,504.439412,133.662009,2,0
0,0,3,3,7,8,15,23,12,35,0.000333,0.04558,3,410.223513,22.790195,136.741171,43.651484,1,0
0,0,5,5,8,10,18,28,17,45,0.000333,0.062549,4,750.5865,41.69925,187.646625,57.219281,1,0
0,0,7,7,11,19,30,44,28,72,0.000333,0.117765,5,1766.480614,98.137812,353.296123,118.764371,2,0
0,0,4,4,10,15,25,32,21,53,0.000333,0.082041,5,1230.62189,68.367883,246.124378,91.82264,1,0
0,0,5,5,8,10,18,28,17,45,0.000333,0.062549,4,750.5865,41.69925,187.646625,57.219281,1,0
0,0,6,6,14,12,26,41,24,65,0.000333,0.101843,14,4277.400144,237.633341,305.528582,96.322519,5,0
0,0,3,3,7,5,12,11,7,18,0.000333,0.02151,3,193.587975,10.754888,64.529325,31.261125,1,0
0,0,6,6,7,13,20,35,24,59,0.000333,0.084998,3,764.981273,42.49896,254.993758,67.757201,1,0
0,0,5,5,8,11,19,36,19,55,0.000333,0.077879,4,934.544053,51.919114,233.636013,62.053748,1,0
0,0,3,3,9,8,17,16,11,27,0.000333,0.036787,4,441.445987,24.524777,110.361497,52.529325,2,0
0,0,6,6,11,15,26,39,25,64,0.000333,0.100276,5,1504.14071,83.563373,300.828142,96.657107,1,0
0,0,10,10,14,16,30,51,35,86,0.000333,0.140664,14,5907.896277,328.21646,421.992591,117.302969,2,0
0,0,7,7,11,19,30,44,28,72,0.000333,0.117765,5,1766.480614,98.137812,353.296123,118.764371,2,0
0,0,7,7,9,13,22,31,25,56,0.000333,0.083243,4,998.912683,55.495149,249.728171,76.635041,3,0
0,0,5,5,8,10,18,28,17,45,0.000333,0.062549,4,750.5865,41.69925,187.646625,57.219281,1,0
0,0,7,7,11,19,30,44,28,72,0.000333,0.117765,5,1766.480614,98.137812,353.296123,118.764371,2,0
0,0,4,4,9,7,16,16,11,27,0.000333,0.036,4,432,24,108,48.180809,1,0
0,0,6,6,9,9,18,23,15,38,0.000333,0.052819,4,633.8286,35.2127,158.45715,57.05865,1,0
0,0,3,3,5,6,11,10,8,18,0.000333,0.020757,2,124.539538,6.918863,62.269769,27.119415,1,0
0,0,6,6,13,11,24,38,23,61,0.000333,0.093228,12,3356.192551,186.455142,279.682713,86.159464,4,0
0,0,5,5,7,7,14,16,11,27,0.000333,0.034266,3,308.395749,17.133097,102.798583,39.302969,1,0
0,0,6,6,9,10,19,28,17,45,0.000333,0.063719,4,764.626952,42.479275,191.156738,61.748606,1,0
0,0,5,5,8,8,16,25,13,38,0.000333,0.050667,4,608,33.777778,152,48,3,0
0,0,3,3,8,7,15,11,9,20,0.000333,0.026046,4,312.551248,17.363958,78.137812,43.651484,1,0
0,0,4,4,10,9,19,22,13,35,0.000333,0.049559,5,743.387315,41.299295,148.677463,61.748606,1,0
0,0,7,7,9,16,25,24,27,51,0.000333,0.078946,4,947.346663,52.63037,236.836666,92.529325,1,0
0,0,5,5,8,8,16,19,12,31,0.000333,0.041333,4,496,27.555556,124,48,1,0
0,0,5,5,9,11,20,29,23,52,0.000333,0.074913,8,1797.922087,99.88456,224.740261,66.583073,1,0
0,0,5,5,8,8,16,19,12,31,0.000333,0.041333,4,496,27.555556,124,48,1,0
0,0,6,6,9,17,26,38,30,68,0.000333,0.106543,4,1278.519603,71.028867,319.629901,98.016193,1,0
0,0,8,8,15,18,33,66,34,100,0.000333,0.168146,7,3531.075884,196.170882,504.439412,133.662009,2,0
0,0,3,3,9,8,17,16,11,27,0.000333,0.036787,4,441.445987,24.524777,110.361497,52.529325,2,0
0,0,8,8,15,18,33,66,34,100,0.000333,0.168146,7,3531.075884,196.170882,504.439412,133.662009,2,0
0,0,3,3,9,8,17,16,11,27,0.000333,0.036787,4,441.445987,24.524777,110.361497,52.529325,2,0
0,0,4,4,5,10,15,13,13,26,0.000333,0.03386,2,203.158311,11.286573,101.579155,44.828921,1,0
0,0,11,11,11,14,25,42,34,76,0.000333,0.117644,10,3529.330704,196.073928,352.93307,91.356717,1,0
0,0,11,11,15,21,36,84,43,127,0.000333,0.21886,14,9192.126653,510.673703,656.580475,150.842025,2,0
0,0,9,9,15,19,34,68,35,103,0.000333,0.17467,7,3668.060709,203.78115,524.008673,139.313982,2,0
0,0,3,3,7,5,12,11,7,18,0.000333,0.02151,3,193.587975,10.754888,64.529325,31.261125,1,0
0,0,3,3,9,8,17,16,11,27,0.000333,0.036787,4,441.445987,24.524777,110.361497,52.529325,2,0
0,0,3,3,7,5,12,11,7,18,0.000333,0.02151,3,193.587975,10.754888,64.529325,31.261125,1,0
0,0,7,7,11,19,30,44,28,72,0.000333,0.117765,5,1766.480614,98.137812,353.296123,118.764371,2,0
0,0,9,9,15,19,34,68,35,103,0.000333,0.17467,7,3668.060709,203.78115,524.008673,139.313982,2,0
0,0,7,7,11,19,30,44,28,72,0.000333,0.117765,5,1766.480614,98.137812,353.296123,118.764371,2,0
0,0,9,9,15,19,34,68,35,103,0.000333,0.17467,7,3668.060709,203.78115,524.008673,139.313982,2,0
0,0,3,3,7,5,12,11,7,18,0.000333,0.02151,3,193.587975,10.754888,64.529325,31.261125,1,0
0,0,3,3,12,9,21,21,11,32,0.000333,0.046851,6,843.324945,46.851386,140.554158,71.548875,3,0
0,0,9,9,15,19,34,68,35,103,0.000333,0.17467,7,3668.060709,203.78115,524.008673,139.313982,2,0
0,0,4,4,9,10,19,26,20,46,0.000333,0.065135,8,1563.237325,86.846518,195.404666,61.748606,1,0
0,0,3,3,8,7,15,11,9,20,0.000333,0.026046,4,312.551248,17.363958,78.137812,43.651484,1,0
0,0,8,8,15,18,33,66,34,100,0.000333,0.168146,7,3531.075884,196.170882,504.439412,133.662009,2,0
0,0,8,8,15,18,33,66,34,100,0.000333,0.168146,7,3531.075884,196.170882,504.439412,133.662009,2,0
0,0,11,11,15,21,36,84,43,127,0.000333,0.21886,14,9192.126653,510.673703,656.580475,150.842025,2,0
0,0,6,6,9,9,18,28,19,47,0.000333,0.065329,8,1567.891801,87.1051,195.986475,57.05865,1,0
0,0,5,5,10,7,17,20,16,36,0.000333,0.04905,10,1471.486623,81.749257,147.148662,52.870765,1,0
0,0,7,7,11,19,30,44,28,72,0.000333,0.117765,5,1766.480614,98.137812,353.296123,118.764371,2,0
0,0,25,25,12,35,47,382,213,595,0.000333,1.10166,36,118979.2932,6609.960733,3304.980367,222.544456,4,0
0,0,4,4,4,7,11,13,11,24,0.000333,0.027675,2,166.052718,9.225151,83.026359,27.651484,3,0
0,0,8,8,12,15,27,42,27,69,0.000333,0.109362,6,1968.523426,109.362413,328.087238,101.622909,2,0
0,0,4,4,4,7,11,13,11,24,0.000333,0.027675,2,166.052718,9.225151,83.026359,27.651484,2,0
0,0,3,3,6,10,16,25,13,38,0.000333,0.050667,3,456,25.333333,152,48.729056,1,0
0,0,7,7,11,19,30,44,28,72,0.000333,0.117765,5,1766.480614,98.137812,353.296123,118.764371,2,0
0,0,5,5,8,15,23,29,34,63,0.000333,0.094995,8,2279.875226,126.659735,284.984403,82.603359,1,0
0,0,24,24,15,29,44,594,86,680,0.000333,1.237471,14,51973.78901,2887.432723,3712.413501,199.484808,1,0
0,0,3,3,9,8,17,16,11,27,0.000333,0.036787,4,441.445987,24.524777,110.361497,52.529325,2,0
0,0,4,4,5,11,16,13,14,27,0.000333,0.036,2,216,12,108,49.663388,1,0
0,0,4,4,7,13,20,23,18,41,0.000333,0.059066,3,531.597156,29.533175,177.199052,67.757201,1,0
0,0,3,3,8,7,15,11,9,20,0.000333,0.026046,4,312.551248,17.363958,78.137812,43.651484,1,0
0,0,3,3,7,5,12,11,7,18,0.000333,0.02151,3,193.587975,10.754888,64.529325,31.261125,1,0
0,0,3,3,7,8,15,23,12,35,0.000333,0.04558,3,410.223513,22.790195,136.741171,43.651484,1,0
0,0,8,8,13,14,27,39,29,68,0.000333,0.107777,12,3879.988202,215.5549,323.33235,101.408685,1,0
0,0,3,3,8,7,15,11,9,20,0.000333,0.026046,4,312.551248,17.363958,78.137812,43.651484,1,0
0,0,16,16,11,24,35,89,52,141,0.000333,0.241076,10,7232.289054,401.793836,723.228905,148.092848,5,0
0,0,4,4,4,7,11,13,11,24,0.000333,0.027675,2,166.052718,9.225151,83.026359,27.651484,3,0
0,0,3,3,12,9,21,21,11,32,0.000333,0.046851,6,843.324945,46.851386,140.554158,71.548875,3,0
0,0,4,4,4,7,11,13,11,24,0.000333,0.027675,2,166.052718,9.225151,83.026359,27.651484,3,0
0,0,3,3,8,7,15,15,9,24,0.000333,0.031255,4,375.061497,20.83675,93.765374,43.651484,3,0
0,0,4,4,4,7,11,13,11,24,0.000333,0.027675,2,166.052718,9.225151,83.026359,27.651484,3,0
0,0,8,8,15,18,33,66,34,100,0.000333,0.168146,7,3531.075884,196.170882,504.439412,133.662009,2,0
0,0,4,4,5,7,12,14,10,24,0.000333,0.02868,2,172.0782,9.5599,86.0391,31.261125,2,0
0,0,10,10,14,18,32,51,39,90,0.000333,0.15,14,6300,350,450,128.361619,2,0
0,0,8,8,12,17,29,52,34,86,0.000333,0.139262,12,5013.436387,278.524244,417.786366,112.506418,1,0
0,0,13,13,12,19,31,94,48,142,0.000333,0.234499,12,8441.950513,468.997251,703.495876,123.730173,2,0
0,0,4,4,10,7,17,29,15,44,0.000333,0.059949,10,1798.48365,99.915758,179.848365,52.870765,2,0
0,0,5,5,11,12,23,33,21,54,0.000333,0.081424,5,1221.361728,67.853429,244.272346,81.073298,1,0
0,0,3,3,7,8,15,23,12,35,0.000333,0.04558,3,410.223513,22.790195,136.741171,43.651484,1,0
0,0,3,3,7,8,15,23,12,35,0.000333,0.04558,3,410.223513,22.790195,136.741171,43.651484,1,0
0,0,3,3,9,8,17,16,11,27,0.000333,0.036787,4,441.445987,24.524777,110.361497,52.529325,2,0
0,0,5,5,6,11,17,18,16,34,0.000333,0.046325,3,416.92121,23.162289,138.973737,53.563523,1,0
0,0,4,4,4,7,11,13,11,24,0.000333,0.027675,2,166.052718,9.225151,83.026359,27.651484,3,0
0,0,5,5,12,16,28,39,25,64,0.000333,0.102557,6,1846.02429,102.556905,307.670715,107.01955,2,0
0,0,7,7,8,13,21,20,22,42,0.000333,0.061492,4,737.909327,40.994963,184.477332,72.105716,1,0
0,0,13,13,10,14,24,73,48,121,0.000333,0.184927,15,8321.706939,462.317052,554.780463,86.52225,1,0
0,0,4,4,4,7,11,13,11,24,0.000333,0.027675,2,166.052718,9.225151,83.026359,27.651484,3,0
0,0,8,8,8,19,27,46,41,87,0.000333,0.137892,8,3309.401702,183.85565,413.675213,104.710623,1,0
0,0,3,3,7,5,12,11,7,18,0.000333,0.02151,3,193.587975,10.754888,64.529325,31.261125,1,0
0,0,4,4,5,7,12,222,14,236,0.000333,0.282017,4,3384.204601,188.011367,846.05115,31.261125,1,0
0,0,8,8,12,15,27,52,34,86,0.000333,0.136307,12,4907.043902,272.61355,408.920325,101.622909,1,0
0,0,4,4,6,8,14,17,12,29,0.000333,0.036804,3,331.239878,18.402215,110.413293,39.509775,3,0
0,0,9,9,15,19,34,68,35,103,0.000333,0.17467,7,3668.060709,203.78115,524.008673,139.313982,2,0
0,0,4,4,4,7,11,13,11,24,0.000333,0.027675,2,166.052718,9.225151,83.026359,27.651484,3,0
0,0,3,3,8,7,15,11,9,20,0.000333,0.026046,4,312.551248,17.363958,78.137812,43.651484,1,0
0,0,11,11,9,16,25,51,39,90,0.000333,0.139316,8,3343.576457,185.754248,417.947057,92.529325,1,0
0,0,9,9,15,19,34,68,35,103,0.000333,0.17467,7,3668.060709,203.78115,524.008673,139.313982,2,0
0,0,6,6,9,10,19,28,17,45,0.000333,0.063719,4,764.626952,42.479275,191.156738,61.748606,1,0
0,0,6,6,11,11,22,28,18,46,0.000333,0.068378,5,1025.669272,56.981626,205.133854,76.107496,1,0
0,0,25,25,12,35,47,382,213,595,0.000333,1.10166,36,118979.2932,6609.960733,3304.980367,222.544456,4,0
0,0,5,5,8,10,18,28,17,45,0.000333,0.062549,4,750.5865,41.69925,187.646625,57.219281,1,0
0,0,5,5,8,10,18,28,17,45,0.000333,0.062549,4,750.5865,41.69925,187.646625,57.219281,1,0
0,0,6,6,9,14,23,30,21,51,0.000333,0.076901,4,922.806639,51.267036,230.70166,81.832294,1,0
0,0,3,3,8,7,15,20,12,32,0.000333,0.041673,4,500.081996,27.782333,125.020499,43.651484,1,0
0,0,5,5,8,10,18,28,17,45,0.000333,0.062549,4,750.5865,41.69925,187.646625,57.219281,1,0
0,0,6,6,14,11,25,40,23,63,0.000333,0.097521,14,4095.881159,227.548953,292.56294,91.356717,4,0
0,0,4,4,8,7,15,17,10,27,0.000333,0.035162,4,421.944184,23.441344,105.486046,43.651484,1,0
0,0,4,4,4,7,11,13,11,24,0.000333,0.027675,2,166.052718,9.225151,83.026359,27.651484,3,0
0,0,7,7,11,19,30,44,28,72,0.000333,0.117765,5,1766.480614,98.137812,353.296123,118.764371,2,0
0,0,7,7,9,13,22,26,24,50,0.000333,0.074324,4,891.886324,49.54924,222.971581,76.635041,1,0
0,0,8,8,11,15,26,46,32,78,0.000333,0.122211,10,3666.34298,203.685721,366.634298,96.657107,1,0
0,0,5,5,8,10,18,26,15,41,0.000333,0.056989,4,683.8677,37.99265,170.966925,57.219281,1,0
0,0,5,5,7,8,15,17,12,29,0.000333,0.037767,3,339.899482,18.883305,113.299827,43.651484,1,0
0,0,8,8,11,15,26,33,27,60,0.000333,0.094009,5,1410.131915,78.340662,282.026383,96.657107,1,0
0,0,4,4,10,11,21,18,16,34,0.000333,0.04978,5,746.693962,41.482998,149.338792,71.273029,1,0
0,0,10,10,16,19,35,57,44,101,0.000333,0.172686,16,8288.921355,460.495631,518.057585,144.710623,5,0
0,0,9,9,12,18,30,106,32,138,0.000333,0.225717,6,4062.905413,225.716967,677.150902,118.0782,1,0
0,0,6,6,10,11,21,24,21,45,0.000333,0.065885,5,988.27142,54.903968,197.654284,71.273029,1,0
0,0,4,4,4,7,11,13,11,24,0.000333,0.027675,2,166.052718,9.225151,83.026359,27.651484,3,0
0,0,8,8,12,15,27,42,27,69,0.000333,0.109362,6,1968.523426,109.362413,328.087238,101.622909,2,0
0,0,3,3,7,8,15,23,12,35,0.000333,0.04558,3,410.223513,22.790195,136.741171,43.651484,1,0
0,0,4,4,9,13,22,22,17,39,0.000333,0.057973,4,695.671333,38.648407,173.917833,76.635041,3,0
0,0,6,6,8,19,27,34,34,68,0.000333,0.107777,4,1293.329401,71.851633,323.33235,104.710623,1,0
0,0,4,4,5,9,14,15,13,28,0.000333,0.035535,2,213.211876,11.845104,106.605938,40.138965,1,0
0,0,10,10,14,18,32,51,39,90,0.000333,0.15,14,6300,350,450,128.361619,2,0
0,0,4,4,5,7,12,14,10,24,0.000333,0.02868,2,172.0782,9.5599,86.0391,31.261125,2,0
0,0,3,3,9,8,17,16,11,27,0.000333,0.036787,4,441.445987,24.524777,110.361497,52.529325,2,0
0,0,34,34,20,87,107,283,232,515,0.000333,1.157285,20,69437.10996,3857.61722,3471.855498,646.974646,10,0
0,0,3,3,7,8,15,23,12,35,0.000333,0.04558,3,410.223513,22.790195,136.741171,43.651484,1,0
0,0,6,6,14,12,26,41,24,65,0.000333,0.101843,14,4277.400144,237.633341,305.528582,96.322519,5,0
0,0,4,4,9,10,19,24,17,41,0.000333,0.058055,4,696.660112,38.70334,174.165028,61.748606,1,0
0,0,3,3,8,7,15,20,12,32,0.000333,0.041673,4,500.081996,27.782333,125.020499,43.651484,1,0
0,0,3,3,8,8,16,20,12,32,0.000333,0.042667,4,512,28.444444,128,48,1,0
0,0,3,3,8,6,14,11,9,20,0.000333,0.025382,4,304.588394,16.921577,76.147098,39.509775,1,0
0,0,5,5,10,11,21,33,18,51,0.000333,0.074669,5,1120.040943,62.224497,224.008189,71.273029,1,0
0,0,3,3,7,5,12,11,7,18,0.000333,0.02151,3,193.587975,10.754888,64.529325,31.261125,1,0
0,0,3,3,7,9,16,36,18,54,0.000333,0.072,6,1296,72,216,48.180809,1,0
0,0,4,4,6,8,14,17,12,29,0.000333,0.036804,3,331.239878,18.402215,110.413293,39.509775,3,0
0,0,17,17,14,22,36,97,56,153,0.000333,0.263666,14,11073.97935,615.221075,790.998525,151.410465,6,0
0,0,25,25,12,35,47,382,213,595,0.000333,1.10166,36,118979.2932,6609.960733,3304.980367,222.544456,4,0
0,0,11,11,15,21,36,84,43,127,0.000333,0.21886,14,9192.126653,510.673703,656.580475,150.842025,2,0
0,0,5,5,11,12,23,33,21,54,0.000333,0.081424,5,1221.361728,67.853429,244.272346,81.073298,1,0
0,0,8,8,15,18,33,66,34,100,0.000333,0.168146,7,3531.075884,196.170882,504.439412,133.662009,2,0
0,0,18,18,13,26,39,106,60,166,0.000333,0.292459,12,10528.52122,584.917846,877.376768,170.317149,1,0
0,0,8,8,15,18,33,66,34,100,0.000333,0.168146,7,3531.075884,196.170882,504.439412,133.662009,2,0
0,0,4,4,6,13,19,18,18,36,0.000333,0.050975,3,458.776171,25.487565,152.92539,63.615491,1,0
0,0,7,7,11,19,30,44,28,72,0.000333,0.117765,5,1766.480614,98.137812,353.296123,118.764371,2,0
0,0,3,3,7,8,15,23,12,35,0.000333,0.04558,3,410.223513,22.790195,136.741171,43.651484,1,0
0,0,11,11,12,16,28,46,37,83,0.000333,0.133003,12,4788.125502,266.006972,399.010459,107.01955,1,0
0,0,6,6,8,12,20,23,20,43,0.000333,0.061948,4,743.371632,41.298424,185.842908,67.01955,3,0
0,0,15,15,10,15,25,65,58,123,0.000333,0.190398,15,8567.91467,475.995259,571.194311,91.82264,1,0
0,0,8,8,15,18,33,66,34,100,0.000333,0.168146,7,3531.075884,196.170882,504.439412,133.662009,2,0
0,0,7,7,11,19,30,44,28,72,0.000333,0.117765,5,1766.480614,98.137812,353.296123,118.764371,2,0
0,0,6,6,6,8,14,36,22,58,0.000333,0.073609,6,1324.959513,73.608862,220.826585,39.509775,1,0
0,0,4,4,11,10,21,36,17,53,0.000333,0.077598,5,1163.964117,64.664673,232.792823,71.273029,1,0
0,0,4,4,6,8,14,17,12,29,0.000333,0.036804,3,331.239878,18.402215,110.413293,39.509775,3,0
0,0,3,3,9,8,17,16,11,27,0.000333,0.036787,4,441.445987,24.524777,110.361497,52.529325,2,0
0,0,12,12,9,17,26,45,45,90,0.000333,0.141013,8,3384.316597,188.017589,423.039575,98.016193,1,0
0,0,4,4,10,15,25,32,21,53,0.000333,0.082041,5,1230.62189,68.367883,246.124378,91.82264,1,0
0,0,3,3,9,8,17,16,11,27,0.000333,0.036787,4,441.445987,24.524777,110.361497,52.529325,2,0
0,0,4,4,4,7,11,13,11,24,0.000333,0.027675,2,166.052718,9.225151,83.026359,27.651484,3,0
0,0,5,5,7,10,17,26,18,44,0.000333,0.059949,3,539.545095,29.974728,179.848365,52.870765,1,0
0,0,6,6,9,10,19,28,17,45,0.000333,0.063719,4,764.626952,42.479275,191.156738,61.748606,1,0
0,0,6,6,9,15,24,24,26,50,0.000333,0.076416,4,916.9925,50.944028,229.248125,87.132684,1,0
0,0,3,3,8,7,15,11,9,20,0.000333,0.026046,4,312.551248,17.363958,78.137812,43.651484,1,0
0,0,9,9,15,19,34,68,35,103,0.000333,0.17467,7,3668.060709,203.78115,524.008673,139.313982,2,0
0,0,3,3,7,8,15,23,12,35,0.000333,0.04558,3,410.223513,22.790195,136.741171,43.651484,1,0
0,0,17,17,21,26,47,131,75,206,0.000333,0.381415,20,22884.90607,1271.38367,1144.245303,214.450099,9,0
0,0,4,4,10,15,25,32,21,53,0.000333,0.082041,5,1230.62189,68.367883,246.124378,91.82264,1,0
0,0,15,15,15,23,38,83,53,136,0.000333,0.237906,14,9992.053986,555.11411,713.718142,162.645284,2,0
0,0,3,3,8,6,14,11,9,20,0.000333,0.025382,4,304.588394,16.921577,76.147098,39.509775,1,0
0,0,7,7,9,11,20,31,20,51,0.000333,0.073473,4,881.673331,48.981852,220.418333,66.583073,1,0
0,0,5,5,10,12,22,21,17,38,0.000333,0.056486,5,847.292008,47.071778,169.458402,76.238831,1,0
0,0,6,6,14,12,26,43,26,69,0.000333,0.10811,14,4540.624768,252.256932,324.330341,96.322519,4,0
0,0,4,4,6,8,14,17,12,29,0.000333,0.036804,3,331.239878,18.402215,110.413293,39.509775,3,0
0,0,3,3,10,7,17,16,11,27,0.000333,0.036787,5,551.807484,30.655971,110.361497,52.870765,2,0
0,0,6,6,9,10,19,28,17,45,0.000333,0.063719,4,764.626952,42.479275,191.156738,61.748606,1,0
0,0,5,5,11,11,22,31,17,48,0.000333,0.071351,5,1070.263588,59.459088,214.052718,76.107496,1,0
0,0,4,4,4,8,12,19,14,33,0.000333,0.039435,2,236.607525,13.144863,118.303763,32,1,0
0,0,3,3,7,8,15,23,12,35,0.000333,0.04558,3,410.223513,22.790195,136.741171,43.651484,1,0
0,0,9,9,16,24,40,75,54,129,0.000333,0.228843,16,10984.45959,610.247755,686.528724,174.0391,2,0
0,0,9,9,15,19,34,68,35,103,0.000333,0.17467,7,3668.060709,203.78115,524.008673,139.313982,2,0
0,0,3,3,7,8,15,23,12,35,0.000333,0.04558,3,410.223513,22.790195,136.741171,43.651484,1,0
0,0,3,3,8,7,15,20,12,32,0.000333,0.041673,4,500.081996,27.782333,125.020499,43.651484,1,0
0,0,4,4,7,7,14,15,10,25,0.000333,0.031728,3,285.551619,15.863979,95.183873,39.302969,1,0
0,0,11,11,16,20,36,68,50,118,0.000333,0.20335,16,9760.818403,542.267689,610.05115,150.438562,4,0
0,0,5,5,10,10,20,26,15,41,0.000333,0.059066,5,885.995259,49.221959,177.199052,66.438562,1,0
0,0,3,3,10,8,18,16,13,29,0.000333,0.040309,5,604.639125,33.591063,120.927825,57.219281,3,0
0,0,3,3,8,7,15,15,9,24,0.000333,0.031255,4,375.061497,20.83675,93.765374,43.651484,3,0
0,0,4,4,6,8,14,17,12,29,0.000333,0.036804,3,331.239878,18.402215,110.413293,39.509775,3,0
0,0,3,3,7,5,12,11,7,18,0.000333,0.02151,3,193.587975,10.754888,64.529325,31.261125,1,0
0,0,3,3,8,7,15,11,9,20,0.000333,0.026046,4,312.551248,17.363958,78.137812,43.651484,1,0
0,0,5,5,10,11,21,29,17,46,0.000333,0.067349,5,1010.233007,56.124056,202.046601,71.273029,1,0
0,0,4,4,10,15,25,32,21,53,0.000333,0.082041,5,1230.62189,68.367883,246.124378,91.82264,1,0
0,0,5,5,8,10,18,28,17,45,0.000333,0.062549,4,750.5865,41.69925,187.646625,57.219281,1,0
0,0,7,7,11,19,30,44,28,72,0.000333,0.117765,5,1766.480614,98.137812,353.296123,118.764371,2,0
0,0,9,9,14,17,31,45,39,84,0.000333,0.138717,14,5826.134861,323.674159,416.15249,122.789837,1,0
0,0,15,15,12,22,34,100,56,156,0.000333,0.264548,12,9523.730439,529.096135,793.644203,141.127046,2,0
0,0,4,4,6,9,15,16,12,28,0.000333,0.036464,3,328.17881,18.232156,109.392937,44.0391,1,0
0,0,5,5,8,8,16,19,12,31,0.000333,0.041333,4,496,27.555556,124,48,1,0
0,0,3,3,9,8,17,16,11,27,0.000333,0.036787,4,441.445987,24.524777,110.361497,52.529325,2,0
0,0,4,4,4,7,11,13,11,24,0.000333,0.027675,2,166.052718,9.225151,83.026359,27.651484,3,0
0,0,4,4,7,13,20,23,18,41,0.000333,0.059066,3,531.597156,29.533175,177.199052,67.757201,1,0
0,0,11,11,16,21,37,55,46,101,0.000333,0.175385,16,8418.476639,467.693147,526.15479,156.238666,4,0
0,0,5,5,8,10,18,28,17,45,0.000333,0.062549,4,750.5865,41.69925,187.646625,57.219281,1,0
0,0,4,4,4,7,11,13,11,24,0.000333,0.027675,2,166.052718,9.225151,83.026359,27.651484,3,0
0,0,4,4,4,7,11,13,11,24,0.000333,0.027675,2,166.052718,9.225151,83.026359,27.651484,3,0
0,0,5,5,12,13,25,28,18,46,0.000333,0.071206,6,1281.704308,71.205795,213.617385,91.125266,3,0
0,0,5,5,7,15,22,19,23,42,0.000333,0.062432,3,561.888384,31.216021,187.296128,78.254843,1,0
0,0,3,3,9,8,17,16,11,27,0.000333,0.036787,4,441.445987,24.524777,110.361497,52.529325,2,0
0,0,4,4,8,7,15,17,12,29,0.000333,0.037767,4,453.199309,25.177739,113.299827,43.651484,1,0
0,0,16,16,15,23,38,98,57,155,0.000333,0.271143,14,11388.0027,632.666817,813.428765,162.645284,2,0
0,0,7,7,11,19,30,44,28,72,0.000333,0.117765,5,1766.480614,98.137812,353.296123,118.764371,2,0
0,0,6,6,7,11,18,41,25,66,0.000333,0.091738,6,1651.290301,91.73835,275.21505,57.705232,1,0
0,0,5,5,8,10,18,28,17,45,0.000333,0.062549,4,750.5865,41.69925,187.646625,57.219281,1,0
0,0,5,5,10,11,21,33,18,51,0.000333,0.074669,5,1120.040943,62.224497,224.008189,71.273029,1,0
0,0,8,8,15,15,30,47,35,82,0.000333,0.134122,14,5633.110404,312.950578,402.365029,117.206718,4,0
0,0,8,8,15,18,33,66,34,100,0.000333,0.168146,7,3531.075884,196.170882,504.439412,133.662009,2,0
0,0,25,25,12,35,47,382,213,595,0.000333,1.10166,36,118979.2932,6609.960733,3304.980367,222.544456,4,0
0,0,3,3,8,8,16,20,12,32,0.000333,0.042667,4,512,28.444444,128,48,1,0
0,0,5,5,10,10,20,26,15,41,0.000333,0.059066,5,885.995259,49.221959,177.199052,66.438562,1,0
0,0,3,3,7,8,15,23,12,35,0.000333,0.04558,3,410.223513,22.790195,136.741171,43.651484,1,0
0,0,8,8,15,18,33,66,34,100,0.000333,0.168146,7,3531.075884,196.170882,504.439412,133.662009,2,0
0,0,11,11,15,21,36,84,43,127,0.000333,0.21886,14,9192.126653,510.673703,656.580475,150.842025,2,0
0,0,9,9,15,19,34,68,35,103,0.000333,0.17467,7,3668.060709,203.78115,524.008673,139.313982,2,0
0,0,6,6,7,11,18,41,25,66,0.000333,0.091738,6,1651.290301,91.73835,275.21505,57.705232,1,0
0,0,11,11,15,21,36,84,43,127,0.000333,0.21886,14,9192.126653,510.673703,656.580475,150.842025,2,0
0,0,8,8,15,18,33,66,34,100,0.000333,0.168146,7,3531.075884,196.170882,504.439412,133.662009,2,0
0,0,8,8,15,18,33,66,34,100,0.000333,0.168146,7,3531.075884,196.170882,504.439412,133.662009,2,0
0,0,6,6,7,11,18,41,25,66,0.000333,0.091738,6,1651.290301,91.73835,275.21505,57.705232,1,0
0,0,6,6,14,12,26,41,24,65,0.000333,0.101843,14,4277.400144,237.633341,305.528582,96.322519,5,0
0,0,4,4,10,15,25,32,21,53,0.000333,0.082041,5,1230.62189,68.367883,246.124378,91.82264,1,0
0,0,8,8,15,18,33,66,34,100,0.000333,0.168146,7,3531.075884,196.170882,504.439412,133.662009,2,0
0,0,11,11,15,21,36,84,43,127,0.000333,0.21886,14,9192.126653,510.673703,656.580475,150.842025,2,0
0,0,4,4,5,12,17,15,16,31,0.000333,0.042237,2,253.422696,14.079039,126.711348,54.62919,1,0
0,0,4,4,4,7,11,13,11,24,0.000333,0.027675,2,166.052718,9.225151,83.026359,27.651484,2,0
0,0,7,7,9,15,24,23,28,51,0.000333,0.077944,4,935.33235,51.962908,233.833088,87.132684,1,0
0,0,5,5,12,16,28,39,25,64,0.000333,0.102557,6,1846.02429,102.556905,307.670715,107.01955,2,0
0,0,7,7,11,19,30,44,28,72,0.000333,0.117765,5,1766.480614,98.137812,353.296123,118.764371,2,0
0,0,3,3,8,7,15,11,9,20,0.000333,0.026046,4,312.551248,17.363958,78.137812,43.651484,1,0
0,0,5,5,8,13,21,20,18,38,0.000333,0.055636,4,667.632248,37.09068,166.908062,72.105716,1,0
0,0,6,6,7,15,22,31,24,55,0.000333,0.081756,3,735.806217,40.878123,245.268739,78.254843,1,0
0,0,8,8,10,17,27,39,33,72,0.000333,0.114117,5,1711.759501,95.09775,342.3519,102.706149,1,0
0,0,9,9,13,11,24,47,24,71,0.000333,0.108511,12,3906.388051,217.021558,325.532338,86.159464,4,0
0,0,3,3,7,8,15,23,12,35,0.000333,0.04558,3,410.223513,22.790195,136.741171,43.651484,1,0
0,0,8,8,15,18,33,66,34,100,0.000333,0.168146,7,3531.075884,196.170882,504.439412,133.662009,2,0
0,0,9,9,15,19,34,68,35,103,0.000333,0.17467,7,3668.060709,203.78115,524.008673,139.313982,2,0
0,0,10,10,15,20,35,80,41,121,0.000333,0.206881,14,8689.005431,482.722524,620.643245,145.041921,2,0
0,0,5,5,10,14,24,27,22,49,0.000333,0.074888,5,1123.315813,62.406434,224.663163,86.52225,3,0
0,0,8,8,15,18,33,66,34,100,0.000333,0.168146,7,3531.075884,196.170882,504.439412,133.662009,2,0
0,0,7,7,11,19,30,44,28,72,0.000333,0.117765,5,1766.480614,98.137812,353.296123,118.764371,2,0
0,0,8,8,16,17,33,49,35,84,0.000333,0.141243,16,6779.665696,376.648094,423.729106,133.486868,4,0
0,0,5,5,10,9,19,20,18,38,0.000333,0.053807,10,1614.212455,89.67847,161.421246,61.748606,1,0
0,0,11,11,15,21,36,84,43,127,0.000333,0.21886,14,9192.126653,510.673703,656.580475,150.842025,2,0
0,0,9,9,15,19,34,68,35,103,0.000333,0.17467,7,3668.060709,203.78115,524.008673,139.313982,2,0
0,0,6,6,7,11,18,41,25,66,0.000333,0.091738,6,1651.290301,91.73835,275.21505,57.705232,1,0
0,0,4,4,9,10,19,26,20,46,0.000333,0.065135,8,1563.237325,86.846518,195.404666,61.748606,1,0
0,0,7,7,14,16,30,42,33,75,0.000333,0.122672,14,5152.235125,286.235285,368.016795,117.302969,4,0
0,0,7,7,11,19,30,44,28,72,0.000333,0.117765,5,1766.480614,98.137812,353.296123,118.764371,2,0
0,0,3,3,9,8,17,16,11,27,0.000333,0.036787,4,441.445987,24.524777,110.361497,52.529325,2,0
0,0,4,4,4,7,11,13,11,24,0.000333,0.027675,2,166.052718,9.225151,83.026359,27.651484,3,0
0,0,11,11,12,18,30,66,49,115,0.000333,0.188097,12,6771.509022,376.194946,564.292418,118.0782,1,0
0,0,5,5,10,12,22,21,17,38,0.000333,0.056486,5,847.292008,47.071778,169.458402,76.238831,1,0
0,0,9,9,11,15,26,54,26,80,0.000333,0.125345,5,1880.175887,104.454216,376.035177,96.657107,4,0
0,0,3,3,7,5,12,11,7,18,0.000333,0.02151,3,193.587975,10.754888,64.529325,31.261125,1,0
0,0,3,3,7,8,15,23,12,35,0.000333,0.04558,3,410.223513,22.790195,136.741171,43.651484,1,0
0,0,9,9,15,19,34,68,35,103,0.000333,0.17467,7,3668.060709,203.78115,524.008673,139.313982,2,0
0,0,3,3,9,8,17,16,11,27,0.000333,0.036787,4,441.445987,24.524777,110.361497,52.529325,2,0
0,0,5,5,8,8,16,19,12,31,0.000333,0.041333,4,496,27.555556,124,48,1,0
0,0,6,6,10,11,21,24,21,45,0.000333,0.065885,5,988.27142,54.903968,197.654284,71.273029,1,0
0,0,4,4,5,9,14,15,13,28,0.000333,0.035535,2,213.211876,11.845104,106.605938,40.138965,1,0
0,0,7,7,11,12,23,49,24,73,0.000333,0.110073,10,3302.200228,183.455568,330.220023,81.073298,1,0
0,0,17,17,15,23,38,96,56,152,0.000333,0.265895,14,11167.58975,620.421653,797.684982,162.645284,6,0
0,0,5,5,11,12,23,23,17,40,0.000333,0.060314,5,904.712391,50.2618,180.942478,81.073298,1,0
0,0,3,3,11,11,22,29,15,44,0.000333,0.065405,5,981.074956,54.504164,196.214991,76.107496,3,0
0,0,6,6,11,16,27,32,19,51,0.000333,0.080833,5,1212.496313,67.360906,242.499263,102.053748,3,0
0,0,6,6,14,12,26,43,26,69,0.000333,0.10811,14,4540.624768,252.256932,324.330341,96.322519,4,0
0,0,6,6,9,9,18,30,19,49,0.000333,0.068109,8,1634.610601,90.8117,204.326325,57.05865,1,0
0,0,3,3,5,5,10,12,7,19,0.000333,0.021039,2,126.233268,7.012959,63.116634,23.219281,1,0
0,0,4,4,10,15,25,32,21,53,0.000333,0.082041,5,1230.62189,68.367883,246.124378,91.82264,1,0
0,0,5,5,7,13,20,16,19,35,0.000333,0.050422,3,453.80245,25.211247,151.267483,67.757201,1,0
0,0,3,3,8,7,15,11,9,20,0.000333,0.026046,4,312.551248,17.363958,78.137812,43.651484,1,0
0,0,3,3,7,8,15,23,12,35,0.000333,0.04558,3,410.223513,22.790195,136.741171,43.651484,1,0
0,0,4,4,4,7,11,13,11,24,0.000333,0.027675,2,166.052718,9.225151,83.026359,27.651484,3,0
0,0,3,3,8,7,15,11,9,20,0.000333,0.026046,4,312.551248,17.363958,78.137812,43.651484,1,0
0,0,7,7,11,19,30,44,28,72,0.000333,0.117765,5,1766.480614,98.137812,353.296123,118.764371,2,0
0,0,3,3,10,10,20,15,13,28,0.000333,0.040338,5,605.069933,33.614996,121.013987,66.438562,1,0
0,0,4,4,5,10,15,13,13,26,0.000333,0.03386,2,203.158311,11.286573,101.579155,44.828921,1,0
0,0,8,8,15,18,33,66,34,100,0.000333,0.168146,7,3531.075884,196.170882,504.439412,133.662009,2,0
0,0,25,25,12,35,47,382,213,595,0.000333,1.10166,36,118979.2932,6609.960733,3304.980367,222.544456,4,0
0,0,5,5,11,12,23,33,21,54,0.000333,0.081424,5,1221.361728,67.853429,244.272346,81.073298,1,0
0,0,3,3,8,8,16,20,12,32,0.000333,0.042667,4,512,28.444444,128,48,1,0
0,0,7,7,11,19,30,44,28,72,0.000333,0.117765,5,1766.480614,98.137812,353.296123,118.764371,2,0
0,0,9,9,15,19,34,68,35,103,0.000333,0.17467,7,3668.060709,203.78115,524.008673,139.313982,2,0
0,0,11,11,15,21,36,84,43,127,0.000333,0.21886,14,9192.126653,510.673703,656.580475,150.842025,2,0
0,0,4,4,4,7,11,13,11,24,0.000333,0.027675,2,166.052718,9.225151,83.026359,27.651484,3,0
0,0,7,7,11,19,30,44,28,72,0.000333,0.117765,5,1766.480614,98.137812,353.296123,118.764371,2,0
0,0,9,9,15,19,34,68,35,103,0.000333,0.17467,7,3668.060709,203.78115,524.008673,139.313982,2,0
0,0,4,4,8,10,18,34,17,51,0.000333,0.070889,4,850.6647,47.25915,212.666175,57.219281,1,0
0,0,4,4,5,7,12,14,10,24,0.000333,0.02868,2,172.0782,9.5599,86.0391,31.261125,2,0
0,0,5,5,8,10,18,26,15,41,0.000333,0.056989,4,683.8677,37.99265,170.966925,57.219281,1,0
0,0,11,11,15,21,36,84,43,127,0.000333,0.21886,14,9192.126653,510.673703,656.580475,150.842025,2,0
0,0,9,9,15,19,34,68,35,103,0.000333,0.17467,7,3668.060709,203.78115,524.008673,139.313982,2,0
0,0,10,10,15,27,42,169,61,230,0.000333,0.413411,14,17363.2621,964.625672,1240.233007,186.985321,7,0
0,0,7,7,11,19,30,44,28,72,0.000333,0.117765,5,1766.480614,98.137812,353.296123,118.764371,2,0
0,0,9,9,15,19,34,68,35,103,0.000333,0.17467,7,3668.060709,203.78115,524.008673,139.313982,2,0
0,0,4,4,4,7,11,13,11,24,0.000333,0.027675,2,166.052718,9.225151,83.026359,27.651484,3,0
0,0,5,5,7,15,22,31,26,57,0.000333,0.084729,3,762.562807,42.3646,254.187602,78.254843,1,0
0,0,7,7,11,19,30,44,28,72,0.000333,0.117765,5,1766.480614,98.137812,353.296123,118.764371,2,0
0,0,4,4,10,15,25,32,21,53,0.000333,0.082041,5,1230.62189,68.367883,246.124378,91.82264,1,0
0,0,7,7,11,19,30,44,28,72,0.000333,0.117765,5,1766.480614,98.137812,353.296123,118.764371,2,0
0,0,5,5,8,10,18,28,17,45,0.000333,0.062549,4,750.5865,41.69925,187.646625,57.219281,1,0
0,0,3,3,9,8,17,16,11,27,0.000333,0.036787,4,441.445987,24.524777,110.361497,52.529325,2,0
0,0,4,4,6,13,19,20,18,38,0.000333,0.053807,3,484.263737,26.903541,161.421246,63.615491,1,0
0,0,3,3,8,7,15,11,9,20,0.000333,0.026046,4,312.551248,17.363958,78.137812,43.651484,1,0
0,0,11,11,15,21,36,84,43,127,0.000333,0.21886,14,9192.126653,510.673703,656.580475,150.842025,2,0
0,0,9,9,15,19,34,68,35,103,0.000333,0.17467,7,3668.060709,203.78115,524.008673,139.313982,2,0
0,0,7,7,11,19,30,44,28,72,0.000333,0.117765,5,1766.480614,98.137812,353.296123,118.764371,2,0
0,0,6,6,9,10,19,28,17,45,0.000333,0.063719,4,764.626952,42.479275,191.156738,61.748606,1,0
0,0,5,5,9,10,19,35,21,56,0.000333,0.079295,8,1903.071526,105.726196,237.883941,61.748606,4,0
0,0,5,5,8,11,19,30,18,48,0.000333,0.067967,4,815.602083,45.311227,203.900521,62.053748,1,0
0,0,7,7,11,19,30,44,28,72,0.000333,0.117765,5,1766.480614,98.137812,353.296123,118.764371,2,0
0,0,3,3,7,8,15,23,12,35,0.000333,0.04558,3,410.223513,22.790195,136.741171,43.651484,1,0
0,0,3,3,9,8,17,16,11,27,0.000333,0.036787,4,441.445987,24.524777,110.361497,52.529325,2,0
0,0,5,5,12,14,26,26,22,48,0.000333,0.075207,6,1353.726639,75.207035,225.621106,96.322519,1,0
0,0,5,5,10,11,21,29,17,46,0.000333,0.067349,5,1010.233007,56.124056,202.046601,71.273029,1,0
0,0,5,5,14,17,31,60,30,90,0.000333,0.148626,7,3121.143676,173.396871,445.877668,122.789837,4,0
0,0,5,5,8,11,19,25,18,43,0.000333,0.060887,4,730.643532,40.591307,182.660883,62.053748,1,0
0,0,7,7,11,19,30,44,28,72,0.000333,0.117765,5,1766.480614,98.137812,353.296123,118.764371,2,0
0,0,5,5,8,10,18,28,17,45,0.000333,0.062549,4,750.5865,41.69925,187.646625,57.219281,1,0
0,0,3,3,9,8,17,16,11,27,0.000333,0.036787,4,441.445987,24.524777,110.361497,52.529325,2,0
0,0,11,11,11,17,28,56,41,97,0.000333,0.155438,10,4663.134274,259.063015,466.313427,107.540616,1,0
0,0,25,25,12,35,47,382,213,595,0.000333,1.10166,36,118979.2932,6609.960733,3304.980367,222.544456,4,0
0,0,5,5,11,12,23,33,21,54,0.000333,0.081424,5,1221.361728,67.853429,244.272346,81.073298,1,0
0,0,9,9,15,19,34,68,35,103,0.000333,0.17467,7,3668.060709,203.78115,524.008673,139.313982,2,0
0,0,25,25,12,35,47,382,213,595,0.000333,1.10166,36,118979.2932,6609.960733,3304.980367,222.544456,4,0
0,0,5,5,11,12,23,33,21,54,0.000333,0.081424,5,1221.361728,67.853429,244.272346,81.073298,1,0
0,0,4,4,6,13,19,17,17,34,0.000333,0.048143,3,433.288606,24.071589,144.429535,63.615491,1,0
0,0,6,6,10,11,21,24,21,45,0.000333,0.065885,5,988.27142,54.903968,197.654284,71.273029,1,0
0,0,4,4,6,10,16,26,15,41,0.000333,0.054667,3,492,27.333333,164,48.729056,1,0
0,0,7,7,11,19,30,44,28,72,0.000333,0.117765,5,1766.480614,98.137812,353.296123,118.764371,2,0
0,0,7,7,11,19,30,44,28,72,0.000333,0.117765,5,1766.480614,98.137812,353.296123,118.764371,2,0
0,0,4,4,9,7,16,16,11,27,0.000333,0.036,4,432,24,108,48.180809,1,0
0,0,5,5,7,7,14,16,11,27,0.000333,0.034266,3,308.395749,17.133097,102.798583,39.302969,1,0
0,0,3,3,7,8,15,23,12,35,0.000333,0.04558,3,410.223513,22.790195,136.741171,43.651484,1,0
0,0,5,5,8,10,18,28,17,45,0.000333,0.062549,4,750.5865,41.69925,187.646625,57.219281,1,0
0,0,4,4,8,7,15,15,10,25,0.000333,0.032557,4,390.68906,21.704948,97.672265,43.651484,1,0
0,0,7,7,11,19,30,44,28,72,0.000333,0.117765,5,1766.480614,98.137812,353.296123,118.764371,2,0
0,0,9,9,15,19,34,68,35,103,0.000333,0.17467,7,3668.060709,203.78115,524.008673,139.313982,2,0
0,0,7,7,11,19,30,44,28,72,0.000333,0.117765,5,1766.480614,98.137812,353.296123,118.764371,2,0
0,0,10,10,7,14,21,57,36,93,0.000333,0.136162,6,2450.913122,136.16184,408.48552,72.954453,1,0
0,0,8,8,16,16,32,50,34,84,0.000333,0.14,16,6720,373.333333,420,128,4,0
0,0,6,6,14,12,26,41,24,65,0.000333,0.101843,14,4277.400144,237.633341,305.528582,96.322519,5,0
0,0,5,5,7,11,18,28,21,49,0.000333,0.068109,3,612.978975,34.054388,204.326325,57.705232,1,0
0,0,3,3,8,7,15,20,12,32,0.000333,0.041673,4,500.081996,27.782333,125.020499,43.651484,1,0
0,0,5,5,8,15,23,23,24,47,0.000333,0.070869,4,850.429648,47.246092,212.607412,82.603359,1,0
0,0,5,5,10,11,21,20,16,36,0.000333,0.052708,5,790.617136,43.923174,158.123427,71.273029,1,0
0,0,5,5,8,10,18,28,17,45,0.000333,0.062549,4,750.5865,41.69925,187.646625,57.219281,1,0
0,0,11,11,15,21,36,84,43,127,0.000333,0.21886,14,9192.126653,510.673703,656.580475,150.842025,2,0
0,0,6,6,9,10,19,28,17,45,0.000333,0.063719,4,764.626952,42.479275,191.156738,61.748606,1,0
0,0,7,7,11,19,30,44,28,72,0.000333,0.117765,5,1766.480614,98.137812,353.296123,118.764371,2,0
0,0,5,5,8,10,18,28,17,45,0.000333,0.062549,4,750.5865,41.69925,187.646625,57.219281,1,0
0,0,3,3,7,8,15,23,12,35,0.000333,0.04558,3,410.223513,22.790195,136.741171,43.651484,1,0
0,0,3,3,8,7,15,11,9,20,0.000333,0.026046,4,312.551248,17.363958,78.137812,43.651484,1,0
0,0,5,5,8,10,18,26,15,41,0.000333,0.056989,4,683.8677,37.99265,170.966925,57.219281,1,0
0,0,11,11,13,16,29,50,38,88,0.000333,0.142501,12,5130.027931,285.001552,427.502328,112.105716,1,0
0,0,9,9,15,19,34,68,35,103,0.000333,0.17467,7,3668.060709,203.78115,524.008673,139.313982,2,0
0,0,8,8,15,18,33,66,34,100,0.000333,0.168146,7,3531.075884,196.170882,504.439412,133.662009,2,0
0,0,5,5,10,11,21,20,16,36,0.000333,0.052708,5,790.617136,43.923174,158.123427,71.273029,1,0
0,0,3,3,8,7,15,11,9,20,0.000333,0.026046,4,312.551248,17.363958,78.137812,43.651484,1,0
0,0,3,3,7,6,13,17,10,27,0.000333,0.033304,3,299.735617,16.651979,99.911872,35.161259,4,0
0,0,3,3,7,8,15,23,12,35,0.000333,0.04558,3,410.223513,22.790195,136.741171,43.651484,1,0
0,0,4,4,11,7,18,18,13,31,0.000333,0.043089,5,646.338375,35.907688,129.267675,57.705232,1,0
0,0,3,3,7,8,15,23,12,35,0.000333,0.04558,3,410.223513,22.790195,136.741171,43.651484,1,0
0,0,5,5,10,11,21,33,18,51,0.000333,0.074669,5,1120.040943,62.224497,224.008189,71.273029,1,0
0,0,3,3,8,8,16,20,12,32,0.000333,0.042667,4,512,28.444444,128,48,1,0
0,0,5,5,7,7,14,16,11,27,0.000333,0.034266,3,308.395749,17.133097,102.798583,39.302969,1,0
0,0,15,15,14,21,35,85,52,137,0.000333,0.234237,14,9837.964827,546.553601,702.711773,145.541635,2,0
0,0,3,3,9,8,17,16,11,27,0.000333,0.036787,4,441.445987,24.524777,110.361497,52.529325,2,0
0,0,6,6,13,11,24,38,23,61,0.000333,0.093228,12,3356.192551,186.455142,279.682713,86.159464,4,0
0,0,4,4,6,5,11,24,12,36,0.000333,0.041513,6,747.23723,41.513179,124.539538,27.119415,1,0
0,0,4,4,5,7,12,14,10,24,0.000333,0.02868,2,172.0782,9.5599,86.0391,31.261125,2,0
0,0,5,5,9,14,23,20,25,45,0.000333,0.067853,4,814.241152,45.23562,203.560288,81.832294,1,0
0,0,4,4,4,7,11,17,13,30,0.000333,0.034594,2,207.565897,11.531439,103.782949,27.651484,1,0
0,0,5,5,14,10,24,27,14,41,0.000333,0.062661,7,1315.884238,73.10468,187.983463,86.52225,3,0
0,0,4,4,9,10,19,24,17,41,0.000333,0.058055,4,696.660112,38.70334,174.165028,61.748606,1,0
0,0,3,3,8,7,15,11,9,20,0.000333,0.026046,4,312.551248,17.363958,78.137812,43.651484,1,0
0,0,8,8,13,14,27,39,29,68,0.000333,0.107777,12,3879.988202,215.5549,323.33235,101.408685,1,0
0,0,4,4,6,9,15,16,12,28,0.000333,0.036464,3,328.17881,18.232156,109.392937,44.0391,1,0
0,0,3,3,8,7,15,11,9,20,0.000333,0.026046,4,312.551248,17.363958,78.137812,43.651484,1,0
0,0,5,5,10,11,21,33,18,51,0.000333,0.074669,5,1120.040943,62.224497,224.008189,71.273029,1,0
0,0,4,4,7,11,18,24,17,41,0.000333,0.056989,3,512.900775,28.494488,170.966925,57.705232,1,0
0,0,6,6,7,13,20,35,24,59,0.000333,0.084998,3,764.981273,42.49896,254.993758,67.757201,1,0
0,0,5,5,7,7,14,16,11,27,0.000333,0.034266,3,308.395749,17.133097,102.798583,39.302969,1,0
0,0,3,3,7,8,15,23,12,35,0.000333,0.04558,3,410.223513,22.790195,136.741171,43.651484,1,0
0,0,4,4,4,7,11,13,11,24,0.000333,0.027675,2,166.052718,9.225151,83.026359,27.651484,3,0
0,0,5,5,10,13,23,24,19,43,0.000333,0.064838,5,972.565821,54.031434,194.513164,81.324997,1,0
0,0,4,4,10,10,20,25,17,42,0.000333,0.060507,5,907.6049,50.422494,181.52098,66.438562,1,0
0,0,11,11,13,17,30,60,47,107,0.000333,0.175012,12,6300.447525,350.024862,525.037294,117.592585,1,0
0,0,7,7,11,19,30,44,28,72,0.000333,0.117765,5,1766.480614,98.137812,353.296123,118.764371,2,0
0,0,7,7,11,19,30,44,28,72,0.000333,0.117765,5,1766.480614,98.137812,353.296123,118.764371,2,0
0,0,25,25,12,35,47,382,213,595,0.000333,1.10166,36,118979.2932,6609.960733,3304.980367,222.544456,4,0
0,0,4,4,8,7,15,17,10,27,0.000333,0.035162,4,421.944184,23.441344,105.486046,43.651484,1,0
0,0,8,8,16,17,33,49,35,84,0.000333,0.141243,16,6779.665696,376.648094,423.729106,133.486868,4,0
0,0,19,19,10,20,30,124,71,195,0.000333,0.318948,15,14352.65499,797.369722,956.843666,119.657843,1,0
0,0,8,8,15,18,33,66,34,100,0.000333,0.168146,7,3531.075884,196.170882,504.439412,133.662009,2,0
0,0,3,3,7,5,12,11,7,18,0.000333,0.02151,3,193.587975,10.754888,64.529325,31.261125,1,0
0,0,3,3,8,6,14,11,9,20,0.000333,0.025382,4,304.588394,16.921577,76.147098,39.509775,1,0
0,0,5,5,8,10,18,28,17,45,0.000333,0.062549,4,750.5865,41.69925,187.646625,57.219281,1,0
0,0,4,4,11,10,21,36,17,53,0.000333,0.077598,5,1163.964117,64.664673,232.792823,71.273029,1,0
0,0,3,3,10,6,16,22,12,34,0.000333,0.045333,10,1360,75.555556,136,48.729056,1,0
0,0,13,13,16,36,52,233,88,321,0.000333,0.609947,16,29277.45839,1626.525466,1829.84115,250.1173,14,0
0,0,5,5,11,12,23,33,21,54,0.000333,0.081424,5,1221.361728,67.853429,244.272346,81.073298,1,0
0,0,9,9,15,19,34,68,35,103,0.000333,0.17467,7,3668.060709,203.78115,524.008673,139.313982,2,0
0,0,5,5,10,11,21,33,18,51,0.000333,0.074669,5,1120.040943,62.224497,224.008189,71.273029,1,0
0,0,3,3,9,8,17,16,11,27,0.000333,0.036787,4,441.445987,24.524777,110.361497,52.529325,2,0
0,0,4,4,5,12,17,14,15,29,0.000333,0.039512,2,237.072845,13.170714,118.536422,54.62919,1,0
0,0,5,5,9,11,20,19,16,35,0.000333,0.050422,4,605.069933,33.614996,151.267483,66.583073,1,0
0,0,4,4,10,15,25,32,21,53,0.000333,0.082041,5,1230.62189,68.367883,246.124378,91.82264,1,0
0,0,3,3,7,8,15,23,12,35,0.000333,0.04558,3,410.223513,22.790195,136.741171,43.651484,1,0
0,0,3,3,7,5,12,11,7,18,0.000333,0.02151,3,193.587975,10.754888,64.529325,31.261125,1,0
0,0,9,9,15,20,35,72,36,108,0.000333,0.184654,7,3877.737961,215.429887,553.962566,145.041921,2,0
0,0,3,3,9,7,16,19,11,30,0.000333,0.04,4,480,26.666667,120,48.180809,1,0
0,0,8,8,15,18,33,66,34,100,0.000333,0.168146,7,3531.075884,196.170882,504.439412,133.662009,2,0
0,0,4,4,9,7,16,17,12,29,0.000333,0.038667,4,464,25.777778,116,48.180809,1,0
0,0,8,8,16,13,29,56,25,81,0.000333,0.131165,8,3147.971685,174.887316,393.496461,112.105716,3,0
0,0,5,5,8,10,18,28,17,45,0.000333,0.062549,4,750.5865,41.69925,187.646625,57.219281,1,0
0,0,7,7,11,19,30,44,28,72,0.000333,0.117765,5,1766.480614,98.137812,353.296123,118.764371,2,0
0,0,6,6,13,11,24,33,22,55,0.000333,0.084058,12,3026.07525,168.115292,252.172938,86.159464,1,0
0,0,3,3,8,7,15,11,9,20,0.000333,0.026046,4,312.551248,17.363958,78.137812,43.651484,1,0
0,0,3,3,7,5,12,11,7,18,0.000333,0.02151,3,193.587975,10.754888,64.529325,31.261125,1,0
0,0,3,3,10,8,18,16,13,29,0.000333,0.040309,5,604.639125,33.591063,120.927825,57.219281,3,0
0,0,9,9,10,11,21,31,28,59,0.000333,0.086382,10,2591.467279,143.970404,259.146728,71.273029,1,0
0,0,11,11,8,16,24,48,39,87,0.000333,0.132964,8,3191.133901,177.285217,398.891738,88,1,0
0,0,9,9,15,19,34,68,35,103,0.000333,0.17467,7,3668.060709,203.78115,524.008673,139.313982,2,0
0,0,4,4,4,7,11,13,11,24,0.000333,0.027675,2,166.052718,9.225151,83.026359,27.651484,3,0
0,0,5,5,8,11,19,30,18,48,0.000333,0.067967,4,815.602083,45.311227,203.900521,62.053748,1,0
0,0,13,13,10,13,23,53,40,93,0.000333,0.14023,15,6310.368929,350.576052,420.691262,81.324997,1,0
0,0,10,10,12,13,25,41,34,75,0.000333,0.116096,12,4179.470571,232.192809,348.289214,91.125266,1,0
0,0,11,11,13,21,34,91,48,139,0.000333,0.235719,12,8485.888019,471.438223,707.157335,140.344382,2,0
0,0,6,6,14,12,26,43,26,69,0.000333,0.10811,14,4540.624768,252.256932,324.330341,96.322519,4,0
0,0,6,6,8,12,20,23,20,43,0.000333,0.061948,4,743.371632,41.298424,185.842908,67.01955,3,0
0,0,3,3,8,7,15,11,9,20,0.000333,0.026046,4,312.551248,17.363958,78.137812,43.651484,1,0
0,0,4,4,8,7,15,17,12,29,0.000333,0.037767,4,453.199309,25.177739,113.299827,43.651484,1,0
0,0,4,4,4,7,11,13,11,24,0.000333,0.027675,2,166.052718,9.225151,83.026359,27.651484,3,0
0,0,6,6,8,14,22,21,24,45,0.000333,0.066891,4,802.697691,44.594316,200.674423,77.302969,1,0
0,0,11,11,15,19,34,52,28,80,0.000333,0.135666,7,2848.979191,158.276622,406.997027,139.313982,3,0
0,0,5,5,8,10,18,28,17,45,0.000333,0.062549,4,750.5865,41.69925,187.646625,57.219281,1,0
0,0,6,6,8,13,21,42,25,67,0.000333,0.098095,4,1177.141069,65.396726,294.285267,72.105716,1,0
0,0,3,3,8,8,16,20,12,32,0.000333,0.042667,4,512,28.444444,128,48,1,0
0,0,10,10,14,18,32,54,43,97,0.000333,0.161667,14,6790,377.222222,485,128.361619,1,0
0,0,8,8,16,17,33,49,35,84,0.000333,0.141243,16,6779.665696,376.648094,423.729106,133.486868,4,0
0,0,8,8,16,17,33,49,35,84,0.000333,0.141243,16,6779.665696,376.648094,423.729106,133.486868,4,0
0,0,5,5,12,16,28,39,25,64,0.000333,0.102557,6,1846.02429,102.556905,307.670715,107.01955,2,0
0,0,7,7,11,18,29,48,28,76,0.000333,0.123069,5,1846.032778,102.557377,369.206556,113.112398,1,0
0,0,5,5,8,11,19,30,18,48,0.000333,0.067967,4,815.602083,45.311227,203.900521,62.053748,1,0
0,0,5,5,10,10,20,27,14,41,0.000333,0.059066,5,885.995259,49.221959,177.199052,66.438562,3,0
0,0,3,3,11,11,22,26,15,41,0.000333,0.060946,5,914.183482,50.787971,182.836696,76.107496,3,0
0,0,5,5,8,10,18,26,15,41,0.000333,0.056989,4,683.8677,37.99265,170.966925,57.219281,1,0
0,0,5,5,7,7,14,16,11,27,0.000333,0.034266,3,308.395749,17.133097,102.798583,39.302969,1,0
0,0,8,8,13,12,25,39,25,64,0.000333,0.099069,12,3566.481554,198.137864,297.206796,91.125266,1,0
0,0,4,4,4,7,11,13,11,24,0.000333,0.027675,2,166.052718,9.225151,83.026359,27.651484,3,0
0,0,5,5,10,11,21,33,18,51,0.000333,0.074669,5,1120.040943,62.224497,224.008189,71.273029,1,0
0,0,3,3,7,8,15,23,12,35,0.000333,0.04558,3,410.223513,22.790195,136.741171,43.651484,1,0
0,0,3,3,7,5,12,11,7,18,0.000333,0.02151,3,193.587975,10.754888,64.529325,31.261125,1,0
0,0,4,4,4,7,11,13,11,24,0.000333,0.027675,2,166.052718,9.225151,83.026359,27.651484,3,0
0,0,5,5,8,10,18,28,17,45,0.000333,0.062549,4,750.5865,41.69925,187.646625,57.219281,1,0
0,0,5,5,10,11,21,29,17,46,0.000333,0.067349,5,1010.233007,56.124056,202.046601,71.273029,1,0
0,0,6,6,11,13,24,32,23,55,0.000333,0.084058,5,1260.864688,70.048038,252.172938,86.159464,1,0
0,0,4,4,11,12,23,20,16,36,0.000333,0.054283,5,814.241152,45.23562,162.84823,81.073298,1,0
0,0,4,4,5,10,15,14,14,28,0.000333,0.036464,2,218.785873,12.154771,109.392937,44.828921,1,0
0,0,12,12,17,21,38,65,53,118,0.000333,0.206418,16,9908.087145,550.449286,619.255447,161.725534,4,0
0,0,9,9,10,16,26,30,34,64,0.000333,0.100276,10,3008.28142,167.126746,300.828142,97.219281,1,0
0,0,7,7,11,19,30,44,28,72,0.000333,0.117765,5,1766.480614,98.137812,353.296123,118.764371,2,0
0,0,6,6,9,10,19,28,17,45,0.000333,0.063719,4,764.626952,42.479275,191.156738,61.748606,1,0
0,0,5,5,8,10,18,28,17,45,0.000333,0.062549,4,750.5865,41.69925,187.646625,57.219281,1,0
0,0,23,23,13,34,47,157,98,255,0.000333,0.47214,12,16997.04189,944.280105,1416.420157,221.079453,1,0
0,0,3,3,7,8,15,23,12,35,0.000333,0.04558,3,410.223513,22.790195,136.741171,43.651484,1,0
0,0,5,5,7,7,14,16,11,27,0.000333,0.034266,3,308.395749,17.133097,102.798583,39.302969,1,0
0,0,4,4,4,7,11,13,11,24,0.000333,0.027675,2,166.052718,9.225151,83.026359,27.651484,3,0
0,0,3,3,11,11,22,26,15,41,0.000333,0.060946,5,914.183482,50.787971,182.836696,76.107496,3,0
0,0,5,5,8,8,16,19,12,31,0.000333,0.041333,4,496,27.555556,124,48,1,0
0,0,3,3,7,8,15,23,12,35,0.000333,0.04558,3,410.223513,22.790195,136.741171,43.651484,1,0
0,0,3,3,7,8,15,23,12,35,0.000333,0.04558,3,410.223513,22.790195,136.741171,43.651484,1,0
0,0,11,11,15,21,36,84,43,127,0.000333,0.21886,14,9192.126653,510.673703,656.580475,150.842025,2,0
0,0,9,9,15,19,34,68,35,103,0.000333,0.17467,7,3668.060709,203.78115,524.008673,139.313982,2,0
0,0,36,36,16,62,78,272,185,457,0.000333,0.957476,16,45958.86102,2553.270057,2872.428814,433.160171,4,0
0,0,6,6,14,11,25,34,19,53,0.000333,0.082041,7,1722.870646,95.715036,246.124378,91.356717,4,0
0,0,5,5,8,10,18,28,17,45,0.000333,0.062549,4,750.5865,41.69925,187.646625,57.219281,1,0
0,0,6,6,10,11,21,24,21,45,0.000333,0.065885,5,988.27142,54.903968,197.654284,71.273029,1,0
0,0,4,4,8,9,17,24,13,37,0.000333,0.050412,4,604.944501,33.608028,151.236125,52.529325,1,0
0,0,4,4,4,7,11,13,11,24,0.000333,0.027675,2,166.052718,9.225151,83.026359,27.651484,2,0
0,0,8,8,10,17,27,39,34,73,0.000333,0.115702,10,3471.067877,192.837104,347.106788,102.706149,1,0
0,0,4,4,4,7,11,13,11,24,0.000333,0.027675,2,166.052718,9.225151,83.026359,27.651484,3,0
0,0,34,34,12,18,30,223,114,337,0.000333,0.551207,36,59530.39671,3307.244261,1653.622131,118.0782,36,0
0,0,6,6,10,11,21,30,16,46,0.000333,0.067349,5,1010.233007,56.124056,202.046601,71.273029,3,0
0,0,7,7,11,18,29,48,28,76,0.000333,0.123069,5,1846.032778,102.557377,369.206556,113.112398,1,0
0,0,3,3,8,7,15,11,9,20,0.000333,0.026046,4,312.551248,17.363958,78.137812,43.651484,1,0
0,0,7,7,14,15,29,42,31,73,0.000333,0.118211,14,4964.856577,275.825365,354.632613,111.906328,4,0
0,0,4,4,4,7,11,13,11,24,0.000333,0.027675,2,166.052718,9.225151,83.026359,27.651484,3,0
0,0,5,5,7,16,23,31,27,58,0.000333,0.087456,3,787.09978,43.727766,262.366593,83.651484,1,0
0,0,5,5,7,7,14,17,13,30,0.000333,0.038074,3,342.661943,19.036775,114.220648,39.302969,1,0
0,0,3,3,9,8,17,16,11,27,0.000333,0.036787,4,441.445987,24.524777,110.361497,52.529325,2,0
0,0,3,3,9,8,17,16,11,27,0.000333,0.036787,4,441.445987,24.524777,110.361497,52.529325,2,0
0,0,7,7,9,13,22,31,22,53,0.000333,0.078783,4,945.399503,52.522195,236.349876,76.635041,1,0
0,0,3,3,7,8,15,23,12,35,0.000333,0.04558,3,410.223513,22.790195,136.741171,43.651484,1,0
0,0,4,4,4,7,11,13,11,24,0.000333,0.027675,2,166.052718,9.225151,83.026359,27.651484,2,0
0,0,6,6,10,11,21,24,21,45,0.000333,0.065885,5,988.27142,54.903968,197.654284,71.273029,1,0
0,0,7,7,11,19,30,44,28,72,0.000333,0.117765,5,1766.480614,98.137812,353.296123,118.764371,2,0
0,0,3,3,8,8,16,20,12,32,0.000333,0.042667,4,512,28.444444,128,48,1,0
0,0,5,5,9,12,21,31,20,51,0.000333,0.074669,4,896.032754,49.779597,224.008189,71.548875,1,0
0,0,7,7,9,14,23,46,28,74,0.000333,0.111581,8,2677.948678,148.774927,334.743585,81.832294,1,0
0,0,3,3,9,5,14,16,10,26,0.000333,0.032997,8,791.929824,43.996101,98.991228,40.138965,1,0
0,0,11,11,13,16,29,50,38,88,0.000333,0.142501,12,5130.027931,285.001552,427.502328,112.105716,1,0
0,0,5,5,8,11,19,36,19,55,0.000333,0.077879,4,934.544053,51.919114,233.636013,62.053748,1,0
0,0,3,3,8,6,14,11,9,20,0.000333,0.025382,4,304.588394,16.921577,76.147098,39.509775,1,0
0,0,5,5,8,11,19,36,19,55,0.000333,0.077879,4,934.544053,51.919114,233.636013,62.053748,1,0
0,0,6,6,8,12,20,20,21,41,0.000333,0.059066,4,708.796208,39.377567,177.199052,67.01955,1,0
0,0,5,5,9,11,20,26,18,44,0.000333,0.063388,4,760.659345,42.258852,190.164836,66.583073,1,0
0,0,3,3,8,7,15,11,9,20,0.000333,0.026046,4,312.551248,17.363958,78.137812,43.651484,1,0
0,0,8,8,15,18,33,66,34,100,0.000333,0.168146,7,3531.075884,196.170882,504.439412,133.662009,2,0
0,0,4,4,4,7,11,13,11,24,0.000333,0.027675,2,166.052718,9.225151,83.026359,27.651484,3,0
0,0,5,5,11,12,23,33,21,54,0.000333,0.081424,5,1221.361728,67.853429,244.272346,81.073298,1,0
0,0,25,25,12,35,47,382,213,595,0.000333,1.10166,36,118979.2932,6609.960733,3304.980367,222.544456,4,0
0,0,5,5,8,11,19,20,16,36,0.000333,0.050975,4,611.701562,33.98342,152.92539,62.053748,3,0
0,0,5,5,12,16,28,39,25,64,0.000333,0.102557,6,1846.02429,102.556905,307.670715,107.01955,2,0
0,0,4,4,17,14,31,30,20,50,0.000333,0.08257,8,1981.678524,110.093251,247.709816,122.789837,1,0
0,0,5,5,9,9,18,34,14,48,0.000333,0.066719,4,800.6256,44.4792,200.1564,57.05865,3,0
0,0,14,14,11,13,24,62,45,107,0.000333,0.16353,15,7358.864814,408.825823,490.590988,86.159464,1,0
0,0,15,15,12,20,32,105,52,157,0.000333,0.261667,12,9420,523.333333,785,129.458112,10,0
0,0,3,3,8,8,16,20,12,32,0.000333,0.042667,4,512,28.444444,128,48,1,0
0,0,3,3,8,7,15,20,12,32,0.000333,0.041673,4,500.081996,27.782333,125.020499,43.651484,1,0
0,0,9,9,11,13,24,37,31,68,0.000333,0.103926,10,3117.7745,173.209694,311.77745,86.159464,1,0
0,0,6,6,9,9,18,21,15,36,0.000333,0.050039,4,600.4692,33.3594,150.1173,57.05865,1,0
0,0,6,6,14,12,26,43,26,69,0.000333,0.10811,14,4540.624768,252.256932,324.330341,96.322519,4,0
0,0,6,6,9,10,19,28,17,45,0.000333,0.063719,4,764.626952,42.479275,191.156738,61.748606,1,0
0,0,7,7,11,19,30,44,28,72,0.000333,0.117765,5,1766.480614,98.137812,353.296123,118.764371,2,0
0,0,11,11,12,17,29,56,46,102,0.000333,0.165171,12,5946.168738,330.342708,495.514062,112.506418,1,0
0,0,14,14,11,23,34,85,48,133,0.000333,0.225544,10,6766.325579,375.906977,676.632558,142.095673,1,0
0,0,3,3,9,8,17,16,11,27,0.000333,0.036787,4,441.445987,24.524777,110.361497,52.529325,2,0
0,0,6,6,7,11,18,41,25,66,0.000333,0.091738,6,1651.290301,91.73835,275.21505,57.705232,1,0
0,0,17,17,21,26,47,131,75,206,0.000333,0.381415,20,22884.90607,1271.38367,1144.245303,214.450099,9,0
0,0,3,3,10,8,18,16,13,29,0.000333,0.040309,5,604.639125,33.591063,120.927825,57.219281,3,0
0,0,5,5,11,11,22,31,17,48,0.000333,0.071351,5,1070.263588,59.459088,214.052718,76.107496,1,0
0,0,4,4,9,8,17,21,14,35,0.000333,0.047687,4,572.244798,31.791378,143.061199,52.529325,1,0
0,0,13,13,11,22,33,100,50,150,0.000333,0.25222,10,7566.591179,420.366177,756.659118,136.161243,1,0
0,0,5,5,8,11,19,30,18,48,0.000333,0.067967,4,815.602083,45.311227,203.900521,62.053748,1,0
0,0,5,5,10,11,21,29,17,46,0.000333,0.067349,5,1010.233007,56.124056,202.046601,71.273029,1,0
0,0,4,4,4,7,11,13,11,24,0.000333,0.027675,2,166.052718,9.225151,83.026359,27.651484,3,0
0,0,3,3,9,8,17,16,11,27,0.000333,0.036787,4,441.445987,24.524777,110.361497,52.529325,2,0
0,0,5,5,12,16,28,39,25,64,0.000333,0.102557,6,1846.02429,102.556905,307.670715,107.01955,2,0
0,0,25,25,12,35,47,382,213,595,0.000333,1.10166,36,118979.2932,6609.960733,3304.980367,222.544456,4,0
0,0,8,8,9,18,27,49,37,86,0.000333,0.136307,8,3271.362601,181.742367,408.920325,103.587975,1,0
0,0,8,8,15,18,33,66,34,100,0.000333,0.168146,7,3531.075884,196.170882,504.439412,133.662009,2,0
0,0,4,4,9,7,16,16,11,27,0.000333,0.036,4,432,24,108,48.180809,1,0
0,0,11,11,15,21,36,84,43,127,0.000333,0.21886,14,9192.126653,510.673703,656.580475,150.842025,2,0
0,0,5,5,12,16,28,39,25,64,0.000333,0.102557,6,1846.02429,102.556905,307.670715,107.01955,2,0
0,0,6,6,8,11,19,29,21,50,0.000333,0.070799,4,849.585503,47.199195,212.396376,62.053748,1,0
0,0,9,9,15,19,34,68,35,103,0.000333,0.17467,7,3668.060709,203.78115,524.008673,139.313982,2,0
0,0,8,8,13,16,29,37,27,64,0.000333,0.103637,6,1865.464702,103.636928,310.910784,112.105716,2,0
0,0,8,8,15,18,33,66,34,100,0.000333,0.168146,7,3531.075884,196.170882,504.439412,133.662009,2,0
0,0,11,11,15,21,36,84,43,127,0.000333,0.21886,14,9192.126653,510.673703,656.580475,150.842025,2,0
0,0,6,6,9,10,19,28,17,45,0.000333,0.063719,4,764.626952,42.479275,191.156738,61.748606,1,0
0,0,9,9,14,25,39,156,54,210,0.000333,0.369978,14,15539.08252,863.282362,1109.934466,169.399374,5,0
0,0,4,4,9,9,18,28,15,43,0.000333,0.059769,4,717.2271,39.84595,179.306775,57.05865,1,0
0,0,7,7,11,19,30,44,28,72,0.000333,0.117765,5,1766.480614,98.137812,353.296123,118.764371,2,0
0,0,3,3,7,5,12,11,7,18,0.000333,0.02151,3,193.587975,10.754888,64.529325,31.261125,1,0
0,0,3,3,9,8,17,16,11,27,0.000333,0.036787,4,441.445987,24.524777,110.361497,52.529325,2,0
0,0,5,5,12,16,28,39,25,64,0.000333,0.102557,6,1846.02429,102.556905,307.670715,107.01955,2,0
0,0,6,6,9,10,19,28,17,45,0.000333,0.063719,4,764.626952,42.479275,191.156738,61.748606,1,0
0,0,4,4,6,8,14,17,12,29,0.000333,0.036804,3,331.239878,18.402215,110.413293,39.509775,3,0
0,0,4,4,8,7,15,16,12,28,0.000333,0.036464,4,437.571747,24.309541,109.392937,43.651484,1,0
0,0,3,3,9,8,17,16,11,27,0.000333,0.036787,4,441.445987,24.524777,110.361497,52.529325,2,0
0,0,4,4,9,9,18,19,15,34,0.000333,0.047259,4,567.1098,31.5061,141.77745,57.05865,1,0
0,0,3,3,6,9,15,26,11,37,0.000333,0.048185,3,433.664856,24.092492,144.554952,44.0391,1,0
0,0,4,4,6,8,14,17,12,29,0.000333,0.036804,3,331.239878,18.402215,110.413293,39.509775,3,0
0,0,9,9,15,19,34,68,35,103,0.000333,0.17467,7,3668.060709,203.78115,524.008673,139.313982,2,0
0,0,10,10,7,14,21,57,36,93,0.000333,0.136162,6,2450.913122,136.16184,408.48552,72.954453,1,0
0,0,5,5,7,8,15,17,12,29,0.000333,0.037767,3,339.899482,18.883305,113.299827,43.651484,1,0
0,0,3,3,7,5,12,11,7,18,0.000333,0.02151,3,193.587975,10.754888,64.529325,31.261125,1,0
0,0,8,8,9,16,25,349,29,378,0.000333,0.585126,4,7021.510559,390.08392,1755.37764,92.529325,5,0
0,0,3,3,10,8,18,16,13,29,0.000333,0.040309,5,604.639125,33.591063,120.927825,57.219281,3,0
0,0,8,8,16,17,33,50,36,86,0.000333,0.144606,16,6941.086308,385.615906,433.817894,133.486868,4,0
0,0,3,3,9,7,16,19,11,30,0.000333,0.04,4,480,26.666667,120,48.180809,1,0
0,0,7,7,11,19,30,44,28,72,0.000333,0.117765,5,1766.480614,98.137812,353.296123,118.764371,2,0
0,0,5,5,10,10,20,27,14,41,0.000333,0.059066,5,885.995259,49.221959,177.199052,66.438562,3,0
0,0,4,4,4,7,11,13,11,24,0.000333,0.027675,2,166.052718,9.225151,83.026359,27.651484,2,0
0,0,3,3,9,8,17,16,11,27,0.000333,0.036787,4,441.445987,24.524777,110.361497,52.529325,2,0
0,0,5,5,12,13,25,30,20,50,0.000333,0.077398,6,1393.156857,77.397603,232.192809,91.125266,1,0
0,0,11,11,15,21,36,84,43,127,0.000333,0.21886,14,9192.126653,510.673703,656.580475,150.842025,2,0
0,0,8,8,15,18,33,66,34,100,0.000333,0.168146,7,3531.075884,196.170882,504.439412,133.662009,2,0
0,0,3,3,9,13,22,20,16,36,0.000333,0.053513,4,642.158153,35.675453,160.539538,76.635041,3,0
0,0,5,5,7,8,15,17,12,29,0.000333,0.037767,3,339.899482,18.883305,113.299827,43.651484,1,0
0,0,7,7,11,19,30,44,28,72,0.000333,0.117765,5,1766.480614,98.137812,353.296123,118.764371,2,0
0,0,4,4,4,7,11,17,13,30,0.000333,0.034594,2,207.565897,11.531439,103.782949,27.651484,1,0
0,0,5,5,11,12,23,33,21,54,0.000333,0.081424,5,1221.361728,67.853429,244.272346,81.073298,1,0
0,0,25,25,12,35,47,382,213,595,0.000333,1.10166,36,118979.2932,6609.960733,3304.980367,222.544456,4,0
0,0,3,3,8,8,16,20,12,32,0.000333,0.042667,4,512,28.444444,128,48,1,0
0,0,7,7,11,19,30,44,28,72,0.000333,0.117765,5,1766.480614,98.137812,353.296123,118.764371,2,0
0,0,7,7,10,14,24,40,27,67,0.000333,0.102397,5,1535.962438,85.331247,307.192488,86.52225,1,0
0,0,6,6,13,10,23,33,20,53,0.000333,0.079916,12,2876.985404,159.832522,239.748784,81.324997,1,0
0,0,4,4,7,6,13,14,9,23,0.000333,0.02837,3,255.330341,14.185019,85.110114,35.161259,1,0
0,0,4,4,9,7,16,17,12,29,0.000333,0.038667,4,464,25.777778,116,48.180809,1,0
0,0,3,3,9,8,17,16,11,27,0.000333,0.036787,4,441.445987,24.524777,110.361497,52.529325,2,0
0,0,6,6,8,8,16,20,14,34,0.000333,0.045333,4,544,30.222222,136,48,1,0
0,0,4,4,9,9,18,28,15,43,0.000333,0.059769,4,717.2271,39.84595,179.306775,57.05865,1,0
0,0,4,4,4,7,11,13,11,24,0.000333,0.027675,2,166.052718,9.225151,83.026359,27.651484,3,0
0,0,4,4,10,15,25,32,21,53,0.000333,0.082041,5,1230.62189,68.367883,246.124378,91.82264,1,0
0,0,11,11,15,21,36,84,43,127,0.000333,0.21886,14,9192.126653,510.673703,656.580475,150.842025,2,0
0,0,9,9,15,19,34,68,35,103,0.000333,0.17467,7,3668.060709,203.78115,524.008673,139.313982,2,0
0,0,8,8,15,18,33,66,34,100,0.000333,0.168146,7,3531.075884,196.170882,504.439412,133.662009,2,0
0,0,8,8,9,17,26,35,33,68,0.000333,0.106543,4,1278.519603,71.028867,319.629901,98.016193,1,0
0,0,7,7,16,14,30,45,29,74,0.000333,0.121037,16,5809.758465,322.764359,363.109904,117.302969,4,0
0,0,5,5,10,10,20,26,15,41,0.000333,0.059066,5,885.995259,49.221959,177.199052,66.438562,1,0
0,0,3,3,7,8,15,23,12,35,0.000333,0.04558,3,410.223513,22.790195,136.741171,43.651484,1,0
0,0,18,18,14,26,40,146,72,218,0.000333,0.386727,14,16242.52455,902.362475,1160.180325,175.514402,2,0
0,0,6,6,10,11,21,24,21,45,0.000333,0.065885,5,988.27142,54.903968,197.654284,71.273029,1,0
0,0,4,4,5,9,14,15,13,28,0.000333,0.035535,2,213.211876,11.845104,106.605938,40.138965,1,0
0,0,25,25,12,35,47,382,213,595,0.000333,1.10166,36,118979.2932,6609.960733,3304.980367,222.544456,4,0
0,0,4,4,6,8,14,17,12,29,0.000333,0.036804,3,331.239878,18.402215,110.413293,39.509775,3,0
0,0,10,10,14,18,32,51,39,90,0.000333,0.15,14,6300,350,450,128.361619,2,0
0,0,4,4,5,7,12,14,10,24,0.000333,0.02868,2,172.0782,9.5599,86.0391,31.261125,2,0
0,0,5,5,8,12,20,20,17,37,0.000333,0.053304,4,639.645358,35.535853,159.91134,67.01955,1,0
0,0,3,3,9,8,17,16,11,27,0.000333,0.036787,4,441.445987,24.524777,110.361497,52.529325,2,0
0,0,6,6,11,17,28,39,30,69,0.000333,0.110569,5,1658.537448,92.140969,331.70749,107.540616,1,0
0,0,5,5,8,10,18,28,17,45,0.000333,0.062549,4,750.5865,41.69925,187.646625,57.219281,1,0
0,0,3,3,8,7,15,11,9,20,0.000333,0.026046,4,312.551248,17.363958,78.137812,43.651484,1,0
0,0,5,5,11,12,23,33,21,54,0.000333,0.081424,5,1221.361728,67.853429,244.272346,81.073298,1,0
0,0,4,4,8,7,15,17,12,29,0.000333,0.037767,4,453.199309,25.177739,113.299827,43.651484,1,0
0,0,5,5,9,10,19,33,21,54,0.000333,0.076463,8,1835.104686,101.95026,229.388086,61.748606,4,0
0,0,3,3,8,6,14,11,9,20,0.000333,0.025382,4,304.588394,16.921577,76.147098,39.509775,1,0
0,0,12,12,7,18,25,72,44,116,0.000333,0.179562,6,3232.123908,179.562439,538.687318,94.710134,1,0
0,0,3,3,5,6,11,9,8,17,0.000333,0.019603,2,117.620675,6.534482,58.810338,27.119415,3,0
0,0,5,5,10,11,21,29,17,46,0.000333,0.067349,5,1010.233007,56.124056,202.046601,71.273029,1,0
0,0,4,4,4,7,11,13,11,24,0.000333,0.027675,2,166.052718,9.225151,83.026359,27.651484,3,0
0,0,7,7,14,8,22,60,31,91,0.000333,0.135269,21,8521.973823,473.44299,405.808277,77.302969,3,0
0,0,5,5,7,7,14,16,11,27,0.000333,0.034266,3,308.395749,17.133097,102.798583,39.302969,1,0
0,0,4,4,11,10,21,24,14,38,0.000333,0.055636,5,834.54031,46.363351,166.908062,71.273029,3,0
0,0,7,7,11,19,30,44,28,72,0.000333,0.117765,5,1766.480614,98.137812,353.296123,118.764371,2,0
0,0,3,3,7,5,12,11,7,18,0.000333,0.02151,3,193.587975,10.754888,64.529325,31.261125,1,0
0,0,4,4,8,9,17,18,15,33,0.000333,0.044962,4,539.545095,29.974728,134.886274,52.529325,1,0
0,0,9,9,12,13,25,41,32,73,0.000333,0.113001,12,4068.018022,226.001001,339.001502,91.125266,1,0
0,0,4,4,4,7,11,13,11,24,0.000333,0.027675,2,166.052718,9.225151,83.026359,27.651484,3,0
0,0,3,3,8,7,15,11,9,20,0.000333,0.026046,4,312.551248,17.363958,78.137812,43.651484,1,0
0,0,3,3,8,7,15,20,12,32,0.000333,0.041673,4,500.081996,27.782333,125.020499,43.651484,1,0
0,0,7,7,10,14,24,40,27,67,0.000333,0.102397,5,1535.962438,85.331247,307.192488,86.52225,1,0
0,0,4,4,4,7,11,13,11,24,0.000333,0.027675,2,166.052718,9.225151,83.026359,27.651484,3,0
0,0,3,3,7,8,15,23,12,35,0.000333,0.04558,3,410.223513,22.790195,136.741171,43.651484,1,0
0,0,7,7,11,19,30,44,28,72,0.000333,0.117765,5,1766.480614,98.137812,353.296123,118.764371,2,0
0,0,5,5,11,12,23,33,21,54,0.000333,0.081424,5,1221.361728,67.853429,244.272346,81.073298,1,0
0,0,9,9,15,19,34,68,35,103,0.000333,0.17467,7,3668.060709,203.78115,524.008673,139.313982,2,0
0,0,5,5,8,10,18,26,15,41,0.000333,0.056989,4,683.8677,37.99265,170.966925,57.219281,1,0
0,0,7,7,14,15,29,42,31,73,0.000333,0.118211,14,4964.856577,275.825365,354.632613,111.906328,4,0
0,0,7,7,11,19,30,44,28,72,0.000333,0.117765,5,1766.480614,98.137812,353.296123,118.764371,2,0
0,0,3,3,9,8,17,16,11,27,0.000333,0.036787,4,441.445987,24.524777,110.361497,52.529325,2,0
0,0,16,16,12,25,37,93,56,149,0.000333,0.258736,12,9314.502618,517.472368,776.208551,159.115955,1,0
0,0,6,6,7,11,18,41,25,66,0.000333,0.091738,6,1651.290301,91.73835,275.21505,57.705232,1,0
0,0,3,3,8,8,16,20,12,32,0.000333,0.042667,4,512,28.444444,128,48,1,0
0,0,5,5,8,11,19,36,19,55,0.000333,0.077879,4,934.544053,51.919114,233.636013,62.053748,1,0
0,0,7,7,11,19,30,44,28,72,0.000333,0.117765,5,1766.480614,98.137812,353.296123,118.764371,2,0
0,0,6,6,11,13,24,30,22,52,0.000333,0.079473,5,1192.09025,66.227236,238.41805,86.159464,1,0
0,0,8,8,15,18,33,66,34,100,0.000333,0.168146,7,3531.075884,196.170882,504.439412,133.662009,2,0
0,0,3,3,9,8,17,16,11,27,0.000333,0.036787,4,441.445987,24.524777,110.361497,52.529325,2,0
0,0,4,4,7,13,20,23,18,41,0.000333,0.059066,3,531.597156,29.533175,177.199052,67.757201,1,0
0,0,3,3,10,8,18,16,13,29,0.000333,0.040309,5,604.639125,33.591063,120.927825,57.219281,3,0
0,0,13,13,9,18,27,363,44,407,0.000333,0.64508,8,15481.91371,860.106317,1935.239213,103.587975,1,0
0,0,3,3,7,5,12,11,7,18,0.000333,0.02151,3,193.587975,10.754888,64.529325,31.261125,1,0
0,0,3,3,8,8,16,20,12,32,0.000333,0.042667,4,512,28.444444,128,48,1,0
0,0,9,9,15,19,34,68,35,103,0.000333,0.17467,7,3668.060709,203.78115,524.008673,139.313982,2,0
0,0,4,4,4,7,11,13,11,24,0.000333,0.027675,2,166.052718,9.225151,83.026359,27.651484,3,0
0,0,4,4,6,12,18,16,15,31,0.000333,0.043089,3,387.803025,21.544613,129.267675,58.529325,1,0
0,0,4,4,4,7,11,13,11,24,0.000333,0.027675,2,166.052718,9.225151,83.026359,27.651484,3,0
0,0,9,9,15,19,34,68,35,103,0.000333,0.17467,7,3668.060709,203.78115,524.008673,139.313982,2,0
0,0,11,11,15,21,36,84,43,127,0.000333,0.21886,14,9192.126653,510.673703,656.580475,150.842025,2,0
0,0,8,8,15,18,33,66,34,100,0.000333,0.168146,7,3531.075884,196.170882,504.439412,133.662009,2,0
0,0,3,3,9,8,17,16,11,27,0.000333,0.036787,4,441.445987,24.524777,110.361497,52.529325,2,0
0,0,3,3,7,8,15,23,12,35,0.000333,0.04558,3,410.223513,22.790195,136.741171,43.651484,1,0
0,0,5,5,9,10,19,29,21,50,0.000333,0.070799,8,1699.171005,94.398389,212.396376,61.748606,1,0
0,0,4,4,10,15,25,32,21,53,0.000333,0.082041,5,1230.62189,68.367883,246.124378,91.82264,1,0
0,0,5,5,8,10,18,28,17,45,0.000333,0.062549,4,750.5865,41.69925,187.646625,57.219281,1,0
0,0,6,6,14,12,26,38,24,62,0.000333,0.097142,14,4079.981675,226.665649,291.427263,96.322519,4,0
0,0,3,3,9,7,16,24,10,34,0.000333,0.045333,4,544,30.222222,136,48.180809,3,0
0,0,6,6,7,10,17,48,32,80,0.000333,0.108999,9,2942.973246,163.498514,326.997027,52.870765,1,0
0,0,3,3,10,10,20,16,13,29,0.000333,0.041779,5,626.679574,34.815532,125.335915,66.438562,1,0
0,0,5,5,9,13,22,26,21,47,0.000333,0.069864,4,838.373144,46.576286,209.593286,76.635041,3,0
0,0,5,5,7,7,14,16,11,27,0.000333,0.034266,3,308.395749,17.133097,102.798583,39.302969,1,0
0,0,6,6,7,11,18,41,25,66,0.000333,0.091738,6,1651.290301,91.73835,275.21505,57.705232,1,0
0,0,7,7,8,17,25,44,42,86,0.000333,0.133124,8,3194.973059,177.498503,399.371632,93.486868,1,0
0,0,3,3,8,8,16,20,12,32,0.000333,0.042667,4,512,28.444444,128,48,1,0
0,0,5,5,17,15,32,38,23,61,0.000333,0.101667,8,2440,135.555556,305,128.090227,6,0
0,0,8,8,15,18,33,66,34,100,0.000333,0.168146,7,3531.075884,196.170882,504.439412,133.662009,2,0
0,0,11,11,15,21,36,84,43,127,0.000333,0.21886,14,9192.126653,510.673703,656.580475,150.842025,2,0
0,0,9,9,15,20,35,72,36,108,0.000333,0.184654,7,3877.737961,215.429887,553.962566,145.041921,2,0
0,0,10,10,16,21,37,53,45,98,0.000333,0.170175,16,8168.422877,453.801271,510.52643,156.238666,5,0
0,0,8,8,15,18,33,66,34,100,0.000333,0.168146,7,3531.075884,196.170882,504.439412,133.662009,2,0
0,0,5,5,7,7,14,16,11,27,0.000333,0.034266,3,308.395749,17.133097,102.798583,39.302969,1,0
0,0,3,3,9,8,17,16,11,27,0.000333,0.036787,4,441.445987,24.524777,110.361497,52.529325,2,0
0,0,3,3,9,8,17,16,11,27,0.000333,0.036787,4,441.445987,24.524777,110.361497,52.529325,2,0
0,0,4,4,10,15,25,32,21,53,0.000333,0.082041,5,1230.62189,68.367883,246.124378,91.82264,1,0
0,0,8,8,15,18,33,66,34,100,0.000333,0.168146,7,3531.075884,196.170882,504.439412,133.662009,2,0
0,0,5,5,8,10,18,28,17,45,0.000333,0.062549,4,750.5865,41.69925,187.646625,57.219281,1,0
0,0,6,6,9,10,19,28,17,45,0.000333,0.063719,4,764.626952,42.479275,191.156738,61.748606,1,0
0,0,3,3,12,9,21,21,11,32,0.000333,0.046851,6,843.324945,46.851386,140.554158,71.548875,3,0
0,0,19,19,15,25,40,108,64,172,0.000333,0.305124,14,12815.20285,711.955714,915.371632,174.699764,2,0
0,0,3,3,8,7,15,11,9,20,0.000333,0.026046,4,312.551248,17.363958,78.137812,43.651484,1,0
0,0,4,4,5,12,17,15,16,31,0.000333,0.042237,2,253.422696,14.079039,126.711348,54.62919,1,0
0,0,4,4,6,12,18,17,16,33,0.000333,0.045869,3,412.822575,22.934588,137.607525,58.529325,1,0
0,0,6,6,7,11,18,41,25,66,0.000333,0.091738,6,1651.290301,91.73835,275.21505,57.705232,1,0
0,0,3,3,8,8,16,20,12,32,0.000333,0.042667,4,512,28.444444,128,48,1,0
0,0,3,3,7,8,15,23,12,35,0.000333,0.04558,3,410.223513,22.790195,136.741171,43.651484,1,0
0,0,4,4,10,15,25,32,21,53,0.000333,0.082041,5,1230.62189,68.367883,246.124378,91.82264,1,0
0,0,4,4,5,11,16,13,14,27,0.000333,0.036,2,216,12,108,49.663388,1,0
0,0,7,7,10,16,26,26,27,53,0.000333,0.083041,5,1245.616525,69.200918,249.123305,97.219281,1,0
0,0,3,3,7,8,15,23,12,35,0.000333,0.04558,3,410.223513,22.790195,136.741171,43.651484,1,0
0,0,3,3,10,8,18,19,11,30,0.000333,0.041699,5,625.48875,34.749375,125.09775,57.219281,1,0
0,0,4,4,4,7,11,13,11,24,0.000333,0.027675,2,166.052718,9.225151,83.026359,27.651484,3,0
0,0,3,3,7,5,12,11,7,18,0.000333,0.02151,3,193.587975,10.754888,64.529325,31.261125,1,0
0,0,5,5,6,10,16,22,15,37,0.000333,0.049333,3,444,24.666667,148,48.729056,1,0
0,0,3,3,7,8,15,23,12,35,0.000333,0.04558,3,410.223513,22.790195,136.741171,43.651484,1,0
0,0,6,6,14,12,26,41,24,65,0.000333,0.101843,14,4277.400144,237.633341,305.528582,96.322519,5,0
0,0,9,9,15,19,34,68,35,103,0.000333,0.17467,7,3668.060709,203.78115,524.008673,139.313982,2,0
0,0,11,11,15,21,36,84,43,127,0.000333,0.21886,14,9192.126653,510.673703,656.580475,150.842025,2,0
0,0,5,5,10,11,21,29,17,46,0.000333,0.067349,5,1010.233007,56.124056,202.046601,71.273029,1,0
0,0,5,5,8,11,19,30,18,48,0.000333,0.067967,4,815.602083,45.311227,203.900521,62.053748,1,0
0,0,3,3,7,5,12,11,7,18,0.000333,0.02151,3,193.587975,10.754888,64.529325,31.261125,1,0
0,0,5,5,6,13,19,21,19,40,0.000333,0.056639,3,509.751302,28.319517,169.917101,63.615491,1,0
0,0,6,6,9,10,19,28,17,45,0.000333,0.063719,4,764.626952,42.479275,191.156738,61.748606,1,0
0,0,3,3,7,8,15,23,12,35,0.000333,0.04558,3,410.223513,22.790195,136.741171,43.651484,1,0
0,0,9,9,12,19,31,57,43,100,0.000333,0.16514,12,5945.035572,330.279754,495.419631,123.730173,1,0
0,0,19,19,21,26,47,149,82,231,0.000333,0.427703,30,38493.30074,2138.516708,1283.110025,214.450099,11,0
0,0,4,4,10,15,25,32,21,53,0.000333,0.082041,5,1230.62189,68.367883,246.124378,91.82264,1,0
0,0,3,3,8,6,14,11,9,20,0.000333,0.025382,4,304.588394,16.921577,76.147098,39.509775,1,0
0,0,5,5,10,11,21,29,17,46,0.000333,0.067349,5,1010.233007,56.124056,202.046601,71.273029,1,0
0,0,11,11,13,17,30,62,47,109,0.000333,0.178284,12,6418.212899,356.567383,534.851075,117.592585,1,0
0,0,3,3,7,8,15,23,12,35,0.000333,0.04558,3,410.223513,22.790195,136.741171,43.651484,1,0
0,0,6,6,6,12,18,27,20,47,0.000333,0.065329,3,587.959425,32.664413,195.986475,58.529325,1,0
0,0,4,4,10,10,20,25,17,42,0.000333,0.060507,5,907.6049,50.422494,181.52098,66.438562,1,0
0,0,5,5,8,8,16,25,13,38,0.000333,0.050667,4,608,33.777778,152,48,3,0
0,0,8,8,15,18,33,66,34,100,0.000333,0.168146,7,3531.075884,196.170882,504.439412,133.662009,2,0
0,0,7,7,15,17,32,45,36,81,0.000333,0.135,14,5670,315,405,128.090227,4,0
0,0,16,16,11,26,37,113,60,173,0.000333,0.300412,10,9012.354323,500.686351,901.235432,160.26518,6,0
0,0,5,5,11,11,22,31,17,48,0.000333,0.071351,5,1070.263588,59.459088,214.052718,76.107496,1,0
0,0,5,5,10,10,20,26,15,41,0.000333,0.059066,5,885.995259,49.221959,177.199052,66.438562,1,0
0,0,6,6,13,11,24,39,24,63,0.000333,0.096284,12,3466.231651,192.568425,288.852638,86.159464,4,0
0,0,5,5,8,10,18,28,17,45,0.000333,0.062549,4,750.5865,41.69925,187.646625,57.219281,1,0
0,0,6,6,9,10,19,28,17,45,0.000333,0.063719,4,764.626952,42.479275,191.156738,61.748606,1,0
0,0,4,4,5,8,13,23,13,36,0.000333,0.044405,2,266.43166,14.801759,133.21583,35.60964,1,0
0,0,9,9,15,19,34,68,35,103,0.000333,0.17467,7,3668.060709,203.78115,524.008673,139.313982,2,0
0,0,11,11,15,21,36,84,43,127,0.000333,0.21886,14,9192.126653,510.673703,656.580475,150.842025,2,0
0,0,3,3,10,10,20,16,13,29,0.000333,0.041779,5,626.679574,34.815532,125.335915,66.438562,1,0
0,0,4,4,5,10,15,13,13,26,0.000333,0.03386,2,203.158311,11.286573,101.579155,44.828921,1,0
0,0,5,5,7,7,14,16,11,27,0.000333,0.034266,3,308.395749,17.133097,102.798583,39.302969,1,0
0,0,3,3,7,8,15,23,12,35,0.000333,0.04558,3,410.223513,22.790195,136.741171,43.651484,1,0
0,0,5,5,10,11,21,29,17,46,0.000333,0.067349,5,1010.233007,56.124056,202.046601,71.273029,1,0
0,0,5,5,8,13,21,27,20,47,0.000333,0.068813,4,825.755675,45.875315,206.438919,72.105716,1,0
0,0,5,5,8,8,16,19,12,31,0.000333,0.041333,4,496,27.555556,124,48,1,0
0,0,4,4,10,8,18,25,15,40,0.000333,0.055599,5,833.985,46.3325,166.797,57.219281,1,0
0,0,4,4,6,8,14,28,15,43,0.000333,0.054572,3,491.148785,27.286044,163.716262,39.509775,1,0
0,0,9,9,15,19,34,68,35,103,0.000333,0.17467,7,3668.060709,203.78115,524.008673,139.313982,2,0
0,0,11,11,15,21,36,84,43,127,0.000333,0.21886,14,9192.126653,510.673703,656.580475,150.842025,2,0
0,0,8,8,15,18,33,66,34,100,0.000333,0.168146,7,3531.075884,196.170882,504.439412,133.662009,2,0
0,0,22,22,13,31,44,114,69,183,0.000333,0.333025,12,11988.91184,666.050657,999.075986,201.685802,1,0
0,0,6,6,9,14,23,23,24,47,0.000333,0.070869,4,850.429648,47.246092,212.607412,81.832294,1,0
0,0,4,4,10,8,18,19,16,35,0.000333,0.048649,10,1459.473751,81.081875,145.947375,57.219281,1,0
0,0,4,4,11,10,21,24,14,38,0.000333,0.055636,5,834.54031,46.363351,166.908062,71.273029,3,0
0,0,4,4,8,14,22,24,19,43,0.000333,0.063919,4,767.022238,42.612347,191.75556,77.302969,1,0
0,0,7,7,8,16,24,30,28,58,0.000333,0.088643,4,1063.7113,59.095072,265.927825,88,1,0
0,0,3,3,11,11,22,26,15,41,0.000333,0.060946,5,914.183482,50.787971,182.836696,76.107496,3,0
0,0,11,11,15,21,36,84,43,127,0.000333,0.21886,14,9192.126653,510.673703,656.580475,150.842025,2,0
0,0,4,4,4,7,11,13,11,24,0.000333,0.027675,2,166.052718,9.225151,83.026359,27.651484,3,0
0,0,4,4,5,9,14,15,13,28,0.000333,0.035535,2,213.211876,11.845104,106.605938,40.138965,1,0
0,0,4,4,10,15,25,32,21,53,0.000333,0.082041,5,1230.62189,68.367883,246.124378,91.82264,1,0
0,0,11,11,12,19,31,66,55,121,0.000333,0.199819,12,7193.493043,399.638502,599.457754,123.730173,1,0
0,0,3,3,9,8,17,16,11,27,0.000333,0.036787,4,441.445987,24.524777,110.361497,52.529325,2,0
0,0,7,7,10,14,24,40,27,67,0.000333,0.102397,5,1535.962438,85.331247,307.192488,86.52225,1,0
0,0,8,8,14,17,31,44,36,80,0.000333,0.132112,14,5548.699868,308.261104,396.335705,122.789837,4,0
0,0,3,3,7,8,15,23,12,35,0.000333,0.04558,3,410.223513,22.790195,136.741171,43.651484,1,0
0,0,8,8,15,18,33,66,34,100,0.000333,0.168146,7,3531.075884,196.170882,504.439412,133.662009,2,0
0,0,4,4,7,10,17,17,17,34,0.000333,0.046325,3,416.92121,23.162289,138.973737,52.870765,1,0
0,0,4,4,5,7,12,14,10,24,0.000333,0.02868,2,172.0782,9.5599,86.0391,31.261125,2,0
0,0,6,6,8,10,18,30,19,49,0.000333,0.068109,4,817.3053,45.40585,204.326325,57.219281,1,0
0,0,4,4,8,7,15,17,12,29,0.000333,0.037767,4,453.199309,25.177739,113.299827,43.651484,1,0
0,0,3,3,7,8,15,23,12,35,0.000333,0.04558,3,410.223513,22.790195,136.741171,43.651484,1,0
0,0,4,4,11,10,21,24,14,38,0.000333,0.055636,5,834.54031,46.363351,166.908062,71.273029,3,0
0,0,4,4,9,8,17,15,12,27,0.000333,0.036787,4,441.445987,24.524777,110.361497,52.529325,1,0
0,0,5,5,8,10,18,28,17,45,0.000333,0.062549,4,750.5865,41.69925,187.646625,57.219281,1,0
0,0,8,8,15,18,33,66,34,100,0.000333,0.168146,7,3531.075884,196.170882,504.439412,133.662009,2,0
0,0,6,6,11,13,24,32,23,55,0.000333,0.084058,5,1260.864688,70.048038,252.172938,86.159464,1,0
0,0,6,6,15,14,29,37,24,61,0.000333,0.098779,7,2074.357885,115.242105,296.336841,111.906328,3,0
0,0,5,5,8,10,18,28,17,45,0.000333,0.062549,4,750.5865,41.69925,187.646625,57.219281,1,0
0,0,4,4,5,10,15,13,13,26,0.000333,0.03386,2,203.158311,11.286573,101.579155,44.828921,1,0
0,0,36,36,16,62,78,272,185,457,0.000333,0.957476,16,45958.86102,2553.270057,2872.428814,433.160171,4,0
0,0,5,5,8,10,18,28,17,45,0.000333,0.062549,4,750.5865,41.69925,187.646625,57.219281,1,0
0,0,9,9,16,24,40,75,54,129,0.000333,0.228843,16,10984.45959,610.247755,686.528724,174.0391,2,0
0,0,4,4,6,8,14,17,12,29,0.000333,0.036804,3,331.239878,18.402215,110.413293,39.509775,3,0
0,0,3,3,7,8,15,23,12,35,0.000333,0.04558,3,410.223513,22.790195,136.741171,43.651484,1,0
0,0,5,5,8,16,24,20,24,44,0.000333,0.067246,4,806.9534,44.830744,201.73835,88,1,0
0,0,5,5,7,7,14,16,11,27,0.000333,0.034266,3,308.395749,17.133097,102.798583,39.302969,1,0
0,0,5,5,8,10,18,28,17,45,0.000333,0.062549,4,750.5865,41.69925,187.646625,57.219281,1,0
0,0,4,4,12,11,23,18,15,33,0.000333,0.049759,6,895.665267,49.759182,149.277545,81.073298,1,0
0,0,6,6,14,11,25,40,23,63,0.000333,0.097521,14,4095.881159,227.548953,292.56294,91.356717,4,0
0,0,5,5,9,13,22,19,26,45,0.000333,0.066891,8,1605.395383,89.188632,200.674423,76.635041,1,0
0,0,6,6,10,11,21,24,21,45,0.000333,0.065885,5,988.27142,54.903968,197.654284,71.273029,1,0
0,0,6,6,7,11,18,41,25,66,0.000333,0.091738,6,1651.290301,91.73835,275.21505,57.705232,1,0
0,0,10,10,8,13,21,39,32,71,0.000333,0.103952,8,2494.836296,138.602016,311.854537,72.105716,1,0
0,0,5,5,11,11,22,31,17,48,0.000333,0.071351,5,1070.263588,59.459088,214.052718,76.107496,1,0
0,0,4,4,9,9,18,19,15,34,0.000333,0.047259,4,567.1098,31.5061,141.77745,57.05865,1,0
0,0,9,9,12,14,26,48,35,83,0.000333,0.130045,12,4681.637959,260.090998,390.136497,96.322519,1,0
0,0,19,19,19,27,46,152,72,224,0.000333,0.412426,18,22271.00181,1237.277878,1237.277878,209.092585,9,0
0,0,20,20,19,27,46,157,73,230,0.000333,0.423473,18,22867.5465,1270.41925,1270.41925,209.092585,10,0
0,0,8,8,16,17,33,48,34,82,0.000333,0.13788,16,6618.245085,367.680282,413.640318,133.486868,5,0
0,0,5,5,8,8,16,19,12,31,0.000333,0.041333,4,496,27.555556,124,48,1,0
0,0,4,4,6,8,14,17,12,29,0.000333,0.036804,3,331.239878,18.402215,110.413293,39.509775,3,0
0,0,4,4,6,13,19,17,17,34,0.000333,0.048143,3,433.288606,24.071589,144.429535,63.615491,1,0
0,0,3,3,8,8,16,20,12,32,0.000333,0.042667,4,512,28.444444,128,48,1,0
0,0,7,7,11,13,24,39,25,64,0.000333,0.097813,5,1467.188,81.510444,293.4376,86.159464,1,0
0,0,8,8,15,18,33,66,34,100,0.000333,0.168146,7,3531.075884,196.170882,504.439412,133.662009,2,0
0,0,11,11,15,21,36,84,43,127,0.000333,0.21886,14,9192.126653,510.673703,656.580475,150.842025,2,0
0,0,9,9,15,19,34,68,35,103,0.000333,0.17467,7,3668.060709,203.78115,524.008673,139.313982,2,0
0,0,13,13,10,14,24,61,46,107,0.000333,0.16353,15,7358.864814,408.825823,490.590988,86.52225,1,0
0,0,3,3,7,8,15,23,12,35,0.000333,0.04558,3,410.223513,22.790195,136.741171,43.651484,1,0
0,0,8,8,15,18,33,66,34,100,0.000333,0.168146,7,3531.075884,196.170882,504.439412,133.662009,2,0
0,0,7,7,14,16,30,42,33,75,0.000333,0.122672,14,5152.235125,286.235285,368.016795,117.302969,4,0
0,0,4,4,9,13,22,21,17,38,0.000333,0.056486,4,677.833606,37.657423,169.458402,76.635041,3,0
0,0,7,7,9,16,25,36,30,66,0.000333,0.102165,4,1225.978034,68.109891,306.494509,92.529325,1,0
0,0,9,9,15,19,34,47,39,86,0.000333,0.145841,14,6125.305261,340.294737,437.521804,139.313982,5,0
0,0,3,3,8,8,16,20,12,32,0.000333,0.042667,4,512,28.444444,128,48,1,0
0,0,5,5,8,10,18,28,17,45,0.000333,0.062549,4,750.5865,41.69925,187.646625,57.219281,1,0
0,0,5,5,12,16,28,39,25,64,0.000333,0.102557,6,1846.02429,102.556905,307.670715,107.01955,2,0
0,0,6,6,7,13,20,35,24,59,0.000333,0.084998,3,764.981273,42.49896,254.993758,67.757201,1,0
0,0,3,3,7,8,15,23,12,35,0.000333,0.04558,3,410.223513,22.790195,136.741171,43.651484,1,0
0,0,5,5,8,10,18,28,17,45,0.000333,0.062549,4,750.5865,41.69925,187.646625,57.219281,1,0
0,0,6,6,14,11,25,38,23,61,0.000333,0.094425,14,3965.853186,220.325177,283.275228,91.356717,4,0
0,0,5,5,9,11,20,29,23,52,0.000333,0.074913,8,1797.922087,99.88456,224.740261,66.583073,1,0
0,0,5,5,8,8,16,19,12,31,0.000333,0.041333,4,496,27.555556,124,48,1,0
0,0,5,5,10,11,21,29,17,46,0.000333,0.067349,5,1010.233007,56.124056,202.046601,71.273029,1,0
0,0,5,5,6,11,17,26,20,46,0.000333,0.062674,3,564.069872,31.337215,188.023291,53.563523,1,0
0,0,4,4,4,7,11,13,11,24,0.000333,0.027675,2,166.052718,9.225151,83.026359,27.651484,3,0
0,0,5,5,8,10,18,28,17,45,0.000333,0.062549,4,750.5865,41.69925,187.646625,57.219281,1,0
0,0,4,4,7,8,15,16,12,28,0.000333,0.036464,3,328.17881,18.232156,109.392937,43.651484,3,0
0,0,4,4,6,8,14,17,12,29,0.000333,0.036804,3,331.239878,18.402215,110.413293,39.509775,3,0
0,0,5,5,11,12,23,23,17,40,0.000333,0.060314,5,904.712391,50.2618,180.942478,81.073298,1,0
0,0,3,3,7,8,15,23,12,35,0.000333,0.04558,3,410.223513,22.790195,136.741171,43.651484,1,0
0,0,4,4,6,8,14,17,12,29,0.000333,0.036804,3,331.239878,18.402215,110.413293,39.509775,3,0
0,0,8,8,10,18,28,45,37,82,0.000333,0.131401,10,3942.031036,219.001724,394.203104,108.277931,1,0
0,0,5,5,8,11,19,36,19,55,0.000333,0.077879,4,934.544053,51.919114,233.636013,62.053748,1,0
0,0,5,5,8,10,18,26,15,41,0.000333,0.056989,4,683.8677,37.99265,170.966925,57.219281,1,0
0,0,7,7,11,19,30,44,28,72,0.000333,0.117765,5,1766.480614,98.137812,353.296123,118.764371,2,0
0,0,7,7,11,19,30,44,28,72,0.000333,0.117765,5,1766.480614,98.137812,353.296123,118.764371,2,0
0,0,8,8,15,18,33,66,34,100,0.000333,0.168146,7,3531.075884,196.170882,504.439412,133.662009,2,0
0,0,6,6,14,12,26,41,24,65,0.000333,0.101843,14,4277.400144,237.633341,305.528582,96.322519,5,0
0,0,7,7,8,13,21,54,31,85,0.000333,0.124449,8,2986.775847,165.931992,373.346981,72.105716,1,0
0,0,5,5,8,12,20,39,23,62,0.000333,0.08932,4,1071.838168,59.546565,267.959542,67.01955,1,0
0,0,5,5,8,10,18,28,17,45,0.000333,0.062549,4,750.5865,41.69925,187.646625,57.219281,1,0
0,0,4,4,6,13,19,18,17,35,0.000333,0.049559,3,446.032389,24.779577,148.677463,63.615491,1,0
0,0,5,5,8,10,18,28,17,45,0.000333,0.062549,4,750.5865,41.69925,187.646625,57.219281,1,0
0,0,8,8,15,18,33,66,34,100,0.000333,0.168146,7,3531.075884,196.170882,504.439412,133.662009,2,0
0,0,7,7,11,18,29,48,28,76,0.000333,0.123069,5,1846.032778,102.557377,369.206556,113.112398,1,0
0,0,4,4,11,9,20,20,18,38,0.000333,0.054744,10,1642.332676,91.240704,164.233268,66.583073,1,0
0,0,8,8,15,16,31,48,35,83,0.000333,0.137066,14,5756.776113,319.820895,411.198294,122.603359,4,0
0,0,7,7,11,19,30,44,28,72,0.000333,0.117765,5,1766.480614,98.137812,353.296123,118.764371,2,0
0,0,4,4,6,9,15,16,12,28,0.000333,0.036464,3,328.17881,18.232156,109.392937,44.0391,1,0
0,0,4,4,7,13,20,21,18,39,0.000333,0.056185,3,505.665587,28.092533,168.555196,67.757201,1,0
0,0,3,3,8,7,15,11,9,20,0.000333,0.026046,4,312.551248,17.363958,78.137812,43.651484,1,0
0,0,5,5,10,10,20,27,14,41,0.000333,0.059066,5,885.995259,49.221959,177.199052,66.438562,3,0
0,0,3,3,10,8,18,16,13,29,0.000333,0.040309,5,604.639125,33.591063,120.927825,57.219281,3,0
0,0,9,9,15,19,34,68,35,103,0.000333,0.17467,7,3668.060709,203.78115,524.008673,139.313982,2,0
0,0,4,4,5,7,12,14,10,24,0.000333,0.02868,2,172.0782,9.5599,86.0391,31.261125,2,0
0,0,3,3,8,7,15,11,9,20,0.000333,0.026046,4,312.551248,17.363958,78.137812,43.651484,1,0
0,0,11,11,14,17,31,55,37,92,0.000333,0.151929,14,6381.004848,354.500269,455.786061,122.789837,2,0
0,0,3,3,8,7,15,20,12,32,0.000333,0.041673,4,500.081996,27.782333,125.020499,43.651484,1,0
0,0,9,9,12,14,26,47,40,87,0.000333,0.136313,12,4907.259066,272.625504,408.938255,96.322519,1,0
0,0,8,8,9,14,23,35,28,63,0.000333,0.094995,8,2279.875226,126.659735,284.984403,81.832294,1,0
0,0,7,7,11,12,23,49,24,73,0.000333,0.110073,10,3302.200228,183.455568,330.220023,81.073298,1,0
0,0,11,11,15,21,36,84,43,127,0.000333,0.21886,14,9192.126653,510.673703,656.580475,150.842025,2,0
0,0,3,3,8,8,16,20,12,32,0.000333,0.042667,4,512,28.444444,128,48,1,0
0,0,9,9,15,19,34,68,35,103,0.000333,0.17467,7,3668.060709,203.78115,524.008673,139.313982,2,0
0,0,7,7,11,19,30,44,28,72,0.000333,0.117765,5,1766.480614,98.137812,353.296123,118.764371,2,0
0,0,14,14,11,23,34,85,48,133,0.000333,0.225544,10,6766.325579,375.906977,676.632558,142.095673,1,0
0,0,5,5,10,11,21,33,18,51,0.000333,0.074669,5,1120.040943,62.224497,224.008189,71.273029,1,0
0,0,3,3,9,8,17,16,11,27,0.000333,0.036787,4,441.445987,24.524777,110.361497,52.529325,2,0
0,0,5,5,10,10,20,20,20,40,0.000333,0.057626,10,1728.771238,96.042847,172.877124,66.438562,1,0
0,0,5,5,7,13,20,25,20,45,0.000333,0.064829,3,583.460293,32.414461,194.486764,67.757201,1,0
0,0,4,4,4,7,11,13,11,24,0.000333,0.027675,2,166.052718,9.225151,83.026359,27.651484,3,0
0,0,9,9,15,19,34,68,35,103,0.000333,0.17467,7,3668.060709,203.78115,524.008673,139.313982,2,0
0,0,8,8,15,18,33,66,34,100,0.000333,0.168146,7,3531.075884,196.170882,504.439412,133.662009,2,0
0,0,5,5,7,7,14,16,11,27,0.000333,0.034266,3,308.395749,17.133097,102.798583,39.302969,1,0
0,0,3,3,8,7,15,11,9,20,0.000333,0.026046,4,312.551248,17.363958,78.137812,43.651484,1,0
0,0,3,3,7,8,15,23,12,35,0.000333,0.04558,3,410.223513,22.790195,136.741171,43.651484,1,0
0,0,3,3,9,7,16,24,10,34,0.000333,0.045333,4,544,30.222222,136,48.180809,3,0
0,0,3,3,12,10,22,20,15,35,0.000333,0.052027,6,936.48064,52.026702,156.080107,76.238831,2,0
0,0,4,4,4,6,10,16,12,28,0.000333,0.031005,4,372.055947,20.669775,93.013987,23.509775,1,0
0,0,6,6,10,15,25,28,27,55,0.000333,0.085137,5,1277.060452,70.947803,255.41209,91.82264,1,0
0,0,7,7,11,19,30,44,28,72,0.000333,0.117765,5,1766.480614,98.137812,353.296123,118.764371,2,0
0,0,4,4,5,7,12,14,10,24,0.000333,0.02868,2,172.0782,9.5599,86.0391,31.261125,2,0
0,0,4,4,10,15,25,32,21,53,0.000333,0.082041,5,1230.62189,68.367883,246.124378,91.82264,1,0
0,0,8,8,10,11,21,29,25,54,0.000333,0.079062,10,2371.851408,131.769523,237.185141,71.273029,1,0
0,0,3,3,7,5,12,11,7,18,0.000333,0.02151,3,193.587975,10.754888,64.529325,31.261125,1,0
0,0,8,8,15,18,33,66,34,100,0.000333,0.168146,7,3531.075884,196.170882,504.439412,133.662009,2,0
0,0,11,11,15,21,36,84,43,127,0.000333,0.21886,14,9192.126653,510.673703,656.580475,150.842025,2,0
0,0,3,3,7,5,12,11,7,18,0.000333,0.02151,3,193.587975,10.754888,64.529325,31.261125,1,0
0,0,12,12,15,20,35,74,35,109,0.000333,0.186364,7,3913.642942,217.424608,559.091849,145.041921,5,0
0,0,8,8,15,18,33,66,34,100,0.000333,0.168146,7,3531.075884,196.170882,504.439412,133.662009,2,0
0,0,4,4,9,13,22,22,17,39,0.000333,0.057973,4,695.671333,38.648407,173.917833,76.635041,3,0
0,0,4,4,6,8,14,17,12,29,0.000333,0.036804,3,331.239878,18.402215,110.413293,39.509775,3,0
0,0,5,5,8,11,19,36,19,55,0.000333,0.077879,4,934.544053,51.919114,233.636013,62.053748,1,0
0,0,8,8,9,17,26,45,34,79,0.000333,0.123778,8,2970.677902,165.037661,371.334738,98.016193,1,0
0,0,7,7,11,19,30,44,28,72,0.000333,0.117765,5,1766.480614,98.137812,353.296123,118.764371,2,0
0,0,6,6,10,15,25,26,26,52,0.000333,0.080494,5,1207.402609,67.077923,241.480522,91.82264,1,0
0,0,3,3,7,5,12,11,7,18,0.000333,0.02151,3,193.587975,10.754888,64.529325,31.261125,1,0
0,0,9,9,15,20,35,72,36,108,0.000333,0.184654,7,3877.737961,215.429887,553.962566,145.041921,2,0
0,0,10,10,14,22,36,57,37,94,0.000333,0.161991,7,3401.810651,188.989481,485.97295,151.410465,1,0
0,0,3,3,7,5,12,11,7,18,0.000333,0.02151,3,193.587975,10.754888,64.529325,31.261125,1,0
0,0,8,8,15,18,33,66,34,100,0.000333,0.168146,7,3531.075884,196.170882,504.439412,133.662009,2,0
0,0,3,3,8,8,16,20,12,32,0.000333,0.042667,4,512,28.444444,128,48,1,0
0,0,8,8,15,18,33,66,34,100,0.000333,0.168146,7,3531.075884,196.170882,504.439412,133.662009,2,0
0,0,14,14,11,23,34,85,48,133,0.000333,0.225544,10,6766.325579,375.906977,676.632558,142.095673,1,0
0,0,3,3,8,8,16,20,12,32,0.000333,0.042667,4,512,28.444444,128,48,1,0
0,0,3,3,9,8,17,16,11,27,0.000333,0.036787,4,441.445987,24.524777,110.361497,52.529325,2,0
0,0,25,25,12,35,47,382,213,595,0.000333,1.10166,36,118979.2932,6609.960733,3304.980367,222.544456,4,0
0,0,13,13,17,29,46,73,55,128,0.000333,0.235672,8,5656.127443,314.229302,707.01593,210.368317,4,0
0,0,13,13,16,36,52,233,88,321,0.000333,0.609947,16,29277.45839,1626.525466,1829.84115,250.1173,14,0
0,0,4,4,7,8,15,19,14,33,0.000333,0.042976,3,386.782169,21.487898,128.92739,43.651484,1,0
0,0,5,5,7,7,14,16,11,27,0.000333,0.034266,3,308.395749,17.133097,102.798583,39.302969,1,0
0,0,4,4,9,8,17,15,12,27,0.000333,0.036787,4,441.445987,24.524777,110.361497,52.529325,1,0
0,0,7,7,11,19,30,44,28,72,0.000333,0.117765,5,1766.480614,98.137812,353.296123,118.764371,2,0
0,0,11,11,15,21,36,84,43,127,0.000333,0.21886,14,9192.126653,510.673703,656.580475,150.842025,2,0
0,0,9,9,15,19,34,68,35,103,0.000333,0.17467,7,3668.060709,203.78115,524.008673,139.313982,2,0
0,0,8,8,15,18,33,66,34,100,0.000333,0.168146,7,3531.075884,196.170882,504.439412,133.662009,2,0
0,0,3,3,8,7,15,11,9,20,0.000333,0.026046,4,312.551248,17.363958,78.137812,43.651484,1,0
0,0,5,5,7,7,14,16,11,27,0.000333,0.034266,3,308.395749,17.133097,102.798583,39.302969,1,0
0,0,11,11,15,21,36,84,43,127,0.000333,0.21886,14,9192.126653,510.673703,656.580475,150.842025,2,0
0,0,5,5,12,16,28,39,25,64,0.000333,0.102557,6,1846.02429,102.556905,307.670715,107.01955,2,0
0,0,3,3,7,8,15,23,12,35,0.000333,0.04558,3,410.223513,22.790195,136.741171,43.651484,1,0
0,0,8,8,12,15,27,42,27,69,0.000333,0.109362,6,1968.523426,109.362413,328.087238,101.622909,2,0
0,0,4,4,10,15,25,32,21,53,0.000333,0.082041,5,1230.62189,68.367883,246.124378,91.82264,1,0
0,0,3,3,11,11,22,26,15,41,0.000333,0.060946,5,914.183482,50.787971,182.836696,76.107496,3,0
0,0,4,4,11,10,21,24,14,38,0.000333,0.055636,5,834.54031,46.363351,166.908062,71.273029,3,0
0,0,4,4,4,7,11,13,11,24,0.000333,0.027675,2,166.052718,9.225151,83.026359,27.651484,3,0
0,0,10,10,16,21,37,55,47,102,0.000333,0.177121,16,8501.827893,472.323772,531.364243,156.238666,4,0
0,0,28,28,17,39,56,146,79,225,0.000333,0.435552,16,20906.47772,1161.470984,1306.654857,275.617555,11,0
0,0,3,3,8,8,16,20,12,32,0.000333,0.042667,4,512,28.444444,128,48,1,0
0,0,11,11,15,21,36,84,43,127,0.000333,0.21886,14,9192.126653,510.673703,656.580475,150.842025,2,0
0,0,8,8,8,16,24,57,30,87,0.000333,0.132964,4,1595.56695,88.642608,398.891738,88,1,0
0,0,8,8,15,18,33,66,34,100,0.000333,0.168146,7,3531.075884,196.170882,504.439412,133.662009,2,0
0,0,6,6,13,16,29,37,23,60,0.000333,0.09716,6,1748.873158,97.15962,291.47886,112.105716,3,0
0,0,9,9,15,19,34,68,35,103,0.000333,0.17467,7,3668.060709,203.78115,524.008673,139.313982,2,0
0,0,3,3,8,7,15,15,9,24,0.000333,0.031255,4,375.061497,20.83675,93.765374,43.651484,3,0
0,0,6,6,6,15,21,23,32,55,0.000333,0.080526,6,1449.46475,80.525819,241.577458,74.113134,1,0
0,0,3,3,7,5,12,11,7,18,0.000333,0.02151,3,193.587975,10.754888,64.529325,31.261125,1,0
0,0,7,7,11,19,30,44,28,72,0.000333,0.117765,5,1766.480614,98.137812,353.296123,118.764371,2,0
0,0,11,11,12,16,28,46,37,83,0.000333,0.133003,12,4788.125502,266.006972,399.010459,107.01955,1,0
0,0,4,4,10,15,25,32,21,53,0.000333,0.082041,5,1230.62189,68.367883,246.124378,91.82264,1,0
0,0,5,5,11,13,24,24,18,42,0.000333,0.064189,5,962.842125,53.491229,192.568425,86.159464,1,0
0,0,5,5,8,14,22,23,20,43,0.000333,0.063919,4,767.022238,42.612347,191.75556,77.302969,1,0
0,0,9,9,15,19,34,68,35,103,0.000333,0.17467,7,3668.060709,203.78115,524.008673,139.313982,2,0
0,0,11,11,15,21,36,84,43,127,0.000333,0.21886,14,9192.126653,510.673703,656.580475,150.842025,2,0
0,0,4,4,5,7,12,14,10,24,0.000333,0.02868,2,172.0782,9.5599,86.0391,31.261125,2,0
0,0,11,11,14,18,32,54,42,96,0.000333,0.16,14,6720,373.333333,480,128.361619,2,0
0,0,7,7,11,19,30,44,28,72,0.000333,0.117765,5,1766.480614,98.137812,353.296123,118.764371,2,0
0,0,7,7,8,16,24,30,31,61,0.000333,0.093228,4,1118.73085,62.151714,279.682713,88,1,0
0,0,5,5,8,14,22,28,29,57,0.000333,0.084729,8,2033.500818,112.972268,254.187602,77.302969,1,0
0,0,11,11,16,22,38,55,48,103,0.000333,0.180179,16,8648.584542,480.476919,540.536534,162.107496,4,0
0,0,5,5,8,10,18,26,15,41,0.000333,0.056989,4,683.8677,37.99265,170.966925,57.219281,1,0
0,0,5,5,7,7,14,16,11,27,0.000333,0.034266,3,308.395749,17.133097,102.798583,39.302969,1,0
0,0,3,3,8,8,16,20,12,32,0.000333,0.042667,4,512,28.444444,128,48,1,0
0,0,4,4,4,7,11,13,11,24,0.000333,0.027675,2,166.052718,9.225151,83.026359,27.651484,3,0
0,0,3,3,9,8,17,16,11,27,0.000333,0.036787,4,441.445987,24.524777,110.361497,52.529325,2,0
0,0,5,5,8,11,19,30,18,48,0.000333,0.067967,4,815.602083,45.311227,203.900521,62.053748,1,0
0,0,3,3,8,7,15,20,12,32,0.000333,0.041673,4,500.081996,27.782333,125.020499,43.651484,1,0
0,0,13,13,13,22,35,98,52,150,0.000333,0.256464,12,9232.709431,512.928302,769.392453,146.213212,2,0
0,0,3,3,8,7,15,20,12,32,0.000333,0.041673,4,500.081996,27.782333,125.020499,43.651484,1,0
0,0,7,7,8,16,24,30,31,61,0.000333,0.093228,4,1118.73085,62.151714,279.682713,88,1,0
0,0,5,5,9,11,20,29,23,52,0.000333,0.074913,8,1797.922087,99.88456,224.740261,66.583073,1,0
0,0,3,3,8,7,15,11,9,20,0.000333,0.026046,4,312.551248,17.363958,78.137812,43.651484,1,0
0,0,3,3,10,8,18,16,13,29,0.000333,0.040309,5,604.639125,33.591063,120.927825,57.219281,3,0
0,0,5,5,11,12,23,33,21,54,0.000333,0.081424,5,1221.361728,67.853429,244.272346,81.073298,1,0
0,0,25,25,12,35,47,382,213,595,0.000333,1.10166,36,118979.2932,6609.960733,3304.980367,222.544456,4,0
0,0,11,11,16,19,35,65,47,112,0.000333,0.191493,16,9191.675166,510.64862,574.479698,144.710623,4,0
0,0,4,4,4,7,11,13,11,24,0.000333,0.027675,2,166.052718,9.225151,83.026359,27.651484,3,0
0,0,3,3,9,11,20,19,16,35,0.000333,0.050422,4,605.069933,33.614996,151.267483,66.583073,1,0
0,0,3,3,7,8,15,23,12,35,0.000333,0.04558,3,410.223513,22.790195,136.741171,43.651484,1,0
0,0,3,3,9,8,17,16,11,27,0.000333,0.036787,4,441.445987,24.524777,110.361497,52.529325,2,0
0,0,6,6,9,10,19,28,17,45,0.000333,0.063719,4,764.626952,42.479275,191.156738,61.748606,1,0
0,0,25,25,12,35,47,382,213,595,0.000333,1.10166,36,118979.2932,6609.960733,3304.980367,222.544456,4,0
0,0,5,5,11,12,23,33,21,54,0.000333,0.081424,5,1221.361728,67.853429,244.272346,81.073298,1,0
0,0,6,6,9,10,19,28,17,45,0.000333,0.063719,4,764.626952,42.479275,191.156738,61.748606,1,0
0,0,5,5,11,12,23,33,21,54,0.000333,0.081424,5,1221.361728,67.853429,244.272346,81.073298,1,0
0,0,25,25,12,35,47,382,213,595,0.000333,1.10166,36,118979.2932,6609.960733,3304.980367,222.544456,4,0
0,0,12,12,16,17,33,68,49,117,0.000333,0.196731,16,9443.105791,524.616988,590.194112,133.486868,5,0
0,0,4,4,4,7,11,13,11,24,0.000333,0.027675,2,166.052718,9.225151,83.026359,27.651484,3,0
0,0,3,3,8,7,15,15,9,24,0.000333,0.031255,4,375.061497,20.83675,93.765374,43.651484,3,0
0,0,4,4,8,7,15,16,12,28,0.000333,0.036464,4,437.571747,24.309541,109.392937,43.651484,1,0
0,0,3,3,7,5,12,11,7,18,0.000333,0.02151,3,193.587975,10.754888,64.529325,31.261125,1,0
0,0,5,5,10,11,21,29,17,46,0.000333,0.067349,5,1010.233007,56.124056,202.046601,71.273029,1,0
0,0,4,4,13,12,25,25,15,40,0.000333,0.061918,6,1114.525486,61.918083,185.754248,91.125266,3,0
0,0,6,6,8,13,21,29,22,51,0.000333,0.074669,4,896.032754,49.779597,224.008189,72.105716,1,0
0,0,4,4,5,10,15,14,14,28,0.000333,0.036464,2,218.785873,12.154771,109.392937,44.828921,1,0
0,0,4,4,10,15,25,32,21,53,0.000333,0.082041,5,1230.62189,68.367883,246.124378,91.82264,1,0
0,0,3,3,7,8,15,23,12,35,0.000333,0.04558,3,410.223513,22.790195,136.741171,43.651484,1,0
0,0,3,3,8,6,14,11,9,20,0.000333,0.025382,4,304.588394,16.921577,76.147098,39.509775,1,0
0,0,25,25,12,35,47,382,213,595,0.000333,1.10166,36,118979.2932,6609.960733,3304.980367,222.544456,4,0
0,0,5,5,11,12,23,33,21,54,0.000333,0.081424,5,1221.361728,67.853429,244.272346,81.073298,1,0
0,0,8,8,10,18,28,51,38,89,0.000333,0.142618,10,4278.545881,237.696993,427.854588,108.277931,1,0
0,0,5,5,8,10,18,28,17,45,0.000333,0.062549,4,750.5865,41.69925,187.646625,57.219281,1,0
0,0,30,30,13,34,47,193,107,300,0.000333,0.555459,18,29994.7798,1666.376656,1666.376656,221.079453,1,0
0,0,3,3,6,4,10,17,9,26,0.000333,0.02879,6,518.220783,28.790043,86.37013,23.509775,1,0
0,0,4,4,6,13,19,17,17,34,0.000333,0.048143,3,433.288606,24.071589,144.429535,63.615491,1,0
0,0,4,4,4,7,11,13,11,24,0.000333,0.027675,2,166.052718,9.225151,83.026359,27.651484,3,0
0,0,8,8,15,18,33,66,34,100,0.000333,0.168146,7,3531.075884,196.170882,504.439412,133.662009,2,0
0,0,3,3,9,8,17,16,11,27,0.000333,0.036787,4,441.445987,24.524777,110.361497,52.529325,2,0
0,0,6,6,13,15,28,30,23,53,0.000333,0.08493,6,1528.738865,84.929937,254.789811,106.709075,4,0
0,0,4,4,8,10,18,34,17,51,0.000333,0.070889,4,850.6647,47.25915,212.666175,57.219281,1,0
0,0,5,5,11,12,23,33,21,54,0.000333,0.081424,5,1221.361728,67.853429,244.272346,81.073298,1,0
0,0,4,4,7,6,13,14,9,23,0.000333,0.02837,3,255.330341,14.185019,85.110114,35.161259,1,0
0,0,5,5,8,11,19,30,18,48,0.000333,0.067967,4,815.602083,45.311227,203.900521,62.053748,1,0
0,0,3,3,5,6,11,9,8,17,0.000333,0.019603,2,117.620675,6.534482,58.810338,27.119415,1,0
0,0,11,11,15,21,36,84,43,127,0.000333,0.21886,14,9192.126653,510.673703,656.580475,150.842025,2,0
0,0,6,6,14,11,25,38,23,61,0.000333,0.094425,14,3965.853186,220.325177,283.275228,91.356717,4,0
0,0,4,4,9,9,18,19,15,34,0.000333,0.047259,4,567.1098,31.5061,141.77745,57.05865,1,0
0,0,4,4,9,8,17,31,17,48,0.000333,0.065399,8,1569.585731,87.199207,196.198216,52.529325,1,0
0,0,3,3,7,8,15,23,12,35,0.000333,0.04558,3,410.223513,22.790195,136.741171,43.651484,1,0
0,0,5,5,11,12,23,33,18,51,0.000333,0.076901,5,1153.508299,64.083794,230.70166,81.073298,3,0
0,0,6,6,7,11,18,41,25,66,0.000333,0.091738,6,1651.290301,91.73835,275.21505,57.705232,1,0
0,0,4,4,4,7,11,13,11,24,0.000333,0.027675,2,166.052718,9.225151,83.026359,27.651484,3,0
0,0,3,3,12,9,21,21,11,32,0.000333,0.046851,6,843.324945,46.851386,140.554158,71.548875,3,0
0,0,11,11,13,18,31,67,49,116,0.000333,0.191562,12,6896.241264,383.124515,574.686772,123.164366,1,0
0,0,3,3,7,8,15,23,12,35,0.000333,0.04558,3,410.223513,22.790195,136.741171,43.651484,1,0
0,0,4,4,5,10,15,13,13,26,0.000333,0.03386,2,203.158311,11.286573,101.579155,44.828921,1,0
0,0,10,10,7,14,21,57,36,93,0.000333,0.136162,6,2450.913122,136.16184,408.48552,72.954453,1,0
0,0,11,11,11,18,29,70,34,104,0.000333,0.16841,5,2526.150117,140.341673,505.230023,113.112398,11,0
0,0,7,7,11,19,30,44,28,72,0.000333,0.117765,5,1766.480614,98.137812,353.296123,118.764371,2,0
0,0,4,4,8,6,14,16,12,28,0.000333,0.035535,8,852.847503,47.380417,106.605938,39.509775,1,0
0,0,11,11,12,18,30,69,40,109,0.000333,0.178284,12,6418.212899,356.567383,534.851075,118.0782,2,0
0,0,4,4,8,10,18,34,17,51,0.000333,0.070889,4,850.6647,47.25915,212.666175,57.219281,1,0
0,0,3,3,7,8,15,23,12,35,0.000333,0.04558,3,410.223513,22.790195,136.741171,43.651484,1,0
0,0,14,14,11,23,34,85,48,133,0.000333,0.225544,10,6766.325579,375.906977,676.632558,142.095673,1,0
0,0,3,3,8,8,16,20,12,32,0.000333,0.042667,4,512,28.444444,128,48,1,0
0,0,3,3,7,8,15,23,12,35,0.000333,0.04558,3,410.223513,22.790195,136.741171,43.651484,1,0
0,0,3,3,9,8,17,16,11,27,0.000333,0.036787,4,441.445987,24.524777,110.361497,52.529325,2,0
0,0,4,4,5,11,16,13,14,27,0.000333,0.036,2,216,12,108,49.663388,1,0
0,0,4,4,5,10,15,13,13,26,0.000333,0.03386,2,203.158311,11.286573,101.579155,44.828921,1,0
0,0,4,4,8,13,21,25,26,51,0.000333,0.074669,8,1792.065508,99.559195,224.008189,72.105716,1,0
0,0,11,11,12,18,30,69,40,109,0.000333,0.178284,12,6418.212899,356.567383,534.851075,118.0782,2,0
0,0,5,5,8,10,18,28,17,45,0.000333,0.062549,4,750.5865,41.69925,187.646625,57.219281,1,0
0,0,4,4,6,5,11,24,12,36,0.000333,0.041513,6,747.23723,41.513179,124.539538,27.119415,1,0
0,0,4,4,6,10,16,17,14,31,0.000333,0.041333,3,372,20.666667,124,48.729056,1,0
0,0,5,5,8,11,19,30,18,48,0.000333,0.067967,4,815.602083,45.311227,203.900521,62.053748,1,0
0,0,5,5,7,9,16,26,17,43,0.000333,0.057333,3,516,28.666667,172,48.180809,1,0
0,0,3,3,7,5,12,11,7,18,0.000333,0.02151,3,193.587975,10.754888,64.529325,31.261125,1,0
0,0,3,3,9,8,17,16,11,27,0.000333,0.036787,4,441.445987,24.524777,110.361497,52.529325,2,0
0,0,4,4,6,8,14,23,14,37,0.000333,0.046957,3,422.616396,23.478689,140.872132,39.509775,1,0
0,0,4,4,8,7,15,17,12,29,0.000333,0.037767,4,453.199309,25.177739,113.299827,43.651484,1,0
0,0,4,4,4,6,10,16,12,28,0.000333,0.031005,4,372.055947,20.669775,93.013987,23.509775,1,0
0,0,7,7,14,17,31,42,35,77,0.000333,0.127158,14,5340.623623,296.701312,381.473116,122.789837,4,0
0,0,5,5,7,8,15,17,12,29,0.000333,0.037767,3,339.899482,18.883305,113.299827,43.651484,1,0
0,0,5,5,8,10,18,28,17,45,0.000333,0.062549,4,750.5865,41.69925,187.646625,57.219281,1,0
0,0,8,8,9,14,23,35,28,63,0.000333,0.094995,8,2279.875226,126.659735,284.984403,81.832294,1,0
0,0,5,5,8,11,19,30,18,48,0.000333,0.067967,4,815.602083,45.311227,203.900521,62.053748,1,0
0,0,7,7,14,8,22,60,31,91,0.000333,0.135269,21,8521.973823,473.44299,405.808277,77.302969,3,0
0,0,3,3,8,7,15,11,9,20,0.000333,0.026046,4,312.551248,17.363958,78.137812,43.651484,1,0
0,0,4,4,7,13,20,23,18,41,0.000333,0.059066,3,531.597156,29.533175,177.199052,67.757201,1,0
0,0,3,3,10,8,18,16,13,29,0.000333,0.040309,5,604.639125,33.591063,120.927825,57.219281,3,0
0,0,29,29,22,49,71,182,138,320,0.000333,0.655973,22,43294.21972,2405.234429,1967.919078,373.228278,5,0
0,0,5,5,8,12,20,25,19,44,0.000333,0.063388,4,760.659345,42.258852,190.164836,67.01955,1,0
0,0,9,9,15,19,34,68,35,103,0.000333,0.17467,7,3668.060709,203.78115,524.008673,139.313982,2,0
0,0,4,4,9,13,22,21,17,38,0.000333,0.056486,4,677.833606,37.657423,169.458402,76.635041,3,0
0,0,6,6,6,14,20,30,23,53,0.000333,0.076354,3,687.186567,38.177032,229.062189,68.812744,1,0
0,0,3,3,8,7,15,20,12,32,0.000333,0.041673,4,500.081996,27.782333,125.020499,43.651484,1,0
0,0,8,8,13,12,25,39,25,64,0.000333,0.099069,12,3566.481554,198.137864,297.206796,91.125266,1,0
0,0,7,7,11,19,30,44,28,72,0.000333,0.117765,5,1766.480614,98.137812,353.296123,118.764371,2,0
0,0,7,7,11,19,30,44,28,72,0.000333,0.117765,5,1766.480614,98.137812,353.296123,118.764371,2,0
0,0,3,3,7,5,12,11,7,18,0.000333,0.02151,3,193.587975,10.754888,64.529325,31.261125,1,0
0,0,3,3,7,8,15,23,12,35,0.000333,0.04558,3,410.223513,22.790195,136.741171,43.651484,1,0
0,0,3,3,7,6,13,17,10,27,0.000333,0.033304,3,299.735617,16.651979,99.911872,35.161259,4,0
0,0,5,5,8,8,16,24,16,40,0.000333,0.053333,8,1280,71.111111,160,48,1,0
0,0,4,4,6,8,14,17,12,29,0.000333,0.036804,3,331.239878,18.402215,110.413293,39.509775,3,0
0,0,3,3,6,9,15,26,11,37,0.000333,0.048185,3,433.664856,24.092492,144.554952,44.0391,3,0
0,0,4,4,10,15,25,32,21,53,0.000333,0.082041,5,1230.62189,68.367883,246.124378,91.82264,1,0
0,0,6,6,7,11,18,41,25,66,0.000333,0.091738,6,1651.290301,91.73835,275.21505,57.705232,1,0
0,0,5,5,11,12,23,33,18,51,0.000333,0.076901,5,1153.508299,64.083794,230.70166,81.073298,3,0
0,0,11,11,15,21,36,84,43,127,0.000333,0.21886,14,9192.126653,510.673703,656.580475,150.842025,2,0
0,0,8,8,15,18,33,66,34,100,0.000333,0.168146,7,3531.075884,196.170882,504.439412,133.662009,2,0
0,0,9,9,15,19,34,68,35,103,0.000333,0.17467,7,3668.060709,203.78115,524.008673,139.313982,2,0
0,0,15,15,12,22,34,100,56,156,0.000333,0.264548,12,9523.730439,529.096135,793.644203,141.127046,2,0
0,0,11,11,12,18,30,66,49,115,0.000333,0.188097,12,6771.509022,376.194946,564.292418,118.0782,1,0
0,0,3,3,8,6,14,11,9,20,0.000333,0.025382,4,304.588394,16.921577,76.147098,39.509775,1,0
0,0,6,6,9,13,22,27,21,48,0.000333,0.071351,4,856.210871,47.567271,214.052718,76.635041,1,0
0,0,3,3,8,7,15,11,9,20,0.000333,0.026046,4,312.551248,17.363958,78.137812,43.651484,1,0
0,0,8,8,15,18,33,66,34,100,0.000333,0.168146,7,3531.075884,196.170882,504.439412,133.662009,2,0
0,0,11,11,15,21,36,84,43,127,0.000333,0.21886,14,9192.126653,510.673703,656.580475,150.842025,2,0
0,0,4,4,4,7,11,13,11,24,0.000333,0.027675,2,166.052718,9.225151,83.026359,27.651484,3,0
0,0,5,5,9,12,21,19,20,39,0.000333,0.0571,4,685.201518,38.066751,171.300379,71.548875,1,0
0,0,4,4,4,7,11,13,11,24,0.000333,0.027675,2,166.052718,9.225151,83.026359,27.651484,2,0
0,0,3,3,10,8,18,16,13,29,0.000333,0.040309,5,604.639125,33.591063,120.927825,57.219281,3,0
0,0,4,4,6,10,16,26,15,41,0.000333,0.054667,3,492,27.333333,164,48.729056,1,0
0,0,10,10,7,14,21,57,36,93,0.000333,0.136162,6,2450.913122,136.16184,408.48552,72.954453,1,0
0,0,5,5,8,10,18,28,17,45,0.000333,0.062549,4,750.5865,41.69925,187.646625,57.219281,1,0
0,0,8,8,15,18,33,66,34,100,0.000333,0.168146,7,3531.075884,196.170882,504.439412,133.662009,2,0
0,0,3,3,7,8,15,23,12,35,0.000333,0.04558,3,410.223513,22.790195,136.741171,43.651484,1,0
0,0,4,4,4,7,11,13,11,24,0.000333,0.027675,2,166.052718,9.225151,83.026359,27.651484,3,0
0,0,4,4,10,15,25,32,21,53,0.000333,0.082041,5,1230.62189,68.367883,246.124378,91.82264,1,0
0,0,3,3,8,6,14,11,9,20,0.000333,0.025382,4,304.588394,16.921577,76.147098,39.509775,1,0
0,0,3,3,7,5,12,11,7,18,0.000333,0.02151,3,193.587975,10.754888,64.529325,31.261125,1,0
0,0,8,8,13,12,25,39,25,64,0.000333,0.099069,12,3566.481554,198.137864,297.206796,91.125266,1,0
0,0,3,3,8,8,16,20,12,32,0.000333,0.042667,4,512,28.444444,128,48,1,0
0,0,6,6,9,10,19,28,17,45,0.000333,0.063719,4,764.626952,42.479275,191.156738,61.748606,1,0
0,0,3,3,8,8,16,20,12,32,0.000333,0.042667,4,512,28.444444,128,48,1,0
0,0,4,4,6,8,14,17,12,29,0.000333,0.036804,3,331.239878,18.402215,110.413293,39.509775,3,0
0,0,25,25,12,35,47,382,213,595,0.000333,1.10166,36,118979.2932,6609.960733,3304.980367,222.544456,4,0
0,0,4,4,8,7,15,17,10,27,0.000333,0.035162,4,421.944184,23.441344,105.486046,43.651484,1,0
0,0,14,14,11,23,34,85,48,133,0.000333,0.225544,10,6766.325579,375.906977,676.632558,142.095673,1,0
0,0,6,6,8,16,24,34,30,64,0.000333,0.097813,4,1173.7504,65.208356,293.4376,88,1,0
0,0,9,9,15,19,34,68,35,103,0.000333,0.17467,7,3668.060709,203.78115,524.008673,139.313982,2,0
0,0,4,4,4,7,11,13,11,24,0.000333,0.027675,2,166.052718,9.225151,83.026359,27.651484,3,0
0,0,6,6,5,12,17,19,26,45,0.000333,0.061312,4,735.743311,40.874628,183.935828,54.62919,1,0
0,0,7,7,11,19,30,44,28,72,0.000333,0.117765,5,1766.480614,98.137812,353.296123,118.764371,2,0
0,0,3,3,8,6,14,11,9,20,0.000333,0.025382,4,304.588394,16.921577,76.147098,39.509775,1,0
0,0,5,5,8,14,22,21,19,40,0.000333,0.059459,4,713.509059,39.639392,178.377265,77.302969,1,0
0,0,5,5,8,8,16,19,12,31,0.000333,0.041333,4,496,27.555556,124,48,1,0
0,0,7,7,10,14,24,40,27,67,0.000333,0.102397,5,1535.962438,85.331247,307.192488,86.52225,1,0
0,0,3,3,7,8,15,23,12,35,0.000333,0.04558,3,410.223513,22.790195,136.741171,43.651484,1,0
0,0,5,5,10,12,22,21,17,38,0.000333,0.056486,5,847.292008,47.071778,169.458402,76.238831,1,0
0,0,15,15,12,22,34,100,56,156,0.000333,0.264548,12,9523.730439,529.096135,793.644203,141.127046,8,0
0,0,6,6,6,14,20,22,30,52,0.000333,0.074913,6,1348.441566,74.91342,224.740261,68.812744,1,0
0,0,3,3,8,7,15,15,9,24,0.000333,0.031255,4,375.061497,20.83675,93.765374,43.651484,3,0
0,0,6,6,5,13,18,19,29,48,0.000333,0.066719,4,800.6256,44.4792,200.1564,59.715357,1,0
0,0,3,3,10,8,18,16,13,29,0.000333,0.040309,5,604.639125,33.591063,120.927825,57.219281,3,0
0,0,4,4,4,7,11,13,11,24,0.000333,0.027675,2,166.052718,9.225151,83.026359,27.651484,3,0
0,0,4,4,11,10,21,36,17,53,0.000333,0.077598,5,1163.964117,64.664673,232.792823,71.273029,1,0
0,0,4,4,4,7,11,13,11,24,0.000333,0.027675,2,166.052718,9.225151,83.026359,27.651484,3,0
0,0,3,3,9,8,17,16,11,27,0.000333,0.036787,4,441.445987,24.524777,110.361497,52.529325,2,0
0,0,5,5,10,10,20,26,15,41,0.000333,0.059066,5,885.995259,49.221959,177.199052,66.438562,1,0
0,0,5,5,12,16,28,39,25,64,0.000333,0.102557,6,1846.02429,102.556905,307.670715,107.01955,4,0
0,0,5,5,11,12,23,33,21,54,0.000333,0.081424,5,1221.361728,67.853429,244.272346,81.073298,1,0
0,0,5,5,8,11,19,30,18,48,0.000333,0.067967,4,815.602083,45.311227,203.900521,62.053748,1,0
0,0,4,4,4,7,11,13,11,24,0.000333,0.027675,2,166.052718,9.225151,83.026359,27.651484,3,0
0,0,4,4,6,8,14,17,12,29,0.000333,0.036804,3,331.239878,18.402215,110.413293,39.509775,3,0
0,0,3,3,7,8,15,23,12,35,0.000333,0.04558,3,410.223513,22.790195,136.741171,43.651484,1,0
0,0,4,4,9,8,17,15,12,27,0.000333,0.036787,4,441.445987,24.524777,110.361497,52.529325,1,0
0,0,3,3,7,8,15,23,12,35,0.000333,0.04558,3,410.223513,22.790195,136.741171,43.651484,1,0
0,0,11,11,15,21,36,84,43,127,0.000333,0.21886,14,9192.126653,510.673703,656.580475,150.842025,2,0
0,0,5,5,10,11,21,27,16,43,0.000333,0.062957,5,944.348246,52.463791,188.869649,71.273029,1,0
0,0,5,5,10,11,21,29,17,46,0.000333,0.067349,5,1010.233007,56.124056,202.046601,71.273029,1,0
0,0,3,3,6,9,15,26,11,37,0.000333,0.048185,3,433.664856,24.092492,144.554952,44.0391,6,0
0,0,4,4,4,7,11,13,11,24,0.000333,0.027675,2,166.052718,9.225151,83.026359,27.651484,3,0
0,0,7,7,11,19,30,44,28,72,0.000333,0.117765,5,1766.480614,98.137812,353.296123,118.764371,2,0
0,0,9,9,15,19,34,68,35,103,0.000333,0.17467,7,3668.060709,203.78115,524.008673,139.313982,2,0
0,0,11,11,15,21,36,84,43,127,0.000333,0.21886,14,9192.126653,510.673703,656.580475,150.842025,2,0
0,0,5,5,8,8,16,19,12,31,0.000333,0.041333,4,496,27.555556,124,48,1,0
0,0,3,3,10,8,18,16,13,29,0.000333,0.040309,5,604.639125,33.591063,120.927825,57.219281,3,0
0,0,8,8,10,14,24,44,31,75,0.000333,0.114624,10,3438.721876,191.040104,343.872188,86.52225,1,0
0,0,14,14,10,15,25,61,51,112,0.000333,0.173371,15,7801.678399,433.426578,520.111893,91.82264,1,0
0,0,3,3,9,8,17,16,11,27,0.000333,0.036787,4,441.445987,24.524777,110.361497,52.529325,2,0
0,0,6,6,8,12,20,23,20,43,0.000333,0.061948,4,743.371632,41.298424,185.842908,67.01955,3,0
0,0,6,6,9,10,19,28,17,45,0.000333,0.063719,4,764.626952,42.479275,191.156738,61.748606,1,0
0,0,3,3,13,7,20,27,12,39,0.000333,0.056185,6,1011.331174,56.185065,168.555196,67.757201,3,0
0,0,6,6,8,9,17,27,17,44,0.000333,0.059949,4,719.39346,39.966303,179.848365,52.529325,1,0
0,0,6,6,7,11,18,41,25,66,0.000333,0.091738,6,1651.290301,91.73835,275.21505,57.705232,1,0
0,0,5,5,7,7,14,16,11,27,0.000333,0.034266,3,308.395749,17.133097,102.798583,39.302969,1,0
0,0,5,5,8,10,18,28,17,45,0.000333,0.062549,4,750.5865,41.69925,187.646625,57.219281,1,0
0,0,3,3,8,8,16,20,12,32,0.000333,0.042667,4,512,28.444444,128,48,1,0
0,0,8,8,16,17,33,49,35,84,0.000333,0.141243,16,6779.665696,376.648094,423.729106,133.486868,4,0
0,0,5,5,8,10,18,28,17,45,0.000333,0.062549,4,750.5865,41.69925,187.646625,57.219281,1,0
0,0,5,5,16,19,35,37,26,63,0.000333,0.107715,8,2585.158641,143.619924,323.14483,144.710623,2,0
0,0,4,4,8,7,15,17,10,27,0.000333,0.035162,4,421.944184,23.441344,105.486046,43.651484,1,0
0,0,4,4,10,15,25,32,21,53,0.000333,0.082041,5,1230.62189,68.367883,246.124378,91.82264,1,0
0,0,3,3,9,8,17,16,10,26,0.000333,0.035425,4,425.096135,23.616452,106.274034,52.529325,3,0
0,0,4,4,4,7,11,13,11,24,0.000333,0.027675,2,166.052718,9.225151,83.026359,27.651484,3,0
0,0,4,4,4,7,11,13,11,24,0.000333,0.027675,2,166.052718,9.225151,83.026359,27.651484,3,0
0,0,13,13,13,20,33,77,46,123,0.000333,0.20682,12,7445.52572,413.640318,620.460477,134.544278,2,0
0,0,3,3,7,7,14,18,10,28,0.000333,0.035535,3,319.817813,17.767656,106.605938,39.302969,1,0
0,0,4,4,4,7,11,13,11,24,0.000333,0.027675,2,166.052718,9.225151,83.026359,27.651484,3,0
0,0,3,3,7,5,12,11,7,18,0.000333,0.02151,3,193.587975,10.754888,64.529325,31.261125,1,0
0,0,8,8,8,16,24,32,31,63,0.000333,0.096284,4,1155.41055,64.189475,288.852638,88,1,0
0,0,3,3,7,8,15,23,12,35,0.000333,0.04558,3,410.223513,22.790195,136.741171,43.651484,1,0
0,0,8,8,15,18,33,66,34,100,0.000333,0.168146,7,3531.075884,196.170882,504.439412,133.662009,2,0
0,0,9,9,15,20,35,72,36,108,0.000333,0.184654,7,3877.737961,215.429887,553.962566,145.041921,2,0
0,0,4,4,9,13,22,21,17,38,0.000333,0.056486,4,677.833606,37.657423,169.458402,76.635041,3,0
0,0,7,7,14,16,30,42,33,75,0.000333,0.122672,14,5152.235125,286.235285,368.016795,117.302969,4,0
0,0,4,4,9,8,17,21,14,35,0.000333,0.047687,4,572.244798,31.791378,143.061199,52.529325,1,0
0,0,11,11,15,21,36,84,43,127,0.000333,0.21886,14,9192.126653,510.673703,656.580475,150.842025,2,0
0,0,4,4,9,13,22,21,17,38,0.000333,0.056486,4,677.833606,37.657423,169.458402,76.635041,3,0
0,0,3,3,7,8,15,23,12,35,0.000333,0.04558,3,410.223513,22.790195,136.741171,43.651484,1,0
0,0,4,4,6,8,14,17,12,29,0.000333,0.036804,3,331.239878,18.402215,110.413293,39.509775,3,0
0,0,8,8,11,15,26,59,34,93,0.000333,0.145714,10,4371.408938,242.856052,437.140894,96.657107,1,0
0,0,3,3,8,7,15,11,9,20,0.000333,0.026046,4,312.551248,17.363958,78.137812,43.651484,1,0
0,0,7,7,11,19,30,44,28,72,0.000333,0.117765,5,1766.480614,98.137812,353.296123,118.764371,2,0
0,0,3,3,8,8,16,16,12,28,0.000333,0.037333,4,448,24.888889,112,48,1,0
0,0,3,3,9,8,17,16,11,27,0.000333,0.036787,4,441.445987,24.524777,110.361497,52.529325,2,0
0,0,6,6,8,8,16,20,15,35,0.000333,0.046667,4,560,31.111111,140,48,1,0
0,0,4,4,5,11,16,13,14,27,0.000333,0.036,2,216,12,108,49.663388,1,0
0,0,6,6,11,13,24,30,22,52,0.000333,0.079473,5,1192.09025,66.227236,238.41805,86.159464,1,0
0,0,4,4,5,9,14,15,13,28,0.000333,0.035535,2,213.211876,11.845104,106.605938,40.138965,1,0
0,0,8,8,10,11,21,30,25,55,0.000333,0.080526,10,2415.774583,134.209699,241.577458,71.273029,1,0
0,0,4,4,6,13,19,17,17,34,0.000333,0.048143,3,433.288606,24.071589,144.429535,63.615491,1,0
0,0,8,8,15,18,33,66,34,100,0.000333,0.168146,7,3531.075884,196.170882,504.439412,133.662009,2,0
0,0,9,9,15,19,34,68,35,103,0.000333,0.17467,7,3668.060709,203.78115,524.008673,139.313982,2,0
0,0,3,3,7,8,15,23,12,35,0.000333,0.04558,3,410.223513,22.790195,136.741171,43.651484,1,0
0,0,5,5,8,10,18,28,17,45,0.000333,0.062549,4,750.5865,41.69925,187.646625,57.219281,1,0
0,0,18,18,11,28,39,115,64,179,0.000333,0.315362,10,9460.869972,525.603887,946.086997,172.659686,1,0
0,0,3,3,6,10,16,25,13,38,0.000333,0.050667,3,456,25.333333,152,48.729056,1,0
0,0,3,3,5,6,11,9,8,17,0.000333,0.019603,2,117.620675,6.534482,58.810338,27.119415,1,0
0,0,3,3,8,7,15,11,9,20,0.000333,0.026046,4,312.551248,17.363958,78.137812,43.651484,1,0
0,0,11,11,15,21,36,84,43,127,0.000333,0.21886,14,9192.126653,510.673703,656.580475,150.842025,2,0
0,0,9,9,15,19,34,68,35,103,0.000333,0.17467,7,3668.060709,203.78115,524.008673,139.313982,2,0
0,0,4,4,9,7,16,17,12,29,0.000333,0.038667,4,464,25.777778,116,48.180809,1,0
0,0,8,8,15,18,33,66,34,100,0.000333,0.168146,7,3531.075884,196.170882,504.439412,133.662009,2,0
0,0,9,9,15,20,35,72,36,108,0.000333,0.184654,7,3877.737961,215.429887,553.962566,145.041921,2,0
0,0,6,6,14,12,26,43,26,69,0.000333,0.10811,14,4540.624768,252.256932,324.330341,96.322519,4,0
0,0,25,25,12,35,47,382,213,595,0.000333,1.10166,36,118979.2932,6609.960733,3304.980367,222.544456,4,0
0,0,7,7,11,19,30,44,28,72,0.000333,0.117765,5,1766.480614,98.137812,353.296123,118.764371,2,0
0,0,5,5,10,10,20,27,14,41,0.000333,0.059066,5,885.995259,49.221959,177.199052,66.438562,3,0
0,0,3,3,8,6,14,11,9,20,0.000333,0.025382,4,304.588394,16.921577,76.147098,39.509775,1,0
0,0,6,6,10,11,21,24,21,45,0.000333,0.065885,5,988.27142,54.903968,197.654284,71.273029,1,0
0,0,4,4,4,7,11,13,11,24,0.000333,0.027675,2,166.052718,9.225151,83.026359,27.651484,2,0
0,0,3,3,9,8,17,16,10,26,0.000333,0.035425,4,425.096135,23.616452,106.274034,52.529325,3,0
0,0,9,9,11,15,26,41,32,73,0.000333,0.114377,10,3431.320994,190.628944,343.132099,96.657107,1,0
0,0,8,8,15,18,33,66,34,100,0.000333,0.168146,7,3531.075884,196.170882,504.439412,133.662009,2,0
0,0,4,4,7,6,13,14,9,23,0.000333,0.02837,3,255.330341,14.185019,85.110114,35.161259,1,0
0,0,6,6,5,12,17,19,26,45,0.000333,0.061312,4,735.743311,40.874628,183.935828,54.62919,1,0
0,0,3,3,8,8,16,20,12,32,0.000333,0.042667,4,512,28.444444,128,48,1,0
0,0,3,3,7,8,15,23,12,35,0.000333,0.04558,3,410.223513,22.790195,136.741171,43.651484,1,0
0,0,6,6,8,12,20,23,20,43,0.000333,0.061948,4,743.371632,41.298424,185.842908,67.01955,3,0
0,0,4,4,6,8,14,17,12,29,0.000333,0.036804,3,331.239878,18.402215,110.413293,39.509775,3,0
0,0,9,9,11,20,31,51,44,95,0.000333,0.156883,10,4706.486495,261.471472,470.648649,124.49231,1,0
0,0,4,4,10,15,25,32,21,53,0.000333,0.082041,5,1230.62189,68.367883,246.124378,91.82264,1,0
0,0,11,11,9,16,25,51,39,90,0.000333,0.139316,8,3343.576457,185.754248,417.947057,92.529325,1,0
0,0,5,5,10,10,20,26,15,41,0.000333,0.059066,5,885.995259,49.221959,177.199052,66.438562,1,0
0,0,7,7,11,19,30,44,28,72,0.000333,0.117765,5,1766.480614,98.137812,353.296123,118.764371,2,0
0,0,3,3,8,6,14,11,9,20,0.000333,0.025382,4,304.588394,16.921577,76.147098,39.509775,1,0
0,0,3,3,7,8,15,23,12,35,0.000333,0.04558,3,410.223513,22.790195,136.741171,43.651484,1,0
0,0,5,5,8,10,18,26,15,41,0.000333,0.056989,4,683.8677,37.99265,170.966925,57.219281,1,0
0,0,7,7,8,14,22,30,32,62,0.000333,0.092162,8,2211.878083,122.882116,276.48476,77.302969,1,0
0,0,5,5,8,11,19,36,19,55,0.000333,0.077879,4,934.544053,51.919114,233.636013,62.053748,1,0
0,0,9,9,15,19,34,68,35,103,0.000333,0.17467,7,3668.060709,203.78115,524.008673,139.313982,2,0
0,0,9,9,15,19,34,68,35,103,0.000333,0.17467,7,3668.060709,203.78115,524.008673,139.313982,2,0
0,0,6,6,10,11,21,30,16,46,0.000333,0.067349,5,1010.233007,56.124056,202.046601,71.273029,3,0
0,0,7,7,11,18,29,48,28,76,0.000333,0.123069,5,1846.032778,102.557377,369.206556,113.112398,1,0
0,0,6,6,7,12,19,23,31,54,0.000333,0.076463,6,1376.328514,76.462695,229.388086,62.671034,1,0
0,0,4,4,5,7,12,14,10,24,0.000333,0.02868,2,172.0782,9.5599,86.0391,31.261125,2,0
0,0,3,3,7,8,15,23,12,35,0.000333,0.04558,3,410.223513,22.790195,136.741171,43.651484,1,0
0,0,4,4,7,11,18,17,19,36,0.000333,0.050039,3,450.3519,25.01955,150.1173,57.705232,1,0
0,0,5,5,8,11,19,36,19,55,0.000333,0.077879,4,934.544053,51.919114,233.636013,62.053748,1,0
0,0,5,5,10,10,20,27,14,41,0.000333,0.059066,5,885.995259,49.221959,177.199052,66.438562,7,0
0,0,4,4,5,9,14,15,13,28,0.000333,0.035535,2,213.211876,11.845104,106.605938,40.138965,1,0
0,0,6,6,10,11,21,24,21,45,0.000333,0.065885,5,988.27142,54.903968,197.654284,71.273029,1,0
0,0,7,7,11,18,29,48,28,76,0.000333,0.123069,5,1846.032778,102.557377,369.206556,113.112398,3,0
0,0,11,11,15,21,36,84,43,127,0.000333,0.21886,14,9192.126653,510.673703,656.580475,150.842025,2,0
0,0,8,8,15,18,33,66,34,100,0.000333,0.168146,7,3531.075884,196.170882,504.439412,133.662009,2,0
0,0,5,5,8,8,16,19,12,31,0.000333,0.041333,4,496,27.555556,124,48,1,0
0,0,3,3,8,8,16,20,12,32,0.000333,0.042667,4,512,28.444444,128,48,1,0
0,0,5,5,7,7,14,16,11,27,0.000333,0.034266,3,308.395749,17.133097,102.798583,39.302969,1,0
0,0,4,4,11,16,27,27,21,48,0.000333,0.076078,5,1141.173001,63.3985,228.2346,102.053748,2,0
0,0,5,5,7,15,22,19,23,42,0.000333,0.062432,3,561.888384,31.216021,187.296128,78.254843,1,0
0,0,6,6,6,12,18,27,20,47,0.000333,0.065329,3,587.959425,32.664413,195.986475,58.529325,1,0
0,0,5,5,10,11,21,33,18,51,0.000333,0.074669,5,1120.040943,62.224497,224.008189,71.273029,1,0
0,0,6,6,7,13,20,23,34,57,0.000333,0.082117,6,1478.099408,82.116634,246.349901,67.757201,1,0
0,0,9,9,15,19,34,68,35,103,0.000333,0.17467,7,3668.060709,203.78115,524.008673,139.313982,2,0
0,0,6,6,9,9,18,23,16,39,0.000333,0.054209,4,650.5083,36.13935,162.627075,57.05865,1,0
0,0,11,11,15,21,36,84,43,127,0.000333,0.21886,14,9192.126653,510.673703,656.580475,150.842025,2,0
0,0,5,5,8,13,21,27,20,47,0.000333,0.068813,4,825.755675,45.875315,206.438919,72.105716,1,0
0,0,5,5,7,7,14,16,11,27,0.000333,0.034266,3,308.395749,17.133097,102.798583,39.302969,1,0
0,0,48,48,12,20,32,263,154,417,0.000333,0.695,42,87570,4865,2085,129.458112,32,0
0,0,3,3,8,8,16,20,12,32,0.000333,0.042667,4,512,28.444444,128,48,1,0
0,0,7,7,11,19,30,44,28,72,0.000333,0.117765,5,1766.480614,98.137812,353.296123,118.764371,2,0
0,0,11,11,15,21,36,84,43,127,0.000333,0.21886,14,9192.126653,510.673703,656.580475,150.842025,2,0
0,0,9,9,15,19,34,68,35,103,0.000333,0.17467,7,3668.060709,203.78115,524.008673,139.313982,2,0
0,0,9,9,15,19,34,68,35,103,0.000333,0.17467,7,3668.060709,203.78115,524.008673,139.313982,2,0
0,0,11,11,15,21,36,84,43,127,0.000333,0.21886,14,9192.126653,510.673703,656.580475,150.842025,2,0
0,0,5,5,7,16,23,34,27,61,0.000333,0.091979,3,827.811838,45.989547,275.937279,83.651484,1,0
0,0,10,10,7,14,21,57,36,93,0.000333,0.136162,6,2450.913122,136.16184,408.48552,72.954453,1,0
0,0,10,10,12,15,27,51,42,93,0.000333,0.147402,12,5306.454452,294.803025,442.204538,101.622909,1,0
0,0,8,8,15,18,33,66,34,100,0.000333,0.168146,7,3531.075884,196.170882,504.439412,133.662009,2,0
0,0,3,3,9,8,17,16,11,27,0.000333,0.036787,4,441.445987,24.524777,110.361497,52.529325,2,0
0,0,11,11,15,21,36,84,43,127,0.000333,0.21886,14,9192.126653,510.673703,656.580475,150.842025,2,0
0,0,3,3,7,5,12,13,7,20,0.000333,0.0239,3,215.09775,11.949875,71.69925,31.261125,1,0
0,0,3,3,5,6,11,9,8,17,0.000333,0.019603,2,117.620675,6.534482,58.810338,27.119415,1,0
0,0,3,3,9,8,17,16,11,27,0.000333,0.036787,4,441.445987,24.524777,110.361497,52.529325,2,0
0,0,3,3,9,6,15,16,10,26,0.000333,0.03386,4,406.316622,22.573146,101.579155,44.0391,1,0
0,0,4,4,4,7,11,13,11,24,0.000333,0.027675,2,166.052718,9.225151,83.026359,27.651484,3,0
0,0,5,5,8,8,16,23,15,38,0.000333,0.050667,4,608,33.777778,152,48,1,0
0,0,5,5,12,16,28,39,25,64,0.000333,0.102557,6,1846.02429,102.556905,307.670715,107.01955,3,0
0,0,7,7,11,19,30,44,28,72,0.000333,0.117765,5,1766.480614,98.137812,353.296123,118.764371,2,0
0,0,8,8,15,18,33,66,34,100,0.000333,0.168146,7,3531.075884,196.170882,504.439412,133.662009,2,0
0,0,5,5,8,10,18,26,15,41,0.000333,0.056989,4,683.8677,37.99265,170.966925,57.219281,1,0
0,0,5,5,8,10,18,28,17,45,0.000333,0.062549,4,750.5865,41.69925,187.646625,57.219281,1,0
0,0,3,3,9,8,17,16,11,27,0.000333,0.036787,4,441.445987,24.524777,110.361497,52.529325,2,0
0,0,4,4,4,7,11,13,11,24,0.000333,0.027675,2,166.052718,9.225151,83.026359,27.651484,2,0
0,0,5,5,11,13,24,26,19,45,0.000333,0.068774,5,1031.616563,57.312031,206.323313,86.159464,1,0
0,0,8,8,16,17,33,49,35,84,0.000333,0.141243,16,6779.665696,376.648094,423.729106,133.486868,4,0
0,0,4,4,11,10,21,36,17,53,0.000333,0.077598,5,1163.964117,64.664673,232.792823,71.273029,1,0
0,0,5,5,7,7,14,16,11,27,0.000333,0.034266,3,308.395749,17.133097,102.798583,39.302969,1,0
0,0,5,5,8,8,16,19,12,31,0.000333,0.041333,4,496,27.555556,124,48,1,0
0,0,8,8,14,12,26,39,27,66,0.000333,0.10341,14,4343.2063,241.289239,310.229021,96.322519,1,0
0,0,4,4,6,9,15,16,12,28,0.000333,0.036464,3,328.17881,18.232156,109.392937,44.0391,1,0
0,0,15,15,10,15,25,65,58,123,0.000333,0.190398,15,8567.91467,475.995259,571.194311,91.82264,1,0
0,0,7,7,11,19,30,44,28,72,0.000333,0.117765,5,1766.480614,98.137812,353.296123,118.764371,2,0
0,0,8,8,10,14,24,32,26,58,0.000333,0.088643,5,1329.639125,73.86884,265.927825,86.52225,1,0
0,0,4,4,6,5,11,24,12,36,0.000333,0.041513,6,747.23723,41.513179,124.539538,27.119415,1,0
0,0,4,4,9,9,18,19,15,34,0.000333,0.047259,4,567.1098,31.5061,141.77745,57.05865,1,0
0,0,3,3,8,7,15,20,12,32,0.000333,0.041673,4,500.081996,27.782333,125.020499,43.651484,1,0
0,0,3,3,11,11,22,26,15,41,0.000333,0.060946,5,914.183482,50.787971,182.836696,76.107496,3,0
0,0,3,3,6,5,11,15,8,23,0.000333,0.026522,3,238.700782,13.261155,79.566927,27.119415,4,0
0,0,4,4,7,9,16,19,15,34,0.000333,0.045333,3,408,22.666667,136,48.180809,1,0
0,0,3,3,9,8,17,16,10,26,0.000333,0.035425,4,425.096135,23.616452,106.274034,52.529325,3,0
0,0,3,3,7,8,15,23,12,35,0.000333,0.04558,3,410.223513,22.790195,136.741171,43.651484,1,0
0,0,4,4,5,7,12,14,10,24,0.000333,0.02868,2,172.0782,9.5599,86.0391,31.261125,2,0
0,0,18,18,14,28,42,110,63,173,0.000333,0.310957,14,13060.1928,725.566267,932.870914,187.908907,4,0
0,0,5,5,6,8,14,35,18,53,0.000333,0.067263,6,1210.738865,67.26327,201.789811,39.509775,1,0
0,0,5,5,7,8,15,17,12,29,0.000333,0.037767,3,339.899482,18.883305,113.299827,43.651484,1,0
0,0,5,5,12,16,28,39,25,64,0.000333,0.102557,6,1846.02429,102.556905,307.670715,107.01955,2,0
0,0,5,5,11,12,23,31,19,50,0.000333,0.075393,5,1130.890489,62.827249,226.178098,81.073298,2,0
0,0,5,5,8,11,19,22,20,42,0.000333,0.059471,4,713.651822,39.647323,178.412956,62.053748,1,0
0,0,3,3,9,8,17,16,11,27,0.000333,0.036787,4,441.445987,24.524777,110.361497,52.529325,2,0
0,0,7,7,10,14,24,40,27,67,0.000333,0.102397,5,1535.962438,85.331247,307.192488,86.52225,1,0
0,0,3,3,5,6,11,9,8,17,0.000333,0.019603,2,117.620675,6.534482,58.810338,27.119415,1,0
0,0,3,3,6,7,13,13,9,22,0.000333,0.027137,3,244.229021,13.568279,81.409674,35.161259,1,0
0,0,10,10,11,11,22,39,33,72,0.000333,0.107026,15,4816.186148,267.565897,321.079077,76.107496,1,0
0,0,4,4,4,7,11,13,11,24,0.000333,0.027675,2,166.052718,9.225151,83.026359,27.651484,2,0
0,0,5,5,12,16,28,39,25,64,0.000333,0.102557,6,1846.02429,102.556905,307.670715,107.01955,4,0
0,0,3,3,8,7,15,20,12,32,0.000333,0.041673,4,500.081996,27.782333,125.020499,43.651484,1,0
0,0,4,4,8,11,19,27,17,44,0.000333,0.062303,4,747.635242,41.535291,186.908811,62.053748,1,0
0,0,6,6,8,13,21,42,25,67,0.000333,0.098095,4,1177.141069,65.396726,294.285267,72.105716,1,0
0,0,10,10,15,27,42,169,61,230,0.000333,0.413411,14,17363.2621,964.625672,1240.233007,186.985321,7,0
0,0,7,7,11,19,30,44,28,72,0.000333,0.117765,5,1766.480614,98.137812,353.296123,118.764371,2,0
0,0,21,21,14,29,43,105,68,173,0.000333,0.312915,14,13142.41324,730.134069,938.743803,194.184418,1,0
0,0,6,6,9,15,24,24,26,50,0.000333,0.076416,4,916.9925,50.944028,229.248125,87.132684,1,0
0,0,5,5,8,10,18,26,15,41,0.000333,0.056989,4,683.8677,37.99265,170.966925,57.219281,1,0
0,0,14,14,11,23,34,85,48,133,0.000333,0.225544,10,6766.325579,375.906977,676.632558,142.095673,1,0
0,0,3,3,7,8,15,23,12,35,0.000333,0.04558,3,410.223513,22.790195,136.741171,43.651484,1,0
0,0,6,6,9,10,19,28,17,45,0.000333,0.063719,4,764.626952,42.479275,191.156738,61.748606,1,0
0,0,3,3,7,8,15,23,12,35,0.000333,0.04558,3,410.223513,22.790195,136.741171,43.651484,1,0
0,0,11,11,15,21,36,84,43,127,0.000333,0.21886,14,9192.126653,510.673703,656.580475,150.842025,2,0
0,0,5,5,7,7,14,16,11,27,0.000333,0.034266,3,308.395749,17.133097,102.798583,39.302969,1,0
0,0,8,8,15,18,33,66,34,100,0.000333,0.168146,7,3531.075884,196.170882,504.439412,133.662009,2,0
0,0,9,9,15,19,34,68,35,103,0.000333,0.17467,7,3668.060709,203.78115,524.008673,139.313982,2,0
0,0,4,4,7,8,15,19,14,33,0.000333,0.042976,3,386.782169,21.487898,128.92739,43.651484,1,0
0,0,3,3,5,6,11,9,8,17,0.000333,0.019603,2,117.620675,6.534482,58.810338,27.119415,1,0
0,0,3,3,9,8,17,16,11,27,0.000333,0.036787,4,441.445987,24.524777,110.361497,52.529325,2,0
0,0,5,5,10,11,21,29,17,46,0.000333,0.067349,5,1010.233007,56.124056,202.046601,71.273029,1,0
0,0,5,5,8,10,18,28,17,45,0.000333,0.062549,4,750.5865,41.69925,187.646625,57.219281,1,0
0,0,3,3,8,7,15,11,9,20,0.000333,0.026046,4,312.551248,17.363958,78.137812,43.651484,1,0
0,0,9,9,15,19,34,68,35,103,0.000333,0.17467,7,3668.060709,203.78115,524.008673,139.313982,2,0
0,0,4,4,6,8,14,17,12,29,0.000333,0.036804,3,331.239878,18.402215,110.413293,39.509775,3,0
0,0,5,5,7,13,20,16,19,35,0.000333,0.050422,3,453.80245,25.211247,151.267483,67.757201,1,0
0,0,5,5,8,10,18,28,17,45,0.000333,0.062549,4,750.5865,41.69925,187.646625,57.219281,1,0
0,0,5,5,12,14,26,29,20,49,0.000333,0.076774,6,1381.929277,76.773849,230.321546,96.322519,1,0
0,0,4,4,7,11,18,24,17,41,0.000333,0.056989,3,512.900775,28.494488,170.966925,57.705232,1,0
0,0,6,6,7,13,20,35,24,59,0.000333,0.084998,3,764.981273,42.49896,254.993758,67.757201,1,0
0,0,3,3,7,8,15,23,12,35,0.000333,0.04558,3,410.223513,22.790195,136.741171,43.651484,1,0
0,0,10,10,7,14,21,57,36,93,0.000333,0.136162,6,2450.913122,136.16184,408.48552,72.954453,1,0
0,0,4,4,6,8,14,17,12,29,0.000333,0.036804,3,331.239878,18.402215,110.413293,39.509775,3,0
0,0,5,5,10,11,21,33,18,51,0.000333,0.074669,5,1120.040943,62.224497,224.008189,71.273029,1,0
0,0,7,7,6,9,15,37,23,60,0.000333,0.078138,6,1406.480614,78.137812,234.413436,44.0391,1,0
0,0,4,4,11,9,20,35,15,50,0.000333,0.072032,5,1080.482024,60.026779,216.096405,66.583073,2,0
0,0,8,8,15,18,33,66,34,100,0.000333,0.168146,7,3531.075884,196.170882,504.439412,133.662009,2,0
0,0,6,6,15,14,29,37,24,61,0.000333,0.098779,7,2074.357885,115.242105,296.336841,111.906328,3,0
0,0,4,4,6,9,15,16,12,28,0.000333,0.036464,3,328.17881,18.232156,109.392937,44.0391,1,0
0,0,8,8,13,14,27,39,29,68,0.000333,0.107777,12,3879.988202,215.5549,323.33235,101.408685,1,0
0,0,6,6,7,11,18,41,25,66,0.000333,0.091738,6,1651.290301,91.73835,275.21505,57.705232,1,0
0,0,6,6,9,10,19,28,17,45,0.000333,0.063719,4,764.626952,42.479275,191.156738,61.748606,1,0
0,0,10,10,16,24,40,84,58,142,0.000333,0.251905,16,12091.42063,671.745591,755.713789,174.0391,2,0
0,0,7,7,14,15,29,42,31,73,0.000333,0.118211,14,4964.856577,275.825365,354.632613,111.906328,4,0
0,0,5,5,8,10,18,28,17,45,0.000333,0.062549,4,750.5865,41.69925,187.646625,57.219281,1,0
0,0,4,4,10,15,25,32,21,53,0.000333,0.082041,5,1230.62189,68.367883,246.124378,91.82264,1,0
0,0,9,9,13,18,31,39,40,79,0.000333,0.130461,12,4696.578102,260.921006,391.381509,123.164366,1,0
0,0,4,4,6,9,15,16,12,28,0.000333,0.036464,3,328.17881,18.232156,109.392937,44.0391,1,0
0,0,5,5,6,11,17,24,18,42,0.000333,0.057224,3,515.020318,28.61224,171.673439,53.563523,7,0
0,0,7,7,11,19,30,44,28,72,0.000333,0.117765,5,1766.480614,98.137812,353.296123,118.764371,2,0
0,0,3,3,10,8,18,16,13,29,0.000333,0.040309,5,604.639125,33.591063,120.927825,57.219281,3,0
0,0,8,8,15,14,29,47,30,77,0.000333,0.124688,14,5236.903513,290.939084,374.064537,111.906328,5,0
0,0,5,5,9,11,20,19,16,35,0.000333,0.050422,4,605.069933,33.614996,151.267483,66.583073,1,0
0,0,6,6,6,14,20,22,30,52,0.000333,0.074913,6,1348.441566,74.91342,224.740261,68.812744,1,0
0,0,3,3,8,8,16,20,12,32,0.000333,0.042667,4,512,28.444444,128,48,1,0
0,0,7,7,11,19,30,44,28,72,0.000333,0.117765,5,1766.480614,98.137812,353.296123,118.764371,2,0
0,0,3,3,9,8,17,16,10,26,0.000333,0.035425,4,425.096135,23.616452,106.274034,52.529325,3,0
0,0,4,4,9,13,22,21,17,38,0.000333,0.056486,4,677.833606,37.657423,169.458402,76.635041,3,0
0,0,4,4,4,7,11,13,11,24,0.000333,0.027675,2,166.052718,9.225151,83.026359,27.651484,3,0
0,0,4,4,9,13,22,22,17,39,0.000333,0.057973,4,695.671333,38.648407,173.917833,76.635041,3,0
0,0,7,7,11,19,30,44,28,72,0.000333,0.117765,5,1766.480614,98.137812,353.296123,118.764371,2,0
0,0,5,5,7,8,15,17,12,29,0.000333,0.037767,3,339.899482,18.883305,113.299827,43.651484,1,0
0,0,13,13,9,19,28,73,46,119,0.000333,0.190692,8,4576.601886,254.25566,572.075236,109.239948,1,0
0,0,6,6,5,13,18,19,29,48,0.000333,0.066719,4,800.6256,44.4792,200.1564,59.715357,1,0
0,0,3,3,9,8,17,16,10,26,0.000333,0.035425,4,425.096135,23.616452,106.274034,52.529325,3,0
0,0,27,27,23,39,62,156,100,256,0.000333,0.508091,22,33534.03362,1863.001868,1524.274255,310.172612,9,0
0,0,63,63,32,39,71,301,199,500,0.000333,1.024958,80,245989.8848,13666.10471,3074.87356,366.130687,28,0
0,0,20,20,26,34,60,119,80,199,0.000333,0.391824,26,30562.25194,1697.902886,1175.471229,295.185169,5,0
0,0,16,16,18,23,41,71,54,125,0.000333,0.223231,18,12054.49201,669.694001,669.694001,179.100575,4,0
0,0,21,21,19,42,61,132,81,213,0.000333,0.421082,9,11369.22348,631.623526,1263.247053,307.187955,13,0
0,0,37,37,24,47,71,199,146,345,0.000333,0.707221,36,76379.85922,4243.325512,2121.662756,371.104776,8,0
0,0,4,4,13,14,27,29,20,49,0.000333,0.077663,6,1397.936926,77.663163,232.989488,101.408685,2,0
0,0,5,5,14,12,26,25,17,42,0.000333,0.065806,7,1381.929277,76.773849,197.418468,96.322519,2,0
0,0,8,8,18,16,34,68,34,102,0.000333,0.172974,18,9340.581777,518.92121,518.92121,139.05865,2,0
0,0,73,73,33,122,155,388,275,663,0.000333,1.608023,32,154370.2554,8576.125299,4824.070481,1012.014961,26,0
0,0,10,10,18,27,45,66,47,113,0.000333,0.20686,9,5585.214599,310.2897,620.5794,203.440613,3,0
0,0,10,10,20,32,52,75,56,131,0.000333,0.248919,10,7467.576031,414.865335,746.757603,246.438562,4,0
0,0,17,17,22,38,60,97,79,176,0.000333,0.346538,22,22871.48039,1270.637799,1039.612745,297.528741,4,0
0,0,22,22,28,53,81,123,97,220,0.000333,0.464922,14,19526.73801,1084.818778,1394.767001,438.185722,5,0
0,0,7,7,12,17,29,38,32,70,0.000333,0.113353,6,2040.352018,113.35289,340.05867,112.506418,3,0
0,0,9,9,18,20,38,124,84,208,0.000333,0.363856,36,39296.48122,2183.137846,1091.568923,161.497212,6,0
0,0,5,5,11,12,23,35,30,65,0.000333,0.098011,10,2940.315271,163.350848,294.031527,81.073298,2,0
0,0,9,9,13,12,25,61,32,93,0.000333,0.14396,12,5182.543508,287.919084,431.878626,91.125266,3,0
1,0,23,24,15,32,47,84,79,163,0.000333,0.301799,14,12675.57176,704.198431,905.397983,218.603359,7,0
0,0,8,8,14,23,37,37,30,67,0.000333,0.116344,7,2443.233628,135.735202,349.033375,157.344894,2,0
0,0,5,5,14,25,39,33,28,61,0.000333,0.10747,7,2256.866747,125.381486,322.409535,169.399374,2,0
0,0,11,11,22,38,60,69,57,126,0.000333,0.248089,11,8186.950366,454.830576,744.268215,297.528741,3,0
0,0,19,19,25,46,71,95,79,174,0.000333,0.356685,12,12840.67199,713.370666,1070.055999,370.180255,3,0
0,0,17,17,25,46,71,95,79,174,0.000333,0.356685,12,12840.67199,713.370666,1070.055999,370.180255,3,0
0,0,11,11,14,25,39,38,32,70,0.000333,0.123326,7,2589.847087,143.880394,369.978155,169.399374,2,0
0,0,5,5,16,21,37,35,26,61,0.000333,0.105926,8,2542.213242,141.234069,317.776655,156.238666,3,0
0,0,8,8,16,23,39,45,34,79,0.000333,0.139182,8,3340.374202,185.576345,417.546775,168.041925,5,0
0,0,18,18,20,40,60,86,72,158,0.000333,0.311096,10,9332.887141,518.49373,933.288714,299.315686,3,0
0,0,7,7,19,21,40,41,35,76,0.000333,0.134822,9,3640.198817,202.233268,404.466535,172.949289,3,0
0,0,9,9,13,30,43,45,43,88,0.000333,0.15917,6,2865.06779,159.170433,477.511298,195.312434,1,0
0,0,14,14,15,30,45,51,43,94,0.000333,0.172078,7,3613.639337,200.757741,516.234191,205.810077,2,0
0,0,11,11,14,25,39,38,32,70,0.000333,0.123326,7,2589.847087,143.880394,369.978155,169.399374,2,0
0,0,10,10,16,24,40,45,32,77,0.000333,0.136596,8,3278.307706,182.128206,409.788463,174.0391,10,0
0,0,7,7,15,22,37,31,26,57,0.000333,0.09898,7,2078.571893,115.476216,296.938842,156.710855,3,0
0,0,12,12,15,27,42,43,34,77,0.000333,0.138403,7,2906.459091,161.469949,415.208442,186.985321,2,0
0,0,10,10,14,23,37,37,30,67,0.000333,0.116344,7,2443.233628,135.735202,349.033375,157.344894,2,0
0,0,10,10,18,36,54,55,49,104,0.000333,0.199503,9,5386.574702,299.25415,598.5083,261.17595,1,0
0,0,13,13,15,31,46,49,43,92,0.000333,0.169389,7,3557.1739,197.620772,508.1677,212.183445,3,0
0,0,12,12,17,28,45,47,39,86,0.000333,0.157433,8,3778.39493,209.910829,472.299366,204.092806,3,0
0,0,12,12,15,27,42,43,34,77,0.000333,0.138403,7,2906.459091,161.469949,415.208442,186.985321,2,0
0,0,12,12,15,30,45,56,43,99,0.000333,0.181231,7,3805.854196,211.436344,543.693457,205.810077,9,0
0,0,10,10,18,36,54,55,49,104,0.000333,0.199503,9,5386.574702,299.25415,598.5083,261.17595,1,0
0,0,14,14,15,30,45,51,43,94,0.000333,0.172078,7,3613.639337,200.757741,516.234191,205.810077,2,0
0,0,4,4,12,14,26,30,21,51,0.000333,0.079907,6,1438.334554,79.907475,239.722426,96.322519,6,0
0,0,4,4,13,15,28,33,23,56,0.000333,0.089737,6,1615.271254,89.737292,269.211876,106.709075,7,0
0,0,21,21,25,26,51,95,63,158,0.000333,0.298748,24,21509.8369,1194.990939,896.243204,238.307837,8,0
0,0,20,20,29,36,65,107,67,174,0.000333,0.349297,14,14670.48799,815.027111,1047.891999,326.998749,8,0
0,0,35,35,31,66,97,224,150,374,0.000333,0.822789,30,74051.02209,4113.945672,2468.367403,552.510097,19,0
0,0,24,24,26,42,68,125,85,210,0.000333,0.426122,26,33237.54711,1846.530395,1278.367197,348.688764,10,0
0,0,23,23,29,46,75,151,113,264,0.000333,0.548136,28,46043.42776,2557.968209,1644.408134,394.965299,10,0
0,0,22,22,26,54,80,168,99,267,0.000333,0.562652,13,21943.41242,1219.078468,1687.954801,432.975358,10,0
0,0,27,27,30,65,95,197,124,321,0.000333,0.702975,15,31633.85475,1757.436375,2108.92365,538.660626,11,0
0,0,25,25,27,47,74,136,107,243,0.000333,0.502966,26,39231.32636,2179.518131,1508.897168,389.447639,15,0
0,0,13,13,13,40,53,86,90,176,0.000333,0.336038,12,12097.368,672.076,1008.114,260.98284,13,0
0,0,11,11,18,22,40,60,43,103,0.000333,0.18272,9,4933.427344,274.079297,548.158594,173.166146,5,0
0,0,23,23,20,30,50,126,74,200,0.000333,0.376257,20,22575.42476,1254.190264,1128.771238,233.64528,5,0
0,0,18,18,18,25,43,98,59,157,0.000333,0.283975,18,15334.6242,851.923566,851.923566,191.155055,6,0
0,0,9,9,15,24,39,39,32,71,0.000333,0.125088,7,2626.844903,145.935828,375.263558,168.642459,2,0
0,0,6,6,15,26,41,35,30,65,0.000333,0.11608,7,2437.686162,135.427009,348.24088,180.814792,2,0
0,0,12,12,22,39,61,71,59,130,0.000333,0.256999,11,8480.954393,471.164133,770.995854,304.238182,3,0
0,0,20,20,25,47,72,97,81,178,0.000333,0.366082,12,13178.9598,732.164434,1098.24665,377.162081,3,0
0,0,18,18,25,47,72,97,81,178,0.000333,0.366082,12,13178.9598,732.164434,1098.24665,377.162081,3,0
0,0,12,12,15,26,41,40,34,74,0.000333,0.132153,7,2775.211938,154.178441,396.458848,180.814792,2,0
0,0,7,7,16,22,38,41,31,72,0.000333,0.12595,8,3022.806248,167.93368,377.850781,162.107496,3,0
0,0,9,9,17,24,41,47,36,83,0.000333,0.148226,8,3557.414531,197.634141,444.676816,179.525968,5,0
0,0,19,19,20,41,61,88,74,162,0.000333,0.32026,10,9607.794487,533.76636,960.779449,306.098194,3,0
0,0,8,8,19,22,41,45,37,82,0.000333,0.14644,9,3953.873379,219.659632,439.319264,178.818118,3,0
0,0,10,10,13,31,44,47,45,92,0.000333,0.167423,6,3013.606253,167.42257,502.267709,201.685802,1,0
0,0,15,15,16,31,47,53,45,98,0.000333,0.18145,8,4354.79766,241.933203,544.349707,217.580086,2,0
0,0,12,12,15,26,41,40,34,74,0.000333,0.132153,7,2775.211938,154.178441,396.458848,180.814792,2,0
0,0,11,11,16,25,41,47,34,81,0.000333,0.144654,8,3471.693699,192.871872,433.961712,180.096405,10,0
0,0,8,8,15,23,38,35,28,63,0.000333,0.110206,7,2314.336033,128.574224,330.619433,162.645284,3,0
0,0,13,13,16,28,44,45,36,81,0.000333,0.147405,8,3537.711689,196.539538,442.213961,198.605938,2,0
0,0,11,11,15,24,39,39,32,71,0.000333,0.125088,7,2626.844903,145.935828,375.263558,168.642459,2,0
0,0,11,11,18,37,55,57,51,108,0.000333,0.208129,9,5619.481642,312.193425,624.386849,267.808425,1,0
0,0,14,14,16,32,48,51,45,96,0.000333,0.178719,8,4289.251201,238.291733,536.1564,224,3,0
0,0,13,13,18,29,47,49,41,90,0.000333,0.166638,9,4499.21697,249.956498,499.912997,215.940099,3,0
0,0,13,13,16,28,44,45,36,81,0.000333,0.147405,8,3537.711689,196.539538,442.213961,198.605938,2,0
0,0,13,13,15,31,46,58,45,103,0.000333,0.189642,7,3982.48817,221.249343,568.926881,212.183445,9,0
0,0,11,11,18,37,55,57,51,108,0.000333,0.208129,9,5619.481642,312.193425,624.386849,267.808425,1,0
0,0,15,15,16,31,47,53,45,98,0.000333,0.18145,8,4354.79766,241.933203,544.349707,217.580086,2,0
0,0,5,5,13,15,28,32,23,55,0.000333,0.088135,6,1586.427124,88.13484,264.404521,106.709075,6,0
0,0,5,5,13,16,29,35,25,60,0.000333,0.09716,6,1748.873158,97.15962,291.47886,112.105716,7,0
0,0,22,22,25,27,52,97,65,162,0.000333,0.307824,24,22163.30962,1231.294979,923.471234,244.478367,8,0
0,0,21,21,29,37,66,109,69,178,0.000333,0.358634,14,15062.63015,836.812786,1075.902153,333.631223,8,0
0,0,36,36,31,67,98,226,152,378,0.000333,0.833453,30,75010.80963,4167.267202,2500.360321,560.008061,19,0
0,0,25,25,26,43,69,127,87,214,0.000333,0.435741,26,33987.83008,1888.212782,1307.224234,355.540817,10,0
0,0,24,24,29,47,76,153,115,268,0.000333,0.558148,28,46884.44806,2604.691559,1674.444574,401.947125,10,0
0,0,28,28,30,66,96,199,126,325,0.000333,0.713371,15,32101.69219,1783.427344,2140.112813,546.13673,11,0
0,0,26,26,27,48,75,138,109,247,0.000333,0.512839,26,40001.47363,2222.304091,1538.518217,396.460163,15,0
0,0,14,14,13,41,54,88,92,180,0.000333,0.345293,12,12430.55701,690.5865,1035.87975,267.765349,13,0
0,0,12,12,18,23,41,62,45,107,0.000333,0.191086,9,5159.32258,286.629032,573.258064,179.100575,5,0
0,0,24,24,20,31,51,128,76,204,0.000333,0.385725,20,23143.4954,1285.749744,1157.17477,240.018648,5,0
0,0,19,19,18,26,44,100,61,161,0.000333,0.292989,18,15821.43283,878.968491,878.968491,197.270083,6,0
0,0,14,14,23,39,62,90,74,164,0.000333,0.325496,11,10741.37014,596.742786,976.488195,310.172612,3,0
0,0,20,20,26,47,73,108,90,198,0.000333,0.408528,13,15932.60842,885.144912,1225.585263,383.277109,3,0
0,0,21,21,20,41,61,106,82,188,0.000333,0.37166,20,22299.57239,1238.865133,1114.978619,306.098194,3,0
0,0,10,10,20,22,42,52,47,99,0.000333,0.177946,20,10676.7885,593.154917,533.839425,184.546058,3,0
0,0,12,12,14,31,45,64,59,123,0.000333,0.225166,7,4728.485516,262.69364,675.497931,206.883055,1,0
0,0,13,13,20,37,57,68,60,128,0.000333,0.24887,10,7466.099218,414.78329,746.609922,279.188336,1,0
0,0,15,15,18,31,49,70,55,125,0.000333,0.233946,9,6316.548575,350.919365,701.838731,228.638736,9,0
0,0,13,13,20,37,57,68,60,128,0.000333,0.24887,10,7466.099218,414.78329,746.609922,279.188336,1,0
0,0,24,24,25,27,52,108,74,182,0.000333,0.345827,24,24899.52069,1383.306705,1037.480029,244.478367,8,0
0,0,23,23,30,37,67,128,83,211,0.000333,0.426648,30,38398.34458,2133.241365,1279.944819,339.956492,8,0
0,0,38,38,32,67,99,243,165,408,0.000333,0.901593,32,86552.88003,4808.493335,2704.777501,566.427976,19,0
0,0,27,27,27,43,70,144,100,244,0.000333,0.498515,26,38884.17146,2160.231748,1495.545056,361.711347,10,0
0,0,26,26,30,47,77,167,123,290,0.000333,0.605789,30,54521.0429,3028.946828,1817.368097,408.272394,10,0
0,0,30,30,30,66,96,212,134,346,0.000333,0.759466,30,68351.91076,3797.328375,2278.397025,546.13673,11,0
0,0,28,28,28,48,76,147,116,263,0.000333,0.547735,28,46009.73821,2556.096567,1643.204936,402.684138,16,0
0,0,16,16,14,41,55,101,100,201,0.000333,0.387351,14,16268.74623,903.819235,1162.053302,272.962601,13,0
0,0,14,14,20,23,43,83,56,139,0.000333,0.251417,20,15085.01602,838.056445,754.250801,190.480487,5,0
0,0,26,26,20,31,51,140,84,224,0.000333,0.423541,20,25412.46553,1411.803641,1270.623277,240.018648,5,0
0,0,21,21,18,26,44,112,68,180,0.000333,0.327566,18,17688.55844,982.697691,982.697691,197.270083,6,0
0,0,17,17,23,42,65,99,82,181,0.000333,0.36335,11,11990.53432,666.140795,1090.048574,330.519257,3,0
0,0,25,25,25,50,75,118,102,220,0.000333,0.45678,24,32888.16269,1827.120149,1370.340112,398.289214,3,0
0,0,23,23,25,50,75,118,100,218,0.000333,0.452627,24,32589.17939,1810.509966,1357.882475,398.289214,3,0
0,0,24,24,20,46,66,112,93,205,0.000333,0.413034,20,24782.01589,1376.778661,1239.100794,340.522412,3,0
0,0,13,13,20,25,45,61,56,117,0.000333,0.214182,20,12850.93625,713.940903,642.546812,202.534967,3,0
0,0,17,17,14,34,48,78,74,152,0.000333,0.282971,14,11884.8002,660.266678,848.9143,226.276706,1,0
0,0,16,16,19,40,59,78,72,150,0.000333,0.294132,9,7941.568117,441.198229,882.396457,293.587747,1,0
0,0,16,16,19,40,59,78,72,150,0.000333,0.294132,9,7941.568117,441.198229,882.396457,293.587747,1,0
0,0,27,27,25,30,55,118,86,204,0.000333,0.393132,24,28305.53716,1572.529842,1179.397382,263.303123,8,0
0,0,26,26,30,40,70,141,95,236,0.000333,0.48217,30,43395.32376,2410.85132,1446.510792,360.083842,8,0
0,0,41,41,32,70,102,252,175,427,0.000333,0.949709,32,91172.01987,5065.112215,2849.125621,589.049811,19,0
0,0,30,30,27,46,73,151,110,261,0.000333,0.538515,26,42004.14946,2333.563859,1615.54421,382.465813,10,0
0,0,29,29,30,50,80,177,133,310,0.000333,0.653266,30,58793.93128,3266.329516,1959.797709,429.399527,10,0
0,0,33,33,30,70,100,228,147,375,0.000333,0.830482,30,74743.38214,4152.410119,2491.446071,576.256529,11,0
0,0,31,31,29,51,80,159,126,285,0.000333,0.600583,28,50448.9862,2802.721455,1801.749507,430.175141,16,0
0,0,19,19,14,44,58,108,110,218,0.000333,0.42568,14,17878.558,993.253222,1277.039857,293.51796,13,0
0,0,29,29,22,33,55,147,95,242,0.000333,0.466363,22,30779.95912,1709.997729,1399.089051,264.572502,5,0
0,0,24,24,20,29,49,123,79,202,0.000333,0.378057,20,22683.42777,1260.190432,1134.171389,227.320011,6,0
0,0,15,15,23,40,63,95,81,176,0.000333,0.350667,22,23144.02786,1285.779326,1052.001267,316.919049,3,0
0,0,23,23,25,48,73,113,91,204,0.000333,0.420908,12,15152.69052,841.81614,1262.72421,384.174605,3,0
0,0,21,21,25,48,73,112,95,207,0.000333,0.427098,12,15375.5242,854.195789,1281.293684,384.174605,3,0
0,0,9,9,16,23,39,46,35,81,0.000333,0.142706,8,3424.940638,190.27448,428.11758,168.041925,3,0
0,0,22,22,20,42,62,109,86,195,0.000333,0.387023,20,23221.36561,1290.075867,1161.068281,312.915894,3,0
0,0,11,11,21,23,44,58,52,110,0.000333,0.200179,20,12010.74956,667.263865,600.537478,196.280591,3,0
0,0,13,13,14,32,46,69,66,135,0.000333,0.24856,14,10439.5321,579.974005,745.680864,213.302969,1,0
0,0,18,18,17,32,49,59,52,111,0.000333,0.207744,8,4985.862342,276.992352,623.232793,229.486868,2,0
0,0,14,14,17,26,43,57,41,98,0.000333,0.177258,8,4254.191568,236.343976,531.773946,191.698301,10,0
0,0,14,14,19,38,57,72,65,137,0.000333,0.266369,9,7191.953387,399.552966,799.105932,280.131868,1,0
0,0,17,17,17,33,50,58,52,110,0.000333,0.206941,8,4966.593447,275.921858,620.824181,235.951874,3,0
0,0,16,16,19,30,49,55,48,103,0.000333,0.192772,9,5204.836025,289.157557,578.315114,227.917341,3,0
0,0,16,16,16,32,48,75,60,135,0.000333,0.251323,8,6031.759501,335.09775,753.969938,224,9,0
0,0,14,14,19,38,57,72,65,137,0.000333,0.266369,9,7191.953387,399.552966,799.105932,280.131868,1,0
0,0,18,18,17,32,49,59,52,111,0.000333,0.207744,8,4985.862342,276.992352,623.232793,229.486868,2,0
0,0,25,25,25,28,53,111,80,191,0.000333,0.364678,24,26256.78736,1458.710409,1094.032807,250.702343,8,0
0,0,24,24,30,38,68,135,90,225,0.000333,0.45656,30,41090.37418,2282.798565,1369.679139,346.627963,8,0
0,0,39,39,32,68,100,249,172,421,0.000333,0.932354,32,89506.03059,4972.557255,2797.063456,573.947473,19,0
0,0,28,28,27,44,71,149,106,255,0.000333,0.522729,26,40772.8234,2265.156856,1568.185515,368.596954,10,0
0,0,27,27,30,48,78,173,127,300,0.000333,0.62854,30,56568.61997,3142.701109,1885.620666,415.284918,10,0
0,0,31,31,30,67,97,217,138,355,0.000333,0.78099,30,70289.07177,3904.948432,2342.969059,553.634694,11,0
0,0,29,29,27,49,76,153,120,273,0.000333,0.568561,26,44347.78949,2463.766083,1705.684211,403.502745,16,0
0,0,16,16,14,43,57,104,104,208,0.000333,0.404414,14,16985.37572,943.631985,1213.241123,286.632353,13,0
0,0,15,15,19,24,43,95,65,160,0.000333,0.289401,18,15627.64249,868.202361,868.202361,190.749723,5,0
0,0,27,27,20,32,52,143,89,232,0.000333,0.440834,20,26450.04029,1469.446683,1322.502015,246.438562,5,0
0,0,22,22,18,27,45,115,72,187,0.000333,0.342326,18,18485.57752,1026.976529,1026.976529,203.440613,6,0
0,0,14,14,23,39,62,84,74,158,0.000333,0.313588,11,10348.39319,574.910733,940.763017,310.172612,3,0
0,0,22,22,25,47,72,105,87,192,0.000333,0.394875,12,14215.5072,789.7504,1184.6256,377.162081,3,0
0,0,20,20,25,47,72,105,90,195,0.000333,0.401045,12,14437.6245,802.09025,1203.135375,377.162081,3,0
0,0,9,9,17,22,39,44,35,79,0.000333,0.139182,8,3340.374202,185.576345,417.546775,167.594364,3,0
0,0,21,21,20,41,61,99,83,182,0.000333,0.359798,20,21587.88391,1199.326884,1079.394195,306.098194,3,0
0,0,10,10,20,22,42,51,47,98,0.000333,0.176149,20,10568.94215,587.163453,528.447107,184.546058,3,0
0,0,12,12,14,31,45,60,59,119,0.000333,0.217844,7,4574.713629,254.150757,653.530518,206.883055,1,0
0,0,17,17,17,31,48,54,49,103,0.000333,0.19175,8,4602.009101,255.667172,575.251138,223.066954,2,0
0,0,13,13,17,25,42,51,38,89,0.000333,0.159972,8,3839.330005,213.296111,479.916251,185.583273,10,0
0,0,13,13,19,37,56,65,60,125,0.000333,0.241973,9,6533.274287,362.959683,725.919365,273.460397,1,0
0,0,16,16,17,32,49,53,49,102,0.000333,0.1909,8,4581.603233,254.533513,572.700404,229.486868,3,0
0,0,15,15,19,29,48,50,45,95,0.000333,0.176857,9,4775.142938,265.285719,530.571438,221.592072,3,0
0,0,15,15,16,31,47,67,55,122,0.000333,0.225887,8,5421.278719,301.182151,677.65984,217.580086,9,0
0,0,13,13,19,37,56,65,60,125,0.000333,0.241973,9,6533.274287,362.959683,725.919365,273.460397,1,0
0,0,17,17,17,31,48,54,49,103,0.000333,0.19175,8,4602.009101,255.667172,575.251138,223.066954,2,0
0,0,24,24,25,27,52,104,74,178,0.000333,0.338226,24,24352.27848,1352.90436,1014.67827,244.478367,8,0
0,0,23,23,30,37,67,124,83,207,0.000333,0.41856,30,37670.41387,2092.800771,1255.680462,339.956492,8,0
0,0,38,38,32,67,99,239,165,404,0.000333,0.892753,32,85704.32238,4761.351244,2678.260075,566.427976,19,0
0,0,27,27,27,43,70,140,100,240,0.000333,0.490343,26,38246.72603,2124.818113,1471.027924,361.711347,10,0
0,0,26,26,30,47,77,164,123,287,0.000333,0.599523,30,53957.03212,2997.612895,1798.567737,408.272394,10,0
0,0,30,30,30,66,96,209,134,343,0.000333,0.752881,30,67759.26413,3764.403563,2258.642138,546.13673,11,0
0,0,28,28,27,48,75,146,116,262,0.000333,0.543983,26,42430.71292,2357.261829,1631.950497,396.460163,16,0
0,0,16,16,14,41,55,97,100,197,0.000333,0.379643,14,15944.99009,885.832783,1138.927864,272.962601,13,0
0,0,14,14,19,23,42,78,56,134,0.000333,0.240857,18,13006.26962,722.570535,722.570535,184.752548,5,0
0,0,26,26,20,31,51,136,84,220,0.000333,0.415978,20,24958.67151,1386.592861,1247.933575,240.018648,5,0
0,0,21,21,18,26,44,108,68,176,0.000333,0.320287,18,17295.47937,960.859965,960.859965,197.270083,6,0
0,0,10,10,15,24,39,43,36,79,0.000333,0.139182,7,2922.827427,162.379302,417.546775,168.642459,2,0
0,0,7,7,15,26,41,39,34,73,0.000333,0.130367,7,2737.709074,152.094949,391.101296,180.814792,2,0
0,0,13,13,22,39,61,75,63,138,0.000333,0.272814,11,9002.859278,500.158849,818.441753,304.238182,3,0
0,0,21,21,25,47,72,100,84,184,0.000333,0.378422,12,13623.1944,756.844134,1135.2662,377.162081,3,0
0,0,19,19,25,47,72,100,84,184,0.000333,0.378422,12,13623.1944,756.844134,1135.2662,377.162081,3,0
0,0,13,13,15,26,41,44,38,82,0.000333,0.14644,7,3075.234851,170.846381,439.319264,180.814792,2,0
0,0,7,7,16,22,38,41,32,73,0.000333,0.1277,8,3064.789668,170.266093,383.098708,162.107496,3,0
0,0,10,10,17,24,41,51,40,91,0.000333,0.162512,8,3900.297859,216.683214,487.537232,179.525968,5,0
0,0,19,19,20,41,61,88,74,162,0.000333,0.32026,10,9607.794487,533.76636,960.779449,306.098194,3,0
0,0,9,9,20,22,42,46,40,86,0.000333,0.15458,10,4637.392984,257.632944,463.739298,184.546058,3,0
0,0,11,11,13,31,44,50,48,98,0.000333,0.178341,6,3210.145792,178.341433,535.024299,201.685802,1,0
0,0,16,16,16,31,47,57,49,106,0.000333,0.196262,8,4710.291346,261.682853,588.786418,217.580086,2,0
0,0,13,13,15,26,41,44,38,82,0.000333,0.14644,7,3075.234851,170.846381,439.319264,180.814792,2,0
0,0,12,12,16,25,41,51,38,89,0.000333,0.158941,8,3814.577027,211.920946,476.822128,180.096405,10,0
0,0,9,9,15,23,38,37,32,69,0.000333,0.120702,7,2534.748989,140.819388,362.106998,162.645284,3,0
0,0,14,14,16,28,44,49,40,89,0.000333,0.161963,8,3887.115312,215.950851,485.889414,198.605938,2,0
0,0,12,12,15,24,39,43,36,79,0.000333,0.139182,7,2922.827427,162.379302,417.546775,168.642459,2,0
0,0,12,12,18,37,55,61,55,116,0.000333,0.223546,9,6035.739541,335.318863,670.637727,267.808425,1,0
0,0,15,15,16,32,48,55,49,104,0.000333,0.193612,8,4646.688801,258.149378,580.8361,224,3,0
0,0,14,14,18,29,47,53,45,98,0.000333,0.18145,9,4899.147367,272.174854,544.349707,215.940099,3,0
0,0,14,14,16,28,44,49,40,89,0.000333,0.161963,8,3887.115312,215.950851,485.889414,198.605938,2,0
0,0,14,14,15,31,46,61,48,109,0.000333,0.200689,7,4214.477772,234.137654,602.068253,212.183445,11,0
0,0,12,12,18,37,55,60,54,114,0.000333,0.219692,9,5931.675066,329.537504,659.075007,267.808425,1,0
0,0,16,16,16,31,47,57,49,106,0.000333,0.196262,8,4710.291346,261.682853,588.786418,217.580086,2,0
0,0,6,6,13,15,28,36,27,63,0.000333,0.100954,6,1817.180161,100.954453,302.86336,106.709075,6,0
0,0,6,6,13,16,29,39,29,68,0.000333,0.110114,6,1982.056246,110.114236,330.342708,112.105716,7,0
0,0,23,23,25,28,53,102,71,173,0.000333,0.33031,24,23782.32573,1321.240318,990.930239,250.702343,8,0
0,0,22,22,29,37,66,112,72,184,0.000333,0.370723,14,15570.35925,865.019958,1112.168518,333.631223,8,0
0,0,37,37,31,67,98,229,155,384,0.000333,0.846683,30,76201.4574,4233.4143,2540.04858,560.008061,20,0
0,0,26,26,26,43,69,132,91,223,0.000333,0.454067,26,35417.2248,1967.6236,1362.200954,355.540817,10,0
0,0,25,25,29,47,76,156,118,274,0.000333,0.570644,28,47934.09988,2663.005549,1711.932139,401.947125,10,0
0,0,24,24,26,55,81,175,104,279,0.000333,0.589606,13,22994.63596,1277.479776,1768.818151,440.186217,10,0
0,0,29,29,30,66,96,204,129,333,0.000333,0.730931,15,32891.88769,1827.327094,2192.792513,546.13673,11,0
0,0,27,27,27,48,75,141,113,254,0.000333,0.527373,26,41135.11863,2285.284368,1582.119947,396.460163,15,0
0,0,15,15,13,41,54,92,95,187,0.000333,0.358721,12,12913.96756,717.442642,1076.163963,267.765349,13,0
0,0,13,13,18,24,42,65,48,113,0.000333,0.203111,18,10967.97364,609.331869,609.331869,185.09775,5,0
0,0,25,25,20,31,51,133,79,212,0.000333,0.400851,20,24051.08345,1336.171303,1202.554172,240.018648,5,0
0,0,20,20,18,26,44,105,64,169,0.000333,0.307548,18,16607.59098,922.643944,922.643944,197.270083,6,0
0,0,17,17,23,42,65,91,83,174,0.000333,0.349297,11,11526.81199,640.378444,1047.891999,330.519257,3,0
0,0,23,23,25,50,75,112,99,211,0.000333,0.438094,12,15771.36892,876.187162,1314.280744,398.289214,3,0
0,0,24,24,20,44,64,107,91,198,0.000333,0.396,20,23760,1320,1188,326.653553,3,0
0,0,13,13,20,25,45,58,56,114,0.000333,0.20869,20,12521.42506,695.634726,626.071253,202.534967,3,0
0,0,15,15,15,34,49,67,68,135,0.000333,0.252662,14,10611.80161,589.544534,757.985829,231.577096,1,0
0,0,16,16,19,40,59,72,69,141,0.000333,0.276484,9,7465.07403,414.726335,829.45267,293.587747,1,0
0,0,18,18,16,34,50,74,64,138,0.000333,0.259617,8,6230.817234,346.156513,778.852154,236.973737,9,0
0,0,16,16,19,40,59,72,69,141,0.000333,0.276484,9,7465.07403,414.726335,829.45267,293.587747,1,0
0,0,27,27,25,30,55,111,83,194,0.000333,0.373861,24,26918.01083,1495.445046,1121.583784,263.303123,8,0
0,0,26,26,30,40,70,129,90,219,0.000333,0.447438,30,40269.38942,2237.188301,1342.312981,360.083842,8,0
0,0,41,41,32,70,102,246,174,420,0.000333,0.93414,32,89677.3966,4982.077589,2802.418644,589.049811,19,0
0,0,30,30,27,46,73,147,109,256,0.000333,0.528198,26,41199.47226,2288.85957,1584.595087,382.465813,10,0
0,0,29,29,30,50,80,172,132,304,0.000333,0.640622,30,57655.98423,3203.110235,1921.866141,429.399527,10,0
0,0,33,33,30,69,99,217,143,360,0.000333,0.795523,30,71597.0515,3977.613972,2386.568383,568.694905,11,0
0,0,31,31,28,51,79,154,125,279,0.000333,0.586252,28,49245.13521,2735.840845,1758.754829,423.89963,16,0
0,0,19,19,14,44,58,104,109,213,0.000333,0.415917,14,17468.49933,970.472185,1247.749952,293.51796,13,0
0,0,29,29,21,34,55,143,93,236,0.000333,0.4548,20,27288.01785,1516.000992,1364.400892,265.212402,5,0
0,0,24,24,19,29,48,115,77,192,0.000333,0.357438,18,19301.6304,1072.3128,1072.3128,221.592072,6,0
0,0,17,17,23,43,66,91,83,174,0.000333,0.350575,11,11568.97034,642.720575,1051.724577,337.371309,3,0
0,0,23,23,25,51,76,112,99,211,0.000333,0.439438,12,15819.75246,878.875137,1318.312705,405.390097,3,0
0,0,24,24,20,45,65,107,91,198,0.000333,0.397476,20,23848.57654,1324.920919,1192.428827,333.571951,3,0
0,0,13,13,20,26,46,58,56,114,0.000333,0.209895,20,12593.72126,699.651181,629.686063,208.649995,3,0
0,0,15,15,15,35,50,67,68,135,0.000333,0.253974,7,5333.444099,296.30245,761.920586,238.128265,1,0
0,0,16,16,19,41,60,72,69,141,0.000333,0.277624,9,7495.844166,416.435787,832.871574,300.370255,1,0
0,0,18,18,16,35,51,74,64,138,0.000333,0.260932,8,6262.357578,347.908754,782.794697,243.524906,9,0
0,0,16,16,19,41,60,72,69,141,0.000333,0.277624,9,7495.844166,416.435787,832.871574,300.370255,1,0
0,0,27,27,25,31,56,111,83,194,0.000333,0.375542,24,27039.04452,1502.16914,1126.626855,269.67649,8,0
0,0,26,26,30,41,71,129,90,219,0.000333,0.448932,30,40403.83858,2244.657699,1346.794619,366.86635,8,0
0,0,41,41,32,71,103,246,174,420,0.000333,0.93611,32,89866.56709,4992.58706,2808.330221,596.632045,19,0
0,0,30,30,27,47,74,147,109,256,0.000333,0.529873,26,41330.1216,2296.117867,1589.620062,389.447639,10,0
0,0,29,29,30,51,81,172,132,304,0.000333,0.642438,30,57819.43203,3212.190668,1927.314401,436.50041,10,0
0,0,33,33,30,70,100,217,143,360,0.000333,0.797263,30,71753.64685,3986.313714,2391.788228,576.256529,11,0
0,0,31,31,28,52,80,154,125,279,0.000333,0.587939,28,49386.90228,2743.716793,1763.817938,431.028803,16,0
0,0,19,19,14,44,58,104,109,213,0.000333,0.415917,14,17468.49933,970.472185,1247.749952,293.51796,13,0
0,0,29,29,21,35,56,143,93,236,0.000333,0.456845,20,27410.71523,1522.817513,1370.535762,271.763571,5,0
0,0,24,24,19,30,49,115,77,192,0.000333,0.359341,18,19404.43722,1078.02429,1078.02429,227.917341,6,0
0,0,11,11,22,38,60,69,57,126,0.000333,0.248089,11,8186.950366,454.830576,744.268215,297.528741,3,0
0,0,19,19,25,46,71,95,79,174,0.000333,0.356685,12,12840.67199,713.370666,1070.055999,370.180255,3,0
0,0,17,17,25,46,71,95,79,174,0.000333,0.356685,12,12840.67199,713.370666,1070.055999,370.180255,3,0
0,0,5,5,16,21,37,35,26,61,0.000333,0.105926,8,2542.213242,141.234069,317.776655,156.238666,3,0
0,0,18,18,20,40,60,86,72,158,0.000333,0.311096,10,9332.887141,518.49373,933.288714,299.315686,3,0
0,0,7,7,19,21,40,41,35,76,0.000333,0.134822,9,3640.198817,202.233268,404.466535,172.949289,3,0
0,0,9,9,13,30,43,45,43,88,0.000333,0.15917,6,2865.06779,159.170433,477.511298,195.312434,1,0
0,0,14,14,15,30,45,51,43,94,0.000333,0.172078,7,3613.639337,200.757741,516.234191,205.810077,2,0
0,0,10,10,18,36,54,55,49,104,0.000333,0.199503,9,5386.574702,299.25415,598.5083,261.17595,1,0
0,0,13,13,15,31,46,49,43,92,0.000333,0.169389,7,3557.1739,197.620772,508.1677,212.183445,3,0
0,0,12,12,17,28,45,47,39,86,0.000333,0.157433,8,3778.39493,209.910829,472.299366,204.092806,3,0
0,0,10,10,18,36,54,55,49,104,0.000333,0.199503,9,5386.574702,299.25415,598.5083,261.17595,1,0
0,0,14,14,15,30,45,51,43,94,0.000333,0.172078,7,3613.639337,200.757741,516.234191,205.810077,2,0
0,0,20,20,29,36,65,107,67,174,0.000333,0.349297,14,14670.48799,815.027111,1047.891999,326.998749,8,0
0,0,35,35,31,66,97,224,150,374,0.000333,0.822789,30,74051.02209,4113.945672,2468.367403,552.510097,19,0
0,0,24,24,26,42,68,125,85,210,0.000333,0.426122,26,33237.54711,1846.530395,1278.367197,348.688764,10,0
0,0,23,23,29,46,75,151,113,264,0.000333,0.548136,28,46043.42776,2557.968209,1644.408134,394.965299,10,0
0,0,22,22,26,54,80,168,99,267,0.000333,0.562652,13,21943.41242,1219.078468,1687.954801,432.975358,10,0
0,0,27,27,30,65,95,197,124,321,0.000333,0.702975,15,31633.85475,1757.436375,2108.92365,538.660626,11,0
0,0,25,25,27,47,74,136,107,243,0.000333,0.502966,26,39231.32636,2179.518131,1508.897168,389.447639,15,0
0,0,13,13,13,40,53,86,90,176,0.000333,0.336038,12,12097.368,672.076,1008.114,260.98284,13,0
0,0,23,23,20,30,50,126,74,200,0.000333,0.376257,20,22575.42476,1254.190264,1128.771238,233.64528,5,0
0,0,15,15,16,30,46,62,58,120,0.000333,0.220942,8,5302.619478,294.589971,662.827435,211.206718,2,0
0,0,16,16,15,15,30,56,33,89,0.000333,0.145571,14,6113.985682,339.665871,436.713263,117.206718,7,0
0,0,16,16,15,15,30,56,33,89,0.000333,0.145571,14,6113.985682,339.665871,436.713263,117.206718,7,0
0,0,9,9,9,12,21,21,21,42,0.000333,0.061492,4,737.909327,40.994963,184.477332,71.548875,2,0
0,0,16,16,14,22,36,48,47,95,0.000333,0.163714,14,6876.000252,382.000014,491.142875,151.410465,7,0
0,0,9,9,15,17,32,40,38,78,0.000333,0.13,14,5460,303.333333,390,128.090227,2,0
0,0,12,12,14,27,41,60,60,120,0.000333,0.214302,14,9000.687368,500.038187,642.906241,181.684931,2,0
0,0,21,21,19,50,69,106,111,217,0.000333,0.44185,18,23859.89653,1325.549807,1325.549807,362.903432,2,0
0,0,24,24,24,33,57,130,92,222,0.000333,0.431634,24,31077.638,1726.535444,1294.901583,276.504106,16,0
0,0,12,12,10,28,38,54,57,111,0.000333,0.194173,10,5825.19954,323.622197,582.519954,167.825219,1,0
0,0,12,12,10,28,38,54,57,111,0.000333,0.194173,10,5825.19954,323.622197,582.519954,167.825219,1,0
0,0,19,19,16,39,55,85,90,175,0.000333,0.337246,16,16187.8072,899.322622,1011.73795,270.130687,2,0
0,0,36,36,22,62,84,197,197,394,0.000333,0.839524,33,83112.91113,4617.383952,2518.573065,467.267667,3,0
0,0,28,28,21,56,77,137,133,270,0.000333,0.564011,20,33840.64732,1880.035962,1692.032366,417.450542,3,0
0,0,31,31,25,40,65,172,111,283,0.000333,0.56811,24,40903.92219,2272.440121,1704.330091,328.973529,9,0
0,0,32,32,24,41,65,178,114,292,0.000333,0.586177,24,42204.75363,2344.708535,1758.531401,329.698732,9,0
0,0,30,30,23,42,65,169,110,279,0.000333,0.56008,22,36965.29364,2053.627424,1680.24062,330.519257,9,0
0,0,29,29,23,40,63,162,106,268,0.000333,0.53397,22,35242.04243,1957.891246,1601.911019,316.919049,9,0
0,0,28,28,23,40,63,158,102,260,0.000333,0.518031,22,34190.04116,1899.446731,1554.09278,316.919049,9,0
0,0,27,27,23,39,62,156,100,256,0.000333,0.508091,22,33534.03362,1863.001868,1524.274255,310.172612,9,0
0,0,33,33,23,44,67,176,117,293,0.000333,0.592455,22,39102.01092,2172.33394,1777.364133,344.256916,9,0
0,0,30,30,24,43,67,164,109,273,0.000333,0.552014,24,39745.01638,2208.056465,1656.042349,343.368484,9,0
0,0,33,33,24,44,68,171,117,288,0.000333,0.584396,24,42076.54316,2337.585731,1753.189298,350.254091,9,0
0,0,67,67,33,41,74,317,210,527,0.000333,1.090794,80,261790.5539,14543.91966,3272.381924,386.124638,28,0
0,0,68,68,33,41,74,323,213,536,0.000333,1.109422,80,266261.3603,14792.2978,3328.267004,386.124638,28,0
0,0,66,66,32,42,74,314,209,523,0.000333,1.082515,64,207842.8231,11546.8235,3247.54411,386.477332,28,0
0,0,65,65,32,40,72,307,205,512,0.000333,1.053001,80,252720.1281,14040.00711,3159.001601,372.877124,28,0
0,0,64,64,32,40,72,301,199,500,0.000333,1.028321,64,197437.6,10968.75556,3084.962501,372.877124,28,0
0,0,63,63,32,39,71,301,199,500,0.000333,1.024958,80,245989.8848,13666.10471,3074.87356,366.130687,28,0
0,0,69,69,32,43,75,324,217,541,0.000333,1.123264,80,269583.2729,14976.8485,3369.790912,393.329384,28,0
0,0,66,66,32,43,75,309,208,517,0.000333,1.073433,64,206099.1528,11449.95294,3220.299263,393.329384,28,0
0,0,69,69,32,44,76,316,216,532,0.000333,1.107966,64,212729.436,11818.302,3323.897437,400.214991,28,0
0,0,24,24,28,36,64,135,91,226,0.000333,0.452,28,37968,2109.333333,1356,320.723238,5,0
0,0,25,25,28,37,65,141,94,235,0.000333,0.471752,28,39627.18021,2201.510012,1415.256436,327.355712,5,0
0,0,23,23,26,38,64,132,90,222,0.000333,0.444,26,34632,1924,1332,321.632678,5,0
0,0,22,22,26,36,62,125,86,211,0.000333,0.418778,26,32664.72096,1814.70672,1256.335421,308.328733,5,0
0,0,19,19,26,33,59,125,90,215,0.000333,0.421589,26,32883.97465,1826.88748,1264.768256,288.676439,5,0
0,0,20,20,26,34,60,119,80,199,0.000333,0.391824,26,30562.25194,1697.902886,1175.471229,295.185169,5,0
0,0,26,26,27,39,66,143,98,241,0.000333,0.485566,26,37874.17355,2104.120753,1456.698983,334.512649,5,0
0,0,23,23,26,39,65,127,89,216,0.000333,0.43361,26,33821.61764,1878.978758,1300.831448,328.342119,5,0
0,0,26,26,27,40,67,135,97,232,0.000333,0.469111,26,36590.65,2032.813889,1407.332692,341.259086,5,0
0,0,20,20,20,25,45,87,65,152,0.000333,0.278254,20,16695.23341,927.512967,834.761671,202.534967,4,0
0,0,21,21,19,26,45,93,68,161,0.000333,0.294729,18,15915.39027,884.188349,884.188349,202.922055,4,0
0,0,19,19,18,26,44,81,63,144,0.000333,0.262053,18,14150.84676,786.158153,786.158153,197.270083,4,0
0,0,18,18,18,26,44,77,60,137,0.000333,0.249314,18,13462.95837,747.942132,747.942132,197.270083,4,0
0,0,17,17,18,24,42,73,56,129,0.000333,0.23187,18,12520.96106,695.608948,695.608948,185.09775,4,0
0,0,16,16,18,23,41,71,54,125,0.000333,0.223231,18,12054.49201,669.694001,669.694001,179.100575,4,0
0,0,22,22,18,28,46,94,72,166,0.000333,0.305637,18,16504.40313,916.911285,916.911285,209.664588,4,0
0,0,19,19,18,28,46,79,63,142,0.000333,0.261449,18,14118.22436,784.345798,784.345798,209.664588,4,0
0,0,22,22,18,28,46,87,71,158,0.000333,0.290908,18,15709.0102,872.722789,872.722789,209.664588,4,0
0,0,25,25,21,43,64,148,92,240,0.000333,0.48,20,28800,1600,1440,325.56805,13,0
0,0,26,26,20,44,64,154,95,249,0.000333,0.498,20,29880,1660,1494,326.653553,13,0
0,0,24,24,19,45,64,145,91,236,0.000333,0.472,18,25488,1416,1416,327.844012,13,0
0,0,23,23,19,43,62,138,87,225,0.000333,0.446565,18,24114.49506,1339.69417,1339.69417,314.040007,13,0
0,0,22,22,19,43,62,130,79,209,0.000333,0.414809,9,11199.84326,622.213514,1244.427029,314.040007,11,0
0,0,21,21,19,42,61,132,81,213,0.000333,0.421082,9,11369.22348,631.623526,1263.247053,307.187955,13,0
0,0,27,27,21,47,68,156,99,255,0.000333,0.517434,20,31046.06049,1724.781138,1552.303025,353.304342,13,0
0,0,24,24,19,46,65,140,90,230,0.000333,0.461715,9,12466.30137,692.572298,1385.144597,334.794473,13,0
0,0,27,27,19,47,66,148,98,246,0.000333,0.49564,18,26764.57716,1486.920953,1486.920953,341.776299,13,0
0,0,41,41,26,48,74,215,157,372,0.000333,0.769972,39,90086.74943,5004.819413,2309.916652,390.289633,8,0
0,0,42,42,25,49,74,221,160,381,0.000333,0.788601,36,85168.86236,4731.603465,2365.801732,391.217187,8,0
0,0,40,40,24,50,74,212,156,368,0.000333,0.761693,36,82262.83819,4570.157677,2285.078839,392.23191,8,0
0,0,39,39,24,48,72,205,152,357,0.000333,0.734221,36,79295.87612,4405.326451,2202.663226,378.1173,8,0
0,0,38,38,24,48,72,199,148,347,0.000333,0.713655,36,77074.70312,4281.927951,2140.963976,378.1173,8,0
0,0,37,37,24,47,71,199,146,345,0.000333,0.707221,36,76379.85922,4243.325512,2121.662756,371.104776,8,0
0,0,43,43,24,52,76,223,164,387,0.000333,0.805983,36,87046.12612,4835.895895,2417.947948,406.461965,8,0
0,0,40,40,25,51,76,207,155,362,0.000333,0.753917,36,81422.99136,4523.49952,2261.74976,405.390097,8,0
0,0,43,43,25,52,77,215,163,378,0.000333,0.789615,36,85278.43125,4737.690625,2368.845312,412.51927,8,0
0,0,8,8,16,15,31,45,31,76,0.000333,0.125506,16,6024.302713,334.683484,376.51892,122.603359,2,0
0,0,9,9,16,16,32,50,34,84,0.000333,0.14,16,6720,373.333333,420,128,2,0
0,0,4,4,13,14,27,29,20,49,0.000333,0.077663,6,1397.936926,77.663163,232.989488,101.408685,2,0
0,0,4,4,13,14,27,29,20,49,0.000333,0.077663,6,1397.936926,77.663163,232.989488,101.408685,2,0
0,0,10,10,14,18,32,53,38,91,0.000333,0.151667,14,6370,353.888889,455,128.361619,2,0
0,0,7,7,14,18,32,37,29,66,0.000333,0.11,7,2310,128.333333,330,128.361619,2,0
0,0,10,10,15,19,34,45,37,82,0.000333,0.139057,7,2920.203671,162.233537,417.171953,139.313982,2,0
0,0,9,9,17,13,30,41,28,69,0.000333,0.112858,16,5417.207218,300.955957,338.575451,117.592585,2,0
0,0,10,10,16,14,30,47,31,78,0.000333,0.127579,16,6123.799463,340.211081,382.737466,117.302969,2,0
0,0,8,8,15,15,30,39,27,66,0.000333,0.107952,7,2266.983455,125.943525,323.854779,117.206718,2,0
0,0,7,7,15,13,28,31,23,54,0.000333,0.086532,7,1817.180161,100.954453,259.597166,106.709075,2,0
0,0,11,11,15,17,32,49,35,84,0.000333,0.14,14,5880,326.666667,420,128.090227,2,0
0,0,8,8,16,16,32,33,26,59,0.000333,0.098333,8,2360,131.111111,295,128,2,0
0,0,11,11,16,17,33,41,34,75,0.000333,0.12611,16,6053.272943,336.292941,378.329559,133.486868,2,0
0,0,12,12,21,17,38,84,45,129,0.000333,0.225661,20,13539.65299,752.202944,676.982649,161.725534,2,0
0,0,13,13,21,18,39,90,48,138,0.000333,0.243129,20,14587.71012,810.42834,729.385506,167.297316,2,0
0,0,11,11,19,19,38,82,44,126,0.000333,0.220413,18,11902.2996,661.238867,661.238867,161.421246,2,0
0,0,10,10,19,18,37,74,40,114,0.000333,0.197959,18,10689.79831,593.877684,593.877684,155.769273,2,0
0,0,9,9,18,17,35,52,32,84,0.000333,0.14362,9,3877.737961,215.429887,430.859773,144.545518,2,0
0,0,12,12,19,20,39,84,45,129,0.000333,0.227272,18,12272.70395,681.816886,681.816886,167.149185,2,0
0,0,11,11,19,20,39,76,43,119,0.000333,0.209654,18,11321.33155,628.962864,628.962864,167.149185,2,0
0,0,14,14,19,21,40,84,51,135,0.000333,0.239487,18,12932.28527,718.460293,718.460293,172.949289,2,0
0,0,77,77,35,123,158,404,286,690,0.000333,1.67987,34,171346.6964,9519.260908,5039.608716,1033.45419,26,0
0,0,78,78,35,124,159,410,289,699,0.000333,1.703902,34,173797.9763,9655.443129,5111.705186,1041.845248,26,0
0,0,76,76,33,125,158,402,285,687,0.000333,1.672566,32,160566.316,8920.350887,5017.697374,1037.188042,26,0
0,0,75,75,33,123,156,394,281,675,0.000333,1.639215,32,157364.6879,8742.482663,4917.646498,1020.39429,26,0
0,0,74,74,33,123,156,390,277,667,0.000333,1.619788,32,155499.625,8638.868053,4859.36328,1020.39429,26,0
0,0,73,73,33,122,155,388,275,663,0.000333,1.608023,32,154370.2554,8576.125299,4824.070481,1012.014961,26,0
0,0,79,79,36,127,163,412,293,705,0.000333,1.726951,36,186510.7206,10361.7067,5180.853349,1073.680255,26,0
0,0,76,76,33,126,159,396,284,680,0.000333,1.657587,32,159128.3331,8840.46295,4972.76041,1045.602276,26,0
0,0,79,79,34,127,161,403,292,695,0.000333,1.698329,34,173229.5658,9623.864768,5094.98723,1060.536692,26,0
0,0,14,14,20,28,48,82,58,140,0.000333,0.260632,20,15637.895,868.771945,781.89475,221.0445,3,0
0,0,15,15,21,29,50,88,61,149,0.000333,0.280312,20,16818.69145,934.371747,840.934572,233.120115,3,0
0,0,13,13,18,29,47,80,57,137,0.000333,0.25366,9,6848.808054,380.489336,760.978673,215.940099,3,0
0,0,12,12,18,28,46,72,53,125,0.000333,0.230148,9,6214.007201,345.222622,690.445245,209.664588,3,0
0,0,11,11,18,28,46,67,48,115,0.000333,0.211737,9,5716.886625,317.604812,635.209625,209.664588,3,0
0,0,10,10,18,27,45,66,47,113,0.000333,0.20686,9,5585.214599,310.2897,620.5794,203.440613,3,0
0,0,16,16,21,31,52,90,65,155,0.000333,0.294523,20,17671.36313,981.742396,883.568156,245.818752,3,0
0,0,13,13,18,31,49,74,56,130,0.000333,0.243304,9,6569.210518,364.95614,729.91228,228.638736,3,0
0,0,16,16,19,31,50,82,64,146,0.000333,0.274668,18,14832.05407,824.003004,824.003004,234.290708,3,0
0,0,14,14,24,33,57,91,67,158,0.000333,0.307199,24,22118.31893,1228.795496,921.596622,276.504106,4,0
0,0,15,15,23,34,57,97,70,167,0.000333,0.324698,22,21430.03791,1190.557662,974.092632,277.015662,4,0
0,0,13,13,21,35,56,89,66,155,0.000333,0.300047,10,9001.400129,500.077785,900.140013,271.763571,4,0
0,0,12,12,21,33,54,81,62,143,0.000333,0.274316,10,8229.489128,457.19384,822.948913,258.703672,4,0
0,0,11,11,20,33,53,77,58,135,0.000333,0.257756,10,7732.692614,429.594034,773.269261,252.903568,4,0
0,0,16,16,22,38,60,99,74,173,0.000333,0.340631,11,11240.8128,624.4896,1021.892073,297.528741,4,0
0,0,13,13,21,36,57,83,65,148,0.000333,0.287756,10,8632.677221,479.593179,863.267722,278.355966,4,0
0,0,16,16,22,37,59,91,73,164,0.000333,0.321584,11,10612.28806,589.571559,964.75346,290.85727,4,0
0,0,21,21,24,39,63,113,90,203,0.000333,0.404463,24,29121.30779,1617.850433,1213.387824,316.169787,4,0
0,0,22,22,24,40,64,119,93,212,0.000333,0.424,24,30528,1696,1272,322.916224,4,0
0,0,20,20,22,40,62,110,89,199,0.000333,0.394962,22,26067.47145,1448.192858,1184.885066,310.984619,4,0
0,0,19,19,22,39,61,103,85,188,0.000333,0.37166,22,24529.52963,1362.751646,1114.978619,304.238182,4,0
0,0,18,18,22,39,61,99,81,180,0.000333,0.355844,22,23485.71986,1304.762214,1067.532721,304.238182,4,0
0,0,17,17,22,38,60,97,79,176,0.000333,0.346538,22,22871.48039,1270.637799,1039.612745,297.528741,4,0
0,0,23,23,23,42,65,121,97,218,0.000333,0.437625,22,28883.27603,1604.626446,1312.876183,330.519257,4,0
0,0,20,20,22,42,64,105,88,193,0.000333,0.386,22,25476,1415.333333,1158,324.584827,4,0
0,0,23,23,23,42,65,113,96,209,0.000333,0.419558,22,27690.8472,1538.3804,1258.674873,330.519257,4,0
0,0,26,26,29,54,83,139,108,247,0.000333,0.524878,28,44089.77271,2449.431817,1574.63474,451.645374,5,0
0,0,27,27,28,55,83,145,111,256,0.000333,0.544003,28,45696.28264,2538.682369,1632.010094,452.580722,5,0
0,0,25,25,28,55,83,137,107,244,0.000333,0.518503,14,21777.1347,1209.840817,1555.509621,452.580722,5,0
0,0,24,24,28,54,82,129,103,232,0.000333,0.491651,14,20649.32891,1147.184939,1474.952065,445.369863,5,0
0,0,23,23,28,54,82,125,99,224,0.000333,0.474697,14,19937.28309,1107.626838,1424.091649,445.369863,5,0
0,0,22,22,28,53,81,123,97,220,0.000333,0.464922,14,19526.73801,1084.818778,1394.767001,438.185722,5,0
0,0,29,29,28,57,85,150,118,268,0.000333,0.572572,28,48096.06959,2672.003866,1717.716771,467.080669,5,0
0,0,25,25,28,57,85,131,106,237,0.000333,0.506342,14,21266.35913,1181.464396,1519.025652,467.080669,5,0
0,0,28,28,28,57,85,139,114,253,0.000333,0.540525,28,45404.12539,2522.451411,1621.575907,467.080669,5,0
0,0,11,11,13,18,31,53,43,96,0.000333,0.158534,12,5707.23415,317.068564,475.602846,123.164366,3,0
0,0,12,12,13,19,32,58,46,104,0.000333,0.173333,12,6240,346.666667,520,128.816339,3,0
0,0,10,10,12,19,31,51,42,93,0.000333,0.15358,12,5528.883082,307.160171,460.740257,123.730173,3,0
0,0,9,9,12,18,30,43,38,81,0.000333,0.132486,12,4769.497659,264.972092,397.458138,118.0782,3,0
0,0,8,8,12,18,30,40,34,74,0.000333,0.121037,6,2178.659424,121.036635,363.109904,118.0782,3,0
0,0,7,7,12,17,29,38,32,70,0.000333,0.113353,6,2040.352018,113.35289,340.05867,112.506418,3,0
0,0,13,13,14,21,35,58,50,108,0.000333,0.184654,14,7755.475922,430.859773,553.962566,145.541635,3,0
0,0,10,10,13,21,34,45,41,86,0.000333,0.145841,6,2625.130826,145.840601,437.521804,140.344382,3,0
0,0,12,12,13,21,34,48,45,93,0.000333,0.157711,12,5677.608531,315.422696,473.134044,140.344382,3,0
0,0,13,13,21,22,43,158,113,271,0.000333,0.490173,50,73525.88743,4084.771524,1470.517749,190.346161,6,0
0,0,14,14,20,23,43,162,116,278,0.000333,0.502834,50,75425.08009,4190.282227,1508.501602,190.480487,6,0
0,0,12,12,18,23,41,140,99,239,0.000333,0.426818,36,46096.37745,2560.909858,1280.454929,179.100575,6,0
0,0,11,11,18,23,41,136,96,232,0.000333,0.414317,36,44746.27434,2485.90413,1242.952065,179.100575,6,0
0,0,10,10,18,21,39,125,86,211,0.000333,0.37174,36,40147.91525,2230.439736,1115.219868,167.297316,6,0
0,0,9,9,18,20,38,124,84,208,0.000333,0.363856,36,39296.48122,2183.137846,1091.568923,161.497212,6,0
0,0,15,15,19,26,45,159,115,274,0.000333,0.501589,36,54171.63894,3009.535497,1504.767748,202.922055,6,0
0,0,12,12,18,25,43,138,99,237,0.000333,0.428675,27,34722.66817,1929.03712,1286.024747,191.155055,6,0
0,0,15,15,19,27,46,151,112,263,0.000333,0.484232,36,52297.0846,2905.393589,1452.696794,209.092585,6,0
0,0,9,9,14,14,28,54,47,101,0.000333,0.161848,21,10196.39979,566.466655,485.542847,106.605938,2,0
0,0,10,10,14,15,29,60,50,110,0.000333,0.178126,21,11221.9361,623.440894,534.377909,111.906328,2,0
0,0,8,8,11,16,27,47,42,89,0.000333,0.141062,10,4231.849877,235.102771,423.184988,102.053748,2,0
0,0,7,7,11,14,25,41,38,79,0.000333,0.122288,10,3668.64639,203.813688,366.864639,91.356717,2,0
0,0,6,6,11,14,25,38,34,72,0.000333,0.111453,10,3343.576457,185.754248,334.357646,91.356717,2,0
0,0,5,5,11,12,23,35,30,65,0.000333,0.098011,10,2940.315271,163.350848,294.031527,81.073298,2,0
0,0,11,11,14,18,32,58,52,110,0.000333,0.183333,14,7700,427.777778,550,128.361619,2,0
0,0,8,8,12,17,29,44,41,85,0.000333,0.137643,12,4955.140615,275.28559,412.928385,112.506418,2,0
0,0,10,10,12,17,29,51,49,100,0.000333,0.161933,12,5829.577194,323.8654,485.7981,112.506418,2,0
0,0,13,13,16,13,29,77,43,120,0.000333,0.194319,24,13990.98527,777.276959,582.957719,112.105716,3,0
0,0,14,14,17,15,32,84,46,130,0.000333,0.216667,24,15600,866.666667,650,128.090227,3,0
0,0,12,12,13,15,28,74,42,116,0.000333,0.185884,12,6691.838052,371.768781,557.653171,106.709075,3,0
0,0,11,11,13,13,26,67,38,105,0.000333,0.164515,12,5922.554045,329.03078,493.54617,96.211433,3,0
0,0,10,10,15,14,29,65,36,101,0.000333,0.163552,14,6869.185127,381.621396,490.656081,111.906328,3,0
0,0,9,9,13,12,25,61,32,93,0.000333,0.14396,12,5182.543508,287.919084,431.878626,91.125266,3,0
0,0,14,14,13,17,30,83,49,132,0.000333,0.215903,12,7772.514703,431.806372,647.709559,117.592585,3,0
0,0,12,12,14,17,31,69,41,110,0.000333,0.181654,14,7629.462318,423.859018,544.961594,122.789837,3,0
0,0,14,14,14,17,31,74,48,122,0.000333,0.201471,14,8461.767298,470.098183,604.41195,122.789837,3,0
1,0,27,28,17,33,50,100,90,190,0.000333,0.357444,16,17157.32282,953.184601,1072.332676,235.951874,7,0
1,0,27,28,17,34,51,102,90,192,0.000333,0.363035,16,17425.69065,968.093925,1089.105666,242.460605,7,0
1,0,26,27,15,35,50,97,89,186,0.000333,0.349919,14,14696.60152,816.477862,1049.757251,238.128265,7,0
1,0,25,26,15,34,49,90,85,175,0.000333,0.327525,14,13756.03912,764.224395,982.574223,231.577096,7,0
0,0,21,21,15,32,47,93,82,175,0.000333,0.324018,14,13608.74269,756.04126,972.053049,218.603359,7,0
1,0,23,24,15,32,47,84,79,163,0.000333,0.301799,14,12675.57176,704.198431,905.397983,218.603359,7,0
1,0,29,30,17,37,54,108,97,205,0.000333,0.393251,16,18876.03101,1048.668389,1179.751938,262.236643,7,0
1,0,26,27,15,36,51,92,88,180,0.000333,0.340346,14,14294.51186,794.139548,1021.036562,244.720659,7,0
1,0,29,30,15,37,52,100,96,196,0.000333,0.372429,14,15642.00659,869.000366,1117.286185,251.353133,7,0
0,0,8,8,14,23,37,37,30,67,0.000333,0.116344,7,2443.233628,135.735202,349.033375,157.344894,2,0
0,0,5,5,14,25,39,33,28,61,0.000333,0.10747,7,2256.866747,125.381486,322.409535,169.399374,2,0
0,0,11,11,22,38,60,69,57,126,0.000333,0.248089,11,8186.950366,454.830576,744.268215,297.528741,3,0
0,0,19,19,25,46,71,95,79,174,0.000333,0.356685,12,12840.67199,713.370666,1070.055999,370.180255,3,0
0,0,17,17,25,46,71,95,79,174,0.000333,0.356685,12,12840.67199,713.370666,1070.055999,370.180255,3,0
0,0,11,11,14,25,39,38,32,70,0.000333,0.123326,7,2589.847087,143.880394,369.978155,169.399374,2,0
0,0,5,5,16,21,37,35,26,61,0.000333,0.105926,8,2542.213242,141.234069,317.776655,156.238666,3,0
0,0,8,8,16,23,39,45,34,79,0.000333,0.139182,8,3340.374202,185.576345,417.546775,168.041925,5,0
0,0,18,18,20,40,60,86,72,158,0.000333,0.311096,10,9332.887141,518.49373,933.288714,299.315686,3,0
0,0,7,7,19,21,40,41,35,76,0.000333,0.134822,9,3640.198817,202.233268,404.466535,172.949289,3,0
0,0,9,9,13,30,43,45,43,88,0.000333,0.15917,6,2865.06779,159.170433,477.511298,195.312434,1,0
0,0,14,14,15,30,45,51,43,94,0.000333,0.172078,7,3613.639337,200.757741,516.234191,205.810077,2,0
0,0,11,11,14,25,39,38,32,70,0.000333,0.123326,7,2589.847087,143.880394,369.978155,169.399374,2,0
0,0,10,10,16,24,40,45,32,77,0.000333,0.136596,8,3278.307706,182.128206,409.788463,174.0391,10,0
0,0,7,7,15,22,37,31,26,57,0.000333,0.09898,7,2078.571893,115.476216,296.938842,156.710855,3,0
0,0,12,12,15,27,42,43,34,77,0.000333,0.138403,7,2906.459091,161.469949,415.208442,186.985321,2,0
0,0,10,10,14,23,37,37,30,67,0.000333,0.116344,7,2443.233628,135.735202,349.033375,157.344894,2,0
0,0,10,10,18,36,54,55,49,104,0.000333,0.199503,9,5386.574702,299.25415,598.5083,261.17595,1,0
0,0,13,13,15,31,46,49,43,92,0.000333,0.169389,7,3557.1739,197.620772,508.1677,212.183445,3,0
0,0,12,12,17,28,45,47,39,86,0.000333,0.157433,8,3778.39493,209.910829,472.299366,204.092806,3,0
0,0,12,12,15,27,42,43,34,77,0.000333,0.138403,7,2906.459091,161.469949,415.208442,186.985321,2,0
0,0,12,12,15,30,45,56,43,99,0.000333,0.181231,7,3805.854196,211.436344,543.693457,205.810077,9,0
0,0,10,10,18,36,54,55,49,104,0.000333,0.199503,9,5386.574702,299.25415,598.5083,261.17595,1,0
0,0,14,14,15,30,45,51,43,94,0.000333,0.172078,7,3613.639337,200.757741,516.234191,205.810077,2,0
0,0,4,4,12,14,26,30,21,51,0.000333,0.079907,6,1438.334554,79.907475,239.722426,96.322519,6,0
0,0,4,4,13,15,28,33,23,56,0.000333,0.089737,6,1615.271254,89.737292,269.211876,106.709075,7,0
0,0,21,21,25,26,51,95,63,158,0.000333,0.298748,24,21509.8369,1194.990939,896.243204,238.307837,8,0
0,0,20,20,29,36,65,107,67,174,0.000333,0.349297,14,14670.48799,815.027111,1047.891999,326.998749,8,0
0,0,35,35,31,66,97,224,150,374,0.000333,0.822789,30,74051.02209,4113.945672,2468.367403,552.510097,19,0
0,0,24,24,26,42,68,125,85,210,0.000333,0.426122,26,33237.54711,1846.530395,1278.367197,348.688764,10,0
0,0,23,23,29,46,75,151,113,264,0.000333,0.548136,28,46043.42776,2557.968209,1644.408134,394.965299,10,0
0,0,22,22,26,54,80,168,99,267,0.000333,0.562652,13,21943.41242,1219.078468,1687.954801,432.975358,10,0
0,0,27,27,30,65,95,197,124,321,0.000333,0.702975,15,31633.85475,1757.436375,2108.92365,538.660626,11,0
0,0,25,25,27,47,74,136,107,243,0.000333,0.502966,26,39231.32636,2179.518131,1508.897168,389.447639,15,0
0,0,13,13,13,40,53,86,90,176,0.000333,0.336038,12,12097.368,672.076,1008.114,260.98284,13,0
0,0,11,11,18,22,40,60,43,103,0.000333,0.18272,9,4933.427344,274.079297,548.158594,173.166146,5,0
0,0,23,23,20,30,50,126,74,200,0.000333,0.376257,20,22575.42476,1254.190264,1128.771238,233.64528,5,0
0,0,18,18,18,25,43,98,59,157,0.000333,0.283975,18,15334.6242,851.923566,851.923566,191.155055,6,0
0,0,16,16,16,31,47,64,60,124,0.000333,0.22959,8,5510.152141,306.119563,688.769018,217.580086,2,0
0,0,17,17,15,16,31,58,35,93,0.000333,0.15358,14,6450.363596,358.353533,460.740257,122.603359,7,0
0,0,17,17,15,16,31,58,35,93,0.000333,0.15358,14,6450.363596,358.353533,460.740257,122.603359,7,0
0,0,10,10,10,13,23,23,23,46,0.000333,0.069361,5,1040.41925,57.801069,208.08385,81.324997,2,0
0,0,17,17,14,23,37,49,49,98,0.000333,0.170175,14,7147.370018,397.076112,510.52643,157.344894,7,0
0,0,10,10,15,18,33,42,40,82,0.000333,0.13788,14,5790.964449,321.720247,413.640318,133.662009,2,0
0,0,13,13,14,28,42,62,62,124,0.000333,0.222882,14,9361.063046,520.059058,668.64736,187.908907,2,0
0,0,22,22,19,51,70,108,113,221,0.000333,0.451524,18,24382.28784,1354.571547,1354.571547,370.004315,2,0
0,0,25,25,23,34,57,132,94,226,0.000333,0.439411,22,29001.12915,1611.173842,1318.233143,277.015662,16,0
0,0,13,13,10,29,39,56,59,115,0.000333,0.202607,10,6078.212552,337.678475,607.821255,174.10073,1,0
0,0,13,13,10,29,39,56,59,115,0.000333,0.202607,10,6078.212552,337.678475,607.821255,174.10073,1,0
0,0,20,20,16,40,56,87,92,179,0.000333,0.346506,16,16632.2645,924.014694,1039.516531,276.877124,2,0
0,0,37,37,22,63,85,199,199,398,0.000333,0.850313,33,84180.94056,4676.71892,2550.937593,474.676131,3,0
0,0,29,29,21,57,78,139,135,274,0.000333,0.574067,20,34444.00416,1913.555787,1722.200208,424.713397,3,0
0,0,20,20,18,32,50,79,75,154,0.000333,0.289718,18,15644.76936,869.153853,869.153853,235.05865,2,0
0,0,20,20,16,16,32,76,48,124,0.000333,0.206667,24,14880,826.666667,620,128,7,0
0,0,20,20,16,16,32,76,48,124,0.000333,0.206667,24,14880,826.666667,620,128,7,0
0,0,13,13,12,15,27,39,38,77,0.000333,0.122042,12,4393.516052,244.084225,366.126338,101.622909,2,0
0,0,19,19,16,26,42,65,57,122,0.000333,0.219288,16,10525.80361,584.766867,657.862726,186.211433,7,0
0,0,12,12,17,19,36,56,48,104,0.000333,0.179224,16,8602.755202,477.930845,537.6722,150.197491,2,0
0,0,15,15,15,29,44,76,70,146,0.000333,0.265692,14,11159.07823,619.94879,797.077016,199.484808,2,0
0,0,24,24,20,51,71,119,120,239,0.000333,0.48993,20,29395.79123,1633.099513,1469.789562,375.732254,2,0
0,0,27,27,26,36,62,146,103,249,0.000333,0.494198,26,38547.46691,2141.52594,1482.594881,308.328733,16,0
0,0,15,15,12,29,41,70,67,137,0.000333,0.244662,12,8807.815496,489.323083,733.984625,183.900999,1,0
0,0,15,15,12,29,41,70,67,137,0.000333,0.244662,12,8807.815496,489.323083,733.984625,183.900999,1,0
0,0,22,22,17,40,57,101,100,201,0.000333,0.390804,16,18758.57429,1042.143016,1172.410893,282.363992,2,0
0,0,39,39,23,63,86,213,207,420,0.000333,0.899677,33,89068.0295,4948.223861,2699.031197,480.61056,3,0
0,0,31,31,22,57,79,153,143,296,0.000333,0.621973,22,41050.22023,2280.567791,1865.919101,430.582226,3,0
0,0,22,22,17,34,51,80,80,160,0.000333,0.302529,16,14521.40888,806.744938,907.588055,242.460605,2,0
0,0,23,23,16,19,35,82,57,139,0.000333,0.237657,24,17111.28815,950.627119,712.970339,144.710623,7,0
0,0,23,23,16,19,35,82,57,139,0.000333,0.237657,24,17111.28815,950.627119,712.970339,144.710623,7,0
0,0,16,16,12,18,30,42,47,89,0.000333,0.145571,12,5240.559156,291.142175,436.713263,118.0782,2,0
0,0,22,22,16,28,44,66,66,132,0.000333,0.240215,16,11530.31958,640.57331,720.644974,198.605938,7,0
0,0,15,15,16,22,38,57,57,114,0.000333,0.199421,16,9572.219785,531.789988,598.263737,162.107496,2,0
0,0,18,18,15,32,47,77,79,156,0.000333,0.288839,14,12131.22205,673.956781,866.515861,218.603359,2,0
0,0,27,27,20,54,74,123,129,252,0.000333,0.521594,20,31295.64496,1738.646942,1564.782248,397.202487,2,0
0,0,29,29,25,39,64,150,112,262,0.000333,0.524,24,37728,2096,1572,322.227091,16,0
0,0,18,18,11,32,43,71,76,147,0.000333,0.265887,10,7976.609189,443.144955,797.660919,198.053748,1,0
0,0,18,18,11,32,43,71,76,147,0.000333,0.265887,10,7976.609189,443.144955,797.660919,198.053748,1,0
0,0,26,26,16,43,59,105,112,217,0.000333,0.425511,16,20424.53667,1134.696482,1276.533542,297.329384,2,0
0,0,42,42,23,66,89,214,216,430,0.000333,0.928188,33,91890.65739,5105.036521,2784.565375,502.971937,3,0
0,0,34,34,22,60,82,154,152,306,0.000333,0.64847,22,42799.0401,2377.72445,1945.410913,452.520931,3,0
0,0,22,22,17,35,52,81,80,161,0.000333,0.305924,16,14684.33271,815.796262,917.770795,249.011774,2,0
0,0,23,23,16,20,36,82,57,139,0.000333,0.23954,16,11497.9132,638.772956,718.619575,150.438562,7,0
0,0,23,23,16,20,36,82,57,139,0.000333,0.23954,16,11497.9132,638.772956,718.619575,150.438562,7,0
0,0,16,16,12,19,31,42,47,89,0.000333,0.146974,12,5291.081659,293.948981,440.923472,123.730173,2,0
0,0,22,22,16,29,45,66,66,132,0.000333,0.241642,16,11598.79374,644.37743,724.924609,204.881449,7,0
0,0,14,14,16,22,38,54,54,108,0.000333,0.188925,16,9068.418743,503.801041,566.776171,162.107496,2,0
0,0,18,18,15,33,48,78,79,157,0.000333,0.29228,14,12275.74758,681.985976,876.839113,225.068365,2,0
0,0,27,27,20,55,75,123,129,252,0.000333,0.523221,20,31393.2462,1744.069233,1569.66231,404.413346,2,0
0,0,29,29,25,40,65,150,112,262,0.000333,0.525953,24,37868.64881,2103.813823,1577.860367,328.973529,16,0
0,0,18,18,11,33,44,71,76,147,0.000333,0.267512,10,8025.364479,445.853582,802.536448,204.518754,1,0
0,0,18,18,11,33,44,71,76,147,0.000333,0.267512,10,8025.364479,445.853582,802.536448,204.518754,1,0
0,0,25,25,16,44,60,102,109,211,0.000333,0.415451,16,19941.66265,1107.870147,1246.353916,304.214991,2,0
0,0,42,42,23,67,90,214,216,430,0.000333,0.930499,33,92119.39544,5117.744191,2791.496831,510.469901,3,0
0,0,34,34,22,61,83,154,152,306,0.000333,0.650254,22,42916.76545,2384.264747,1950.762066,459.882473,3,0
0,0,19,19,18,31,49,76,72,148,0.000333,0.276992,18,14957.58703,830.977057,830.977057,228.638736,2,0
0,0,20,20,15,16,31,75,48,123,0.000333,0.203122,21,12796.68907,710.927171,609.366146,122.603359,7,0
0,0,20,20,15,16,31,75,48,123,0.000333,0.203122,21,12796.68907,710.927171,609.366146,122.603359,7,0
0,0,13,13,11,15,26,35,38,73,0.000333,0.114377,10,3431.320994,190.628944,343.132099,96.657107,2,0
0,0,19,19,15,25,40,59,59,118,0.000333,0.209329,14,8791.825213,488.434734,627.987515,174.699764,7,0
0,0,12,12,15,19,34,51,48,99,0.000333,0.167886,14,7051.223498,391.734639,503.658821,139.313982,2,0
0,0,15,15,14,29,43,71,70,141,0.000333,0.255034,14,10711.44663,595.080368,765.10333,194.184418,2,0
0,0,24,24,20,51,71,116,122,238,0.000333,0.48788,20,29272.79629,1626.26646,1463.639814,375.732254,2,0
0,0,27,27,25,36,61,143,103,246,0.000333,0.48632,24,35015.07324,1945.281847,1458.961385,302.213705,16,0
0,0,15,15,11,29,40,64,69,133,0.000333,0.235939,10,7078.164366,393.231354,707.816437,178.935197,1,0
0,0,15,15,11,29,40,64,69,133,0.000333,0.235939,10,7078.164366,393.231354,707.816437,178.935197,1,0
0,0,22,22,16,40,56,95,102,197,0.000333,0.38135,16,18304.78271,1016.932373,1144.04892,276.877124,2,0
0,0,39,39,23,63,86,207,209,416,0.000333,0.891109,33,88219.76255,4901.09792,2673.326138,480.61056,3,0
0,0,31,31,22,57,79,147,145,292,0.000333,0.613568,22,40495.48753,2249.749307,1840.703978,430.582226,3,0
0,0,19,19,18,31,49,74,71,145,0.000333,0.271378,18,14654.39269,814.132927,814.132927,228.638736,2,0
0,0,20,20,15,16,31,75,48,123,0.000333,0.203122,21,12796.68907,710.927171,609.366146,122.603359,7,0
0,0,20,20,15,16,31,75,48,123,0.000333,0.203122,21,12796.68907,710.927171,609.366146,122.603359,7,0
0,0,13,13,11,15,26,35,38,73,0.000333,0.114377,10,3431.320994,190.628944,343.132099,96.657107,2,0
0,0,19,19,15,24,39,59,57,116,0.000333,0.204369,14,8583.493203,476.860734,613.106657,168.642459,7,0
0,0,12,12,15,18,33,51,48,99,0.000333,0.166465,14,6991.530249,388.418347,499.395018,133.662009,2,0
0,0,15,15,14,28,42,71,70,141,0.000333,0.253439,14,10644.43459,591.357477,760.316757,187.908907,2,0
0,0,24,24,20,51,71,116,120,236,0.000333,0.48378,20,29026.8064,1612.600356,1451.34032,375.732254,2,0
0,0,27,27,25,36,61,143,103,246,0.000333,0.48632,24,35015.07324,1945.281847,1458.961385,302.213705,16,0
0,0,15,15,11,29,40,64,67,131,0.000333,0.232391,10,6971.725804,387.3181,697.17258,178.935197,1,0
0,0,15,15,11,29,40,64,67,131,0.000333,0.232391,10,6971.725804,387.3181,697.17258,178.935197,1,0
0,0,22,22,16,40,56,95,100,195,0.000333,0.377478,16,18118.94736,1006.608186,1132.43421,276.877124,2,0
0,0,39,39,23,63,86,207,207,414,0.000333,0.886825,33,87795.62908,4877.534949,2660.473608,480.61056,3,0
0,0,31,31,22,57,79,147,143,290,0.000333,0.609365,22,40218.12117,2234.340065,1828.096417,430.582226,3,0
0,0,16,16,16,31,47,65,62,127,0.000333,0.235144,16,11286.92455,627.051364,705.432784,217.580086,2,0
0,0,17,17,15,16,31,59,36,95,0.000333,0.156883,14,6589.081093,366.060061,470.648649,122.603359,7,0
0,0,17,17,15,16,31,59,36,95,0.000333,0.156883,14,6589.081093,366.060061,470.648649,122.603359,7,0
0,0,11,11,11,13,24,28,26,54,0.000333,0.082529,10,2475.87975,137.548875,247.587975,86.159464,2,0
0,0,17,17,15,23,38,53,50,103,0.000333,0.180179,14,7567.511474,420.417304,540.536534,162.645284,7,0
0,0,10,10,16,18,34,45,42,87,0.000333,0.147536,16,7081.748275,393.43046,442.609267,139.05865,2,0
0,0,14,14,14,28,42,65,65,130,0.000333,0.233667,14,9814.017709,545.223206,701.001265,187.908907,2,0
0,0,22,22,19,51,70,110,114,224,0.000333,0.457653,18,24713.26912,1372.959396,1372.959396,370.004315,2,0
0,0,25,25,24,34,58,136,97,233,0.000333,0.45497,24,32757.82973,1819.879429,1364.909572,283.012837,16,0
0,0,13,13,11,29,40,61,60,121,0.000333,0.214651,10,6439.532995,357.751833,643.953299,178.935197,1,0
0,0,13,13,11,29,40,61,60,121,0.000333,0.214651,10,6439.532995,357.751833,643.953299,178.935197,1,0
0,0,20,20,17,40,57,92,93,185,0.000333,0.359695,16,17265.35444,959.186358,1079.084653,282.363992,2,0
0,0,37,37,22,63,85,204,200,404,0.000333,0.863131,33,85449.99996,4747.22222,2589.393938,474.676131,3,0
0,0,29,29,21,57,78,144,136,280,0.000333,0.586638,20,35198.25243,1955.458468,1759.912621,424.713397,3,0
0,0,22,22,17,33,50,92,81,173,0.000333,0.325462,16,15622.19393,867.899663,976.387121,235.951874,2,0
0,0,23,23,17,20,37,94,58,152,0.000333,0.263946,16,12669.39059,703.855033,791.836912,155.92543,7,0
0,0,23,23,17,20,37,93,58,151,0.000333,0.262209,16,12586.03933,699.224407,786.627458,155.92543,7,0
0,0,16,16,13,18,31,50,48,98,0.000333,0.161837,12,5826.134861,323.674159,485.511238,123.164366,2,0
0,0,22,22,15,28,43,72,67,139,0.000333,0.251417,14,10559.51121,586.639512,754.250801,193.209297,7,0
0,0,15,15,15,22,37,66,58,124,0.000333,0.215324,14,9043.611043,502.422836,645.972217,156.710855,2,0
0,0,18,18,16,32,48,86,80,166,0.000333,0.309035,16,14833.6604,824.092245,927.103775,224,2,0
0,0,27,27,20,54,74,129,134,263,0.000333,0.544362,20,32661.7247,1814.540261,1633.086235,397.202487,2,0
0,0,30,30,25,39,64,160,113,273,0.000333,0.546,24,39312,2184,1638,322.227091,16,0
0,0,18,18,13,32,45,77,77,154,0.000333,0.281915,12,10148.94452,563.830251,845.745377,208.105716,1,0
0,0,18,18,13,32,45,77,77,154,0.000333,0.281915,12,10148.94452,563.830251,845.745377,208.105716,1,0
0,0,25,25,18,43,61,108,110,218,0.000333,0.430967,18,23272.21331,1292.90074,1292.90074,308.388034,2,0
0,0,42,42,23,66,89,220,217,437,0.000333,0.943299,33,93386.55181,5188.141767,2829.895509,502.971937,3,0
0,0,34,34,22,60,82,160,153,313,0.000333,0.663305,22,43778.1031,2432.116839,1989.913777,452.520931,3,0
0,0,15,15,16,30,46,62,58,120,0.000333,0.220942,8,5302.619478,294.589971,662.827435,211.206718,2,0
0,0,21,21,19,50,69,106,111,217,0.000333,0.44185,18,23859.89653,1325.549807,1325.549807,362.903432,2,0
0,0,24,24,24,33,57,130,92,222,0.000333,0.431634,24,31077.638,1726.535444,1294.901583,276.504106,16,0
0,0,12,12,10,28,38,54,57,111,0.000333,0.194173,10,5825.19954,323.622197,582.519954,167.825219,1,0
0,0,12,12,10,28,38,54,57,111,0.000333,0.194173,10,5825.19954,323.622197,582.519954,167.825219,1,0
0,0,19,19,16,39,55,85,90,175,0.000333,0.337246,16,16187.8072,899.322622,1011.73795,270.130687,2,0
0,0,36,36,22,62,84,197,197,394,0.000333,0.839524,33,83112.91113,4617.383952,2518.573065,467.267667,3,0
0,0,28,28,21,56,77,137,133,270,0.000333,0.564011,20,33840.64732,1880.035962,1692.032366,417.450542,3,0
0,0,18,18,22,34,56,145,111,256,0.000333,0.495561,33,49060.53438,2725.585243,1486.68286,271.081232,22,0
0,0,25,25,18,31,49,114,80,194,0.000333,0.363085,18,19606.56678,1089.25371,1089.25371,228.638736,8,0
0,0,40,40,22,32,54,191,131,322,0.000333,0.617691,44,81535.24613,4529.735896,1853.073776,258.107496,13,0
0,0,52,52,29,59,88,268,213,481,0.000333,1.035662,42,130493.4376,7249.63542,3106.986609,487.957389,15,0
0,0,452,452,42,392,434,2804,1965,4769,0.000333,13.927946,105,4387302.972,243739.054,41783.83783,3603.443591,142,0
0,0,55,55,18,61,79,230,129,359,0.000333,0.754352,18,40735.0312,2263.057289,2263.057289,436.833628,19,0
0,0,22,22,20,23,43,80,58,138,0.000333,0.249608,20,14976.49072,832.027262,748.824536,190.480487,8,0
0,0,6,6,17,19,36,34,26,60,0.000333,0.103399,8,2481.564001,137.864667,310.1955,150.197491,2,0
0,0,64,64,27,63,90,245,184,429,0.000333,0.928335,26,72410.12944,4022.784969,2785.004978,504.950598,15,0
0,0,43,43,28,38,66,205,114,319,0.000333,0.642721,42,80982.79241,4499.044023,1928.161724,334.027183,14,0
0,0,3,3,4,6,10,8,8,16,0.000333,0.017717,2,106.301699,5.90565,53.15085,23.509775,1,0
0,0,6,6,13,13,26,33,22,55,0.000333,0.086175,6,1551.145107,86.174728,258.524184,96.211433,2,0
0,0,5,5,11,9,20,24,16,40,0.000333,0.057626,5,864.385619,48.021423,172.877124,66.583073,1,0
0,0,4,4,10,8,18,15,12,27,0.000333,0.037529,5,562.939875,31.274438,112.587975,57.219281,1,0
0,0,6,6,13,13,26,34,22,56,0.000333,0.087742,6,1579.347745,87.741541,263.224624,96.211433,2,0
0,0,4,4,13,9,22,27,16,43,0.000333,0.063919,6,1150.533358,63.91852,191.75556,76.635041,1,0
0,0,3,3,13,6,19,20,11,31,0.000333,0.043895,6,790.114518,43.895251,131.685753,63.615491,1,0
0,0,3,3,13,6,19,20,11,31,0.000333,0.043895,6,790.114518,43.895251,131.685753,63.615491,1,0
0,0,3,3,15,7,22,25,13,38,0.000333,0.056486,7,1186.208811,65.900489,169.458402,78.254843,1,0
0,0,4,4,13,9,22,27,16,43,0.000333,0.063919,6,1150.533358,63.91852,191.75556,76.635041,1,0
0,0,3,3,15,7,22,25,13,38,0.000333,0.056486,7,1186.208811,65.900489,169.458402,78.254843,1,0
0,0,3,3,13,6,19,20,11,31,0.000333,0.043895,6,790.114518,43.895251,131.685753,63.615491,1,0
0,0,7,7,13,8,21,45,28,73,0.000333,0.10688,18,5771.505094,320.639172,320.639172,72.105716,1,0
0,0,3,3,15,7,22,25,13,38,0.000333,0.056486,7,1186.208811,65.900489,169.458402,78.254843,1,0
0,0,3,3,13,6,19,20,11,31,0.000333,0.043895,6,790.114518,43.895251,131.685753,63.615491,1,0
0,0,2,2,8,6,14,17,9,26,0.000333,0.032997,4,395.964912,21.998051,98.991228,39.509775,1,0
0,0,2,2,8,6,14,17,9,26,0.000333,0.032997,4,395.964912,21.998051,98.991228,39.509775,1,0
0,0,2,2,8,6,14,17,9,26,0.000333,0.032997,4,395.964912,21.998051,98.991228,39.509775,1,0
0,0,2,2,8,6,14,17,9,26,0.000333,0.032997,4,395.964912,21.998051,98.991228,39.509775,1,0
0,0,2,2,8,6,14,17,9,26,0.000333,0.032997,4,395.964912,21.998051,98.991228,39.509775,1,0
0,0,2,2,8,6,14,17,9,26,0.000333,0.032997,4,395.964912,21.998051,98.991228,39.509775,1,0
0,0,2,2,8,6,14,17,9,26,0.000333,0.032997,4,395.964912,21.998051,98.991228,39.509775,1,0
0,0,2,2,8,6,14,17,9,26,0.000333,0.032997,4,395.964912,21.998051,98.991228,39.509775,1,0
0,0,2,2,8,6,14,17,9,26,0.000333,0.032997,4,395.964912,21.998051,98.991228,39.509775,1,0
0,0,2,2,8,6,14,17,9,26,0.000333,0.032997,4,395.964912,21.998051,98.991228,39.509775,1,0
0,0,2,2,8,6,14,17,9,26,0.000333,0.032997,4,395.964912,21.998051,98.991228,39.509775,1,0
0,0,2,2,8,6,14,17,9,26,0.000333,0.032997,4,395.964912,21.998051,98.991228,39.509775,1,0
0,0,2,2,9,5,14,11,7,18,0.000333,0.022844,4,274.129554,15.22942,68.532389,40.138965,1,0
0,0,2,2,9,5,14,11,7,18,0.000333,0.022844,4,274.129554,15.22942,68.532389,40.138965,1,0
0,0,2,2,9,5,14,11,7,18,0.000333,0.022844,4,274.129554,15.22942,68.532389,40.138965,1,0
0,0,2,2,9,5,14,11,7,18,0.000333,0.022844,4,274.129554,15.22942,68.532389,40.138965,1,0
0,0,2,2,9,5,14,11,7,18,0.000333,0.022844,4,274.129554,15.22942,68.532389,40.138965,1,0
0,0,2,2,9,5,14,11,7,18,0.000333,0.022844,4,274.129554,15.22942,68.532389,40.138965,1,0
0,0,2,2,9,5,14,11,7,18,0.000333,0.022844,4,274.129554,15.22942,68.532389,40.138965,1,0
0,0,2,2,9,5,14,11,7,18,0.000333,0.022844,4,274.129554,15.22942,68.532389,40.138965,1,0
0,0,2,2,9,5,14,11,7,18,0.000333,0.022844,4,274.129554,15.22942,68.532389,40.138965,1,0
0,0,2,2,9,5,14,11,7,18,0.000333,0.022844,4,274.129554,15.22942,68.532389,40.138965,1,0
0,0,2,2,9,5,14,11,7,18,0.000333,0.022844,4,274.129554,15.22942,68.532389,40.138965,1,0
0,0,2,2,9,5,14,11,7,18,0.000333,0.022844,4,274.129554,15.22942,68.532389,40.138965,1,0
0,0,2,2,9,5,14,11,7,18,0.000333,0.022844,4,274.129554,15.22942,68.532389,40.138965,1,0
0,0,2,2,9,5,14,11,7,18,0.000333,0.022844,4,274.129554,15.22942,68.532389,40.138965,1,0
0,0,2,2,9,5,14,11,7,18,0.000333,0.022844,4,274.129554,15.22942,68.532389,40.138965,1,0
0,0,2,2,9,5,14,11,7,18,0.000333,0.022844,4,274.129554,15.22942,68.532389,40.138965,1,0
0,0,2,2,9,5,14,11,7,18,0.000333,0.022844,4,274.129554,15.22942,68.532389,40.138965,1,0
0,0,2,2,9,5,14,11,7,18,0.000333,0.022844,4,274.129554,15.22942,68.532389,40.138965,1,0
0,0,2,2,9,5,14,11,7,18,0.000333,0.022844,4,274.129554,15.22942,68.532389,40.138965,1,0
0,0,2,2,9,5,14,11,7,18,0.000333,0.022844,4,274.129554,15.22942,68.532389,40.138965,1,0
0,0,2,2,9,5,14,11,7,18,0.000333,0.022844,4,274.129554,15.22942,68.532389,40.138965,1,0
0,0,2,2,9,5,14,11,7,18,0.000333,0.022844,4,274.129554,15.22942,68.532389,40.138965,1,0
0,0,2,2,9,5,14,11,7,18,0.000333,0.022844,4,274.129554,15.22942,68.532389,40.138965,1,0
0,0,2,2,9,5,14,11,7,18,0.000333,0.022844,4,274.129554,15.22942,68.532389,40.138965,1,0
0,0,2,2,9,5,14,11,7,18,0.000333,0.022844,4,274.129554,15.22942,68.532389,40.138965,1,0
0,0,2,2,9,5,14,11,7,18,0.000333,0.022844,4,274.129554,15.22942,68.532389,40.138965,1,0
0,0,2,2,9,5,14,11,7,18,0.000333,0.022844,4,274.129554,15.22942,68.532389,40.138965,1,0
0,0,2,2,9,5,14,11,7,18,0.000333,0.022844,4,274.129554,15.22942,68.532389,40.138965,1,0
0,0,2,2,9,5,14,11,7,18,0.000333,0.022844,4,274.129554,15.22942,68.532389,40.138965,1,0
0,0,2,2,9,5,14,11,7,18,0.000333,0.022844,4,274.129554,15.22942,68.532389,40.138965,1,0
0,0,2,2,9,5,14,11,7,18,0.000333,0.022844,4,274.129554,15.22942,68.532389,40.138965,1,0
0,0,2,2,9,5,14,11,7,18,0.000333,0.022844,4,274.129554,15.22942,68.532389,40.138965,1,0
0,0,2,2,9,5,14,11,7,18,0.000333,0.022844,4,274.129554,15.22942,68.532389,40.138965,1,0
0,0,2,2,9,5,14,11,7,18,0.000333,0.022844,4,274.129554,15.22942,68.532389,40.138965,1,0
0,0,2,2,9,5,14,11,7,18,0.000333,0.022844,4,274.129554,15.22942,68.532389,40.138965,1,0
0,0,2,2,9,5,14,11,7,18,0.000333,0.022844,4,274.129554,15.22942,68.532389,40.138965,1,0
0,0,2,2,9,5,14,11,7,18,0.000333,0.022844,4,274.129554,15.22942,68.532389,40.138965,1,0
0,0,2,2,9,5,14,11,7,18,0.000333,0.022844,4,274.129554,15.22942,68.532389,40.138965,1,0
0,0,2,2,9,5,14,11,7,18,0.000333,0.022844,4,274.129554,15.22942,68.532389,40.138965,1,0
0,0,2,2,9,5,14,11,7,18,0.000333,0.022844,4,274.129554,15.22942,68.532389,40.138965,1,0
0,0,2,2,9,5,14,11,7,18,0.000333,0.022844,4,274.129554,15.22942,68.532389,40.138965,1,0
0,0,2,2,9,5,14,11,7,18,0.000333,0.022844,4,274.129554,15.22942,68.532389,40.138965,1,0
0,0,2,2,9,5,14,11,7,18,0.000333,0.022844,4,274.129554,15.22942,68.532389,40.138965,1,0
0,0,2,2,9,5,14,11,7,18,0.000333,0.022844,4,274.129554,15.22942,68.532389,40.138965,1,0
0,0,2,2,9,5,14,11,7,18,0.000333,0.022844,4,274.129554,15.22942,68.532389,40.138965,1,0
0,0,2,2,9,5,14,11,7,18,0.000333,0.022844,4,274.129554,15.22942,68.532389,40.138965,1,0
0,0,2,2,9,5,14,11,7,18,0.000333,0.022844,4,274.129554,15.22942,68.532389,40.138965,1,0
0,0,2,2,9,5,14,11,7,18,0.000333,0.022844,4,274.129554,15.22942,68.532389,40.138965,1,0
0,0,2,2,9,5,14,11,7,18,0.000333,0.022844,4,274.129554,15.22942,68.532389,40.138965,1,0
0,0,2,2,9,5,14,11,7,18,0.000333,0.022844,4,274.129554,15.22942,68.532389,40.138965,1,0
0,0,2,2,9,5,14,11,7,18,0.000333,0.022844,4,274.129554,15.22942,68.532389,40.138965,1,0
0,0,2,2,9,5,14,11,7,18,0.000333,0.022844,4,274.129554,15.22942,68.532389,40.138965,1,0
0,0,2,2,9,5,14,11,7,18,0.000333,0.022844,4,274.129554,15.22942,68.532389,40.138965,1,0
0,0,2,2,9,5,14,11,7,18,0.000333,0.022844,4,274.129554,15.22942,68.532389,40.138965,1,0
0,0,2,2,9,5,14,11,7,18,0.000333,0.022844,4,274.129554,15.22942,68.532389,40.138965,1,0
0,0,2,2,9,5,14,11,7,18,0.000333,0.022844,4,274.129554,15.22942,68.532389,40.138965,1,0
0,0,2,2,9,5,14,11,7,18,0.000333,0.022844,4,274.129554,15.22942,68.532389,40.138965,1,0
0,0,2,2,9,5,14,11,7,18,0.000333,0.022844,4,274.129554,15.22942,68.532389,40.138965,1,0
0,0,2,2,9,5,14,11,7,18,0.000333,0.022844,4,274.129554,15.22942,68.532389,40.138965,1,0
0,0,2,2,9,5,14,11,7,18,0.000333,0.022844,4,274.129554,15.22942,68.532389,40.138965,1,0
0,0,2,2,9,5,14,11,7,18,0.000333,0.022844,4,274.129554,15.22942,68.532389,40.138965,1,0
0,0,2,2,9,5,14,11,7,18,0.000333,0.022844,4,274.129554,15.22942,68.532389,40.138965,1,0
0,0,2,2,9,5,14,11,7,18,0.000333,0.022844,4,274.129554,15.22942,68.532389,40.138965,1,0
0,0,2,2,9,5,14,11,7,18,0.000333,0.022844,4,274.129554,15.22942,68.532389,40.138965,1,0
0,0,2,2,9,5,14,11,7,18,0.000333,0.022844,4,274.129554,15.22942,68.532389,40.138965,1,0
0,0,2,2,9,5,14,11,7,18,0.000333,0.022844,4,274.129554,15.22942,68.532389,40.138965,1,0
0,0,2,2,9,5,14,11,7,18,0.000333,0.022844,4,274.129554,15.22942,68.532389,40.138965,1,0
0,0,2,2,9,5,14,11,7,18,0.000333,0.022844,4,274.129554,15.22942,68.532389,40.138965,1,0
0,0,2,2,9,5,14,11,7,18,0.000333,0.022844,4,274.129554,15.22942,68.532389,40.138965,1,0
0,0,2,2,9,5,14,11,7,18,0.000333,0.022844,4,274.129554,15.22942,68.532389,40.138965,1,0
0,0,2,2,9,5,14,11,7,18,0.000333,0.022844,4,274.129554,15.22942,68.532389,40.138965,1,0
0,0,2,2,9,5,14,11,7,18,0.000333,0.022844,4,274.129554,15.22942,68.532389,40.138965,1,0
0,0,2,2,9,5,14,11,7,18,0.000333,0.022844,4,274.129554,15.22942,68.532389,40.138965,1,0
0,0,2,2,9,5,14,11,7,18,0.000333,0.022844,4,274.129554,15.22942,68.532389,40.138965,1,0
0,0,2,2,9,5,14,11,7,18,0.000333,0.022844,4,274.129554,15.22942,68.532389,40.138965,1,0
0,0,2,2,9,5,14,11,7,18,0.000333,0.022844,4,274.129554,15.22942,68.532389,40.138965,1,0
0,0,2,2,9,5,14,11,7,18,0.000333,0.022844,4,274.129554,15.22942,68.532389,40.138965,1,0
0,0,2,2,9,5,14,11,7,18,0.000333,0.022844,4,274.129554,15.22942,68.532389,40.138965,1,0
0,0,2,2,9,5,14,11,7,18,0.000333,0.022844,4,274.129554,15.22942,68.532389,40.138965,1,0
0,0,2,2,9,5,14,11,7,18,0.000333,0.022844,4,274.129554,15.22942,68.532389,40.138965,1,0
0,0,2,2,9,5,14,11,7,18,0.000333,0.022844,4,274.129554,15.22942,68.532389,40.138965,1,0
0,0,2,2,9,5,14,11,7,18,0.000333,0.022844,4,274.129554,15.22942,68.532389,40.138965,1,0
0,0,2,2,9,5,14,11,7,18,0.000333,0.022844,4,274.129554,15.22942,68.532389,40.138965,1,0
0,0,2,2,9,5,14,11,7,18,0.000333,0.022844,4,274.129554,15.22942,68.532389,40.138965,1,0
0,0,2,2,9,5,14,11,7,18,0.000333,0.022844,4,274.129554,15.22942,68.532389,40.138965,1,0
0,0,2,2,9,5,14,11,7,18,0.000333,0.022844,4,274.129554,15.22942,68.532389,40.138965,1,0
0,0,2,2,9,5,14,11,7,18,0.000333,0.022844,4,274.129554,15.22942,68.532389,40.138965,1,0
0,0,2,2,9,5,14,11,7,18,0.000333,0.022844,4,274.129554,15.22942,68.532389,40.138965,1,0
0,0,2,2,9,5,14,11,7,18,0.000333,0.022844,4,274.129554,15.22942,68.532389,40.138965,1,0
0,0,2,2,9,5,14,11,7,18,0.000333,0.022844,4,274.129554,15.22942,68.532389,40.138965,1,0
0,0,2,2,9,5,14,11,7,18,0.000333,0.022844,4,274.129554,15.22942,68.532389,40.138965,1,0
0,0,2,2,9,5,14,11,7,18,0.000333,0.022844,4,274.129554,15.22942,68.532389,40.138965,1,0
0,0,2,2,9,5,14,11,7,18,0.000333,0.022844,4,274.129554,15.22942,68.532389,40.138965,1,0
0,0,2,2,9,5,14,11,7,18,0.000333,0.022844,4,274.129554,15.22942,68.532389,40.138965,1,0
0,0,2,2,9,5,14,11,7,18,0.000333,0.022844,4,274.129554,15.22942,68.532389,40.138965,1,0
0,0,2,2,9,5,14,11,7,18,0.000333,0.022844,4,274.129554,15.22942,68.532389,40.138965,1,0
0,0,2,2,9,5,14,11,7,18,0.000333,0.022844,4,274.129554,15.22942,68.532389,40.138965,1,0
0,0,2,2,9,5,14,11,7,18,0.000333,0.022844,4,274.129554,15.22942,68.532389,40.138965,1,0
0,0,2,2,9,5,14,11,7,18,0.000333,0.022844,4,274.129554,15.22942,68.532389,40.138965,1,0
0,0,2,2,9,5,14,11,7,18,0.000333,0.022844,4,274.129554,15.22942,68.532389,40.138965,1,0
0,0,2,2,9,5,14,11,7,18,0.000333,0.022844,4,274.129554,15.22942,68.532389,40.138965,1,0
0,0,2,2,9,5,14,11,7,18,0.000333,0.022844,4,274.129554,15.22942,68.532389,40.138965,1,0
0,0,2,2,9,5,14,11,7,18,0.000333,0.022844,4,274.129554,15.22942,68.532389,40.138965,1,0
0,0,2,2,9,5,14,11,7,18,0.000333,0.022844,4,274.129554,15.22942,68.532389,40.138965,1,0
0,0,2,2,9,5,14,11,7,18,0.000333,0.022844,4,274.129554,15.22942,68.532389,40.138965,1,0
0,0,2,2,9,5,14,11,7,18,0.000333,0.022844,4,274.129554,15.22942,68.532389,40.138965,1,0
0,0,2,2,9,5,14,11,7,18,0.000333,0.022844,4,274.129554,15.22942,68.532389,40.138965,1,0
0,0,2,2,9,5,14,11,7,18,0.000333,0.022844,4,274.129554,15.22942,68.532389,40.138965,1,0
0,0,2,2,9,5,14,11,7,18,0.000333,0.022844,4,274.129554,15.22942,68.532389,40.138965,1,0
0,0,2,2,9,5,14,11,7,18,0.000333,0.022844,4,274.129554,15.22942,68.532389,40.138965,1,0
0,0,2,2,9,5,14,11,7,18,0.000333,0.022844,4,274.129554,15.22942,68.532389,40.138965,1,0
0,0,2,2,9,5,14,11,7,18,0.000333,0.022844,4,274.129554,15.22942,68.532389,40.138965,1,0
0,0,2,2,9,5,14,11,7,18,0.000333,0.022844,4,274.129554,15.22942,68.532389,40.138965,1,0
0,0,2,2,9,5,14,11,7,18,0.000333,0.022844,4,274.129554,15.22942,68.532389,40.138965,1,0
0,0,2,2,9,5,14,11,7,18,0.000333,0.022844,4,274.129554,15.22942,68.532389,40.138965,1,0
0,0,2,2,9,5,14,11,7,18,0.000333,0.022844,4,274.129554,15.22942,68.532389,40.138965,1,0
0,0,2,2,9,5,14,11,7,18,0.000333,0.022844,4,274.129554,15.22942,68.532389,40.138965,1,0
0,0,2,2,9,5,14,11,7,18,0.000333,0.022844,4,274.129554,15.22942,68.532389,40.138965,1,0
0,0,2,2,9,5,14,11,7,18,0.000333,0.022844,4,274.129554,15.22942,68.532389,40.138965,1,0
0,0,2,2,9,5,14,11,7,18,0.000333,0.022844,4,274.129554,15.22942,68.532389,40.138965,1,0
0,0,2,2,9,5,14,11,7,18,0.000333,0.022844,4,274.129554,15.22942,68.532389,40.138965,1,0
0,0,2,2,9,5,14,11,7,18,0.000333,0.022844,4,274.129554,15.22942,68.532389,40.138965,1,0
0,0,2,2,9,5,14,11,7,18,0.000333,0.022844,4,274.129554,15.22942,68.532389,40.138965,1,0
0,0,2,2,9,5,14,11,7,18,0.000333,0.022844,4,274.129554,15.22942,68.532389,40.138965,1,0
0,0,2,2,9,5,14,11,7,18,0.000333,0.022844,4,274.129554,15.22942,68.532389,40.138965,1,0
0,0,2,2,9,5,14,11,7,18,0.000333,0.022844,4,274.129554,15.22942,68.532389,40.138965,1,0
0,0,2,2,9,5,14,11,7,18,0.000333,0.022844,4,274.129554,15.22942,68.532389,40.138965,1,0
0,0,2,2,9,5,14,11,7,18,0.000333,0.022844,4,274.129554,15.22942,68.532389,40.138965,1,0
0,0,2,2,9,5,14,11,7,18,0.000333,0.022844,4,274.129554,15.22942,68.532389,40.138965,1,0
0,0,2,2,9,5,14,11,7,18,0.000333,0.022844,4,274.129554,15.22942,68.532389,40.138965,1,0
0,0,2,2,9,5,14,11,7,18,0.000333,0.022844,4,274.129554,15.22942,68.532389,40.138965,1,0
0,0,2,2,9,5,14,11,7,18,0.000333,0.022844,4,274.129554,15.22942,68.532389,40.138965,1,0
0,0,2,2,9,5,14,11,7,18,0.000333,0.022844,4,274.129554,15.22942,68.532389,40.138965,1,0
0,0,2,2,9,5,14,11,7,18,0.000333,0.022844,4,274.129554,15.22942,68.532389,40.138965,1,0
0,0,2,2,9,5,14,11,7,18,0.000333,0.022844,4,274.129554,15.22942,68.532389,40.138965,1,0
0,0,2,2,9,5,14,11,7,18,0.000333,0.022844,4,274.129554,15.22942,68.532389,40.138965,1,0
0,0,2,2,9,5,14,11,7,18,0.000333,0.022844,4,274.129554,15.22942,68.532389,40.138965,1,0
0,0,2,2,9,5,14,11,7,18,0.000333,0.022844,4,274.129554,15.22942,68.532389,40.138965,1,0
0,0,2,2,9,5,14,11,7,18,0.000333,0.022844,4,274.129554,15.22942,68.532389,40.138965,1,0
0,0,2,2,9,5,14,11,7,18,0.000333,0.022844,4,274.129554,15.22942,68.532389,40.138965,1,0
0,0,2,2,9,5,14,11,7,18,0.000333,0.022844,4,274.129554,15.22942,68.532389,40.138965,1,0
0,0,2,2,9,5,14,11,7,18,0.000333,0.022844,4,274.129554,15.22942,68.532389,40.138965,1,0
0,0,2,2,9,5,14,11,7,18,0.000333,0.022844,4,274.129554,15.22942,68.532389,40.138965,1,0
0,0,2,2,9,5,14,11,7,18,0.000333,0.022844,4,274.129554,15.22942,68.532389,40.138965,1,0
0,0,2,2,9,5,14,11,7,18,0.000333,0.022844,4,274.129554,15.22942,68.532389,40.138965,1,0
0,0,2,2,9,5,14,11,7,18,0.000333,0.022844,4,274.129554,15.22942,68.532389,40.138965,1,0
0,0,2,2,9,5,14,11,7,18,0.000333,0.022844,4,274.129554,15.22942,68.532389,40.138965,1,0
0,0,2,2,9,5,14,11,7,18,0.000333,0.022844,4,274.129554,15.22942,68.532389,40.138965,1,0
0,0,2,2,9,5,14,11,7,18,0.000333,0.022844,4,274.129554,15.22942,68.532389,40.138965,1,0
0,0,2,2,9,5,14,11,7,18,0.000333,0.022844,4,274.129554,15.22942,68.532389,40.138965,1,0
0,0,2,2,9,5,14,11,7,18,0.000333,0.022844,4,274.129554,15.22942,68.532389,40.138965,1,0
0,0,2,2,9,5,14,11,7,18,0.000333,0.022844,4,274.129554,15.22942,68.532389,40.138965,1,0
0,0,2,2,9,5,14,11,7,18,0.000333,0.022844,4,274.129554,15.22942,68.532389,40.138965,1,0
0,0,2,2,9,5,14,11,7,18,0.000333,0.022844,4,274.129554,15.22942,68.532389,40.138965,1,0
0,0,2,2,9,5,14,11,7,18,0.000333,0.022844,4,274.129554,15.22942,68.532389,40.138965,1,0
0,0,2,2,9,5,14,11,7,18,0.000333,0.022844,4,274.129554,15.22942,68.532389,40.138965,1,0
0,0,2,2,9,5,14,11,7,18,0.000333,0.022844,4,274.129554,15.22942,68.532389,40.138965,1,0
0,0,2,2,9,5,14,11,7,18,0.000333,0.022844,4,274.129554,15.22942,68.532389,40.138965,1,0
0,0,2,2,9,5,14,11,7,18,0.000333,0.022844,4,274.129554,15.22942,68.532389,40.138965,1,0
0,0,2,2,9,5,14,11,7,18,0.000333,0.022844,4,274.129554,15.22942,68.532389,40.138965,1,0
0,0,2,2,9,5,14,11,7,18,0.000333,0.022844,4,274.129554,15.22942,68.532389,40.138965,1,0
0,0,2,2,9,5,14,11,7,18,0.000333,0.022844,4,274.129554,15.22942,68.532389,40.138965,1,0
0,0,2,2,9,5,14,11,7,18,0.000333,0.022844,4,274.129554,15.22942,68.532389,40.138965,1,0
0,0,2,2,9,5,14,11,7,18,0.000333,0.022844,4,274.129554,15.22942,68.532389,40.138965,1,0
0,0,2,2,9,5,14,11,7,18,0.000333,0.022844,4,274.129554,15.22942,68.532389,40.138965,1,0
0,0,2,2,9,5,14,11,7,18,0.000333,0.022844,4,274.129554,15.22942,68.532389,40.138965,1,0
0,0,2,2,9,5,14,11,7,18,0.000333,0.022844,4,274.129554,15.22942,68.532389,40.138965,1,0
0,0,2,2,9,5,14,11,7,18,0.000333,0.022844,4,274.129554,15.22942,68.532389,40.138965,1,0
0,0,2,2,9,5,14,11,7,18,0.000333,0.022844,4,274.129554,15.22942,68.532389,40.138965,1,0
0,0,2,2,9,5,14,11,7,18,0.000333,0.022844,4,274.129554,15.22942,68.532389,40.138965,1,0
0,0,2,2,9,5,14,11,7,18,0.000333,0.022844,4,274.129554,15.22942,68.532389,40.138965,1,0
0,0,2,2,9,5,14,11,7,18,0.000333,0.022844,4,274.129554,15.22942,68.532389,40.138965,1,0
0,0,2,2,9,5,14,11,7,18,0.000333,0.022844,4,274.129554,15.22942,68.532389,40.138965,1,0
0,0,2,2,9,5,14,11,7,18,0.000333,0.022844,4,274.129554,15.22942,68.532389,40.138965,1,0
0,0,2,2,9,5,14,11,7,18,0.000333,0.022844,4,274.129554,15.22942,68.532389,40.138965,1,0
0,0,2,2,9,5,14,11,7,18,0.000333,0.022844,4,274.129554,15.22942,68.532389,40.138965,1,0
0,0,2,2,9,5,14,11,7,18,0.000333,0.022844,4,274.129554,15.22942,68.532389,40.138965,1,0
0,0,2,2,9,5,14,11,7,18,0.000333,0.022844,4,274.129554,15.22942,68.532389,40.138965,1,0
0,0,2,2,9,5,14,11,7,18,0.000333,0.022844,4,274.129554,15.22942,68.532389,40.138965,1,0
0,0,2,2,9,5,14,11,7,18,0.000333,0.022844,4,274.129554,15.22942,68.532389,40.138965,1,0
0,0,2,2,9,5,14,11,7,18,0.000333,0.022844,4,274.129554,15.22942,68.532389,40.138965,1,0
0,0,2,2,9,5,14,11,7,18,0.000333,0.022844,4,274.129554,15.22942,68.532389,40.138965,1,0
0,0,2,2,9,5,14,11,7,18,0.000333,0.022844,4,274.129554,15.22942,68.532389,40.138965,1,0
0,0,2,2,9,5,14,11,7,18,0.000333,0.022844,4,274.129554,15.22942,68.532389,40.138965,1,0
0,0,2,2,9,5,14,11,7,18,0.000333,0.022844,4,274.129554,15.22942,68.532389,40.138965,1,0
0,0,2,2,9,5,14,11,7,18,0.000333,0.022844,4,274.129554,15.22942,68.532389,40.138965,1,0
0,0,2,2,9,5,14,11,7,18,0.000333,0.022844,4,274.129554,15.22942,68.532389,40.138965,1,0
0,0,2,2,9,5,14,11,7,18,0.000333,0.022844,4,274.129554,15.22942,68.532389,40.138965,1,0
0,0,2,2,9,5,14,11,7,18,0.000333,0.022844,4,274.129554,15.22942,68.532389,40.138965,1,0
0,0,2,2,9,5,14,11,7,18,0.000333,0.022844,4,274.129554,15.22942,68.532389,40.138965,1,0
0,0,8,8,11,20,31,55,33,88,0.000333,0.145323,5,2179.846377,121.102576,435.969275,124.49231,2,0
0,0,8,8,11,20,31,55,33,88,0.000333,0.145323,5,2179.846377,121.102576,435.969275,124.49231,2,0
0,0,8,8,11,20,31,55,33,88,0.000333,0.145323,5,2179.846377,121.102576,435.969275,124.49231,2,0
0,0,8,8,11,20,31,55,33,88,0.000333,0.145323,5,2179.846377,121.102576,435.969275,124.49231,2,0
0,0,8,8,11,20,31,55,33,88,0.000333,0.145323,5,2179.846377,121.102576,435.969275,124.49231,2,0
0,0,8,8,11,20,31,55,33,88,0.000333,0.145323,5,2179.846377,121.102576,435.969275,124.49231,2,0
0,0,1,1,5,5,10,8,5,13,0.000333,0.014395,2,86.37013,4.798341,43.185065,23.219281,2,0
0,0,3,3,10,8,18,15,10,25,0.000333,0.034749,5,521.240625,28.957813,104.248125,57.219281,2,0
0,0,1,1,5,5,10,8,5,13,0.000333,0.014395,2,86.37013,4.798341,43.185065,23.219281,2,0
0,0,6,6,12,11,23,30,21,51,0.000333,0.076901,6,1384.209959,76.900553,230.70166,81.073298,3,0
0,0,1,1,5,5,10,8,5,13,0.000333,0.014395,2,86.37013,4.798341,43.185065,23.219281,2,0
0,0,3,3,10,10,20,15,12,27,0.000333,0.038897,5,583.460293,32.414461,116.692059,66.438562,2,0
0,0,1,1,5,5,10,8,5,13,0.000333,0.014395,2,86.37013,4.798341,43.185065,23.219281,2,0
0,0,3,3,10,8,18,15,10,25,0.000333,0.034749,5,521.240625,28.957813,104.248125,57.219281,2,0
0,0,1,1,5,5,10,8,5,13,0.000333,0.014395,2,86.37013,4.798341,43.185065,23.219281,2,0
0,0,3,3,10,8,18,15,10,25,0.000333,0.034749,5,521.240625,28.957813,104.248125,57.219281,2,0
0,0,1,1,5,5,10,8,5,13,0.000333,0.014395,2,86.37013,4.798341,43.185065,23.219281,2,0
0,0,3,3,10,8,18,15,10,25,0.000333,0.034749,5,521.240625,28.957813,104.248125,57.219281,2,0
0,0,8,8,11,19,30,53,32,85,0.000333,0.139029,5,2085.428503,115.857139,417.085701,118.764371,2,0
0,0,8,8,11,19,30,53,32,85,0.000333,0.139029,5,2085.428503,115.857139,417.085701,118.764371,2,0
0,0,8,8,11,19,30,53,32,85,0.000333,0.139029,5,2085.428503,115.857139,417.085701,118.764371,2,0
0,0,8,8,11,19,30,53,32,85,0.000333,0.139029,5,2085.428503,115.857139,417.085701,118.764371,2,0
0,0,8,8,11,19,30,53,32,85,0.000333,0.139029,5,2085.428503,115.857139,417.085701,118.764371,2,0
0,0,8,8,11,19,30,53,32,85,0.000333,0.139029,5,2085.428503,115.857139,417.085701,118.764371,2,0
0,0,8,8,11,20,31,55,33,88,0.000333,0.145323,5,2179.846377,121.102576,435.969275,124.49231,2,0
0,0,8,8,11,20,31,55,33,88,0.000333,0.145323,5,2179.846377,121.102576,435.969275,124.49231,2,0
0,0,8,8,11,20,31,55,33,88,0.000333,0.145323,5,2179.846377,121.102576,435.969275,124.49231,2,0
0,0,8,8,11,20,31,55,33,88,0.000333,0.145323,5,2179.846377,121.102576,435.969275,124.49231,2,0
0,0,8,8,11,20,31,55,33,88,0.000333,0.145323,5,2179.846377,121.102576,435.969275,124.49231,2,0
0,0,8,8,11,20,31,55,33,88,0.000333,0.145323,5,2179.846377,121.102576,435.969275,124.49231,2,0
0,0,8,8,11,20,31,55,33,88,0.000333,0.145323,5,2179.846377,121.102576,435.969275,124.49231,2,0
0,0,8,8,11,20,31,55,33,88,0.000333,0.145323,5,2179.846377,121.102576,435.969275,124.49231,2,0
0,0,8,8,11,20,31,55,33,88,0.000333,0.145323,5,2179.846377,121.102576,435.969275,124.49231,2,0
0,0,8,8,11,20,31,55,33,88,0.000333,0.145323,5,2179.846377,121.102576,435.969275,124.49231,2,0
0,0,8,8,11,20,31,55,33,88,0.000333,0.145323,5,2179.846377,121.102576,435.969275,124.49231,2,0
0,0,8,8,11,20,31,55,33,88,0.000333,0.145323,5,2179.846377,121.102576,435.969275,124.49231,2,0
0,0,8,8,11,20,31,55,33,88,0.000333,0.145323,5,2179.846377,121.102576,435.969275,124.49231,2,0
0,0,8,8,11,20,31,55,33,88,0.000333,0.145323,5,2179.846377,121.102576,435.969275,124.49231,2,0
0,0,8,8,11,20,31,55,33,88,0.000333,0.145323,5,2179.846377,121.102576,435.969275,124.49231,2,0
0,0,8,8,11,20,31,55,33,88,0.000333,0.145323,5,2179.846377,121.102576,435.969275,124.49231,2,0
0,0,8,8,11,20,31,55,33,88,0.000333,0.145323,5,2179.846377,121.102576,435.969275,124.49231,2,0
0,0,8,8,11,20,31,55,33,88,0.000333,0.145323,5,2179.846377,121.102576,435.969275,124.49231,2,0
0,0,8,8,11,20,31,55,33,88,0.000333,0.145323,5,2179.846377,121.102576,435.969275,124.49231,2,0
0,0,8,8,11,20,31,55,33,88,0.000333,0.145323,5,2179.846377,121.102576,435.969275,124.49231,2,0
0,0,8,8,11,20,31,55,33,88,0.000333,0.145323,5,2179.846377,121.102576,435.969275,124.49231,2,0
0,0,8,8,11,20,31,55,33,88,0.000333,0.145323,5,2179.846377,121.102576,435.969275,124.49231,2,0
0,0,8,8,11,20,31,55,33,88,0.000333,0.145323,5,2179.846377,121.102576,435.969275,124.49231,2,0
0,0,8,8,11,20,31,55,33,88,0.000333,0.145323,5,2179.846377,121.102576,435.969275,124.49231,2,0
0,0,8,8,11,20,31,55,33,88,0.000333,0.145323,5,2179.846377,121.102576,435.969275,124.49231,2,0
0,0,8,8,11,20,31,55,33,88,0.000333,0.145323,5,2179.846377,121.102576,435.969275,124.49231,2,0
0,0,8,8,11,20,31,55,33,88,0.000333,0.145323,5,2179.846377,121.102576,435.969275,124.49231,2,0
0,0,8,8,11,20,31,55,33,88,0.000333,0.145323,5,2179.846377,121.102576,435.969275,124.49231,2,0
0,0,8,8,11,20,31,55,33,88,0.000333,0.145323,5,2179.846377,121.102576,435.969275,124.49231,2,0
0,0,8,8,11,20,31,55,33,88,0.000333,0.145323,5,2179.846377,121.102576,435.969275,124.49231,2,0
0,0,8,8,11,20,31,55,33,88,0.000333,0.145323,5,2179.846377,121.102576,435.969275,124.49231,2,0
0,0,8,8,11,20,31,55,33,88,0.000333,0.145323,5,2179.846377,121.102576,435.969275,124.49231,2,0
0,0,8,8,11,20,31,55,33,88,0.000333,0.145323,5,2179.846377,121.102576,435.969275,124.49231,2,0
0,0,8,8,11,20,31,55,33,88,0.000333,0.145323,5,2179.846377,121.102576,435.969275,124.49231,2,0
0,0,8,8,11,20,31,55,33,88,0.000333,0.145323,5,2179.846377,121.102576,435.969275,124.49231,2,0
0,0,8,8,11,20,31,55,33,88,0.000333,0.145323,5,2179.846377,121.102576,435.969275,124.49231,2,0
0,0,8,8,11,20,31,55,33,88,0.000333,0.145323,5,2179.846377,121.102576,435.969275,124.49231,2,0
0,0,8,8,11,20,31,55,33,88,0.000333,0.145323,5,2179.846377,121.102576,435.969275,124.49231,2,0
0,0,8,8,11,20,31,55,33,88,0.000333,0.145323,5,2179.846377,121.102576,435.969275,124.49231,2,0
0,0,8,8,11,20,31,55,33,88,0.000333,0.145323,5,2179.846377,121.102576,435.969275,124.49231,2,0
0,0,8,8,11,20,31,55,33,88,0.000333,0.145323,5,2179.846377,121.102576,435.969275,124.49231,2,0
0,0,8,8,11,20,31,55,33,88,0.000333,0.145323,5,2179.846377,121.102576,435.969275,124.49231,2,0
0,0,8,8,11,20,31,55,33,88,0.000333,0.145323,5,2179.846377,121.102576,435.969275,124.49231,2,0
0,0,8,8,11,20,31,55,33,88,0.000333,0.145323,5,2179.846377,121.102576,435.969275,124.49231,2,0
0,0,1,1,5,5,10,8,5,13,0.000333,0.014395,2,86.37013,4.798341,43.185065,23.219281,2,0
0,0,3,3,10,8,18,15,10,25,0.000333,0.034749,5,521.240625,28.957813,104.248125,57.219281,2,0
0,0,1,1,5,5,10,8,5,13,0.000333,0.014395,2,86.37013,4.798341,43.185065,23.219281,2,0
0,0,3,3,10,8,18,15,10,25,0.000333,0.034749,5,521.240625,28.957813,104.248125,57.219281,2,0
0,0,1,1,5,5,10,8,5,13,0.000333,0.014395,2,86.37013,4.798341,43.185065,23.219281,2,0
0,0,3,3,10,8,18,15,10,25,0.000333,0.034749,5,521.240625,28.957813,104.248125,57.219281,2,0
0,0,1,1,5,5,10,8,5,13,0.000333,0.014395,2,86.37013,4.798341,43.185065,23.219281,2,0
0,0,3,3,10,8,18,15,10,25,0.000333,0.034749,5,521.240625,28.957813,104.248125,57.219281,2,0
0,0,1,1,5,5,10,8,5,13,0.000333,0.014395,2,86.37013,4.798341,43.185065,23.219281,2,0
0,0,3,3,10,8,18,15,10,25,0.000333,0.034749,5,521.240625,28.957813,104.248125,57.219281,2,0
0,0,1,1,5,5,10,8,5,13,0.000333,0.014395,2,86.37013,4.798341,43.185065,23.219281,2,0
0,0,3,3,10,8,18,15,10,25,0.000333,0.034749,5,521.240625,28.957813,104.248125,57.219281,2,0
0,0,1,1,5,5,10,8,5,13,0.000333,0.014395,2,86.37013,4.798341,43.185065,23.219281,2,0
0,0,3,3,10,8,18,15,10,25,0.000333,0.034749,5,521.240625,28.957813,104.248125,57.219281,2,0
0,0,1,1,5,5,10,8,5,13,0.000333,0.014395,2,86.37013,4.798341,43.185065,23.219281,2,0
0,0,3,3,10,8,18,15,10,25,0.000333,0.034749,5,521.240625,28.957813,104.248125,57.219281,2,0
0,0,1,1,5,5,10,8,5,13,0.000333,0.014395,2,86.37013,4.798341,43.185065,23.219281,2,0
0,0,3,3,10,8,18,15,10,25,0.000333,0.034749,5,521.240625,28.957813,104.248125,57.219281,2,0
0,0,1,1,5,5,10,8,5,13,0.000333,0.014395,2,86.37013,4.798341,43.185065,23.219281,2,0
0,0,3,3,10,8,18,15,10,25,0.000333,0.034749,5,521.240625,28.957813,104.248125,57.219281,2,0
0,0,1,1,5,5,10,8,5,13,0.000333,0.014395,2,86.37013,4.798341,43.185065,23.219281,2,0
0,0,3,3,10,8,18,15,10,25,0.000333,0.034749,5,521.240625,28.957813,104.248125,57.219281,2,0
0,0,1,1,5,5,10,8,5,13,0.000333,0.014395,2,86.37013,4.798341,43.185065,23.219281,2,0
0,0,3,3,10,8,18,15,10,25,0.000333,0.034749,5,521.240625,28.957813,104.248125,57.219281,2,0
0,0,1,1,5,5,10,8,5,13,0.000333,0.014395,2,86.37013,4.798341,43.185065,23.219281,2,0
0,0,3,3,10,8,18,15,10,25,0.000333,0.034749,5,521.240625,28.957813,104.248125,57.219281,2,0
0,0,1,1,5,5,10,8,5,13,0.000333,0.014395,2,86.37013,4.798341,43.185065,23.219281,2,0
0,0,3,3,10,8,18,15,10,25,0.000333,0.034749,5,521.240625,28.957813,104.248125,57.219281,2,0
0,0,1,1,5,5,10,8,5,13,0.000333,0.014395,2,86.37013,4.798341,43.185065,23.219281,2,0
0,0,3,3,10,8,18,15,10,25,0.000333,0.034749,5,521.240625,28.957813,104.248125,57.219281,2,0
0,0,1,1,5,5,10,8,5,13,0.000333,0.014395,2,86.37013,4.798341,43.185065,23.219281,2,0
0,0,4,4,10,9,19,19,13,32,0.000333,0.045311,5,679.668402,37.759356,135.93368,61.748606,2,0
0,0,1,1,5,5,10,8,5,13,0.000333,0.014395,2,86.37013,4.798341,43.185065,23.219281,2,0
0,0,4,4,10,9,19,19,13,32,0.000333,0.045311,5,679.668402,37.759356,135.93368,61.748606,2,0
0,0,1,1,5,5,10,8,5,13,0.000333,0.014395,2,86.37013,4.798341,43.185065,23.219281,2,0
0,0,3,3,10,8,18,15,10,25,0.000333,0.034749,5,521.240625,28.957813,104.248125,57.219281,2,0
0,0,1,1,5,5,10,8,5,13,0.000333,0.014395,2,86.37013,4.798341,43.185065,23.219281,2,0
0,0,5,5,11,10,21,22,17,39,0.000333,0.0571,5,856.501897,47.583439,171.300379,71.273029,2,0
0,0,1,1,5,5,10,8,5,13,0.000333,0.014395,2,86.37013,4.798341,43.185065,23.219281,2,0
0,0,3,3,9,9,18,14,12,26,0.000333,0.036139,4,433.6722,24.0929,108.41805,57.05865,2,0
0,0,1,1,5,5,10,8,5,13,0.000333,0.014395,2,86.37013,4.798341,43.185065,23.219281,2,0
0,0,3,3,10,8,18,15,10,25,0.000333,0.034749,5,521.240625,28.957813,104.248125,57.219281,2,0
0,0,1,1,5,5,10,8,5,13,0.000333,0.014395,2,86.37013,4.798341,43.185065,23.219281,2,0
0,0,3,3,10,8,18,15,10,25,0.000333,0.034749,5,521.240625,28.957813,104.248125,57.219281,2,0
0,0,1,1,5,5,10,8,5,13,0.000333,0.014395,2,86.37013,4.798341,43.185065,23.219281,2,0
0,0,3,3,10,8,18,15,10,25,0.000333,0.034749,5,521.240625,28.957813,104.248125,57.219281,2,0
0,0,1,1,5,5,10,8,5,13,0.000333,0.014395,2,86.37013,4.798341,43.185065,23.219281,2,0
0,0,3,3,10,8,18,15,10,25,0.000333,0.034749,5,521.240625,28.957813,104.248125,57.219281,2,0
0,0,1,1,5,5,10,8,5,13,0.000333,0.014395,2,86.37013,4.798341,43.185065,23.219281,2,0
0,0,3,3,10,8,18,15,10,25,0.000333,0.034749,5,521.240625,28.957813,104.248125,57.219281,2,0
0,0,1,1,5,5,10,8,5,13,0.000333,0.014395,2,86.37013,4.798341,43.185065,23.219281,2,0
0,0,5,5,11,10,21,22,17,39,0.000333,0.0571,5,856.501897,47.583439,171.300379,71.273029,2,0
0,0,1,1,5,5,10,8,5,13,0.000333,0.014395,2,86.37013,4.798341,43.185065,23.219281,2,0
0,0,5,5,11,11,22,21,16,37,0.000333,0.055,5,824.994849,45.833047,164.99897,76.107496,2,0
0,0,1,1,5,5,10,8,5,13,0.000333,0.014395,2,86.37013,4.798341,43.185065,23.219281,2,0
0,0,3,3,10,8,18,15,10,25,0.000333,0.034749,5,521.240625,28.957813,104.248125,57.219281,2,0
0,0,1,1,5,5,10,8,5,13,0.000333,0.014395,2,86.37013,4.798341,43.185065,23.219281,2,0
0,0,3,3,10,8,18,15,10,25,0.000333,0.034749,5,521.240625,28.957813,104.248125,57.219281,2,0
0,0,1,1,5,5,10,8,5,13,0.000333,0.014395,2,86.37013,4.798341,43.185065,23.219281,2,0
0,0,3,3,10,8,18,15,10,25,0.000333,0.034749,5,521.240625,28.957813,104.248125,57.219281,2,0
0,0,1,1,5,5,10,8,5,13,0.000333,0.014395,2,86.37013,4.798341,43.185065,23.219281,2,0
0,0,3,3,10,8,18,15,10,25,0.000333,0.034749,5,521.240625,28.957813,104.248125,57.219281,2,0
0,0,1,1,5,5,10,8,5,13,0.000333,0.014395,2,86.37013,4.798341,43.185065,23.219281,2,0
0,0,3,3,10,8,18,15,10,25,0.000333,0.034749,5,521.240625,28.957813,104.248125,57.219281,2,0
0,0,1,1,5,5,10,8,5,13,0.000333,0.014395,2,86.37013,4.798341,43.185065,23.219281,2,0
0,0,3,3,10,8,18,15,10,25,0.000333,0.034749,5,521.240625,28.957813,104.248125,57.219281,2,0
0,0,1,1,5,5,10,8,5,13,0.000333,0.014395,2,86.37013,4.798341,43.185065,23.219281,2,0
0,0,3,3,9,9,18,14,12,26,0.000333,0.036139,4,433.6722,24.0929,108.41805,57.05865,2,0
0,0,1,1,5,5,10,8,5,13,0.000333,0.014395,2,86.37013,4.798341,43.185065,23.219281,2,0
0,0,3,3,10,10,20,15,12,27,0.000333,0.038897,5,583.460293,32.414461,116.692059,66.438562,2,0
0,0,1,1,5,5,10,8,5,13,0.000333,0.014395,2,86.37013,4.798341,43.185065,23.219281,2,0
0,0,3,3,10,8,18,15,10,25,0.000333,0.034749,5,521.240625,28.957813,104.248125,57.219281,2,0
0,0,1,1,5,5,10,8,5,13,0.000333,0.014395,2,86.37013,4.798341,43.185065,23.219281,2,0
0,0,3,3,10,8,18,15,10,25,0.000333,0.034749,5,521.240625,28.957813,104.248125,57.219281,2,0
0,0,1,1,5,5,10,8,5,13,0.000333,0.014395,2,86.37013,4.798341,43.185065,23.219281,2,0
0,0,3,3,10,8,18,15,10,25,0.000333,0.034749,5,521.240625,28.957813,104.248125,57.219281,2,0
0,0,1,1,5,5,10,8,5,13,0.000333,0.014395,2,86.37013,4.798341,43.185065,23.219281,2,0
0,0,3,3,10,8,18,15,10,25,0.000333,0.034749,5,521.240625,28.957813,104.248125,57.219281,2,0
0,0,1,1,5,5,10,8,5,13,0.000333,0.014395,2,86.37013,4.798341,43.185065,23.219281,2,0
0,0,3,3,10,8,18,15,10,25,0.000333,0.034749,5,521.240625,28.957813,104.248125,57.219281,2,0
0,0,1,1,5,5,10,8,5,13,0.000333,0.014395,2,86.37013,4.798341,43.185065,23.219281,2,0
0,0,3,3,10,8,18,15,10,25,0.000333,0.034749,5,521.240625,28.957813,104.248125,57.219281,2,0
0,0,1,1,5,5,10,8,5,13,0.000333,0.014395,2,86.37013,4.798341,43.185065,23.219281,2,0
0,0,3,3,10,8,18,15,10,25,0.000333,0.034749,5,521.240625,28.957813,104.248125,57.219281,2,0
0,0,1,1,5,5,10,8,5,13,0.000333,0.014395,2,86.37013,4.798341,43.185065,23.219281,2,0
0,0,3,3,10,8,18,15,10,25,0.000333,0.034749,5,521.240625,28.957813,104.248125,57.219281,2,0
0,0,1,1,5,5,10,8,5,13,0.000333,0.014395,2,86.37013,4.798341,43.185065,23.219281,2,0
0,0,3,3,10,8,18,15,10,25,0.000333,0.034749,5,521.240625,28.957813,104.248125,57.219281,2,0
0,0,7,7,11,19,30,44,28,72,0.000333,0.117765,5,1766.480614,98.137812,353.296123,118.764371,2,0
0,0,7,7,11,19,30,44,28,72,0.000333,0.117765,5,1766.480614,98.137812,353.296123,118.764371,2,0
0,0,7,7,11,19,30,44,28,72,0.000333,0.117765,5,1766.480614,98.137812,353.296123,118.764371,2,0
0,0,7,7,11,19,30,44,28,72,0.000333,0.117765,5,1766.480614,98.137812,353.296123,118.764371,2,0
0,0,7,7,11,19,30,44,28,72,0.000333,0.117765,5,1766.480614,98.137812,353.296123,118.764371,2,0
0,0,7,7,11,19,30,44,28,72,0.000333,0.117765,5,1766.480614,98.137812,353.296123,118.764371,2,0
0,0,7,7,11,19,30,44,28,72,0.000333,0.117765,5,1766.480614,98.137812,353.296123,118.764371,2,0
0,0,7,7,11,19,30,44,28,72,0.000333,0.117765,5,1766.480614,98.137812,353.296123,118.764371,2,0
0,0,7,7,11,19,30,44,28,72,0.000333,0.117765,5,1766.480614,98.137812,353.296123,118.764371,2,0
0,0,7,7,11,19,30,44,28,72,0.000333,0.117765,5,1766.480614,98.137812,353.296123,118.764371,2,0
0,0,7,7,11,19,30,44,28,72,0.000333,0.117765,5,1766.480614,98.137812,353.296123,118.764371,2,0
0,0,7,7,11,19,30,44,28,72,0.000333,0.117765,5,1766.480614,98.137812,353.296123,118.764371,2,0
0,0,7,7,11,19,30,44,28,72,0.000333,0.117765,5,1766.480614,98.137812,353.296123,118.764371,2,0
0,0,7,7,11,19,30,44,28,72,0.000333,0.117765,5,1766.480614,98.137812,353.296123,118.764371,2,0
0,0,7,7,11,19,30,44,28,72,0.000333,0.117765,5,1766.480614,98.137812,353.296123,118.764371,2,0
0,0,7,7,11,19,30,44,28,72,0.000333,0.117765,5,1766.480614,98.137812,353.296123,118.764371,2,0
0,0,7,7,11,19,30,44,28,72,0.000333,0.117765,5,1766.480614,98.137812,353.296123,118.764371,2,0
0,0,7,7,11,19,30,44,28,72,0.000333,0.117765,5,1766.480614,98.137812,353.296123,118.764371,2,0
0,0,7,7,11,19,30,44,28,72,0.000333,0.117765,5,1766.480614,98.137812,353.296123,118.764371,2,0
0,0,7,7,11,19,30,44,28,72,0.000333,0.117765,5,1766.480614,98.137812,353.296123,118.764371,2,0
0,0,7,7,11,19,30,44,28,72,0.000333,0.117765,5,1766.480614,98.137812,353.296123,118.764371,2,0
0,0,7,7,11,19,30,44,28,72,0.000333,0.117765,5,1766.480614,98.137812,353.296123,118.764371,2,0
0,0,7,7,11,19,30,44,28,72,0.000333,0.117765,5,1766.480614,98.137812,353.296123,118.764371,2,0
0,0,7,7,11,19,30,44,28,72,0.000333,0.117765,5,1766.480614,98.137812,353.296123,118.764371,2,0
0,0,7,7,11,19,30,44,28,72,0.000333,0.117765,5,1766.480614,98.137812,353.296123,118.764371,2,0
0,0,7,7,11,19,30,44,28,72,0.000333,0.117765,5,1766.480614,98.137812,353.296123,118.764371,2,0
0,0,7,7,11,19,30,44,28,72,0.000333,0.117765,5,1766.480614,98.137812,353.296123,118.764371,2,0
0,0,7,7,11,19,30,44,28,72,0.000333,0.117765,5,1766.480614,98.137812,353.296123,118.764371,2,0
0,0,7,7,11,19,30,44,28,72,0.000333,0.117765,5,1766.480614,98.137812,353.296123,118.764371,2,0
0,0,7,7,11,19,30,44,28,72,0.000333,0.117765,5,1766.480614,98.137812,353.296123,118.764371,2,0
0,0,7,7,11,19,30,44,28,72,0.000333,0.117765,5,1766.480614,98.137812,353.296123,118.764371,2,0
0,0,7,7,11,19,30,44,28,72,0.000333,0.117765,5,1766.480614,98.137812,353.296123,118.764371,2,0
0,0,7,7,11,19,30,44,28,72,0.000333,0.117765,5,1766.480614,98.137812,353.296123,118.764371,2,0
0,0,7,7,11,19,30,44,28,72,0.000333,0.117765,5,1766.480614,98.137812,353.296123,118.764371,2,0
0,0,7,7,11,19,30,44,28,72,0.000333,0.117765,5,1766.480614,98.137812,353.296123,118.764371,2,0
0,0,7,7,11,19,30,44,28,72,0.000333,0.117765,5,1766.480614,98.137812,353.296123,118.764371,2,0
0,0,7,7,11,19,30,44,28,72,0.000333,0.117765,5,1766.480614,98.137812,353.296123,118.764371,2,0
0,0,7,7,11,19,30,44,28,72,0.000333,0.117765,5,1766.480614,98.137812,353.296123,118.764371,2,0
0,0,7,7,11,19,30,44,28,72,0.000333,0.117765,5,1766.480614,98.137812,353.296123,118.764371,2,0
0,0,7,7,11,19,30,44,28,72,0.000333,0.117765,5,1766.480614,98.137812,353.296123,118.764371,2,0
0,0,7,7,11,19,30,44,28,72,0.000333,0.117765,5,1766.480614,98.137812,353.296123,118.764371,2,0
0,0,7,7,11,19,30,44,28,72,0.000333,0.117765,5,1766.480614,98.137812,353.296123,118.764371,2,0
0,0,7,7,11,19,30,44,28,72,0.000333,0.117765,5,1766.480614,98.137812,353.296123,118.764371,2,0
0,0,7,7,11,19,30,44,28,72,0.000333,0.117765,5,1766.480614,98.137812,353.296123,118.764371,2,0
0,0,6,6,13,12,25,32,23,55,0.000333,0.085137,6,1532.472543,85.137363,255.41209,91.125266,5,0
0,0,7,7,11,20,31,46,29,75,0.000333,0.123855,5,1857.823616,103.212423,371.564723,124.49231,2,0
0,0,7,7,11,20,31,46,29,75,0.000333,0.123855,5,1857.823616,103.212423,371.564723,124.49231,2,0
0,0,6,6,13,12,25,32,23,55,0.000333,0.085137,6,1532.472543,85.137363,255.41209,91.125266,5,0
0,0,7,7,11,20,31,46,29,75,0.000333,0.123855,5,1857.823616,103.212423,371.564723,124.49231,2,0
0,0,7,7,11,20,31,46,29,75,0.000333,0.123855,5,1857.823616,103.212423,371.564723,124.49231,2,0
0,0,6,6,13,12,25,32,23,55,0.000333,0.085137,6,1532.472543,85.137363,255.41209,91.125266,5,0
0,0,7,7,11,20,31,46,29,75,0.000333,0.123855,5,1857.823616,103.212423,371.564723,124.49231,2,0
0,0,7,7,11,20,31,46,29,75,0.000333,0.123855,5,1857.823616,103.212423,371.564723,124.49231,2,0
0,0,6,6,13,12,25,32,23,55,0.000333,0.085137,6,1532.472543,85.137363,255.41209,91.125266,5,0
0,0,7,7,11,20,31,46,29,75,0.000333,0.123855,5,1857.823616,103.212423,371.564723,124.49231,2,0
0,0,7,7,11,20,31,46,29,75,0.000333,0.123855,5,1857.823616,103.212423,371.564723,124.49231,2,0
0,0,6,6,13,12,25,32,23,55,0.000333,0.085137,6,1532.472543,85.137363,255.41209,91.125266,5,0
0,0,7,7,11,20,31,46,29,75,0.000333,0.123855,5,1857.823616,103.212423,371.564723,124.49231,2,0
0,0,7,7,11,20,31,46,29,75,0.000333,0.123855,5,1857.823616,103.212423,371.564723,124.49231,2,0
0,0,6,6,13,12,25,32,23,55,0.000333,0.085137,6,1532.472543,85.137363,255.41209,91.125266,5,0
0,0,7,7,11,20,31,46,29,75,0.000333,0.123855,5,1857.823616,103.212423,371.564723,124.49231,2,0
0,0,7,7,11,20,31,46,29,75,0.000333,0.123855,5,1857.823616,103.212423,371.564723,124.49231,2,0
0,0,1,1,5,5,10,8,5,13,0.000333,0.014395,2,86.37013,4.798341,43.185065,23.219281,2,0
0,0,1,1,5,5,10,8,5,13,0.000333,0.014395,2,86.37013,4.798341,43.185065,23.219281,2,0
0,0,3,3,10,8,18,15,10,25,0.000333,0.034749,5,521.240625,28.957813,104.248125,57.219281,2,0
0,0,3,3,10,8,18,15,10,25,0.000333,0.034749,5,521.240625,28.957813,104.248125,57.219281,2,0
0,0,1,1,5,5,10,8,5,13,0.000333,0.014395,2,86.37013,4.798341,43.185065,23.219281,2,0
0,0,1,1,5,5,10,8,5,13,0.000333,0.014395,2,86.37013,4.798341,43.185065,23.219281,2,0
0,0,5,5,12,11,23,22,16,38,0.000333,0.057298,6,1031.372126,57.298451,171.895354,81.073298,2,0
0,0,5,5,12,12,24,22,18,40,0.000333,0.061133,6,1100.391,61.132833,183.3985,86.0391,2,0
0,0,1,1,5,5,10,8,5,13,0.000333,0.014395,2,86.37013,4.798341,43.185065,23.219281,2,0
0,0,1,1,5,5,10,8,5,13,0.000333,0.014395,2,86.37013,4.798341,43.185065,23.219281,2,0
0,0,3,3,10,10,20,15,12,27,0.000333,0.038897,5,583.460293,32.414461,116.692059,66.438562,2,0
0,0,5,5,11,12,23,21,18,39,0.000333,0.058806,5,882.094581,49.005255,176.418916,81.073298,2,0
0,0,1,1,5,5,10,8,5,13,0.000333,0.014395,2,86.37013,4.798341,43.185065,23.219281,2,0
0,0,1,1,5,5,10,8,5,13,0.000333,0.014395,2,86.37013,4.798341,43.185065,23.219281,2,0
0,0,3,3,10,8,18,15,10,25,0.000333,0.034749,5,521.240625,28.957813,104.248125,57.219281,2,0
0,0,3,3,10,8,18,15,10,25,0.000333,0.034749,5,521.240625,28.957813,104.248125,57.219281,2,0
0,0,1,1,5,5,10,8,5,13,0.000333,0.014395,2,86.37013,4.798341,43.185065,23.219281,2,0
0,0,1,1,5,5,10,8,5,13,0.000333,0.014395,2,86.37013,4.798341,43.185065,23.219281,2,0
0,0,3,3,10,8,18,15,10,25,0.000333,0.034749,5,521.240625,28.957813,104.248125,57.219281,2,0
0,0,3,3,10,8,18,15,10,25,0.000333,0.034749,5,521.240625,28.957813,104.248125,57.219281,2,0
0,0,1,1,5,5,10,8,5,13,0.000333,0.014395,2,86.37013,4.798341,43.185065,23.219281,2,0
0,0,1,1,5,5,10,8,5,13,0.000333,0.014395,2,86.37013,4.798341,43.185065,23.219281,2,0
0,0,3,3,10,8,18,15,10,25,0.000333,0.034749,5,521.240625,28.957813,104.248125,57.219281,2,0
0,0,3,3,10,8,18,15,10,25,0.000333,0.034749,5,521.240625,28.957813,104.248125,57.219281,2,0
0,0,6,6,13,12,25,32,23,55,0.000333,0.085137,6,1532.472543,85.137363,255.41209,91.125266,5,0
0,0,7,7,11,19,30,44,28,72,0.000333,0.117765,5,1766.480614,98.137812,353.296123,118.764371,2,0
0,0,8,8,11,19,30,53,32,85,0.000333,0.139029,5,2085.428503,115.857139,417.085701,118.764371,2,0
0,0,6,6,13,12,25,32,23,55,0.000333,0.085137,6,1532.472543,85.137363,255.41209,91.125266,5,0
0,0,8,8,11,19,30,53,32,85,0.000333,0.139029,5,2085.428503,115.857139,417.085701,118.764371,2,0
0,0,8,8,11,19,30,53,32,85,0.000333,0.139029,5,2085.428503,115.857139,417.085701,118.764371,2,0
0,0,6,6,13,12,25,32,23,55,0.000333,0.085137,6,1532.472543,85.137363,255.41209,91.125266,5,0
0,0,8,8,11,19,30,53,32,85,0.000333,0.139029,5,2085.428503,115.857139,417.085701,118.764371,2,0
0,0,8,8,11,19,30,53,32,85,0.000333,0.139029,5,2085.428503,115.857139,417.085701,118.764371,2,0
0,0,6,6,13,12,25,32,23,55,0.000333,0.085137,6,1532.472543,85.137363,255.41209,91.125266,5,0
0,0,8,8,11,19,30,53,32,85,0.000333,0.139029,5,2085.428503,115.857139,417.085701,118.764371,2,0
0,0,8,8,11,19,30,53,32,85,0.000333,0.139029,5,2085.428503,115.857139,417.085701,118.764371,2,0
0,0,6,6,13,12,25,32,23,55,0.000333,0.085137,6,1532.472543,85.137363,255.41209,91.125266,5,0
0,0,8,8,11,19,30,53,32,85,0.000333,0.139029,5,2085.428503,115.857139,417.085701,118.764371,2,0
0,0,8,8,11,19,30,53,32,85,0.000333,0.139029,5,2085.428503,115.857139,417.085701,118.764371,2,0
0,0,6,6,13,12,25,32,23,55,0.000333,0.085137,6,1532.472543,85.137363,255.41209,91.125266,5,0
0,0,8,8,11,19,30,53,32,85,0.000333,0.139029,5,2085.428503,115.857139,417.085701,118.764371,2,0
0,0,8,8,11,19,30,53,32,85,0.000333,0.139029,5,2085.428503,115.857139,417.085701,118.764371,2,0
0,0,5,5,12,8,20,33,20,53,0.000333,0.076354,12,2748.746268,152.708126,229.062189,67.01955,1,0
0,0,3,3,11,7,18,26,14,40,0.000333,0.055599,10,1667.970001,92.665,166.797,57.705232,1,0
0,0,3,3,11,7,18,26,14,40,0.000333,0.055599,10,1667.970001,92.665,166.797,57.705232,1,0
0,0,11,11,14,16,30,73,53,126,0.000333,0.206089,21,12983.63252,721.312918,618.268215,117.302969,1,0
0,0,11,11,14,14,28,63,44,107,0.000333,0.171462,21,10802.12651,600.118139,514.386977,106.605938,1,0
0,0,8,8,13,13,26,53,36,89,0.000333,0.139446,12,5020.069619,278.892757,418.339135,96.211433,1,0
0,0,5,5,12,8,20,33,20,53,0.000333,0.076354,12,2748.746268,152.708126,229.062189,67.01955,1,0
0,0,3,3,11,7,18,26,14,40,0.000333,0.055599,10,1667.970001,92.665,166.797,57.705232,1,0
0,0,3,3,11,7,18,26,14,40,0.000333,0.055599,10,1667.970001,92.665,166.797,57.705232,1,0
0,0,11,11,14,16,30,73,53,126,0.000333,0.206089,21,12983.63252,721.312918,618.268215,117.302969,1,0
0,0,11,11,14,14,28,63,44,107,0.000333,0.171462,21,10802.12651,600.118139,514.386977,106.605938,1,0
0,0,8,8,13,13,26,53,36,89,0.000333,0.139446,12,5020.069619,278.892757,418.339135,96.211433,1,0
0,0,5,5,6,9,15,19,16,35,0.000333,0.04558,3,410.223513,22.790195,136.741171,44.0391,1,0
0,0,4,4,6,8,14,19,14,33,0.000333,0.041881,3,376.928137,20.940452,125.642712,39.509775,1,0
0,0,4,4,6,8,14,19,14,33,0.000333,0.041881,3,376.928137,20.940452,125.642712,39.509775,1,0
0,0,2,2,5,7,12,12,8,20,0.000333,0.0239,2,143.3985,7.966583,71.69925,31.261125,1,0
0,0,2,2,5,7,12,12,8,20,0.000333,0.0239,2,143.3985,7.966583,71.69925,31.261125,1,0
0,0,2,2,5,7,12,12,8,20,0.000333,0.0239,2,143.3985,7.966583,71.69925,31.261125,1,0
0,0,2,2,5,7,12,12,8,20,0.000333,0.0239,2,143.3985,7.966583,71.69925,31.261125,1,0
0,0,5,5,6,10,16,22,18,40,0.000333,0.053333,3,480,26.666667,160,48.729056,1,0
0,0,7,7,8,14,22,40,30,70,0.000333,0.104053,8,2497.281706,138.737873,312.160213,77.302969,1,0
0,0,4,4,8,11,19,37,21,58,0.000333,0.082127,4,985.519183,54.751066,246.379796,62.053748,1,0
0,0,10,10,11,16,27,51,43,94,0.000333,0.148986,10,4469.594252,248.310792,446.959425,102.053748,1,0
0,0,12,12,12,19,31,69,55,124,0.000333,0.204773,12,7371.84411,409.546895,614.320342,123.730173,1,0
0,0,11,11,13,18,31,75,55,130,0.000333,0.214682,18,11592.81937,644.04552,644.04552,123.164366,1,0
0,0,10,10,8,14,22,41,34,75,0.000333,0.111486,8,2675.658971,148.647721,334.457371,77.302969,1,0
0,0,10,10,8,14,22,41,34,75,0.000333,0.111486,8,2675.658971,148.647721,334.457371,77.302969,1,0
0,0,11,11,11,17,28,65,46,111,0.000333,0.177872,10,5336.163963,296.453554,533.616396,107.540616,1,0
0,0,11,11,10,16,26,47,39,86,0.000333,0.134746,10,4042.378158,224.576564,404.237816,97.219281,1,0
0,0,13,13,11,19,30,65,51,116,0.000333,0.189733,10,5691.993091,316.221838,569.199309,118.764371,1,0
0,0,8,8,12,17,29,55,38,93,0.000333,0.150597,12,5421.506791,301.194822,451.792233,112.506418,1,0
0,0,7,7,11,11,22,37,25,62,0.000333,0.092162,10,2764.847604,153.602645,276.48476,76.107496,1,0
0,0,13,13,13,18,31,72,56,128,0.000333,0.211379,18,11414.4683,634.137128,634.137128,123.164366,1,0
0,0,12,12,12,15,27,47,40,87,0.000333,0.137892,12,4964.102552,275.783475,413.675213,101.622909,1,0
0,0,12,12,12,17,29,59,45,104,0.000333,0.16841,12,6062.760282,336.820016,505.230023,112.506418,1,0
0,0,8,8,11,13,24,61,35,96,0.000333,0.146719,10,4401.564001,244.531333,440.1564,86.159464,1,0
0,0,11,11,13,17,30,75,55,130,0.000333,0.212632,18,11482.12399,637.895777,637.895777,117.592585,1,0
0,0,11,11,13,16,29,65,46,111,0.000333,0.179745,12,6470.830686,359.490594,539.23589,112.105716,1,0
0,0,8,8,12,16,28,55,38,93,0.000333,0.149028,12,5365.008093,298.056005,447.084008,107.01955,1,0
0,0,8,8,11,13,24,61,35,96,0.000333,0.146719,10,4401.564001,244.531333,440.1564,86.159464,1,0
0,0,11,11,13,17,30,75,55,130,0.000333,0.212632,18,11482.12399,637.895777,637.895777,117.592585,1,0
0,0,11,11,13,16,29,65,46,111,0.000333,0.179745,12,6470.830686,359.490594,539.23589,112.105716,1,0
0,0,8,8,12,16,28,55,38,93,0.000333,0.149028,12,5365.008093,298.056005,447.084008,107.01955,1,0
0,0,7,7,11,12,23,41,28,69,0.000333,0.104042,10,3121.25775,173.403208,312.125775,81.073298,1,0
0,0,11,11,12,17,29,63,53,116,0.000333,0.187842,18,10143.46432,563.525795,563.525795,112.506418,1,0
0,0,11,11,12,16,28,53,44,97,0.000333,0.155438,12,5595.761129,310.875618,466.313427,107.01955,1,0
0,0,8,8,11,16,27,43,36,79,0.000333,0.125212,10,3756.361127,208.686729,375.636113,102.053748,1,0
0,0,7,7,10,10,20,25,23,48,0.000333,0.069151,10,2074.525486,115.251416,207.452549,66.438562,1,0
0,0,11,11,12,16,28,55,47,102,0.000333,0.16345,12,5884.202425,326.900135,490.350202,107.01955,1,0
0,0,11,11,12,15,27,45,38,83,0.000333,0.131552,12,4735.867952,263.103775,394.655663,101.622909,1,0
0,0,8,8,11,15,26,35,30,65,0.000333,0.101843,10,3055.285817,169.738101,305.528582,96.657107,1,0
0,0,11,11,13,16,29,65,46,111,0.000333,0.179745,12,6470.830686,359.490594,539.23589,112.105716,1,0
0,0,8,8,12,16,28,55,38,93,0.000333,0.149028,12,5365.008093,298.056005,447.084008,107.01955,1,0
0,0,7,7,11,11,22,36,26,62,0.000333,0.092162,10,2764.847604,153.602645,276.48476,76.107496,1,0
0,0,11,11,13,17,30,75,55,130,0.000333,0.212632,18,11482.12399,637.895777,637.895777,117.592585,1,0
0,0,11,11,13,16,29,65,46,111,0.000333,0.179745,12,6470.830686,359.490594,539.23589,112.105716,1,0
0,0,8,8,12,16,28,55,38,93,0.000333,0.149028,12,5365.008093,298.056005,447.084008,107.01955,1,0
0,0,7,7,10,12,22,30,25,55,0.000333,0.081756,10,2452.68739,136.260411,245.268739,76.238831,1,0
0,0,6,6,10,11,21,26,21,47,0.000333,0.068813,5,1032.194594,57.344144,206.438919,71.273029,1,0
0,0,11,11,12,17,29,63,53,116,0.000333,0.187842,18,10143.46432,563.525795,563.525795,112.506418,1,0
0,0,11,11,12,16,28,53,44,97,0.000333,0.155438,12,5595.761129,310.875618,466.313427,107.01955,1,0
0,0,8,8,11,16,27,43,36,79,0.000333,0.125212,10,3756.361127,208.686729,375.636113,102.053748,1,0
0,0,7,7,10,11,21,25,21,46,0.000333,0.067349,5,1010.233007,56.124056,202.046601,71.273029,1,0
0,0,11,11,12,16,28,55,47,102,0.000333,0.16345,12,5884.202425,326.900135,490.350202,107.01955,1,0
0,0,11,11,12,15,27,45,38,83,0.000333,0.131552,12,4735.867952,263.103775,394.655663,101.622909,1,0
0,0,8,8,11,15,26,35,30,65,0.000333,0.101843,10,3055.285817,169.738101,305.528582,96.657107,1,0
0,0,6,6,11,12,23,55,31,86,0.000333,0.129675,10,3890.263282,216.125738,389.026328,81.073298,1,0
0,0,6,6,11,12,23,55,31,86,0.000333,0.129675,10,3890.263282,216.125738,389.026328,81.073298,1,0
0,0,11,11,13,17,30,75,55,130,0.000333,0.212632,18,11482.12399,637.895777,637.895777,117.592585,1,0
0,0,11,11,13,16,29,65,46,111,0.000333,0.179745,12,6470.830686,359.490594,539.23589,112.105716,1,0
0,0,8,8,12,16,28,55,38,93,0.000333,0.149028,12,5365.008093,298.056005,447.084008,107.01955,1,0
0,0,7,7,11,12,23,56,33,89,0.000333,0.134199,10,4025.970141,223.665008,402.597014,81.073298,1,0
0,0,11,11,13,17,30,75,55,130,0.000333,0.212632,18,11482.12399,637.895777,637.895777,117.592585,1,0
0,0,11,11,13,16,29,65,46,111,0.000333,0.179745,12,6470.830686,359.490594,539.23589,112.105716,1,0
0,0,8,8,12,16,28,55,38,93,0.000333,0.149028,12,5365.008093,298.056005,447.084008,107.01955,1,0
0,0,7,7,10,12,22,29,24,53,0.000333,0.078783,10,2363.498758,131.305487,236.349876,76.238831,1,0
0,0,11,11,12,17,29,63,53,116,0.000333,0.187842,18,10143.46432,563.525795,563.525795,112.506418,1,0
0,0,11,11,12,16,28,53,44,97,0.000333,0.155438,12,5595.761129,310.875618,466.313427,107.01955,1,0
0,0,8,8,11,16,27,43,36,79,0.000333,0.125212,10,3756.361127,208.686729,375.636113,102.053748,1,0
0,0,7,7,10,11,21,25,21,46,0.000333,0.067349,5,1010.233007,56.124056,202.046601,71.273029,1,0
0,0,11,11,12,16,28,55,47,102,0.000333,0.16345,12,5884.202425,326.900135,490.350202,107.01955,1,0
0,0,11,11,12,15,27,45,38,83,0.000333,0.131552,12,4735.867952,263.103775,394.655663,101.622909,1,0
0,0,8,8,11,15,26,35,30,65,0.000333,0.101843,10,3055.285817,169.738101,305.528582,96.657107,1,0
0,0,7,7,11,12,23,35,25,60,0.000333,0.090471,10,2714.137174,150.785399,271.413717,81.073298,1,0
0,0,11,11,13,17,30,75,55,130,0.000333,0.212632,18,11482.12399,637.895777,637.895777,117.592585,1,0
0,0,11,11,13,16,29,65,46,111,0.000333,0.179745,12,6470.830686,359.490594,539.23589,112.105716,1,0
0,0,8,8,12,16,28,55,38,93,0.000333,0.149028,12,5365.008093,298.056005,447.084008,107.01955,1,0
0,0,7,7,11,12,23,35,25,60,0.000333,0.090471,10,2714.137174,150.785399,271.413717,81.073298,1,0
0,0,11,11,13,17,30,75,55,130,0.000333,0.212632,18,11482.12399,637.895777,637.895777,117.592585,1,0
0,0,11,11,13,16,29,65,46,111,0.000333,0.179745,12,6470.830686,359.490594,539.23589,112.105716,1,0
0,0,8,8,12,16,28,55,38,93,0.000333,0.149028,12,5365.008093,298.056005,447.084008,107.01955,1,0
0,0,8,8,10,11,21,31,28,59,0.000333,0.086382,10,2591.467279,143.970404,259.146728,71.273029,1,0
0,0,15,15,12,19,31,74,64,138,0.000333,0.227893,18,12306.22364,683.679091,683.679091,123.730173,1,0
0,0,15,15,12,18,30,64,55,119,0.000333,0.19464,18,10510.55966,583.919981,583.919981,118.0782,1,0
0,0,9,9,11,17,28,45,38,83,0.000333,0.133003,10,3990.104585,221.672477,399.010459,107.540616,1,0
0,0,13,13,11,18,29,59,51,110,0.000333,0.178126,10,5343.779095,296.876616,534.377909,113.112398,1,0
0,0,2,2,7,5,12,9,7,16,0.000333,0.01912,3,172.0782,9.5599,57.3594,31.261125,1,0
0,0,2,2,7,5,12,9,7,16,0.000333,0.01912,3,172.0782,9.5599,57.3594,31.261125,1,0
0,0,2,2,7,5,12,9,7,16,0.000333,0.01912,3,172.0782,9.5599,57.3594,31.261125,1,0
0,0,2,2,7,5,12,9,7,16,0.000333,0.01912,3,172.0782,9.5599,57.3594,31.261125,1,0
0,0,2,2,7,5,12,9,7,16,0.000333,0.01912,3,172.0782,9.5599,57.3594,31.261125,1,0
0,0,2,2,7,5,12,9,7,16,0.000333,0.01912,3,172.0782,9.5599,57.3594,31.261125,1,0
0,0,2,2,7,5,12,9,7,16,0.000333,0.01912,3,172.0782,9.5599,57.3594,31.261125,1,0
0,0,2,2,7,5,12,9,7,16,0.000333,0.01912,3,172.0782,9.5599,57.3594,31.261125,1,0
0,0,2,2,7,5,12,9,7,16,0.000333,0.01912,3,172.0782,9.5599,57.3594,31.261125,1,0
0,0,8,8,11,11,22,49,30,79,0.000333,0.117432,10,3522.950979,195.719499,352.295098,76.107496,1,0
0,0,2,2,7,5,12,9,7,16,0.000333,0.01912,3,172.0782,9.5599,57.3594,31.261125,1,0
0,0,2,2,7,5,12,9,7,16,0.000333,0.01912,3,172.0782,9.5599,57.3594,31.261125,1,0
0,0,15,15,13,19,32,93,65,158,0.000333,0.263333,18,14220,790,790,128.816339,1,0
0,0,2,2,7,5,12,9,7,16,0.000333,0.01912,3,172.0782,9.5599,57.3594,31.261125,1,0
0,0,16,16,13,18,31,87,59,146,0.000333,0.241104,18,13019.6279,723.312661,723.312661,123.164366,1,0
0,0,2,2,7,5,12,9,7,16,0.000333,0.01912,3,172.0782,9.5599,57.3594,31.261125,1,0
0,0,2,2,7,5,12,9,7,16,0.000333,0.01912,3,172.0782,9.5599,57.3594,31.261125,1,0
0,0,13,13,12,18,30,78,52,130,0.000333,0.212632,12,7654.749329,425.263852,637.895777,118.0782,1,0
0,0,2,2,7,5,12,9,7,16,0.000333,0.01912,3,172.0782,9.5599,57.3594,31.261125,1,0
0,0,8,8,11,11,22,49,30,79,0.000333,0.117432,10,3522.950979,195.719499,352.295098,76.107496,1,0
0,0,2,2,7,5,12,9,7,16,0.000333,0.01912,3,172.0782,9.5599,57.3594,31.261125,1,0
0,0,15,15,13,19,32,93,65,158,0.000333,0.263333,18,14220,790,790,128.816339,1,0
0,0,2,2,7,5,12,9,7,16,0.000333,0.01912,3,172.0782,9.5599,57.3594,31.261125,1,0
0,0,2,2,7,5,12,9,7,16,0.000333,0.01912,3,172.0782,9.5599,57.3594,31.261125,1,0
0,0,15,15,13,18,31,83,56,139,0.000333,0.229544,18,12395.39917,688.633287,688.633287,123.164366,1,0
0,0,2,2,7,5,12,9,7,16,0.000333,0.01912,3,172.0782,9.5599,57.3594,31.261125,1,0
0,0,2,2,7,5,12,9,7,16,0.000333,0.01912,3,172.0782,9.5599,57.3594,31.261125,1,0
0,0,13,13,12,18,30,78,52,130,0.000333,0.212632,12,7654.749329,425.263852,637.895777,118.0782,1,0
0,0,8,8,11,11,22,45,29,74,0.000333,0.109999,10,3299.979398,183.332189,329.99794,76.107496,1,0
0,0,2,2,7,5,12,9,7,16,0.000333,0.01912,3,172.0782,9.5599,57.3594,31.261125,1,0
0,0,2,2,7,5,12,9,7,16,0.000333,0.01912,3,172.0782,9.5599,57.3594,31.261125,1,0
0,0,15,15,13,19,32,85,63,148,0.000333,0.246667,18,13320,740,740,128.816339,1,0
0,0,15,15,13,18,31,75,54,129,0.000333,0.21303,18,11503.64383,639.091324,639.091324,123.164366,1,0
0,0,13,13,12,18,30,70,50,120,0.000333,0.196276,12,7065.922458,392.551248,588.826871,118.0782,1,0
0,0,8,8,11,11,22,46,30,76,0.000333,0.112972,10,3389.16803,188.287113,338.916803,76.107496,1,0
0,0,2,2,7,5,12,9,7,16,0.000333,0.01912,3,172.0782,9.5599,57.3594,31.261125,1,0
0,0,2,2,7,5,12,9,7,16,0.000333,0.01912,3,172.0782,9.5599,57.3594,31.261125,1,0
0,0,15,15,13,19,32,87,65,152,0.000333,0.253333,18,13680,760,760,128.816339,1,0
0,0,15,15,13,18,31,77,56,133,0.000333,0.219636,18,11860.34597,658.908109,658.908109,123.164366,1,0
0,0,13,13,12,18,30,72,52,124,0.000333,0.202818,12,7301.453206,405.636289,608.454434,118.0782,1,0
0,0,2,2,7,5,12,9,7,16,0.000333,0.01912,3,172.0782,9.5599,57.3594,31.261125,1,0
0,0,2,2,7,5,12,9,7,16,0.000333,0.01912,3,172.0782,9.5599,57.3594,31.261125,1,0
0,0,2,2,7,5,12,9,7,16,0.000333,0.01912,3,172.0782,9.5599,57.3594,31.261125,1,0
0,0,2,2,7,5,12,9,7,16,0.000333,0.01912,3,172.0782,9.5599,57.3594,31.261125,1,0
0,0,2,2,7,5,12,9,7,16,0.000333,0.01912,3,172.0782,9.5599,57.3594,31.261125,1,0
0,0,2,2,7,5,12,9,7,16,0.000333,0.01912,3,172.0782,9.5599,57.3594,31.261125,1,0
0,0,2,2,7,5,12,9,7,16,0.000333,0.01912,3,172.0782,9.5599,57.3594,31.261125,1,0
0,0,2,2,7,5,12,9,7,16,0.000333,0.01912,3,172.0782,9.5599,57.3594,31.261125,1,0
0,0,2,2,7,5,12,9,7,16,0.000333,0.01912,3,172.0782,9.5599,57.3594,31.261125,1,0
0,0,2,2,7,5,12,9,7,16,0.000333,0.01912,3,172.0782,9.5599,57.3594,31.261125,1,0
0,0,2,2,7,5,12,9,7,16,0.000333,0.01912,3,172.0782,9.5599,57.3594,31.261125,1,0
0,0,2,2,7,5,12,9,7,16,0.000333,0.01912,3,172.0782,9.5599,57.3594,31.261125,1,0
0,0,2,2,7,5,12,9,7,16,0.000333,0.01912,3,172.0782,9.5599,57.3594,31.261125,1,0
0,0,2,2,7,5,12,9,7,16,0.000333,0.01912,3,172.0782,9.5599,57.3594,31.261125,1,0
0,0,2,2,7,5,12,9,7,16,0.000333,0.01912,3,172.0782,9.5599,57.3594,31.261125,1,0
0,0,2,2,7,5,12,9,7,16,0.000333,0.01912,3,172.0782,9.5599,57.3594,31.261125,1,0
0,0,2,2,7,5,12,9,7,16,0.000333,0.01912,3,172.0782,9.5599,57.3594,31.261125,1,0
0,0,8,8,11,10,21,31,24,55,0.000333,0.080526,10,2415.774583,134.209699,241.577458,71.273029,1,0
0,0,2,2,7,5,12,9,7,16,0.000333,0.01912,3,172.0782,9.5599,57.3594,31.261125,1,0
0,0,2,2,7,5,12,9,7,16,0.000333,0.01912,3,172.0782,9.5599,57.3594,31.261125,1,0
0,0,15,15,13,18,31,75,59,134,0.000333,0.221287,18,11949.5215,663.862306,663.862306,123.164366,1,0
0,0,2,2,7,5,12,9,7,16,0.000333,0.01912,3,172.0782,9.5599,57.3594,31.261125,1,0
0,0,2,2,7,5,12,9,7,16,0.000333,0.01912,3,172.0782,9.5599,57.3594,31.261125,1,0
0,0,15,15,13,17,30,65,50,115,0.000333,0.188097,12,6771.509022,376.194946,564.292418,117.592585,1,0
0,0,2,2,7,5,12,9,7,16,0.000333,0.01912,3,172.0782,9.5599,57.3594,31.261125,1,0
0,0,2,2,7,5,12,9,7,16,0.000333,0.01912,3,172.0782,9.5599,57.3594,31.261125,1,0
0,0,2,2,7,5,12,9,7,16,0.000333,0.01912,3,172.0782,9.5599,57.3594,31.261125,1,0
0,0,13,13,12,17,29,60,46,106,0.000333,0.171649,12,6179.351826,343.297324,514.945985,112.506418,1,0
0,0,2,2,7,5,12,9,7,16,0.000333,0.01912,3,172.0782,9.5599,57.3594,31.261125,1,0
0,0,8,8,11,10,21,31,24,55,0.000333,0.080526,10,2415.774583,134.209699,241.577458,71.273029,1,0
0,0,2,2,7,5,12,9,7,16,0.000333,0.01912,3,172.0782,9.5599,57.3594,31.261125,1,0
0,0,2,2,7,5,12,9,7,16,0.000333,0.01912,3,172.0782,9.5599,57.3594,31.261125,1,0
0,0,2,2,7,5,12,9,7,16,0.000333,0.01912,3,172.0782,9.5599,57.3594,31.261125,1,0
0,0,15,15,13,18,31,75,59,134,0.000333,0.221287,18,11949.5215,663.862306,663.862306,123.164366,1,0
0,0,2,2,7,5,12,9,7,16,0.000333,0.01912,3,172.0782,9.5599,57.3594,31.261125,1,0
0,0,2,2,7,5,12,9,7,16,0.000333,0.01912,3,172.0782,9.5599,57.3594,31.261125,1,0
0,0,15,15,13,17,30,65,50,115,0.000333,0.188097,12,6771.509022,376.194946,564.292418,117.592585,1,0
0,0,2,2,7,5,12,9,7,16,0.000333,0.01912,3,172.0782,9.5599,57.3594,31.261125,1,0
0,0,2,2,7,5,12,9,7,16,0.000333,0.01912,3,172.0782,9.5599,57.3594,31.261125,1,0
0,0,13,13,12,17,29,60,46,106,0.000333,0.171649,12,6179.351826,343.297324,514.945985,112.506418,1,0
0,0,8,8,10,10,20,27,23,50,0.000333,0.072032,10,2160.964047,120.053558,216.096405,66.438562,1,0
0,0,2,2,7,5,12,9,7,16,0.000333,0.01912,3,172.0782,9.5599,57.3594,31.261125,1,0
0,0,2,2,7,5,12,9,7,16,0.000333,0.01912,3,172.0782,9.5599,57.3594,31.261125,1,0
0,0,15,15,12,18,30,67,57,124,0.000333,0.202818,18,10952.17981,608.454434,608.454434,118.0782,1,0
0,0,15,15,12,17,29,57,48,105,0.000333,0.170029,12,6121.056054,340.05867,510.088004,112.506418,1,0
0,0,13,13,11,17,28,52,44,96,0.000333,0.153835,10,4615.060725,256.392263,461.506073,107.540616,1,0
0,0,2,2,7,5,12,9,7,16,0.000333,0.01912,3,172.0782,9.5599,57.3594,31.261125,1,0
0,0,8,8,10,10,20,28,24,52,0.000333,0.074913,10,2247.402609,124.855701,224.740261,66.438562,1,0
0,0,2,2,7,5,12,9,7,16,0.000333,0.01912,3,172.0782,9.5599,57.3594,31.261125,1,0
0,0,2,2,7,5,12,9,7,16,0.000333,0.01912,3,172.0782,9.5599,57.3594,31.261125,1,0
0,0,15,15,12,18,30,69,59,128,0.000333,0.209361,18,11305.47593,628.081996,628.081996,118.0782,1,0
0,0,2,2,7,5,12,9,7,16,0.000333,0.01912,3,172.0782,9.5599,57.3594,31.261125,1,0
0,0,2,2,7,5,12,9,7,16,0.000333,0.01912,3,172.0782,9.5599,57.3594,31.261125,1,0
0,0,12,12,12,15,27,51,42,93,0.000333,0.147402,12,5306.454452,294.803025,442.204538,101.622909,1,0
0,0,15,15,12,17,29,59,50,109,0.000333,0.176507,12,6354.239142,353.013286,529.519928,112.506418,1,0
0,0,13,13,11,17,28,54,46,100,0.000333,0.160245,10,4807.354922,267.075273,480.735492,107.540616,1,0
0,0,2,2,7,5,12,9,7,16,0.000333,0.01912,3,172.0782,9.5599,57.3594,31.261125,1,0
0,0,2,2,7,5,12,9,7,16,0.000333,0.01912,3,172.0782,9.5599,57.3594,31.261125,1,0
0,0,2,2,7,5,12,9,7,16,0.000333,0.01912,3,172.0782,9.5599,57.3594,31.261125,1,0
0,0,2,2,7,5,12,9,7,16,0.000333,0.01912,3,172.0782,9.5599,57.3594,31.261125,1,0
0,0,2,2,7,5,12,9,7,16,0.000333,0.01912,3,172.0782,9.5599,57.3594,31.261125,1,0
0,0,2,2,7,5,12,9,7,16,0.000333,0.01912,3,172.0782,9.5599,57.3594,31.261125,1,0
0,0,2,2,7,5,12,9,7,16,0.000333,0.01912,3,172.0782,9.5599,57.3594,31.261125,1,0
0,0,2,2,7,5,12,9,7,16,0.000333,0.01912,3,172.0782,9.5599,57.3594,31.261125,1,0
0,0,8,8,12,12,24,50,42,92,0.000333,0.140606,18,7592.697901,421.81655,421.81655,86.0391,1,0
0,0,14,14,14,20,34,90,77,167,0.000333,0.283202,21,17841.73218,991.207344,849.606294,139.741531,1,0
0,0,14,14,14,18,32,80,68,148,0.000333,0.246667,21,15540,863.333333,740,128.361619,1,0
0,0,12,12,13,18,31,75,64,139,0.000333,0.229544,18,12395.39917,688.633287,688.633287,123.164366,1,0
0,0,8,8,12,12,24,50,42,92,0.000333,0.140606,18,7592.697901,421.81655,421.81655,86.0391,1,0
0,0,14,14,14,20,34,90,77,167,0.000333,0.283202,21,17841.73218,991.207344,849.606294,139.741531,1,0
0,0,14,14,14,18,32,80,68,148,0.000333,0.246667,21,15540,863.333333,740,128.361619,1,0
0,0,12,12,13,18,31,75,64,139,0.000333,0.229544,18,12395.39917,688.633287,688.633287,123.164366,1,0
0,0,8,8,12,11,23,32,32,64,0.000333,0.096503,12,3474.095582,193.00531,289.507965,81.073298,1,0
0,0,13,13,14,17,31,69,63,132,0.000333,0.217985,21,13733.03217,762.946232,653.953913,122.789837,1,0
0,0,14,14,14,17,31,62,58,120,0.000333,0.198168,21,12484.5747,693.587483,594.503557,122.789837,1,0
0,0,12,12,13,17,30,57,54,111,0.000333,0.181555,18,9803.96741,544.664856,544.664856,117.592585,1,0
0,0,8,8,12,11,23,32,32,64,0.000333,0.096503,12,3474.095582,193.00531,289.507965,81.073298,1,0
0,0,14,14,14,19,33,72,67,139,0.000333,0.233724,21,14724.58643,818.03258,701.170783,134.013592,1,0
0,0,14,14,14,17,31,62,58,120,0.000333,0.198168,21,12484.5747,693.587483,594.503557,122.789837,1,0
0,0,12,12,13,17,30,57,54,111,0.000333,0.181555,18,9803.96741,544.664856,544.664856,117.592585,1,0
0,0,8,8,12,11,23,50,31,81,0.000333,0.122136,12,4396.902221,244.272346,366.408518,81.073298,1,0
0,0,14,14,14,19,33,90,64,154,0.000333,0.258946,21,16313.57058,906.309477,776.836694,134.013592,1,0
0,0,14,14,14,17,31,80,55,135,0.000333,0.222939,21,14045.14654,780.285919,668.816502,122.789837,1,0
0,0,12,12,13,16,29,75,51,126,0.000333,0.204035,18,11017.9009,612.105605,612.105605,112.105716,1,0
0,0,8,8,12,11,23,50,31,81,0.000333,0.122136,12,4396.902221,244.272346,366.408518,81.073298,1,0
0,0,14,14,14,19,33,89,64,153,0.000333,0.257264,21,16207.63831,900.42435,771.7923,134.013592,1,0
0,0,14,14,14,17,31,80,55,135,0.000333,0.222939,21,14045.14654,780.285919,668.816502,122.789837,1,0
0,0,12,12,13,16,29,75,51,126,0.000333,0.204035,18,11017.9009,612.105605,612.105605,112.105716,1,0
0,0,8,8,12,10,22,32,25,57,0.000333,0.084729,12,3050.251227,169.458402,254.187602,76.238831,1,0
0,0,13,13,14,16,30,69,55,124,0.000333,0.202818,21,12777.54311,709.863506,608.454434,117.302969,1,0
0,0,13,13,14,14,28,59,46,105,0.000333,0.168257,21,10600.2176,588.900978,504.772267,106.605938,1,0
0,0,12,12,13,15,28,57,45,102,0.000333,0.16345,18,8826.303637,490.350202,490.350202,106.709075,1,0
0,0,8,8,12,10,22,32,25,57,0.000333,0.084729,12,3050.251227,169.458402,254.187602,76.238831,1,0
0,0,13,13,14,16,30,69,55,124,0.000333,0.202818,21,12777.54311,709.863506,608.454434,117.302969,1,0
0,0,14,14,14,16,30,62,49,111,0.000333,0.181555,21,11437.96198,635.442332,544.664856,117.302969,1,0
0,0,12,12,14,16,30,56,44,100,0.000333,0.163563,14,6869.646834,381.647046,490.68906,117.302969,1,0
0,0,9,9,11,13,24,52,34,86,0.000333,0.131436,10,3943.067751,219.059319,394.306775,86.159464,1,0
0,0,15,15,12,21,33,92,67,159,0.000333,0.267353,18,14437.05597,802.058665,802.058665,135.258216,1,0
0,0,14,14,12,19,31,80,56,136,0.000333,0.22459,12,8085.248379,449.180465,673.770698,123.730173,1,0
0,0,13,13,12,19,31,77,54,131,0.000333,0.216333,12,7787.9966,432.666478,648.999717,123.730173,1,0
0,0,9,9,11,13,24,52,34,86,0.000333,0.131436,10,3943.067751,219.059319,394.306775,86.159464,1,0
0,0,15,15,12,21,33,92,67,159,0.000333,0.267353,18,14437.05597,802.058665,802.058665,135.258216,1,0
0,0,15,15,12,19,31,82,58,140,0.000333,0.231196,18,12484.5747,693.587483,693.587483,123.730173,1,0
0,0,13,13,12,19,31,77,54,131,0.000333,0.216333,12,7787.9966,432.666478,648.999717,123.730173,1,0
0,0,9,9,11,12,23,34,28,62,0.000333,0.093487,10,2804.608413,155.811578,280.460841,81.073298,1,0
0,0,15,15,12,20,32,74,61,135,0.000333,0.225,18,12150,675,675,129.458112,1,0
0,0,15,15,12,18,30,64,52,116,0.000333,0.189733,12,6830.391709,379.466206,569.199309,118.0782,1,0
0,0,13,13,12,18,30,59,48,107,0.000333,0.175012,12,6300.447525,350.024862,525.037294,118.0782,1,0
0,0,7,7,11,10,21,29,23,52,0.000333,0.076134,10,2284.00506,126.88917,228.400506,71.273029,1,0
0,0,15,15,12,20,32,74,61,135,0.000333,0.225,18,12150,675,675,129.458112,1,0
0,0,15,15,12,18,30,64,52,116,0.000333,0.189733,12,6830.391709,379.466206,569.199309,118.0782,1,0
0,0,13,13,12,18,30,59,48,107,0.000333,0.175012,12,6300.447525,350.024862,525.037294,118.0782,1,0
0,0,2,2,7,5,12,9,7,16,0.000333,0.01912,3,172.0782,9.5599,57.3594,31.261125,1,0
0,0,2,2,7,5,12,9,7,16,0.000333,0.01912,3,172.0782,9.5599,57.3594,31.261125,1,0
0,0,2,2,7,5,12,9,7,16,0.000333,0.01912,3,172.0782,9.5599,57.3594,31.261125,1,0
0,0,2,2,7,5,12,9,7,16,0.000333,0.01912,3,172.0782,9.5599,57.3594,31.261125,1,0
0,0,2,2,7,5,12,9,7,16,0.000333,0.01912,3,172.0782,9.5599,57.3594,31.261125,1,0
0,0,2,2,7,5,12,9,7,16,0.000333,0.01912,3,172.0782,9.5599,57.3594,31.261125,1,0
0,0,2,2,7,5,12,9,7,16,0.000333,0.01912,3,172.0782,9.5599,57.3594,31.261125,1,0
0,0,2,2,7,5,12,9,7,16,0.000333,0.01912,3,172.0782,9.5599,57.3594,31.261125,1,0
0,0,2,2,7,5,12,9,7,16,0.000333,0.01912,3,172.0782,9.5599,57.3594,31.261125,1,0
0,0,8,8,11,11,22,49,30,79,0.000333,0.117432,10,3522.950979,195.719499,352.295098,76.107496,1,0
0,0,2,2,7,5,12,9,7,16,0.000333,0.01912,3,172.0782,9.5599,57.3594,31.261125,1,0
0,0,2,2,7,5,12,9,7,16,0.000333,0.01912,3,172.0782,9.5599,57.3594,31.261125,1,0
0,0,2,2,7,5,12,9,7,16,0.000333,0.01912,3,172.0782,9.5599,57.3594,31.261125,1,0
0,0,15,15,13,19,32,93,65,158,0.000333,0.263333,18,14220,790,790,128.816339,1,0
0,0,2,2,7,5,12,9,7,16,0.000333,0.01912,3,172.0782,9.5599,57.3594,31.261125,1,0
0,0,2,2,7,5,12,9,7,16,0.000333,0.01912,3,172.0782,9.5599,57.3594,31.261125,1,0
0,0,15,15,13,18,31,83,56,139,0.000333,0.229544,18,12395.39917,688.633287,688.633287,123.164366,1,0
0,0,2,2,7,5,12,9,7,16,0.000333,0.01912,3,172.0782,9.5599,57.3594,31.261125,1,0
0,0,2,2,7,5,12,9,7,16,0.000333,0.01912,3,172.0782,9.5599,57.3594,31.261125,1,0
0,0,13,13,12,18,30,78,52,130,0.000333,0.212632,12,7654.749329,425.263852,637.895777,118.0782,1,0
0,0,8,8,11,11,22,45,29,74,0.000333,0.109999,10,3299.979398,183.332189,329.99794,76.107496,1,0
0,0,2,2,7,5,12,9,7,16,0.000333,0.01912,3,172.0782,9.5599,57.3594,31.261125,1,0
0,0,2,2,7,5,12,9,7,16,0.000333,0.01912,3,172.0782,9.5599,57.3594,31.261125,1,0
0,0,15,15,13,19,32,85,63,148,0.000333,0.246667,18,13320,740,740,128.816339,1,0
0,0,2,2,7,5,12,9,7,16,0.000333,0.01912,3,172.0782,9.5599,57.3594,31.261125,1,0
0,0,15,15,13,19,32,85,63,148,0.000333,0.246667,18,13320,740,740,128.816339,1,0
0,0,15,15,13,18,31,75,54,129,0.000333,0.21303,18,11503.64383,639.091324,639.091324,123.164366,1,0
0,0,2,2,7,5,12,9,7,16,0.000333,0.01912,3,172.0782,9.5599,57.3594,31.261125,1,0
0,0,12,12,12,18,30,65,46,111,0.000333,0.181555,12,6535.978273,363.109904,544.664856,118.0782,1,0
0,0,2,2,7,5,12,9,7,16,0.000333,0.01912,3,172.0782,9.5599,57.3594,31.261125,1,0
0,0,8,8,11,11,22,46,30,76,0.000333,0.112972,10,3389.16803,188.287113,338.916803,76.107496,1,0
0,0,2,2,7,5,12,9,7,16,0.000333,0.01912,3,172.0782,9.5599,57.3594,31.261125,1,0
0,0,15,15,13,19,32,87,65,152,0.000333,0.253333,18,13680,760,760,128.816339,1,0
0,0,2,2,7,5,12,9,7,16,0.000333,0.01912,3,172.0782,9.5599,57.3594,31.261125,1,0
0,0,15,15,13,18,31,77,56,133,0.000333,0.219636,18,11860.34597,658.908109,658.908109,123.164366,1,0
0,0,2,2,7,5,12,9,7,16,0.000333,0.01912,3,172.0782,9.5599,57.3594,31.261125,1,0
0,0,15,15,12,18,30,80,58,138,0.000333,0.225717,18,12188.71624,677.150902,677.150902,118.0782,1,0
0,0,2,2,7,5,12,9,7,16,0.000333,0.01912,3,172.0782,9.5599,57.3594,31.261125,1,0
0,0,2,2,7,5,12,9,7,16,0.000333,0.01912,3,172.0782,9.5599,57.3594,31.261125,1,0
0,0,2,2,7,5,12,9,7,16,0.000333,0.01912,3,172.0782,9.5599,57.3594,31.261125,1,0
0,0,2,2,7,5,12,9,7,16,0.000333,0.01912,3,172.0782,9.5599,57.3594,31.261125,1,0
0,0,2,2,7,5,12,9,7,16,0.000333,0.01912,3,172.0782,9.5599,57.3594,31.261125,1,0
0,0,2,2,7,5,12,9,7,16,0.000333,0.01912,3,172.0782,9.5599,57.3594,31.261125,1,0
0,0,2,2,7,5,12,9,7,16,0.000333,0.01912,3,172.0782,9.5599,57.3594,31.261125,1,0
0,0,2,2,7,5,12,9,7,16,0.000333,0.01912,3,172.0782,9.5599,57.3594,31.261125,1,0
0,0,2,2,7,5,12,9,7,16,0.000333,0.01912,3,172.0782,9.5599,57.3594,31.261125,1,0
0,0,2,2,7,5,12,9,7,16,0.000333,0.01912,3,172.0782,9.5599,57.3594,31.261125,1,0
0,0,2,2,7,5,12,9,7,16,0.000333,0.01912,3,172.0782,9.5599,57.3594,31.261125,1,0
0,0,8,8,11,10,21,31,24,55,0.000333,0.080526,10,2415.774583,134.209699,241.577458,71.273029,1,0
0,0,2,2,7,5,12,9,7,16,0.000333,0.01912,3,172.0782,9.5599,57.3594,31.261125,1,0
0,0,2,2,7,5,12,9,7,16,0.000333,0.01912,3,172.0782,9.5599,57.3594,31.261125,1,0
0,0,15,15,13,18,31,75,59,134,0.000333,0.221287,18,11949.5215,663.862306,663.862306,123.164366,1,0
0,0,2,2,7,5,12,9,7,16,0.000333,0.01912,3,172.0782,9.5599,57.3594,31.261125,1,0
0,0,2,2,7,5,12,9,7,16,0.000333,0.01912,3,172.0782,9.5599,57.3594,31.261125,1,0
0,0,15,15,13,17,30,65,50,115,0.000333,0.188097,12,6771.509022,376.194946,564.292418,117.592585,1,0
0,0,2,2,7,5,12,9,7,16,0.000333,0.01912,3,172.0782,9.5599,57.3594,31.261125,1,0
0,0,2,2,7,5,12,9,7,16,0.000333,0.01912,3,172.0782,9.5599,57.3594,31.261125,1,0
0,0,13,13,12,17,29,60,46,106,0.000333,0.171649,12,6179.351826,343.297324,514.945985,112.506418,1,0
0,0,2,2,7,5,12,9,7,16,0.000333,0.01912,3,172.0782,9.5599,57.3594,31.261125,1,0
0,0,2,2,7,5,12,9,7,16,0.000333,0.01912,3,172.0782,9.5599,57.3594,31.261125,1,0
0,0,2,2,7,5,12,9,7,16,0.000333,0.01912,3,172.0782,9.5599,57.3594,31.261125,1,0
0,0,15,15,13,18,31,75,59,134,0.000333,0.221287,18,11949.5215,663.862306,663.862306,123.164366,1,0
0,0,2,2,7,5,12,9,7,16,0.000333,0.01912,3,172.0782,9.5599,57.3594,31.261125,1,0
0,0,2,2,7,5,12,9,7,16,0.000333,0.01912,3,172.0782,9.5599,57.3594,31.261125,1,0
0,0,15,15,13,17,30,65,50,115,0.000333,0.188097,12,6771.509022,376.194946,564.292418,117.592585,1,0
0,0,2,2,7,5,12,9,7,16,0.000333,0.01912,3,172.0782,9.5599,57.3594,31.261125,1,0
0,0,2,2,7,5,12,9,7,16,0.000333,0.01912,3,172.0782,9.5599,57.3594,31.261125,1,0
0,0,13,13,12,17,29,60,46,106,0.000333,0.171649,12,6179.351826,343.297324,514.945985,112.506418,1,0
0,0,8,8,10,10,20,27,23,50,0.000333,0.072032,10,2160.964047,120.053558,216.096405,66.438562,1,0
0,0,2,2,7,5,12,9,7,16,0.000333,0.01912,3,172.0782,9.5599,57.3594,31.261125,1,0
0,0,2,2,7,5,12,9,7,16,0.000333,0.01912,3,172.0782,9.5599,57.3594,31.261125,1,0
0,0,15,15,12,18,30,67,57,124,0.000333,0.202818,18,10952.17981,608.454434,608.454434,118.0782,1,0
0,0,2,2,7,5,12,9,7,16,0.000333,0.01912,3,172.0782,9.5599,57.3594,31.261125,1,0
0,0,15,15,12,17,29,57,48,105,0.000333,0.170029,12,6121.056054,340.05867,510.088004,112.506418,1,0
0,0,13,13,11,17,28,52,44,96,0.000333,0.153835,10,4615.060725,256.392263,461.506073,107.540616,1,0
0,0,2,2,7,5,12,9,7,16,0.000333,0.01912,3,172.0782,9.5599,57.3594,31.261125,1,0
0,0,8,8,10,10,20,28,24,52,0.000333,0.074913,10,2247.402609,124.855701,224.740261,66.438562,1,0
0,0,2,2,7,5,12,9,7,16,0.000333,0.01912,3,172.0782,9.5599,57.3594,31.261125,1,0
0,0,15,15,12,18,30,69,59,128,0.000333,0.209361,18,11305.47593,628.081996,628.081996,118.0782,1,0
0,0,2,2,7,5,12,9,7,16,0.000333,0.01912,3,172.0782,9.5599,57.3594,31.261125,1,0
0,0,15,15,12,17,29,59,50,109,0.000333,0.176507,12,6354.239142,353.013286,529.519928,112.506418,1,0
0,0,2,2,7,5,12,9,7,16,0.000333,0.01912,3,172.0782,9.5599,57.3594,31.261125,1,0
0,0,14,14,10,15,25,53,52,105,0.000333,0.162535,15,7314.073499,406.337417,487.6049,91.82264,1,0
0,0,2,2,9,6,15,11,7,18,0.000333,0.023441,4,281.296123,15.627562,70.324031,44.0391,1,0
0,0,2,2,9,5,14,11,7,18,0.000333,0.022844,4,274.129554,15.22942,68.532389,40.138965,1,0
0,0,4,4,10,6,16,19,14,33,0.000333,0.044,10,1320,73.333333,132,48.729056,1,0
0,0,9,9,11,11,22,39,30,69,0.000333,0.102567,10,3077.007817,170.944879,307.700782,76.107496,1,0
0,0,4,4,10,8,18,19,16,35,0.000333,0.048649,10,1459.473751,81.081875,145.947375,57.219281,1,0
0,0,4,4,11,7,18,18,13,31,0.000333,0.043089,5,646.338375,35.907688,129.267675,57.705232,1,0
0,0,4,4,11,9,20,18,15,33,0.000333,0.047541,5,713.118136,39.617674,142.623627,66.583073,1,0
0,0,8,8,11,12,23,36,28,64,0.000333,0.096503,10,2895.079652,160.837758,289.507965,81.073298,1,0
0,0,9,9,11,13,24,41,31,72,0.000333,0.110039,10,3301.173001,183.3985,330.1173,86.159464,1,0
0,0,2,2,9,5,14,11,7,18,0.000333,0.022844,4,274.129554,15.22942,68.532389,40.138965,1,0
0,0,2,2,9,6,15,11,7,18,0.000333,0.023441,4,281.296123,15.627562,70.324031,44.0391,1,0
0,0,2,2,9,5,14,11,7,18,0.000333,0.022844,4,274.129554,15.22942,68.532389,40.138965,1,0
0,0,10,10,11,14,25,50,35,85,0.000333,0.131576,10,3947.277761,219.293209,394.727776,91.356717,1,0
0,0,2,2,9,6,15,11,7,18,0.000333,0.023441,4,281.296123,15.627562,70.324031,44.0391,1,0
0,0,2,2,9,5,14,11,7,18,0.000333,0.022844,4,274.129554,15.22942,68.532389,40.138965,1,0
0,0,2,2,9,6,15,11,7,18,0.000333,0.023441,4,281.296123,15.627562,70.324031,44.0391,1,0
0,0,9,9,10,13,23,43,32,75,0.000333,0.113089,10,3392.671467,188.481748,339.267147,81.324997,1,0
0,0,11,11,10,15,25,50,38,88,0.000333,0.13622,10,4086.593447,227.032969,408.659345,91.82264,1,0
0,0,2,2,9,5,14,11,7,18,0.000333,0.022844,4,274.129554,15.22942,68.532389,40.138965,1,0
0,0,2,2,9,6,15,11,7,18,0.000333,0.023441,4,281.296123,15.627562,70.324031,44.0391,1,0
0,0,2,2,9,6,15,11,7,18,0.000333,0.023441,4,281.296123,15.627562,70.324031,44.0391,1,0
0,0,11,11,11,15,26,42,37,79,0.000333,0.123778,10,3713.347377,206.297077,371.334738,96.657107,1,0
0,0,2,2,9,5,14,11,7,18,0.000333,0.022844,4,274.129554,15.22942,68.532389,40.138965,1,0
0,0,2,2,9,5,14,11,7,18,0.000333,0.022844,4,274.129554,15.22942,68.532389,40.138965,1,0
0,0,10,10,10,17,27,35,38,73,0.000333,0.115702,10,3471.067877,192.837104,347.106788,102.706149,1,0
0,0,2,2,9,6,15,11,7,18,0.000333,0.023441,4,281.296123,15.627562,70.324031,44.0391,1,0
0,0,2,2,9,6,15,11,7,18,0.000333,0.023441,4,281.296123,15.627562,70.324031,44.0391,1,0
0,0,13,13,13,17,30,67,54,121,0.000333,0.197911,18,10687.20772,593.733762,593.733762,117.592585,1,0
0,0,2,2,9,5,14,11,7,18,0.000333,0.022844,4,274.129554,15.22942,68.532389,40.138965,1,0
0,0,2,2,9,6,15,11,7,18,0.000333,0.023441,4,281.296123,15.627562,70.324031,44.0391,1,0
0,0,13,13,13,16,29,57,45,102,0.000333,0.165171,12,5946.168738,330.342708,495.514062,112.105716,1,0
0,0,2,2,9,5,14,11,7,18,0.000333,0.022844,4,274.129554,15.22942,68.532389,40.138965,1,0
0,0,2,2,9,6,15,11,7,18,0.000333,0.023441,4,281.296123,15.627562,70.324031,44.0391,1,0
0,0,13,13,12,17,29,60,47,107,0.000333,0.173268,12,6237.647598,346.535978,519.803966,112.506418,1,0
0,0,2,2,9,5,14,11,7,18,0.000333,0.022844,4,274.129554,15.22942,68.532389,40.138965,1,0
0,0,6,6,11,9,20,31,20,51,0.000333,0.073473,10,2204.183328,122.454629,220.418333,66.583073,1,0
0,0,2,2,9,5,14,11,7,18,0.000333,0.022844,4,274.129554,15.22942,68.532389,40.138965,1,0
0,0,2,2,9,6,15,11,7,18,0.000333,0.023441,4,281.296123,15.627562,70.324031,44.0391,1,0
0,0,7,7,12,9,21,34,21,55,0.000333,0.080526,12,2898.929499,161.051639,241.577458,71.548875,2,0
0,0,8,8,13,10,23,35,21,56,0.000333,0.08444,12,3039.833634,168.879646,253.31947,81.324997,2,0
0,0,2,2,9,6,15,11,7,18,0.000333,0.023441,4,281.296123,15.627562,70.324031,44.0391,1,0
0,0,2,2,9,5,14,11,7,18,0.000333,0.022844,4,274.129554,15.22942,68.532389,40.138965,1,0
0,0,2,2,9,6,15,11,7,18,0.000333,0.023441,4,281.296123,15.627562,70.324031,44.0391,1,0
0,0,7,7,12,10,22,34,22,56,0.000333,0.083243,12,2996.738048,166.485447,249.728171,76.238831,2,0
0,0,8,8,14,10,24,36,22,58,0.000333,0.088643,14,3722.989551,206.832753,265.927825,86.52225,2,0
0,0,2,2,9,6,15,11,7,18,0.000333,0.023441,4,281.296123,15.627562,70.324031,44.0391,1,0
0,0,2,2,9,5,14,11,7,18,0.000333,0.022844,4,274.129554,15.22942,68.532389,40.138965,1,0
0,0,2,2,9,6,15,11,7,18,0.000333,0.023441,4,281.296123,15.627562,70.324031,44.0391,1,0
0,0,8,8,13,10,23,35,21,56,0.000333,0.08444,12,3039.833634,168.879646,253.31947,81.324997,2,0
0,0,7,7,12,10,22,34,21,55,0.000333,0.081756,12,2943.224868,163.512493,245.268739,76.238831,2,0
0,0,2,2,9,5,14,11,7,18,0.000333,0.022844,4,274.129554,15.22942,68.532389,40.138965,1,0
0,0,2,2,9,6,15,11,7,18,0.000333,0.023441,4,281.296123,15.627562,70.324031,44.0391,1,0
0,0,2,2,9,6,15,11,7,18,0.000333,0.023441,4,281.296123,15.627562,70.324031,44.0391,1,0
0,0,8,8,13,10,23,35,21,56,0.000333,0.08444,12,3039.833634,168.879646,253.31947,81.324997,2,0
0,0,7,7,12,10,22,34,21,55,0.000333,0.081756,12,2943.224868,163.512493,245.268739,76.238831,2,0
0,0,2,2,9,5,14,11,7,18,0.000333,0.022844,4,274.129554,15.22942,68.532389,40.138965,1,0
0,0,2,2,9,6,15,11,7,18,0.000333,0.023441,4,281.296123,15.627562,70.324031,44.0391,1,0
0,0,2,2,9,6,15,11,7,18,0.000333,0.023441,4,281.296123,15.627562,70.324031,44.0391,1,0
0,0,7,7,12,11,23,34,22,56,0.000333,0.08444,12,3039.833634,168.879646,253.31947,81.073298,2,0
0,0,8,8,14,11,25,36,22,58,0.000333,0.089781,14,3770.811226,209.489513,269.343659,91.356717,2,0
0,0,2,2,9,6,15,11,7,18,0.000333,0.023441,4,281.296123,15.627562,70.324031,44.0391,1,0
0,0,2,2,9,5,14,11,7,18,0.000333,0.022844,4,274.129554,15.22942,68.532389,40.138965,1,0
0,0,2,2,9,6,15,11,7,18,0.000333,0.023441,4,281.296123,15.627562,70.324031,44.0391,1,0
0,0,7,7,12,11,23,34,22,56,0.000333,0.08444,12,3039.833634,168.879646,253.31947,81.073298,2,0
0,0,8,8,14,11,25,36,22,58,0.000333,0.089781,14,3770.811226,209.489513,269.343659,91.356717,2,0
0,0,2,2,9,6,15,11,7,18,0.000333,0.023441,4,281.296123,15.627562,70.324031,44.0391,1,0
0,0,2,2,9,5,14,11,7,18,0.000333,0.022844,4,274.129554,15.22942,68.532389,40.138965,1,0
0,0,2,2,9,6,15,11,7,18,0.000333,0.023441,4,281.296123,15.627562,70.324031,44.0391,1,0
0,0,7,7,12,10,22,34,21,55,0.000333,0.081756,12,2943.224868,163.512493,245.268739,76.238831,2,0
0,0,8,8,13,10,23,35,21,56,0.000333,0.08444,12,3039.833634,168.879646,253.31947,81.324997,2,0
0,0,2,2,9,6,15,11,7,18,0.000333,0.023441,4,281.296123,15.627562,70.324031,44.0391,1,0
0,0,2,2,9,5,14,11,7,18,0.000333,0.022844,4,274.129554,15.22942,68.532389,40.138965,1,0
0,0,2,2,9,6,15,11,7,18,0.000333,0.023441,4,281.296123,15.627562,70.324031,44.0391,1,0
0,0,7,7,12,10,22,34,21,55,0.000333,0.081756,12,2943.224868,163.512493,245.268739,76.238831,2,0
0,0,8,8,13,10,23,35,21,56,0.000333,0.08444,12,3039.833634,168.879646,253.31947,81.324997,2,0
0,0,2,2,9,6,15,11,7,18,0.000333,0.023441,4,281.296123,15.627562,70.324031,44.0391,1,0
0,0,2,2,9,5,14,11,7,18,0.000333,0.022844,4,274.129554,15.22942,68.532389,40.138965,1,0
0,0,2,2,9,6,15,11,7,18,0.000333,0.023441,4,281.296123,15.627562,70.324031,44.0391,1,0
0,0,7,7,12,10,22,34,21,55,0.000333,0.081756,12,2943.224868,163.512493,245.268739,76.238831,2,0
0,0,8,8,13,10,23,35,21,56,0.000333,0.08444,12,3039.833634,168.879646,253.31947,81.324997,2,0
0,0,2,2,9,6,15,11,7,18,0.000333,0.023441,4,281.296123,15.627562,70.324031,44.0391,1,0
0,0,2,2,9,5,14,11,7,18,0.000333,0.022844,4,274.129554,15.22942,68.532389,40.138965,1,0
0,0,2,2,9,6,15,11,7,18,0.000333,0.023441,4,281.296123,15.627562,70.324031,44.0391,1,0
0,0,7,7,12,10,22,34,21,55,0.000333,0.081756,12,2943.224868,163.512493,245.268739,76.238831,2,0
0,0,8,8,13,10,23,35,21,56,0.000333,0.08444,12,3039.833634,168.879646,253.31947,81.324997,2,0
0,0,2,2,9,6,15,11,7,18,0.000333,0.023441,4,281.296123,15.627562,70.324031,44.0391,1,0
0,0,2,2,9,5,14,11,7,18,0.000333,0.022844,4,274.129554,15.22942,68.532389,40.138965,1,0
0,0,2,2,9,6,15,11,7,18,0.000333,0.023441,4,281.296123,15.627562,70.324031,44.0391,1,0
0,0,10,10,13,10,23,46,28,74,0.000333,0.111581,12,4016.923017,223.16239,334.743585,81.324997,2,0
0,0,2,2,9,6,15,11,7,18,0.000333,0.023441,4,281.296123,15.627562,70.324031,44.0391,1,0
0,0,2,2,9,6,15,11,7,18,0.000333,0.023441,4,281.296123,15.627562,70.324031,44.0391,1,0
0,0,2,2,9,6,15,11,7,18,0.000333,0.023441,4,281.296123,15.627562,70.324031,44.0391,1,0
0,0,2,2,9,5,14,11,7,18,0.000333,0.022844,4,274.129554,15.22942,68.532389,40.138965,1,0
0,0,7,7,12,11,23,34,22,56,0.000333,0.08444,12,3039.833634,168.879646,253.31947,81.073298,2,0
0,0,8,8,14,11,25,36,22,58,0.000333,0.089781,14,3770.811226,209.489513,269.343659,91.356717,2,0
0,0,2,2,9,6,15,11,7,18,0.000333,0.023441,4,281.296123,15.627562,70.324031,44.0391,1,0
0,0,2,2,9,5,14,11,7,18,0.000333,0.022844,4,274.129554,15.22942,68.532389,40.138965,1,0
0,0,2,2,9,6,15,11,7,18,0.000333,0.023441,4,281.296123,15.627562,70.324031,44.0391,1,0
0,0,7,7,12,11,23,34,22,56,0.000333,0.08444,12,3039.833634,168.879646,253.31947,81.073298,2,0
0,0,8,8,14,11,25,36,22,58,0.000333,0.089781,14,3770.811226,209.489513,269.343659,91.356717,2,0
0,0,2,2,9,6,15,11,7,18,0.000333,0.023441,4,281.296123,15.627562,70.324031,44.0391,1,0
0,0,2,2,9,5,14,11,7,18,0.000333,0.022844,4,274.129554,15.22942,68.532389,40.138965,1,0
0,0,2,2,9,6,15,11,7,18,0.000333,0.023441,4,281.296123,15.627562,70.324031,44.0391,1,0
0,0,8,8,14,10,24,36,21,57,0.000333,0.087114,14,3658.800076,203.266671,261.342863,86.52225,2,0
0,0,8,8,14,10,24,36,22,58,0.000333,0.088643,14,3722.989551,206.832753,265.927825,86.52225,2,0
0,0,2,2,9,6,15,11,7,18,0.000333,0.023441,4,281.296123,15.627562,70.324031,44.0391,1,0
0,0,2,2,9,6,15,11,7,18,0.000333,0.023441,4,281.296123,15.627562,70.324031,44.0391,1,0
0,0,2,2,9,5,14,11,7,18,0.000333,0.022844,4,274.129554,15.22942,68.532389,40.138965,1,0
0,0,7,7,12,9,21,34,21,55,0.000333,0.080526,12,2898.929499,161.051639,241.577458,71.548875,2,0
0,0,3,3,9,5,14,16,10,26,0.000333,0.032997,8,791.929824,43.996101,98.991228,40.138965,1,0
0,0,3,3,9,6,15,16,10,26,0.000333,0.03386,4,406.316622,22.573146,101.579155,44.0391,1,0
0,0,7,7,14,11,25,39,25,64,0.000333,0.099069,14,4160.895146,231.160841,297.206796,91.356717,2,0
0,0,3,3,9,6,15,16,10,26,0.000333,0.03386,4,406.316622,22.573146,101.579155,44.0391,1,0
0,0,3,3,9,5,14,16,10,26,0.000333,0.032997,8,791.929824,43.996101,98.991228,40.138965,1,0
0,0,8,8,13,10,23,34,22,56,0.000333,0.08444,12,3039.833634,168.879646,253.31947,81.324997,1,0
0,0,2,2,9,6,15,11,7,18,0.000333,0.023441,4,281.296123,15.627562,70.324031,44.0391,1,0
0,0,2,2,9,5,14,11,7,18,0.000333,0.022844,4,274.129554,15.22942,68.532389,40.138965,1,0
0,0,12,12,15,14,29,48,39,87,0.000333,0.140881,14,5917.020852,328.723381,422.644347,111.906328,2,0
0,0,11,11,14,13,27,47,39,86,0.000333,0.136307,21,8587.326829,477.073713,408.920325,101.408685,2,0
0,0,4,4,11,9,20,20,18,38,0.000333,0.054744,10,1642.332676,91.240704,164.233268,66.583073,1,0
0,0,4,4,11,9,20,20,18,38,0.000333,0.054744,10,1642.332676,91.240704,164.233268,66.583073,1,0
0,0,4,4,11,6,17,20,14,34,0.000333,0.046325,10,1389.737366,77.207631,138.973737,53.563523,1,0
0,0,11,11,13,13,26,46,39,85,0.000333,0.133179,18,7191.672769,399.537376,399.537376,96.211433,2,0
0,0,12,12,14,14,28,47,39,86,0.000333,0.137811,14,5788.055326,321.558629,413.432523,106.605938,2,0
0,0,2,2,6,8,14,10,10,20,0.000333,0.025382,3,228.441295,12.691183,76.147098,39.509775,1,0
0,0,2,2,6,6,12,10,8,18,0.000333,0.02151,3,193.587975,10.754888,64.529325,31.01955,1,0
0,0,4,4,10,9,19,19,18,37,0.000333,0.052391,10,1571.73318,87.31851,157.173318,61.748606,1,0
0,0,8,8,11,10,21,36,26,62,0.000333,0.090775,10,2723.236802,151.290933,272.32368,71.273029,1,0
0,0,2,2,9,6,15,11,7,18,0.000333,0.023441,4,281.296123,15.627562,70.324031,44.0391,1,0
0,0,2,2,9,5,14,11,7,18,0.000333,0.022844,4,274.129554,15.22942,68.532389,40.138965,1,0
0,0,11,11,12,11,23,52,34,86,0.000333,0.129675,18,7002.473908,389.026328,389.026328,81.073298,1,0
0,0,2,2,9,6,15,11,7,18,0.000333,0.023441,4,281.296123,15.627562,70.324031,44.0391,1,0
0,0,2,2,9,5,14,11,7,18,0.000333,0.022844,4,274.129554,15.22942,68.532389,40.138965,1,0
0,0,8,8,12,10,22,38,26,64,0.000333,0.095135,12,3424.843483,190.269082,285.403624,76.238831,1,0
0,0,2,2,9,6,15,11,7,18,0.000333,0.023441,4,281.296123,15.627562,70.324031,44.0391,1,0
0,0,2,2,9,5,14,11,7,18,0.000333,0.022844,4,274.129554,15.22942,68.532389,40.138965,1,0
0,0,9,9,12,13,25,39,29,68,0.000333,0.105261,12,3789.386651,210.521481,315.782221,91.125266,1,0
0,0,2,2,9,6,15,11,7,18,0.000333,0.023441,4,281.296123,15.627562,70.324031,44.0391,1,0
0,0,2,2,9,5,14,11,7,18,0.000333,0.022844,4,274.129554,15.22942,68.532389,40.138965,1,0
0,0,8,8,11,12,23,37,28,65,0.000333,0.098011,10,2940.315271,163.350848,294.031527,81.073298,1,0
0,0,2,2,9,6,15,11,7,18,0.000333,0.023441,4,281.296123,15.627562,70.324031,44.0391,1,0
0,0,2,2,9,5,14,11,7,18,0.000333,0.022844,4,274.129554,15.22942,68.532389,40.138965,1,0
0,0,9,9,13,11,24,42,30,72,0.000333,0.110039,12,3961.407601,220.0782,330.1173,86.159464,1,0
0,0,4,4,11,8,19,20,16,36,0.000333,0.050975,10,1529.253905,84.95855,152.92539,62.053748,1,0
0,0,4,4,11,6,17,20,14,34,0.000333,0.046325,10,1389.737366,77.207631,138.973737,53.563523,1,0
0,0,8,8,13,12,25,39,28,67,0.000333,0.103713,12,3733.660377,207.425576,311.138365,91.125266,1,0
0,0,4,4,12,9,21,19,15,34,0.000333,0.04978,6,896.032754,49.779597,149.338792,71.548875,1,0
0,0,4,4,11,7,18,18,13,31,0.000333,0.043089,5,646.338375,35.907688,129.267675,57.705232,1,0
0,0,9,9,12,13,25,46,32,78,0.000333,0.12074,12,4346.649394,241.480522,362.220783,91.125266,1,0
0,0,2,2,9,6,15,11,7,18,0.000333,0.023441,4,281.296123,15.627562,70.324031,44.0391,1,0
0,0,2,2,9,5,14,11,7,18,0.000333,0.022844,4,274.129554,15.22942,68.532389,40.138965,1,0
0,0,10,10,12,13,25,38,32,70,0.000333,0.108357,12,3900.839199,216.713289,325.069933,91.125266,1,0
0,0,2,2,9,5,14,11,7,18,0.000333,0.022844,4,274.129554,15.22942,68.532389,40.138965,1,0
0,0,2,2,9,6,15,11,7,18,0.000333,0.023441,4,281.296123,15.627562,70.324031,44.0391,1,0
0,0,8,8,11,12,23,37,28,65,0.000333,0.098011,10,2940.315271,163.350848,294.031527,81.073298,1,0
0,0,2,2,9,6,15,11,7,18,0.000333,0.023441,4,281.296123,15.627562,70.324031,44.0391,1,0
0,0,2,2,9,5,14,11,7,18,0.000333,0.022844,4,274.129554,15.22942,68.532389,40.138965,1,0
0,0,10,10,11,13,24,43,36,79,0.000333,0.120737,10,3622.120376,201.22891,362.212038,86.159464,1,0
0,0,2,2,9,6,15,11,7,18,0.000333,0.023441,4,281.296123,15.627562,70.324031,44.0391,1,0
0,0,2,2,9,5,14,11,7,18,0.000333,0.022844,4,274.129554,15.22942,68.532389,40.138965,1,0
0,0,12,12,11,14,25,49,44,93,0.000333,0.14396,15,6478.179385,359.898855,431.878626,91.356717,1,0
0,0,2,2,9,6,15,11,7,18,0.000333,0.023441,4,281.296123,15.627562,70.324031,44.0391,1,0
0,0,2,2,9,5,14,11,7,18,0.000333,0.022844,4,274.129554,15.22942,68.532389,40.138965,1,0
0,0,14,14,11,15,26,55,52,107,0.000333,0.167649,15,7544.205748,419.122542,502.94705,96.657107,1,0
0,0,2,2,9,6,15,11,7,18,0.000333,0.023441,4,281.296123,15.627562,70.324031,44.0391,1,0
0,0,2,2,9,5,14,11,7,18,0.000333,0.022844,4,274.129554,15.22942,68.532389,40.138965,1,0
0,0,9,9,12,11,23,41,30,71,0.000333,0.107058,12,3854.074787,214.115266,321.172899,81.073298,1,0
0,0,2,2,6,6,12,10,8,18,0.000333,0.02151,3,193.587975,10.754888,64.529325,31.01955,1,0
0,0,4,4,10,8,18,19,16,35,0.000333,0.048649,10,1459.473751,81.081875,145.947375,57.219281,1,0
0,0,8,8,12,12,24,38,28,66,0.000333,0.100869,12,3631.290301,201.73835,302.607525,86.0391,1,0
0,0,2,2,7,7,14,10,8,18,0.000333,0.022844,3,205.597166,11.422065,68.532389,39.302969,1,0
0,0,4,4,11,9,20,18,15,33,0.000333,0.047541,5,713.118136,39.617674,142.623627,66.583073,1,0
0,0,9,9,12,13,25,43,31,74,0.000333,0.114548,12,4123.744297,229.096905,343.645358,91.125266,1,0
0,0,2,2,9,6,15,11,7,18,0.000333,0.023441,4,281.296123,15.627562,70.324031,44.0391,1,0
0,0,2,2,9,5,14,11,7,18,0.000333,0.022844,4,274.129554,15.22942,68.532389,40.138965,1,0
0,0,10,10,12,14,26,52,35,87,0.000333,0.136313,12,4907.259066,272.625504,408.938255,96.322519,1,0
0,0,2,2,9,6,15,11,7,18,0.000333,0.023441,4,281.296123,15.627562,70.324031,44.0391,1,0
0,0,2,2,9,5,14,11,7,18,0.000333,0.022844,4,274.129554,15.22942,68.532389,40.138965,1,0
0,0,9,9,11,13,24,45,32,77,0.000333,0.117681,10,3530.421126,196.134507,353.042113,86.159464,1,0
0,0,2,2,9,5,14,11,7,18,0.000333,0.022844,4,274.129554,15.22942,68.532389,40.138965,1,0
0,0,2,2,9,6,15,11,7,18,0.000333,0.023441,4,281.296123,15.627562,70.324031,44.0391,1,0
0,0,11,11,11,15,26,52,38,90,0.000333,0.141013,10,4230.395746,235.021986,423.039575,96.657107,1,0
0,0,2,2,9,6,15,11,7,18,0.000333,0.023441,4,281.296123,15.627562,70.324031,44.0391,1,0
0,0,2,2,9,5,14,11,7,18,0.000333,0.022844,4,274.129554,15.22942,68.532389,40.138965,1,0
0,0,11,11,12,15,27,44,37,81,0.000333,0.128382,12,4621.750652,256.763925,385.145888,101.622909,1,0
0,0,2,2,9,6,15,11,7,18,0.000333,0.023441,4,281.296123,15.627562,70.324031,44.0391,1,0
0,0,2,2,9,5,14,11,7,18,0.000333,0.022844,4,274.129554,15.22942,68.532389,40.138965,1,0
0,0,10,10,11,17,28,37,38,75,0.000333,0.120184,10,3605.516192,200.306455,360.551619,107.540616,1,0
0,0,2,2,9,6,15,11,7,18,0.000333,0.023441,4,281.296123,15.627562,70.324031,44.0391,1,0
0,0,2,2,9,5,14,11,7,18,0.000333,0.022844,4,274.129554,15.22942,68.532389,40.138965,1,0
0,0,13,13,14,17,31,69,54,123,0.000333,0.203122,21,12796.68907,710.927171,609.366146,122.789837,1,0
0,0,2,2,9,6,15,11,7,18,0.000333,0.023441,4,281.296123,15.627562,70.324031,44.0391,1,0
0,0,2,2,9,5,14,11,7,18,0.000333,0.022844,4,274.129554,15.22942,68.532389,40.138965,1,0
0,0,13,13,14,16,30,59,45,104,0.000333,0.170106,14,7144.432707,396.912928,510.316622,117.302969,1,0
0,0,2,2,9,6,15,11,7,18,0.000333,0.023441,4,281.296123,15.627562,70.324031,44.0391,1,0
0,0,2,2,9,5,14,11,7,18,0.000333,0.022844,4,274.129554,15.22942,68.532389,40.138965,1,0
0,0,13,13,13,17,30,62,47,109,0.000333,0.178284,12,6418.212899,356.567383,534.851075,117.592585,1,0
0,0,2,2,9,6,15,11,7,18,0.000333,0.023441,4,281.296123,15.627562,70.324031,44.0391,1,0
0,0,2,2,9,5,14,11,7,18,0.000333,0.022844,4,274.129554,15.22942,68.532389,40.138965,1,0
0,0,2,2,9,6,15,11,7,18,0.000333,0.023441,4,281.296123,15.627562,70.324031,44.0391,1,0
0,0,2,2,9,5,14,11,7,18,0.000333,0.022844,4,274.129554,15.22942,68.532389,40.138965,1,0
0,0,6,6,11,9,20,33,21,54,0.000333,0.077795,10,2333.841171,129.657843,233.384117,66.583073,1,0
0,0,2,2,9,6,15,11,7,18,0.000333,0.023441,4,281.296123,15.627562,70.324031,44.0391,1,0
0,0,2,2,9,6,15,11,7,18,0.000333,0.023441,4,281.296123,15.627562,70.324031,44.0391,1,0
0,0,2,2,9,5,14,11,7,18,0.000333,0.022844,4,274.129554,15.22942,68.532389,40.138965,1,0
0,0,8,8,13,10,23,37,22,59,0.000333,0.088963,12,3202.681865,177.92677,266.890155,81.324997,2,0
0,0,7,7,12,9,21,36,22,58,0.000333,0.084918,12,3057.052926,169.836274,254.754411,71.548875,2,0
0,0,2,2,9,6,15,11,7,18,0.000333,0.023441,4,281.296123,15.627562,70.324031,44.0391,1,0
0,0,2,2,9,6,15,11,7,18,0.000333,0.023441,4,281.296123,15.627562,70.324031,44.0391,1,0
0,0,2,2,9,5,14,11,7,18,0.000333,0.022844,4,274.129554,15.22942,68.532389,40.138965,1,0
0,0,8,8,14,10,24,38,23,61,0.000333,0.093228,14,3915.557976,217.530999,279.682713,86.52225,2,0
0,0,7,7,12,10,22,36,23,59,0.000333,0.087702,12,3157.277586,175.40431,263.106465,76.238831,2,0
0,0,2,2,9,6,15,11,7,18,0.000333,0.023441,4,281.296123,15.627562,70.324031,44.0391,1,0
0,0,2,2,9,5,14,11,7,18,0.000333,0.022844,4,274.129554,15.22942,68.532389,40.138965,1,0
0,0,8,8,12,11,23,36,23,59,0.000333,0.088963,12,3202.681865,177.92677,266.890155,81.073298,2,0
0,0,7,7,12,10,22,36,22,58,0.000333,0.086216,12,3103.764407,172.431356,258.647034,76.238831,2,0
0,0,2,2,9,6,15,11,7,18,0.000333,0.023441,4,281.296123,15.627562,70.324031,44.0391,1,0
0,0,2,2,9,6,15,11,7,18,0.000333,0.023441,4,281.296123,15.627562,70.324031,44.0391,1,0
0,0,2,2,9,5,14,11,7,18,0.000333,0.022844,4,274.129554,15.22942,68.532389,40.138965,1,0
0,0,8,8,12,11,23,36,23,59,0.000333,0.088963,12,3202.681865,177.92677,266.890155,81.073298,2,0
0,0,7,7,12,10,22,36,22,58,0.000333,0.086216,12,3103.764407,172.431356,258.647034,76.238831,2,0
0,0,2,2,9,6,15,11,7,18,0.000333,0.023441,4,281.296123,15.627562,70.324031,44.0391,1,0
0,0,7,7,12,11,23,36,23,59,0.000333,0.088963,12,3202.681865,177.92677,266.890155,81.073298,2,0
0,0,2,2,9,5,14,11,7,18,0.000333,0.022844,4,274.129554,15.22942,68.532389,40.138965,1,0
0,0,8,8,13,12,25,37,24,61,0.000333,0.094425,12,3399.302731,188.850152,283.275228,91.125266,2,0
0,0,2,2,9,6,15,11,7,18,0.000333,0.023441,4,281.296123,15.627562,70.324031,44.0391,1,0
0,0,2,2,9,6,15,11,7,18,0.000333,0.023441,4,281.296123,15.627562,70.324031,44.0391,1,0
0,0,7,7,12,11,23,36,23,59,0.000333,0.088963,12,3202.681865,177.92677,266.890155,81.073298,2,0
0,0,2,2,9,5,14,11,7,18,0.000333,0.022844,4,274.129554,15.22942,68.532389,40.138965,1,0
0,0,8,8,14,11,25,38,23,61,0.000333,0.094425,14,3965.853186,220.325177,283.275228,91.356717,2,0
0,0,2,2,9,6,15,11,7,18,0.000333,0.023441,4,281.296123,15.627562,70.324031,44.0391,1,0
0,0,2,2,9,6,15,11,7,18,0.000333,0.023441,4,281.296123,15.627562,70.324031,44.0391,1,0
0,0,7,7,12,10,22,36,22,58,0.000333,0.086216,12,3103.764407,172.431356,258.647034,76.238831,2,0
0,0,2,2,9,6,15,11,7,18,0.000333,0.023441,4,281.296123,15.627562,70.324031,44.0391,1,0
0,0,8,8,13,10,23,37,22,59,0.000333,0.088963,12,3202.681865,177.92677,266.890155,81.324997,2,0
0,0,2,2,9,5,14,11,7,18,0.000333,0.022844,4,274.129554,15.22942,68.532389,40.138965,1,0
0,0,2,2,9,6,15,11,7,18,0.000333,0.023441,4,281.296123,15.627562,70.324031,44.0391,1,0
0,0,2,2,9,6,15,11,7,18,0.000333,0.023441,4,281.296123,15.627562,70.324031,44.0391,1,0
0,0,2,2,9,6,15,11,7,18,0.000333,0.023441,4,281.296123,15.627562,70.324031,44.0391,1,0
0,0,2,2,9,5,14,11,7,18,0.000333,0.022844,4,274.129554,15.22942,68.532389,40.138965,1,0
0,0,8,8,13,10,23,37,22,59,0.000333,0.088963,12,3202.681865,177.92677,266.890155,81.324997,2,0
0,0,7,7,12,10,22,36,22,58,0.000333,0.086216,12,3103.764407,172.431356,258.647034,76.238831,2,0
0,0,2,2,9,6,15,11,7,18,0.000333,0.023441,4,281.296123,15.627562,70.324031,44.0391,1,0
0,0,2,2,9,6,15,11,7,18,0.000333,0.023441,4,281.296123,15.627562,70.324031,44.0391,1,0
0,0,2,2,9,5,14,11,7,18,0.000333,0.022844,4,274.129554,15.22942,68.532389,40.138965,1,0
0,0,8,8,13,10,23,37,22,59,0.000333,0.088963,12,3202.681865,177.92677,266.890155,81.324997,2,0
0,0,7,7,12,10,22,36,22,58,0.000333,0.086216,12,3103.764407,172.431356,258.647034,76.238831,2,0
0,0,2,2,9,6,15,11,7,18,0.000333,0.023441,4,281.296123,15.627562,70.324031,44.0391,1,0
0,0,2,2,9,6,15,11,7,18,0.000333,0.023441,4,281.296123,15.627562,70.324031,44.0391,1,0
0,0,2,2,9,5,14,11,7,18,0.000333,0.022844,4,274.129554,15.22942,68.532389,40.138965,1,0
0,0,8,8,13,10,23,37,22,59,0.000333,0.088963,12,3202.681865,177.92677,266.890155,81.324997,2,0
0,0,7,7,12,10,22,36,22,58,0.000333,0.086216,12,3103.764407,172.431356,258.647034,76.238831,2,0
0,0,2,2,9,6,15,11,7,18,0.000333,0.023441,4,281.296123,15.627562,70.324031,44.0391,1,0
0,0,10,10,13,10,23,48,29,77,0.000333,0.116105,12,4179.771247,232.209514,348.314271,81.324997,2,0
0,0,2,2,9,5,14,11,7,18,0.000333,0.022844,4,274.129554,15.22942,68.532389,40.138965,1,0
0,0,2,2,9,6,15,11,7,18,0.000333,0.023441,4,281.296123,15.627562,70.324031,44.0391,1,0
0,0,2,2,9,6,15,11,7,18,0.000333,0.023441,4,281.296123,15.627562,70.324031,44.0391,1,0
0,0,2,2,9,6,15,11,7,18,0.000333,0.023441,4,281.296123,15.627562,70.324031,44.0391,1,0
0,0,2,2,9,6,15,11,7,18,0.000333,0.023441,4,281.296123,15.627562,70.324031,44.0391,1,0
0,0,2,2,9,5,14,11,7,18,0.000333,0.022844,4,274.129554,15.22942,68.532389,40.138965,1,0
0,0,8,8,14,11,25,38,23,61,0.000333,0.094425,14,3965.853186,220.325177,283.275228,91.356717,2,0
0,0,7,7,12,11,23,36,23,59,0.000333,0.088963,12,3202.681865,177.92677,266.890155,81.073298,2,0
0,0,2,2,9,6,15,11,7,18,0.000333,0.023441,4,281.296123,15.627562,70.324031,44.0391,1,0
0,0,2,2,9,6,15,11,7,18,0.000333,0.023441,4,281.296123,15.627562,70.324031,44.0391,1,0
0,0,2,2,9,5,14,11,7,18,0.000333,0.022844,4,274.129554,15.22942,68.532389,40.138965,1,0
0,0,8,8,14,11,25,38,23,61,0.000333,0.094425,14,3965.853186,220.325177,283.275228,91.356717,2,0
0,0,7,7,12,11,23,36,23,59,0.000333,0.088963,12,3202.681865,177.92677,266.890155,81.073298,2,0
0,0,8,8,14,10,24,38,23,61,0.000333,0.093228,14,3915.557976,217.530999,279.682713,86.52225,2,0
0,0,2,2,9,6,15,11,7,18,0.000333,0.023441,4,281.296123,15.627562,70.324031,44.0391,1,0
0,0,8,8,14,10,24,38,22,60,0.000333,0.091699,14,3851.368501,213.964917,275.09775,86.52225,2,0
0,0,2,2,9,6,15,11,7,18,0.000333,0.023441,4,281.296123,15.627562,70.324031,44.0391,1,0
0,0,2,2,9,5,14,11,7,18,0.000333,0.022844,4,274.129554,15.22942,68.532389,40.138965,1,0
0,0,3,3,9,5,14,16,10,26,0.000333,0.032997,8,791.929824,43.996101,98.991228,40.138965,1,0
0,0,3,3,9,6,15,16,10,26,0.000333,0.03386,4,406.316622,22.573146,101.579155,44.0391,1,0
0,0,7,7,12,9,21,36,22,58,0.000333,0.084918,12,3057.052926,169.836274,254.754411,71.548875,2,0
0,0,3,3,9,5,14,16,10,26,0.000333,0.032997,8,791.929824,43.996101,98.991228,40.138965,1,0
0,0,3,3,9,6,15,16,10,26,0.000333,0.03386,4,406.316622,22.573146,101.579155,44.0391,1,0
0,0,7,7,14,11,25,41,26,67,0.000333,0.103713,14,4355.937106,241.996506,311.138365,91.356717,2,0
0,0,2,2,9,5,14,11,7,18,0.000333,0.022844,4,274.129554,15.22942,68.532389,40.138965,1,0
0,0,8,8,13,10,23,36,23,59,0.000333,0.088963,12,3202.681865,177.92677,266.890155,81.324997,1,0
0,0,2,2,9,6,15,11,7,18,0.000333,0.023441,4,281.296123,15.627562,70.324031,44.0391,1,0
0,0,4,4,11,9,20,20,18,38,0.000333,0.054744,10,1642.332676,91.240704,164.233268,66.583073,1,0
0,0,4,4,11,6,17,20,14,34,0.000333,0.046325,10,1389.737366,77.207631,138.973737,53.563523,1,0
0,0,11,11,14,13,27,49,40,89,0.000333,0.141062,21,8886.884742,493.715819,423.184988,101.408685,2,0
0,0,12,12,15,14,29,50,40,90,0.000333,0.145739,14,6121.056054,340.05867,437.21829,111.906328,2,0
0,0,4,4,11,9,20,20,18,38,0.000333,0.054744,10,1642.332676,91.240704,164.233268,66.583073,1,0
0,0,12,12,14,14,28,49,40,89,0.000333,0.142618,14,5989.964233,332.775791,427.854588,106.605938,2,0
0,0,2,2,6,6,12,10,8,18,0.000333,0.02151,3,193.587975,10.754888,64.529325,31.01955,1,0
0,0,4,4,10,9,19,19,18,37,0.000333,0.052391,10,1571.73318,87.31851,157.173318,61.748606,1,0
0,0,2,2,6,8,14,10,10,20,0.000333,0.025382,3,228.441295,12.691183,76.147098,39.509775,1,0
0,0,11,11,13,13,26,48,40,88,0.000333,0.13788,18,7445.496514,413.638695,413.638695,96.211433,2,0
0,0,2,2,9,5,14,11,7,18,0.000333,0.022844,4,274.129554,15.22942,68.532389,40.138965,1,0
0,0,8,8,11,10,21,39,27,66,0.000333,0.096631,10,2898.929499,161.051639,289.89295,71.273029,1,0
0,0,2,2,9,6,15,11,7,18,0.000333,0.023441,4,281.296123,15.627562,70.324031,44.0391,1,0
0,0,2,2,9,6,15,11,7,18,0.000333,0.023441,4,281.296123,15.627562,70.324031,44.0391,1,0
0,0,2,2,9,5,14,11,7,18,0.000333,0.022844,4,274.129554,15.22942,68.532389,40.138965,1,0
0,0,11,11,12,11,23,54,35,89,0.000333,0.134199,18,7246.746254,402.597014,402.597014,81.073298,1,0
0,0,2,2,9,6,15,11,7,18,0.000333,0.023441,4,281.296123,15.627562,70.324031,44.0391,1,0
0,0,2,2,9,5,14,11,7,18,0.000333,0.022844,4,274.129554,15.22942,68.532389,40.138965,1,0
0,0,8,8,12,10,22,40,27,67,0.000333,0.099594,12,3585.383021,199.187946,298.781918,76.238831,1,0
0,0,2,2,9,5,14,11,7,18,0.000333,0.022844,4,274.129554,15.22942,68.532389,40.138965,1,0
0,0,2,2,9,6,15,11,7,18,0.000333,0.023441,4,281.296123,15.627562,70.324031,44.0391,1,0
0,0,9,9,12,13,25,41,30,71,0.000333,0.109905,12,3956.565474,219.809193,329.713789,91.125266,1,0
0,0,2,2,9,5,14,11,7,18,0.000333,0.022844,4,274.129554,15.22942,68.532389,40.138965,1,0
0,0,2,2,9,6,15,11,7,18,0.000333,0.023441,4,281.296123,15.627562,70.324031,44.0391,1,0
0,0,8,8,11,12,23,39,29,68,0.000333,0.102534,10,3076.02213,170.890118,307.602213,81.073298,1,0
0,0,4,4,11,8,19,20,16,36,0.000333,0.050975,10,1529.253905,84.95855,152.92539,62.053748,1,0
0,0,9,9,13,11,24,44,31,75,0.000333,0.114624,12,4126.466251,229.248125,343.872188,86.159464,1,0
0,0,4,4,11,6,17,20,14,34,0.000333,0.046325,10,1389.737366,77.207631,138.973737,53.563523,1,0
0,0,4,4,12,9,21,19,15,34,0.000333,0.04978,6,896.032754,49.779597,149.338792,71.548875,1,0
0,0,4,4,11,7,18,18,13,31,0.000333,0.043089,5,646.338375,35.907688,129.267675,57.705232,1,0
0,0,8,8,13,12,25,41,29,70,0.000333,0.108357,12,3900.839199,216.713289,325.069933,91.125266,1,0
0,0,2,2,9,6,15,11,7,18,0.000333,0.023441,4,281.296123,15.627562,70.324031,44.0391,1,0
0,0,9,9,12,13,25,48,33,81,0.000333,0.125384,12,4513.828216,250.768234,376.152351,91.125266,1,0
0,0,2,2,9,5,14,11,7,18,0.000333,0.022844,4,274.129554,15.22942,68.532389,40.138965,1,0
0,0,10,10,12,13,25,40,33,73,0.000333,0.113001,12,4068.018022,226.001001,339.001502,91.125266,1,0
0,0,2,2,9,6,15,11,7,18,0.000333,0.023441,4,281.296123,15.627562,70.324031,44.0391,1,0
0,0,2,2,9,5,14,11,7,18,0.000333,0.022844,4,274.129554,15.22942,68.532389,40.138965,1,0
0,0,2,2,9,6,15,11,7,18,0.000333,0.023441,4,281.296123,15.627562,70.324031,44.0391,1,0
0,0,8,8,11,12,23,39,29,68,0.000333,0.102534,10,3076.02213,170.890118,307.602213,81.073298,1,0
0,0,2,2,9,5,14,11,7,18,0.000333,0.022844,4,274.129554,15.22942,68.532389,40.138965,1,0
0,0,10,10,11,13,24,45,37,82,0.000333,0.125322,10,3759.669251,208.870514,375.966925,86.159464,1,0
0,0,2,2,9,5,14,11,7,18,0.000333,0.022844,4,274.129554,15.22942,68.532389,40.138965,1,0
0,0,2,2,9,6,15,11,7,18,0.000333,0.023441,4,281.296123,15.627562,70.324031,44.0391,1,0
0,0,12,12,11,14,25,51,45,96,0.000333,0.148603,15,6687.152913,371.508495,445.810194,91.356717,1,0
0,0,2,2,9,5,14,11,7,18,0.000333,0.022844,4,274.129554,15.22942,68.532389,40.138965,1,0
0,0,2,2,9,6,15,11,7,18,0.000333,0.023441,4,281.296123,15.627562,70.324031,44.0391,1,0
0,0,14,14,11,15,26,57,53,110,0.000333,0.172349,15,7755.725535,430.873641,517.048369,96.657107,1,0
0,0,2,2,9,5,14,11,7,18,0.000333,0.022844,4,274.129554,15.22942,68.532389,40.138965,1,0
0,0,2,2,9,6,15,11,7,18,0.000333,0.023441,4,281.296123,15.627562,70.324031,44.0391,1,0
0,0,4,4,10,8,18,19,16,35,0.000333,0.048649,10,1459.473751,81.081875,145.947375,57.219281,1,0
0,0,2,2,6,6,12,10,8,18,0.000333,0.02151,3,193.587975,10.754888,64.529325,31.01955,1,0
0,0,9,9,12,11,23,43,31,74,0.000333,0.111581,12,4016.923017,223.16239,334.743585,81.073298,1,0
0,0,2,2,7,7,14,10,8,18,0.000333,0.022844,3,205.597166,11.422065,68.532389,39.302969,1,0
0,0,8,8,12,12,24,40,29,69,0.000333,0.105454,12,3796.348951,210.908275,316.362413,86.0391,1,0
0,0,4,4,11,9,20,18,15,33,0.000333,0.047541,5,713.118136,39.617674,142.623627,66.583073,1,0
0,0,9,9,12,13,25,45,32,77,0.000333,0.119192,12,4290.923119,238.384618,357.576927,91.125266,1,0
0,0,2,2,9,6,15,11,7,18,0.000333,0.023441,4,281.296123,15.627562,70.324031,44.0391,1,0
0,0,2,2,9,5,14,11,7,18,0.000333,0.022844,4,274.129554,15.22942,68.532389,40.138965,1,0
0,0,2,2,9,6,15,11,7,18,0.000333,0.023441,4,281.296123,15.627562,70.324031,44.0391,1,0
0,0,10,10,12,14,26,54,36,90,0.000333,0.141013,12,5076.474896,282.026383,423.039575,96.322519,1,0
0,0,2,2,9,5,14,11,7,18,0.000333,0.022844,4,274.129554,15.22942,68.532389,40.138965,1,0
0,0,2,2,9,5,14,11,7,18,0.000333,0.022844,4,274.129554,15.22942,68.532389,40.138965,1,0
0,0,9,9,11,13,24,47,33,80,0.000333,0.122266,10,3667.970001,203.776111,366.797,86.159464,1,0
0,0,2,2,9,6,15,11,7,18,0.000333,0.023441,4,281.296123,15.627562,70.324031,44.0391,1,0
0,0,11,11,11,15,26,54,39,93,0.000333,0.145714,10,4371.408938,242.856052,437.140894,96.657107,1,0
0,0,2,2,9,5,14,11,7,18,0.000333,0.022844,4,274.129554,15.22942,68.532389,40.138965,1,0
0,0,2,2,9,6,15,11,7,18,0.000333,0.023441,4,281.296123,15.627562,70.324031,44.0391,1,0
0,0,2,2,9,5,14,11,7,18,0.000333,0.022844,4,274.129554,15.22942,68.532389,40.138965,1,0
0,0,2,2,9,6,15,11,7,18,0.000333,0.023441,4,281.296123,15.627562,70.324031,44.0391,1,0
0,0,11,11,12,15,27,46,38,84,0.000333,0.133137,12,4792.926602,266.2737,399.41055,101.622909,1,0
0,0,2,2,9,5,14,11,7,18,0.000333,0.022844,4,274.129554,15.22942,68.532389,40.138965,1,0
0,0,2,2,9,6,15,11,7,18,0.000333,0.023441,4,281.296123,15.627562,70.324031,44.0391,1,0
0,0,10,10,11,17,28,39,39,78,0.000333,0.124991,10,3749.736839,208.318713,374.973684,107.540616,1,0
0,0,2,2,9,6,15,11,7,18,0.000333,0.023441,4,281.296123,15.627562,70.324031,44.0391,1,0
0,0,2,2,9,5,14,11,7,18,0.000333,0.022844,4,274.129554,15.22942,68.532389,40.138965,1,0
0,0,13,13,14,17,31,71,55,126,0.000333,0.208076,21,13108.80344,728.266858,624.228735,122.789837,1,0
0,0,2,2,9,6,15,11,7,18,0.000333,0.023441,4,281.296123,15.627562,70.324031,44.0391,1,0
0,0,2,2,9,5,14,11,7,18,0.000333,0.022844,4,274.129554,15.22942,68.532389,40.138965,1,0
0,0,13,13,14,16,30,61,46,107,0.000333,0.175012,14,7350.522112,408.36234,525.037294,117.302969,1,0
0,0,2,2,9,6,15,11,7,18,0.000333,0.023441,4,281.296123,15.627562,70.324031,44.0391,1,0
0,0,2,2,9,5,14,11,7,18,0.000333,0.022844,4,274.129554,15.22942,68.532389,40.138965,1,0
0,0,13,13,13,17,30,64,48,112,0.000333,0.183191,12,6594.86096,366.381164,549.571747,117.592585,1,0
0,0,6,6,11,9,20,33,21,54,0.000333,0.077795,10,2333.841171,129.657843,233.384117,66.583073,1,0
0,0,2,2,9,5,14,11,7,18,0.000333,0.022844,4,274.129554,15.22942,68.532389,40.138965,1,0
0,0,2,2,9,6,15,11,7,18,0.000333,0.023441,4,281.296123,15.627562,70.324031,44.0391,1,0
0,0,8,8,13,10,23,37,22,59,0.000333,0.088963,12,3202.681865,177.92677,266.890155,81.324997,2,0
0,0,2,2,9,6,15,11,7,18,0.000333,0.023441,4,281.296123,15.627562,70.324031,44.0391,1,0
0,0,2,2,9,6,15,11,7,18,0.000333,0.023441,4,281.296123,15.627562,70.324031,44.0391,1,0
0,0,2,2,9,5,14,11,7,18,0.000333,0.022844,4,274.129554,15.22942,68.532389,40.138965,1,0
0,0,7,7,12,9,21,36,22,58,0.000333,0.084918,12,3057.052926,169.836274,254.754411,71.548875,2,0
0,0,8,8,14,10,24,38,23,61,0.000333,0.093228,14,3915.557976,217.530999,279.682713,86.52225,2,0
0,0,2,2,9,6,15,11,7,18,0.000333,0.023441,4,281.296123,15.627562,70.324031,44.0391,1,0
0,0,2,2,9,6,15,11,7,18,0.000333,0.023441,4,281.296123,15.627562,70.324031,44.0391,1,0
0,0,2,2,9,5,14,11,7,18,0.000333,0.022844,4,274.129554,15.22942,68.532389,40.138965,1,0
0,0,7,7,12,10,22,36,23,59,0.000333,0.087702,12,3157.277586,175.40431,263.106465,76.238831,2,0
0,0,2,2,9,6,15,11,7,18,0.000333,0.023441,4,281.296123,15.627562,70.324031,44.0391,1,0
0,0,8,8,13,10,23,37,22,59,0.000333,0.088963,12,3202.681865,177.92677,266.890155,81.324997,2,0
0,0,2,2,9,5,14,11,7,18,0.000333,0.022844,4,274.129554,15.22942,68.532389,40.138965,1,0
0,0,7,7,12,10,22,36,22,58,0.000333,0.086216,12,3103.764407,172.431356,258.647034,76.238831,2,0
0,0,2,2,9,6,15,11,7,18,0.000333,0.023441,4,281.296123,15.627562,70.324031,44.0391,1,0
0,0,2,2,9,6,15,11,7,18,0.000333,0.023441,4,281.296123,15.627562,70.324031,44.0391,1,0
0,0,8,8,13,10,23,37,22,59,0.000333,0.088963,12,3202.681865,177.92677,266.890155,81.324997,2,0
0,0,2,2,9,5,14,11,7,18,0.000333,0.022844,4,274.129554,15.22942,68.532389,40.138965,1,0
0,0,7,7,12,10,22,36,22,58,0.000333,0.086216,12,3103.764407,172.431356,258.647034,76.238831,2,0
0,0,2,2,9,6,15,11,7,18,0.000333,0.023441,4,281.296123,15.627562,70.324031,44.0391,1,0
0,0,7,7,12,11,23,36,23,59,0.000333,0.088963,12,3202.681865,177.92677,266.890155,81.073298,2,0
0,0,2,2,9,5,14,11,7,18,0.000333,0.022844,4,274.129554,15.22942,68.532389,40.138965,1,0
0,0,2,2,9,6,15,11,7,18,0.000333,0.023441,4,281.296123,15.627562,70.324031,44.0391,1,0
0,0,8,8,14,11,25,38,23,61,0.000333,0.094425,14,3965.853186,220.325177,283.275228,91.356717,2,0
0,0,2,2,9,6,15,11,7,18,0.000333,0.023441,4,281.296123,15.627562,70.324031,44.0391,1,0
0,0,7,7,12,11,23,36,23,59,0.000333,0.088963,12,3202.681865,177.92677,266.890155,81.073298,2,0
0,0,2,2,9,5,14,11,7,18,0.000333,0.022844,4,274.129554,15.22942,68.532389,40.138965,1,0
0,0,2,2,9,6,15,11,7,18,0.000333,0.023441,4,281.296123,15.627562,70.324031,44.0391,1,0
0,0,8,8,14,11,25,38,23,61,0.000333,0.094425,14,3965.853186,220.325177,283.275228,91.356717,2,0
0,0,2,2,9,6,15,11,7,18,0.000333,0.023441,4,281.296123,15.627562,70.324031,44.0391,1,0
0,0,8,8,13,10,23,37,22,59,0.000333,0.088963,12,3202.681865,177.92677,266.890155,81.324997,2,0
0,0,2,2,9,6,15,11,7,18,0.000333,0.023441,4,281.296123,15.627562,70.324031,44.0391,1,0
0,0,2,2,9,5,14,11,7,18,0.000333,0.022844,4,274.129554,15.22942,68.532389,40.138965,1,0
0,0,7,7,12,10,22,36,22,58,0.000333,0.086216,12,3103.764407,172.431356,258.647034,76.238831,2,0
0,0,2,2,9,6,15,11,7,18,0.000333,0.023441,4,281.296123,15.627562,70.324031,44.0391,1,0
0,0,8,8,13,10,23,37,22,59,0.000333,0.088963,12,3202.681865,177.92677,266.890155,81.324997,2,0
0,0,2,2,9,6,15,11,7,18,0.000333,0.023441,4,281.296123,15.627562,70.324031,44.0391,1,0
0,0,2,2,9,6,15,11,7,18,0.000333,0.023441,4,281.296123,15.627562,70.324031,44.0391,1,0
0,0,2,2,9,5,14,11,7,18,0.000333,0.022844,4,274.129554,15.22942,68.532389,40.138965,1,0
0,0,7,7,12,10,22,36,22,58,0.000333,0.086216,12,3103.764407,172.431356,258.647034,76.238831,2,0
0,0,8,8,13,10,23,37,22,59,0.000333,0.088963,12,3202.681865,177.92677,266.890155,81.324997,2,0
0,0,2,2,9,6,15,11,7,18,0.000333,0.023441,4,281.296123,15.627562,70.324031,44.0391,1,0
0,0,2,2,9,6,15,11,7,18,0.000333,0.023441,4,281.296123,15.627562,70.324031,44.0391,1,0
0,0,2,2,9,5,14,11,7,18,0.000333,0.022844,4,274.129554,15.22942,68.532389,40.138965,1,0
0,0,7,7,12,10,22,36,22,58,0.000333,0.086216,12,3103.764407,172.431356,258.647034,76.238831,2,0
0,0,8,8,13,10,23,37,22,59,0.000333,0.088963,12,3202.681865,177.92677,266.890155,81.324997,2,0
0,0,2,2,9,6,15,11,7,18,0.000333,0.023441,4,281.296123,15.627562,70.324031,44.0391,1,0
0,0,2,2,9,6,15,11,7,18,0.000333,0.023441,4,281.296123,15.627562,70.324031,44.0391,1,0
0,0,2,2,9,5,14,11,7,18,0.000333,0.022844,4,274.129554,15.22942,68.532389,40.138965,1,0
0,0,7,7,12,10,22,36,22,58,0.000333,0.086216,12,3103.764407,172.431356,258.647034,76.238831,2,0
0,0,2,2,9,6,15,11,7,18,0.000333,0.023441,4,281.296123,15.627562,70.324031,44.0391,1,0
0,0,10,10,13,10,23,48,29,77,0.000333,0.116105,12,4179.771247,232.209514,348.314271,81.324997,2,0
0,0,2,2,9,5,14,11,7,18,0.000333,0.022844,4,274.129554,15.22942,68.532389,40.138965,1,0
0,0,2,2,9,6,15,11,7,18,0.000333,0.023441,4,281.296123,15.627562,70.324031,44.0391,1,0
0,0,2,2,9,6,15,11,7,18,0.000333,0.023441,4,281.296123,15.627562,70.324031,44.0391,1,0
0,0,8,8,14,11,25,38,23,61,0.000333,0.094425,14,3965.853186,220.325177,283.275228,91.356717,2,0
0,0,2,2,9,6,15,11,7,18,0.000333,0.023441,4,281.296123,15.627562,70.324031,44.0391,1,0
0,0,2,2,9,6,15,11,7,18,0.000333,0.023441,4,281.296123,15.627562,70.324031,44.0391,1,0
0,0,2,2,9,5,14,11,7,18,0.000333,0.022844,4,274.129554,15.22942,68.532389,40.138965,1,0
0,0,7,7,12,11,23,36,23,59,0.000333,0.088963,12,3202.681865,177.92677,266.890155,81.073298,2,0
0,0,8,8,14,11,25,38,23,61,0.000333,0.094425,14,3965.853186,220.325177,283.275228,91.356717,2,0
0,0,2,2,9,6,15,11,7,18,0.000333,0.023441,4,281.296123,15.627562,70.324031,44.0391,1,0
0,0,2,2,9,6,15,11,7,18,0.000333,0.023441,4,281.296123,15.627562,70.324031,44.0391,1,0
0,0,2,2,9,5,14,11,7,18,0.000333,0.022844,4,274.129554,15.22942,68.532389,40.138965,1,0
0,0,7,7,12,11,23,36,23,59,0.000333,0.088963,12,3202.681865,177.92677,266.890155,81.073298,2,0
0,0,2,2,9,6,15,11,7,18,0.000333,0.023441,4,281.296123,15.627562,70.324031,44.0391,1,0
0,0,2,2,9,5,14,11,7,18,0.000333,0.022844,4,274.129554,15.22942,68.532389,40.138965,1,0
0,0,2,2,9,6,15,11,7,18,0.000333,0.023441,4,281.296123,15.627562,70.324031,44.0391,1,0
0,0,8,8,14,10,24,38,23,61,0.000333,0.093228,14,3915.557976,217.530999,279.682713,86.52225,2,0
0,0,8,8,14,10,24,38,22,60,0.000333,0.091699,14,3851.368501,213.964917,275.09775,86.52225,2,0
0,0,3,3,9,5,14,16,10,26,0.000333,0.032997,8,791.929824,43.996101,98.991228,40.138965,1,0
0,0,7,7,12,9,21,36,22,58,0.000333,0.084918,12,3057.052926,169.836274,254.754411,71.548875,2,0
0,0,3,3,9,6,15,16,10,26,0.000333,0.03386,4,406.316622,22.573146,101.579155,44.0391,1,0
0,0,7,7,14,11,25,41,26,67,0.000333,0.103713,14,4355.937106,241.996506,311.138365,91.356717,2,0
0,0,3,3,9,5,14,16,10,26,0.000333,0.032997,8,791.929824,43.996101,98.991228,40.138965,1,0
0,0,3,3,9,6,15,16,10,26,0.000333,0.03386,4,406.316622,22.573146,101.579155,44.0391,1,0
0,0,2,2,9,5,14,11,7,18,0.000333,0.022844,4,274.129554,15.22942,68.532389,40.138965,1,0
0,0,8,8,13,10,23,36,23,59,0.000333,0.088963,12,3202.681865,177.92677,266.890155,81.324997,1,0
0,0,2,2,9,6,15,11,7,18,0.000333,0.023441,4,281.296123,15.627562,70.324031,44.0391,1,0
0,0,4,4,11,9,20,20,18,38,0.000333,0.054744,10,1642.332676,91.240704,164.233268,66.583073,1,0
0,0,4,4,11,6,17,20,14,34,0.000333,0.046325,10,1389.737366,77.207631,138.973737,53.563523,1,0
0,0,12,12,15,14,29,50,40,90,0.000333,0.145739,14,6121.056054,340.05867,437.21829,111.906328,2,0
0,0,4,4,11,9,20,20,18,38,0.000333,0.054744,10,1642.332676,91.240704,164.233268,66.583073,1,0
0,0,11,11,14,13,27,49,40,89,0.000333,0.141062,21,8886.884742,493.715819,423.184988,101.408685,2,0
0,0,2,2,6,6,12,10,8,18,0.000333,0.02151,3,193.587975,10.754888,64.529325,31.01955,1,0
0,0,4,4,10,9,19,19,18,37,0.000333,0.052391,10,1571.73318,87.31851,157.173318,61.748606,1,0
0,0,11,11,13,13,26,48,40,88,0.000333,0.13788,18,7445.496514,413.638695,413.638695,96.211433,2,0
0,0,2,2,6,8,14,10,10,20,0.000333,0.025382,3,228.441295,12.691183,76.147098,39.509775,1,0
0,0,12,12,14,14,28,49,40,89,0.000333,0.142618,14,5989.964233,332.775791,427.854588,106.605938,2,0
0,0,8,8,11,10,21,39,27,66,0.000333,0.096631,10,2898.929499,161.051639,289.89295,71.273029,1,0
0,0,2,2,9,6,15,11,7,18,0.000333,0.023441,4,281.296123,15.627562,70.324031,44.0391,1,0
0,0,2,2,9,5,14,11,7,18,0.000333,0.022844,4,274.129554,15.22942,68.532389,40.138965,1,0
0,0,2,2,9,6,15,11,7,18,0.000333,0.023441,4,281.296123,15.627562,70.324031,44.0391,1,0
0,0,2,2,9,5,14,11,7,18,0.000333,0.022844,4,274.129554,15.22942,68.532389,40.138965,1,0
0,0,11,11,12,11,23,54,35,89,0.000333,0.134199,18,7246.746254,402.597014,402.597014,81.073298,1,0
0,0,2,2,9,6,15,11,7,18,0.000333,0.023441,4,281.296123,15.627562,70.324031,44.0391,1,0
0,0,2,2,9,5,14,11,7,18,0.000333,0.022844,4,274.129554,15.22942,68.532389,40.138965,1,0
0,0,8,8,12,10,22,40,27,67,0.000333,0.099594,12,3585.383021,199.187946,298.781918,76.238831,1,0
0,0,2,2,9,5,14,11,7,18,0.000333,0.022844,4,274.129554,15.22942,68.532389,40.138965,1,0
0,0,9,9,12,13,25,41,30,71,0.000333,0.109905,12,3956.565474,219.809193,329.713789,91.125266,1,0
0,0,2,2,9,6,15,11,7,18,0.000333,0.023441,4,281.296123,15.627562,70.324031,44.0391,1,0
0,0,8,8,11,12,23,39,29,68,0.000333,0.102534,10,3076.02213,170.890118,307.602213,81.073298,1,0
0,0,2,2,9,6,15,11,7,18,0.000333,0.023441,4,281.296123,15.627562,70.324031,44.0391,1,0
0,0,2,2,9,5,14,11,7,18,0.000333,0.022844,4,274.129554,15.22942,68.532389,40.138965,1,0
0,0,4,4,11,8,19,20,16,36,0.000333,0.050975,10,1529.253905,84.95855,152.92539,62.053748,1,0
0,0,4,4,11,6,17,20,14,34,0.000333,0.046325,10,1389.737366,77.207631,138.973737,53.563523,1,0
0,0,9,9,13,11,24,44,31,75,0.000333,0.114624,12,4126.466251,229.248125,343.872188,86.159464,1,0
0,0,4,4,12,9,21,19,15,34,0.000333,0.04978,6,896.032754,49.779597,149.338792,71.548875,1,0
0,0,8,8,13,12,25,41,29,70,0.000333,0.108357,12,3900.839199,216.713289,325.069933,91.125266,1,0
0,0,4,4,11,7,18,18,13,31,0.000333,0.043089,5,646.338375,35.907688,129.267675,57.705232,1,0
0,0,9,9,12,13,25,48,33,81,0.000333,0.125384,12,4513.828216,250.768234,376.152351,91.125266,1,0
0,0,2,2,9,6,15,11,7,18,0.000333,0.023441,4,281.296123,15.627562,70.324031,44.0391,1,0
0,0,2,2,9,5,14,11,7,18,0.000333,0.022844,4,274.129554,15.22942,68.532389,40.138965,1,0
0,0,2,2,9,6,15,11,7,18,0.000333,0.023441,4,281.296123,15.627562,70.324031,44.0391,1,0
0,0,2,2,9,5,14,11,7,18,0.000333,0.022844,4,274.129554,15.22942,68.532389,40.138965,1,0
0,0,10,10,12,13,25,40,33,73,0.000333,0.113001,12,4068.018022,226.001001,339.001502,91.125266,1,0
0,0,8,8,11,12,23,39,29,68,0.000333,0.102534,10,3076.02213,170.890118,307.602213,81.073298,1,0
0,0,2,2,9,5,14,11,7,18,0.000333,0.022844,4,274.129554,15.22942,68.532389,40.138965,1,0
0,0,2,2,9,6,15,11,7,18,0.000333,0.023441,4,281.296123,15.627562,70.324031,44.0391,1,0
0,0,8,8,11,13,24,39,29,68,0.000333,0.103926,10,3117.7745,173.209694,311.77745,86.159464,1,0
0,0,8,8,11,13,24,39,29,68,0.000333,0.103926,10,3117.7745,173.209694,311.77745,86.159464,1,0
0,0,8,8,11,13,24,39,29,68,0.000333,0.103926,10,3117.7745,173.209694,311.77745,86.159464,1,0
0,0,10,10,12,11,23,47,35,82,0.000333,0.123644,18,6676.777447,370.93208,370.93208,81.073298,1,0
0,0,9,9,12,12,24,45,32,77,0.000333,0.117681,12,4236.505351,235.361408,353.042113,86.0391,1,0
0,0,9,9,12,13,25,45,32,77,0.000333,0.119192,12,4290.923119,238.384618,357.576927,91.125266,1,0
0,0,10,10,12,14,26,54,36,90,0.000333,0.141013,12,5076.474896,282.026383,423.039575,96.322519,1,0
0,0,9,9,11,13,24,47,33,80,0.000333,0.122266,10,3667.970001,203.776111,366.797,86.159464,1,0
0,0,11,11,11,15,26,54,39,93,0.000333,0.145714,10,4371.408938,242.856052,437.140894,96.657107,1,0
0,0,11,11,12,15,27,46,38,84,0.000333,0.133137,12,4792.926602,266.2737,399.41055,101.622909,1,0
0,0,10,10,11,17,28,39,39,78,0.000333,0.124991,10,3749.736839,208.318713,374.973684,107.540616,1,0
0,0,13,13,14,17,31,71,55,126,0.000333,0.208076,21,13108.80344,728.266858,624.228735,122.789837,1,0
0,0,13,13,14,16,30,61,46,107,0.000333,0.175012,14,7350.522112,408.36234,525.037294,117.302969,1,0
0,0,13,13,13,17,30,64,48,112,0.000333,0.183191,12,6594.86096,366.381164,549.571747,117.592585,1,0
0,0,6,6,10,9,19,29,20,49,0.000333,0.069383,10,2081.484482,115.638027,208.148448,61.748606,1,0
0,0,6,6,10,9,19,29,20,49,0.000333,0.069383,10,2081.484482,115.638027,208.148448,61.748606,1,0
0,0,6,6,10,9,19,29,20,49,0.000333,0.069383,10,2081.484482,115.638027,208.148448,61.748606,1,0
0,0,6,6,10,9,19,29,20,49,0.000333,0.069383,10,2081.484482,115.638027,208.148448,61.748606,1,0
0,0,6,6,10,9,19,29,20,49,0.000333,0.069383,10,2081.484482,115.638027,208.148448,61.748606,1,0
0,0,6,6,10,9,19,29,20,49,0.000333,0.069383,10,2081.484482,115.638027,208.148448,61.748606,1,0
0,0,6,6,10,9,19,29,20,49,0.000333,0.069383,10,2081.484482,115.638027,208.148448,61.748606,1,0
0,0,6,6,10,9,19,29,20,49,0.000333,0.069383,10,2081.484482,115.638027,208.148448,61.748606,1,0
0,0,6,6,10,9,19,29,20,49,0.000333,0.069383,10,2081.484482,115.638027,208.148448,61.748606,1,0
0,0,6,6,10,9,19,29,20,49,0.000333,0.069383,10,2081.484482,115.638027,208.148448,61.748606,1,0
0,0,6,6,10,9,19,29,20,49,0.000333,0.069383,10,2081.484482,115.638027,208.148448,61.748606,1,0
0,0,6,6,10,9,19,29,20,49,0.000333,0.069383,10,2081.484482,115.638027,208.148448,61.748606,1,0
0,0,6,6,10,9,19,29,20,49,0.000333,0.069383,10,2081.484482,115.638027,208.148448,61.748606,1,0
0,0,6,6,10,9,19,29,20,49,0.000333,0.069383,10,2081.484482,115.638027,208.148448,61.748606,1,0
0,0,6,6,10,9,19,29,20,49,0.000333,0.069383,10,2081.484482,115.638027,208.148448,61.748606,1,0
0,0,6,6,10,9,19,29,20,49,0.000333,0.069383,10,2081.484482,115.638027,208.148448,61.748606,1,0
0,0,6,6,10,9,19,29,20,49,0.000333,0.069383,10,2081.484482,115.638027,208.148448,61.748606,1,0
0,0,6,6,10,9,19,29,20,49,0.000333,0.069383,10,2081.484482,115.638027,208.148448,61.748606,1,0
0,0,10,10,12,12,24,44,37,81,0.000333,0.123794,18,6684.875326,371.381963,371.381963,86.0391,1,0
0,0,10,10,11,12,23,43,37,80,0.000333,0.120628,15,5428.274347,301.570797,361.884956,81.073298,1,0
0,0,8,8,10,10,20,35,26,61,0.000333,0.087879,10,2636.376138,146.465341,263.637614,66.438562,1,0
0,0,7,7,11,10,21,36,24,60,0.000333,0.087846,10,2635.390454,146.410581,263.539045,71.273029,1,0
0,0,8,8,11,10,21,36,26,62,0.000333,0.090775,10,2723.236802,151.290933,272.32368,71.273029,1,0
0,0,9,9,11,13,24,37,29,66,0.000333,0.100869,10,3026.07525,168.115292,302.607525,86.159464,1,0
0,0,8,8,10,12,22,35,28,63,0.000333,0.093648,10,2809.44192,156.080107,280.944192,76.238831,1,0
0,0,10,10,12,11,23,44,34,78,0.000333,0.117613,18,6351.080986,352.837833,352.837833,81.073298,1,0
0,0,9,9,12,12,24,40,31,71,0.000333,0.108511,12,3906.388051,217.021558,325.532338,86.0391,1,0
0,0,9,9,11,13,24,44,32,76,0.000333,0.116152,10,3484.571501,193.587306,348.45715,86.159464,1,0
0,0,10,10,11,13,24,36,32,68,0.000333,0.103926,10,3117.7745,173.209694,311.77745,86.159464,1,0
0,0,8,8,10,12,22,35,28,63,0.000333,0.093648,10,2809.44192,156.080107,280.944192,76.238831,1,0
0,0,8,8,10,13,23,35,28,63,0.000333,0.094995,10,2849.844032,158.324668,284.984403,81.324997,1,0
0,0,8,8,10,13,23,35,28,63,0.000333,0.094995,10,2849.844032,158.324668,284.984403,81.324997,1,0
0,0,8,8,10,13,23,35,28,63,0.000333,0.094995,10,2849.844032,158.324668,284.984403,81.324997,1,0
0,0,10,10,11,11,22,43,34,77,0.000333,0.114459,15,5150.64352,286.146862,343.376235,76.107496,1,0
0,0,10,10,11,12,23,44,34,78,0.000333,0.117613,10,3528.378326,196.021018,352.837833,81.073298,1,0
0,0,9,9,11,13,24,41,31,72,0.000333,0.110039,10,3301.173001,183.3985,330.1173,86.159464,1,0
0,0,9,9,11,14,25,46,32,78,0.000333,0.12074,10,3622.207828,201.233768,362.220783,91.356717,1,0
0,0,9,9,10,13,23,43,32,75,0.000333,0.113089,10,3392.671467,188.481748,339.267147,81.324997,1,0
0,0,11,11,10,15,25,50,38,88,0.000333,0.13622,10,4086.593447,227.032969,408.659345,91.82264,1,0
0,0,11,11,11,15,26,42,37,79,0.000333,0.123778,10,3713.347377,206.297077,371.334738,96.657107,1,0
0,0,10,10,10,17,27,36,38,74,0.000333,0.117287,10,3518.616752,195.478708,351.861675,102.706149,1,0
0,0,13,13,13,17,30,67,54,121,0.000333,0.197911,18,10687.20772,593.733762,593.733762,117.592585,1,0
0,0,13,13,13,19,32,59,46,105,0.000333,0.175,12,6300,350,525,128.816339,1,0
0,0,13,13,13,19,32,59,46,105,0.000333,0.175,12,6300,350,525,128.816339,1,0
0,0,7,7,12,9,21,37,24,61,0.000333,0.08931,12,3215.176353,178.620909,267.931363,71.548875,1,0
0,0,8,8,13,11,24,41,29,70,0.000333,0.106982,12,3851.368501,213.964917,320.947375,86.159464,1,0
0,0,8,8,12,11,23,41,29,70,0.000333,0.10555,12,3799.792043,211.099558,316.649337,81.073298,1,0
0,0,12,12,14,17,31,68,52,120,0.000333,0.198168,21,12484.5747,693.587483,594.503557,122.789837,1,0
0,0,12,12,14,15,29,58,43,101,0.000333,0.163552,14,6869.185127,381.621396,490.656081,111.906328,1,0
0,0,12,12,13,15,28,61,45,106,0.000333,0.16986,18,9172.433191,509.579622,509.579622,106.709075,1,0
0,0,6,6,10,9,19,29,20,49,0.000333,0.069383,10,2081.484482,115.638027,208.148448,61.748606,1,0
0,0,6,6,10,9,19,29,20,49,0.000333,0.069383,10,2081.484482,115.638027,208.148448,61.748606,1,0
0,0,6,6,10,9,19,29,20,49,0.000333,0.069383,10,2081.484482,115.638027,208.148448,61.748606,1,0
0,0,6,6,10,9,19,29,20,49,0.000333,0.069383,10,2081.484482,115.638027,208.148448,61.748606,1,0
0,0,6,6,10,9,19,29,20,49,0.000333,0.069383,10,2081.484482,115.638027,208.148448,61.748606,1,0
0,0,6,6,10,9,19,29,20,49,0.000333,0.069383,10,2081.484482,115.638027,208.148448,61.748606,1,0
0,0,6,6,10,9,19,29,20,49,0.000333,0.069383,10,2081.484482,115.638027,208.148448,61.748606,1,0
0,0,6,6,10,9,19,29,20,49,0.000333,0.069383,10,2081.484482,115.638027,208.148448,61.748606,1,0
0,0,6,6,10,9,19,29,20,49,0.000333,0.069383,10,2081.484482,115.638027,208.148448,61.748606,1,0
0,0,6,6,10,9,19,29,20,49,0.000333,0.069383,10,2081.484482,115.638027,208.148448,61.748606,1,0
0,0,6,6,10,9,19,29,20,49,0.000333,0.069383,10,2081.484482,115.638027,208.148448,61.748606,1,0
0,0,6,6,10,9,19,29,20,49,0.000333,0.069383,10,2081.484482,115.638027,208.148448,61.748606,1,0
0,0,6,6,10,9,19,29,20,49,0.000333,0.069383,10,2081.484482,115.638027,208.148448,61.748606,1,0
0,0,6,6,10,9,19,29,20,49,0.000333,0.069383,10,2081.484482,115.638027,208.148448,61.748606,1,0
0,0,6,6,10,9,19,29,20,49,0.000333,0.069383,10,2081.484482,115.638027,208.148448,61.748606,1,0
0,0,6,6,10,9,19,29,20,49,0.000333,0.069383,10,2081.484482,115.638027,208.148448,61.748606,1,0
0,0,6,6,10,9,19,29,20,49,0.000333,0.069383,10,2081.484482,115.638027,208.148448,61.748606,1,0
0,0,6,6,10,9,19,29,20,49,0.000333,0.069383,10,2081.484482,115.638027,208.148448,61.748606,1,0
0,0,10,10,12,11,23,45,37,82,0.000333,0.123644,18,6676.777447,370.93208,370.93208,81.073298,1,0
0,0,10,10,12,12,24,44,37,81,0.000333,0.123794,18,6684.875326,371.381963,371.381963,86.0391,1,0
0,0,8,8,10,10,20,35,26,61,0.000333,0.087879,10,2636.376138,146.465341,263.637614,66.438562,1,0
0,0,7,7,11,10,21,36,24,60,0.000333,0.087846,10,2635.390454,146.410581,263.539045,71.273029,1,0
0,0,8,8,11,10,21,36,26,62,0.000333,0.090775,10,2723.236802,151.290933,272.32368,71.273029,1,0
0,0,9,9,11,13,24,37,29,66,0.000333,0.100869,10,3026.07525,168.115292,302.607525,86.159464,1,0
0,0,8,8,10,12,22,35,28,63,0.000333,0.093648,10,2809.44192,156.080107,280.944192,76.238831,1,0
0,0,10,10,12,11,23,44,34,78,0.000333,0.117613,18,6351.080986,352.837833,352.837833,81.073298,1,0
0,0,9,9,12,12,24,40,31,71,0.000333,0.108511,12,3906.388051,217.021558,325.532338,86.0391,1,0
0,0,9,9,11,13,24,44,32,76,0.000333,0.116152,10,3484.571501,193.587306,348.45715,86.159464,1,0
0,0,10,10,11,13,24,36,32,68,0.000333,0.103926,10,3117.7745,173.209694,311.77745,86.159464,1,0
0,0,8,8,10,12,22,35,28,63,0.000333,0.093648,10,2809.44192,156.080107,280.944192,76.238831,1,0
0,0,8,8,10,13,23,35,28,63,0.000333,0.094995,10,2849.844032,158.324668,284.984403,81.324997,1,0
0,0,8,8,10,13,23,35,28,63,0.000333,0.094995,10,2849.844032,158.324668,284.984403,81.324997,1,0
0,0,8,8,10,13,23,35,28,63,0.000333,0.094995,10,2849.844032,158.324668,284.984403,81.324997,1,0
0,0,10,10,11,11,22,43,34,77,0.000333,0.114459,15,5150.64352,286.146862,343.376235,76.107496,1,0
0,0,9,9,10,11,21,40,29,69,0.000333,0.101023,10,3030.699022,168.372168,303.069902,71.273029,1,0
0,0,9,9,11,13,24,41,31,72,0.000333,0.110039,10,3301.173001,183.3985,330.1173,86.159464,1,0
0,0,10,10,11,14,25,50,35,85,0.000333,0.131576,10,3947.277761,219.293209,394.727776,91.356717,1,0
0,0,9,9,10,13,23,43,32,75,0.000333,0.113089,10,3392.671467,188.481748,339.267147,81.324997,1,0
0,0,11,11,10,15,25,50,38,88,0.000333,0.13622,10,4086.593447,227.032969,408.659345,91.82264,1,0
0,0,11,11,11,15,26,42,37,79,0.000333,0.123778,10,3713.347377,206.297077,371.334738,96.657107,1,0
0,0,10,10,10,17,27,36,38,74,0.000333,0.117287,10,3518.616752,195.478708,351.861675,102.706149,1,0
0,0,13,13,13,17,30,67,54,121,0.000333,0.197911,18,10687.20772,593.733762,593.733762,117.592585,1,0
0,0,13,13,13,16,29,57,45,102,0.000333,0.165171,12,5946.168738,330.342708,495.514062,112.105716,1,0
0,0,13,13,12,17,29,60,47,107,0.000333,0.173268,12,6237.647598,346.535978,519.803966,112.506418,1,0
0,0,6,6,11,9,20,31,20,51,0.000333,0.073473,10,2204.183328,122.454629,220.418333,66.583073,1,0
0,0,6,6,11,9,20,31,20,51,0.000333,0.073473,10,2204.183328,122.454629,220.418333,66.583073,1,0
0,0,6,6,11,9,20,31,20,51,0.000333,0.073473,10,2204.183328,122.454629,220.418333,66.583073,1,0
0,0,6,6,11,9,20,31,20,51,0.000333,0.073473,10,2204.183328,122.454629,220.418333,66.583073,1,0
0,0,6,6,11,9,20,31,20,51,0.000333,0.073473,10,2204.183328,122.454629,220.418333,66.583073,1,0
0,0,6,6,11,9,20,31,20,51,0.000333,0.073473,10,2204.183328,122.454629,220.418333,66.583073,1,0
0,0,6,6,11,9,20,31,20,51,0.000333,0.073473,10,2204.183328,122.454629,220.418333,66.583073,1,0
0,0,6,6,11,9,20,31,20,51,0.000333,0.073473,10,2204.183328,122.454629,220.418333,66.583073,1,0
0,0,6,6,11,9,20,31,20,51,0.000333,0.073473,10,2204.183328,122.454629,220.418333,66.583073,1,0
0,0,6,6,11,9,20,31,20,51,0.000333,0.073473,10,2204.183328,122.454629,220.418333,66.583073,1,0
0,0,6,6,11,9,20,31,20,51,0.000333,0.073473,10,2204.183328,122.454629,220.418333,66.583073,1,0
0,0,6,6,11,9,20,31,20,51,0.000333,0.073473,10,2204.183328,122.454629,220.418333,66.583073,1,0
0,0,8,8,11,19,30,53,32,85,0.000333,0.139029,5,2085.428503,115.857139,417.085701,118.764371,2,0
0,0,8,8,11,19,30,53,32,85,0.000333,0.139029,5,2085.428503,115.857139,417.085701,118.764371,2,0
0,0,8,8,14,16,30,38,31,69,0.000333,0.112858,7,2370.028158,131.668231,338.575451,117.302969,5,0
0,0,8,8,11,19,30,53,32,85,0.000333,0.139029,5,2085.428503,115.857139,417.085701,118.764371,2,0
0,0,8,8,11,19,30,53,32,85,0.000333,0.139029,5,2085.428503,115.857139,417.085701,118.764371,2,0
0,0,9,9,14,19,33,43,36,79,0.000333,0.132836,7,2789.549948,154.974997,398.507135,134.013592,5,0
0,0,8,8,11,19,30,53,32,85,0.000333,0.139029,5,2085.428503,115.857139,417.085701,118.764371,2,0
0,0,8,8,11,19,30,53,32,85,0.000333,0.139029,5,2085.428503,115.857139,417.085701,118.764371,2,0
0,0,8,8,14,18,32,39,32,71,0.000333,0.118333,7,2485,138.055556,355,128.361619,5,0
0,0,8,8,11,19,30,53,32,85,0.000333,0.139029,5,2085.428503,115.857139,417.085701,118.764371,2,0
0,0,8,8,11,19,30,53,32,85,0.000333,0.139029,5,2085.428503,115.857139,417.085701,118.764371,2,0
0,0,9,9,14,19,33,44,37,81,0.000333,0.136199,7,2860.171466,158.898415,408.595924,134.013592,5,0
0,0,8,8,11,19,30,53,32,85,0.000333,0.139029,5,2085.428503,115.857139,417.085701,118.764371,2,0
0,0,8,8,11,19,30,53,32,85,0.000333,0.139029,5,2085.428503,115.857139,417.085701,118.764371,2,0
0,0,5,5,11,9,20,30,20,50,0.000333,0.072032,10,2160.964047,120.053558,216.096405,66.583073,1,0
0,0,5,5,12,11,23,31,22,53,0.000333,0.079916,12,2876.985404,159.832522,239.748784,81.073298,1,0
0,0,6,6,11,12,23,32,24,56,0.000333,0.08444,10,2533.194695,140.733039,253.31947,81.073298,1,0
0,0,10,10,13,16,29,61,48,109,0.000333,0.176507,18,9531.358712,529.519928,529.519928,112.105716,1,0
0,0,10,10,13,15,28,51,39,90,0.000333,0.144221,12,5191.943316,288.441295,432.661943,106.709075,1,0
0,0,10,10,12,16,28,54,41,95,0.000333,0.152233,12,5480.384611,304.465812,456.698718,107.01955,1,0
0,0,5,5,11,10,21,40,24,64,0.000333,0.093703,10,2811.083151,156.171286,281.108315,71.273029,1,0
0,0,5,5,12,12,24,41,26,67,0.000333,0.102397,12,3686.309851,204.794992,307.192488,86.0391,1,0
0,0,5,5,11,12,23,40,26,66,0.000333,0.099518,10,2985.550891,165.863938,298.555089,81.073298,1,0
0,0,10,10,13,17,30,71,52,123,0.000333,0.201183,18,10863.85578,603.547543,603.547543,117.592585,1,0
0,0,10,10,13,16,29,61,43,104,0.000333,0.16841,12,6062.760282,336.820016,505.230023,112.105716,1,0
0,0,10,10,12,17,29,64,45,109,0.000333,0.176507,12,6354.239142,353.013286,529.519928,112.506418,1,0
0,0,5,5,11,10,21,40,24,64,0.000333,0.093703,10,2811.083151,156.171286,281.108315,71.273029,1,0
0,0,5,5,12,12,24,41,26,67,0.000333,0.102397,12,3686.309851,204.794992,307.192488,86.0391,1,0
0,0,5,5,11,12,23,40,26,66,0.000333,0.099518,10,2985.550891,165.863938,298.555089,81.073298,1,0
0,0,10,10,13,17,30,71,52,123,0.000333,0.201183,18,10863.85578,603.547543,603.547543,117.592585,1,0
0,0,10,10,13,16,29,61,43,104,0.000333,0.16841,12,6062.760282,336.820016,505.230023,112.105716,1,0
0,0,10,10,12,17,29,64,45,109,0.000333,0.176507,12,6354.239142,353.013286,529.519928,112.506418,1,0
0,0,5,5,11,10,21,34,23,57,0.000333,0.083454,10,2503.620931,139.090052,250.362093,71.273029,1,0
0,0,5,5,12,12,24,35,25,60,0.000333,0.091699,12,3301.173001,183.3985,275.09775,86.0391,1,0
0,0,5,5,11,12,23,34,25,59,0.000333,0.088963,10,2668.901554,148.272309,266.890155,81.073298,1,0
0,0,10,10,13,17,30,65,51,116,0.000333,0.189733,18,10245.58756,569.199309,569.199309,117.592585,1,0
0,0,10,10,13,16,29,55,42,97,0.000333,0.157075,12,5654.689878,314.149438,471.224157,112.105716,1,0
0,0,10,10,12,17,29,58,44,102,0.000333,0.165171,12,5946.168738,330.342708,495.514062,112.506418,1,0
0,0,5,5,11,9,20,30,20,50,0.000333,0.072032,10,2160.964047,120.053558,216.096405,66.583073,1,0
0,0,5,5,12,11,23,31,22,53,0.000333,0.079916,12,2876.985404,159.832522,239.748784,81.073298,1,0
0,0,5,5,11,11,22,30,22,52,0.000333,0.077297,10,2318.904442,128.828025,231.890444,76.107496,1,0
0,0,10,10,13,16,29,61,48,109,0.000333,0.176507,18,9531.358712,529.519928,529.519928,112.105716,1,0
0,0,10,10,13,15,28,51,39,90,0.000333,0.144221,12,5191.943316,288.441295,432.661943,106.709075,1,0
0,0,10,10,12,16,28,54,41,95,0.000333,0.152233,12,5480.384611,304.465812,456.698718,107.01955,1,0
0,0,5,5,11,10,21,40,24,64,0.000333,0.093703,10,2811.083151,156.171286,281.108315,71.273029,1,0
0,0,5,5,12,12,24,41,26,67,0.000333,0.102397,12,3686.309851,204.794992,307.192488,86.0391,1,0
0,0,5,5,11,12,23,40,26,66,0.000333,0.099518,10,2985.550891,165.863938,298.555089,81.073298,1,0
0,0,10,10,13,17,30,71,52,123,0.000333,0.201183,18,10863.85578,603.547543,603.547543,117.592585,1,0
0,0,10,10,13,16,29,61,43,104,0.000333,0.16841,12,6062.760282,336.820016,505.230023,112.105716,1,0
0,0,10,10,12,17,29,64,45,109,0.000333,0.176507,12,6354.239142,353.013286,529.519928,112.506418,1,0
0,0,5,5,11,10,21,40,24,64,0.000333,0.093703,10,2811.083151,156.171286,281.108315,71.273029,1,0
0,0,5,5,12,12,24,41,26,67,0.000333,0.102397,12,3686.309851,204.794992,307.192488,86.0391,1,0
0,0,5,5,11,12,23,40,26,66,0.000333,0.099518,10,2985.550891,165.863938,298.555089,81.073298,1,0
0,0,10,10,13,17,30,71,52,123,0.000333,0.201183,18,10863.85578,603.547543,603.547543,117.592585,1,0
0,0,10,10,13,16,29,61,43,104,0.000333,0.16841,12,6062.760282,336.820016,505.230023,112.105716,1,0
0,0,10,10,12,17,29,64,45,109,0.000333,0.176507,12,6354.239142,353.013286,529.519928,112.506418,1,0
0,0,5,5,11,10,21,34,23,57,0.000333,0.083454,10,2503.620931,139.090052,250.362093,71.273029,1,0
0,0,5,5,12,12,24,35,25,60,0.000333,0.091699,12,3301.173001,183.3985,275.09775,86.0391,1,0
0,0,5,5,11,12,23,34,25,59,0.000333,0.088963,10,2668.901554,148.272309,266.890155,81.073298,1,0
0,0,10,10,13,17,30,65,51,116,0.000333,0.189733,18,10245.58756,569.199309,569.199309,117.592585,1,0
0,0,10,10,13,16,29,55,42,97,0.000333,0.157075,12,5654.689878,314.149438,471.224157,112.105716,1,0
0,0,10,10,12,17,29,58,44,102,0.000333,0.165171,12,5946.168738,330.342708,495.514062,112.506418,1,0
0,0,2,2,7,5,12,9,7,16,0.000333,0.01912,3,172.0782,9.5599,57.3594,31.261125,1,0
0,0,7,7,11,9,20,41,26,67,0.000333,0.096523,10,2895.691824,160.871768,289.569182,66.583073,1,0
0,0,2,2,7,5,12,9,7,16,0.000333,0.01912,3,172.0782,9.5599,57.3594,31.261125,1,0
0,0,2,2,7,5,12,9,7,16,0.000333,0.01912,3,172.0782,9.5599,57.3594,31.261125,1,0
0,0,8,8,12,12,24,46,28,74,0.000333,0.113096,12,4071.446701,226.191483,339.287225,86.0391,1,0
0,0,2,2,7,5,12,9,7,16,0.000333,0.01912,3,172.0782,9.5599,57.3594,31.261125,1,0
0,0,2,2,7,5,12,9,7,16,0.000333,0.01912,3,172.0782,9.5599,57.3594,31.261125,1,0
0,0,8,8,11,12,23,45,30,75,0.000333,0.113089,10,3392.671467,188.481748,339.267147,81.073298,1,0
0,0,2,2,7,5,12,9,7,16,0.000333,0.01912,3,172.0782,9.5599,57.3594,31.261125,1,0
0,0,2,2,7,5,12,9,7,16,0.000333,0.01912,3,172.0782,9.5599,57.3594,31.261125,1,0
0,0,12,12,13,16,29,72,54,126,0.000333,0.204035,18,11017.9009,612.105605,612.105605,112.105716,1,0
0,0,2,2,7,5,12,9,7,16,0.000333,0.01912,3,172.0782,9.5599,57.3594,31.261125,1,0
0,0,2,2,7,5,12,9,7,16,0.000333,0.01912,3,172.0782,9.5599,57.3594,31.261125,1,0
0,0,13,13,13,16,29,66,47,113,0.000333,0.182984,12,6587.422229,365.967902,548.951852,112.105716,1,0
0,0,2,2,7,5,12,9,7,16,0.000333,0.01912,3,172.0782,9.5599,57.3594,31.261125,1,0
0,0,2,2,7,5,12,9,7,16,0.000333,0.01912,3,172.0782,9.5599,57.3594,31.261125,1,0
0,0,13,13,12,16,28,69,49,118,0.000333,0.189089,18,10210.82185,567.267881,567.267881,107.01955,1,0
0,0,2,2,7,5,12,9,7,16,0.000333,0.01912,3,172.0782,9.5599,57.3594,31.261125,1,0
0,0,2,2,7,5,12,9,7,16,0.000333,0.01912,3,172.0782,9.5599,57.3594,31.261125,1,0
0,0,7,7,11,9,20,41,26,67,0.000333,0.096523,10,2895.691824,160.871768,289.569182,66.583073,1,0
0,0,2,2,7,5,12,9,7,16,0.000333,0.01912,3,172.0782,9.5599,57.3594,31.261125,1,0
0,0,2,2,7,5,12,9,7,16,0.000333,0.01912,3,172.0782,9.5599,57.3594,31.261125,1,0
0,0,8,8,12,12,24,46,30,76,0.000333,0.116152,12,4181.485801,232.304767,348.45715,86.0391,1,0
0,0,2,2,7,5,12,9,7,16,0.000333,0.01912,3,172.0782,9.5599,57.3594,31.261125,1,0
0,0,2,2,7,5,12,9,7,16,0.000333,0.01912,3,172.0782,9.5599,57.3594,31.261125,1,0
0,0,2,2,7,5,12,9,7,16,0.000333,0.01912,3,172.0782,9.5599,57.3594,31.261125,1,0
0,0,8,8,11,12,23,45,30,75,0.000333,0.113089,10,3392.671467,188.481748,339.267147,81.073298,1,0
0,0,2,2,7,5,12,9,7,16,0.000333,0.01912,3,172.0782,9.5599,57.3594,31.261125,1,0
0,0,13,13,13,17,30,76,56,132,0.000333,0.215903,18,11658.77206,647.709559,647.709559,117.592585,1,0
0,0,2,2,7,5,12,9,7,16,0.000333,0.01912,3,172.0782,9.5599,57.3594,31.261125,1,0
0,0,2,2,7,5,12,9,7,16,0.000333,0.01912,3,172.0782,9.5599,57.3594,31.261125,1,0
0,0,13,13,13,16,29,66,47,113,0.000333,0.182984,12,6587.422229,365.967902,548.951852,112.105716,1,0
0,0,2,2,7,5,12,9,7,16,0.000333,0.01912,3,172.0782,9.5599,57.3594,31.261125,1,0
0,0,2,2,7,5,12,9,7,16,0.000333,0.01912,3,172.0782,9.5599,57.3594,31.261125,1,0
0,0,13,13,12,16,28,69,49,118,0.000333,0.189089,18,10210.82185,567.267881,567.267881,107.01955,1,0
0,0,2,2,7,5,12,9,7,16,0.000333,0.01912,3,172.0782,9.5599,57.3594,31.261125,1,0
0,0,2,2,7,5,12,9,7,16,0.000333,0.01912,3,172.0782,9.5599,57.3594,31.261125,1,0
0,0,2,2,7,5,12,9,7,16,0.000333,0.01912,3,172.0782,9.5599,57.3594,31.261125,1,0
0,0,7,7,11,9,20,37,25,62,0.000333,0.08932,10,2679.595419,148.866412,267.959542,66.583073,1,0
0,0,2,2,7,5,12,9,7,16,0.000333,0.01912,3,172.0782,9.5599,57.3594,31.261125,1,0
0,0,2,2,7,5,12,9,7,16,0.000333,0.01912,3,172.0782,9.5599,57.3594,31.261125,1,0
0,0,8,8,12,12,24,42,29,71,0.000333,0.108511,12,3906.388051,217.021558,325.532338,86.0391,1,0
0,0,8,8,11,12,23,41,29,70,0.000333,0.10555,10,3166.493369,175.916298,316.649337,81.073298,1,0
0,0,2,2,7,5,12,9,7,16,0.000333,0.01912,3,172.0782,9.5599,57.3594,31.261125,1,0
0,0,2,2,7,5,12,9,7,16,0.000333,0.01912,3,172.0782,9.5599,57.3594,31.261125,1,0
0,0,2,2,7,5,12,9,7,16,0.000333,0.01912,3,172.0782,9.5599,57.3594,31.261125,1,0
0,0,2,2,7,5,12,9,7,16,0.000333,0.01912,3,172.0782,9.5599,57.3594,31.261125,1,0
0,0,13,13,13,17,30,72,55,127,0.000333,0.207725,18,11217.1519,623.175106,623.175106,117.592585,1,0
0,0,2,2,7,5,12,9,7,16,0.000333,0.01912,3,172.0782,9.5599,57.3594,31.261125,1,0
0,0,2,2,7,5,12,9,7,16,0.000333,0.01912,3,172.0782,9.5599,57.3594,31.261125,1,0
0,0,13,13,13,16,29,62,46,108,0.000333,0.174887,12,6295.94337,349.774632,524.661947,112.105716,1,0
0,0,2,2,7,5,12,9,7,16,0.000333,0.01912,3,172.0782,9.5599,57.3594,31.261125,1,0
0,0,2,2,7,5,12,9,7,16,0.000333,0.01912,3,172.0782,9.5599,57.3594,31.261125,1,0
0,0,13,13,12,16,28,65,48,113,0.000333,0.181077,18,9778.159911,543.231106,543.231106,107.01955,1,0
0,0,7,7,11,9,20,38,26,64,0.000333,0.092201,10,2766.033981,153.668554,276.603398,66.583073,1,0
0,0,2,2,7,5,12,9,7,16,0.000333,0.01912,3,172.0782,9.5599,57.3594,31.261125,1,0
0,0,2,2,7,5,12,9,7,16,0.000333,0.01912,3,172.0782,9.5599,57.3594,31.261125,1,0
0,0,2,2,7,5,12,9,7,16,0.000333,0.01912,3,172.0782,9.5599,57.3594,31.261125,1,0
0,0,8,8,12,12,24,43,30,73,0.000333,0.111567,12,4016.427151,223.134842,334.702263,86.0391,1,0
0,0,2,2,7,5,12,9,7,16,0.000333,0.01912,3,172.0782,9.5599,57.3594,31.261125,1,0
0,0,8,8,11,12,23,42,30,72,0.000333,0.108565,10,3256.964608,180.942478,325.696461,81.073298,1,0
0,0,2,2,7,5,12,9,7,16,0.000333,0.01912,3,172.0782,9.5599,57.3594,31.261125,1,0
0,0,2,2,7,5,12,9,7,16,0.000333,0.01912,3,172.0782,9.5599,57.3594,31.261125,1,0
0,0,13,13,13,17,30,73,56,129,0.000333,0.210996,18,11393.79996,632.988887,632.988887,117.592585,1,0
0,0,2,2,7,5,12,9,7,16,0.000333,0.01912,3,172.0782,9.5599,57.3594,31.261125,1,0
0,0,2,2,7,5,12,9,7,16,0.000333,0.01912,3,172.0782,9.5599,57.3594,31.261125,1,0
0,0,13,13,13,16,29,63,47,110,0.000333,0.178126,12,6412.534914,356.25194,534.377909,112.105716,1,0
0,0,2,2,7,5,12,9,7,16,0.000333,0.01912,3,172.0782,9.5599,57.3594,31.261125,1,0
0,0,2,2,7,5,12,9,7,16,0.000333,0.01912,3,172.0782,9.5599,57.3594,31.261125,1,0
0,0,13,13,12,16,28,66,49,115,0.000333,0.184282,18,9951.224689,552.845816,552.845816,107.01955,1,0
0,0,2,2,7,5,12,9,7,16,0.000333,0.01912,3,172.0782,9.5599,57.3594,31.261125,1,0
0,0,2,2,7,5,12,9,7,16,0.000333,0.01912,3,172.0782,9.5599,57.3594,31.261125,1,0
0,0,7,7,12,9,21,39,25,64,0.000333,0.093703,12,3373.299781,187.405543,281.108315,71.548875,1,0
0,0,2,2,7,5,12,9,7,16,0.000333,0.01912,3,172.0782,9.5599,57.3594,31.261125,1,0
0,0,2,2,7,5,12,9,7,16,0.000333,0.01912,3,172.0782,9.5599,57.3594,31.261125,1,0
0,0,8,8,13,12,25,44,29,73,0.000333,0.113001,12,4068.018022,226.001001,339.001502,91.125266,1,0
0,0,2,2,7,5,12,9,7,16,0.000333,0.01912,3,172.0782,9.5599,57.3594,31.261125,1,0
0,0,2,2,7,5,12,9,7,16,0.000333,0.01912,3,172.0782,9.5599,57.3594,31.261125,1,0
0,0,8,8,12,12,24,43,29,72,0.000333,0.110039,12,3961.407601,220.0782,330.1173,86.0391,1,0
0,0,2,2,7,5,12,9,7,16,0.000333,0.01912,3,172.0782,9.5599,57.3594,31.261125,1,0
0,0,2,2,7,5,12,9,7,16,0.000333,0.01912,3,172.0782,9.5599,57.3594,31.261125,1,0
0,0,13,13,14,17,31,74,55,129,0.000333,0.21303,21,13420.91781,745.606545,639.091324,122.789837,1,0
0,0,2,2,7,5,12,9,7,16,0.000333,0.01912,3,172.0782,9.5599,57.3594,31.261125,1,0
0,0,2,2,7,5,12,9,7,16,0.000333,0.01912,3,172.0782,9.5599,57.3594,31.261125,1,0
0,0,13,13,14,16,30,64,46,110,0.000333,0.179919,14,7556.611517,419.811751,539.757966,117.302969,1,0
0,0,2,2,7,5,12,9,7,16,0.000333,0.01912,3,172.0782,9.5599,57.3594,31.261125,1,0
0,0,2,2,7,5,12,9,7,16,0.000333,0.01912,3,172.0782,9.5599,57.3594,31.261125,1,0
0,0,13,13,13,16,29,67,48,115,0.000333,0.186223,18,10056.02066,558.667814,558.667814,112.105716,1,0
0,0,2,2,7,5,12,9,7,16,0.000333,0.01912,3,172.0782,9.5599,57.3594,31.261125,1,0
0,0,2,2,7,5,12,9,7,16,0.000333,0.01912,3,172.0782,9.5599,57.3594,31.261125,1,0
0,0,5,5,12,9,21,33,26,59,0.000333,0.086382,12,3109.760735,172.764485,259.146728,71.548875,1,0
0,0,5,5,13,11,24,34,27,61,0.000333,0.093228,12,3356.192551,186.455142,279.682713,86.159464,1,0
0,0,5,5,12,11,23,33,27,60,0.000333,0.090471,12,3256.964608,180.942478,271.413717,81.073298,1,0
0,0,10,10,14,17,31,64,55,119,0.000333,0.196516,21,12380.53658,687.807588,589.549361,122.789837,1,0
0,0,10,10,14,15,29,54,46,100,0.000333,0.161933,21,10201.76009,566.764449,485.7981,111.906328,1,0
0,0,10,10,13,16,29,57,48,105,0.000333,0.170029,18,9181.584081,510.088004,510.088004,112.105716,1,0
0,0,5,5,12,9,21,33,26,59,0.000333,0.086382,12,3109.760735,172.764485,259.146728,71.548875,1,0
0,0,5,5,13,11,24,34,27,61,0.000333,0.093228,12,3356.192551,186.455142,279.682713,86.159464,1,0
0,0,5,5,12,11,23,34,27,61,0.000333,0.091979,12,3311.247352,183.958186,275.937279,81.073298,1,0
0,0,10,10,14,17,31,64,55,119,0.000333,0.196516,21,12380.53658,687.807588,589.549361,122.789837,1,0
0,0,10,10,14,15,29,54,46,100,0.000333,0.161933,21,10201.76009,566.764449,485.7981,111.906328,1,0
0,0,10,10,13,16,29,57,48,105,0.000333,0.170029,18,9181.584081,510.088004,510.088004,112.105716,1,0
0,0,5,5,12,8,20,33,20,53,0.000333,0.076354,12,2748.746268,152.708126,229.062189,67.01955,1,0
0,0,5,5,13,10,23,34,22,56,0.000333,0.08444,12,3039.833634,168.879646,253.31947,81.324997,1,0
0,0,5,5,12,10,22,33,22,55,0.000333,0.081756,12,2943.224868,163.512493,245.268739,76.238831,1,0
0,0,10,10,14,16,30,64,48,112,0.000333,0.183191,21,11541.00668,641.167038,549.571747,117.302969,1,0
0,0,10,10,14,14,28,54,39,93,0.000333,0.149028,14,6259.176109,347.732006,447.084008,106.605938,1,0
0,0,10,10,13,14,27,57,41,98,0.000333,0.155326,12,5591.747703,310.65265,465.978975,101.408685,1,0
0,0,5,5,12,8,20,33,20,53,0.000333,0.076354,12,2748.746268,152.708126,229.062189,67.01955,1,0
0,0,5,5,13,10,23,34,22,56,0.000333,0.08444,12,3039.833634,168.879646,253.31947,81.324997,1,0
0,0,5,5,12,10,22,33,22,55,0.000333,0.081756,12,2943.224868,163.512493,245.268739,76.238831,1,0
0,0,10,10,14,16,30,64,48,112,0.000333,0.183191,21,11541.00668,641.167038,549.571747,117.302969,1,0
0,0,10,10,14,14,28,54,39,93,0.000333,0.149028,14,6259.176109,347.732006,447.084008,106.605938,1,0
0,0,10,10,13,14,27,57,41,98,0.000333,0.155326,12,5591.747703,310.65265,465.978975,101.408685,1,0
0,0,8,8,14,11,25,48,32,80,0.000333,0.123836,14,5201.118933,288.951052,371.508495,91.356717,2,0
0,0,8,8,15,13,28,49,34,83,0.000333,0.133003,14,5586.146419,310.341468,399.010459,106.709075,2,0
0,0,8,8,14,13,27,48,34,82,0.000333,0.129967,14,5458.610852,303.256158,389.900775,101.408685,2,0
0,0,13,13,14,19,33,79,60,139,0.000333,0.233724,21,14724.58643,818.03258,701.170783,134.013592,2,0
0,0,13,13,14,17,31,69,51,120,0.000333,0.198168,21,12484.5747,693.587483,594.503557,122.789837,2,0
0,0,13,13,14,18,32,72,53,125,0.000333,0.208333,14,8750,486.111111,625,128.361619,2,0
0,0,8,8,14,11,25,48,32,80,0.000333,0.123836,14,5201.118933,288.951052,371.508495,91.356717,2,0
0,0,8,8,15,13,28,49,34,83,0.000333,0.133003,14,5586.146419,310.341468,399.010459,106.709075,2,0
0,0,8,8,14,13,27,48,34,82,0.000333,0.129967,14,5458.610852,303.256158,389.900775,101.408685,2,0
0,0,13,13,14,19,33,79,60,139,0.000333,0.233724,21,14724.58643,818.03258,701.170783,134.013592,2,0
0,0,13,13,14,17,31,69,51,120,0.000333,0.198168,21,12484.5747,693.587483,594.503557,122.789837,2,0
0,0,13,13,14,18,32,72,53,125,0.000333,0.208333,14,8750,486.111111,625,128.361619,2,0
0,0,2,2,7,5,12,9,7,16,0.000333,0.01912,3,172.0782,9.5599,57.3594,31.261125,1,0
0,0,7,7,11,9,20,41,26,67,0.000333,0.096523,10,2895.691824,160.871768,289.569182,66.583073,1,0
0,0,2,2,7,5,12,9,7,16,0.000333,0.01912,3,172.0782,9.5599,57.3594,31.261125,1,0
0,0,8,8,12,12,24,46,30,76,0.000333,0.116152,12,4181.485801,232.304767,348.45715,86.0391,1,0
0,0,2,2,7,5,12,9,7,16,0.000333,0.01912,3,172.0782,9.5599,57.3594,31.261125,1,0
0,0,2,2,7,5,12,9,7,16,0.000333,0.01912,3,172.0782,9.5599,57.3594,31.261125,1,0
0,0,2,2,7,5,12,9,7,16,0.000333,0.01912,3,172.0782,9.5599,57.3594,31.261125,1,0
0,0,2,2,7,5,12,9,7,16,0.000333,0.01912,3,172.0782,9.5599,57.3594,31.261125,1,0
0,0,8,8,11,12,23,45,30,75,0.000333,0.113089,10,3392.671467,188.481748,339.267147,81.073298,1,0
0,0,13,13,13,17,30,76,56,132,0.000333,0.215903,18,11658.77206,647.709559,647.709559,117.592585,1,0
0,0,2,2,7,5,12,9,7,16,0.000333,0.01912,3,172.0782,9.5599,57.3594,31.261125,1,0
0,0,2,2,7,5,12,9,7,16,0.000333,0.01912,3,172.0782,9.5599,57.3594,31.261125,1,0
0,0,13,13,13,16,29,66,47,113,0.000333,0.182984,12,6587.422229,365.967902,548.951852,112.105716,1,0
0,0,2,2,7,5,12,9,7,16,0.000333,0.01912,3,172.0782,9.5599,57.3594,31.261125,1,0
0,0,2,2,7,5,12,9,7,16,0.000333,0.01912,3,172.0782,9.5599,57.3594,31.261125,1,0
0,0,13,13,12,16,28,69,49,118,0.000333,0.189089,18,10210.82185,567.267881,567.267881,107.01955,1,0
0,0,2,2,7,5,12,9,7,16,0.000333,0.01912,3,172.0782,9.5599,57.3594,31.261125,1,0
0,0,2,2,7,5,12,9,7,16,0.000333,0.01912,3,172.0782,9.5599,57.3594,31.261125,1,0
0,0,7,7,11,9,20,41,26,67,0.000333,0.096523,10,2895.691824,160.871768,289.569182,66.583073,1,0
0,0,2,2,7,5,12,9,7,16,0.000333,0.01912,3,172.0782,9.5599,57.3594,31.261125,1,0
0,0,2,2,7,5,12,9,7,16,0.000333,0.01912,3,172.0782,9.5599,57.3594,31.261125,1,0
0,0,8,8,12,12,24,46,30,76,0.000333,0.116152,12,4181.485801,232.304767,348.45715,86.0391,1,0
0,0,2,2,7,5,12,9,7,16,0.000333,0.01912,3,172.0782,9.5599,57.3594,31.261125,1,0
0,0,2,2,7,5,12,9,7,16,0.000333,0.01912,3,172.0782,9.5599,57.3594,31.261125,1,0
0,0,8,8,11,12,23,45,30,75,0.000333,0.113089,10,3392.671467,188.481748,339.267147,81.073298,1,0
0,0,2,2,7,5,12,9,7,16,0.000333,0.01912,3,172.0782,9.5599,57.3594,31.261125,1,0
0,0,2,2,7,5,12,9,7,16,0.000333,0.01912,3,172.0782,9.5599,57.3594,31.261125,1,0
0,0,13,13,13,17,30,76,56,132,0.000333,0.215903,18,11658.77206,647.709559,647.709559,117.592585,1,0
0,0,2,2,7,5,12,9,7,16,0.000333,0.01912,3,172.0782,9.5599,57.3594,31.261125,1,0
0,0,2,2,7,5,12,9,7,16,0.000333,0.01912,3,172.0782,9.5599,57.3594,31.261125,1,0
0,0,13,13,13,16,29,66,47,113,0.000333,0.182984,12,6587.422229,365.967902,548.951852,112.105716,1,0
0,0,2,2,7,5,12,9,7,16,0.000333,0.01912,3,172.0782,9.5599,57.3594,31.261125,1,0
0,0,2,2,7,5,12,9,7,16,0.000333,0.01912,3,172.0782,9.5599,57.3594,31.261125,1,0
0,0,13,13,12,16,28,69,49,118,0.000333,0.189089,18,10210.82185,567.267881,567.267881,107.01955,1,0
0,0,2,2,7,5,12,9,7,16,0.000333,0.01912,3,172.0782,9.5599,57.3594,31.261125,1,0
0,0,2,2,7,5,12,9,7,16,0.000333,0.01912,3,172.0782,9.5599,57.3594,31.261125,1,0
0,0,2,2,7,5,12,9,7,16,0.000333,0.01912,3,172.0782,9.5599,57.3594,31.261125,1,0
0,0,7,7,11,9,20,37,25,62,0.000333,0.08932,10,2679.595419,148.866412,267.959542,66.583073,1,0
0,0,2,2,7,5,12,9,7,16,0.000333,0.01912,3,172.0782,9.5599,57.3594,31.261125,1,0
0,0,2,2,7,5,12,9,7,16,0.000333,0.01912,3,172.0782,9.5599,57.3594,31.261125,1,0
0,0,8,8,12,12,24,42,29,71,0.000333,0.108511,12,3906.388051,217.021558,325.532338,86.0391,1,0
0,0,2,2,7,5,12,9,7,16,0.000333,0.01912,3,172.0782,9.5599,57.3594,31.261125,1,0
0,0,2,2,7,5,12,9,7,16,0.000333,0.01912,3,172.0782,9.5599,57.3594,31.261125,1,0
0,0,2,2,7,5,12,9,7,16,0.000333,0.01912,3,172.0782,9.5599,57.3594,31.261125,1,0
0,0,8,8,11,12,23,41,29,70,0.000333,0.10555,10,3166.493369,175.916298,316.649337,81.073298,1,0
0,0,2,2,7,5,12,9,7,16,0.000333,0.01912,3,172.0782,9.5599,57.3594,31.261125,1,0
0,0,13,13,13,17,30,72,55,127,0.000333,0.207725,18,11217.1519,623.175106,623.175106,117.592585,1,0
0,0,2,2,7,5,12,9,7,16,0.000333,0.01912,3,172.0782,9.5599,57.3594,31.261125,1,0
0,0,2,2,7,5,12,9,7,16,0.000333,0.01912,3,172.0782,9.5599,57.3594,31.261125,1,0
0,0,13,13,13,16,29,62,46,108,0.000333,0.174887,12,6295.94337,349.774632,524.661947,112.105716,1,0
0,0,2,2,7,5,12,9,7,16,0.000333,0.01912,3,172.0782,9.5599,57.3594,31.261125,1,0
0,0,2,2,7,5,12,9,7,16,0.000333,0.01912,3,172.0782,9.5599,57.3594,31.261125,1,0
0,0,13,13,12,16,28,65,48,113,0.000333,0.181077,18,9778.159911,543.231106,543.231106,107.01955,1,0
0,0,2,2,7,5,12,9,7,16,0.000333,0.01912,3,172.0782,9.5599,57.3594,31.261125,1,0
0,0,2,2,7,5,12,9,7,16,0.000333,0.01912,3,172.0782,9.5599,57.3594,31.261125,1,0
0,0,7,7,11,9,20,38,26,64,0.000333,0.092201,10,2766.033981,153.668554,276.603398,66.583073,1,0
0,0,2,2,7,5,12,9,7,16,0.000333,0.01912,3,172.0782,9.5599,57.3594,31.261125,1,0
0,0,2,2,7,5,12,9,7,16,0.000333,0.01912,3,172.0782,9.5599,57.3594,31.261125,1,0
0,0,2,2,7,5,12,9,7,16,0.000333,0.01912,3,172.0782,9.5599,57.3594,31.261125,1,0
0,0,8,8,12,12,24,43,30,73,0.000333,0.111567,12,4016.427151,223.134842,334.702263,86.0391,1,0
0,0,2,2,7,5,12,9,7,16,0.000333,0.01912,3,172.0782,9.5599,57.3594,31.261125,1,0
0,0,8,8,11,13,24,42,30,72,0.000333,0.110039,10,3301.173001,183.3985,330.1173,86.159464,1,0
0,0,2,2,7,5,12,9,7,16,0.000333,0.01912,3,172.0782,9.5599,57.3594,31.261125,1,0
0,0,2,2,7,5,12,9,7,16,0.000333,0.01912,3,172.0782,9.5599,57.3594,31.261125,1,0
0,0,13,13,13,17,30,73,56,129,0.000333,0.210996,18,11393.79996,632.988887,632.988887,117.592585,1,0
0,0,2,2,7,5,12,9,7,16,0.000333,0.01912,3,172.0782,9.5599,57.3594,31.261125,1,0
0,0,2,2,7,5,12,9,7,16,0.000333,0.01912,3,172.0782,9.5599,57.3594,31.261125,1,0
0,0,13,13,13,16,29,63,47,110,0.000333,0.178126,12,6412.534914,356.25194,534.377909,112.105716,1,0
0,0,2,2,7,5,12,9,7,16,0.000333,0.01912,3,172.0782,9.5599,57.3594,31.261125,1,0
0,0,2,2,7,5,12,9,7,16,0.000333,0.01912,3,172.0782,9.5599,57.3594,31.261125,1,0
0,0,13,13,12,16,28,66,49,115,0.000333,0.184282,18,9951.224689,552.845816,552.845816,107.01955,1,0
0,0,2,2,7,5,12,9,7,16,0.000333,0.01912,3,172.0782,9.5599,57.3594,31.261125,1,0
0,0,7,7,12,9,21,39,25,64,0.000333,0.093703,12,3373.299781,187.405543,281.108315,71.548875,1,0
0,0,2,2,7,5,12,9,7,16,0.000333,0.01912,3,172.0782,9.5599,57.3594,31.261125,1,0
0,0,2,2,7,5,12,9,7,16,0.000333,0.01912,3,172.0782,9.5599,57.3594,31.261125,1,0
0,0,8,8,13,12,25,44,29,73,0.000333,0.113001,12,4068.018022,226.001001,339.001502,91.125266,1,0
0,0,2,2,7,5,12,9,7,16,0.000333,0.01912,3,172.0782,9.5599,57.3594,31.261125,1,0
0,0,2,2,7,5,12,9,7,16,0.000333,0.01912,3,172.0782,9.5599,57.3594,31.261125,1,0
0,0,2,2,7,5,12,9,7,16,0.000333,0.01912,3,172.0782,9.5599,57.3594,31.261125,1,0
0,0,2,2,7,5,12,9,7,16,0.000333,0.01912,3,172.0782,9.5599,57.3594,31.261125,1,0
0,0,13,13,14,17,31,74,55,129,0.000333,0.21303,21,13420.91781,745.606545,639.091324,122.789837,1,0
0,0,2,2,7,5,12,9,7,16,0.000333,0.01912,3,172.0782,9.5599,57.3594,31.261125,1,0
0,0,2,2,7,5,12,9,7,16,0.000333,0.01912,3,172.0782,9.5599,57.3594,31.261125,1,0
0,0,13,13,14,16,30,64,46,110,0.000333,0.179919,14,7556.611517,419.811751,539.757966,117.302969,1,0
0,0,2,2,7,5,12,9,7,16,0.000333,0.01912,3,172.0782,9.5599,57.3594,31.261125,1,0
0,0,2,2,7,5,12,9,7,16,0.000333,0.01912,3,172.0782,9.5599,57.3594,31.261125,1,0
0,0,13,13,13,16,29,67,48,115,0.000333,0.186223,18,10056.02066,558.667814,558.667814,112.105716,1,0
0,0,2,2,7,5,12,9,7,16,0.000333,0.01912,3,172.0782,9.5599,57.3594,31.261125,1,0
0,0,2,2,7,5,12,9,7,16,0.000333,0.01912,3,172.0782,9.5599,57.3594,31.261125,1,0
0,0,7,7,11,11,22,44,27,71,0.000333,0.10554,10,3166.196449,175.899803,316.619645,76.107496,1,0
0,0,7,7,12,13,25,45,29,74,0.000333,0.114548,12,4123.744297,229.096905,343.645358,91.125266,1,0
0,0,7,7,11,13,24,45,29,74,0.000333,0.113096,10,3392.872251,188.492903,339.287225,86.159464,1,0
0,0,12,12,13,18,31,75,55,130,0.000333,0.214682,18,11592.81937,644.04552,644.04552,123.164366,1,0
0,0,12,12,13,17,30,65,46,111,0.000333,0.181555,12,6535.978273,363.109904,544.664856,117.592585,1,0
0,0,12,12,12,18,30,68,48,116,0.000333,0.189733,12,6830.391709,379.466206,569.199309,118.0782,1,0
0,0,7,7,11,11,22,44,27,71,0.000333,0.10554,10,3166.196449,175.899803,316.619645,76.107496,1,0
0,0,7,7,12,13,25,45,29,74,0.000333,0.114548,12,4123.744297,229.096905,343.645358,91.125266,1,0
0,0,7,7,11,13,24,45,29,74,0.000333,0.113096,10,3392.872251,188.492903,339.287225,86.159464,1,0
0,0,12,12,13,18,31,75,55,130,0.000333,0.214682,18,11592.81937,644.04552,644.04552,123.164366,1,0
0,0,12,12,13,17,30,65,46,111,0.000333,0.181555,12,6535.978273,363.109904,544.664856,117.592585,1,0
0,0,12,12,12,18,30,68,48,116,0.000333,0.189733,12,6830.391709,379.466206,569.199309,118.0782,1,0
0,0,7,7,11,11,22,40,26,66,0.000333,0.098107,10,2943.224868,163.512493,294.322487,76.107496,1,0
0,0,7,7,12,13,25,41,28,69,0.000333,0.106809,12,3845.112925,213.617385,320.426077,91.125266,1,0
0,0,7,7,11,13,24,41,28,69,0.000333,0.105454,10,3163.624125,175.756896,316.362413,86.159464,1,0
0,0,12,12,13,18,31,71,54,125,0.000333,0.206425,18,11146.9417,619.274539,619.274539,123.164366,1,0
0,0,12,12,13,17,30,61,45,106,0.000333,0.173377,12,6241.564838,346.753602,520.130403,117.592585,1,0
0,0,12,12,12,18,30,64,47,111,0.000333,0.181555,12,6535.978273,363.109904,544.664856,118.0782,1,0
0,0,7,7,11,11,22,40,26,66,0.000333,0.098107,10,2943.224868,163.512493,294.322487,76.107496,1,0
0,0,7,7,12,13,25,41,28,69,0.000333,0.106809,12,3845.112925,213.617385,320.426077,91.125266,1,0
0,0,7,7,11,13,24,40,28,68,0.000333,0.103926,10,3117.7745,173.209694,311.77745,86.159464,1,0
0,0,12,12,13,18,31,71,54,125,0.000333,0.206425,18,11146.9417,619.274539,619.274539,123.164366,1,0
0,0,12,12,13,17,30,61,45,106,0.000333,0.173377,12,6241.564838,346.753602,520.130403,117.592585,1,0
0,0,12,12,12,18,30,64,47,111,0.000333,0.181555,12,6535.978273,363.109904,544.664856,118.0782,1,0
0,0,7,7,12,11,23,42,26,68,0.000333,0.102534,12,3691.226556,205.068142,307.602213,81.073298,1,0
0,0,7,7,13,13,26,43,28,71,0.000333,0.111244,12,4004.77464,222.48748,333.73122,96.211433,1,0
0,0,7,7,12,13,25,42,28,70,0.000333,0.108357,12,3900.839199,216.713289,325.069933,91.125266,1,0
0,0,12,12,14,18,32,73,54,127,0.000333,0.211667,21,13335,740.833333,635,128.361619,1,0
0,0,12,12,14,17,31,63,45,108,0.000333,0.178351,14,7490.744821,416.15249,535.053202,122.789837,1,0
0,0,12,12,13,18,31,66,47,113,0.000333,0.186608,12,6717.890197,373.216122,559.824183,123.164366,1,0
0,0,7,7,11,11,22,44,27,71,0.000333,0.10554,10,3166.196449,175.899803,316.619645,76.107496,1,0
0,0,7,7,12,13,25,45,29,74,0.000333,0.114548,12,4123.744297,229.096905,343.645358,91.125266,1,0
0,0,7,7,11,13,24,44,29,73,0.000333,0.111567,10,3347.022626,185.945701,334.702263,86.159464,1,0
0,0,12,12,13,18,31,75,55,130,0.000333,0.214682,18,11592.81937,644.04552,644.04552,123.164366,1,0
0,0,12,12,13,17,30,65,46,111,0.000333,0.181555,12,6535.978273,363.109904,544.664856,117.592585,1,0
0,0,12,12,12,18,30,68,48,116,0.000333,0.189733,12,6830.391709,379.466206,569.199309,118.0782,1,0
0,0,7,7,11,11,22,44,27,71,0.000333,0.10554,10,3166.196449,175.899803,316.619645,76.107496,1,0
0,0,7,7,12,13,25,45,29,74,0.000333,0.114548,12,4123.744297,229.096905,343.645358,91.125266,1,0
0,0,7,7,11,13,24,44,29,73,0.000333,0.111567,10,3347.022626,185.945701,334.702263,86.159464,1,0
0,0,12,12,13,18,31,75,55,130,0.000333,0.214682,18,11592.81937,644.04552,644.04552,123.164366,1,0
0,0,12,12,13,17,30,65,46,111,0.000333,0.181555,12,6535.978273,363.109904,544.664856,117.592585,1,0
0,0,12,12,12,18,30,68,48,116,0.000333,0.189733,12,6830.391709,379.466206,569.199309,118.0782,1,0
0,0,7,7,11,11,22,40,26,66,0.000333,0.098107,10,2943.224868,163.512493,294.322487,76.107496,1,0
0,0,7,7,12,13,25,41,28,69,0.000333,0.106809,12,3845.112925,213.617385,320.426077,91.125266,1,0
0,0,7,7,11,13,24,40,28,68,0.000333,0.103926,10,3117.7745,173.209694,311.77745,86.159464,1,0
0,0,12,12,13,18,31,71,54,125,0.000333,0.206425,18,11146.9417,619.274539,619.274539,123.164366,1,0
0,0,12,12,13,17,30,61,45,106,0.000333,0.173377,12,6241.564838,346.753602,520.130403,117.592585,1,0
0,0,12,12,12,18,30,64,47,111,0.000333,0.181555,12,6535.978273,363.109904,544.664856,118.0782,1,0
0,0,7,7,11,11,22,40,26,66,0.000333,0.098107,10,2943.224868,163.512493,294.322487,76.107496,1,0
0,0,7,7,12,13,25,41,28,69,0.000333,0.106809,12,3845.112925,213.617385,320.426077,91.125266,1,0
0,0,7,7,11,13,24,40,28,68,0.000333,0.103926,10,3117.7745,173.209694,311.77745,86.159464,1,0
0,0,12,12,13,18,31,71,54,125,0.000333,0.206425,18,11146.9417,619.274539,619.274539,123.164366,1,0
0,0,12,12,13,17,30,61,45,106,0.000333,0.173377,12,6241.564838,346.753602,520.130403,117.592585,1,0
0,0,12,12,12,18,30,64,47,111,0.000333,0.181555,12,6535.978273,363.109904,544.664856,118.0782,1,0
0,0,7,7,12,11,23,42,26,68,0.000333,0.102534,12,3691.226556,205.068142,307.602213,81.073298,1,0
0,0,7,7,13,13,26,43,28,71,0.000333,0.111244,12,4004.77464,222.48748,333.73122,96.211433,1,0
0,0,7,7,12,13,25,42,28,70,0.000333,0.108357,12,3900.839199,216.713289,325.069933,91.125266,1,0
0,0,12,12,14,18,32,73,54,127,0.000333,0.211667,21,13335,740.833333,635,128.361619,1,0
0,0,12,12,14,17,31,63,45,108,0.000333,0.178351,14,7490.744821,416.15249,535.053202,122.789837,1,0
0,0,12,12,13,18,31,66,47,113,0.000333,0.186608,12,6717.890197,373.216122,559.824183,123.164366,1,0
0,0,7,7,11,9,20,36,24,60,0.000333,0.086439,10,2593.156857,144.06427,259.315686,66.583073,1,0
0,0,8,8,12,12,24,41,28,69,0.000333,0.105454,12,3796.348951,210.908275,316.362413,86.0391,1,0
0,0,8,8,11,12,23,40,28,68,0.000333,0.102534,10,3076.02213,170.890118,307.602213,81.073298,1,0
0,0,13,13,13,17,30,71,54,125,0.000333,0.204454,18,11040.50384,613.361324,613.361324,117.592585,1,0
0,0,13,13,13,16,29,61,45,106,0.000333,0.171649,12,6179.351826,343.297324,514.945985,112.105716,1,0
0,0,13,13,12,16,28,64,47,111,0.000333,0.177872,12,6403.396756,355.744264,533.616396,107.01955,1,0
0,0,8,8,11,10,21,40,26,66,0.000333,0.096631,10,2898.929499,161.051639,289.89295,71.273029,1,0
0,0,8,8,12,12,24,41,28,69,0.000333,0.105454,12,3796.348951,210.908275,316.362413,86.0391,1,0
0,0,8,8,11,12,23,40,28,68,0.000333,0.102534,10,3076.02213,170.890118,307.602213,81.073298,1,0
0,0,13,13,13,17,30,71,54,125,0.000333,0.204454,18,11040.50384,613.361324,613.361324,117.592585,1,0
0,0,13,13,13,16,29,61,45,106,0.000333,0.171649,12,6179.351826,343.297324,514.945985,112.105716,1,0
0,0,13,13,12,16,28,64,47,111,0.000333,0.177872,12,6403.396756,355.744264,533.616396,107.01955,1,0
0,0,8,8,11,10,21,40,26,66,0.000333,0.096631,10,2898.929499,161.051639,289.89295,71.273029,1,0
0,0,8,8,12,12,24,41,28,69,0.000333,0.105454,12,3796.348951,210.908275,316.362413,86.0391,1,0
0,0,8,8,11,12,23,40,28,68,0.000333,0.102534,10,3076.02213,170.890118,307.602213,81.073298,1,0
0,0,13,13,13,17,30,71,54,125,0.000333,0.204454,18,11040.50384,613.361324,613.361324,117.592585,1,0
0,0,13,13,13,16,29,61,45,106,0.000333,0.171649,12,6179.351826,343.297324,514.945985,112.105716,1,0
0,0,13,13,12,16,28,64,47,111,0.000333,0.177872,12,6403.396756,355.744264,533.616396,107.01955,1,0
0,0,7,7,11,10,21,37,24,61,0.000333,0.08931,10,2679.313628,148.850757,267.931363,71.273029,1,0
0,0,7,7,12,12,24,38,26,64,0.000333,0.097813,12,3521.251201,195.625067,293.4376,86.0391,1,0
0,0,7,7,11,12,23,37,26,63,0.000333,0.094995,10,2849.844032,158.324668,284.984403,81.073298,1,0
0,0,12,12,13,17,30,68,52,120,0.000333,0.196276,18,10598.88369,588.826871,588.826871,117.592585,1,0
0,0,12,12,13,16,29,58,43,101,0.000333,0.163552,12,5887.872966,327.104054,490.656081,112.105716,1,0
0,0,12,12,12,17,29,61,45,106,0.000333,0.171649,12,6179.351826,343.297324,514.945985,112.506418,1,0
0,0,7,7,11,10,21,37,24,61,0.000333,0.08931,10,2679.313628,148.850757,267.931363,71.273029,1,0
0,0,7,7,12,12,24,38,26,64,0.000333,0.097813,12,3521.251201,195.625067,293.4376,86.0391,1,0
0,0,7,7,11,12,23,37,26,63,0.000333,0.094995,10,2849.844032,158.324668,284.984403,81.073298,1,0
0,0,12,12,13,17,30,68,52,120,0.000333,0.196276,18,10598.88369,588.826871,588.826871,117.592585,1,0
0,0,12,12,13,16,29,58,43,101,0.000333,0.163552,12,5887.872966,327.104054,490.656081,112.105716,1,0
0,0,12,12,12,17,29,61,45,106,0.000333,0.171649,12,6179.351826,343.297324,514.945985,112.506418,1,0
0,0,7,7,11,10,21,36,24,60,0.000333,0.087846,10,2635.390454,146.410581,263.539045,71.273029,1,0
0,0,7,7,12,12,24,38,26,64,0.000333,0.097813,12,3521.251201,195.625067,293.4376,86.0391,1,0
0,0,7,7,11,12,23,37,26,63,0.000333,0.094995,10,2849.844032,158.324668,284.984403,81.073298,1,0
0,0,12,12,13,17,30,68,52,120,0.000333,0.196276,18,10598.88369,588.826871,588.826871,117.592585,1,0
0,0,12,12,13,16,29,58,43,101,0.000333,0.163552,12,5887.872966,327.104054,490.656081,112.105716,1,0
0,0,12,12,12,17,29,61,45,106,0.000333,0.171649,12,6179.351826,343.297324,514.945985,112.506418,1,0
0,0,5,5,6,7,13,23,13,36,0.000333,0.044405,3,399.64749,22.202638,133.21583,35.161259,3,0
0,0,6,6,8,9,17,28,18,46,0.000333,0.062674,8,1504.186326,83.565907,188.023291,52.529325,3,0
0,0,6,6,7,9,16,27,18,45,0.000333,0.06,6,1080,60,180,48.180809,3,0
0,0,11,11,12,15,27,58,44,102,0.000333,0.161666,12,5819.982303,323.33235,484.998525,101.622909,5,0
0,0,11,11,9,13,22,48,35,83,0.000333,0.123378,8,2961.062595,164.503477,370.132824,76.635041,5,0
0,0,11,11,11,15,26,51,37,88,0.000333,0.13788,10,4136.386952,229.799275,413.638695,96.657107,5,0
0,0,5,5,6,9,15,23,16,39,0.000333,0.05079,3,457.1062,25.394789,152.368733,44.0391,1,0
0,0,6,6,8,11,19,28,21,49,0.000333,0.069383,4,832.593793,46.255211,208.148448,62.053748,1,0
0,0,6,6,7,11,18,27,21,48,0.000333,0.066719,3,600.4692,33.3594,200.1564,57.705232,1,0
0,0,11,11,12,17,29,58,49,107,0.000333,0.173268,12,6237.647598,346.535978,519.803966,112.506418,1,0
0,0,11,11,9,15,24,48,40,88,0.000333,0.134492,8,3227.813601,179.322978,403.4767,87.132684,1,0
0,0,11,11,11,17,28,51,42,93,0.000333,0.149028,10,4470.840078,248.380004,447.084008,107.540616,1,0
0,0,4,4,6,6,12,19,11,30,0.000333,0.03585,3,322.646625,17.924813,107.548875,31.01955,1,0
0,0,5,5,8,8,16,24,16,40,0.000333,0.053333,8,1280,71.111111,160,48,1,0
0,0,5,5,7,8,15,23,16,39,0.000333,0.05079,6,914.212399,50.789578,152.368733,43.651484,1,0
0,0,10,10,12,14,26,54,42,96,0.000333,0.150414,18,8122.359833,451.242213,451.242213,96.322519,1,0
0,0,10,10,9,12,21,44,33,77,0.000333,0.112736,8,2705.667532,150.314863,338.208442,71.548875,1,0
0,0,10,10,11,14,25,47,35,82,0.000333,0.126932,10,3807.962076,211.553449,380.796208,91.356717,1,0
0,0,6,6,13,12,25,32,23,55,0.000333,0.085137,6,1532.472543,85.137363,255.41209,91.125266,5,0
0,0,8,8,15,16,31,39,31,70,0.000333,0.115598,7,2427.556192,134.864233,346.793742,122.603359,5,0
0,0,8,8,14,16,30,38,31,69,0.000333,0.112858,7,2370.028158,131.668231,338.575451,117.302969,5,0
0,0,13,13,15,21,36,67,57,124,0.000333,0.21369,14,8974.989803,498.610545,641.0707,150.842025,5,0
0,0,13,13,15,20,35,57,48,105,0.000333,0.179525,14,7540.046035,418.891446,538.574717,145.041921,5,0
0,0,13,13,14,19,33,60,50,110,0.000333,0.184961,14,7768.366944,431.575941,554.883353,134.013592,5,0
0,0,6,6,13,12,25,31,20,51,0.000333,0.078946,6,1421.019994,78.945555,236.836666,91.125266,4,0
0,0,8,8,15,16,31,38,28,66,0.000333,0.108992,7,2288.838695,127.157705,326.976956,122.603359,4,0
0,0,7,7,13,16,29,34,26,60,0.000333,0.09716,6,1748.873158,97.15962,291.47886,112.105716,4,0
0,0,13,13,15,21,36,66,54,120,0.000333,0.206797,14,8685.474002,482.526333,620.391,150.842025,4,0
0,0,13,13,15,20,35,56,45,101,0.000333,0.172686,14,7252.806186,402.933677,518.057585,145.041921,4,0
0,0,13,13,14,19,33,59,47,106,0.000333,0.178235,14,7485.880873,415.882271,534.705777,134.013592,4,0
0,0,3,3,13,7,20,19,10,29,0.000333,0.041779,6,752.015489,41.778638,125.335915,67.757201,3,0
0,0,5,5,14,11,25,26,18,44,0.000333,0.06811,7,1430.307706,79.461539,204.329672,91.356717,3,0
0,0,5,5,13,11,24,25,18,43,0.000333,0.065718,6,1182.920325,65.717796,197.153388,86.159464,3,0
0,0,10,10,15,16,31,54,44,98,0.000333,0.161837,14,6797.157338,377.619852,485.511238,122.603359,3,0
0,0,10,10,15,15,30,44,35,79,0.000333,0.129215,14,5427.020999,301.501167,387.644357,117.206718,3,0
0,0,10,10,14,14,28,47,37,84,0.000333,0.134606,14,5653.449388,314.080522,403.817813,106.605938,3,0
0,0,6,6,13,12,25,32,23,55,0.000333,0.085137,6,1532.472543,85.137363,255.41209,91.125266,5,0
0,0,8,8,15,16,31,39,31,70,0.000333,0.115598,7,2427.556192,134.864233,346.793742,122.603359,5,0
0,0,8,8,14,16,30,38,31,69,0.000333,0.112858,7,2370.028158,131.668231,338.575451,117.302969,5,0
0,0,13,13,15,21,36,67,57,124,0.000333,0.21369,14,8974.989803,498.610545,641.0707,150.842025,5,0
0,0,13,13,15,20,35,57,48,105,0.000333,0.179525,14,7540.046035,418.891446,538.574717,145.041921,5,0
0,0,13,13,14,19,33,60,50,110,0.000333,0.184961,14,7768.366944,431.575941,554.883353,134.013592,5,0
0,0,10,10,11,10,21,50,34,84,0.000333,0.122985,15,5534.319953,307.46222,368.954664,71.273029,1,0
0,0,15,15,13,17,30,81,62,143,0.000333,0.233895,18,12630.33639,701.685355,701.685355,117.592585,1,0
0,0,15,15,13,16,29,71,53,124,0.000333,0.200797,18,10843.01358,602.389643,602.389643,112.105716,1,0
0,0,15,15,12,17,29,74,55,129,0.000333,0.208893,18,11280.23187,626.679548,626.679548,112.506418,1,0
0,0,10,10,11,10,21,55,36,91,0.000333,0.133234,15,5995.513282,333.084071,399.700885,71.273029,1,0
0,0,15,15,13,17,30,86,64,150,0.000333,0.245345,18,13248.60461,736.033589,736.033589,117.592585,1,0
0,0,15,15,13,16,29,76,55,131,0.000333,0.212132,18,11455.11919,636.39551,636.39551,112.105716,1,0
0,0,15,15,12,17,29,79,57,136,0.000333,0.220228,18,11892.33748,660.685415,660.685415,112.506418,1,0
0,0,10,10,11,10,21,55,36,91,0.000333,0.133234,15,5995.513282,333.084071,399.700885,71.273029,1,0
0,0,15,15,13,17,30,86,64,150,0.000333,0.245345,18,13248.60461,736.033589,736.033589,117.592585,1,0
0,0,15,15,13,16,29,76,55,131,0.000333,0.212132,18,11455.11919,636.39551,636.39551,112.105716,1,0
0,0,15,15,12,17,29,79,57,136,0.000333,0.220228,18,11892.33748,660.685415,660.685415,112.506418,1,0
0,0,10,10,11,10,21,52,36,88,0.000333,0.128841,15,5797.858998,322.103278,386.523933,71.273029,1,0
0,0,15,15,13,17,30,83,64,147,0.000333,0.240438,18,12983.63252,721.312918,721.312918,117.592585,1,0
0,0,15,15,13,16,29,73,55,128,0.000333,0.207274,18,11192.78821,621.821567,621.821567,112.105716,1,0
0,0,15,15,12,17,29,76,57,133,0.000333,0.21537,18,11630.0065,646.111472,646.111472,112.506418,1,0
0,0,10,10,10,9,19,41,31,72,0.000333,0.10195,15,4587.761715,254.875651,305.850781,61.748606,1,0
0,0,15,15,12,16,28,72,59,131,0.000333,0.209921,18,11335.74291,629.763495,629.763495,107.01955,1,0
0,0,15,15,12,15,27,62,50,112,0.000333,0.177516,18,9585.853204,532.5474,532.5474,101.622909,1,0
0,0,15,15,11,16,27,65,52,117,0.000333,0.185441,15,8344.827566,463.601531,556.321838,102.053748,1,0
0,0,10,10,11,9,20,46,33,79,0.000333,0.113811,15,5121.484792,284.526933,341.432319,66.583073,1,0
0,0,15,15,13,16,29,77,61,138,0.000333,0.223467,18,12067.22479,670.401377,670.401377,112.105716,1,0
0,0,15,15,13,15,28,67,52,119,0.000333,0.190692,18,10297.35424,572.075236,572.075236,106.709075,1,0
0,0,15,15,12,16,28,70,54,124,0.000333,0.198704,18,10730.01619,596.11201,596.11201,107.01955,1,0
0,0,10,10,11,9,20,46,33,79,0.000333,0.113811,15,5121.484792,284.526933,341.432319,66.583073,1,0
0,0,15,15,13,16,29,77,61,138,0.000333,0.223467,18,12067.22479,670.401377,670.401377,112.105716,1,0
0,0,15,15,13,15,28,67,52,119,0.000333,0.190692,18,10297.35424,572.075236,572.075236,106.709075,1,0
0,0,15,15,12,16,28,70,54,124,0.000333,0.198704,18,10730.01619,596.11201,596.11201,107.01955,1,0
0,0,10,10,10,9,19,43,33,76,0.000333,0.107614,15,4842.637365,269.035409,322.842491,61.748606,1,0
0,0,15,15,12,16,28,74,61,135,0.000333,0.216331,18,11681.87246,648.992914,648.992914,107.01955,1,0
0,0,12,12,11,17,28,47,41,88,0.000333,0.141016,10,4230.472331,235.026241,423.047233,107.540616,1,0
0,0,2,2,7,5,12,9,7,16,0.000333,0.01912,3,172.0782,9.5599,57.3594,31.261125,1,0
0,0,11,11,14,18,32,41,37,78,0.000333,0.13,14,5460,303.333333,390,128.361619,1,0
0,0,2,2,7,5,12,9,7,16,0.000333,0.01912,3,172.0782,9.5599,57.3594,31.261125,1,0
0,0,15,15,13,18,31,72,58,130,0.000333,0.214682,18,11592.81937,644.04552,644.04552,123.164366,1,0
0,0,2,2,7,5,12,9,7,16,0.000333,0.01912,3,172.0782,9.5599,57.3594,31.261125,1,0
0,0,16,16,15,24,39,67,58,125,0.000333,0.220225,14,9249.453883,513.858549,660.675277,168.642459,1,0
0,0,2,2,7,5,12,9,7,16,0.000333,0.01912,3,172.0782,9.5599,57.3594,31.261125,1,0
0,0,14,14,15,24,39,60,53,113,0.000333,0.199083,14,8361.50631,464.528128,597.250451,168.642459,1,0
0,0,2,2,7,5,12,9,7,16,0.000333,0.01912,3,172.0782,9.5599,57.3594,31.261125,1,0
0,0,3,3,8,7,15,20,12,32,0.000333,0.041673,4,500.081996,27.782333,125.020499,43.651484,1,0
0,0,11,11,15,17,32,54,40,94,0.000333,0.156667,14,6580,365.555556,470,128.090227,2,0
0,0,11,11,14,17,31,53,40,93,0.000333,0.15358,14,6450.363596,358.353533,460.740257,122.789837,2,0
0,0,9,9,11,12,23,49,32,81,0.000333,0.122136,10,3664.085184,203.560288,366.408518,81.073298,1,0
0,0,6,6,10,11,21,29,20,49,0.000333,0.071741,5,1076.117769,59.78432,215.223554,71.273029,1,0
0,0,7,7,9,14,23,40,28,68,0.000333,0.102534,8,2460.817704,136.712095,307.602213,81.832294,1,0
0,0,13,13,13,18,31,75,54,129,0.000333,0.21303,18,11503.64383,639.091324,639.091324,123.164366,1,0
0,0,14,14,13,18,31,70,51,121,0.000333,0.199819,12,7193.493043,399.638502,599.457754,123.164366,1,0
0,0,14,14,12,19,31,73,53,126,0.000333,0.208076,12,7490.744821,416.15249,624.228735,123.730173,1,0
0,0,9,9,11,12,23,49,32,81,0.000333,0.122136,10,3664.085184,203.560288,366.408518,81.073298,1,0
0,0,7,7,10,13,23,40,26,66,0.000333,0.099518,10,2985.550891,165.863938,298.555089,81.324997,1,0
0,0,7,7,10,13,23,40,26,66,0.000333,0.099518,10,2985.550891,165.863938,298.555089,81.324997,1,0
0,0,14,14,13,19,32,80,60,140,0.000333,0.233333,18,12600,700,700,128.816339,1,0
0,0,14,14,13,18,31,70,51,121,0.000333,0.199819,12,7193.493043,399.638502,599.457754,123.164366,1,0
0,0,14,14,12,19,31,73,53,126,0.000333,0.208076,12,7490.744821,416.15249,624.228735,123.730173,1,0
0,0,8,8,11,12,23,40,28,68,0.000333,0.102534,10,3076.02213,170.890118,307.602213,81.073298,1,0
0,0,8,8,12,14,26,41,30,71,0.000333,0.111244,12,4004.77464,222.48748,333.73122,96.322519,1,0
0,0,8,8,11,14,25,40,30,70,0.000333,0.108357,10,3250.699333,180.594407,325.069933,91.356717,1,0
0,0,15,15,13,19,32,83,64,147,0.000333,0.245,18,13230,735,735,128.816339,1,0
0,0,15,15,13,18,31,73,55,128,0.000333,0.211379,18,11414.4683,634.137128,634.137128,123.164366,1,0
0,0,15,15,12,19,31,76,57,133,0.000333,0.219636,18,11860.34597,658.908109,658.908109,123.730173,1,0
0,0,9,9,11,12,23,45,31,76,0.000333,0.114597,10,3437.907087,190.994838,343.790709,81.073298,1,0
0,0,8,8,12,14,26,41,30,71,0.000333,0.111244,12,4004.77464,222.48748,333.73122,96.322519,1,0
0,0,8,8,11,14,25,40,30,70,0.000333,0.108357,10,3250.699333,180.594407,325.069933,91.356717,1,0
0,0,13,13,13,18,31,72,53,125,0.000333,0.206425,12,7431.294466,412.849693,619.274539,123.164366,1,0
0,0,15,15,13,18,31,73,55,128,0.000333,0.211379,18,11414.4683,634.137128,634.137128,123.164366,1,0
0,0,15,15,12,19,31,76,57,133,0.000333,0.219636,18,11860.34597,658.908109,658.908109,123.730173,1,0
0,0,8,8,12,12,24,42,28,70,0.000333,0.106982,12,3851.368501,213.964917,320.947375,86.0391,1,0
0,0,8,8,13,14,27,43,30,73,0.000333,0.115702,12,4165.281452,231.404525,347.106788,101.408685,1,0
0,0,8,8,12,14,26,42,30,72,0.000333,0.112811,12,4061.179916,225.621106,338.43166,96.322519,1,0
0,0,15,15,14,19,33,87,64,151,0.000333,0.253901,21,15995.77375,888.654097,761.703512,134.013592,1,0
0,0,15,15,14,18,32,77,55,132,0.000333,0.22,21,13860,770,660,128.361619,1,0
0,0,16,16,13,19,32,84,60,144,0.000333,0.24,18,12960,720,720,128.816339,1,0
0,0,9,9,14,14,28,39,31,70,0.000333,0.112172,14,4711.207824,261.733768,336.514845,106.605938,2,0
0,0,11,11,13,16,29,44,37,81,0.000333,0.131165,12,4721.957527,262.330974,393.496461,112.105716,2,0
0,0,16,16,14,20,34,75,62,137,0.000333,0.232327,21,14636.63059,813.146144,696.982409,139.741531,2,0
0,0,18,18,13,21,34,77,62,139,0.000333,0.235719,12,8485.888019,471.438223,707.157335,140.344382,2,0
0,0,8,8,11,11,22,35,26,61,0.000333,0.090675,10,2720.253287,151.125183,272.025329,76.107496,1,0
0,0,8,8,12,13,25,36,28,64,0.000333,0.099069,12,3566.481554,198.137864,297.206796,91.125266,1,0
0,0,8,8,11,13,24,35,28,63,0.000333,0.096284,10,2888.526375,160.473688,288.852638,86.159464,1,0
0,0,14,14,13,18,31,71,57,128,0.000333,0.211379,18,11414.4683,634.137128,634.137128,123.164366,1,0
0,0,14,14,13,17,30,61,48,109,0.000333,0.178284,12,6418.212899,356.567383,534.851075,117.592585,1,0
0,0,14,14,12,18,30,64,50,114,0.000333,0.186462,12,6712.626335,372.923685,559.385528,118.0782,1,0
0,0,9,9,11,11,22,40,29,69,0.000333,0.102567,10,3077.007817,170.944879,307.700782,76.107496,1,0
0,0,8,8,12,13,25,36,28,64,0.000333,0.099069,12,3566.481554,198.137864,297.206796,91.125266,1,0
0,0,8,8,11,13,24,35,28,63,0.000333,0.096284,10,2888.526375,160.473688,288.852638,86.159464,1,0
0,0,14,14,13,18,31,71,57,128,0.000333,0.211379,18,11414.4683,634.137128,634.137128,123.164366,1,0
0,0,14,14,13,17,30,61,48,109,0.000333,0.178284,12,6418.212899,356.567383,534.851075,117.592585,1,0
0,0,14,14,12,18,30,64,50,114,0.000333,0.186462,12,6712.626335,372.923685,559.385528,118.0782,1,0
0,0,9,9,10,11,21,36,28,64,0.000333,0.093703,10,2811.083151,156.171286,281.108315,71.273029,1,0
0,0,16,16,12,16,28,76,63,139,0.000333,0.222741,18,12028.00202,668.222334,668.222334,107.01955,1,0
0,0,16,16,12,15,27,66,54,120,0.000333,0.190196,18,10270.55701,570.5865,570.5865,101.622909,1,0
0,0,16,16,11,16,27,69,56,125,0.000333,0.19812,15,8915.414067,495.300781,594.360938,102.053748,1,0
0,0,12,12,11,11,22,54,38,92,0.000333,0.136756,15,6154.015634,341.889757,410.267709,76.107496,1,0
0,0,13,13,12,13,25,58,43,101,0.000333,0.156343,18,8442.530553,469.029475,469.029475,91.125266,1,0
0,0,13,13,11,14,25,59,45,104,0.000333,0.160987,15,7244.415656,402.467536,482.961044,91.356717,1,0
0,0,17,17,13,18,31,85,66,151,0.000333,0.249361,18,13465.50557,748.083643,748.083643,123.164366,1,0
0,0,17,17,13,17,30,75,57,132,0.000333,0.215903,18,11658.77206,647.709559,647.709559,117.592585,1,0
0,0,17,17,12,18,30,77,59,136,0.000333,0.222446,18,12012.06818,667.337121,667.337121,118.0782,1,0
0,0,14,14,14,13,27,65,46,111,0.000333,0.175931,21,11083.64277,615.757932,527.792513,101.408685,2,0
0,0,14,14,15,15,30,66,48,114,0.000333,0.186462,21,11747.09609,652.616449,559.385528,117.206718,2,0
0,0,15,15,14,15,29,68,51,119,0.000333,0.1927,21,12140.09451,674.449695,578.099738,111.906328,2,0
0,0,18,18,15,19,34,95,72,167,0.000333,0.283202,21,17841.73218,991.207344,849.606294,139.313982,2,0
0,0,18,18,15,18,33,85,63,148,0.000333,0.248857,21,15677.97692,870.998718,746.57033,133.662009,2,0
0,0,18,18,14,18,32,88,65,153,0.000333,0.255,21,16065,892.5,765,128.361619,2,0
0,0,12,12,11,11,22,59,40,99,0.000333,0.147161,15,6622.255954,367.903109,441.48373,76.107496,1,0
0,0,13,13,12,13,25,63,45,108,0.000333,0.167179,18,9027.656433,501.536468,501.536468,91.125266,1,0
0,0,13,13,11,13,24,62,45,107,0.000333,0.16353,15,7358.864814,408.825823,490.590988,86.159464,1,0
0,0,17,17,13,18,31,90,68,158,0.000333,0.260921,18,14089.73431,782.763017,782.763017,123.164366,1,0
0,0,17,17,13,17,30,80,59,139,0.000333,0.227353,18,12277.04027,682.057793,682.057793,117.592585,1,0
0,0,17,17,12,18,30,83,61,144,0.000333,0.235531,18,12718.66042,706.592246,706.592246,118.0782,1,0
0,0,12,12,11,11,22,59,40,99,0.000333,0.147161,15,6622.255954,367.903109,441.48373,76.107496,1,0
0,0,13,13,12,13,25,63,45,108,0.000333,0.167179,18,9027.656433,501.536468,501.536468,91.125266,1,0
0,0,13,13,11,13,24,62,45,107,0.000333,0.16353,15,7358.864814,408.825823,490.590988,86.159464,1,0
0,0,17,17,13,18,31,90,68,158,0.000333,0.260921,18,14089.73431,782.763017,782.763017,123.164366,1,0
0,0,17,17,13,17,30,80,59,139,0.000333,0.227353,18,12277.04027,682.057793,682.057793,117.592585,1,0
0,0,17,17,12,18,30,83,61,144,0.000333,0.235531,18,12718.66042,706.592246,706.592246,118.0782,1,0
0,0,11,11,11,11,22,54,38,92,0.000333,0.136756,15,6154.015634,341.889757,410.267709,76.107496,1,0
0,0,12,12,12,13,25,57,42,99,0.000333,0.153247,18,8275.35173,459.741763,459.741763,91.125266,1,0
0,0,13,13,11,13,24,59,45,104,0.000333,0.158945,15,7152.541501,397.363417,476.8361,86.159464,1,0
0,0,17,17,13,18,31,87,68,155,0.000333,0.255967,18,13822.20771,767.900428,767.900428,123.164366,1,0
0,0,17,17,13,17,30,77,59,136,0.000333,0.222446,18,12012.06818,667.337121,667.337121,117.592585,1,0
0,0,17,17,12,18,30,80,61,141,0.000333,0.230624,18,12453.68833,691.871574,691.871574,118.0782,1,0
0,0,12,12,11,11,22,54,38,92,0.000333,0.136756,15,6154.015634,341.889757,410.267709,76.107496,1,0
0,0,12,12,12,13,25,55,40,95,0.000333,0.147055,18,7940.994085,441.166338,441.166338,91.125266,1,0
0,0,13,13,11,13,24,57,43,100,0.000333,0.152832,15,6877.443751,382.080208,458.49625,86.159464,1,0
0,0,17,17,13,18,31,85,66,151,0.000333,0.249361,18,13465.50557,748.083643,748.083643,123.164366,1,0
0,0,14,14,13,17,30,61,47,108,0.000333,0.176648,12,6359.330212,353.296123,529.944184,117.592585,1,0
0,0,17,17,12,18,30,78,59,137,0.000333,0.224081,18,12100.39221,672.244012,672.244012,118.0782,1,0
0,0,14,14,14,13,27,65,46,111,0.000333,0.175931,21,11083.64277,615.757932,527.792513,101.408685,2,0
0,0,14,14,15,14,29,68,49,117,0.000333,0.189461,21,11936.05931,663.114406,568.383776,111.906328,2,0
0,0,14,14,14,14,28,67,49,116,0.000333,0.185884,21,11710.71659,650.595366,557.653171,106.605938,2,0
0,0,18,18,15,19,34,95,72,167,0.000333,0.283202,21,17841.73218,991.207344,849.606294,139.313982,2,0
0,0,18,18,15,18,33,85,63,148,0.000333,0.248857,21,15677.97692,870.998718,746.57033,133.662009,2,0
0,0,18,18,14,18,32,88,65,153,0.000333,0.255,21,16065,892.5,765,128.361619,2,0
0,0,12,12,11,11,22,59,40,99,0.000333,0.147161,15,6622.255954,367.903109,441.48373,76.107496,1,0
0,0,13,13,12,13,25,63,45,108,0.000333,0.167179,18,9027.656433,501.536468,501.536468,91.125266,1,0
0,0,12,12,11,13,24,59,42,101,0.000333,0.15436,15,6946.218189,385.90101,463.081213,86.159464,1,0
0,0,17,17,13,18,31,90,68,158,0.000333,0.260921,18,14089.73431,782.763017,782.763017,123.164366,1,0
0,0,17,17,13,17,30,80,59,139,0.000333,0.227353,18,12277.04027,682.057793,682.057793,117.592585,1,0
0,0,17,17,12,18,30,83,61,144,0.000333,0.235531,18,12718.66042,706.592246,706.592246,118.0782,1,0
0,0,12,12,11,11,22,59,40,99,0.000333,0.147161,15,6622.255954,367.903109,441.48373,76.107496,1,0
0,0,12,12,12,13,25,61,43,104,0.000333,0.160987,18,8693.298787,482.961044,482.961044,91.125266,1,0
0,0,13,13,11,13,24,62,45,107,0.000333,0.16353,15,7358.864814,408.825823,490.590988,86.159464,1,0
0,0,17,17,13,18,31,90,68,158,0.000333,0.260921,18,14089.73431,782.763017,782.763017,123.164366,1,0
0,0,17,17,13,17,30,80,59,139,0.000333,0.227353,18,12277.04027,682.057793,682.057793,117.592585,1,0
0,0,17,17,12,18,30,83,61,144,0.000333,0.235531,18,12718.66042,706.592246,706.592246,118.0782,1,0
0,0,12,12,11,11,22,56,40,96,0.000333,0.142702,15,6421.581531,356.754529,428.105435,76.107496,1,0
0,0,13,13,12,13,25,60,45,105,0.000333,0.162535,18,8776.888199,487.6049,487.6049,91.125266,1,0
0,0,13,13,11,13,24,59,45,104,0.000333,0.158945,15,7152.541501,397.363417,476.8361,86.159464,1,0
0,0,17,17,13,18,31,87,68,155,0.000333,0.255967,18,13822.20771,767.900428,767.900428,123.164366,1,0
0,0,17,17,13,17,30,77,59,136,0.000333,0.222446,18,12012.06818,667.337121,667.337121,117.592585,1,0
0,0,17,17,12,18,30,80,61,141,0.000333,0.230624,18,12453.68833,691.871574,691.871574,118.0782,1,0
0,0,10,10,10,9,19,41,30,71,0.000333,0.100534,15,4524.042802,251.335711,301.602853,61.748606,1,0
0,0,10,10,10,9,19,41,30,71,0.000333,0.100534,15,4524.042802,251.335711,301.602853,61.748606,1,0
0,0,10,10,10,9,19,41,30,71,0.000333,0.100534,15,4524.042802,251.335711,301.602853,61.748606,1,0
0,0,10,10,10,9,19,41,30,71,0.000333,0.100534,15,4524.042802,251.335711,301.602853,61.748606,1,0
0,0,10,10,10,9,19,41,30,71,0.000333,0.100534,15,4524.042802,251.335711,301.602853,61.748606,1,0
0,0,10,10,10,9,19,41,30,71,0.000333,0.100534,15,4524.042802,251.335711,301.602853,61.748606,1,0
0,0,10,10,10,9,19,41,30,71,0.000333,0.100534,15,4524.042802,251.335711,301.602853,61.748606,1,0
0,0,10,10,10,9,19,41,30,71,0.000333,0.100534,15,4524.042802,251.335711,301.602853,61.748606,1,0
0,0,10,10,10,9,19,41,30,71,0.000333,0.100534,15,4524.042802,251.335711,301.602853,61.748606,1,0
0,0,10,10,10,9,19,41,30,71,0.000333,0.100534,15,4524.042802,251.335711,301.602853,61.748606,1,0
0,0,10,10,10,9,19,41,30,71,0.000333,0.100534,15,4524.042802,251.335711,301.602853,61.748606,1,0
0,0,10,10,10,9,19,41,30,71,0.000333,0.100534,15,4524.042802,251.335711,301.602853,61.748606,1,0
0,0,10,10,10,9,19,41,30,71,0.000333,0.100534,15,4524.042802,251.335711,301.602853,61.748606,1,0
0,0,10,10,10,9,19,41,30,71,0.000333,0.100534,15,4524.042802,251.335711,301.602853,61.748606,1,0
0,0,10,10,10,9,19,41,30,71,0.000333,0.100534,15,4524.042802,251.335711,301.602853,61.748606,1,0
0,0,10,10,10,9,19,41,30,71,0.000333,0.100534,15,4524.042802,251.335711,301.602853,61.748606,1,0
0,0,10,10,10,9,19,41,30,71,0.000333,0.100534,15,4524.042802,251.335711,301.602853,61.748606,1,0
0,0,10,10,10,9,19,41,30,71,0.000333,0.100534,15,4524.042802,251.335711,301.602853,61.748606,1,0
0,0,15,15,12,14,26,58,51,109,0.000333,0.170783,18,9222.262727,512.347929,512.347929,96.322519,1,0
0,0,14,14,11,12,23,55,47,102,0.000333,0.153801,15,6921.049793,384.502766,461.40332,81.073298,1,0
0,0,12,12,10,10,20,47,36,83,0.000333,0.119573,15,5380.800478,298.93336,358.720032,66.438562,1,0
0,0,15,15,11,11,22,62,44,106,0.000333,0.157567,20,9453.995032,525.221946,472.699752,76.107496,1,0
0,0,12,12,11,10,21,48,36,84,0.000333,0.122985,15,5534.319953,307.46222,368.954664,71.273029,1,0
0,0,13,13,11,13,24,49,39,88,0.000333,0.134492,15,6052.150501,336.230583,403.4767,86.159464,1,0
0,0,12,12,10,12,22,47,38,85,0.000333,0.126351,15,5685.775314,315.876406,379.051688,76.238831,1,0
0,0,14,14,12,11,23,56,44,100,0.000333,0.150785,24,10856.5487,603.141594,452.356196,81.073298,1,0
0,0,13,13,12,12,24,52,41,93,0.000333,0.142134,18,7675.227226,426.401513,426.401513,86.0391,1,0
0,0,13,13,11,13,24,56,42,98,0.000333,0.149775,15,6739.894876,374.438604,449.326325,86.159464,1,0
0,0,15,15,11,14,25,49,45,94,0.000333,0.145507,15,6547.837228,363.768735,436.522482,91.356717,1,0
0,0,12,12,10,12,22,47,38,85,0.000333,0.126351,15,5685.775314,315.876406,379.051688,76.238831,1,0
0,0,12,12,10,13,23,47,38,85,0.000333,0.128168,10,3845.027663,213.612648,384.502766,81.324997,1,0
0,0,12,12,10,13,23,47,38,85,0.000333,0.128168,10,3845.027663,213.612648,384.502766,81.324997,1,0
0,0,12,12,10,13,23,47,38,85,0.000333,0.128168,10,3845.027663,213.612648,384.502766,81.324997,1,0
0,0,14,14,11,11,22,55,44,99,0.000333,0.147161,20,8829.674605,490.537478,441.48373,76.107496,1,0
0,0,13,13,11,12,23,51,41,92,0.000333,0.138723,15,6242.515499,346.806417,416.1677,81.073298,1,0
0,0,13,13,11,13,24,53,41,94,0.000333,0.143662,15,6464.797126,359.155396,430.986475,86.159464,1,0
0,0,14,14,11,14,25,62,45,107,0.000333,0.165631,15,7453.389185,414.077177,496.892612,91.356717,1,0
0,0,13,13,10,13,23,55,42,97,0.000333,0.146262,15,6581.782646,365.654591,438.78551,81.324997,1,0
0,0,15,15,10,15,25,62,48,110,0.000333,0.170275,15,7662.362713,425.686817,510.824181,91.82264,1,0
0,0,15,15,11,15,26,54,47,101,0.000333,0.158248,15,7121.166173,395.620343,474.744412,96.657107,1,0
0,0,14,14,10,16,26,47,46,93,0.000333,0.145714,10,4371.408938,242.856052,437.140894,97.219281,1,0
0,0,17,17,13,17,30,79,64,143,0.000333,0.233895,18,12630.33639,701.685355,701.685355,117.592585,1,0
0,0,17,17,13,16,29,69,55,124,0.000333,0.200797,18,10843.01358,602.389643,602.389643,112.105716,1,0
0,0,17,17,12,17,29,72,57,129,0.000333,0.208893,18,11280.23187,626.679548,626.679548,112.506418,1,0
0,0,12,12,13,11,24,52,38,90,0.000333,0.137549,18,7427.639251,412.646625,412.646625,86.159464,2,0
0,0,12,12,13,11,24,52,38,90,0.000333,0.137549,18,7427.639251,412.646625,412.646625,86.159464,2,0
0,0,12,12,13,11,24,52,38,90,0.000333,0.137549,18,7427.639251,412.646625,412.646625,86.159464,2,0
0,0,13,13,14,14,28,53,41,94,0.000333,0.15063,14,6326.479077,351.47106,451.891363,106.605938,2,0
0,0,12,12,13,11,24,52,38,90,0.000333,0.137549,18,7427.639251,412.646625,412.646625,86.159464,2,0
0,0,12,12,13,11,24,52,38,90,0.000333,0.137549,18,7427.639251,412.646625,412.646625,86.159464,2,0
0,0,12,12,13,11,24,52,38,90,0.000333,0.137549,18,7427.639251,412.646625,412.646625,86.159464,2,0
0,0,12,12,13,11,24,52,38,90,0.000333,0.137549,18,7427.639251,412.646625,412.646625,86.159464,2,0
0,0,12,12,13,11,24,52,38,90,0.000333,0.137549,18,7427.639251,412.646625,412.646625,86.159464,2,0
0,0,12,12,13,11,24,52,38,90,0.000333,0.137549,18,7427.639251,412.646625,412.646625,86.159464,2,0
0,0,12,12,13,11,24,52,38,90,0.000333,0.137549,18,7427.639251,412.646625,412.646625,86.159464,2,0
0,0,12,12,13,11,24,52,38,90,0.000333,0.137549,18,7427.639251,412.646625,412.646625,86.159464,2,0
0,0,12,12,13,11,24,52,38,90,0.000333,0.137549,18,7427.639251,412.646625,412.646625,86.159464,2,0
0,0,12,12,13,11,24,52,38,90,0.000333,0.137549,18,7427.639251,412.646625,412.646625,86.159464,2,0
0,0,12,12,13,11,24,52,38,90,0.000333,0.137549,18,7427.639251,412.646625,412.646625,86.159464,2,0
0,0,12,12,13,11,24,52,38,90,0.000333,0.137549,18,7427.639251,412.646625,412.646625,86.159464,2,0
0,0,12,12,13,11,24,52,38,90,0.000333,0.137549,18,7427.639251,412.646625,412.646625,86.159464,2,0
0,0,12,12,13,11,24,52,38,90,0.000333,0.137549,18,7427.639251,412.646625,412.646625,86.159464,2,0
0,0,16,16,15,14,29,67,55,122,0.000333,0.197558,21,12446.14731,691.452628,592.673681,111.906328,2,0
0,0,16,16,14,14,28,66,55,121,0.000333,0.193897,21,12215.48886,678.63827,581.689946,106.605938,2,0
0,0,14,14,13,12,25,58,44,102,0.000333,0.157891,18,8526.119964,473.673331,473.673331,91.125266,2,0
0,0,17,17,14,13,27,73,52,125,0.000333,0.19812,28,16642.10626,924.561459,594.360938,101.408685,2,0
0,0,14,14,14,12,26,59,44,103,0.000333,0.161382,21,10167.05111,564.836173,484.145291,96.322519,2,0
0,0,15,15,14,15,29,60,47,107,0.000333,0.173268,21,10915.8833,606.437961,519.803966,111.906328,2,0
0,0,14,14,13,14,27,58,46,104,0.000333,0.164836,18,8901.149404,494.5083,494.5083,101.408685,2,0
0,0,16,16,15,13,28,67,52,119,0.000333,0.190692,28,16018.1066,889.894811,572.075236,106.709075,2,0
0,0,15,15,15,14,29,63,49,112,0.000333,0.181365,21,11425.9713,634.776183,544.093871,111.906328,2,0
0,0,15,15,14,15,29,67,50,117,0.000333,0.189461,21,11936.05931,663.114406,568.383776,111.906328,2,0
0,0,14,14,13,14,27,58,46,104,0.000333,0.164836,18,8901.149404,494.5083,494.5083,101.408685,2,0
0,0,14,14,13,15,28,58,46,104,0.000333,0.166655,18,8999.368414,499.964912,499.964912,106.709075,2,0
0,0,14,14,13,12,25,58,44,102,0.000333,0.157891,18,8526.119964,473.673331,473.673331,91.125266,2,0
0,0,14,14,13,15,28,58,46,104,0.000333,0.166655,18,8999.368414,499.964912,499.964912,106.709075,2,0
0,0,14,14,13,15,28,58,46,104,0.000333,0.166655,18,8999.368414,499.964912,499.964912,106.709075,2,0
0,0,16,16,14,13,27,66,52,118,0.000333,0.187026,28,15710.14831,872.786017,561.076725,101.408685,2,0
0,0,15,15,14,14,28,62,49,111,0.000333,0.177872,21,11205.94432,622.552462,533.616396,106.605938,2,0
0,0,15,15,14,15,29,64,49,113,0.000333,0.182984,21,11527.9889,640.443828,548.951852,111.906328,2,0
0,0,16,16,14,16,30,73,53,126,0.000333,0.206089,21,12983.63252,721.312918,618.268215,117.302969,2,0
0,0,15,15,13,15,28,66,50,116,0.000333,0.185884,18,10037.75708,557.653171,557.653171,106.709075,2,0
0,0,17,17,13,17,30,73,56,129,0.000333,0.210996,18,11393.79996,632.988887,632.988887,117.592585,2,0
0,0,17,17,14,17,31,65,55,120,0.000333,0.198168,21,12484.5747,693.587483,594.503557,122.789837,2,0
0,0,16,16,13,18,31,58,54,112,0.000333,0.184957,18,9987.659762,554.869987,554.869987,123.164366,2,0
0,0,19,19,15,19,34,90,72,162,0.000333,0.274723,21,17307.54859,961.530477,824.16898,139.313982,2,0
0,0,19,19,15,18,33,80,63,143,0.000333,0.240449,21,15148.31554,841.573086,721.348359,133.662009,2,0
0,0,19,19,14,18,32,83,65,148,0.000333,0.246667,21,15540,863.333333,740,128.361619,2,0
0,0,10,10,11,9,20,46,32,78,0.000333,0.11237,15,5056.655871,280.925326,337.110391,66.583073,1,0
0,0,10,10,11,9,20,46,32,78,0.000333,0.11237,15,5056.655871,280.925326,337.110391,66.583073,1,0
0,0,10,10,11,9,20,46,32,78,0.000333,0.11237,15,5056.655871,280.925326,337.110391,66.583073,1,0
0,0,10,10,11,9,20,46,32,78,0.000333,0.11237,15,5056.655871,280.925326,337.110391,66.583073,1,0
0,0,10,10,11,9,20,46,32,78,0.000333,0.11237,15,5056.655871,280.925326,337.110391,66.583073,1,0
0,0,10,10,11,9,20,46,32,78,0.000333,0.11237,15,5056.655871,280.925326,337.110391,66.583073,1,0
0,0,10,10,11,9,20,46,32,78,0.000333,0.11237,15,5056.655871,280.925326,337.110391,66.583073,1,0
0,0,10,10,11,9,20,46,32,78,0.000333,0.11237,15,5056.655871,280.925326,337.110391,66.583073,1,0
0,0,10,10,11,9,20,46,32,78,0.000333,0.11237,15,5056.655871,280.925326,337.110391,66.583073,1,0
0,0,10,10,12,10,22,47,31,78,0.000333,0.115945,18,6261.041993,347.835666,347.835666,76.238831,2,0
0,0,11,11,13,10,23,48,31,79,0.000333,0.11912,18,6432.505102,357.361395,357.361395,81.324997,2,0
0,0,10,10,12,10,22,47,31,78,0.000333,0.115945,18,6261.041993,347.835666,347.835666,76.238831,2,0
0,0,11,11,13,10,23,48,31,79,0.000333,0.11912,18,6432.505102,357.361395,357.361395,81.324997,2,0
0,0,10,10,12,10,22,47,31,78,0.000333,0.115945,18,6261.041993,347.835666,347.835666,76.238831,2,0
0,0,15,15,13,10,23,67,44,111,0.000333,0.167372,24,12050.76905,669.487169,502.115377,81.324997,2,0
0,0,11,11,14,11,25,49,32,81,0.000333,0.125384,14,5266.132919,292.56294,376.152351,91.356717,2,0
0,0,10,10,12,11,23,47,32,79,0.000333,0.11912,12,4288.336734,238.24093,357.361395,81.073298,2,0
0,0,11,11,14,11,25,49,32,81,0.000333,0.125384,14,5266.132919,292.56294,376.152351,91.356717,2,0
0,0,10,10,12,11,23,47,32,79,0.000333,0.11912,12,4288.336734,238.24093,357.361395,81.073298,2,0
0,0,11,11,14,10,24,49,32,81,0.000333,0.123794,21,7799.021214,433.278956,371.381963,86.52225,2,0
0,0,11,11,14,10,24,49,31,80,0.000333,0.122266,21,7702.737001,427.929833,366.797,86.52225,2,0
0,0,10,10,12,9,21,47,31,78,0.000333,0.1142,18,6166.813662,342.600759,342.600759,71.548875,2,0
0,0,10,10,14,11,25,52,35,87,0.000333,0.134672,21,8484.325259,471.351403,404.015489,91.356717,2,0
0,0,11,11,13,9,22,47,32,79,0.000333,0.117432,18,6341.311762,352.295098,352.295098,76.635041,1,0
0,0,15,15,15,14,29,61,49,110,0.000333,0.178126,21,11221.9361,623.440894,534.377909,111.906328,2,0
0,0,14,14,14,13,27,60,49,109,0.000333,0.172761,21,10883.93749,604.663194,518.282738,101.408685,2,0
0,0,15,15,14,14,28,60,49,109,0.000333,0.174667,21,11004.03542,611.335301,524.001687,106.605938,2,0
0,0,14,14,13,13,26,59,49,108,0.000333,0.169216,18,9137.654812,507.64749,507.64749,96.211433,2,0
0,0,10,10,11,9,20,48,34,82,0.000333,0.118133,15,5315.971557,295.331753,354.398104,66.583073,1,0
0,0,14,14,12,11,23,65,44,109,0.000333,0.164356,24,11833.63808,657.424338,493.068253,81.073298,1,0
0,0,11,11,12,10,22,51,36,87,0.000333,0.129324,18,6983.469915,387.970551,387.970551,76.238831,1,0
0,0,11,11,12,12,24,50,37,87,0.000333,0.132964,18,7180.051276,398.891738,398.891738,86.0391,1,0
0,0,10,10,11,11,22,48,36,84,0.000333,0.124864,15,5618.883839,312.160213,374.592256,76.107496,1,0
0,0,12,12,13,11,24,55,40,95,0.000333,0.14519,18,7840.285876,435.571438,435.571438,86.159464,1,0
0,0,11,11,13,12,25,52,38,90,0.000333,0.139316,18,7523.047027,417.947057,417.947057,91.125266,1,0
0,0,12,12,12,13,25,59,42,101,0.000333,0.156343,18,8442.530553,469.029475,469.029475,91.125266,1,0
0,0,12,12,12,12,24,49,40,89,0.000333,0.136021,18,7345.109926,408.061663,408.061663,86.0391,1,0
0,0,10,10,11,11,22,48,36,84,0.000333,0.124864,15,5618.883839,312.160213,374.592256,76.107496,1,0
0,0,12,12,11,12,23,54,44,98,0.000333,0.14777,15,6649.636075,369.424226,443.309072,81.073298,1,0
0,0,14,14,11,13,24,60,52,112,0.000333,0.171172,20,10270.316,570.573111,513.5158,86.159464,1,0
0,0,16,16,11,14,25,66,60,126,0.000333,0.195042,20,11702.5176,650.139867,585.12588,91.356717,1,0
0,0,11,11,12,10,22,52,38,90,0.000333,0.133783,18,7224.279222,401.348846,401.348846,76.238831,1,0
0,0,11,11,12,12,24,51,38,89,0.000333,0.136021,18,7345.109926,408.061663,408.061663,86.0391,1,0
0,0,11,11,12,12,24,54,39,93,0.000333,0.142134,18,7675.227226,426.401513,426.401513,86.0391,1,0
0,0,12,12,12,13,25,63,43,106,0.000333,0.164083,18,8860.47761,492.248756,492.248756,91.125266,1,0
0,0,12,12,11,13,24,58,42,100,0.000333,0.152832,15,6877.443751,382.080208,458.49625,86.159464,1,0
0,0,13,13,11,14,25,63,46,109,0.000333,0.168727,15,7592.70487,421.816937,506.180325,91.356717,1,0
0,0,13,13,12,14,26,55,45,100,0.000333,0.156681,18,8460.791493,470.043972,470.043972,96.322519,1,0
0,0,12,12,11,15,26,48,44,92,0.000333,0.144147,10,4324.404541,240.244697,432.440454,96.657107,1,0
0,0,15,15,14,16,30,80,62,142,0.000333,0.232259,21,14632.34776,812.908209,696.778465,117.302969,1,0
0,0,15,15,14,15,29,70,53,123,0.000333,0.199177,21,12548.16491,697.120273,597.531662,111.906328,1,0
0,0,15,15,13,16,29,73,55,128,0.000333,0.207274,18,11192.78821,621.821567,621.821567,112.105716,1,0
0,0,8,8,11,8,19,42,28,70,0.000333,0.099118,15,4460.323889,247.795772,297.354926,62.053748,1,0
0,0,11,11,13,10,23,48,31,79,0.000333,0.11912,18,6432.505102,357.361395,357.361395,81.324997,2,0
0,0,10,10,12,9,21,47,31,78,0.000333,0.1142,18,6166.813662,342.600759,342.600759,71.548875,2,0
0,0,11,11,14,10,24,49,32,81,0.000333,0.123794,21,7799.021214,433.278956,371.381963,86.52225,2,0
0,0,10,10,12,10,22,47,32,79,0.000333,0.117432,18,6341.311762,352.295098,352.295098,76.238831,2,0
0,0,10,10,12,10,22,47,31,78,0.000333,0.115945,18,6261.041993,347.835666,347.835666,76.238831,2,0
0,0,11,11,13,10,23,48,31,79,0.000333,0.11912,18,6432.505102,357.361395,357.361395,81.324997,2,0
0,0,10,10,12,10,22,47,31,78,0.000333,0.115945,18,6261.041993,347.835666,347.835666,76.238831,2,0
0,0,11,11,13,10,23,48,31,79,0.000333,0.11912,18,6432.505102,357.361395,357.361395,81.324997,2,0
0,0,10,10,12,11,23,47,32,79,0.000333,0.11912,12,4288.336734,238.24093,357.361395,81.073298,2,0
0,0,11,11,14,11,25,49,32,81,0.000333,0.125384,14,5266.132919,292.56294,376.152351,91.356717,2,0
0,0,10,10,12,11,23,47,32,79,0.000333,0.11912,12,4288.336734,238.24093,357.361395,81.073298,2,0
0,0,11,11,14,11,25,49,32,81,0.000333,0.125384,14,5266.132919,292.56294,376.152351,91.356717,2,0
0,0,10,10,12,10,22,47,31,78,0.000333,0.115945,18,6261.041993,347.835666,347.835666,76.238831,2,0
0,0,11,11,13,10,23,48,31,79,0.000333,0.11912,18,6432.505102,357.361395,357.361395,81.324997,2,0
0,0,11,11,13,10,23,49,31,80,0.000333,0.120628,18,6513.929217,361.884956,361.884956,81.324997,2,0
0,0,10,10,12,10,22,48,31,79,0.000333,0.117432,18,6341.311762,352.295098,352.295098,76.238831,2,0
0,0,11,11,13,10,23,49,31,80,0.000333,0.120628,18,6513.929217,361.884956,361.884956,81.324997,2,0
0,0,10,10,12,10,22,48,31,79,0.000333,0.117432,18,6341.311762,352.295098,352.295098,76.238831,2,0
0,0,11,11,13,10,23,48,31,79,0.000333,0.11912,18,6432.505102,357.361395,357.361395,81.324997,2,0
0,0,10,10,12,10,22,47,31,78,0.000333,0.115945,18,6261.041993,347.835666,347.835666,76.238831,2,0
0,0,15,15,13,10,23,67,44,111,0.000333,0.167372,24,12050.76905,669.487169,502.115377,81.324997,2,0
0,0,11,11,14,11,25,49,32,81,0.000333,0.125384,14,5266.132919,292.56294,376.152351,91.356717,2,0
0,0,10,10,12,11,23,47,32,79,0.000333,0.11912,12,4288.336734,238.24093,357.361395,81.073298,2,0
0,0,11,11,14,11,25,49,32,81,0.000333,0.125384,14,5266.132919,292.56294,376.152351,91.356717,2,0
0,0,10,10,12,11,23,47,32,79,0.000333,0.11912,12,4288.336734,238.24093,357.361395,81.073298,2,0
0,0,11,11,14,10,24,49,32,81,0.000333,0.123794,21,7799.021214,433.278956,371.381963,86.52225,2,0
0,0,11,11,14,10,24,49,31,80,0.000333,0.122266,21,7702.737001,427.929833,366.797,86.52225,2,0
0,0,10,10,12,9,21,47,31,78,0.000333,0.1142,18,6166.813662,342.600759,342.600759,71.548875,2,0
0,0,10,10,14,11,25,52,35,87,0.000333,0.134672,21,8484.325259,471.351403,404.015489,91.356717,2,0
0,0,11,11,13,9,22,47,32,79,0.000333,0.117432,18,6341.311762,352.295098,352.295098,76.635041,1,0
0,0,14,14,14,13,27,60,49,109,0.000333,0.172761,21,10883.93749,604.663194,518.282738,101.408685,2,0
0,0,15,15,15,14,29,61,49,110,0.000333,0.178126,21,11221.9361,623.440894,534.377909,111.906328,2,0
0,0,14,14,13,13,26,59,49,108,0.000333,0.169216,18,9137.654812,507.64749,507.64749,96.211433,2,0
0,0,15,15,14,14,28,60,49,109,0.000333,0.174667,21,11004.03542,611.335301,524.001687,106.605938,2,0
0,0,11,11,11,10,21,50,36,86,0.000333,0.125913,15,5666.089475,314.782749,377.739298,71.273029,1,0
0,0,12,12,11,11,22,55,38,93,0.000333,0.138242,15,6220.907108,345.60595,414.727141,76.107496,1,0
0,0,10,10,11,10,21,47,33,80,0.000333,0.117128,15,5270.780907,292.821162,351.385394,71.273029,1,0
0,0,12,12,12,13,25,52,39,91,0.000333,0.140864,18,7606.636439,422.590913,422.590913,91.125266,1,0
0,0,11,11,11,12,23,50,38,88,0.000333,0.132691,15,5971.101782,331.727877,398.073452,81.073298,1,0
0,0,12,12,13,11,24,55,40,95,0.000333,0.14519,18,7840.285876,435.571438,435.571438,86.159464,1,0
0,0,11,11,12,12,24,51,39,90,0.000333,0.137549,18,7427.639251,412.646625,412.646625,86.0391,1,0
0,0,12,12,12,13,25,59,42,101,0.000333,0.156343,18,8442.530553,469.029475,469.029475,91.125266,1,0
0,0,13,13,12,13,25,51,42,93,0.000333,0.14396,18,7773.815262,431.878626,431.878626,91.125266,1,0
0,0,11,11,11,12,23,50,38,88,0.000333,0.132691,15,5971.101782,331.727877,398.073452,81.073298,1,0
0,0,13,13,11,13,24,56,46,102,0.000333,0.155889,15,7014.992626,389.721813,467.666175,86.159464,1,0
0,0,15,15,11,14,25,62,54,116,0.000333,0.179562,15,8080.30977,448.906098,538.687318,91.356717,1,0
0,0,17,17,11,15,26,68,62,130,0.000333,0.203686,20,12221.14327,678.952404,611.057163,96.657107,1,0
0,0,12,12,12,11,23,54,40,94,0.000333,0.141738,18,7653.86683,425.214824,425.214824,81.073298,1,0
0,0,11,11,12,12,24,51,38,89,0.000333,0.136021,18,7345.109926,408.061663,408.061663,86.0391,1,0
0,0,12,12,12,13,25,56,41,97,0.000333,0.150151,18,8108.172907,450.45405,450.45405,91.125266,1,0
0,0,13,13,12,14,26,65,45,110,0.000333,0.172349,18,9306.870642,517.048369,517.048369,96.322519,1,0
0,0,12,12,11,13,24,58,42,100,0.000333,0.152832,15,6877.443751,382.080208,458.49625,86.159464,1,0
0,0,13,13,11,14,25,61,45,106,0.000333,0.164083,15,7383.731342,410.207297,492.248756,91.356717,1,0
0,0,14,14,12,15,27,57,47,104,0.000333,0.164836,18,8901.149404,494.5083,494.5083,101.622909,1,0
0,0,12,12,11,16,27,48,41,89,0.000333,0.141062,10,4231.849877,235.102771,423.184988,102.053748,1,0
0,0,16,16,14,17,31,82,64,146,0.000333,0.241104,21,15189.56589,843.864772,723.312661,122.789837,1,0
0,0,16,16,14,16,30,72,55,127,0.000333,0.207725,21,13086.67722,727.037623,623.175106,117.302969,1,0
0,0,16,16,13,17,30,75,57,132,0.000333,0.215903,18,11658.77206,647.709559,647.709559,117.592585,1,0
0,0,9,9,10,9,19,41,30,71,0.000333,0.100534,15,4524.042802,251.335711,301.602853,61.748606,1,0
0,0,10,10,11,9,20,44,31,75,0.000333,0.108048,15,4862.169107,270.120506,324.144607,66.583073,2,0
0,0,11,11,12,10,22,45,31,76,0.000333,0.112972,18,6100.502454,338.916803,338.916803,76.238831,2,0
0,0,10,10,11,10,21,44,32,76,0.000333,0.111272,15,5007.241862,278.180103,333.816124,71.273029,2,0
0,0,11,11,13,10,23,46,32,78,0.000333,0.117613,18,6351.080986,352.837833,352.837833,81.324997,2,0
0,0,10,10,11,10,21,44,31,75,0.000333,0.109808,15,4941.357101,274.519839,329.423807,71.273029,2,0
0,0,11,11,12,10,22,45,31,76,0.000333,0.112972,18,6100.502454,338.916803,338.916803,76.238831,2,0
0,0,10,10,11,10,21,44,31,75,0.000333,0.109808,15,4941.357101,274.519839,329.423807,71.273029,2,0
0,0,11,11,12,10,22,45,31,76,0.000333,0.112972,18,6100.502454,338.916803,338.916803,76.238831,2,0
0,0,10,10,11,11,22,44,32,76,0.000333,0.112972,10,3389.16803,188.287113,338.916803,76.107496,2,0
0,0,11,11,13,11,24,46,32,78,0.000333,0.119209,12,4291.524901,238.41805,357.627075,86.159464,2,0
0,0,10,10,11,11,22,44,32,76,0.000333,0.112972,10,3389.16803,188.287113,338.916803,76.107496,2,0
0,0,11,11,13,11,24,46,32,78,0.000333,0.119209,12,4291.524901,238.41805,357.627075,86.159464,2,0
0,0,10,10,11,10,21,44,31,75,0.000333,0.109808,15,4941.357101,274.519839,329.423807,71.273029,2,0
0,0,11,11,12,10,22,45,31,76,0.000333,0.112972,18,6100.502454,338.916803,338.916803,76.238831,2,0
0,0,10,10,11,10,21,44,31,75,0.000333,0.109808,15,4941.357101,274.519839,329.423807,71.273029,2,0
0,0,11,11,12,10,22,45,31,76,0.000333,0.112972,18,6100.502454,338.916803,338.916803,76.238831,2,0
0,0,10,10,11,10,21,44,31,75,0.000333,0.109808,15,4941.357101,274.519839,329.423807,71.273029,2,0
0,0,11,11,12,10,22,45,31,76,0.000333,0.112972,18,6100.502454,338.916803,338.916803,76.238831,2,0
0,0,10,10,11,10,21,44,31,75,0.000333,0.109808,15,4941.357101,274.519839,329.423807,71.273029,2,0
0,0,11,11,12,10,22,45,31,76,0.000333,0.112972,18,6100.502454,338.916803,338.916803,76.238831,2,0
0,0,15,15,12,10,22,64,44,108,0.000333,0.16054,24,11558.84676,642.158153,481.618615,76.238831,2,0
0,0,10,10,11,11,22,44,32,76,0.000333,0.112972,10,3389.16803,188.287113,338.916803,76.107496,2,0
0,0,11,11,13,11,24,46,32,78,0.000333,0.119209,12,4291.524901,238.41805,357.627075,86.159464,2,0
0,0,10,10,11,11,22,44,32,76,0.000333,0.112972,10,3389.16803,188.287113,338.916803,76.107496,2,0
0,0,11,11,13,11,24,46,32,78,0.000333,0.119209,12,4291.524901,238.41805,357.627075,86.159464,2,0
0,0,11,11,13,10,23,46,32,78,0.000333,0.117613,18,6351.080986,352.837833,352.837833,81.324997,2,0
0,0,11,11,13,10,23,46,31,77,0.000333,0.116105,18,6269.656871,348.314271,348.314271,81.324997,2,0
0,0,10,10,11,9,20,44,31,75,0.000333,0.108048,15,4862.169107,270.120506,324.144607,66.583073,2,0
0,0,10,10,13,11,24,49,35,84,0.000333,0.128379,18,6932.463301,385.13685,385.13685,86.159464,2,0
0,0,11,11,12,9,21,44,32,76,0.000333,0.111272,18,6008.690234,333.816124,333.816124,71.548875,1,0
0,0,15,15,14,14,28,58,49,107,0.000333,0.171462,21,10802.12651,600.118139,514.386977,106.605938,2,0
0,0,14,14,13,13,26,57,49,106,0.000333,0.166082,18,8968.438982,498.24661,498.24661,96.211433,2,0
0,0,15,15,13,14,27,57,49,106,0.000333,0.168006,18,9072.325354,504.018075,504.018075,101.408685,2,0
0,0,14,14,12,13,25,56,49,105,0.000333,0.162535,18,8776.888199,487.6049,487.6049,91.125266,2,0
0,0,11,11,10,10,20,47,36,83,0.000333,0.119573,15,5380.800478,298.93336,358.720032,66.438562,1,0
0,0,12,12,10,11,21,52,38,90,0.000333,0.13177,15,5929.628521,329.423807,395.308568,71.273029,1,0
0,0,10,10,10,10,20,44,33,77,0.000333,0.110929,15,4991.82695,277.323719,332.788463,66.438562,1,0
0,0,12,12,11,13,24,49,39,88,0.000333,0.134492,15,6052.150501,336.230583,403.4767,86.159464,1,0
0,0,11,11,10,12,22,47,38,85,0.000333,0.126351,15,5685.775314,315.876406,379.051688,76.238831,1,0
0,0,12,12,12,11,23,52,40,92,0.000333,0.138723,18,7491.018599,416.1677,416.1677,81.073298,1,0
0,0,11,11,12,12,24,49,38,87,0.000333,0.132964,18,7180.051276,398.891738,398.891738,86.0391,1,0
0,0,12,12,11,13,24,56,42,98,0.000333,0.149775,15,6739.894876,374.438604,449.326325,86.159464,1,0
0,0,13,13,11,13,24,48,42,90,0.000333,0.137549,15,6189.699376,343.872188,412.646625,86.159464,1,0
0,0,11,11,10,12,22,47,38,85,0.000333,0.126351,15,5685.775314,315.876406,379.051688,76.238831,1,0
0,0,13,13,10,13,23,53,46,99,0.000333,0.149278,15,6717.489505,373.193861,447.832634,81.324997,1,0
0,0,15,15,10,14,24,59,54,113,0.000333,0.1727,15,7771.511439,431.750635,518.100763,86.52225,1,0
0,0,17,17,10,15,25,65,62,127,0.000333,0.19659,20,11795.39472,655.299707,589.769736,91.82264,1,0
0,0,12,12,11,11,22,51,40,91,0.000333,0.135269,15,6087.124159,338.173564,405.808277,76.107496,1,0
0,0,11,11,11,12,23,48,38,86,0.000333,0.129675,15,5835.394923,324.188607,389.026328,81.073298,1,0
0,0,12,12,11,13,24,53,41,94,0.000333,0.143662,15,6464.797126,359.155396,430.986475,86.159464,1,0
0,0,13,13,11,14,25,62,45,107,0.000333,0.165631,15,7453.389185,414.077177,496.892612,91.356717,1,0
0,0,3,3,8,6,14,11,9,20,0.000333,0.025382,4,304.588394,16.921577,76.147098,39.509775,1,0
0,0,3,3,8,7,15,16,11,27,0.000333,0.035162,4,421.944184,23.441344,105.486046,43.651484,1,0
0,0,3,3,8,7,15,16,11,27,0.000333,0.035162,4,421.944184,23.441344,105.486046,43.651484,1,0
0,0,5,5,11,10,21,19,17,36,0.000333,0.052708,5,790.617136,43.923174,158.123427,71.273029,1,0
0,0,5,5,11,8,19,19,15,34,0.000333,0.048143,5,722.147677,40.119315,144.429535,62.053748,1,0
0,0,3,3,8,7,15,16,11,27,0.000333,0.035162,4,421.944184,23.441344,105.486046,43.651484,1,0
0,0,5,5,10,10,20,18,17,35,0.000333,0.050422,5,756.337417,42.018745,151.267483,66.438562,1,0
0,0,2,2,7,7,14,10,8,18,0.000333,0.022844,3,205.597166,11.422065,68.532389,39.302969,1,0
0,0,11,11,12,15,27,61,50,111,0.000333,0.175931,18,9500.265229,527.792513,527.792513,101.622909,1,0
0,0,3,3,8,6,14,11,9,20,0.000333,0.025382,4,304.588394,16.921577,76.147098,39.509775,1,0
0,0,3,3,8,7,15,11,9,20,0.000333,0.026046,4,312.551248,17.363958,78.137812,43.651484,1,0
0,0,11,11,12,14,26,51,41,92,0.000333,0.144147,12,5189.285449,288.293636,432.440454,96.322519,1,0
0,0,3,3,8,6,14,11,9,20,0.000333,0.025382,4,304.588394,16.921577,76.147098,39.509775,1,0
0,0,3,3,8,7,15,11,9,20,0.000333,0.026046,4,312.551248,17.363958,78.137812,43.651484,1,0
2,0,24,26,14,29,43,119,90,209,0.000333,0.37803,21,23815.87601,1323.104223,1134.089334,194.184418,1,0
0,0,3,3,8,6,14,11,9,20,0.000333,0.025382,4,304.588394,16.921577,76.147098,39.509775,1,0
0,0,3,3,8,7,15,11,9,20,0.000333,0.026046,4,312.551248,17.363958,78.137812,43.651484,1,0
0,0,5,5,10,8,18,23,17,40,0.000333,0.055599,10,1667.970001,92.665,166.797,57.219281,1,0
0,0,3,3,8,7,15,11,9,20,0.000333,0.026046,4,312.551248,17.363958,78.137812,43.651484,1,0
0,0,3,3,8,6,14,11,9,20,0.000333,0.025382,4,304.588394,16.921577,76.147098,39.509775,1,0
0,0,3,3,8,7,15,16,11,27,0.000333,0.035162,4,421.944184,23.441344,105.486046,43.651484,1,0
0,0,5,5,11,8,19,19,15,34,0.000333,0.048143,5,722.147677,40.119315,144.429535,62.053748,1,0
0,0,5,5,11,10,21,19,17,36,0.000333,0.052708,5,790.617136,43.923174,158.123427,71.273029,1,0
0,0,3,3,8,7,15,16,11,27,0.000333,0.035162,4,421.944184,23.441344,105.486046,43.651484,1,0
0,0,5,5,10,10,20,18,17,35,0.000333,0.050422,5,756.337417,42.018745,151.267483,66.438562,1,0
0,0,2,2,7,7,14,10,8,18,0.000333,0.022844,3,205.597166,11.422065,68.532389,39.302969,1,0
0,0,11,11,12,15,27,61,50,111,0.000333,0.175931,18,9500.265229,527.792513,527.792513,101.622909,1,0
0,0,3,3,8,6,14,11,9,20,0.000333,0.025382,4,304.588394,16.921577,76.147098,39.509775,1,0
0,0,3,3,8,7,15,11,9,20,0.000333,0.026046,4,312.551248,17.363958,78.137812,43.651484,1,0
0,0,11,11,12,14,26,51,41,92,0.000333,0.144147,12,5189.285449,288.293636,432.440454,96.322519,1,0
0,0,3,3,8,6,14,11,9,20,0.000333,0.025382,4,304.588394,16.921577,76.147098,39.509775,1,0
0,0,3,3,8,7,15,11,9,20,0.000333,0.026046,4,312.551248,17.363958,78.137812,43.651484,1,0
0,0,8,8,11,14,25,41,33,74,0.000333,0.114548,10,3436.45358,190.914088,343.645358,91.356717,1,0
0,0,3,3,8,6,14,11,9,20,0.000333,0.025382,4,304.588394,16.921577,76.147098,39.509775,1,0
0,0,3,3,8,7,15,11,9,20,0.000333,0.026046,4,312.551248,17.363958,78.137812,43.651484,1,0
0,0,8,8,11,11,22,36,26,62,0.000333,0.092162,10,2764.847604,153.602645,276.48476,76.107496,1,0
0,0,3,3,8,6,14,11,9,20,0.000333,0.025382,4,304.588394,16.921577,76.147098,39.509775,1,0
0,0,3,3,8,7,15,11,9,20,0.000333,0.026046,4,312.551248,17.363958,78.137812,43.651484,1,0
0,0,3,3,9,7,16,18,11,29,0.000333,0.038667,4,464,25.777778,116,48.180809,1,0
0,0,5,5,11,10,21,19,17,36,0.000333,0.052708,5,790.617136,43.923174,158.123427,71.273029,1,0
0,0,5,5,11,8,19,19,15,34,0.000333,0.048143,5,722.147677,40.119315,144.429535,62.053748,1,0
0,0,3,3,9,7,16,18,11,29,0.000333,0.038667,4,464,25.777778,116,48.180809,1,0
0,0,5,5,10,10,20,18,17,35,0.000333,0.050422,5,756.337417,42.018745,151.267483,66.438562,1,0
0,0,2,2,7,7,14,10,8,18,0.000333,0.022844,3,205.597166,11.422065,68.532389,39.302969,1,0
0,0,11,11,13,15,28,65,50,115,0.000333,0.184282,18,9951.224689,552.845816,552.845816,106.709075,1,0
0,0,3,3,8,6,14,11,9,20,0.000333,0.025382,4,304.588394,16.921577,76.147098,39.509775,1,0
0,0,3,3,8,7,15,11,9,20,0.000333,0.026046,4,312.551248,17.363958,78.137812,43.651484,1,0
0,0,11,11,13,14,27,55,41,96,0.000333,0.152156,12,5477.630402,304.3128,456.4692,101.408685,1,0
0,0,3,3,8,6,14,11,9,20,0.000333,0.025382,4,304.588394,16.921577,76.147098,39.509775,1,0
0,0,3,3,8,7,15,11,9,20,0.000333,0.026046,4,312.551248,17.363958,78.137812,43.651484,1,0
0,0,8,8,12,14,26,45,33,78,0.000333,0.122211,12,4399.611576,244.422865,366.634298,96.322519,1,0
0,0,3,3,8,6,14,11,9,20,0.000333,0.025382,4,304.588394,16.921577,76.147098,39.509775,1,0
0,0,3,3,8,7,15,11,9,20,0.000333,0.026046,4,312.551248,17.363958,78.137812,43.651484,1,0
0,0,3,3,8,7,15,20,12,32,0.000333,0.041673,4,500.081996,27.782333,125.020499,43.651484,1,0
0,0,3,3,8,8,16,20,12,32,0.000333,0.042667,4,512,28.444444,128,48,1,0
0,0,5,5,10,11,21,28,20,48,0.000333,0.070277,5,1054.156181,58.564232,210.831236,71.273029,1,0
0,0,5,5,10,9,19,28,18,46,0.000333,0.065135,10,1954.046656,108.558148,195.404666,61.748606,1,0
0,0,2,2,7,7,14,10,8,18,0.000333,0.022844,3,205.597166,11.422065,68.532389,39.302969,1,0
0,0,5,5,9,11,20,27,20,47,0.000333,0.06771,4,812.522482,45.140138,203.13062,66.583073,1,0
0,0,3,3,8,8,16,20,12,32,0.000333,0.042667,4,512,28.444444,128,48,1,0
0,0,3,3,8,7,15,20,12,32,0.000333,0.041673,4,500.081996,27.782333,125.020499,43.651484,1,0
0,0,3,3,8,7,15,20,12,32,0.000333,0.041673,4,500.081996,27.782333,125.020499,43.651484,1,0
0,0,3,3,8,8,16,20,12,32,0.000333,0.042667,4,512,28.444444,128,48,1,0
0,0,8,8,11,12,23,47,30,77,0.000333,0.116105,10,3483.142706,193.507928,348.314271,81.073298,1,0
0,0,4,4,10,10,20,32,18,50,0.000333,0.072032,5,1080.482024,60.026779,216.096405,66.438562,1,0
0,0,5,5,10,9,19,28,18,46,0.000333,0.065135,10,1954.046656,108.558148,195.404666,61.748606,1,0
0,0,5,5,10,11,21,28,20,48,0.000333,0.070277,5,1054.156181,58.564232,210.831236,71.273029,1,0
0,0,5,5,9,11,20,27,20,47,0.000333,0.06771,4,812.522482,45.140138,203.13062,66.583073,1,0
0,0,2,2,7,7,14,10,8,18,0.000333,0.022844,3,205.597166,11.422065,68.532389,39.302969,1,0
0,0,4,4,10,10,20,32,18,50,0.000333,0.072032,5,1080.482024,60.026779,216.096405,66.438562,1,0
0,0,11,11,13,15,28,69,52,121,0.000333,0.193897,18,10470.41902,581.689946,581.689946,106.709075,1,0
0,0,3,3,8,8,16,20,12,32,0.000333,0.042667,4,512,28.444444,128,48,1,0
0,0,3,3,8,7,15,20,12,32,0.000333,0.041673,4,500.081996,27.782333,125.020499,43.651484,1,0
0,0,11,11,13,14,27,59,43,102,0.000333,0.161666,18,8729.973454,484.998525,484.998525,101.408685,1,0
0,0,3,3,8,8,16,20,12,32,0.000333,0.042667,4,512,28.444444,128,48,1,0
0,0,3,3,8,7,15,20,12,32,0.000333,0.041673,4,500.081996,27.782333,125.020499,43.651484,1,0
0,0,3,3,8,8,16,20,12,32,0.000333,0.042667,4,512,28.444444,128,48,1,0
0,0,8,8,12,14,26,49,35,84,0.000333,0.131612,12,4738.043236,263.224624,394.836936,96.322519,1,0
0,0,3,3,8,7,15,20,12,32,0.000333,0.041673,4,500.081996,27.782333,125.020499,43.651484,1,0
0,0,3,3,8,7,15,20,12,32,0.000333,0.041673,4,500.081996,27.782333,125.020499,43.651484,1,0
0,0,7,7,11,12,23,45,28,73,0.000333,0.110073,10,3302.200228,183.455568,330.220023,81.073298,1,0
0,0,3,3,8,8,16,20,12,32,0.000333,0.042667,4,512,28.444444,128,48,1,0
0,0,7,7,10,11,21,45,27,72,0.000333,0.105416,10,3162.468544,175.692697,316.246854,71.273029,1,0
0,0,5,5,10,11,21,28,20,48,0.000333,0.070277,5,1054.156181,58.564232,210.831236,71.273029,1,0
0,0,5,5,10,9,19,28,18,46,0.000333,0.065135,10,1954.046656,108.558148,195.404666,61.748606,1,0
0,0,5,5,9,11,20,27,20,47,0.000333,0.06771,4,812.522482,45.140138,203.13062,66.583073,1,0
0,0,2,2,7,7,14,10,8,18,0.000333,0.022844,3,205.597166,11.422065,68.532389,39.302969,1,0
0,0,7,7,10,11,21,45,27,72,0.000333,0.105416,10,3162.468544,175.692697,316.246854,71.273029,1,0
0,0,11,11,13,15,28,69,52,121,0.000333,0.193897,18,10470.41902,581.689946,581.689946,106.709075,1,0
0,0,3,3,8,8,16,20,12,32,0.000333,0.042667,4,512,28.444444,128,48,1,0
0,0,3,3,8,7,15,20,12,32,0.000333,0.041673,4,500.081996,27.782333,125.020499,43.651484,1,0
0,0,11,11,13,14,27,59,43,102,0.000333,0.161666,18,8729.973454,484.998525,484.998525,101.408685,1,0
0,0,3,3,8,8,16,20,12,32,0.000333,0.042667,4,512,28.444444,128,48,1,0
0,0,3,3,8,7,15,20,12,32,0.000333,0.041673,4,500.081996,27.782333,125.020499,43.651484,1,0
0,0,8,8,12,14,26,49,35,84,0.000333,0.131612,12,4738.043236,263.224624,394.836936,96.322519,1,0
0,0,3,3,8,8,16,20,12,32,0.000333,0.042667,4,512,28.444444,128,48,1,0
0,0,3,3,8,7,15,20,12,32,0.000333,0.041673,4,500.081996,27.782333,125.020499,43.651484,1,0
0,0,8,8,11,12,23,43,29,72,0.000333,0.108565,10,3256.964608,180.942478,325.696461,81.073298,1,0
0,0,3,3,8,7,15,20,12,32,0.000333,0.041673,4,500.081996,27.782333,125.020499,43.651484,1,0
0,0,3,3,8,8,16,20,12,32,0.000333,0.042667,4,512,28.444444,128,48,1,0
0,0,9,9,10,13,23,46,31,77,0.000333,0.116105,10,3483.142706,193.507928,348.314271,81.324997,1,0
0,0,5,5,10,9,19,28,18,46,0.000333,0.065135,10,1954.046656,108.558148,195.404666,61.748606,1,0
0,0,5,5,10,11,21,28,20,48,0.000333,0.070277,5,1054.156181,58.564232,210.831236,71.273029,1,0
0,0,8,8,10,11,21,43,28,71,0.000333,0.103952,10,3118.54537,173.252521,311.854537,71.273029,1,0
0,0,2,2,7,7,14,10,8,18,0.000333,0.022844,3,205.597166,11.422065,68.532389,39.302969,1,0
0,0,5,5,9,11,20,27,20,47,0.000333,0.06771,4,812.522482,45.140138,203.13062,66.583073,1,0
0,0,14,14,13,19,32,81,62,143,0.000333,0.238333,18,12870,715,715,128.816339,1,0
0,0,3,3,8,8,16,20,12,32,0.000333,0.042667,4,512,28.444444,128,48,1,0
0,0,3,3,8,7,15,20,12,32,0.000333,0.041673,4,500.081996,27.782333,125.020499,43.651484,1,0
0,0,14,14,13,18,31,71,53,124,0.000333,0.204773,12,7371.84411,409.546895,614.320342,123.164366,1,0
0,0,3,3,8,8,16,20,12,32,0.000333,0.042667,4,512,28.444444,128,48,1,0
0,0,3,3,8,7,15,20,12,32,0.000333,0.041673,4,500.081996,27.782333,125.020499,43.651484,1,0
0,0,13,13,12,18,30,68,51,119,0.000333,0.19464,12,7007.039771,389.279987,583.919981,118.0782,1,0
0,0,3,3,8,8,16,20,12,32,0.000333,0.042667,4,512,28.444444,128,48,1,0
0,0,3,3,8,7,15,20,12,32,0.000333,0.041673,4,500.081996,27.782333,125.020499,43.651484,1,0
0,0,8,8,11,12,23,43,29,72,0.000333,0.108565,10,3256.964608,180.942478,325.696461,81.073298,1,0
0,0,3,3,8,7,15,20,12,32,0.000333,0.041673,4,500.081996,27.782333,125.020499,43.651484,1,0
0,0,3,3,8,8,16,20,12,32,0.000333,0.042667,4,512,28.444444,128,48,1,0
0,0,8,8,10,13,23,41,28,69,0.000333,0.104042,10,3121.25775,173.403208,312.125775,81.324997,1,0
0,0,5,5,10,9,19,28,18,46,0.000333,0.065135,10,1954.046656,108.558148,195.404666,61.748606,1,0
0,0,5,5,10,11,21,28,20,48,0.000333,0.070277,5,1054.156181,58.564232,210.831236,71.273029,1,0
0,0,9,9,10,13,23,46,31,77,0.000333,0.116105,10,3483.142706,193.507928,348.314271,81.324997,1,0
0,0,5,5,9,11,20,27,20,47,0.000333,0.06771,4,812.522482,45.140138,203.13062,66.583073,1,0
0,0,2,2,7,7,14,10,8,18,0.000333,0.022844,3,205.597166,11.422065,68.532389,39.302969,1,0
0,0,14,14,13,19,32,81,62,143,0.000333,0.238333,18,12870,715,715,128.816339,1,0
0,0,3,3,8,8,16,20,12,32,0.000333,0.042667,4,512,28.444444,128,48,1,0
0,0,3,3,8,7,15,20,12,32,0.000333,0.041673,4,500.081996,27.782333,125.020499,43.651484,1,0
0,0,14,14,13,18,31,71,53,124,0.000333,0.204773,12,7371.84411,409.546895,614.320342,123.164366,1,0
0,0,3,3,8,8,16,20,12,32,0.000333,0.042667,4,512,28.444444,128,48,1,0
0,0,3,3,8,7,15,20,12,32,0.000333,0.041673,4,500.081996,27.782333,125.020499,43.651484,1,0
0,0,13,13,12,18,30,68,51,119,0.000333,0.19464,12,7007.039771,389.279987,583.919981,118.0782,1,0
0,0,3,3,8,8,16,20,12,32,0.000333,0.042667,4,512,28.444444,128,48,1,0
0,0,3,3,8,7,15,20,12,32,0.000333,0.041673,4,500.081996,27.782333,125.020499,43.651484,1,0
0,0,8,8,12,12,24,45,29,74,0.000333,0.113096,12,4071.446701,226.191483,339.287225,86.0391,1,0
0,0,3,3,8,8,16,20,12,32,0.000333,0.042667,4,512,28.444444,128,48,1,0
0,0,3,3,8,7,15,20,12,32,0.000333,0.041673,4,500.081996,27.782333,125.020499,43.651484,1,0
0,0,3,3,9,7,16,18,11,29,0.000333,0.038667,4,464,25.777778,116,48.180809,1,0
0,0,5,5,10,11,21,28,20,48,0.000333,0.070277,5,1054.156181,58.564232,210.831236,71.273029,1,0
0,0,5,5,10,9,19,28,18,46,0.000333,0.065135,10,1954.046656,108.558148,195.404666,61.748606,1,0
0,0,3,3,9,7,16,18,11,29,0.000333,0.038667,4,464,25.777778,116,48.180809,1,0
0,0,5,5,9,11,20,27,20,47,0.000333,0.06771,4,812.522482,45.140138,203.13062,66.583073,1,0
0,0,2,2,7,7,14,10,8,18,0.000333,0.022844,3,205.597166,11.422065,68.532389,39.302969,1,0
0,0,14,14,14,19,33,85,62,147,0.000333,0.247175,21,15572.04465,865.113591,741.525936,134.013592,1,0
0,0,3,3,8,8,16,20,12,32,0.000333,0.042667,4,512,28.444444,128,48,1,0
0,0,3,3,8,7,15,20,12,32,0.000333,0.041673,4,500.081996,27.782333,125.020499,43.651484,1,0
0,0,14,14,14,18,32,75,53,128,0.000333,0.213333,14,8960,497.777778,640,128.361619,1,0
0,0,3,3,8,8,16,20,12,32,0.000333,0.042667,4,512,28.444444,128,48,1,0
0,0,3,3,8,7,15,20,12,32,0.000333,0.041673,4,500.081996,27.782333,125.020499,43.651484,1,0
0,0,11,11,13,18,31,65,45,110,0.000333,0.181654,12,6539.53913,363.307729,544.961594,123.164366,1,0
0,0,3,3,8,8,16,20,12,32,0.000333,0.042667,4,512,28.444444,128,48,1,0
0,0,3,3,8,7,15,20,12,32,0.000333,0.041673,4,500.081996,27.782333,125.020499,43.651484,1,0
0,0,3,3,8,6,14,11,9,20,0.000333,0.025382,4,304.588394,16.921577,76.147098,39.509775,1,0
0,0,3,3,8,7,15,11,9,20,0.000333,0.026046,4,312.551248,17.363958,78.137812,43.651484,1,0
0,0,5,5,11,10,21,19,17,36,0.000333,0.052708,5,790.617136,43.923174,158.123427,71.273029,1,0
0,0,5,5,11,8,19,19,15,34,0.000333,0.048143,5,722.147677,40.119315,144.429535,62.053748,1,0
0,0,2,2,7,7,14,10,8,18,0.000333,0.022844,3,205.597166,11.422065,68.532389,39.302969,1,0
0,0,5,5,10,10,20,18,17,35,0.000333,0.050422,5,756.337417,42.018745,151.267483,66.438562,1,0
0,0,3,3,8,7,15,11,9,20,0.000333,0.026046,4,312.551248,17.363958,78.137812,43.651484,1,0
0,0,3,3,8,6,14,11,9,20,0.000333,0.025382,4,304.588394,16.921577,76.147098,39.509775,1,0
0,0,3,3,8,7,15,11,9,20,0.000333,0.026046,4,312.551248,17.363958,78.137812,43.651484,1,0
0,0,3,3,8,6,14,11,9,20,0.000333,0.025382,4,304.588394,16.921577,76.147098,39.509775,1,0
0,0,3,3,8,7,15,11,9,20,0.000333,0.026046,4,312.551248,17.363958,78.137812,43.651484,1,0
0,0,3,3,8,6,14,11,9,20,0.000333,0.025382,4,304.588394,16.921577,76.147098,39.509775,1,0
0,0,3,3,8,6,14,11,9,20,0.000333,0.025382,4,304.588394,16.921577,76.147098,39.509775,1,0
0,0,3,3,8,7,15,11,9,20,0.000333,0.026046,4,312.551248,17.363958,78.137812,43.651484,1,0
0,0,7,7,11,11,22,33,24,57,0.000333,0.084729,10,2541.876023,141.215335,254.187602,76.107496,1,0
0,0,6,6,10,12,22,34,24,58,0.000333,0.086216,10,2586.470339,143.692797,258.647034,76.238831,1,0
0,0,5,5,11,8,19,19,15,34,0.000333,0.048143,5,722.147677,40.119315,144.429535,62.053748,1,0
0,0,5,5,11,10,21,19,17,36,0.000333,0.052708,5,790.617136,43.923174,158.123427,71.273029,1,0
0,0,5,5,10,10,20,18,17,35,0.000333,0.050422,5,756.337417,42.018745,151.267483,66.438562,1,0
0,0,2,2,7,7,14,10,8,18,0.000333,0.022844,3,205.597166,11.422065,68.532389,39.302969,1,0
0,0,9,9,10,12,22,41,29,70,0.000333,0.104053,10,3121.602133,173.422341,312.160213,76.238831,1,0
0,0,14,14,13,18,31,80,61,141,0.000333,0.232847,18,12573.75024,698.54168,698.54168,123.164366,1,0
0,0,3,3,8,7,15,11,9,20,0.000333,0.026046,4,312.551248,17.363958,78.137812,43.651484,1,0
0,0,3,3,8,6,14,11,9,20,0.000333,0.025382,4,304.588394,16.921577,76.147098,39.509775,1,0
0,0,14,14,13,17,30,70,52,122,0.000333,0.199547,18,10775.53175,598.640653,598.640653,117.592585,1,0
0,0,3,3,8,7,15,11,9,20,0.000333,0.026046,4,312.551248,17.363958,78.137812,43.651484,1,0
0,0,3,3,8,6,14,11,9,20,0.000333,0.025382,4,304.588394,16.921577,76.147098,39.509775,1,0
0,0,3,3,8,7,15,11,9,20,0.000333,0.026046,4,312.551248,17.363958,78.137812,43.651484,1,0
0,0,13,13,12,17,29,67,50,117,0.000333,0.189461,12,6820.605317,378.922518,568.383776,112.506418,1,0
0,0,3,3,8,6,14,11,9,20,0.000333,0.025382,4,304.588394,16.921577,76.147098,39.509775,1,0
0,0,3,3,8,6,14,11,9,20,0.000333,0.025382,4,304.588394,16.921577,76.147098,39.509775,1,0
0,0,8,8,11,11,22,38,27,65,0.000333,0.096621,10,2898.630552,161.035031,289.863055,76.107496,1,0
0,0,3,3,8,7,15,11,9,20,0.000333,0.026046,4,312.551248,17.363958,78.137812,43.651484,1,0
0,0,8,8,10,12,22,36,26,62,0.000333,0.092162,10,2764.847604,153.602645,276.48476,76.238831,1,0
0,0,5,5,11,10,21,19,17,36,0.000333,0.052708,5,790.617136,43.923174,158.123427,71.273029,1,0
0,0,5,5,11,8,19,19,15,34,0.000333,0.048143,5,722.147677,40.119315,144.429535,62.053748,1,0
0,0,5,5,10,10,20,18,17,35,0.000333,0.050422,5,756.337417,42.018745,151.267483,66.438562,1,0
0,0,2,2,7,7,14,10,8,18,0.000333,0.022844,3,205.597166,11.422065,68.532389,39.302969,1,0
0,0,9,9,10,12,22,41,29,70,0.000333,0.104053,10,3121.602133,173.422341,312.160213,76.238831,1,0
0,0,14,14,13,18,31,80,61,141,0.000333,0.232847,18,12573.75024,698.54168,698.54168,123.164366,1,0
0,0,3,3,8,7,15,11,9,20,0.000333,0.026046,4,312.551248,17.363958,78.137812,43.651484,1,0
0,0,3,3,8,6,14,11,9,20,0.000333,0.025382,4,304.588394,16.921577,76.147098,39.509775,1,0
0,0,14,14,13,17,30,70,52,122,0.000333,0.199547,18,10775.53175,598.640653,598.640653,117.592585,1,0
0,0,3,3,8,7,15,11,9,20,0.000333,0.026046,4,312.551248,17.363958,78.137812,43.651484,1,0
0,0,3,3,8,6,14,11,9,20,0.000333,0.025382,4,304.588394,16.921577,76.147098,39.509775,1,0
0,0,13,13,12,17,29,67,50,117,0.000333,0.189461,12,6820.605317,378.922518,568.383776,112.506418,1,0
0,0,3,3,8,7,15,11,9,20,0.000333,0.026046,4,312.551248,17.363958,78.137812,43.651484,1,0
0,0,3,3,8,6,14,11,9,20,0.000333,0.025382,4,304.588394,16.921577,76.147098,39.509775,1,0
0,0,8,8,10,11,21,34,26,60,0.000333,0.087846,10,2635.390454,146.410581,263.539045,71.273029,1,0
0,0,3,3,8,6,14,11,9,20,0.000333,0.025382,4,304.588394,16.921577,76.147098,39.509775,1,0
0,0,3,3,8,7,15,11,9,20,0.000333,0.026046,4,312.551248,17.363958,78.137812,43.651484,1,0
0,0,8,8,9,12,21,32,25,57,0.000333,0.083454,8,2002.896745,111.272041,250.362093,71.548875,1,0
0,0,5,5,11,8,19,19,15,34,0.000333,0.048143,5,722.147677,40.119315,144.429535,62.053748,1,0
0,0,5,5,11,10,21,19,17,36,0.000333,0.052708,5,790.617136,43.923174,158.123427,71.273029,1,0
0,0,9,9,9,12,21,37,28,65,0.000333,0.095167,8,2284.00506,126.88917,285.500632,71.548875,1,0
0,0,2,2,7,7,14,10,8,18,0.000333,0.022844,3,205.597166,11.422065,68.532389,39.302969,1,0
0,0,5,5,10,10,20,18,17,35,0.000333,0.050422,5,756.337417,42.018745,151.267483,66.438562,1,0
0,0,14,14,12,18,30,72,59,131,0.000333,0.214268,18,11570.44802,642.802668,642.802668,118.0782,1,0
0,0,3,3,8,7,15,11,9,20,0.000333,0.026046,4,312.551248,17.363958,78.137812,43.651484,1,0
0,0,3,3,8,6,14,11,9,20,0.000333,0.025382,4,304.588394,16.921577,76.147098,39.509775,1,0
0,0,14,14,12,17,29,62,50,112,0.000333,0.181365,12,6529.126457,362.729248,544.093871,112.506418,1,0
0,0,3,3,8,7,15,11,9,20,0.000333,0.026046,4,312.551248,17.363958,78.137812,43.651484,1,0
0,0,3,3,8,6,14,11,9,20,0.000333,0.025382,4,304.588394,16.921577,76.147098,39.509775,1,0
0,0,13,13,11,17,28,59,48,107,0.000333,0.171462,10,5143.869767,285.770543,514.386977,107.540616,1,0
0,0,3,3,8,7,15,11,9,20,0.000333,0.026046,4,312.551248,17.363958,78.137812,43.651484,1,0
0,0,3,3,8,6,14,11,9,20,0.000333,0.025382,4,304.588394,16.921577,76.147098,39.509775,1,0
0,0,8,8,10,11,21,34,26,60,0.000333,0.087846,10,2635.390454,146.410581,263.539045,71.273029,1,0
0,0,3,3,8,6,14,11,9,20,0.000333,0.025382,4,304.588394,16.921577,76.147098,39.509775,1,0
0,0,3,3,8,7,15,11,9,20,0.000333,0.026046,4,312.551248,17.363958,78.137812,43.651484,1,0
0,0,3,3,8,7,15,16,11,27,0.000333,0.035162,4,421.944184,23.441344,105.486046,43.651484,1,0
0,0,5,5,11,8,19,19,15,34,0.000333,0.048143,5,722.147677,40.119315,144.429535,62.053748,1,0
0,0,5,5,11,10,21,19,17,36,0.000333,0.052708,5,790.617136,43.923174,158.123427,71.273029,1,0
0,0,5,5,10,10,20,18,17,35,0.000333,0.050422,5,756.337417,42.018745,151.267483,66.438562,1,0
0,0,2,2,7,7,14,10,8,18,0.000333,0.022844,3,205.597166,11.422065,68.532389,39.302969,1,0
0,0,3,3,8,7,15,16,11,27,0.000333,0.035162,4,421.944184,23.441344,105.486046,43.651484,1,0
0,0,11,11,12,15,27,61,50,111,0.000333,0.175931,18,9500.265229,527.792513,527.792513,101.622909,1,0
0,0,3,3,8,7,15,11,9,20,0.000333,0.026046,4,312.551248,17.363958,78.137812,43.651484,1,0
0,0,3,3,8,6,14,11,9,20,0.000333,0.025382,4,304.588394,16.921577,76.147098,39.509775,1,0
0,0,11,11,12,14,26,51,41,92,0.000333,0.144147,12,5189.285449,288.293636,432.440454,96.322519,1,0
0,0,3,3,8,7,15,11,9,20,0.000333,0.026046,4,312.551248,17.363958,78.137812,43.651484,1,0
0,0,3,3,8,6,14,11,9,20,0.000333,0.025382,4,304.588394,16.921577,76.147098,39.509775,1,0
0,0,8,8,11,14,25,41,33,74,0.000333,0.114548,10,3436.45358,190.914088,343.645358,91.356717,1,0
0,0,3,3,8,7,15,11,9,20,0.000333,0.026046,4,312.551248,17.363958,78.137812,43.651484,1,0
0,0,3,3,8,6,14,11,9,20,0.000333,0.025382,4,304.588394,16.921577,76.147098,39.509775,1,0
0,0,6,6,11,9,20,31,21,52,0.000333,0.074913,10,2247.402609,124.855701,224.740261,66.583073,1,0
0,0,3,3,8,7,15,11,9,20,0.000333,0.026046,4,312.551248,17.363958,78.137812,43.651484,1,0
0,0,3,3,8,6,14,11,9,20,0.000333,0.025382,4,304.588394,16.921577,76.147098,39.509775,1,0
0,0,3,3,9,7,16,18,11,29,0.000333,0.038667,4,464,25.777778,116,48.180809,1,0
0,0,5,5,11,10,21,19,17,36,0.000333,0.052708,5,790.617136,43.923174,158.123427,71.273029,1,0
0,0,5,5,11,8,19,19,15,34,0.000333,0.048143,5,722.147677,40.119315,144.429535,62.053748,1,0
0,0,3,3,9,7,16,18,11,29,0.000333,0.038667,4,464,25.777778,116,48.180809,1,0
0,0,5,5,10,10,20,18,17,35,0.000333,0.050422,5,756.337417,42.018745,151.267483,66.438562,1,0
0,0,2,2,7,7,14,10,8,18,0.000333,0.022844,3,205.597166,11.422065,68.532389,39.302969,1,0
0,0,11,11,13,15,28,65,50,115,0.000333,0.184282,18,9951.224689,552.845816,552.845816,106.709075,1,0
0,0,3,3,8,7,15,11,9,20,0.000333,0.026046,4,312.551248,17.363958,78.137812,43.651484,1,0
0,0,3,3,8,6,14,11,9,20,0.000333,0.025382,4,304.588394,16.921577,76.147098,39.509775,1,0
0,0,11,11,13,14,27,55,41,96,0.000333,0.152156,12,5477.630402,304.3128,456.4692,101.408685,1,0
0,0,3,3,8,7,15,11,9,20,0.000333,0.026046,4,312.551248,17.363958,78.137812,43.651484,1,0
0,0,3,3,8,6,14,11,9,20,0.000333,0.025382,4,304.588394,16.921577,76.147098,39.509775,1,0
0,0,8,8,12,14,26,45,33,78,0.000333,0.122211,12,4399.611576,244.422865,366.634298,96.322519,1,0
0,0,3,3,8,7,15,11,9,20,0.000333,0.026046,4,312.551248,17.363958,78.137812,43.651484,1,0
0,0,3,3,8,6,14,11,9,20,0.000333,0.025382,4,304.588394,16.921577,76.147098,39.509775,1,0
0,0,7,7,11,10,21,34,22,56,0.000333,0.08199,10,2459.697757,136.649875,245.969776,71.273029,1,0
0,0,2,2,7,5,12,9,7,16,0.000333,0.01912,3,172.0782,9.5599,57.3594,31.261125,1,0
0,0,2,2,7,5,12,9,7,16,0.000333,0.01912,3,172.0782,9.5599,57.3594,31.261125,1,0
0,0,11,11,12,15,27,55,45,100,0.000333,0.158496,18,8558.797504,475.48875,475.48875,101.622909,1,0
0,0,2,2,7,5,12,9,7,16,0.000333,0.01912,3,172.0782,9.5599,57.3594,31.261125,1,0
0,0,2,2,7,5,12,9,7,16,0.000333,0.01912,3,172.0782,9.5599,57.3594,31.261125,1,0
0,0,11,11,12,14,26,45,36,81,0.000333,0.126912,12,4568.827406,253.823745,380.735617,96.322519,1,0
0,0,2,2,7,5,12,9,7,16,0.000333,0.01912,3,172.0782,9.5599,57.3594,31.261125,1,0
0,0,2,2,7,5,12,9,7,16,0.000333,0.01912,3,172.0782,9.5599,57.3594,31.261125,1,0
0,0,8,8,11,14,25,35,28,63,0.000333,0.097521,10,2925.6294,162.534967,292.56294,91.356717,1,0
0,0,2,2,7,5,12,9,7,16,0.000333,0.01912,3,172.0782,9.5599,57.3594,31.261125,1,0
0,0,2,2,7,5,12,9,7,16,0.000333,0.01912,3,172.0782,9.5599,57.3594,31.261125,1,0
0,0,8,8,11,12,23,46,28,74,0.000333,0.111581,10,3347.435847,185.968658,334.743585,81.073298,1,0
0,0,2,2,7,5,12,9,7,16,0.000333,0.01912,3,172.0782,9.5599,57.3594,31.261125,1,0
0,0,2,2,7,5,12,9,7,16,0.000333,0.01912,3,172.0782,9.5599,57.3594,31.261125,1,0
0,0,15,15,13,19,32,85,61,146,0.000333,0.243333,18,13140,730,730,128.816339,1,0
0,0,2,2,7,5,12,9,7,16,0.000333,0.01912,3,172.0782,9.5599,57.3594,31.261125,1,0
0,0,2,2,7,5,12,9,7,16,0.000333,0.01912,3,172.0782,9.5599,57.3594,31.261125,1,0
0,0,15,15,13,18,31,75,53,128,0.000333,0.211379,12,7609.645533,422.758085,634.137128,123.164366,1,0
0,0,2,2,7,5,12,9,7,16,0.000333,0.01912,3,172.0782,9.5599,57.3594,31.261125,1,0
0,0,2,2,7,5,12,9,7,16,0.000333,0.01912,3,172.0782,9.5599,57.3594,31.261125,1,0
0,0,13,13,12,18,30,68,48,116,0.000333,0.189733,12,6830.391709,379.466206,569.199309,118.0782,1,0
0,0,2,2,7,5,12,9,7,16,0.000333,0.01912,3,172.0782,9.5599,57.3594,31.261125,1,0
0,0,2,2,7,5,12,9,7,16,0.000333,0.01912,3,172.0782,9.5599,57.3594,31.261125,1,0
0,0,8,8,10,11,21,28,22,50,0.000333,0.073205,10,2196.158711,122.008817,219.615871,71.273029,1,0
0,0,2,2,7,5,12,9,7,16,0.000333,0.01912,3,172.0782,9.5599,57.3594,31.261125,1,0
0,0,2,2,7,5,12,9,7,16,0.000333,0.01912,3,172.0782,9.5599,57.3594,31.261125,1,0
0,0,14,14,12,18,30,63,53,116,0.000333,0.189733,12,6830.391709,379.466206,569.199309,118.0782,1,0
0,0,2,2,7,5,12,9,7,16,0.000333,0.01912,3,172.0782,9.5599,57.3594,31.261125,1,0
0,0,2,2,7,5,12,9,7,16,0.000333,0.01912,3,172.0782,9.5599,57.3594,31.261125,1,0
0,0,14,14,12,17,29,53,44,97,0.000333,0.157075,12,5654.689878,314.149438,471.224157,112.506418,1,0
0,0,2,2,7,5,12,9,7,16,0.000333,0.01912,3,172.0782,9.5599,57.3594,31.261125,1,0
0,0,2,2,7,5,12,9,7,16,0.000333,0.01912,3,172.0782,9.5599,57.3594,31.261125,1,0
0,0,13,13,11,17,28,50,42,92,0.000333,0.147426,10,4422.766528,245.709252,442.276653,107.540616,1,0
0,0,2,2,7,5,12,9,7,16,0.000333,0.01912,3,172.0782,9.5599,57.3594,31.261125,1,0
0,0,2,2,7,5,12,9,7,16,0.000333,0.01912,3,172.0782,9.5599,57.3594,31.261125,1,0
0,0,8,8,10,11,21,28,22,50,0.000333,0.073205,10,2196.158711,122.008817,219.615871,71.273029,1,0
0,0,2,2,7,5,12,9,7,16,0.000333,0.01912,3,172.0782,9.5599,57.3594,31.261125,1,0
0,0,2,2,7,5,12,9,7,16,0.000333,0.01912,3,172.0782,9.5599,57.3594,31.261125,1,0
0,0,14,14,12,18,30,63,53,116,0.000333,0.189733,12,6830.391709,379.466206,569.199309,118.0782,1,0
0,0,2,2,7,5,12,9,7,16,0.000333,0.01912,3,172.0782,9.5599,57.3594,31.261125,1,0
0,0,2,2,7,5,12,9,7,16,0.000333,0.01912,3,172.0782,9.5599,57.3594,31.261125,1,0
0,0,14,14,12,17,29,53,44,97,0.000333,0.157075,12,5654.689878,314.149438,471.224157,112.506418,1,0
0,0,2,2,7,5,12,9,7,16,0.000333,0.01912,3,172.0782,9.5599,57.3594,31.261125,1,0
0,0,2,2,7,5,12,9,7,16,0.000333,0.01912,3,172.0782,9.5599,57.3594,31.261125,1,0
0,0,12,12,11,17,28,48,40,88,0.000333,0.141016,10,4230.472331,235.026241,423.047233,107.540616,1,0
0,0,2,2,7,5,12,9,7,16,0.000333,0.01912,3,172.0782,9.5599,57.3594,31.261125,1,0
0,0,2,2,7,5,12,9,7,16,0.000333,0.01912,3,172.0782,9.5599,57.3594,31.261125,1,0
0,0,2,2,7,5,12,9,7,16,0.000333,0.01912,3,172.0782,9.5599,57.3594,31.261125,1,0
0,0,2,2,7,5,12,9,7,16,0.000333,0.01912,3,172.0782,9.5599,57.3594,31.261125,1,0
0,0,2,2,7,5,12,9,7,16,0.000333,0.01912,3,172.0782,9.5599,57.3594,31.261125,1,0
0,0,2,2,7,5,12,9,7,16,0.000333,0.01912,3,172.0782,9.5599,57.3594,31.261125,1,0
0,0,2,2,7,5,12,9,7,16,0.000333,0.01912,3,172.0782,9.5599,57.3594,31.261125,1,0
0,0,2,2,7,5,12,9,7,16,0.000333,0.01912,3,172.0782,9.5599,57.3594,31.261125,1,0
0,0,2,2,7,5,12,9,7,16,0.000333,0.01912,3,172.0782,9.5599,57.3594,31.261125,1,0
0,0,2,2,7,5,12,9,7,16,0.000333,0.01912,3,172.0782,9.5599,57.3594,31.261125,1,0
0,0,7,7,11,11,22,42,26,68,0.000333,0.10108,10,3032.413501,168.467417,303.24135,76.107496,1,0
0,0,2,2,7,5,12,9,7,16,0.000333,0.01912,3,172.0782,9.5599,57.3594,31.261125,1,0
0,0,2,2,7,5,12,9,7,16,0.000333,0.01912,3,172.0782,9.5599,57.3594,31.261125,1,0
0,0,14,14,13,19,32,81,59,140,0.000333,0.233333,18,12600,700,700,128.816339,1,0
0,0,2,2,7,5,12,9,7,16,0.000333,0.01912,3,172.0782,9.5599,57.3594,31.261125,1,0
0,0,2,2,7,5,12,9,7,16,0.000333,0.01912,3,172.0782,9.5599,57.3594,31.261125,1,0
0,0,14,14,13,18,31,71,50,121,0.000333,0.199819,12,7193.493043,399.638502,599.457754,123.164366,1,0
0,0,2,2,7,5,12,9,7,16,0.000333,0.01912,3,172.0782,9.5599,57.3594,31.261125,1,0
0,0,2,2,7,5,12,9,7,16,0.000333,0.01912,3,172.0782,9.5599,57.3594,31.261125,1,0
0,0,12,12,12,18,30,66,46,112,0.000333,0.183191,12,6594.86096,366.381164,549.571747,118.0782,1,0
0,0,2,2,7,5,12,9,7,16,0.000333,0.01912,3,172.0782,9.5599,57.3594,31.261125,1,0
0,0,2,2,7,5,12,9,7,16,0.000333,0.01912,3,172.0782,9.5599,57.3594,31.261125,1,0
0,0,2,2,7,5,12,9,7,16,0.000333,0.01912,3,172.0782,9.5599,57.3594,31.261125,1,0
0,0,2,2,7,5,12,9,7,16,0.000333,0.01912,3,172.0782,9.5599,57.3594,31.261125,1,0
0,0,2,2,7,5,12,9,7,16,0.000333,0.01912,3,172.0782,9.5599,57.3594,31.261125,1,0
0,0,2,2,7,5,12,9,7,16,0.000333,0.01912,3,172.0782,9.5599,57.3594,31.261125,1,0
0,0,2,2,7,5,12,9,7,16,0.000333,0.01912,3,172.0782,9.5599,57.3594,31.261125,1,0
0,0,2,2,7,5,12,9,7,16,0.000333,0.01912,3,172.0782,9.5599,57.3594,31.261125,1,0
0,0,2,2,7,5,12,9,7,16,0.000333,0.01912,3,172.0782,9.5599,57.3594,31.261125,1,0
0,0,2,2,7,5,12,9,7,16,0.000333,0.01912,3,172.0782,9.5599,57.3594,31.261125,1,0
0,0,7,7,10,10,20,24,20,44,0.000333,0.063388,10,1901.648362,105.647131,190.164836,66.438562,1,0
0,0,2,2,7,5,12,9,7,16,0.000333,0.01912,3,172.0782,9.5599,57.3594,31.261125,1,0
0,0,2,2,7,5,12,9,7,16,0.000333,0.01912,3,172.0782,9.5599,57.3594,31.261125,1,0
0,0,14,14,12,18,30,63,53,116,0.000333,0.189733,12,6830.391709,379.466206,569.199309,118.0782,1,0
0,0,2,2,7,5,12,9,7,16,0.000333,0.01912,3,172.0782,9.5599,57.3594,31.261125,1,0
0,0,2,2,7,5,12,9,7,16,0.000333,0.01912,3,172.0782,9.5599,57.3594,31.261125,1,0
0,0,14,14,12,17,29,53,44,97,0.000333,0.157075,12,5654.689878,314.149438,471.224157,112.506418,1,0
0,0,2,2,7,5,12,9,7,16,0.000333,0.01912,3,172.0782,9.5599,57.3594,31.261125,1,0
0,0,2,2,7,5,12,9,7,16,0.000333,0.01912,3,172.0782,9.5599,57.3594,31.261125,1,0
0,0,12,12,11,17,28,48,40,88,0.000333,0.141016,10,4230.472331,235.026241,423.047233,107.540616,1,0
0,0,2,2,7,5,12,9,7,16,0.000333,0.01912,3,172.0782,9.5599,57.3594,31.261125,1,0
0,0,2,2,7,5,12,9,7,16,0.000333,0.01912,3,172.0782,9.5599,57.3594,31.261125,1,0
0,0,8,8,11,11,22,40,27,67,0.000333,0.099594,10,2987.819184,165.989955,298.781918,76.107496,1,0
0,0,3,3,8,7,15,20,12,32,0.000333,0.041673,4,500.081996,27.782333,125.020499,43.651484,1,0
0,0,3,3,8,8,16,20,12,32,0.000333,0.042667,4,512,28.444444,128,48,1,0
0,0,6,6,10,10,20,33,21,54,0.000333,0.077795,10,2333.841171,129.657843,233.384117,66.438562,1,0
0,0,5,5,10,9,19,28,18,46,0.000333,0.065135,10,1954.046656,108.558148,195.404666,61.748606,1,0
0,0,5,5,10,11,21,28,20,48,0.000333,0.070277,5,1054.156181,58.564232,210.831236,71.273029,1,0
0,0,9,9,10,12,22,43,29,72,0.000333,0.107026,10,3210.790765,178.377265,321.079077,76.238831,1,0
0,0,2,2,7,7,14,10,8,18,0.000333,0.022844,3,205.597166,11.422065,68.532389,39.302969,1,0
0,0,5,5,9,11,20,27,20,47,0.000333,0.06771,4,812.522482,45.140138,203.13062,66.583073,1,0
0,0,14,14,13,18,31,75,58,133,0.000333,0.219636,18,11860.34597,658.908109,658.908109,123.164366,1,0
0,0,3,3,8,7,15,20,12,32,0.000333,0.041673,4,500.081996,27.782333,125.020499,43.651484,1,0
0,0,3,3,8,8,16,20,12,32,0.000333,0.042667,4,512,28.444444,128,48,1,0
0,0,14,14,13,17,30,65,49,114,0.000333,0.186462,12,6712.626335,372.923685,559.385528,117.592585,1,0
0,0,3,3,8,7,15,20,12,32,0.000333,0.041673,4,500.081996,27.782333,125.020499,43.651484,1,0
0,0,3,3,8,8,16,20,12,32,0.000333,0.042667,4,512,28.444444,128,48,1,0
0,0,12,12,12,17,29,60,45,105,0.000333,0.170029,12,6121.056054,340.05867,510.088004,112.506418,1,0
0,0,3,3,8,7,15,20,12,32,0.000333,0.041673,4,500.081996,27.782333,125.020499,43.651484,1,0
0,0,3,3,8,8,16,20,12,32,0.000333,0.042667,4,512,28.444444,128,48,1,0
0,0,8,8,11,11,22,40,27,67,0.000333,0.099594,10,2987.819184,165.989955,298.781918,76.107496,1,0
0,0,3,3,8,7,15,20,12,32,0.000333,0.041673,4,500.081996,27.782333,125.020499,43.651484,1,0
0,0,3,3,8,8,16,20,12,32,0.000333,0.042667,4,512,28.444444,128,48,1,0
0,0,7,7,10,12,22,36,24,60,0.000333,0.089189,10,2675.658971,148.647721,267.565897,76.238831,1,0
0,0,5,5,10,9,19,28,18,46,0.000333,0.065135,10,1954.046656,108.558148,195.404666,61.748606,1,0
0,0,5,5,10,11,21,28,20,48,0.000333,0.070277,5,1054.156181,58.564232,210.831236,71.273029,1,0
0,0,8,8,10,12,22,41,27,68,0.000333,0.10108,10,3032.413501,168.467417,303.24135,76.238831,1,0
0,0,2,2,7,7,14,10,8,18,0.000333,0.022844,3,205.597166,11.422065,68.532389,39.302969,1,0
0,0,5,5,9,11,20,27,20,47,0.000333,0.06771,4,812.522482,45.140138,203.13062,66.583073,1,0
0,0,14,14,13,18,31,75,58,133,0.000333,0.219636,18,11860.34597,658.908109,658.908109,123.164366,1,0
0,0,3,3,8,7,15,20,12,32,0.000333,0.041673,4,500.081996,27.782333,125.020499,43.651484,1,0
0,0,3,3,8,8,16,20,12,32,0.000333,0.042667,4,512,28.444444,128,48,1,0
0,0,14,14,13,17,30,65,49,114,0.000333,0.186462,12,6712.626335,372.923685,559.385528,117.592585,1,0
0,0,3,3,8,7,15,20,12,32,0.000333,0.041673,4,500.081996,27.782333,125.020499,43.651484,1,0
0,0,3,3,8,8,16,20,12,32,0.000333,0.042667,4,512,28.444444,128,48,1,0
0,0,12,12,12,17,29,60,45,105,0.000333,0.170029,12,6121.056054,340.05867,510.088004,112.506418,1,0
0,0,3,3,8,7,15,20,12,32,0.000333,0.041673,4,500.081996,27.782333,125.020499,43.651484,1,0
0,0,3,3,8,8,16,20,12,32,0.000333,0.042667,4,512,28.444444,128,48,1,0
0,0,8,8,10,10,20,31,24,55,0.000333,0.079235,10,2377.060452,132.058914,237.706045,66.438562,1,0
0,0,3,3,8,6,14,11,9,20,0.000333,0.025382,4,304.588394,16.921577,76.147098,39.509775,1,0
0,0,3,3,8,7,15,11,9,20,0.000333,0.026046,4,312.551248,17.363958,78.137812,43.651484,1,0
0,0,8,8,9,11,20,29,23,52,0.000333,0.074913,8,1797.922087,99.88456,224.740261,66.583073,1,0
0,0,5,5,11,8,19,19,15,34,0.000333,0.048143,5,722.147677,40.119315,144.429535,62.053748,1,0
0,0,5,5,11,10,21,19,17,36,0.000333,0.052708,5,790.617136,43.923174,158.123427,71.273029,1,0
0,0,9,9,9,11,20,34,26,60,0.000333,0.086439,8,2074.525486,115.251416,259.315686,66.583073,1,0
0,0,2,2,7,7,14,10,8,18,0.000333,0.022844,3,205.597166,11.422065,68.532389,39.302969,1,0
0,0,5,5,10,10,20,18,17,35,0.000333,0.050422,5,756.337417,42.018745,151.267483,66.438562,1,0
0,0,14,14,12,17,29,66,55,121,0.000333,0.195939,18,10580.68261,587.8157,587.8157,112.506418,1,0
0,0,3,3,8,6,14,11,9,20,0.000333,0.025382,4,304.588394,16.921577,76.147098,39.509775,1,0
0,0,3,3,8,7,15,11,9,20,0.000333,0.026046,4,312.551248,17.363958,78.137812,43.651484,1,0
0,0,14,14,12,16,28,56,46,102,0.000333,0.16345,12,5884.202425,326.900135,490.350202,107.01955,1,0
0,0,3,3,8,6,14,11,9,20,0.000333,0.025382,4,304.588394,16.921577,76.147098,39.509775,1,0
0,0,3,3,8,7,15,11,9,20,0.000333,0.026046,4,312.551248,17.363958,78.137812,43.651484,1,0
0,0,11,11,11,16,27,46,38,84,0.000333,0.133137,10,3994.105502,221.89475,399.41055,102.053748,1,0
0,0,3,3,8,6,14,11,9,20,0.000333,0.025382,4,304.588394,16.921577,76.147098,39.509775,1,0
0,0,3,3,8,7,15,11,9,20,0.000333,0.026046,4,312.551248,17.363958,78.137812,43.651484,1,0
0,0,8,8,10,10,20,31,24,55,0.000333,0.079235,10,2377.060452,132.058914,237.706045,66.438562,1,0
0,0,3,3,8,6,14,11,9,20,0.000333,0.025382,4,304.588394,16.921577,76.147098,39.509775,1,0
0,0,3,3,8,7,15,11,9,20,0.000333,0.026046,4,312.551248,17.363958,78.137812,43.651484,1,0
0,0,3,3,8,6,14,13,9,22,0.000333,0.027921,4,335.047233,18.613735,83.761808,39.509775,1,0
0,0,5,5,11,8,19,19,15,34,0.000333,0.048143,5,722.147677,40.119315,144.429535,62.053748,1,0
0,0,5,5,11,10,21,19,17,36,0.000333,0.052708,5,790.617136,43.923174,158.123427,71.273029,1,0
0,0,9,9,9,11,20,34,26,60,0.000333,0.086439,8,2074.525486,115.251416,259.315686,66.583073,1,0
0,0,2,2,7,7,14,10,8,18,0.000333,0.022844,3,205.597166,11.422065,68.532389,39.302969,1,0
0,0,5,5,10,10,20,18,17,35,0.000333,0.050422,5,756.337417,42.018745,151.267483,66.438562,1,0
0,0,14,14,12,17,29,66,55,121,0.000333,0.195939,18,10580.68261,587.8157,587.8157,112.506418,1,0
0,0,3,3,8,6,14,11,9,20,0.000333,0.025382,4,304.588394,16.921577,76.147098,39.509775,1,0
0,0,3,3,8,7,15,11,9,20,0.000333,0.026046,4,312.551248,17.363958,78.137812,43.651484,1,0
0,0,14,14,12,16,28,56,46,102,0.000333,0.16345,12,5884.202425,326.900135,490.350202,107.01955,1,0
0,0,3,3,8,6,14,11,9,20,0.000333,0.025382,4,304.588394,16.921577,76.147098,39.509775,1,0
0,0,3,3,8,7,15,11,9,20,0.000333,0.026046,4,312.551248,17.363958,78.137812,43.651484,1,0
0,0,13,13,11,16,27,53,44,97,0.000333,0.153741,10,4612.240877,256.235604,461.224088,102.053748,1,0
0,0,3,3,8,6,14,11,9,20,0.000333,0.025382,4,304.588394,16.921577,76.147098,39.509775,1,0
0,0,3,3,8,7,15,11,9,20,0.000333,0.026046,4,312.551248,17.363958,78.137812,43.651484,1,0
0,0,3,3,8,8,16,20,12,32,0.000333,0.042667,4,512,28.444444,128,48,1,0
0,0,3,3,8,7,15,20,12,32,0.000333,0.041673,4,500.081996,27.782333,125.020499,43.651484,1,0
0,0,5,5,10,9,19,28,18,46,0.000333,0.065135,10,1954.046656,108.558148,195.404666,61.748606,1,0
0,0,5,5,10,11,21,28,20,48,0.000333,0.070277,5,1054.156181,58.564232,210.831236,71.273029,1,0
0,0,5,5,9,11,20,27,20,47,0.000333,0.06771,4,812.522482,45.140138,203.13062,66.583073,1,0
0,0,2,2,7,7,14,10,8,18,0.000333,0.022844,3,205.597166,11.422065,68.532389,39.302969,1,0
0,0,3,3,8,8,16,20,12,32,0.000333,0.042667,4,512,28.444444,128,48,1,0
0,0,3,3,8,7,15,20,12,32,0.000333,0.041673,4,500.081996,27.782333,125.020499,43.651484,1,0
0,0,3,3,8,8,16,20,12,32,0.000333,0.042667,4,512,28.444444,128,48,1,0
0,0,3,3,8,7,15,20,12,32,0.000333,0.041673,4,500.081996,27.782333,125.020499,43.651484,1,0
0,0,3,3,8,8,16,20,12,32,0.000333,0.042667,4,512,28.444444,128,48,1,0
0,0,3,3,8,7,15,20,12,32,0.000333,0.041673,4,500.081996,27.782333,125.020499,43.651484,1,0
0,0,8,8,11,11,22,40,27,67,0.000333,0.099594,10,2987.819184,165.989955,298.781918,76.107496,1,0
0,0,3,3,8,8,16,20,12,32,0.000333,0.042667,4,512,28.444444,128,48,1,0
0,0,3,3,8,7,15,20,12,32,0.000333,0.041673,4,500.081996,27.782333,125.020499,43.651484,1,0
0,0,8,8,10,12,22,38,26,64,0.000333,0.095135,10,2854.036236,158.557569,285.403624,76.238831,1,0
0,0,5,5,10,9,19,28,18,46,0.000333,0.065135,10,1954.046656,108.558148,195.404666,61.748606,1,0
0,0,5,5,10,11,21,28,20,48,0.000333,0.070277,5,1054.156181,58.564232,210.831236,71.273029,1,0
0,0,9,9,10,12,22,43,29,72,0.000333,0.107026,10,3210.790765,178.377265,321.079077,76.238831,1,0
0,0,5,5,9,11,20,27,20,47,0.000333,0.06771,4,812.522482,45.140138,203.13062,66.583073,1,0
0,0,2,2,7,7,14,10,8,18,0.000333,0.022844,3,205.597166,11.422065,68.532389,39.302969,1,0
0,0,14,14,13,18,31,75,58,133,0.000333,0.219636,18,11860.34597,658.908109,658.908109,123.164366,1,0
0,0,3,3,8,8,16,20,12,32,0.000333,0.042667,4,512,28.444444,128,48,1,0
0,0,3,3,8,7,15,20,12,32,0.000333,0.041673,4,500.081996,27.782333,125.020499,43.651484,1,0
0,0,14,14,13,17,30,65,49,114,0.000333,0.186462,12,6712.626335,372.923685,559.385528,117.592585,1,0
0,0,3,3,8,8,16,20,12,32,0.000333,0.042667,4,512,28.444444,128,48,1,0
0,0,3,3,8,7,15,20,12,32,0.000333,0.041673,4,500.081996,27.782333,125.020499,43.651484,1,0
0,0,13,13,12,17,29,62,47,109,0.000333,0.176507,12,6354.239142,353.013286,529.519928,112.506418,1,0
0,0,3,3,8,8,16,20,12,32,0.000333,0.042667,4,512,28.444444,128,48,1,0
0,0,3,3,8,7,15,20,12,32,0.000333,0.041673,4,500.081996,27.782333,125.020499,43.651484,1,0
0,0,3,3,8,7,15,11,9,20,0.000333,0.026046,4,312.551248,17.363958,78.137812,43.651484,1,0
0,0,3,3,8,6,14,11,9,20,0.000333,0.025382,4,304.588394,16.921577,76.147098,39.509775,1,0
0,0,5,5,11,8,19,19,15,34,0.000333,0.048143,5,722.147677,40.119315,144.429535,62.053748,1,0
0,0,5,5,11,10,21,19,17,36,0.000333,0.052708,5,790.617136,43.923174,158.123427,71.273029,1,0
0,0,5,5,10,10,20,18,17,35,0.000333,0.050422,5,756.337417,42.018745,151.267483,66.438562,1,0
0,0,2,2,7,7,14,10,8,18,0.000333,0.022844,3,205.597166,11.422065,68.532389,39.302969,1,0
0,0,3,3,8,7,15,11,9,20,0.000333,0.026046,4,312.551248,17.363958,78.137812,43.651484,1,0
0,0,3,3,8,6,14,11,9,20,0.000333,0.025382,4,304.588394,16.921577,76.147098,39.509775,1,0
0,0,3,3,8,7,15,11,9,20,0.000333,0.026046,4,312.551248,17.363958,78.137812,43.651484,1,0
0,0,3,3,8,6,14,11,9,20,0.000333,0.025382,4,304.588394,16.921577,76.147098,39.509775,1,0
0,0,3,3,8,7,15,11,9,20,0.000333,0.026046,4,312.551248,17.363958,78.137812,43.651484,1,0
0,0,3,3,8,6,14,11,9,20,0.000333,0.025382,4,304.588394,16.921577,76.147098,39.509775,1,0
0,0,8,8,10,10,20,31,24,55,0.000333,0.079235,10,2377.060452,132.058914,237.706045,66.438562,1,0
0,0,3,3,8,7,15,11,9,20,0.000333,0.026046,4,312.551248,17.363958,78.137812,43.651484,1,0
0,0,3,3,8,6,14,11,9,20,0.000333,0.025382,4,304.588394,16.921577,76.147098,39.509775,1,0
0,0,3,3,8,6,14,13,9,22,0.000333,0.027921,4,335.047233,18.613735,83.761808,39.509775,1,0
0,0,5,5,11,8,19,19,15,34,0.000333,0.048143,5,722.147677,40.119315,144.429535,62.053748,1,0
0,0,5,5,11,10,21,19,17,36,0.000333,0.052708,5,790.617136,43.923174,158.123427,71.273029,1,0
0,0,3,3,8,6,14,13,9,22,0.000333,0.027921,4,335.047233,18.613735,83.761808,39.509775,1,0
0,0,5,5,10,10,20,18,17,35,0.000333,0.050422,5,756.337417,42.018745,151.267483,66.438562,1,0
0,0,2,2,7,7,14,10,8,18,0.000333,0.022844,3,205.597166,11.422065,68.532389,39.302969,1,0
0,0,13,13,12,17,29,66,55,121,0.000333,0.195939,18,10580.68261,587.8157,587.8157,112.506418,1,0
0,0,3,3,8,7,15,11,9,20,0.000333,0.026046,4,312.551248,17.363958,78.137812,43.651484,1,0
0,0,3,3,8,6,14,11,9,20,0.000333,0.025382,4,304.588394,16.921577,76.147098,39.509775,1,0
0,0,14,14,12,16,28,56,46,102,0.000333,0.16345,12,5884.202425,326.900135,490.350202,107.01955,1,0
0,0,3,3,8,7,15,11,9,20,0.000333,0.026046,4,312.551248,17.363958,78.137812,43.651484,1,0
0,0,3,3,8,6,14,11,9,20,0.000333,0.025382,4,304.588394,16.921577,76.147098,39.509775,1,0
0,0,13,13,11,16,27,53,44,97,0.000333,0.153741,10,4612.240877,256.235604,461.224088,102.053748,1,0
0,0,3,3,8,7,15,11,9,20,0.000333,0.026046,4,312.551248,17.363958,78.137812,43.651484,1,0
0,0,3,3,8,6,14,11,9,20,0.000333,0.025382,4,304.588394,16.921577,76.147098,39.509775,1,0
0,0,6,6,13,12,25,32,23,55,0.000333,0.085137,6,1532.472543,85.137363,255.41209,91.125266,5,0
0,0,8,8,11,20,31,55,33,88,0.000333,0.145323,5,2179.846377,121.102576,435.969275,124.49231,2,0
0,0,8,8,11,20,31,55,33,88,0.000333,0.145323,5,2179.846377,121.102576,435.969275,124.49231,2,0
0,0,6,6,13,12,25,32,23,55,0.000333,0.085137,6,1532.472543,85.137363,255.41209,91.125266,5,0
0,0,6,6,13,12,25,32,23,55,0.000333,0.085137,6,1532.472543,85.137363,255.41209,91.125266,5,0
0,0,8,8,11,20,31,55,33,88,0.000333,0.145323,5,2179.846377,121.102576,435.969275,124.49231,2,0
0,0,8,8,11,20,31,55,33,88,0.000333,0.145323,5,2179.846377,121.102576,435.969275,124.49231,2,0
0,0,8,8,11,20,31,55,33,88,0.000333,0.145323,5,2179.846377,121.102576,435.969275,124.49231,2,0
0,0,6,6,13,12,25,32,23,55,0.000333,0.085137,6,1532.472543,85.137363,255.41209,91.125266,5,0
0,0,6,6,13,12,25,32,23,55,0.000333,0.085137,6,1532.472543,85.137363,255.41209,91.125266,5,0
0,0,8,8,11,20,31,55,33,88,0.000333,0.145323,5,2179.846377,121.102576,435.969275,124.49231,2,0
0,0,8,8,11,20,31,55,33,88,0.000333,0.145323,5,2179.846377,121.102576,435.969275,124.49231,2,0
0,0,8,8,11,20,31,55,33,88,0.000333,0.145323,5,2179.846377,121.102576,435.969275,124.49231,2,0
0,0,6,6,13,12,25,32,23,55,0.000333,0.085137,6,1532.472543,85.137363,255.41209,91.125266,5,0
0,0,6,6,13,12,25,32,23,55,0.000333,0.085137,6,1532.472543,85.137363,255.41209,91.125266,5,0
0,0,8,8,11,20,31,55,33,88,0.000333,0.145323,5,2179.846377,121.102576,435.969275,124.49231,2,0
0,0,8,8,11,20,31,55,33,88,0.000333,0.145323,5,2179.846377,121.102576,435.969275,124.49231,2,0
0,0,8,8,11,20,31,55,33,88,0.000333,0.145323,5,2179.846377,121.102576,435.969275,124.49231,2,0
0,0,6,6,13,12,25,32,23,55,0.000333,0.085137,6,1532.472543,85.137363,255.41209,91.125266,5,0
0,0,6,6,13,12,25,32,23,55,0.000333,0.085137,6,1532.472543,85.137363,255.41209,91.125266,5,0
0,0,8,8,11,20,31,55,33,88,0.000333,0.145323,5,2179.846377,121.102576,435.969275,124.49231,2,0
0,0,8,8,11,20,31,55,33,88,0.000333,0.145323,5,2179.846377,121.102576,435.969275,124.49231,2,0
0,0,8,8,11,20,31,55,33,88,0.000333,0.145323,5,2179.846377,121.102576,435.969275,124.49231,2,0
0,0,6,6,13,12,25,32,23,55,0.000333,0.085137,6,1532.472543,85.137363,255.41209,91.125266,5,0
0,0,6,6,13,12,25,32,23,55,0.000333,0.085137,6,1532.472543,85.137363,255.41209,91.125266,5,0
0,0,8,8,11,20,31,55,33,88,0.000333,0.145323,5,2179.846377,121.102576,435.969275,124.49231,2,0
0,0,8,8,11,20,31,55,33,88,0.000333,0.145323,5,2179.846377,121.102576,435.969275,124.49231,2,0
0,0,8,8,11,20,31,55,33,88,0.000333,0.145323,5,2179.846377,121.102576,435.969275,124.49231,2,0
0,0,6,6,13,12,25,32,23,55,0.000333,0.085137,6,1532.472543,85.137363,255.41209,91.125266,5,0
0,0,6,6,13,12,25,32,23,55,0.000333,0.085137,6,1532.472543,85.137363,255.41209,91.125266,5,0
0,0,8,8,11,20,31,55,33,88,0.000333,0.145323,5,2179.846377,121.102576,435.969275,124.49231,2,0
0,0,8,8,11,20,31,55,33,88,0.000333,0.145323,5,2179.846377,121.102576,435.969275,124.49231,2,0
0,0,8,8,11,20,31,55,33,88,0.000333,0.145323,5,2179.846377,121.102576,435.969275,124.49231,2,0
0,0,6,6,13,12,25,32,23,55,0.000333,0.085137,6,1532.472543,85.137363,255.41209,91.125266,5,0
0,0,6,6,13,12,25,32,23,55,0.000333,0.085137,6,1532.472543,85.137363,255.41209,91.125266,5,0
0,0,8,8,11,20,31,55,33,88,0.000333,0.145323,5,2179.846377,121.102576,435.969275,124.49231,2,0
0,0,8,8,11,20,31,55,33,88,0.000333,0.145323,5,2179.846377,121.102576,435.969275,124.49231,2,0
0,0,8,8,11,20,31,55,33,88,0.000333,0.145323,5,2179.846377,121.102576,435.969275,124.49231,2,0
0,0,6,6,13,12,25,32,23,55,0.000333,0.085137,6,1532.472543,85.137363,255.41209,91.125266,5,0
0,0,6,6,13,12,25,32,23,55,0.000333,0.085137,6,1532.472543,85.137363,255.41209,91.125266,5,0
0,0,8,8,11,20,31,55,33,88,0.000333,0.145323,5,2179.846377,121.102576,435.969275,124.49231,2,0
0,0,8,8,11,20,31,55,33,88,0.000333,0.145323,5,2179.846377,121.102576,435.969275,124.49231,2,0
0,0,8,8,11,20,31,55,33,88,0.000333,0.145323,5,2179.846377,121.102576,435.969275,124.49231,2,0
0,0,6,6,13,12,25,32,23,55,0.000333,0.085137,6,1532.472543,85.137363,255.41209,91.125266,5,0
0,0,6,6,13,12,25,32,23,55,0.000333,0.085137,6,1532.472543,85.137363,255.41209,91.125266,5,0
0,0,8,8,11,20,31,55,33,88,0.000333,0.145323,5,2179.846377,121.102576,435.969275,124.49231,2,0
0,0,8,8,11,20,31,55,33,88,0.000333,0.145323,5,2179.846377,121.102576,435.969275,124.49231,2,0
0,0,8,8,11,20,31,55,33,88,0.000333,0.145323,5,2179.846377,121.102576,435.969275,124.49231,2,0
0,0,6,6,13,12,25,32,23,55,0.000333,0.085137,6,1532.472543,85.137363,255.41209,91.125266,5,0
0,0,6,6,13,12,25,32,23,55,0.000333,0.085137,6,1532.472543,85.137363,255.41209,91.125266,5,0
0,0,8,8,11,20,31,55,33,88,0.000333,0.145323,5,2179.846377,121.102576,435.969275,124.49231,2,0
0,0,8,8,11,20,31,55,33,88,0.000333,0.145323,5,2179.846377,121.102576,435.969275,124.49231,2,0
0,0,8,8,11,20,31,55,33,88,0.000333,0.145323,5,2179.846377,121.102576,435.969275,124.49231,2,0
0,0,6,6,13,12,25,32,23,55,0.000333,0.085137,6,1532.472543,85.137363,255.41209,91.125266,5,0
0,0,6,6,13,12,25,32,23,55,0.000333,0.085137,6,1532.472543,85.137363,255.41209,91.125266,5,0
0,0,8,8,11,20,31,55,33,88,0.000333,0.145323,5,2179.846377,121.102576,435.969275,124.49231,2,0
0,0,8,8,11,20,31,55,33,88,0.000333,0.145323,5,2179.846377,121.102576,435.969275,124.49231,2,0
0,0,8,8,11,20,31,55,33,88,0.000333,0.145323,5,2179.846377,121.102576,435.969275,124.49231,2,0
0,0,6,6,13,12,25,32,23,55,0.000333,0.085137,6,1532.472543,85.137363,255.41209,91.125266,5,0
0,0,6,6,13,12,25,32,23,55,0.000333,0.085137,6,1532.472543,85.137363,255.41209,91.125266,5,0
0,0,8,8,11,20,31,55,33,88,0.000333,0.145323,5,2179.846377,121.102576,435.969275,124.49231,2,0
0,0,8,8,11,20,31,55,33,88,0.000333,0.145323,5,2179.846377,121.102576,435.969275,124.49231,2,0
0,0,8,8,11,20,31,55,33,88,0.000333,0.145323,5,2179.846377,121.102576,435.969275,124.49231,2,0
0,0,6,6,13,12,25,32,23,55,0.000333,0.085137,6,1532.472543,85.137363,255.41209,91.125266,5,0
0,0,6,6,13,12,25,32,23,55,0.000333,0.085137,6,1532.472543,85.137363,255.41209,91.125266,5,0
0,0,8,8,11,20,31,55,33,88,0.000333,0.145323,5,2179.846377,121.102576,435.969275,124.49231,2,0
0,0,8,8,11,20,31,55,33,88,0.000333,0.145323,5,2179.846377,121.102576,435.969275,124.49231,2,0
0,0,8,8,11,20,31,55,33,88,0.000333,0.145323,5,2179.846377,121.102576,435.969275,124.49231,2,0
0,0,6,6,13,12,25,32,23,55,0.000333,0.085137,6,1532.472543,85.137363,255.41209,91.125266,5,0
0,0,6,6,13,12,25,32,23,55,0.000333,0.085137,6,1532.472543,85.137363,255.41209,91.125266,5,0
0,0,8,8,11,20,31,55,33,88,0.000333,0.145323,5,2179.846377,121.102576,435.969275,124.49231,2,0
0,0,8,8,11,20,31,55,33,88,0.000333,0.145323,5,2179.846377,121.102576,435.969275,124.49231,2,0
0,0,8,8,11,20,31,55,33,88,0.000333,0.145323,5,2179.846377,121.102576,435.969275,124.49231,2,0
0,0,6,6,13,12,25,32,23,55,0.000333,0.085137,6,1532.472543,85.137363,255.41209,91.125266,5,0
0,0,8,8,11,20,31,55,33,88,0.000333,0.145323,5,2179.846377,121.102576,435.969275,124.49231,2,0
0,0,8,8,11,20,31,55,33,88,0.000333,0.145323,5,2179.846377,121.102576,435.969275,124.49231,2,0
0,0,6,6,13,12,25,32,23,55,0.000333,0.085137,6,1532.472543,85.137363,255.41209,91.125266,5,0
0,0,8,8,11,20,31,55,33,88,0.000333,0.145323,5,2179.846377,121.102576,435.969275,124.49231,2,0
0,0,8,8,11,20,31,55,33,88,0.000333,0.145323,5,2179.846377,121.102576,435.969275,124.49231,2,0
0,0,6,6,13,12,25,32,23,55,0.000333,0.085137,6,1532.472543,85.137363,255.41209,91.125266,5,0
0,0,8,8,11,20,31,55,33,88,0.000333,0.145323,5,2179.846377,121.102576,435.969275,124.49231,2,0
0,0,8,8,11,20,31,55,33,88,0.000333,0.145323,5,2179.846377,121.102576,435.969275,124.49231,2,0
0,0,6,6,13,12,25,32,23,55,0.000333,0.085137,6,1532.472543,85.137363,255.41209,91.125266,5,0
0,0,6,6,13,12,25,32,23,55,0.000333,0.085137,6,1532.472543,85.137363,255.41209,91.125266,5,0
0,0,8,8,11,20,31,55,33,88,0.000333,0.145323,5,2179.846377,121.102576,435.969275,124.49231,2,0
0,0,8,8,11,20,31,55,33,88,0.000333,0.145323,5,2179.846377,121.102576,435.969275,124.49231,2,0
0,0,8,8,11,20,31,55,33,88,0.000333,0.145323,5,2179.846377,121.102576,435.969275,124.49231,2,0
0,0,6,6,13,12,25,32,23,55,0.000333,0.085137,6,1532.472543,85.137363,255.41209,91.125266,5,0
0,0,6,6,13,12,25,32,23,55,0.000333,0.085137,6,1532.472543,85.137363,255.41209,91.125266,5,0
0,0,8,8,11,20,31,55,33,88,0.000333,0.145323,5,2179.846377,121.102576,435.969275,124.49231,2,0
0,0,8,8,11,20,31,55,33,88,0.000333,0.145323,5,2179.846377,121.102576,435.969275,124.49231,2,0
0,0,8,8,11,20,31,55,33,88,0.000333,0.145323,5,2179.846377,121.102576,435.969275,124.49231,2,0
0,0,6,6,13,12,25,32,23,55,0.000333,0.085137,6,1532.472543,85.137363,255.41209,91.125266,5,0
0,0,8,8,11,20,31,55,33,88,0.000333,0.145323,5,2179.846377,121.102576,435.969275,124.49231,2,0
0,0,8,8,11,20,31,55,33,88,0.000333,0.145323,5,2179.846377,121.102576,435.969275,124.49231,2,0
0,0,6,6,13,12,25,32,23,55,0.000333,0.085137,6,1532.472543,85.137363,255.41209,91.125266,5,0
0,0,8,8,11,20,31,55,33,88,0.000333,0.145323,5,2179.846377,121.102576,435.969275,124.49231,2,0
0,0,8,8,11,20,31,55,33,88,0.000333,0.145323,5,2179.846377,121.102576,435.969275,124.49231,2,0
0,0,6,6,13,12,25,32,23,55,0.000333,0.085137,6,1532.472543,85.137363,255.41209,91.125266,5,0
0,0,8,8,11,20,31,55,33,88,0.000333,0.145323,5,2179.846377,121.102576,435.969275,124.49231,2,0
0,0,8,8,11,20,31,55,33,88,0.000333,0.145323,5,2179.846377,121.102576,435.969275,124.49231,2,0
0,0,6,6,13,12,25,32,23,55,0.000333,0.085137,6,1532.472543,85.137363,255.41209,91.125266,5,0
0,0,8,8,11,20,31,55,33,88,0.000333,0.145323,5,2179.846377,121.102576,435.969275,124.49231,2,0
0,0,8,8,11,20,31,55,33,88,0.000333,0.145323,5,2179.846377,121.102576,435.969275,124.49231,2,0
0,0,6,6,13,12,25,32,23,55,0.000333,0.085137,6,1532.472543,85.137363,255.41209,91.125266,5,0
0,0,8,8,11,20,31,55,33,88,0.000333,0.145323,5,2179.846377,121.102576,435.969275,124.49231,2,0
0,0,8,8,11,20,31,55,33,88,0.000333,0.145323,5,2179.846377,121.102576,435.969275,124.49231,2,0
0,0,6,6,13,12,25,32,23,55,0.000333,0.085137,6,1532.472543,85.137363,255.41209,91.125266,5,0
0,0,8,8,11,20,31,55,33,88,0.000333,0.145323,5,2179.846377,121.102576,435.969275,124.49231,2,0
0,0,8,8,11,20,31,55,33,88,0.000333,0.145323,5,2179.846377,121.102576,435.969275,124.49231,2,0
0,0,6,6,13,12,25,32,23,55,0.000333,0.085137,6,1532.472543,85.137363,255.41209,91.125266,5,0
0,0,8,8,11,20,31,55,33,88,0.000333,0.145323,5,2179.846377,121.102576,435.969275,124.49231,2,0
0,0,8,8,11,20,31,55,33,88,0.000333,0.145323,5,2179.846377,121.102576,435.969275,124.49231,2,0
0,0,6,6,13,12,25,32,23,55,0.000333,0.085137,6,1532.472543,85.137363,255.41209,91.125266,5,0
0,0,8,8,11,20,31,55,33,88,0.000333,0.145323,5,2179.846377,121.102576,435.969275,124.49231,2,0
0,0,8,8,11,20,31,55,33,88,0.000333,0.145323,5,2179.846377,121.102576,435.969275,124.49231,2,0
0,0,6,6,13,12,25,32,23,55,0.000333,0.085137,6,1532.472543,85.137363,255.41209,91.125266,5,0
0,0,8,8,11,20,31,55,33,88,0.000333,0.145323,5,2179.846377,121.102576,435.969275,124.49231,2,0
0,0,8,8,11,20,31,55,33,88,0.000333,0.145323,5,2179.846377,121.102576,435.969275,124.49231,2,0
0,0,6,6,13,12,25,32,23,55,0.000333,0.085137,6,1532.472543,85.137363,255.41209,91.125266,5,0
0,0,8,8,11,20,31,55,33,88,0.000333,0.145323,5,2179.846377,121.102576,435.969275,124.49231,2,0
0,0,8,8,11,20,31,55,33,88,0.000333,0.145323,5,2179.846377,121.102576,435.969275,124.49231,2,0
0,0,6,6,13,12,25,32,23,55,0.000333,0.085137,6,1532.472543,85.137363,255.41209,91.125266,5,0
0,0,8,8,11,20,31,55,33,88,0.000333,0.145323,5,2179.846377,121.102576,435.969275,124.49231,2,0
0,0,8,8,11,20,31,55,33,88,0.000333,0.145323,5,2179.846377,121.102576,435.969275,124.49231,2,0
0,0,6,6,13,12,25,32,23,55,0.000333,0.085137,6,1532.472543,85.137363,255.41209,91.125266,5,0
0,0,8,8,11,20,31,55,33,88,0.000333,0.145323,5,2179.846377,121.102576,435.969275,124.49231,2,0
0,0,8,8,11,20,31,55,33,88,0.000333,0.145323,5,2179.846377,121.102576,435.969275,124.49231,2,0
0,0,6,6,13,12,25,32,23,55,0.000333,0.085137,6,1532.472543,85.137363,255.41209,91.125266,5,0
0,0,8,8,11,20,31,55,33,88,0.000333,0.145323,5,2179.846377,121.102576,435.969275,124.49231,2,0
0,0,8,8,11,20,31,55,33,88,0.000333,0.145323,5,2179.846377,121.102576,435.969275,124.49231,2,0
0,0,6,6,13,12,25,32,23,55,0.000333,0.085137,6,1532.472543,85.137363,255.41209,91.125266,5,0
0,0,8,8,11,20,31,55,33,88,0.000333,0.145323,5,2179.846377,121.102576,435.969275,124.49231,2,0
0,0,8,8,11,20,31,55,33,88,0.000333,0.145323,5,2179.846377,121.102576,435.969275,124.49231,2,0
0,0,6,6,13,12,25,32,23,55,0.000333,0.085137,6,1532.472543,85.137363,255.41209,91.125266,5,0
0,0,8,8,11,20,31,55,33,88,0.000333,0.145323,5,2179.846377,121.102576,435.969275,124.49231,2,0
0,0,8,8,11,20,31,55,33,88,0.000333,0.145323,5,2179.846377,121.102576,435.969275,124.49231,2,0
0,0,6,6,13,12,25,32,23,55,0.000333,0.085137,6,1532.472543,85.137363,255.41209,91.125266,5,0
0,0,8,8,11,20,31,55,33,88,0.000333,0.145323,5,2179.846377,121.102576,435.969275,124.49231,2,0
0,0,8,8,11,20,31,55,33,88,0.000333,0.145323,5,2179.846377,121.102576,435.969275,124.49231,2,0
0,0,6,6,13,12,25,32,23,55,0.000333,0.085137,6,1532.472543,85.137363,255.41209,91.125266,5,0
0,0,8,8,11,20,31,55,33,88,0.000333,0.145323,5,2179.846377,121.102576,435.969275,124.49231,2,0
0,0,8,8,11,20,31,55,33,88,0.000333,0.145323,5,2179.846377,121.102576,435.969275,124.49231,2,0
0,0,6,6,13,12,25,32,23,55,0.000333,0.085137,6,1532.472543,85.137363,255.41209,91.125266,5,0
0,0,8,8,11,20,31,55,33,88,0.000333,0.145323,5,2179.846377,121.102576,435.969275,124.49231,2,0
0,0,8,8,11,20,31,55,33,88,0.000333,0.145323,5,2179.846377,121.102576,435.969275,124.49231,2,0
0,0,6,6,13,12,25,32,23,55,0.000333,0.085137,6,1532.472543,85.137363,255.41209,91.125266,5,0
0,0,8,8,11,20,31,55,33,88,0.000333,0.145323,5,2179.846377,121.102576,435.969275,124.49231,2,0
0,0,8,8,11,20,31,55,33,88,0.000333,0.145323,5,2179.846377,121.102576,435.969275,124.49231,2,0
0,0,6,6,13,12,25,32,23,55,0.000333,0.085137,6,1532.472543,85.137363,255.41209,91.125266,5,0
0,0,8,8,11,20,31,55,33,88,0.000333,0.145323,5,2179.846377,121.102576,435.969275,124.49231,2,0
0,0,8,8,11,20,31,55,33,88,0.000333,0.145323,5,2179.846377,121.102576,435.969275,124.49231,2,0
0,0,6,6,13,12,25,32,23,55,0.000333,0.085137,6,1532.472543,85.137363,255.41209,91.125266,5,0
0,0,8,8,11,20,31,55,33,88,0.000333,0.145323,5,2179.846377,121.102576,435.969275,124.49231,2,0
0,0,8,8,11,20,31,55,33,88,0.000333,0.145323,5,2179.846377,121.102576,435.969275,124.49231,2,0
0,0,6,6,13,12,25,32,23,55,0.000333,0.085137,6,1532.472543,85.137363,255.41209,91.125266,5,0
0,0,8,8,11,20,31,55,33,88,0.000333,0.145323,5,2179.846377,121.102576,435.969275,124.49231,2,0
0,0,8,8,11,20,31,55,33,88,0.000333,0.145323,5,2179.846377,121.102576,435.969275,124.49231,2,0
0,0,6,6,13,12,25,32,23,55,0.000333,0.085137,6,1532.472543,85.137363,255.41209,91.125266,5,0
0,0,8,8,11,20,31,55,33,88,0.000333,0.145323,5,2179.846377,121.102576,435.969275,124.49231,2,0
0,0,8,8,11,20,31,55,33,88,0.000333,0.145323,5,2179.846377,121.102576,435.969275,124.49231,2,0
0,0,6,6,13,12,25,32,23,55,0.000333,0.085137,6,1532.472543,85.137363,255.41209,91.125266,5,0
0,0,8,8,11,20,31,55,33,88,0.000333,0.145323,5,2179.846377,121.102576,435.969275,124.49231,2,0
0,0,8,8,11,20,31,55,33,88,0.000333,0.145323,5,2179.846377,121.102576,435.969275,124.49231,2,0
0,0,3,3,10,8,18,15,10,25,0.000333,0.034749,5,521.240625,28.957813,104.248125,57.219281,2,0
0,0,3,3,10,8,18,15,10,25,0.000333,0.034749,5,521.240625,28.957813,104.248125,57.219281,2,0
0,0,3,3,10,8,18,15,10,25,0.000333,0.034749,5,521.240625,28.957813,104.248125,57.219281,2,0
0,0,3,3,10,8,18,15,10,25,0.000333,0.034749,5,521.240625,28.957813,104.248125,57.219281,2,0
0,0,3,3,10,8,18,15,10,25,0.000333,0.034749,5,521.240625,28.957813,104.248125,57.219281,2,0
0,0,3,3,10,8,18,15,10,25,0.000333,0.034749,5,521.240625,28.957813,104.248125,57.219281,2,0
0,0,3,3,10,8,18,15,10,25,0.000333,0.034749,5,521.240625,28.957813,104.248125,57.219281,2,0
0,0,3,3,10,8,18,15,10,25,0.000333,0.034749,5,521.240625,28.957813,104.248125,57.219281,2,0
0,0,3,3,10,8,18,15,10,25,0.000333,0.034749,5,521.240625,28.957813,104.248125,57.219281,2,0
0,0,3,3,10,8,18,15,10,25,0.000333,0.034749,5,521.240625,28.957813,104.248125,57.219281,2,0
0,0,3,3,10,8,18,15,10,25,0.000333,0.034749,5,521.240625,28.957813,104.248125,57.219281,2,0
0,0,3,3,10,8,18,15,10,25,0.000333,0.034749,5,521.240625,28.957813,104.248125,57.219281,2,0
0,0,3,3,10,8,18,15,10,25,0.000333,0.034749,5,521.240625,28.957813,104.248125,57.219281,2,0
0,0,3,3,10,8,18,15,10,25,0.000333,0.034749,5,521.240625,28.957813,104.248125,57.219281,2,0
0,0,3,3,10,8,18,15,10,25,0.000333,0.034749,5,521.240625,28.957813,104.248125,57.219281,2,0
0,0,3,3,10,8,18,15,10,25,0.000333,0.034749,5,521.240625,28.957813,104.248125,57.219281,2,0
0,0,3,3,10,8,18,15,10,25,0.000333,0.034749,5,521.240625,28.957813,104.248125,57.219281,2,0
0,0,3,3,10,8,18,15,10,25,0.000333,0.034749,5,521.240625,28.957813,104.248125,57.219281,2,0
0,0,3,3,10,8,18,15,10,25,0.000333,0.034749,5,521.240625,28.957813,104.248125,57.219281,2,0
0,0,3,3,10,8,18,15,10,25,0.000333,0.034749,5,521.240625,28.957813,104.248125,57.219281,2,0
0,0,3,3,10,8,18,15,10,25,0.000333,0.034749,5,521.240625,28.957813,104.248125,57.219281,2,0
0,0,3,3,10,8,18,15,10,25,0.000333,0.034749,5,521.240625,28.957813,104.248125,57.219281,2,0
0,0,3,3,10,8,18,15,10,25,0.000333,0.034749,5,521.240625,28.957813,104.248125,57.219281,2,0
0,0,3,3,10,8,18,15,10,25,0.000333,0.034749,5,521.240625,28.957813,104.248125,57.219281,2,0
0,0,3,3,10,8,18,15,10,25,0.000333,0.034749,5,521.240625,28.957813,104.248125,57.219281,2,0
0,0,3,3,10,8,18,15,10,25,0.000333,0.034749,5,521.240625,28.957813,104.248125,57.219281,2,0
0,0,3,3,10,8,18,15,10,25,0.000333,0.034749,5,521.240625,28.957813,104.248125,57.219281,2,0
0,0,3,3,10,8,18,15,10,25,0.000333,0.034749,5,521.240625,28.957813,104.248125,57.219281,2,0
0,0,3,3,10,8,18,15,10,25,0.000333,0.034749,5,521.240625,28.957813,104.248125,57.219281,2,0
0,0,3,3,10,8,18,15,10,25,0.000333,0.034749,5,521.240625,28.957813,104.248125,57.219281,2,0
0,0,3,3,10,8,18,15,10,25,0.000333,0.034749,5,521.240625,28.957813,104.248125,57.219281,2,0
0,0,3,3,10,8,18,15,10,25,0.000333,0.034749,5,521.240625,28.957813,104.248125,57.219281,2,0
0,0,3,3,10,8,18,15,10,25,0.000333,0.034749,5,521.240625,28.957813,104.248125,57.219281,2,0
0,0,3,3,10,8,18,15,10,25,0.000333,0.034749,5,521.240625,28.957813,104.248125,57.219281,2,0
0,0,3,3,10,8,18,15,10,25,0.000333,0.034749,5,521.240625,28.957813,104.248125,57.219281,2,0
0,0,3,3,10,8,18,15,10,25,0.000333,0.034749,5,521.240625,28.957813,104.248125,57.219281,2,0
0,0,3,3,10,8,18,15,10,25,0.000333,0.034749,5,521.240625,28.957813,104.248125,57.219281,2,0
0,0,3,3,10,8,18,15,10,25,0.000333,0.034749,5,521.240625,28.957813,104.248125,57.219281,2,0
0,0,3,3,10,8,18,15,10,25,0.000333,0.034749,5,521.240625,28.957813,104.248125,57.219281,2,0
0,0,3,3,10,8,18,15,10,25,0.000333,0.034749,5,521.240625,28.957813,104.248125,57.219281,2,0
0,0,3,3,10,8,18,15,10,25,0.000333,0.034749,5,521.240625,28.957813,104.248125,57.219281,2,0
0,0,3,3,10,8,18,15,10,25,0.000333,0.034749,5,521.240625,28.957813,104.248125,57.219281,2,0
0,0,3,3,10,8,18,15,10,25,0.000333,0.034749,5,521.240625,28.957813,104.248125,57.219281,2,0
0,0,3,3,10,8,18,15,10,25,0.000333,0.034749,5,521.240625,28.957813,104.248125,57.219281,2,0
0,0,5,5,10,9,19,27,18,45,0.000333,0.063719,10,1911.567381,106.198188,191.156738,61.748606,3,0
0,0,5,5,10,9,19,27,18,45,0.000333,0.063719,10,1911.567381,106.198188,191.156738,61.748606,3,0
0,0,5,5,10,9,19,27,18,45,0.000333,0.063719,10,1911.567381,106.198188,191.156738,61.748606,3,0
0,0,5,5,10,9,19,27,18,45,0.000333,0.063719,10,1911.567381,106.198188,191.156738,61.748606,3,0
0,0,3,3,10,8,18,15,10,25,0.000333,0.034749,5,521.240625,28.957813,104.248125,57.219281,2,0
0,0,3,3,10,8,18,15,10,25,0.000333,0.034749,5,521.240625,28.957813,104.248125,57.219281,2,0
0,0,3,3,10,8,18,15,10,25,0.000333,0.034749,5,521.240625,28.957813,104.248125,57.219281,2,0
0,0,3,3,10,8,18,15,10,25,0.000333,0.034749,5,521.240625,28.957813,104.248125,57.219281,2,0
0,0,3,3,10,8,18,15,10,25,0.000333,0.034749,5,521.240625,28.957813,104.248125,57.219281,2,0
0,0,3,3,10,8,18,15,10,25,0.000333,0.034749,5,521.240625,28.957813,104.248125,57.219281,2,0
0,0,3,3,10,8,18,15,10,25,0.000333,0.034749,5,521.240625,28.957813,104.248125,57.219281,2,0
0,0,3,3,10,8,18,15,10,25,0.000333,0.034749,5,521.240625,28.957813,104.248125,57.219281,2,0
0,0,3,3,10,8,18,15,10,25,0.000333,0.034749,5,521.240625,28.957813,104.248125,57.219281,2,0
0,0,3,3,10,8,18,15,10,25,0.000333,0.034749,5,521.240625,28.957813,104.248125,57.219281,2,0
0,0,3,3,10,8,18,15,10,25,0.000333,0.034749,5,521.240625,28.957813,104.248125,57.219281,2,0
0,0,3,3,10,8,18,15,10,25,0.000333,0.034749,5,521.240625,28.957813,104.248125,57.219281,2,0
0,0,3,3,10,8,18,15,10,25,0.000333,0.034749,5,521.240625,28.957813,104.248125,57.219281,2,0
0,0,3,3,10,8,18,15,10,25,0.000333,0.034749,5,521.240625,28.957813,104.248125,57.219281,2,0
0,0,3,3,10,8,18,15,10,25,0.000333,0.034749,5,521.240625,28.957813,104.248125,57.219281,2,0
0,0,3,3,10,8,18,15,10,25,0.000333,0.034749,5,521.240625,28.957813,104.248125,57.219281,2,0
0,0,3,3,10,8,18,15,10,25,0.000333,0.034749,5,521.240625,28.957813,104.248125,57.219281,2,0
0,0,3,3,10,8,18,15,10,25,0.000333,0.034749,5,521.240625,28.957813,104.248125,57.219281,2,0
0,0,6,6,11,10,21,30,22,52,0.000333,0.076134,10,2284.00506,126.88917,228.400506,71.273029,3,0
0,0,6,6,11,11,22,30,24,54,0.000333,0.08027,10,2408.093074,133.782949,240.809307,76.107496,3,0
0,0,6,6,11,11,22,29,21,50,0.000333,0.074324,5,1114.857905,61.93655,222.971581,76.107496,3,0
0,0,6,6,12,12,24,30,23,53,0.000333,0.081001,6,1458.018075,81.001004,243.003013,86.0391,3,0
0,0,3,3,10,8,18,15,10,25,0.000333,0.034749,5,521.240625,28.957813,104.248125,57.219281,2,0
0,0,3,3,10,8,18,15,10,25,0.000333,0.034749,5,521.240625,28.957813,104.248125,57.219281,2,0
0,0,3,3,10,8,18,15,10,25,0.000333,0.034749,5,521.240625,28.957813,104.248125,57.219281,2,0
0,0,3,3,10,8,18,15,10,25,0.000333,0.034749,5,521.240625,28.957813,104.248125,57.219281,2,0
0,0,3,3,10,8,18,15,10,25,0.000333,0.034749,5,521.240625,28.957813,104.248125,57.219281,2,0
0,0,3,3,10,8,18,15,10,25,0.000333,0.034749,5,521.240625,28.957813,104.248125,57.219281,2,0
0,0,3,3,10,8,18,15,10,25,0.000333,0.034749,5,521.240625,28.957813,104.248125,57.219281,2,0
0,0,3,3,10,8,18,15,10,25,0.000333,0.034749,5,521.240625,28.957813,104.248125,57.219281,2,0
0,0,3,3,10,8,18,15,10,25,0.000333,0.034749,5,521.240625,28.957813,104.248125,57.219281,2,0
0,0,3,3,10,8,18,15,10,25,0.000333,0.034749,5,521.240625,28.957813,104.248125,57.219281,2,0
0,0,3,3,10,8,18,15,10,25,0.000333,0.034749,5,521.240625,28.957813,104.248125,57.219281,2,0
0,0,3,3,10,8,18,15,10,25,0.000333,0.034749,5,521.240625,28.957813,104.248125,57.219281,2,0
0,0,3,3,9,9,18,14,12,26,0.000333,0.036139,4,433.6722,24.0929,108.41805,57.05865,2,0
0,0,6,6,10,11,21,29,24,53,0.000333,0.077598,10,2327.928234,129.329346,232.792823,71.273029,3,0
0,0,6,6,11,12,23,29,23,52,0.000333,0.078408,5,1176.126109,65.340339,235.225222,81.073298,3,0
0,0,3,3,10,10,20,15,12,27,0.000333,0.038897,5,583.460293,32.414461,116.692059,66.438562,2,0
0,0,3,3,10,8,18,15,10,25,0.000333,0.034749,5,521.240625,28.957813,104.248125,57.219281,2,0
0,0,3,3,10,8,18,15,10,25,0.000333,0.034749,5,521.240625,28.957813,104.248125,57.219281,2,0
0,0,3,3,10,8,18,15,10,25,0.000333,0.034749,5,521.240625,28.957813,104.248125,57.219281,2,0
0,0,3,3,10,8,18,15,10,25,0.000333,0.034749,5,521.240625,28.957813,104.248125,57.219281,2,0
0,0,3,3,10,8,18,15,10,25,0.000333,0.034749,5,521.240625,28.957813,104.248125,57.219281,2,0
0,0,3,3,10,8,18,15,10,25,0.000333,0.034749,5,521.240625,28.957813,104.248125,57.219281,2,0
0,0,3,3,10,8,18,15,10,25,0.000333,0.034749,5,521.240625,28.957813,104.248125,57.219281,2,0
0,0,3,3,10,8,18,15,10,25,0.000333,0.034749,5,521.240625,28.957813,104.248125,57.219281,2,0
0,0,3,3,10,8,18,15,10,25,0.000333,0.034749,5,521.240625,28.957813,104.248125,57.219281,2,0
0,0,3,3,10,8,18,15,10,25,0.000333,0.034749,5,521.240625,28.957813,104.248125,57.219281,2,0
0,0,3,3,10,8,18,15,10,25,0.000333,0.034749,5,521.240625,28.957813,104.248125,57.219281,2,0
0,0,3,3,10,8,18,15,10,25,0.000333,0.034749,5,521.240625,28.957813,104.248125,57.219281,2,0
0,0,3,3,10,8,18,15,10,25,0.000333,0.034749,5,521.240625,28.957813,104.248125,57.219281,2,0
0,0,3,3,10,8,18,15,10,25,0.000333,0.034749,5,521.240625,28.957813,104.248125,57.219281,2,0
0,0,3,3,10,8,18,15,10,25,0.000333,0.034749,5,521.240625,28.957813,104.248125,57.219281,2,0
0,0,3,3,10,8,18,15,10,25,0.000333,0.034749,5,521.240625,28.957813,104.248125,57.219281,2,0
0,0,3,3,10,8,18,15,10,25,0.000333,0.034749,5,521.240625,28.957813,104.248125,57.219281,2,0
0,0,3,3,10,8,18,15,10,25,0.000333,0.034749,5,521.240625,28.957813,104.248125,57.219281,2,0
0,0,6,6,13,12,25,32,23,55,0.000333,0.085137,6,1532.472543,85.137363,255.41209,91.125266,5,0
0,0,8,8,11,19,30,53,32,85,0.000333,0.139029,5,2085.428503,115.857139,417.085701,118.764371,2,0
0,0,8,8,11,19,30,53,32,85,0.000333,0.139029,5,2085.428503,115.857139,417.085701,118.764371,2,0
0,0,6,6,13,12,25,32,23,55,0.000333,0.085137,6,1532.472543,85.137363,255.41209,91.125266,5,0
0,0,6,6,13,12,25,32,23,55,0.000333,0.085137,6,1532.472543,85.137363,255.41209,91.125266,5,0
0,0,8,8,11,19,30,53,32,85,0.000333,0.139029,5,2085.428503,115.857139,417.085701,118.764371,2,0
0,0,8,8,11,19,30,53,32,85,0.000333,0.139029,5,2085.428503,115.857139,417.085701,118.764371,2,0
0,0,8,8,11,19,30,53,32,85,0.000333,0.139029,5,2085.428503,115.857139,417.085701,118.764371,2,0
0,0,6,6,13,12,25,32,23,55,0.000333,0.085137,6,1532.472543,85.137363,255.41209,91.125266,5,0
0,0,6,6,13,12,25,32,23,55,0.000333,0.085137,6,1532.472543,85.137363,255.41209,91.125266,5,0
0,0,8,8,11,19,30,53,32,85,0.000333,0.139029,5,2085.428503,115.857139,417.085701,118.764371,2,0
0,0,6,6,13,12,25,32,23,55,0.000333,0.085137,6,1532.472543,85.137363,255.41209,91.125266,5,0
0,0,8,8,11,19,30,53,32,85,0.000333,0.139029,5,2085.428503,115.857139,417.085701,118.764371,2,0
0,0,6,6,13,12,25,32,23,55,0.000333,0.085137,6,1532.472543,85.137363,255.41209,91.125266,5,0
0,0,8,8,11,19,30,53,32,85,0.000333,0.139029,5,2085.428503,115.857139,417.085701,118.764371,2,0
0,0,6,6,13,12,25,32,23,55,0.000333,0.085137,6,1532.472543,85.137363,255.41209,91.125266,5,0
0,0,6,6,13,12,25,32,23,55,0.000333,0.085137,6,1532.472543,85.137363,255.41209,91.125266,5,0
0,0,6,6,13,12,25,32,23,55,0.000333,0.085137,6,1532.472543,85.137363,255.41209,91.125266,5,0
0,0,6,6,13,12,25,32,23,55,0.000333,0.085137,6,1532.472543,85.137363,255.41209,91.125266,5,0
0,0,6,6,13,12,25,32,23,55,0.000333,0.085137,6,1532.472543,85.137363,255.41209,91.125266,5,0
0,0,6,6,13,12,25,32,23,55,0.000333,0.085137,6,1532.472543,85.137363,255.41209,91.125266,5,0
0,0,6,6,13,12,25,32,23,55,0.000333,0.085137,6,1532.472543,85.137363,255.41209,91.125266,5,0
0,0,6,6,13,12,25,32,23,55,0.000333,0.085137,6,1532.472543,85.137363,255.41209,91.125266,5,0
0,0,6,6,13,12,25,32,23,55,0.000333,0.085137,6,1532.472543,85.137363,255.41209,91.125266,5,0
0,0,6,6,13,12,25,32,23,55,0.000333,0.085137,6,1532.472543,85.137363,255.41209,91.125266,5,0
0,0,6,6,13,12,25,32,23,55,0.000333,0.085137,6,1532.472543,85.137363,255.41209,91.125266,5,0
0,0,6,6,13,12,25,32,23,55,0.000333,0.085137,6,1532.472543,85.137363,255.41209,91.125266,5,0
0,0,6,6,13,12,25,32,23,55,0.000333,0.085137,6,1532.472543,85.137363,255.41209,91.125266,5,0
0,0,6,6,13,12,25,32,23,55,0.000333,0.085137,6,1532.472543,85.137363,255.41209,91.125266,5,0
0,0,6,6,13,12,25,32,23,55,0.000333,0.085137,6,1532.472543,85.137363,255.41209,91.125266,5,0
0,0,6,6,13,12,25,32,23,55,0.000333,0.085137,6,1532.472543,85.137363,255.41209,91.125266,5,0
0,0,6,6,13,12,25,32,23,55,0.000333,0.085137,6,1532.472543,85.137363,255.41209,91.125266,5,0
0,0,6,6,13,12,25,32,23,55,0.000333,0.085137,6,1532.472543,85.137363,255.41209,91.125266,5,0
0,0,6,6,13,12,25,32,23,55,0.000333,0.085137,6,1532.472543,85.137363,255.41209,91.125266,5,0
0,0,6,6,13,12,25,32,23,55,0.000333,0.085137,6,1532.472543,85.137363,255.41209,91.125266,5,0
0,0,6,6,13,12,25,32,23,55,0.000333,0.085137,6,1532.472543,85.137363,255.41209,91.125266,5,0
0,0,6,6,13,12,25,32,23,55,0.000333,0.085137,6,1532.472543,85.137363,255.41209,91.125266,5,0
0,0,6,6,13,12,25,32,23,55,0.000333,0.085137,6,1532.472543,85.137363,255.41209,91.125266,5,0
0,0,6,6,13,12,25,32,23,55,0.000333,0.085137,6,1532.472543,85.137363,255.41209,91.125266,5,0
0,0,6,6,13,12,25,32,23,55,0.000333,0.085137,6,1532.472543,85.137363,255.41209,91.125266,5,0
0,0,6,6,13,12,25,32,23,55,0.000333,0.085137,6,1532.472543,85.137363,255.41209,91.125266,5,0
0,0,6,6,13,12,25,32,23,55,0.000333,0.085137,6,1532.472543,85.137363,255.41209,91.125266,5,0
0,0,6,6,13,12,25,32,23,55,0.000333,0.085137,6,1532.472543,85.137363,255.41209,91.125266,5,0
0,0,6,6,13,12,25,32,23,55,0.000333,0.085137,6,1532.472543,85.137363,255.41209,91.125266,5,0
0,0,6,6,13,12,25,32,23,55,0.000333,0.085137,6,1532.472543,85.137363,255.41209,91.125266,5,0
0,0,6,6,13,12,25,32,23,55,0.000333,0.085137,6,1532.472543,85.137363,255.41209,91.125266,5,0
0,0,6,6,13,12,25,32,23,55,0.000333,0.085137,6,1532.472543,85.137363,255.41209,91.125266,5,0
0,0,6,6,13,12,25,32,23,55,0.000333,0.085137,6,1532.472543,85.137363,255.41209,91.125266,5,0
0,0,6,6,13,12,25,32,23,55,0.000333,0.085137,6,1532.472543,85.137363,255.41209,91.125266,5,0
0,0,6,6,13,12,25,32,23,55,0.000333,0.085137,6,1532.472543,85.137363,255.41209,91.125266,5,0
0,0,6,6,13,12,25,32,23,55,0.000333,0.085137,6,1532.472543,85.137363,255.41209,91.125266,5,0
0,0,6,6,13,12,25,32,23,55,0.000333,0.085137,6,1532.472543,85.137363,255.41209,91.125266,5,0
0,0,6,6,13,12,25,32,23,55,0.000333,0.085137,6,1532.472543,85.137363,255.41209,91.125266,5,0
0,0,6,6,13,12,25,32,23,55,0.000333,0.085137,6,1532.472543,85.137363,255.41209,91.125266,5,0
0,0,4,4,10,7,17,18,13,31,0.000333,0.042237,5,633.55674,35.197597,126.711348,52.870765,2,0
0,0,7,7,11,11,22,25,17,42,0.000333,0.062432,5,936.48064,52.026702,187.296128,76.107496,2,0
0,0,5,5,10,8,18,20,15,35,0.000333,0.048649,5,729.736875,40.540938,145.947375,57.219281,2,0
0,0,7,7,12,11,23,26,18,44,0.000333,0.066346,6,1194.220356,66.345575,199.036726,81.073298,2,0
0,0,5,5,10,9,19,20,16,36,0.000333,0.050975,5,764.626952,42.479275,152.92539,61.748606,2,0
0,0,5,5,10,9,19,20,15,35,0.000333,0.049559,5,743.387315,41.299295,148.677463,61.748606,2,0
0,0,7,7,11,11,22,25,17,42,0.000333,0.062432,5,936.48064,52.026702,187.296128,76.107496,2,0
0,0,5,5,10,9,19,20,15,35,0.000333,0.049559,5,743.387315,41.299295,148.677463,61.748606,2,0
0,0,7,7,11,11,22,25,17,42,0.000333,0.062432,5,936.48064,52.026702,187.296128,76.107496,2,0
0,0,7,7,12,12,24,26,18,44,0.000333,0.067246,6,1210.4301,67.246117,201.73835,86.0391,2,0
0,0,5,5,10,10,20,20,16,36,0.000333,0.051863,5,777.947057,43.219281,155.589411,66.438562,2,0
0,0,7,7,12,12,24,26,18,44,0.000333,0.067246,6,1210.4301,67.246117,201.73835,86.0391,2,0
0,0,5,5,10,10,20,20,16,36,0.000333,0.051863,5,777.947057,43.219281,155.589411,66.438562,2,0
0,0,7,7,11,9,20,26,20,46,0.000333,0.06627,10,1988.086924,110.449274,198.808692,66.583073,2,0
0,0,5,5,10,9,19,20,15,35,0.000333,0.049559,5,743.387315,41.299295,148.677463,61.748606,2,0
0,0,5,5,10,9,19,20,15,35,0.000333,0.049559,5,743.387315,41.299295,148.677463,61.748606,2,0
0,0,7,7,11,11,22,25,17,42,0.000333,0.062432,5,936.48064,52.026702,187.296128,76.107496,2,0
0,0,7,7,11,11,22,25,17,42,0.000333,0.062432,5,936.48064,52.026702,187.296128,76.107496,2,0
0,0,5,5,10,9,19,20,15,35,0.000333,0.049559,5,743.387315,41.299295,148.677463,61.748606,2,0
0,0,5,5,10,9,19,20,15,35,0.000333,0.049559,5,743.387315,41.299295,148.677463,61.748606,2,0
0,0,7,7,11,11,22,25,17,42,0.000333,0.062432,5,936.48064,52.026702,187.296128,76.107496,2,0
0,0,4,4,9,7,16,20,15,35,0.000333,0.046667,8,1120,62.222222,140,48.180809,1,0
0,0,5,5,10,10,20,20,16,36,0.000333,0.051863,5,777.947057,43.219281,155.589411,66.438562,2,0
0,0,7,7,12,12,24,26,18,44,0.000333,0.067246,6,1210.4301,67.246117,201.73835,86.0391,2,0
0,0,7,7,12,12,24,26,18,44,0.000333,0.067246,6,1210.4301,67.246117,201.73835,86.0391,2,0
0,0,5,5,10,10,20,20,16,36,0.000333,0.051863,5,777.947057,43.219281,155.589411,66.438562,2,0
0,0,6,6,12,9,21,22,16,38,0.000333,0.055636,6,1001.448372,55.636021,166.908062,71.548875,2,0
0,0,7,7,12,12,24,26,18,44,0.000333,0.067246,6,1210.4301,67.246117,201.73835,86.0391,2,0
0,0,4,4,9,8,17,17,14,31,0.000333,0.042237,4,506.845392,28.158077,126.711348,52.529325,1,0
0,0,4,4,9,8,17,17,14,31,0.000333,0.042237,4,506.845392,28.158077,126.711348,52.529325,1,0
0,0,3,3,9,7,16,15,12,27,0.000333,0.036,4,432,24,108,48.180809,1,0
0,0,12,12,14,14,28,44,39,83,0.000333,0.133003,14,5586.146419,310.341468,399.010459,106.605938,2,0
0,0,10,10,13,12,25,39,37,76,0.000333,0.117644,18,6352.795268,352.93307,352.93307,91.125266,2,0
0,0,7,7,11,13,24,27,22,49,0.000333,0.074888,5,1123.315813,62.406434,224.663163,86.159464,2,0
0,0,6,6,10,12,22,24,22,46,0.000333,0.068378,5,1025.669272,56.981626,205.133854,76.238831,2,0
0,0,5,5,10,8,18,21,18,39,0.000333,0.054209,10,1626.270751,90.348375,162.627075,57.219281,1,0
0,0,5,5,11,8,19,24,18,42,0.000333,0.059471,10,1784.129556,99.118309,178.412956,62.053748,1,0
0,0,5,5,11,8,19,22,18,40,0.000333,0.056639,10,1699.171005,94.398389,169.917101,62.053748,1,0
0,0,5,5,11,10,21,20,18,38,0.000333,0.055636,5,834.54031,46.363351,166.908062,71.273029,1,0
0,0,6,6,10,10,20,25,23,48,0.000333,0.069151,10,2074.525486,115.251416,207.452549,66.438562,1,0
0,0,4,4,9,9,18,19,16,35,0.000333,0.048649,4,583.7895,32.43275,145.947375,57.05865,1,0
0,0,3,3,9,7,16,15,12,27,0.000333,0.036,4,432,24,108,48.180809,1,0
0,0,4,4,11,10,21,19,17,36,0.000333,0.052708,5,790.617136,43.923174,158.123427,71.273029,1,0
0,0,6,6,10,10,20,21,21,42,0.000333,0.060507,10,1815.2098,100.844989,181.52098,66.438562,1,0
0,0,4,4,9,9,18,18,15,33,0.000333,0.045869,4,550.4301,30.57945,137.607525,57.05865,1,0
0,0,6,6,10,11,21,24,25,49,0.000333,0.071741,10,2152.235537,119.568641,215.223554,71.273029,1,0
0,0,6,6,10,11,21,24,25,49,0.000333,0.071741,10,2152.235537,119.568641,215.223554,71.273029,1,0
0,0,6,6,10,11,21,24,25,49,0.000333,0.071741,10,2152.235537,119.568641,215.223554,71.273029,1,0
0,0,5,5,10,9,19,21,17,38,0.000333,0.053807,5,807.106228,44.839235,161.421246,61.748606,1,0
0,0,3,3,9,7,16,15,12,27,0.000333,0.036,4,432,24,108,48.180809,1,0
0,0,7,7,11,11,22,31,26,57,0.000333,0.084729,10,2541.876023,141.215335,254.187602,76.107496,1,0
0,0,8,8,11,12,23,40,30,70,0.000333,0.10555,10,3166.493369,175.916298,316.649337,81.073298,1,0
0,0,4,4,10,10,20,18,17,35,0.000333,0.050422,5,756.337417,42.018745,151.267483,66.438562,1,0
0,0,8,8,10,12,22,36,30,66,0.000333,0.098107,10,2943.224868,163.512493,294.322487,76.238831,1,0
0,0,6,6,11,12,23,20,21,41,0.000333,0.061822,5,927.330201,51.518344,185.46604,81.073298,1,0
0,0,4,4,9,12,21,17,18,35,0.000333,0.051244,4,614.924439,34.162469,153.73111,71.548875,1,0
0,0,11,11,13,15,28,57,49,106,0.000333,0.16986,18,9172.433191,509.579622,509.579622,106.709075,1,0
0,0,11,11,13,14,27,47,40,87,0.000333,0.137892,12,4964.102552,275.783475,413.675213,101.408685,1,0
0,0,8,8,12,14,26,37,32,69,0.000333,0.10811,12,3891.964087,216.220227,324.330341,96.322519,1,0
0,0,3,3,11,8,19,25,16,41,0.000333,0.058055,10,1741.650281,96.758349,174.165028,62.053748,1,0
0,0,6,6,13,11,24,33,19,52,0.000333,0.079473,6,1430.5083,79.472683,238.41805,86.159464,2,0
0,0,4,4,12,8,20,28,17,45,0.000333,0.064829,12,2333.841171,129.657843,194.486764,67.01955,2,0
0,0,6,6,14,11,25,34,20,54,0.000333,0.083589,7,1755.37764,97.52098,250.768234,91.356717,2,0
0,0,4,4,12,9,21,28,18,46,0.000333,0.067349,12,2424.559217,134.697734,202.046601,71.548875,2,0
0,0,4,4,12,9,21,28,17,45,0.000333,0.065885,6,1185.925704,65.884761,197.654284,71.548875,2,0
0,0,6,6,13,11,24,33,19,52,0.000333,0.079473,6,1430.5083,79.472683,238.41805,86.159464,2,0
0,0,6,6,13,11,24,33,19,52,0.000333,0.079473,6,1430.5083,79.472683,238.41805,86.159464,2,0
0,0,4,4,12,9,21,28,17,45,0.000333,0.065885,6,1185.925704,65.884761,197.654284,71.548875,2,0
0,0,6,6,14,12,26,34,20,54,0.000333,0.084608,7,1776.766213,98.709234,253.823745,96.322519,2,0
0,0,4,4,12,10,22,28,18,46,0.000333,0.068378,6,1230.803127,68.377951,205.133854,76.238831,2,0
0,0,6,6,14,12,26,34,20,54,0.000333,0.084608,7,1776.766213,98.709234,253.823745,96.322519,2,0
0,0,4,4,12,10,22,28,18,46,0.000333,0.068378,6,1230.803127,68.377951,205.133854,76.238831,2,0
0,0,6,6,13,11,24,33,19,52,0.000333,0.079473,6,1430.5083,79.472683,238.41805,86.159464,2,0
0,0,4,4,12,9,21,28,17,45,0.000333,0.065885,6,1185.925704,65.884761,197.654284,71.548875,2,0
0,0,6,6,13,11,24,33,19,52,0.000333,0.079473,6,1430.5083,79.472683,238.41805,86.159464,2,0
0,0,4,4,12,9,21,28,17,45,0.000333,0.065885,6,1185.925704,65.884761,197.654284,71.548875,2,0
0,0,6,6,13,11,24,33,19,52,0.000333,0.079473,6,1430.5083,79.472683,238.41805,86.159464,2,0
0,0,4,4,12,9,21,28,17,45,0.000333,0.065885,6,1185.925704,65.884761,197.654284,71.548875,2,0
0,0,6,6,13,11,24,33,19,52,0.000333,0.079473,6,1430.5083,79.472683,238.41805,86.159464,2,0
0,0,4,4,12,9,21,28,17,45,0.000333,0.065885,6,1185.925704,65.884761,197.654284,71.548875,2,0
0,0,6,6,13,9,22,35,21,56,0.000333,0.083243,12,2996.738048,166.485447,249.728171,76.635041,2,0
0,0,6,6,14,12,26,34,20,54,0.000333,0.084608,7,1776.766213,98.709234,253.823745,96.322519,2,0
0,0,4,4,12,10,22,28,18,46,0.000333,0.068378,6,1230.803127,68.377951,205.133854,76.238831,2,0
0,0,6,6,14,12,26,34,20,54,0.000333,0.084608,7,1776.766213,98.709234,253.823745,96.322519,2,0
0,0,4,4,12,10,22,28,18,46,0.000333,0.068378,6,1230.803127,68.377951,205.133854,76.238831,2,0
0,0,8,8,15,11,26,38,19,57,0.000333,0.089308,7,1875.475448,104.19308,267.925064,96.657107,2,0
0,0,4,4,12,9,21,27,17,44,0.000333,0.064421,6,1159.5718,64.420656,193.261967,71.548875,2,0
0,0,4,4,12,8,20,28,17,45,0.000333,0.064829,12,2333.841171,129.657843,194.486764,67.01955,2,0
0,0,4,4,14,10,24,33,21,54,0.000333,0.082529,14,3466.231651,192.568425,247.587975,86.52225,2,0
0,0,3,3,11,8,19,25,16,41,0.000333,0.058055,10,1741.650281,96.758349,174.165028,62.053748,1,0
0,0,6,6,12,13,25,34,26,60,0.000333,0.092877,12,3343.576457,185.754248,278.631371,91.125266,2,0
0,0,14,14,15,15,30,72,52,124,0.000333,0.202818,21,12777.54311,709.863506,608.454434,117.206718,2,0
0,0,8,8,13,16,29,39,28,67,0.000333,0.108495,6,1952.90836,108.494909,325.484727,112.105716,2,0
0,0,5,5,12,13,25,32,24,56,0.000333,0.086685,6,1560.33568,86.685316,260.055947,91.125266,2,0
0,0,5,5,11,9,20,31,22,53,0.000333,0.076354,10,2290.62189,127.256772,229.062189,66.583073,1,0
0,0,6,6,12,10,22,37,24,61,0.000333,0.090675,12,3264.303945,181.350219,272.025329,76.238831,1,0
0,0,5,5,12,9,21,32,22,54,0.000333,0.079062,12,2846.22169,158.123427,237.185141,71.548875,1,0
0,0,5,5,12,11,23,30,22,52,0.000333,0.078408,12,2822.702661,156.816814,235.225222,81.073298,1,0
0,0,4,4,11,10,21,28,19,47,0.000333,0.068813,5,1032.194594,57.344144,206.438919,71.273029,1,0
0,0,4,4,11,10,21,29,20,49,0.000333,0.071741,10,2152.235537,119.568641,215.223554,71.273029,1,0
0,0,3,3,11,8,19,25,16,41,0.000333,0.058055,10,1741.650281,96.758349,174.165028,62.053748,1,0
0,0,4,4,12,11,23,29,21,50,0.000333,0.075393,6,1357.068587,75.392699,226.178098,81.073298,1,0
0,0,6,6,11,11,22,31,25,56,0.000333,0.083243,10,2497.281706,138.737873,249.728171,76.107496,1,0
0,0,4,4,11,10,21,28,19,47,0.000333,0.068813,5,1032.194594,57.344144,206.438919,71.273029,1,0
0,0,4,4,11,11,22,28,21,49,0.000333,0.072837,5,1092.560747,60.697819,218.512149,76.107496,1,0
0,0,4,4,11,10,21,28,19,47,0.000333,0.068813,5,1032.194594,57.344144,206.438919,71.273029,1,0
0,0,4,4,11,11,22,28,21,49,0.000333,0.072837,5,1092.560747,60.697819,218.512149,76.107496,1,0
0,0,4,4,11,10,21,29,20,49,0.000333,0.071741,10,2152.235537,119.568641,215.223554,71.273029,1,0
0,0,4,4,11,10,21,28,19,47,0.000333,0.068813,5,1032.194594,57.344144,206.438919,71.273029,1,0
0,0,7,7,12,12,24,51,34,85,0.000333,0.129907,12,4676.661751,259.814542,389.721813,86.0391,1,0
0,0,4,4,12,10,22,29,19,48,0.000333,0.071351,6,1284.316306,71.350906,214.052718,76.238831,1,0
0,0,4,4,11,11,22,28,21,49,0.000333,0.072837,5,1092.560747,60.697819,218.512149,76.107496,1,0
0,0,5,5,11,12,23,32,22,54,0.000333,0.081424,5,1221.361728,67.853429,244.272346,81.073298,1,0
0,0,6,6,12,13,25,32,24,56,0.000333,0.086685,6,1560.33568,86.685316,260.055947,91.125266,1,0
0,0,4,4,11,13,24,28,23,51,0.000333,0.077944,5,1169.165438,64.953635,233.833088,86.159464,1,0
0,0,11,11,14,16,30,77,57,134,0.000333,0.219174,21,13807.99014,767.110563,657.52334,117.302969,1,0
0,0,11,11,14,15,29,67,48,115,0.000333,0.186223,21,11732.0241,651.779117,558.667814,111.906328,1,0
0,0,13,13,13,17,30,74,54,128,0.000333,0.209361,18,11305.47593,628.081996,628.081996,117.592585,1,0
0,0,3,3,11,8,19,25,16,41,0.000333,0.058055,10,1741.650281,96.758349,174.165028,62.053748,1,0
0,0,7,7,13,12,25,35,21,56,0.000333,0.086685,6,1560.33568,86.685316,260.055947,91.125266,2,0
0,0,5,5,12,9,21,30,19,49,0.000333,0.071741,12,2582.682645,143.482369,215.223554,71.548875,2,0
0,0,7,7,14,12,26,36,22,58,0.000333,0.090875,7,1908.378526,106.021029,272.625504,96.322519,2,0
0,0,5,5,12,10,22,30,20,50,0.000333,0.074324,12,2675.658971,148.647721,222.971581,76.238831,2,0
0,0,5,5,12,10,22,30,19,49,0.000333,0.072837,6,1311.072896,72.837383,218.512149,76.238831,2,0
0,0,7,7,13,12,25,35,21,56,0.000333,0.086685,6,1560.33568,86.685316,260.055947,91.125266,2,0
0,0,5,5,12,10,22,30,19,49,0.000333,0.072837,6,1311.072896,72.837383,218.512149,76.238831,2,0
0,0,7,7,13,12,25,35,21,56,0.000333,0.086685,6,1560.33568,86.685316,260.055947,91.125266,2,0
0,0,5,5,12,11,23,30,20,50,0.000333,0.075393,6,1357.068587,75.392699,226.178098,81.073298,2,0
0,0,7,7,14,13,27,36,22,58,0.000333,0.091928,7,1930.484326,107.249129,275.783475,101.408685,2,0
0,0,5,5,12,11,23,30,20,50,0.000333,0.075393,6,1357.068587,75.392699,226.178098,81.073298,2,0
0,0,7,7,14,13,27,36,22,58,0.000333,0.091928,7,1930.484326,107.249129,275.783475,101.408685,2,0
0,0,5,5,12,10,22,30,19,49,0.000333,0.072837,6,1311.072896,72.837383,218.512149,76.238831,2,0
0,0,7,7,13,12,25,35,21,56,0.000333,0.086685,6,1560.33568,86.685316,260.055947,91.125266,2,0
0,0,5,5,12,10,22,30,19,49,0.000333,0.072837,6,1311.072896,72.837383,218.512149,76.238831,2,0
0,0,7,7,13,12,25,35,21,56,0.000333,0.086685,6,1560.33568,86.685316,260.055947,91.125266,2,0
0,0,5,5,12,10,22,30,19,49,0.000333,0.072837,6,1311.072896,72.837383,218.512149,76.238831,2,0
0,0,7,7,13,12,25,35,21,56,0.000333,0.086685,6,1560.33568,86.685316,260.055947,91.125266,2,0
0,0,5,5,12,10,22,30,19,49,0.000333,0.072837,6,1311.072896,72.837383,218.512149,76.238831,2,0
0,0,7,7,13,12,25,35,21,56,0.000333,0.086685,6,1560.33568,86.685316,260.055947,91.125266,2,0
0,0,4,4,11,8,19,31,20,51,0.000333,0.072215,10,2166.443032,120.357946,216.644303,62.053748,1,0
0,0,7,7,14,13,27,36,22,58,0.000333,0.091928,7,1930.484326,107.249129,275.783475,101.408685,2,0
0,0,5,5,12,11,23,30,20,50,0.000333,0.075393,6,1357.068587,75.392699,226.178098,81.073298,2,0
0,0,5,5,12,11,23,30,20,50,0.000333,0.075393,6,1357.068587,75.392699,226.178098,81.073298,2,0
0,0,7,7,14,13,27,36,22,58,0.000333,0.091928,7,1930.484326,107.249129,275.783475,101.408685,2,0
0,0,5,5,14,9,23,30,17,47,0.000333,0.070869,7,1488.251884,82.68066,212.607412,81.832294,2,0
0,0,6,6,14,10,24,32,20,52,0.000333,0.079473,14,3337.852701,185.436261,238.41805,86.52225,2,0
0,0,5,5,12,9,21,30,19,49,0.000333,0.071741,12,2582.682645,143.482369,215.223554,71.548875,2,0
0,0,4,4,14,10,24,33,21,54,0.000333,0.082529,14,3466.231651,192.568425,247.587975,86.52225,2,0
0,0,3,3,11,8,19,25,16,41,0.000333,0.058055,10,1741.650281,96.758349,174.165028,62.053748,1,0
0,0,5,5,11,12,23,31,23,54,0.000333,0.081424,5,1221.361728,67.853429,244.272346,81.073298,1,0
0,0,5,5,11,12,23,31,23,54,0.000333,0.081424,5,1221.361728,67.853429,244.272346,81.073298,1,0
0,0,7,7,13,14,27,37,26,63,0.000333,0.099853,6,1797.347476,99.852638,299.557913,101.408685,2,0
0,0,10,10,13,13,26,58,45,103,0.000333,0.161382,18,8714.615237,484.145291,484.145291,96.211433,2,0
0,0,5,5,11,9,20,31,22,53,0.000333,0.076354,10,2290.62189,127.256772,229.062189,66.583073,1,0
0,0,10,10,12,11,23,50,34,84,0.000333,0.12666,18,6839.625678,379.979204,379.979204,81.073298,1,0
0,0,7,7,12,10,22,36,26,62,0.000333,0.092162,12,3317.817124,184.323174,276.48476,76.238831,1,0
0,0,8,8,12,13,25,37,29,66,0.000333,0.102165,12,3677.934102,204.329672,306.494509,91.125266,1,0
0,0,4,4,11,10,21,28,19,47,0.000333,0.068813,5,1032.194594,57.344144,206.438919,71.273029,1,0
0,0,4,4,11,10,21,29,20,49,0.000333,0.071741,10,2152.235537,119.568641,215.223554,71.273029,1,0
0,0,4,4,11,10,21,28,19,47,0.000333,0.068813,5,1032.194594,57.344144,206.438919,71.273029,1,0
0,0,4,4,12,11,23,29,21,50,0.000333,0.075393,6,1357.068587,75.392699,226.178098,81.073298,1,0
0,0,6,6,11,11,22,31,25,56,0.000333,0.083243,10,2497.281706,138.737873,249.728171,76.107496,1,0
0,0,6,6,11,11,22,45,31,76,0.000333,0.112972,10,3389.16803,188.287113,338.916803,76.107496,1,0
0,0,4,4,11,10,21,28,19,47,0.000333,0.068813,5,1032.194594,57.344144,206.438919,71.273029,1,0
0,0,5,5,11,11,22,31,24,55,0.000333,0.081756,10,2452.68739,136.260411,245.268739,76.107496,1,0
0,0,5,5,11,11,22,31,24,55,0.000333,0.081756,10,2452.68739,136.260411,245.268739,76.107496,1,0
0,0,5,5,12,10,22,31,21,52,0.000333,0.077297,12,2782.68533,154.593629,231.890444,76.238831,1,0
0,0,5,5,11,11,22,30,21,51,0.000333,0.07581,5,1137.155063,63.175281,227.431013,76.107496,1,0
0,0,4,4,12,10,22,29,19,48,0.000333,0.071351,6,1284.316306,71.350906,214.052718,76.238831,1,0
0,0,4,4,12,10,22,29,19,48,0.000333,0.071351,6,1284.316306,71.350906,214.052718,76.238831,1,0
0,0,4,4,11,11,22,28,21,49,0.000333,0.072837,5,1092.560747,60.697819,218.512149,76.107496,1,0
0,0,8,8,11,13,24,56,38,94,0.000333,0.143662,10,4309.864751,239.436931,430.986475,86.159464,1,0
0,0,11,11,12,15,27,56,44,100,0.000333,0.158496,12,5705.865003,316.9925,475.48875,101.622909,1,0
0,0,4,4,11,12,23,28,22,50,0.000333,0.075393,5,1130.890489,62.827249,226.178098,81.073298,1,0
0,0,11,11,14,16,30,77,57,134,0.000333,0.219174,21,13807.99014,767.110563,657.52334,117.302969,1,0
0,0,11,11,14,15,29,67,48,115,0.000333,0.186223,21,11732.0241,651.779117,558.667814,111.906328,1,0
0,0,13,13,13,17,30,74,54,128,0.000333,0.209361,18,11305.47593,628.081996,628.081996,117.592585,1,0
0,0,3,3,9,8,17,19,15,34,0.000333,0.046325,4,555.894946,30.883053,138.973737,52.529325,1,0
0,0,7,7,11,12,23,29,20,49,0.000333,0.073885,5,1108.272679,61.570704,221.654536,81.073298,2,0
0,0,5,5,10,9,19,24,18,42,0.000333,0.059471,10,1784.129556,99.118309,178.412956,61.748606,2,0
0,0,7,7,12,12,24,30,21,51,0.000333,0.077944,6,1402.998525,77.944363,233.833088,86.0391,2,0
0,0,5,5,10,10,20,24,19,43,0.000333,0.061948,5,929.21454,51.62303,185.842908,66.438562,2,0
0,0,7,7,11,12,23,29,20,49,0.000333,0.073885,5,1108.272679,61.570704,221.654536,81.073298,2,0
0,0,5,5,10,10,20,24,18,42,0.000333,0.060507,5,907.6049,50.422494,181.52098,66.438562,2,0
0,0,7,7,11,12,23,29,20,49,0.000333,0.073885,5,1108.272679,61.570704,221.654536,81.073298,2,0
0,0,5,5,10,10,20,24,18,42,0.000333,0.060507,5,907.6049,50.422494,181.52098,66.438562,2,0
0,0,5,5,10,11,21,24,19,43,0.000333,0.062957,5,944.348246,52.463791,188.869649,71.273029,2,0
0,0,7,7,12,13,25,30,21,51,0.000333,0.078946,6,1421.019994,78.945555,236.836666,91.125266,2,0
0,0,5,5,10,11,21,24,19,43,0.000333,0.062957,5,944.348246,52.463791,188.869649,71.273029,2,0
0,0,7,7,12,13,25,30,21,51,0.000333,0.078946,6,1421.019994,78.945555,236.836666,91.125266,2,0
0,0,5,5,10,10,20,24,18,42,0.000333,0.060507,5,907.6049,50.422494,181.52098,66.438562,2,0
0,0,7,7,11,12,23,29,20,49,0.000333,0.073885,5,1108.272679,61.570704,221.654536,81.073298,2,0
0,0,5,5,10,10,20,24,18,42,0.000333,0.060507,5,907.6049,50.422494,181.52098,66.438562,2,0
0,0,6,6,11,10,21,21,14,35,0.000333,0.051244,5,768.655549,42.703086,153.73111,71.273029,2,0
0,0,5,5,10,10,20,24,18,42,0.000333,0.060507,5,907.6049,50.422494,181.52098,66.438562,2,0
0,0,7,7,11,12,23,29,20,49,0.000333,0.073885,5,1108.272679,61.570704,221.654536,81.073298,2,0
0,0,5,5,10,10,20,24,18,42,0.000333,0.060507,5,907.6049,50.422494,181.52098,66.438562,2,0
0,0,7,7,11,12,23,29,20,49,0.000333,0.073885,5,1108.272679,61.570704,221.654536,81.073298,2,0
0,0,6,6,11,9,20,29,20,49,0.000333,0.070591,10,2117.744766,117.652487,211.774477,66.583073,2,0
0,0,5,5,10,11,21,24,19,43,0.000333,0.062957,5,944.348246,52.463791,188.869649,71.273029,2,0
0,0,7,7,12,13,25,30,21,51,0.000333,0.078946,6,1421.019994,78.945555,236.836666,91.125266,2,0
0,0,5,5,10,11,21,24,19,43,0.000333,0.062957,5,944.348246,52.463791,188.869649,71.273029,2,0
0,0,7,7,12,13,25,30,21,51,0.000333,0.078946,6,1421.019994,78.945555,236.836666,91.125266,2,0
0,0,11,11,14,13,27,42,25,67,0.000333,0.106192,7,2230.042239,123.891235,318.577463,101.408685,2,0
0,0,6,6,12,10,22,26,19,45,0.000333,0.066891,6,1204.046537,66.891474,200.674423,76.238831,2,0
0,0,4,4,10,8,18,22,16,38,0.000333,0.052819,10,1584.571501,88.03175,158.45715,57.219281,2,0
0,0,5,5,12,11,23,29,22,51,0.000333,0.076901,12,2768.419917,153.801107,230.70166,81.073298,2,0
0,0,3,3,9,8,17,19,15,34,0.000333,0.046325,4,555.894946,30.883053,138.973737,52.529325,1,0
0,0,7,7,11,14,25,31,25,56,0.000333,0.086685,5,1300.279733,72.237763,260.055947,91.356717,2,0
0,0,9,9,13,12,25,45,41,86,0.000333,0.133124,18,7188.689382,399.371632,399.371632,91.125266,2,0
0,0,6,6,10,13,23,28,25,53,0.000333,0.079916,5,1198.743918,66.596884,239.748784,81.324997,2,0
0,0,7,7,11,14,25,31,25,56,0.000333,0.086685,5,1300.279733,72.237763,260.055947,91.356717,2,0
0,0,5,5,10,9,19,25,21,46,0.000333,0.065135,10,1954.046656,108.558148,195.404666,61.748606,1,0
0,0,5,5,10,9,19,25,21,46,0.000333,0.065135,10,1954.046656,108.558148,195.404666,61.748606,1,0
0,0,7,7,11,11,22,34,26,60,0.000333,0.089189,10,2675.658971,148.647721,267.565897,76.107496,1,0
0,0,5,5,11,9,20,26,21,47,0.000333,0.06771,10,2031.306205,112.850345,203.13062,66.583073,1,0
0,0,7,7,11,12,23,28,25,53,0.000333,0.079916,10,2397.487837,133.193769,239.748784,81.073298,1,0
0,0,4,4,10,10,20,20,18,38,0.000333,0.054744,5,821.166338,45.620352,164.233268,66.438562,1,0
0,0,4,4,9,10,19,23,19,42,0.000333,0.059471,4,713.651822,39.647323,178.412956,61.748606,1,0
0,0,3,3,9,8,17,19,15,34,0.000333,0.046325,4,555.894946,30.883053,138.973737,52.529325,1,0
0,0,4,4,11,11,22,23,20,43,0.000333,0.063919,5,958.777798,53.265433,191.75556,76.107496,1,0
0,0,6,6,10,11,21,25,24,49,0.000333,0.071741,10,2152.235537,119.568641,215.223554,71.273029,1,0
0,0,6,6,10,11,21,33,29,62,0.000333,0.090775,10,2723.236802,151.290933,272.32368,71.273029,1,0
0,0,4,4,10,11,21,22,20,42,0.000333,0.061492,5,922.386659,51.243703,184.477332,71.273029,1,0
0,0,4,4,10,11,21,22,20,42,0.000333,0.061492,5,922.386659,51.243703,184.477332,71.273029,1,0
0,0,4,4,10,11,21,22,20,42,0.000333,0.061492,5,922.386659,51.243703,184.477332,71.273029,1,0
0,0,4,4,9,10,19,23,19,42,0.000333,0.059471,4,713.651822,39.647323,178.412956,61.748606,1,0
0,0,4,4,11,10,21,23,19,42,0.000333,0.061492,5,922.386659,51.243703,184.477332,71.273029,1,0
0,0,7,7,11,12,23,39,32,71,0.000333,0.107058,10,3211.728989,178.429388,321.172899,81.073298,1,0
0,0,8,8,11,13,24,48,36,84,0.000333,0.128379,10,3851.368501,213.964917,385.13685,86.159464,1,0
0,0,4,4,10,11,21,22,20,42,0.000333,0.061492,5,922.386659,51.243703,184.477332,71.273029,1,0
0,0,11,11,10,15,25,52,43,95,0.000333,0.147055,10,4411.66338,245.09241,441.166338,91.82264,1,0
0,0,11,11,11,15,26,44,42,86,0.000333,0.134746,10,4042.378158,224.576564,404.237816,96.657107,1,0
0,0,4,4,10,12,22,22,21,43,0.000333,0.063919,5,958.777798,53.265433,191.75556,76.238831,1,0
0,0,11,11,13,16,29,65,55,120,0.000333,0.194319,18,10493.23895,582.957719,582.957719,112.105716,1,0
0,0,11,11,13,15,28,55,46,101,0.000333,0.161848,18,8739.771248,485.542847,485.542847,106.709075,1,0
0,0,8,8,12,15,27,45,38,83,0.000333,0.131552,12,4735.867952,263.103775,394.655663,101.622909,1,0
0,0,3,3,9,7,16,14,11,25,0.000333,0.033333,4,400,22.222222,100,48.180809,1,0
0,0,7,7,11,11,22,25,17,42,0.000333,0.062432,5,936.48064,52.026702,187.296128,76.107496,2,0
0,0,5,5,10,8,18,20,15,35,0.000333,0.048649,5,729.736875,40.540938,145.947375,57.219281,2,0
0,0,5,5,10,9,19,20,16,36,0.000333,0.050975,5,764.626952,42.479275,152.92539,61.748606,2,0
0,0,7,7,12,11,23,26,18,44,0.000333,0.066346,6,1194.220356,66.345575,199.036726,81.073298,2,0
0,0,5,5,10,9,19,20,15,35,0.000333,0.049559,5,743.387315,41.299295,148.677463,61.748606,2,0
0,0,7,7,11,11,22,25,17,42,0.000333,0.062432,5,936.48064,52.026702,187.296128,76.107496,2,0
0,0,5,5,10,9,19,20,15,35,0.000333,0.049559,5,743.387315,41.299295,148.677463,61.748606,2,0
0,0,7,7,11,11,22,25,17,42,0.000333,0.062432,5,936.48064,52.026702,187.296128,76.107496,2,0
0,0,5,5,9,11,20,19,17,36,0.000333,0.051863,4,622.357646,34.575425,155.589411,66.583073,1,0
0,0,7,7,12,12,24,26,18,44,0.000333,0.067246,6,1210.4301,67.246117,201.73835,86.0391,2,0
0,0,5,5,10,10,20,20,16,36,0.000333,0.051863,5,777.947057,43.219281,155.589411,66.438562,2,0
0,0,7,7,12,12,24,26,18,44,0.000333,0.067246,6,1210.4301,67.246117,201.73835,86.0391,2,0
0,0,7,7,11,11,22,25,17,42,0.000333,0.062432,5,936.48064,52.026702,187.296128,76.107496,2,0
0,0,5,5,10,9,19,20,15,35,0.000333,0.049559,5,743.387315,41.299295,148.677463,61.748606,2,0
0,0,5,5,10,9,19,20,15,35,0.000333,0.049559,5,743.387315,41.299295,148.677463,61.748606,2,0
0,0,7,7,11,11,22,25,17,42,0.000333,0.062432,5,936.48064,52.026702,187.296128,76.107496,2,0
0,0,5,5,10,9,19,20,15,35,0.000333,0.049559,5,743.387315,41.299295,148.677463,61.748606,2,0
0,0,7,7,11,11,22,25,17,42,0.000333,0.062432,5,936.48064,52.026702,187.296128,76.107496,2,0
0,0,5,5,10,9,19,20,15,35,0.000333,0.049559,5,743.387315,41.299295,148.677463,61.748606,2,0
0,0,7,7,11,11,22,25,17,42,0.000333,0.062432,5,936.48064,52.026702,187.296128,76.107496,2,0
0,0,6,6,11,8,19,25,17,42,0.000333,0.059471,10,1784.129556,99.118309,178.412956,62.053748,2,0
0,0,5,5,10,10,20,20,16,36,0.000333,0.051863,5,777.947057,43.219281,155.589411,66.438562,2,0
0,0,7,7,12,12,24,26,18,44,0.000333,0.067246,6,1210.4301,67.246117,201.73835,86.0391,2,0
0,0,5,5,10,10,20,20,16,36,0.000333,0.051863,5,777.947057,43.219281,155.589411,66.438562,2,0
0,0,7,7,12,12,24,26,18,44,0.000333,0.067246,6,1210.4301,67.246117,201.73835,86.0391,2,0
0,0,9,9,14,12,26,30,18,48,0.000333,0.075207,7,1579.347745,87.741541,225.621106,96.322519,2,0
0,0,6,6,12,9,21,22,16,38,0.000333,0.055636,6,1001.448372,55.636021,166.908062,71.548875,2,0
0,0,5,5,10,8,18,20,15,35,0.000333,0.048649,5,729.736875,40.540938,145.947375,57.219281,2,0
0,0,5,5,12,10,22,25,19,44,0.000333,0.065405,6,1177.289947,65.404997,196.214991,76.238831,2,0
0,0,3,3,9,7,16,15,12,27,0.000333,0.036,4,432,24,108,48.180809,1,0
0,0,11,11,14,13,27,42,37,79,0.000333,0.125212,14,5258.905577,292.161421,375.636113,101.408685,2,0
0,0,9,9,13,11,24,37,35,72,0.000333,0.110039,18,5942.111401,330.1173,330.1173,86.159464,2,0
0,0,7,7,11,13,24,27,22,49,0.000333,0.074888,5,1123.315813,62.406434,224.663163,86.159464,2,0
0,0,5,5,10,11,21,22,20,42,0.000333,0.061492,5,922.386659,51.243703,184.477332,71.273029,2,0
0,0,5,5,10,8,18,21,18,39,0.000333,0.054209,10,1626.270751,90.348375,162.627075,57.219281,1,0
0,0,5,5,11,8,19,24,18,42,0.000333,0.059471,10,1784.129556,99.118309,178.412956,62.053748,1,0
0,0,5,5,11,8,19,22,18,40,0.000333,0.056639,10,1699.171005,94.398389,169.917101,62.053748,1,0
0,0,8,8,11,12,23,27,25,52,0.000333,0.078408,10,2352.252217,130.680679,235.225222,81.073298,1,0
0,0,6,6,10,10,20,25,23,48,0.000333,0.069151,10,2074.525486,115.251416,207.452549,66.438562,1,0
0,0,5,5,10,9,19,21,17,38,0.000333,0.053807,5,807.106228,44.839235,161.421246,61.748606,1,0
0,0,3,3,9,7,16,15,12,27,0.000333,0.036,4,432,24,108,48.180809,1,0
0,0,4,4,11,10,21,19,17,36,0.000333,0.052708,5,790.617136,43.923174,158.123427,71.273029,1,0
0,0,6,6,10,10,20,21,21,42,0.000333,0.060507,10,1815.2098,100.844989,181.52098,66.438562,1,0
0,0,6,6,10,10,20,25,23,48,0.000333,0.069151,10,2074.525486,115.251416,207.452549,66.438562,1,0
0,0,5,5,10,10,20,21,20,41,0.000333,0.059066,10,1771.990519,98.443918,177.199052,66.438562,1,0
0,0,6,6,10,11,21,24,25,49,0.000333,0.071741,10,2152.235537,119.568641,215.223554,71.273029,1,0
0,0,5,5,10,10,20,21,20,41,0.000333,0.059066,10,1771.990519,98.443918,177.199052,66.438562,1,0
0,0,5,5,10,9,19,21,17,38,0.000333,0.053807,5,807.106228,44.839235,161.421246,61.748606,1,0
0,0,4,4,9,9,18,18,15,33,0.000333,0.045869,4,550.4301,30.57945,137.607525,57.05865,1,0
0,0,7,7,11,11,22,31,26,57,0.000333,0.084729,10,2541.876023,141.215335,254.187602,76.107496,1,0
0,0,8,8,11,12,23,40,30,70,0.000333,0.10555,10,3166.493369,175.916298,316.649337,81.073298,1,0
0,0,4,4,10,10,20,18,17,35,0.000333,0.050422,5,756.337417,42.018745,151.267483,66.438562,1,0
0,0,11,11,10,14,24,44,37,81,0.000333,0.123794,10,3713.819626,206.323313,371.381963,86.52225,1,0
0,0,11,11,11,14,25,36,36,72,0.000333,0.111453,10,3343.576457,185.754248,334.357646,91.356717,1,0
0,0,4,4,10,12,22,18,19,37,0.000333,0.055,5,824.994849,45.833047,164.99897,76.238831,1,0
0,0,13,13,13,16,29,61,53,114,0.000333,0.184603,18,9968.577002,553.809833,553.809833,112.105716,1,0
0,0,13,13,13,15,28,51,44,95,0.000333,0.152233,12,5480.384611,304.465812,456.698718,106.709075,1,0
0,0,13,13,12,16,28,54,46,100,0.000333,0.160245,12,5768.825906,320.490328,480.735492,107.01955,1,0
0,0,3,3,11,8,19,25,16,41,0.000333,0.058055,10,1741.650281,96.758349,174.165028,62.053748,1,0
0,0,5,5,12,9,21,30,19,49,0.000333,0.071741,12,2582.682645,143.482369,215.223554,71.548875,2,0
0,0,7,7,13,12,25,35,21,56,0.000333,0.086685,6,1560.33568,86.685316,260.055947,91.125266,2,0
0,0,5,5,12,10,22,30,20,50,0.000333,0.074324,12,2675.658971,148.647721,222.971581,76.238831,2,0
0,0,7,7,14,12,26,36,22,58,0.000333,0.090875,7,1908.378526,106.021029,272.625504,96.322519,2,0
0,0,5,5,12,10,22,30,19,49,0.000333,0.072837,6,1311.072896,72.837383,218.512149,76.238831,2,0
0,0,7,7,13,12,25,35,21,56,0.000333,0.086685,6,1560.33568,86.685316,260.055947,91.125266,2,0
0,0,5,5,12,10,22,30,19,49,0.000333,0.072837,6,1311.072896,72.837383,218.512149,76.238831,2,0
0,0,7,7,13,12,25,35,21,56,0.000333,0.086685,6,1560.33568,86.685316,260.055947,91.125266,2,0
0,0,5,5,12,11,23,30,20,50,0.000333,0.075393,6,1357.068587,75.392699,226.178098,81.073298,2,0
0,0,7,7,14,13,27,36,22,58,0.000333,0.091928,7,1930.484326,107.249129,275.783475,101.408685,2,0
0,0,5,5,12,11,23,30,20,50,0.000333,0.075393,6,1357.068587,75.392699,226.178098,81.073298,2,0
0,0,7,7,14,13,27,36,22,58,0.000333,0.091928,7,1930.484326,107.249129,275.783475,101.408685,2,0
0,0,5,5,12,10,22,30,19,49,0.000333,0.072837,6,1311.072896,72.837383,218.512149,76.238831,2,0
0,0,7,7,13,12,25,35,21,56,0.000333,0.086685,6,1560.33568,86.685316,260.055947,91.125266,2,0
0,0,5,5,12,10,22,30,19,49,0.000333,0.072837,6,1311.072896,72.837383,218.512149,76.238831,2,0
0,0,7,7,13,12,25,35,21,56,0.000333,0.086685,6,1560.33568,86.685316,260.055947,91.125266,2,0
0,0,5,5,12,10,22,30,19,49,0.000333,0.072837,6,1311.072896,72.837383,218.512149,76.238831,2,0
0,0,6,6,13,10,23,31,19,50,0.000333,0.075393,6,1357.068587,75.392699,226.178098,81.324997,2,0
0,0,5,5,12,10,22,30,19,49,0.000333,0.072837,6,1311.072896,72.837383,218.512149,76.238831,2,0
0,0,7,7,13,12,25,35,21,56,0.000333,0.086685,6,1560.33568,86.685316,260.055947,91.125266,2,0
0,0,6,6,13,9,22,35,21,56,0.000333,0.083243,12,2996.738048,166.485447,249.728171,76.635041,2,0
0,0,5,5,12,11,23,30,20,50,0.000333,0.075393,6,1357.068587,75.392699,226.178098,81.073298,2,0
0,0,7,7,14,13,27,36,22,58,0.000333,0.091928,7,1930.484326,107.249129,275.783475,101.408685,2,0
0,0,5,5,12,11,23,30,20,50,0.000333,0.075393,6,1357.068587,75.392699,226.178098,81.073298,2,0
0,0,7,7,14,13,27,36,22,58,0.000333,0.091928,7,1930.484326,107.249129,275.783475,101.408685,2,0
0,0,8,8,15,13,28,38,22,60,0.000333,0.096147,7,2019.089067,112.171615,288.441295,106.709075,2,0
0,0,6,6,14,10,24,32,20,52,0.000333,0.079473,14,3337.852701,185.436261,238.41805,86.52225,2,0
0,0,5,5,12,9,21,30,19,49,0.000333,0.071741,12,2582.682645,143.482369,215.223554,71.548875,2,0
0,0,5,5,14,11,25,35,23,58,0.000333,0.089781,14,3770.811226,209.489513,269.343659,91.356717,2,0
0,0,3,3,11,8,19,25,16,41,0.000333,0.058055,10,1741.650281,96.758349,174.165028,62.053748,1,0
0,0,9,9,14,12,26,57,43,100,0.000333,0.156681,21,9870.923408,548.384634,470.043972,96.322519,2,0
0,0,11,11,15,14,29,62,45,107,0.000333,0.173268,21,10915.8833,606.437961,519.803966,111.906328,2,0
0,0,7,7,13,14,27,37,26,63,0.000333,0.099853,6,1797.347476,99.852638,299.557913,101.408685,2,0
0,0,9,9,13,12,25,56,43,99,0.000333,0.153247,18,8275.35173,459.741763,459.741763,91.125266,2,0
0,0,5,5,11,9,20,31,22,53,0.000333,0.076354,10,2290.62189,127.256772,229.062189,66.583073,1,0
0,0,5,5,12,9,21,34,22,56,0.000333,0.08199,12,2951.637308,163.97985,245.969776,71.548875,1,0
0,0,5,5,12,9,21,32,22,54,0.000333,0.079062,12,2846.22169,158.123427,237.185141,71.548875,1,0
0,0,8,8,12,13,25,37,29,66,0.000333,0.102165,12,3677.934102,204.329672,306.494509,91.125266,1,0
0,0,4,4,11,10,21,26,19,45,0.000333,0.065885,5,988.27142,54.903968,197.654284,71.273029,1,0
0,0,4,4,11,10,21,29,20,49,0.000333,0.071741,10,2152.235537,119.568641,215.223554,71.273029,1,0
0,0,3,3,11,8,19,25,16,41,0.000333,0.058055,10,1741.650281,96.758349,174.165028,62.053748,1,0
0,0,4,4,12,11,23,29,21,50,0.000333,0.075393,6,1357.068587,75.392699,226.178098,81.073298,1,0
0,0,6,6,11,11,22,31,25,56,0.000333,0.083243,10,2497.281706,138.737873,249.728171,76.107496,1,0
0,0,4,4,11,10,21,28,19,47,0.000333,0.068813,5,1032.194594,57.344144,206.438919,71.273029,1,0
0,0,4,4,11,11,22,28,21,49,0.000333,0.072837,5,1092.560747,60.697819,218.512149,76.107496,1,0
0,0,4,4,11,11,22,28,21,49,0.000333,0.072837,5,1092.560747,60.697819,218.512149,76.107496,1,0
0,0,4,4,11,11,22,28,21,49,0.000333,0.072837,5,1092.560747,60.697819,218.512149,76.107496,1,0
0,0,5,5,12,10,22,31,21,52,0.000333,0.077297,12,2782.68533,154.593629,231.890444,76.238831,1,0
0,0,4,4,11,10,21,28,19,47,0.000333,0.068813,5,1032.194594,57.344144,206.438919,71.273029,1,0
0,0,4,4,12,10,22,29,19,48,0.000333,0.071351,6,1284.316306,71.350906,214.052718,76.238831,1,0
0,0,4,4,12,10,22,29,19,48,0.000333,0.071351,6,1284.316306,71.350906,214.052718,76.238831,1,0
0,0,4,4,11,11,22,28,21,49,0.000333,0.072837,5,1092.560747,60.697819,218.512149,76.107496,1,0
0,0,11,11,11,15,26,64,45,109,0.000333,0.170783,15,7685.218939,426.956608,512.347929,96.657107,1,0
0,0,9,9,12,14,26,38,30,68,0.000333,0.106543,12,3835.55881,213.086601,319.629901,96.322519,1,0
0,0,4,4,11,12,23,28,22,50,0.000333,0.075393,5,1130.890489,62.827249,226.178098,81.073298,1,0
0,0,11,11,14,16,30,77,57,134,0.000333,0.219174,21,13807.99014,767.110563,657.52334,117.302969,1,0
0,0,11,11,14,15,29,67,48,115,0.000333,0.186223,21,11732.0241,651.779117,558.667814,111.906328,1,0
0,0,13,13,13,17,30,74,54,128,0.000333,0.209361,18,11305.47593,628.081996,628.081996,117.592585,1,0
0,0,3,3,11,8,19,25,16,41,0.000333,0.058055,10,1741.650281,96.758349,174.165028,62.053748,1,0
0,0,5,5,12,9,21,30,19,49,0.000333,0.071741,12,2582.682645,143.482369,215.223554,71.548875,2,0
0,0,7,7,13,12,25,35,21,56,0.000333,0.086685,6,1560.33568,86.685316,260.055947,91.125266,2,0
0,0,5,5,12,10,22,30,20,50,0.000333,0.074324,12,2675.658971,148.647721,222.971581,76.238831,2,0
0,0,7,7,14,12,26,36,22,58,0.000333,0.090875,7,1908.378526,106.021029,272.625504,96.322519,2,0
0,0,7,7,13,12,25,35,21,56,0.000333,0.086685,6,1560.33568,86.685316,260.055947,91.125266,2,0
0,0,5,5,12,10,22,30,19,49,0.000333,0.072837,6,1311.072896,72.837383,218.512149,76.238831,2,0
0,0,7,7,13,12,25,35,21,56,0.000333,0.086685,6,1560.33568,86.685316,260.055947,91.125266,2,0
0,0,5,5,12,10,22,30,19,49,0.000333,0.072837,6,1311.072896,72.837383,218.512149,76.238831,2,0
0,0,5,5,12,11,23,30,20,50,0.000333,0.075393,6,1357.068587,75.392699,226.178098,81.073298,2,0
0,0,7,7,14,13,27,36,22,58,0.000333,0.091928,7,1930.484326,107.249129,275.783475,101.408685,2,0
0,0,5,5,12,11,23,30,20,50,0.000333,0.075393,6,1357.068587,75.392699,226.178098,81.073298,2,0
0,0,7,7,14,13,27,36,22,58,0.000333,0.091928,7,1930.484326,107.249129,275.783475,101.408685,2,0
0,0,5,5,12,10,22,30,19,49,0.000333,0.072837,6,1311.072896,72.837383,218.512149,76.238831,2,0
0,0,7,7,13,12,25,35,21,56,0.000333,0.086685,6,1560.33568,86.685316,260.055947,91.125266,2,0
0,0,5,5,12,10,22,30,19,49,0.000333,0.072837,6,1311.072896,72.837383,218.512149,76.238831,2,0
0,0,7,7,13,12,25,35,21,56,0.000333,0.086685,6,1560.33568,86.685316,260.055947,91.125266,2,0
0,0,5,5,12,10,22,30,19,49,0.000333,0.072837,6,1311.072896,72.837383,218.512149,76.238831,2,0
0,0,7,7,13,12,25,35,21,56,0.000333,0.086685,6,1560.33568,86.685316,260.055947,91.125266,2,0
0,0,5,5,12,10,22,30,19,49,0.000333,0.072837,6,1311.072896,72.837383,218.512149,76.238831,2,0
0,0,7,7,13,12,25,35,21,56,0.000333,0.086685,6,1560.33568,86.685316,260.055947,91.125266,2,0
0,0,6,6,13,9,22,35,21,56,0.000333,0.083243,12,2996.738048,166.485447,249.728171,76.635041,2,0
0,0,5,5,12,11,23,30,20,50,0.000333,0.075393,6,1357.068587,75.392699,226.178098,81.073298,2,0
0,0,7,7,14,13,27,36,22,58,0.000333,0.091928,7,1930.484326,107.249129,275.783475,101.408685,2,0
0,0,5,5,12,11,23,30,20,50,0.000333,0.075393,6,1357.068587,75.392699,226.178098,81.073298,2,0
0,0,7,7,14,13,27,36,22,58,0.000333,0.091928,7,1930.484326,107.249129,275.783475,101.408685,2,0
0,0,8,8,15,13,28,38,22,60,0.000333,0.096147,7,2019.089067,112.171615,288.441295,106.709075,2,0
0,0,6,6,14,10,24,32,20,52,0.000333,0.079473,14,3337.852701,185.436261,238.41805,86.52225,2,0
0,0,5,5,12,9,21,30,19,49,0.000333,0.071741,12,2582.682645,143.482369,215.223554,71.548875,2,0
0,0,5,5,14,11,25,35,23,58,0.000333,0.089781,14,3770.811226,209.489513,269.343659,91.356717,2,0
0,0,3,3,11,8,19,25,16,41,0.000333,0.058055,10,1741.650281,96.758349,174.165028,62.053748,1,0
0,0,6,6,12,12,24,33,24,57,0.000333,0.087114,12,3136.11435,174.228575,261.342863,86.0391,1,0
0,0,10,10,13,12,25,58,43,101,0.000333,0.156343,18,8442.530553,469.029475,469.029475,91.125266,1,0
0,0,6,6,12,14,26,31,22,53,0.000333,0.083041,6,1494.73983,83.041102,249.123305,96.322519,2,0
0,0,5,5,12,12,24,32,24,56,0.000333,0.085586,12,3081.0948,171.171933,256.7579,86.0391,2,0
0,0,5,5,11,9,20,31,22,53,0.000333,0.076354,10,2290.62189,127.256772,229.062189,66.583073,1,0
0,0,5,5,12,9,21,34,22,56,0.000333,0.08199,12,2951.637308,163.97985,245.969776,71.548875,1,0
0,0,5,5,12,9,21,32,22,54,0.000333,0.079062,12,2846.22169,158.123427,237.185141,71.548875,1,0
0,0,8,8,12,13,25,37,29,66,0.000333,0.102165,12,3677.934102,204.329672,306.494509,91.125266,1,0
0,0,4,4,11,10,21,26,19,45,0.000333,0.065885,5,988.27142,54.903968,197.654284,71.273029,1,0
0,0,5,5,12,10,22,31,21,52,0.000333,0.077297,12,2782.68533,154.593629,231.890444,76.238831,1,0
0,0,6,6,11,10,21,29,21,50,0.000333,0.073205,10,2196.158711,122.008817,219.615871,71.273029,1,0
0,0,6,6,11,10,21,29,21,50,0.000333,0.073205,10,2196.158711,122.008817,219.615871,71.273029,1,0
0,0,6,6,11,10,21,29,21,50,0.000333,0.073205,10,2196.158711,122.008817,219.615871,71.273029,1,0
0,0,6,6,11,10,21,29,21,50,0.000333,0.073205,10,2196.158711,122.008817,219.615871,71.273029,1,0
0,0,6,6,11,10,21,29,21,50,0.000333,0.073205,10,2196.158711,122.008817,219.615871,71.273029,1,0
0,0,6,6,11,10,21,29,21,50,0.000333,0.073205,10,2196.158711,122.008817,219.615871,71.273029,1,0
0,0,6,6,11,10,21,29,21,50,0.000333,0.073205,10,2196.158711,122.008817,219.615871,71.273029,1,0
0,0,6,6,11,10,21,29,21,50,0.000333,0.073205,10,2196.158711,122.008817,219.615871,71.273029,1,0
0,0,6,6,11,10,21,29,21,50,0.000333,0.073205,10,2196.158711,122.008817,219.615871,71.273029,1,0
0,0,6,6,11,10,21,29,21,50,0.000333,0.073205,10,2196.158711,122.008817,219.615871,71.273029,1,0
0,0,6,6,11,10,21,29,21,50,0.000333,0.073205,10,2196.158711,122.008817,219.615871,71.273029,1,0
0,0,6,6,11,10,21,29,21,50,0.000333,0.073205,10,2196.158711,122.008817,219.615871,71.273029,1,0
0,0,6,6,11,10,21,29,21,50,0.000333,0.073205,10,2196.158711,122.008817,219.615871,71.273029,1,0
0,0,6,6,11,10,21,29,21,50,0.000333,0.073205,10,2196.158711,122.008817,219.615871,71.273029,1,0
0,0,6,6,11,10,21,29,21,50,0.000333,0.073205,10,2196.158711,122.008817,219.615871,71.273029,1,0
0,0,8,8,12,9,21,34,30,64,0.000333,0.093703,18,5059.949671,281.108315,281.108315,71.548875,1,0
0,0,8,8,11,9,20,33,30,63,0.000333,0.09076,15,4084.22205,226.901225,272.28147,66.583073,1,0
0,0,7,7,11,10,21,33,25,58,0.000333,0.084918,10,2547.544105,141.530228,254.754411,71.273029,1,0
0,0,7,7,12,11,23,36,25,61,0.000333,0.091979,12,3311.247352,183.958186,275.937279,81.073298,1,0
0,0,7,7,12,11,23,34,25,59,0.000333,0.088963,12,3202.681865,177.92677,266.890155,81.073298,1,0
0,0,9,9,11,14,25,37,30,67,0.000333,0.103713,10,3111.383647,172.854647,311.138365,91.356717,1,0
0,0,6,6,10,9,19,25,21,46,0.000333,0.065135,10,1954.046656,108.558148,195.404666,61.748606,1,0
0,0,9,9,12,12,24,39,30,69,0.000333,0.105454,12,3796.348951,210.908275,316.362413,86.0391,1,0
0,0,7,7,12,10,22,30,24,54,0.000333,0.08027,12,2889.711689,160.539538,240.809307,76.238831,1,0
0,0,9,9,12,14,26,44,33,77,0.000333,0.120645,12,4343.2063,241.289239,361.933858,96.322519,1,0
0,0,10,10,12,15,27,36,32,68,0.000333,0.107777,12,3879.988202,215.5549,323.33235,101.622909,1,0
0,0,6,6,10,9,19,25,21,46,0.000333,0.065135,10,1954.046656,108.558148,195.404666,61.748606,1,0
0,0,8,8,11,14,25,35,29,64,0.000333,0.099069,10,2972.067961,165.114887,297.206796,91.356717,1,0
0,0,8,8,11,14,25,35,29,64,0.000333,0.099069,10,2972.067961,165.114887,297.206796,91.356717,1,0
0,0,8,8,11,14,25,35,29,64,0.000333,0.099069,10,2972.067961,165.114887,297.206796,91.356717,1,0
0,0,10,10,12,12,24,43,35,78,0.000333,0.119209,12,4291.524901,238.41805,357.627075,86.0391,1,0
0,0,9,9,12,13,25,39,32,71,0.000333,0.109905,12,3956.565474,219.809193,329.713789,91.125266,1,0
0,0,9,9,12,14,26,41,32,73,0.000333,0.114377,12,4117.585193,228.754733,343.132099,96.322519,1,0
0,0,10,10,12,15,27,50,36,86,0.000333,0.136307,12,4907.043902,272.61355,408.920325,101.622909,1,0
0,0,9,9,11,14,25,43,33,76,0.000333,0.117644,10,3529.330704,196.073928,352.93307,91.356717,1,0
0,0,10,10,11,15,26,43,33,76,0.000333,0.119078,10,3572.334186,198.46301,357.233419,96.657107,1,0
0,0,10,10,11,16,27,39,34,73,0.000333,0.115702,10,3471.067877,192.837104,347.106788,102.053748,1,0
0,0,10,10,11,18,29,36,39,75,0.000333,0.12145,10,3643.485746,202.415875,364.348575,113.112398,1,0
0,0,12,12,13,18,31,66,53,119,0.000333,0.196516,12,7074.592331,393.032907,589.549361,123.164366,1,0
0,0,13,13,13,16,29,64,49,113,0.000333,0.182984,18,9881.133344,548.951852,548.951852,112.105716,1,0
0,0,13,13,13,18,31,60,48,108,0.000333,0.178351,12,6420.638418,356.702134,535.053202,123.164366,1,0
0,0,6,6,11,10,21,29,21,50,0.000333,0.073205,10,2196.158711,122.008817,219.615871,71.273029,1,0
0,0,6,6,11,10,21,29,21,50,0.000333,0.073205,10,2196.158711,122.008817,219.615871,71.273029,1,0
0,0,6,6,11,10,21,29,21,50,0.000333,0.073205,10,2196.158711,122.008817,219.615871,71.273029,1,0
0,0,6,6,11,10,21,29,21,50,0.000333,0.073205,10,2196.158711,122.008817,219.615871,71.273029,1,0
0,0,6,6,11,10,21,29,21,50,0.000333,0.073205,10,2196.158711,122.008817,219.615871,71.273029,1,0
0,0,6,6,11,10,21,29,21,50,0.000333,0.073205,10,2196.158711,122.008817,219.615871,71.273029,1,0
0,0,6,6,11,10,21,29,21,50,0.000333,0.073205,10,2196.158711,122.008817,219.615871,71.273029,1,0
0,0,6,6,11,10,21,29,21,50,0.000333,0.073205,10,2196.158711,122.008817,219.615871,71.273029,1,0
0,0,6,6,11,10,21,29,21,50,0.000333,0.073205,10,2196.158711,122.008817,219.615871,71.273029,1,0
0,0,6,6,11,10,21,29,21,50,0.000333,0.073205,10,2196.158711,122.008817,219.615871,71.273029,1,0
0,0,6,6,11,10,21,29,21,50,0.000333,0.073205,10,2196.158711,122.008817,219.615871,71.273029,1,0
0,0,6,6,11,10,21,29,21,50,0.000333,0.073205,10,2196.158711,122.008817,219.615871,71.273029,1,0
0,0,6,6,11,10,21,29,21,50,0.000333,0.073205,10,2196.158711,122.008817,219.615871,71.273029,1,0
0,0,6,6,11,10,21,29,21,50,0.000333,0.073205,10,2196.158711,122.008817,219.615871,71.273029,1,0
0,0,6,6,11,10,21,29,21,50,0.000333,0.073205,10,2196.158711,122.008817,219.615871,71.273029,1,0
0,0,6,6,11,10,21,29,21,50,0.000333,0.073205,10,2196.158711,122.008817,219.615871,71.273029,1,0
0,0,6,6,11,10,21,29,21,50,0.000333,0.073205,10,2196.158711,122.008817,219.615871,71.273029,1,0
0,0,6,6,11,10,21,29,21,50,0.000333,0.073205,10,2196.158711,122.008817,219.615871,71.273029,1,0
0,0,10,10,13,13,26,44,38,82,0.000333,0.128479,12,4625.232683,256.957371,385.436057,96.211433,1,0
0,0,10,10,12,13,25,43,38,81,0.000333,0.125384,12,4513.828216,250.768234,376.152351,91.125266,1,0
0,0,8,8,11,11,22,35,27,62,0.000333,0.092162,10,2764.847604,153.602645,276.48476,76.107496,1,0
0,0,8,8,12,11,23,38,27,65,0.000333,0.098011,12,3528.378326,196.021018,294.031527,81.073298,1,0
0,0,8,8,12,11,23,36,27,63,0.000333,0.094995,12,3419.812839,189.989602,284.984403,81.073298,1,0
0,0,8,8,11,13,24,34,27,61,0.000333,0.093228,10,2796.827125,155.379285,279.682713,86.159464,1,0
0,0,8,8,11,13,24,35,29,64,0.000333,0.097813,10,2934.376,163.020889,293.4376,86.159464,1,0
0,0,10,10,13,12,25,44,35,79,0.000333,0.122288,12,4402.375668,244.576426,366.864639,91.125266,1,0
0,0,10,10,13,12,25,44,35,79,0.000333,0.122288,12,4402.375668,244.576426,366.864639,91.125266,1,0
0,0,9,9,12,14,26,44,33,77,0.000333,0.120645,12,4343.2063,241.289239,361.933858,96.322519,1,0
0,0,9,9,12,13,25,34,31,65,0.000333,0.100617,12,3622.207828,201.233768,301.850652,91.125266,1,0
0,0,8,8,11,13,24,35,29,64,0.000333,0.097813,10,2934.376,163.020889,293.4376,86.159464,1,0
0,0,8,8,11,14,25,35,29,64,0.000333,0.099069,10,2972.067961,165.114887,297.206796,91.356717,1,0
0,0,8,8,11,14,25,35,29,64,0.000333,0.099069,10,2972.067961,165.114887,297.206796,91.356717,1,0
0,0,8,8,11,14,25,35,29,64,0.000333,0.099069,10,2972.067961,165.114887,297.206796,91.356717,1,0
0,0,10,10,12,12,24,43,35,78,0.000333,0.119209,12,4291.524901,238.41805,357.627075,86.0391,1,0
0,0,9,9,12,14,26,40,32,72,0.000333,0.112811,12,4061.179916,225.621106,338.43166,96.322519,1,0
0,0,8,8,12,13,25,39,30,69,0.000333,0.106809,12,3845.112925,213.617385,320.426077,91.125266,1,0
0,0,10,10,12,15,27,50,36,86,0.000333,0.136307,12,4907.043902,272.61355,408.920325,101.622909,1,0
0,0,9,9,11,14,25,43,33,76,0.000333,0.117644,10,3529.330704,196.073928,352.93307,91.356717,1,0
0,0,11,11,11,16,27,50,39,89,0.000333,0.141062,10,4231.849877,235.102771,423.184988,102.053748,1,0
0,0,11,11,11,16,27,42,38,80,0.000333,0.126797,10,3803.910002,211.328333,380.391,102.053748,1,0
0,0,10,10,11,18,29,35,39,74,0.000333,0.11983,10,3594.905936,199.716996,359.490594,113.112398,1,0
0,0,12,12,13,18,31,65,53,118,0.000333,0.194865,12,7015.141976,389.73011,584.595165,123.164366,1,0
0,0,13,13,13,17,30,57,46,103,0.000333,0.16847,12,6064.916776,336.939821,505.409731,117.592585,1,0
0,0,13,13,13,18,31,60,48,108,0.000333,0.178351,12,6420.638418,356.702134,535.053202,123.164366,1,0
0,0,5,5,12,8,20,24,20,44,0.000333,0.063388,12,2281.978034,126.776557,190.164836,67.01955,1,0
0,0,5,5,12,8,20,24,20,44,0.000333,0.063388,12,2281.978034,126.776557,190.164836,67.01955,1,0
0,0,5,5,12,8,20,24,20,44,0.000333,0.063388,12,2281.978034,126.776557,190.164836,67.01955,1,0
0,0,5,5,12,8,20,24,20,44,0.000333,0.063388,12,2281.978034,126.776557,190.164836,67.01955,1,0
0,0,5,5,12,8,20,24,20,44,0.000333,0.063388,12,2281.978034,126.776557,190.164836,67.01955,1,0
0,0,5,5,12,8,20,24,20,44,0.000333,0.063388,12,2281.978034,126.776557,190.164836,67.01955,1,0
0,0,5,5,12,8,20,24,20,44,0.000333,0.063388,12,2281.978034,126.776557,190.164836,67.01955,1,0
0,0,5,5,12,8,20,24,20,44,0.000333,0.063388,12,2281.978034,126.776557,190.164836,67.01955,1,0
0,0,5,5,12,8,20,24,20,44,0.000333,0.063388,12,2281.978034,126.776557,190.164836,67.01955,1,0
0,0,5,5,12,8,20,24,20,44,0.000333,0.063388,12,2281.978034,126.776557,190.164836,67.01955,1,0
0,0,5,5,12,8,20,24,20,44,0.000333,0.063388,12,2281.978034,126.776557,190.164836,67.01955,1,0
0,0,5,5,12,8,20,24,20,44,0.000333,0.063388,12,2281.978034,126.776557,190.164836,67.01955,1,0
0,0,5,5,12,8,20,24,20,44,0.000333,0.063388,12,2281.978034,126.776557,190.164836,67.01955,1,0
0,0,5,5,12,8,20,24,20,44,0.000333,0.063388,12,2281.978034,126.776557,190.164836,67.01955,1,0
0,0,5,5,12,8,20,24,20,44,0.000333,0.063388,12,2281.978034,126.776557,190.164836,67.01955,1,0
0,0,5,5,12,8,20,24,20,44,0.000333,0.063388,12,2281.978034,126.776557,190.164836,67.01955,1,0
0,0,5,5,12,8,20,24,20,44,0.000333,0.063388,12,2281.978034,126.776557,190.164836,67.01955,1,0
0,0,5,5,12,8,20,24,20,44,0.000333,0.063388,12,2281.978034,126.776557,190.164836,67.01955,1,0
0,0,8,8,14,11,25,37,36,73,0.000333,0.113001,21,7119.031539,395.501752,339.001502,91.356717,1,0
0,0,9,9,13,13,26,38,40,78,0.000333,0.122211,18,6599.417364,366.634298,366.634298,96.211433,1,0
0,0,6,6,12,9,21,28,25,53,0.000333,0.077598,12,2793.513881,155.195216,232.792823,71.548875,1,0
0,0,6,6,13,9,22,31,25,56,0.000333,0.083243,12,2996.738048,166.485447,249.728171,76.635041,1,0
0,0,6,6,13,9,22,29,25,54,0.000333,0.08027,12,2889.711689,160.539538,240.809307,76.635041,1,0
0,0,7,7,13,12,25,30,27,57,0.000333,0.088233,12,3176.397634,176.466535,264.699803,91.125266,1,0
0,0,6,6,12,11,23,28,26,54,0.000333,0.081424,12,2931.268148,162.84823,244.272346,81.073298,1,0
0,0,9,9,14,11,25,41,37,78,0.000333,0.12074,21,7606.636439,422.590913,362.220783,91.356717,1,0
0,0,6,6,13,11,24,29,26,55,0.000333,0.084058,12,3026.07525,168.115292,252.172938,86.159464,1,0
0,0,7,7,13,12,25,37,31,68,0.000333,0.105261,12,3789.386651,210.521481,315.782221,91.125266,1,0
0,0,8,8,13,12,25,29,30,59,0.000333,0.091329,12,3287.850182,182.658343,273.987515,91.125266,1,0
0,0,6,6,12,11,23,28,26,54,0.000333,0.081424,12,2931.268148,162.84823,244.272346,81.073298,1,0
0,0,6,6,12,12,24,28,26,54,0.000333,0.082529,12,2971.0557,165.05865,247.587975,86.0391,1,0
0,0,6,6,12,12,24,28,26,54,0.000333,0.082529,12,2971.0557,165.05865,247.587975,86.0391,1,0
0,0,6,6,12,12,24,28,26,54,0.000333,0.082529,12,2971.0557,165.05865,247.587975,86.0391,1,0
0,0,8,8,13,12,25,36,33,69,0.000333,0.106809,12,3845.112925,213.617385,320.426077,91.125266,1,0
0,0,7,7,13,11,24,35,30,65,0.000333,0.099341,12,3576.270751,198.681708,298.022563,86.159464,1,0
0,0,7,7,13,12,25,34,30,64,0.000333,0.099069,12,3566.481554,198.137864,297.206796,91.125266,1,0
0,0,8,8,13,13,26,43,35,78,0.000333,0.122211,12,4399.611576,244.422865,366.634298,96.211433,1,0
0,0,7,7,12,12,24,36,31,67,0.000333,0.102397,12,3686.309851,204.794992,307.192488,86.0391,1,0
0,0,9,9,12,14,26,43,38,81,0.000333,0.126912,12,4568.827406,253.823745,380.735617,96.322519,1,0
0,0,9,9,13,14,27,35,35,70,0.000333,0.110947,12,3994.105502,221.89475,332.842125,101.408685,1,0
0,0,8,8,12,17,29,29,38,67,0.000333,0.108495,12,3905.81672,216.989818,325.484727,112.506418,1,0
0,0,10,10,15,16,31,58,52,110,0.000333,0.181654,21,11444.19348,635.788526,544.961594,122.603359,1,0
0,0,11,11,15,15,30,50,45,95,0.000333,0.155385,21,9789.246738,543.847041,466.154607,117.206718,1,0
0,0,11,11,14,16,30,53,47,100,0.000333,0.163563,14,6869.646834,381.647046,490.68906,117.302969,1,0
0,0,5,5,12,8,20,24,20,44,0.000333,0.063388,12,2281.978034,126.776557,190.164836,67.01955,1,0
0,0,5,5,12,8,20,24,20,44,0.000333,0.063388,12,2281.978034,126.776557,190.164836,67.01955,1,0
0,0,5,5,12,8,20,24,20,44,0.000333,0.063388,12,2281.978034,126.776557,190.164836,67.01955,1,0
0,0,5,5,12,8,20,24,20,44,0.000333,0.063388,12,2281.978034,126.776557,190.164836,67.01955,1,0
0,0,5,5,12,8,20,24,20,44,0.000333,0.063388,12,2281.978034,126.776557,190.164836,67.01955,1,0
0,0,5,5,12,8,20,24,20,44,0.000333,0.063388,12,2281.978034,126.776557,190.164836,67.01955,1,0
0,0,5,5,12,8,20,24,20,44,0.000333,0.063388,12,2281.978034,126.776557,190.164836,67.01955,1,0
0,0,5,5,12,8,20,24,20,44,0.000333,0.063388,12,2281.978034,126.776557,190.164836,67.01955,1,0
0,0,5,5,12,8,20,24,20,44,0.000333,0.063388,12,2281.978034,126.776557,190.164836,67.01955,1,0
0,0,5,5,12,8,20,24,20,44,0.000333,0.063388,12,2281.978034,126.776557,190.164836,67.01955,1,0
0,0,5,5,12,8,20,24,20,44,0.000333,0.063388,12,2281.978034,126.776557,190.164836,67.01955,1,0
0,0,5,5,12,8,20,24,20,44,0.000333,0.063388,12,2281.978034,126.776557,190.164836,67.01955,1,0
0,0,5,5,12,8,20,24,20,44,0.000333,0.063388,12,2281.978034,126.776557,190.164836,67.01955,1,0
0,0,4,4,12,8,20,22,17,39,0.000333,0.056185,12,2022.662348,112.37013,168.555196,67.01955,1,0
0,0,5,5,12,8,20,24,20,44,0.000333,0.063388,12,2281.978034,126.776557,190.164836,67.01955,1,0
0,0,5,5,12,8,20,24,20,44,0.000333,0.063388,12,2281.978034,126.776557,190.164836,67.01955,1,0
0,0,5,5,12,8,20,24,20,44,0.000333,0.063388,12,2281.978034,126.776557,190.164836,67.01955,1,0
0,0,5,5,12,8,20,24,20,44,0.000333,0.063388,12,2281.978034,126.776557,190.164836,67.01955,1,0
0,0,8,8,13,11,24,36,36,72,0.000333,0.110039,18,5942.111401,330.1173,330.1173,86.159464,1,0
0,0,9,9,13,13,26,38,38,76,0.000333,0.119078,12,4286.801023,238.155612,357.233419,96.211433,1,0
0,0,6,6,12,9,21,28,25,53,0.000333,0.077598,12,2793.513881,155.195216,232.792823,71.548875,1,0
0,0,6,6,13,9,22,31,25,56,0.000333,0.083243,12,2996.738048,166.485447,249.728171,76.635041,1,0
0,0,6,6,13,9,22,29,25,54,0.000333,0.08027,12,2889.711689,160.539538,240.809307,76.635041,1,0
0,0,7,7,13,12,25,30,27,57,0.000333,0.088233,12,3176.397634,176.466535,264.699803,91.125266,1,0
0,0,6,6,12,11,23,28,26,54,0.000333,0.081424,12,2931.268148,162.84823,244.272346,81.073298,1,0
0,0,8,8,14,10,24,37,33,70,0.000333,0.106982,21,6739.894876,374.438604,320.947375,86.52225,1,0
0,0,7,7,13,11,24,32,29,61,0.000333,0.093228,12,3356.192551,186.455142,279.682713,86.159464,1,0
0,0,7,7,13,12,25,37,31,68,0.000333,0.105261,12,3789.386651,210.521481,315.782221,91.125266,1,0
0,0,7,7,12,11,23,28,27,55,0.000333,0.082932,12,2985.550891,165.863938,248.795908,81.073298,1,0
0,0,6,6,12,11,23,28,26,54,0.000333,0.081424,12,2931.268148,162.84823,244.272346,81.073298,1,0
0,0,6,6,12,12,24,28,26,54,0.000333,0.082529,12,2971.0557,165.05865,247.587975,86.0391,1,0
0,0,6,6,12,12,24,28,26,54,0.000333,0.082529,12,2971.0557,165.05865,247.587975,86.0391,1,0
0,0,6,6,12,12,24,28,26,54,0.000333,0.082529,12,2971.0557,165.05865,247.587975,86.0391,1,0
0,0,8,8,13,10,23,36,33,69,0.000333,0.104042,18,5618.263949,312.125775,312.125775,81.324997,1,0
0,0,6,6,13,11,24,28,26,54,0.000333,0.082529,12,2971.0557,165.05865,247.587975,86.159464,1,0
0,0,7,7,13,12,25,34,30,64,0.000333,0.099069,12,3566.481554,198.137864,297.206796,91.125266,1,0
0,0,8,8,13,13,26,43,35,78,0.000333,0.122211,12,4399.611576,244.422865,366.634298,96.211433,1,0
0,0,7,7,12,12,24,36,31,67,0.000333,0.102397,12,3686.309851,204.794992,307.192488,86.0391,1,0
0,0,9,9,12,14,26,43,38,81,0.000333,0.126912,12,4568.827406,253.823745,380.735617,96.322519,1,0
0,0,9,9,13,14,27,35,35,70,0.000333,0.110947,12,3994.105502,221.89475,332.842125,101.408685,1,0
0,0,8,8,12,17,29,28,38,66,0.000333,0.106876,12,3847.520948,213.751164,320.626746,112.506418,1,0
0,0,10,10,15,16,31,58,52,110,0.000333,0.181654,21,11444.19348,635.788526,544.961594,122.603359,1,0
0,0,10,10,15,14,29,48,43,91,0.000333,0.147359,21,9283.601682,515.755649,442.076271,111.906328,1,0
0,0,11,11,14,16,30,53,47,100,0.000333,0.163563,14,6869.646834,381.647046,490.68906,117.302969,1,0
0,0,4,4,12,7,19,22,14,36,0.000333,0.050975,12,1835.104686,101.95026,152.92539,62.671034,1,0
0,0,4,4,12,7,19,22,14,36,0.000333,0.050975,12,1835.104686,101.95026,152.92539,62.671034,1,0
0,0,4,4,12,7,19,22,14,36,0.000333,0.050975,12,1835.104686,101.95026,152.92539,62.671034,1,0
0,0,4,4,12,7,19,22,14,36,0.000333,0.050975,12,1835.104686,101.95026,152.92539,62.671034,1,0
0,0,4,4,12,7,19,22,14,36,0.000333,0.050975,12,1835.104686,101.95026,152.92539,62.671034,1,0
0,0,4,4,12,7,19,22,14,36,0.000333,0.050975,12,1835.104686,101.95026,152.92539,62.671034,1,0
0,0,4,4,12,7,19,22,14,36,0.000333,0.050975,12,1835.104686,101.95026,152.92539,62.671034,1,0
0,0,4,4,12,7,19,22,14,36,0.000333,0.050975,12,1835.104686,101.95026,152.92539,62.671034,1,0
0,0,4,4,12,7,19,22,14,36,0.000333,0.050975,12,1835.104686,101.95026,152.92539,62.671034,1,0
0,0,4,4,12,7,19,22,14,36,0.000333,0.050975,12,1835.104686,101.95026,152.92539,62.671034,1,0
0,0,4,4,12,7,19,22,14,36,0.000333,0.050975,12,1835.104686,101.95026,152.92539,62.671034,1,0
0,0,4,4,12,7,19,22,14,36,0.000333,0.050975,12,1835.104686,101.95026,152.92539,62.671034,1,0
0,0,4,4,12,7,19,22,14,36,0.000333,0.050975,12,1835.104686,101.95026,152.92539,62.671034,1,0
0,0,4,4,12,7,19,22,14,36,0.000333,0.050975,12,1835.104686,101.95026,152.92539,62.671034,1,0
0,0,4,4,12,7,19,22,14,36,0.000333,0.050975,12,1835.104686,101.95026,152.92539,62.671034,1,0
0,0,4,4,12,7,19,22,14,36,0.000333,0.050975,12,1835.104686,101.95026,152.92539,62.671034,1,0
0,0,4,4,12,7,19,22,14,36,0.000333,0.050975,12,1835.104686,101.95026,152.92539,62.671034,1,0
0,0,4,4,12,7,19,22,14,36,0.000333,0.050975,12,1835.104686,101.95026,152.92539,62.671034,1,0
0,0,8,8,14,10,24,37,31,68,0.000333,0.103926,21,6547.326451,363.740358,311.77745,86.52225,1,0
0,0,8,8,13,11,24,36,31,67,0.000333,0.102397,12,3686.309851,204.794992,307.192488,86.159464,1,0
0,0,6,6,12,8,20,28,20,48,0.000333,0.069151,12,2489.430583,138.301699,207.452549,67.01955,1,0
0,0,6,6,13,8,21,31,20,51,0.000333,0.074669,12,2688.098263,149.338792,224.008189,72.105716,1,0
0,0,6,6,13,8,21,29,20,49,0.000333,0.071741,12,2582.682645,143.482369,215.223554,72.105716,1,0
0,0,7,7,13,11,24,30,23,53,0.000333,0.081001,12,2916.03615,162.002008,243.003013,86.159464,1,0
0,0,6,6,12,10,22,28,22,50,0.000333,0.074324,12,2675.658971,148.647721,222.971581,76.238831,1,0
0,0,8,8,14,9,23,37,28,65,0.000333,0.098011,21,6174.66207,343.036782,294.031527,81.832294,1,0
0,0,6,6,12,9,21,28,20,48,0.000333,0.070277,12,2529.974836,140.554158,210.831236,71.548875,1,0
0,0,7,7,13,11,24,37,26,63,0.000333,0.096284,12,3466.231651,192.568425,288.852638,86.159464,1,0
0,0,7,7,13,11,24,29,24,53,0.000333,0.081001,12,2916.03615,162.002008,243.003013,86.159464,1,0
0,0,6,6,12,10,22,28,22,50,0.000333,0.074324,12,2675.658971,148.647721,222.971581,76.238831,1,0
0,0,6,6,12,11,23,28,22,50,0.000333,0.075393,12,2714.137174,150.785399,226.178098,81.073298,1,0
0,0,6,6,12,11,23,28,22,50,0.000333,0.075393,12,2714.137174,150.785399,226.178098,81.073298,1,0
0,0,6,6,12,11,23,28,22,50,0.000333,0.075393,12,2714.137174,150.785399,226.178098,81.073298,1,0
0,0,8,8,13,9,22,36,28,64,0.000333,0.095135,18,5137.265225,285.403624,285.403624,76.635041,1,0
0,0,7,7,13,11,24,33,25,58,0.000333,0.088643,12,3191.133901,177.285217,265.927825,86.159464,1,0
0,0,7,7,13,11,24,34,25,59,0.000333,0.090171,12,3246.153451,180.341858,270.512788,86.159464,1,0
0,0,8,8,13,12,25,43,29,72,0.000333,0.111453,12,4012.291748,222.905097,334.357646,91.125266,1,0
0,0,7,7,12,11,23,36,26,62,0.000333,0.093487,12,3365.530095,186.973894,280.460841,81.073298,1,0
0,0,9,9,12,13,25,43,32,75,0.000333,0.116096,12,4179.470571,232.192809,348.289214,91.125266,1,0
0,0,9,9,13,13,26,35,31,66,0.000333,0.10341,12,3722.748257,206.819348,310.229021,96.211433,1,0
0,0,8,8,12,15,27,28,32,60,0.000333,0.095098,12,3423.519002,190.1955,285.29325,101.622909,1,0
0,0,10,10,15,15,30,58,46,104,0.000333,0.170106,21,10716.64906,595.369392,510.316622,117.206718,1,0
0,0,10,10,15,13,28,48,37,85,0.000333,0.136208,14,5720.752357,317.819575,408.625168,106.709075,1,0
0,0,11,11,14,14,28,53,41,94,0.000333,0.15063,14,6326.479077,351.47106,451.891363,106.605938,1,0
0,0,4,4,12,7,19,22,14,36,0.000333,0.050975,12,1835.104686,101.95026,152.92539,62.671034,1,0
0,0,4,4,12,7,19,22,14,36,0.000333,0.050975,12,1835.104686,101.95026,152.92539,62.671034,1,0
0,0,4,4,12,7,19,22,14,36,0.000333,0.050975,12,1835.104686,101.95026,152.92539,62.671034,1,0
0,0,4,4,12,7,19,22,14,36,0.000333,0.050975,12,1835.104686,101.95026,152.92539,62.671034,1,0
0,0,4,4,12,7,19,22,14,36,0.000333,0.050975,12,1835.104686,101.95026,152.92539,62.671034,1,0
0,0,4,4,12,7,19,22,14,36,0.000333,0.050975,12,1835.104686,101.95026,152.92539,62.671034,1,0
0,0,4,4,12,7,19,22,14,36,0.000333,0.050975,12,1835.104686,101.95026,152.92539,62.671034,1,0
0,0,4,4,12,7,19,22,14,36,0.000333,0.050975,12,1835.104686,101.95026,152.92539,62.671034,1,0
0,0,4,4,12,7,19,22,14,36,0.000333,0.050975,12,1835.104686,101.95026,152.92539,62.671034,1,0
0,0,4,4,12,7,19,22,14,36,0.000333,0.050975,12,1835.104686,101.95026,152.92539,62.671034,1,0
0,0,4,4,12,7,19,22,14,36,0.000333,0.050975,12,1835.104686,101.95026,152.92539,62.671034,1,0
0,0,4,4,12,7,19,22,14,36,0.000333,0.050975,12,1835.104686,101.95026,152.92539,62.671034,1,0
0,0,4,4,12,7,19,22,14,36,0.000333,0.050975,12,1835.104686,101.95026,152.92539,62.671034,1,0
0,0,4,4,12,7,19,22,14,36,0.000333,0.050975,12,1835.104686,101.95026,152.92539,62.671034,1,0
0,0,4,4,12,7,19,22,14,36,0.000333,0.050975,12,1835.104686,101.95026,152.92539,62.671034,1,0
0,0,4,4,12,7,19,22,14,36,0.000333,0.050975,12,1835.104686,101.95026,152.92539,62.671034,1,0
0,0,4,4,12,7,19,22,14,36,0.000333,0.050975,12,1835.104686,101.95026,152.92539,62.671034,1,0
0,0,4,4,12,7,19,22,14,36,0.000333,0.050975,12,1835.104686,101.95026,152.92539,62.671034,1,0
0,0,8,8,14,10,24,37,31,68,0.000333,0.103926,21,6547.326451,363.740358,311.77745,86.52225,1,0
0,0,8,8,13,10,23,37,31,68,0.000333,0.102534,18,5536.839834,307.602213,307.602213,81.324997,1,0
0,0,6,6,12,8,20,28,20,48,0.000333,0.069151,12,2489.430583,138.301699,207.452549,67.01955,1,0
0,0,6,6,13,8,21,31,20,51,0.000333,0.074669,12,2688.098263,149.338792,224.008189,72.105716,1,0
0,0,6,6,13,8,21,29,20,49,0.000333,0.071741,12,2582.682645,143.482369,215.223554,72.105716,1,0
0,0,7,7,13,11,24,30,23,53,0.000333,0.081001,12,2916.03615,162.002008,243.003013,86.159464,1,0
0,0,6,6,12,10,22,28,22,50,0.000333,0.074324,12,2675.658971,148.647721,222.971581,76.238831,1,0
0,0,8,8,14,9,23,37,28,65,0.000333,0.098011,21,6174.66207,343.036782,294.031527,81.832294,1,0
0,0,7,7,13,10,23,32,25,57,0.000333,0.085948,12,3094.116378,171.895354,257.843031,81.324997,1,0
0,0,7,7,13,11,24,37,26,63,0.000333,0.096284,12,3466.231651,192.568425,288.852638,86.159464,1,0
0,0,8,8,13,11,24,29,26,55,0.000333,0.084058,12,3026.07525,168.115292,252.172938,86.159464,1,0
0,0,6,6,12,10,22,28,22,50,0.000333,0.074324,12,2675.658971,148.647721,222.971581,76.238831,1,0
0,0,6,6,12,11,23,28,22,50,0.000333,0.075393,12,2714.137174,150.785399,226.178098,81.073298,1,0
0,0,6,6,12,11,23,28,22,50,0.000333,0.075393,12,2714.137174,150.785399,226.178098,81.073298,1,0
0,0,6,6,12,11,23,28,22,50,0.000333,0.075393,12,2714.137174,150.785399,226.178098,81.073298,1,0
0,0,8,8,13,9,22,37,28,65,0.000333,0.096621,18,5217.534994,289.863055,289.863055,76.635041,1,0
0,0,6,6,13,10,23,30,22,52,0.000333,0.078408,12,2822.702661,156.816814,235.225222,81.324997,1,0
0,0,7,7,13,11,24,34,25,59,0.000333,0.090171,12,3246.153451,180.341858,270.512788,86.159464,1,0
0,0,8,8,13,12,25,43,29,72,0.000333,0.111453,12,4012.291748,222.905097,334.357646,91.125266,1,0
0,0,7,7,12,11,23,36,26,62,0.000333,0.093487,12,3365.530095,186.973894,280.460841,81.073298,1,0
0,0,9,9,12,13,25,43,32,75,0.000333,0.116096,12,4179.470571,232.192809,348.289214,91.125266,1,0
0,0,9,9,13,13,26,35,31,66,0.000333,0.10341,12,3722.748257,206.819348,310.229021,96.211433,1,0
0,0,8,8,12,15,27,29,32,61,0.000333,0.096683,12,3480.577652,193.365425,290.048138,101.622909,1,0
0,0,11,11,15,16,31,60,48,108,0.000333,0.178351,21,11236.11723,624.228735,535.053202,122.603359,1,0
0,0,11,11,15,14,29,50,39,89,0.000333,0.14412,14,6053.04432,336.28024,432.360309,111.906328,1,0
0,0,11,11,14,14,28,53,41,94,0.000333,0.15063,14,6326.479077,351.47106,451.891363,106.605938,1,0
0,0,7,7,11,9,20,34,22,56,0.000333,0.080676,10,2420.279733,134.459985,242.027973,66.583073,1,0
0,0,7,7,11,9,20,34,22,56,0.000333,0.080676,10,2420.279733,134.459985,242.027973,66.583073,1,0
0,0,7,7,11,9,20,34,22,56,0.000333,0.080676,10,2420.279733,134.459985,242.027973,66.583073,1,0
0,0,7,7,11,9,20,34,22,56,0.000333,0.080676,10,2420.279733,134.459985,242.027973,66.583073,1,0
0,0,7,7,11,9,20,34,22,56,0.000333,0.080676,10,2420.279733,134.459985,242.027973,66.583073,1,0
0,0,7,7,11,9,20,34,22,56,0.000333,0.080676,10,2420.279733,134.459985,242.027973,66.583073,1,0
0,0,7,7,11,9,20,34,22,56,0.000333,0.080676,10,2420.279733,134.459985,242.027973,66.583073,1,0
0,0,7,7,11,9,20,34,22,56,0.000333,0.080676,10,2420.279733,134.459985,242.027973,66.583073,1,0
0,0,7,7,11,9,20,34,22,56,0.000333,0.080676,10,2420.279733,134.459985,242.027973,66.583073,1,0
0,0,7,7,11,9,20,34,22,56,0.000333,0.080676,10,2420.279733,134.459985,242.027973,66.583073,1,0
0,0,7,7,11,9,20,34,22,56,0.000333,0.080676,10,2420.279733,134.459985,242.027973,66.583073,1,0
0,0,7,7,11,9,20,34,22,56,0.000333,0.080676,10,2420.279733,134.459985,242.027973,66.583073,1,0
0,0,7,7,11,9,20,34,22,56,0.000333,0.080676,10,2420.279733,134.459985,242.027973,66.583073,1,0
0,0,7,7,11,9,20,34,22,56,0.000333,0.080676,10,2420.279733,134.459985,242.027973,66.583073,1,0
0,0,7,7,11,9,20,34,22,56,0.000333,0.080676,10,2420.279733,134.459985,242.027973,66.583073,1,0
0,0,7,7,11,9,20,34,22,56,0.000333,0.080676,10,2420.279733,134.459985,242.027973,66.583073,1,0
0,0,7,7,11,9,20,34,22,56,0.000333,0.080676,10,2420.279733,134.459985,242.027973,66.583073,1,0
0,0,7,7,11,9,20,34,22,56,0.000333,0.080676,10,2420.279733,134.459985,242.027973,66.583073,1,0
0,0,11,11,13,12,25,51,40,91,0.000333,0.140864,18,7606.636439,422.590913,422.590913,91.125266,1,0
0,0,11,11,12,12,24,48,39,87,0.000333,0.132964,18,7180.051276,398.891738,398.891738,86.0391,1,0
0,0,9,9,11,10,21,40,28,68,0.000333,0.099559,10,2986.775847,165.931992,298.677585,71.273029,1,0
0,0,13,13,12,11,23,60,39,99,0.000333,0.149278,18,8060.987406,447.832634,447.832634,81.073298,1,0
0,0,9,9,12,10,22,41,28,69,0.000333,0.102567,12,3692.40938,205.133854,307.700782,76.238831,1,0
0,0,10,10,12,13,25,42,31,73,0.000333,0.113001,12,4068.018022,226.001001,339.001502,91.125266,1,0
0,0,9,9,11,12,23,40,30,70,0.000333,0.10555,10,3166.493369,175.916298,316.649337,81.073298,1,0
0,0,11,11,13,11,24,49,36,85,0.000333,0.129907,18,7014.992626,389.721813,389.721813,86.159464,1,0
0,0,10,10,13,12,25,45,33,78,0.000333,0.12074,12,4346.649394,241.480522,362.220783,91.125266,1,0
0,0,10,10,12,13,25,49,34,83,0.000333,0.12848,12,4625.280765,256.960043,385.440064,91.125266,1,0
0,0,11,11,12,13,25,41,34,75,0.000333,0.116096,12,4179.470571,232.192809,348.289214,91.125266,1,0
0,0,9,9,11,12,23,40,30,70,0.000333,0.10555,10,3166.493369,175.916298,316.649337,81.073298,1,0
0,0,9,9,11,13,24,40,30,70,0.000333,0.106982,10,3209.473751,178.304097,320.947375,86.159464,1,0
0,0,9,9,11,13,24,40,30,70,0.000333,0.106982,10,3209.473751,178.304097,320.947375,86.159464,1,0
0,0,9,9,11,13,24,40,30,70,0.000333,0.106982,10,3209.473751,178.304097,320.947375,86.159464,1,0
0,0,11,11,12,11,23,48,36,84,0.000333,0.12666,18,6839.625678,379.979204,379.979204,81.073298,1,0
0,0,10,10,12,12,24,44,33,77,0.000333,0.117681,12,4236.505351,235.361408,353.042113,86.0391,1,0
0,0,10,10,12,13,25,46,33,79,0.000333,0.122288,12,4402.375668,244.576426,366.864639,91.125266,1,0
0,0,11,11,12,14,26,55,37,92,0.000333,0.144147,12,5189.285449,288.293636,432.440454,96.322519,1,0
0,0,10,10,11,13,24,48,34,82,0.000333,0.125322,10,3759.669251,208.870514,375.966925,86.159464,1,0
0,0,12,12,11,15,26,55,40,95,0.000333,0.148847,10,4465.417732,248.078763,446.541773,96.657107,1,0
0,0,12,12,12,15,27,47,39,86,0.000333,0.136307,12,4907.043902,272.61355,408.920325,101.622909,1,0
0,0,11,11,11,17,28,40,40,80,0.000333,0.128196,10,3845.883938,213.660219,384.588394,107.540616,1,0
0,0,14,14,14,17,31,72,56,128,0.000333,0.211379,21,13316.87968,739.826649,634.137128,122.789837,1,0
0,0,14,14,14,16,30,62,47,109,0.000333,0.178284,14,7487.915049,415.99528,534.851075,117.302969,1,0
0,0,14,14,14,19,33,64,48,112,0.000333,0.188324,14,7909.609979,439.422777,564.972141,134.013592,1,0
0,0,7,7,11,9,20,34,22,56,0.000333,0.080676,10,2420.279733,134.459985,242.027973,66.583073,1,0
0,0,7,7,11,9,20,34,22,56,0.000333,0.080676,10,2420.279733,134.459985,242.027973,66.583073,1,0
0,0,7,7,11,9,20,34,22,56,0.000333,0.080676,10,2420.279733,134.459985,242.027973,66.583073,1,0
0,0,7,7,11,9,20,34,22,56,0.000333,0.080676,10,2420.279733,134.459985,242.027973,66.583073,1,0
0,0,7,7,11,9,20,34,22,56,0.000333,0.080676,10,2420.279733,134.459985,242.027973,66.583073,1,0
0,0,7,7,11,9,20,34,22,56,0.000333,0.080676,10,2420.279733,134.459985,242.027973,66.583073,1,0
0,0,7,7,11,9,20,34,22,56,0.000333,0.080676,10,2420.279733,134.459985,242.027973,66.583073,1,0
0,0,7,7,11,9,20,34,22,56,0.000333,0.080676,10,2420.279733,134.459985,242.027973,66.583073,1,0
0,0,7,7,11,9,20,34,22,56,0.000333,0.080676,10,2420.279733,134.459985,242.027973,66.583073,1,0
0,0,7,7,11,9,20,34,22,56,0.000333,0.080676,10,2420.279733,134.459985,242.027973,66.583073,1,0
0,0,7,7,11,9,20,34,22,56,0.000333,0.080676,10,2420.279733,134.459985,242.027973,66.583073,1,0
0,0,7,7,11,9,20,34,22,56,0.000333,0.080676,10,2420.279733,134.459985,242.027973,66.583073,1,0
0,0,7,7,11,9,20,34,22,56,0.000333,0.080676,10,2420.279733,134.459985,242.027973,66.583073,1,0
0,0,7,7,11,9,20,34,22,56,0.000333,0.080676,10,2420.279733,134.459985,242.027973,66.583073,1,0
0,0,7,7,11,9,20,34,22,56,0.000333,0.080676,10,2420.279733,134.459985,242.027973,66.583073,1,0
0,0,7,7,11,9,20,34,22,56,0.000333,0.080676,10,2420.279733,134.459985,242.027973,66.583073,1,0
0,0,7,7,11,9,20,34,22,56,0.000333,0.080676,10,2420.279733,134.459985,242.027973,66.583073,1,0
0,0,7,7,11,9,20,34,22,56,0.000333,0.080676,10,2420.279733,134.459985,242.027973,66.583073,1,0
0,0,10,10,12,12,24,47,38,85,0.000333,0.129907,18,7014.992626,389.721813,389.721813,86.0391,1,0
0,0,12,12,12,13,25,50,41,91,0.000333,0.140864,18,7606.636439,422.590913,422.590913,91.125266,1,0
0,0,9,9,11,10,21,40,28,68,0.000333,0.099559,10,2986.775847,165.931992,298.677585,71.273029,1,0
0,0,9,9,12,10,22,43,28,71,0.000333,0.10554,12,3799.435739,211.079763,316.619645,76.238831,1,0
0,0,9,9,12,10,22,41,28,69,0.000333,0.102567,12,3692.40938,205.133854,307.700782,76.238831,1,0
0,0,10,10,12,13,25,42,31,73,0.000333,0.113001,12,4068.018022,226.001001,339.001502,91.125266,1,0
0,0,9,9,11,12,23,40,30,70,0.000333,0.10555,10,3166.493369,175.916298,316.649337,81.073298,1,0
0,0,11,11,13,11,24,49,36,85,0.000333,0.129907,18,7014.992626,389.721813,389.721813,86.159464,1,0
0,0,10,10,13,12,25,45,33,78,0.000333,0.12074,12,4346.649394,241.480522,362.220783,91.125266,1,0
0,0,10,10,12,13,25,49,34,83,0.000333,0.12848,12,4625.280765,256.960043,385.440064,91.125266,1,0
0,0,11,11,12,14,26,41,33,74,0.000333,0.115944,12,4173.99047,231.888359,347.832539,96.322519,1,0
0,0,9,9,11,12,23,40,30,70,0.000333,0.10555,10,3166.493369,175.916298,316.649337,81.073298,1,0
0,0,9,9,11,13,24,40,30,70,0.000333,0.106982,10,3209.473751,178.304097,320.947375,86.159464,1,0
0,0,9,9,11,13,24,40,30,70,0.000333,0.106982,10,3209.473751,178.304097,320.947375,86.159464,1,0
0,0,9,9,11,13,24,40,30,70,0.000333,0.106982,10,3209.473751,178.304097,320.947375,86.159464,1,0
0,0,11,11,12,11,23,48,36,84,0.000333,0.12666,18,6839.625678,379.979204,379.979204,81.073298,1,0
0,0,10,10,12,12,24,44,33,77,0.000333,0.117681,12,4236.505351,235.361408,353.042113,86.0391,1,0
0,0,10,10,12,13,25,46,33,79,0.000333,0.122288,12,4402.375668,244.576426,366.864639,91.125266,1,0
0,0,11,11,12,14,26,55,37,92,0.000333,0.144147,12,5189.285449,288.293636,432.440454,96.322519,1,0
0,0,10,10,11,13,24,48,34,82,0.000333,0.125322,10,3759.669251,208.870514,375.966925,86.159464,1,0
0,0,12,12,11,15,26,55,40,95,0.000333,0.148847,10,4465.417732,248.078763,446.541773,96.657107,1,0
0,0,10,10,12,14,26,38,32,70,0.000333,0.109677,12,3948.369363,219.353854,329.03078,96.322519,1,0
0,0,11,11,11,18,29,41,39,80,0.000333,0.129546,10,3886.384796,215.910266,388.63848,113.112398,1,0
0,0,14,14,14,17,31,72,56,128,0.000333,0.211379,21,13316.87968,739.826649,634.137128,122.789837,1,0
0,0,14,14,14,16,30,62,47,109,0.000333,0.178284,14,7487.915049,415.99528,534.851075,117.302969,1,0
0,0,12,12,13,15,28,56,42,98,0.000333,0.15704,12,5653.449388,314.080522,471.120782,106.709075,1,0
0,0,7,7,9,9,18,30,21,51,0.000333,0.070889,8,1701.329401,94.5183,212.666175,57.05865,1,0
0,0,7,7,9,9,18,30,21,51,0.000333,0.070889,8,1701.329401,94.5183,212.666175,57.05865,1,0
0,0,7,7,9,9,18,30,21,51,0.000333,0.070889,8,1701.329401,94.5183,212.666175,57.05865,1,0
0,0,7,7,9,9,18,30,21,51,0.000333,0.070889,8,1701.329401,94.5183,212.666175,57.05865,1,0
0,0,7,7,9,9,18,30,21,51,0.000333,0.070889,8,1701.329401,94.5183,212.666175,57.05865,1,0
0,0,7,7,9,9,18,30,21,51,0.000333,0.070889,8,1701.329401,94.5183,212.666175,57.05865,1,0
0,0,7,7,9,9,18,30,21,51,0.000333,0.070889,8,1701.329401,94.5183,212.666175,57.05865,1,0
0,0,7,7,9,9,18,30,21,51,0.000333,0.070889,8,1701.329401,94.5183,212.666175,57.05865,1,0
0,0,7,7,9,9,18,30,21,51,0.000333,0.070889,8,1701.329401,94.5183,212.666175,57.05865,1,0
0,0,7,7,9,9,18,30,21,51,0.000333,0.070889,8,1701.329401,94.5183,212.666175,57.05865,1,0
0,0,7,7,9,9,18,30,21,51,0.000333,0.070889,8,1701.329401,94.5183,212.666175,57.05865,1,0
0,0,7,7,9,9,18,30,21,51,0.000333,0.070889,8,1701.329401,94.5183,212.666175,57.05865,1,0
0,0,7,7,9,9,18,30,21,51,0.000333,0.070889,8,1701.329401,94.5183,212.666175,57.05865,1,0
0,0,7,7,9,9,18,30,21,51,0.000333,0.070889,8,1701.329401,94.5183,212.666175,57.05865,1,0
0,0,7,7,9,9,18,30,21,51,0.000333,0.070889,8,1701.329401,94.5183,212.666175,57.05865,1,0
0,0,7,7,9,9,18,30,21,51,0.000333,0.070889,8,1701.329401,94.5183,212.666175,57.05865,1,0
0,0,7,7,9,9,18,30,21,51,0.000333,0.070889,8,1701.329401,94.5183,212.666175,57.05865,1,0
0,0,7,7,9,9,18,30,21,51,0.000333,0.070889,8,1701.329401,94.5183,212.666175,57.05865,1,0
0,0,11,11,12,12,24,45,38,83,0.000333,0.126851,18,6849.933976,380.551888,380.551888,86.0391,1,0
0,0,11,11,11,13,24,44,38,82,0.000333,0.125322,10,3759.669251,208.870514,375.966925,86.159464,1,0
0,0,9,9,10,10,20,36,27,63,0.000333,0.09076,10,2722.8147,151.267483,272.28147,66.438562,1,0
0,0,8,8,11,9,20,37,25,62,0.000333,0.08932,10,2679.595419,148.866412,267.959542,66.583073,1,0
0,0,9,9,11,10,21,37,27,64,0.000333,0.093703,10,2811.083151,156.171286,281.108315,71.273029,1,0
0,0,10,10,11,13,24,38,30,68,0.000333,0.103926,10,3117.7745,173.209694,311.77745,86.159464,1,0
0,0,9,9,10,12,22,36,29,65,0.000333,0.096621,10,2898.630552,161.035031,289.863055,76.238831,1,0
0,0,11,11,12,11,23,45,35,80,0.000333,0.120628,18,6513.929217,361.884956,361.884956,81.073298,1,0
0,0,10,10,12,12,24,41,32,73,0.000333,0.111567,12,4016.427151,223.134842,334.702263,86.0391,1,0
0,0,10,10,11,13,24,45,33,78,0.000333,0.119209,10,3576.270751,198.681708,357.627075,86.159464,1,0
0,0,11,11,11,13,24,37,33,70,0.000333,0.106982,10,3209.473751,178.304097,320.947375,86.159464,1,0
0,0,9,9,10,12,22,36,29,65,0.000333,0.096621,10,2898.630552,161.035031,289.863055,76.238831,1,0
0,0,9,9,10,13,23,36,29,65,0.000333,0.098011,10,2940.315271,163.350848,294.031527,81.324997,1,0
0,0,9,9,10,13,23,36,29,65,0.000333,0.098011,10,2940.315271,163.350848,294.031527,81.324997,1,0
0,0,9,9,10,13,23,36,29,65,0.000333,0.098011,10,2940.315271,163.350848,294.031527,81.324997,1,0
0,0,11,11,11,11,22,44,35,79,0.000333,0.117432,15,5284.426468,293.579248,352.295098,76.107496,1,0
0,0,10,10,11,12,23,41,32,73,0.000333,0.110073,10,3302.200228,183.455568,330.220023,81.073298,1,0
0,0,10,10,11,13,24,42,32,74,0.000333,0.113096,10,3392.872251,188.492903,339.287225,86.159464,1,0
0,0,11,11,11,14,25,51,36,87,0.000333,0.134672,10,4040.154885,224.453049,404.015489,91.356717,1,0
0,0,11,11,10,15,25,44,35,79,0.000333,0.122288,10,3668.64639,203.813688,366.864639,91.82264,1,0
0,0,12,12,10,15,25,51,39,90,0.000333,0.139316,10,4179.470571,232.192809,417.947057,91.82264,1,0
0,0,12,12,11,15,26,43,38,81,0.000333,0.126912,10,3807.356172,211.519787,380.735617,96.657107,1,0
0,0,11,11,10,17,27,36,39,75,0.000333,0.118872,10,3566.165627,198.120313,356.616563,102.706149,1,0
0,0,14,14,13,17,30,68,55,123,0.000333,0.201183,18,10863.85578,603.547543,603.547543,117.592585,1,0
0,0,14,14,13,17,30,59,46,105,0.000333,0.171741,12,6182.68215,343.482342,515.223513,117.592585,1,0
0,0,14,14,12,16,28,61,48,109,0.000333,0.174667,18,9432.030357,524.001687,524.001687,107.01955,1,0
0,0,7,7,9,9,18,31,22,53,0.000333,0.073669,8,1768.048201,98.2249,221.006025,57.05865,1,0
0,0,7,7,9,9,18,31,22,53,0.000333,0.073669,8,1768.048201,98.2249,221.006025,57.05865,1,0
0,0,7,7,9,9,18,31,22,53,0.000333,0.073669,8,1768.048201,98.2249,221.006025,57.05865,1,0
0,0,7,7,9,9,18,31,22,53,0.000333,0.073669,8,1768.048201,98.2249,221.006025,57.05865,1,0
0,0,7,7,9,9,18,31,22,53,0.000333,0.073669,8,1768.048201,98.2249,221.006025,57.05865,1,0
0,0,7,7,9,9,18,31,22,53,0.000333,0.073669,8,1768.048201,98.2249,221.006025,57.05865,1,0
0,0,7,7,9,9,18,31,22,53,0.000333,0.073669,8,1768.048201,98.2249,221.006025,57.05865,1,0
0,0,7,7,9,9,18,31,22,53,0.000333,0.073669,8,1768.048201,98.2249,221.006025,57.05865,1,0
0,0,7,7,9,9,18,31,22,53,0.000333,0.073669,8,1768.048201,98.2249,221.006025,57.05865,1,0
0,0,7,7,9,9,18,31,22,53,0.000333,0.073669,8,1768.048201,98.2249,221.006025,57.05865,1,0
0,0,7,7,9,9,18,31,22,53,0.000333,0.073669,8,1768.048201,98.2249,221.006025,57.05865,1,0
0,0,7,7,9,9,18,31,22,53,0.000333,0.073669,8,1768.048201,98.2249,221.006025,57.05865,1,0
0,0,7,7,9,9,18,31,22,53,0.000333,0.073669,8,1768.048201,98.2249,221.006025,57.05865,1,0
0,0,7,7,9,9,18,31,22,53,0.000333,0.073669,8,1768.048201,98.2249,221.006025,57.05865,1,0
0,0,7,7,9,9,18,31,22,53,0.000333,0.073669,8,1768.048201,98.2249,221.006025,57.05865,1,0
0,0,7,7,9,9,18,31,22,53,0.000333,0.073669,8,1768.048201,98.2249,221.006025,57.05865,1,0
0,0,7,7,9,9,18,31,22,53,0.000333,0.073669,8,1768.048201,98.2249,221.006025,57.05865,1,0
0,0,7,7,9,9,18,31,22,53,0.000333,0.073669,8,1768.048201,98.2249,221.006025,57.05865,1,0
0,0,11,11,12,12,24,46,39,85,0.000333,0.129907,18,7014.992626,389.721813,389.721813,86.0391,1,0
0,0,11,11,11,13,24,45,37,82,0.000333,0.125322,10,3759.669251,208.870514,375.966925,86.159464,1,0
0,0,9,9,10,10,20,37,28,65,0.000333,0.093642,10,2809.253262,156.069626,280.925326,66.438562,1,0
0,0,9,9,10,11,21,38,27,65,0.000333,0.095167,10,2855.006325,158.611462,285.500632,71.273029,1,0
0,0,9,9,11,10,21,38,28,66,0.000333,0.096631,10,2898.929499,161.051639,289.89295,71.273029,1,0
0,0,10,10,11,13,24,39,31,70,0.000333,0.106982,10,3209.473751,178.304097,320.947375,86.159464,1,0
0,0,9,9,10,12,22,37,30,67,0.000333,0.099594,10,2987.819184,165.989955,298.781918,76.238831,1,0
0,0,11,11,12,11,23,46,36,82,0.000333,0.123644,18,6676.777447,370.93208,370.93208,81.073298,1,0
0,0,10,10,12,12,24,42,33,75,0.000333,0.114624,12,4126.466251,229.248125,343.872188,86.0391,1,0
0,0,10,10,11,13,24,46,34,80,0.000333,0.122266,10,3667.970001,203.776111,366.797,86.159464,1,0
0,0,11,11,11,13,24,38,34,72,0.000333,0.110039,10,3301.173001,183.3985,330.1173,86.159464,1,0
0,0,9,9,10,12,22,37,30,67,0.000333,0.099594,10,2987.819184,165.989955,298.781918,76.238831,1,0
0,0,9,9,10,13,23,37,30,67,0.000333,0.101026,10,3030.786511,168.377028,303.078651,81.324997,1,0
0,0,9,9,10,13,23,37,30,67,0.000333,0.101026,10,3030.786511,168.377028,303.078651,81.324997,1,0
0,0,9,9,10,13,23,37,30,67,0.000333,0.101026,10,3030.786511,168.377028,303.078651,81.324997,1,0
0,0,10,10,11,11,22,40,31,71,0.000333,0.10554,10,3166.196449,175.899803,316.619645,76.107496,1,0
0,0,10,10,11,12,23,41,33,74,0.000333,0.111581,10,3347.435847,185.968658,334.743585,81.073298,1,0
0,0,10,10,11,13,24,43,33,76,0.000333,0.116152,10,3484.571501,193.587306,348.45715,86.159464,1,0
0,0,12,12,10,15,25,59,41,100,0.000333,0.154795,10,4643.85619,257.992011,464.385619,91.82264,1,0
0,0,10,10,10,13,23,45,34,79,0.000333,0.11912,10,3573.613945,198.534108,357.361395,81.324997,1,0
0,0,12,12,10,15,25,52,40,92,0.000333,0.142412,10,4272.347695,237.35265,427.234769,91.82264,1,0
0,0,12,12,11,15,26,44,39,83,0.000333,0.130045,10,3901.364966,216.742498,390.136497,96.657107,1,0
0,0,11,11,10,17,27,37,40,77,0.000333,0.122042,10,3661.263377,203.403521,366.126338,102.706149,1,0
0,0,14,14,13,17,30,69,56,125,0.000333,0.204454,18,11040.50384,613.361324,613.361324,117.592585,1,0
0,0,14,14,13,16,29,59,47,106,0.000333,0.171649,12,6179.351826,343.297324,514.945985,112.105716,1,0
0,0,14,14,12,16,28,62,49,111,0.000333,0.177872,18,9605.095134,533.616396,533.616396,107.01955,1,0
0,0,7,7,10,9,19,32,21,53,0.000333,0.075047,10,2251.401582,125.077866,225.140158,61.748606,1,0
0,0,7,7,10,9,19,32,21,53,0.000333,0.075047,10,2251.401582,125.077866,225.140158,61.748606,1,0
0,0,7,7,10,9,19,32,21,53,0.000333,0.075047,10,2251.401582,125.077866,225.140158,61.748606,1,0
0,0,7,7,10,9,19,32,21,53,0.000333,0.075047,10,2251.401582,125.077866,225.140158,61.748606,1,0
0,0,7,7,10,9,19,32,21,53,0.000333,0.075047,10,2251.401582,125.077866,225.140158,61.748606,1,0
0,0,7,7,10,9,19,32,21,53,0.000333,0.075047,10,2251.401582,125.077866,225.140158,61.748606,1,0
0,0,7,7,10,9,19,32,21,53,0.000333,0.075047,10,2251.401582,125.077866,225.140158,61.748606,1,0
0,0,15,15,13,24,37,84,45,129,0.000333,0.224006,6,4032.116905,224.006495,672.019484,158.144816,5,0
0,0,2,2,7,4,11,13,5,18,0.000333,0.020757,3,186.809307,10.378295,62.269769,27.651484,3,0
0,0,17,17,16,23,39,110,55,165,0.000333,0.290697,16,13953.46186,775.192325,872.091366,168.041925,7,0
0,0,2,2,10,5,15,12,6,18,0.000333,0.023441,5,351.620154,19.534453,70.324031,44.828921,2,0
0,0,6,6,16,18,34,49,29,78,0.000333,0.132274,8,3174.576813,176.365378,396.822102,139.05865,4,0
0,0,5,5,11,10,21,22,14,36,0.000333,0.052708,5,790.617136,43.923174,158.123427,71.273029,5,0
0,0,5,5,14,9,23,39,20,59,0.000333,0.088963,14,3736.462176,207.581232,266.890155,81.832294,4,0
0,0,8,8,17,13,30,41,27,68,0.000333,0.111223,16,5338.696968,296.594276,333.668561,117.592585,4,0
0,0,44,44,29,68,97,542,340,882,0.000333,1.940374,70,407478.6189,22637.70105,5821.123127,554.828922,9,0
0,0,36,36,25,50,75,454,283,737,0.000333,1.530213,60,275438.3625,15302.13125,4590.639375,398.289214,5,0
0,0,3,3,13,22,35,34,32,66,0.000333,0.112844,6,2031.196075,112.844226,338.532679,146.213212,2,0
0,0,17,17,20,45,65,167,114,281,0.000333,0.564095,20,33845.70711,1880.317062,1692.285355,333.571951,3,0
0,0,44,44,29,63,92,482,300,782,0.000333,1.700475,56,285679.8252,15871.1014,5101.42545,517.450084,7,0
0,0,25,25,24,42,66,341,223,564,0.000333,1.136346,60,204542.297,11363.46094,3409.038283,336.516432,3,0
0,0,71,71,28,69,97,658,419,1077,0.000333,2.369369,84,597080.915,33171.16195,7108.106131,556.094125,9,0
0,0,16,16,19,44,63,156,121,277,0.000333,0.551902,18,29802.7177,1655.706539,1655.706539,320.925614,8,0
0,0,25,25,21,58,79,227,167,394,0.000333,0.827897,20,49673.7923,2759.655128,2483.689615,432.001564,3,0
0,0,52,52,29,51,80,696,429,1125,0.000333,2.370723,112,796562.94,44253.49666,7112.169107,430.175141,9,0
0,0,3,3,14,18,32,26,25,51,0.000333,0.085,7,1785,99.166667,255,128.361619,3,0
0,0,17,17,14,19,33,131,74,205,0.000333,0.3447,21,21716.11668,1206.450927,1034.100794,134.013592,1,0
0,0,19,19,20,53,73,252,171,423,0.000333,0.872765,30,78548.87365,4363.826314,2618.295788,390.018346,3,0
0,0,35,35,19,47,66,268,202,470,0.000333,0.946955,36,102271.1485,5681.730472,2840.865236,341.776299,20,0
0,0,67,67,30,113,143,719,513,1232,0.000333,2.94032,60,529257.6892,29403.20496,8820.961487,917.886941,69,0
0,0,69,69,30,104,134,684,476,1160,0.000333,2.732221,60,491799.8077,27322.21154,8196.663461,844.052449,45,0
0,0,58,58,27,65,92,641,408,1049,0.000333,2.281072,78,533770.8864,29653.93813,6843.216492,519.83587,11,0
0,0,99,99,32,119,151,927,587,1514,0.000333,3.652982,64,701372.4656,38965.13698,10958.94478,980.483314,18,0
0,0,75,75,25,67,92,603,432,1035,0.000333,2.250629,72,486135.837,27007.5465,6751.886625,522.524381,10,0
0,0,3,3,11,11,22,26,15,41,0.000333,0.060946,5,914.183482,50.787971,182.836696,76.107496,3,0
0,0,10,10,15,22,37,70,39,109,0.000333,0.189277,7,3974.812918,220.82294,567.830417,156.710855,6,0
0,0,2,2,7,4,11,13,5,18,0.000333,0.020757,3,186.809307,10.378295,62.269769,27.651484,3,0
0,0,2,2,7,4,11,13,5,18,0.000333,0.020757,3,186.809307,10.378295,62.269769,27.651484,3,0
0,0,36,36,24,47,71,225,127,352,0.000333,0.72157,24,51953.06367,2886.281315,2164.710986,371.104776,12,0
0,0,7,7,12,19,31,51,37,88,0.000333,0.145323,6,2615.815652,145.323092,435.969275,123.730173,5,0
0,0,5,5,12,12,24,58,26,84,0.000333,0.128379,12,4621.642201,256.7579,385.13685,86.0391,11,0
0,0,4,4,12,12,24,49,23,72,0.000333,0.110039,6,1980.7038,110.0391,330.1173,86.0391,10,0
0,0,2,2,7,4,11,13,5,18,0.000333,0.020757,3,186.809307,10.378295,62.269769,27.651484,3,0
0,0,2,2,9,10,19,26,14,40,0.000333,0.056639,4,679.668402,37.759356,169.917101,61.748606,1,0
0,0,2,2,9,10,19,26,14,40,0.000333,0.056639,4,679.668402,37.759356,169.917101,61.748606,1,0
0,0,3,3,9,9,18,63,34,97,0.000333,0.134828,12,4853.792702,269.65515,404.482725,57.05865,1,0
0,0,2,2,9,10,19,26,14,40,0.000333,0.056639,4,679.668402,37.759356,169.917101,61.748606,1,0
0,0,2,2,9,10,19,26,14,40,0.000333,0.056639,4,679.668402,37.759356,169.917101,61.748606,1,0
0,0,10,10,9,14,23,123,66,189,0.000333,0.284984,16,13679.25136,759.958409,854.95321,81.832294,1,0
0,0,2,2,9,10,19,26,14,40,0.000333,0.056639,4,679.668402,37.759356,169.917101,61.748606,1,0
0,0,2,2,9,10,19,26,14,40,0.000333,0.056639,4,679.668402,37.759356,169.917101,61.748606,1,0
0,0,2,2,9,10,19,26,14,40,0.000333,0.056639,4,679.668402,37.759356,169.917101,61.748606,1,0
0,0,2,2,9,10,19,26,14,40,0.000333,0.056639,4,679.668402,37.759356,169.917101,61.748606,1,0
0,0,5,5,13,101,114,424,267,691,0.000333,1.573842,12,56658.324,3147.684667,4721.527,720.585076,7,0
0,0,2,2,9,10,19,26,14,40,0.000333,0.056639,4,679.668402,37.759356,169.917101,61.748606,1,0
0,0,2,2,9,10,19,26,14,40,0.000333,0.056639,4,679.668402,37.759356,169.917101,61.748606,2,0
0,0,3,3,11,12,23,35,18,53,0.000333,0.079916,5,1198.743918,66.596884,239.748784,81.073298,2,0
0,0,2,2,9,10,19,26,14,40,0.000333,0.056639,4,679.668402,37.759356,169.917101,61.748606,1,0
0,0,2,2,9,10,19,26,14,40,0.000333,0.056639,4,679.668402,37.759356,169.917101,61.748606,2,0
0,0,2,2,9,10,19,26,14,40,0.000333,0.056639,4,679.668402,37.759356,169.917101,61.748606,1,0
0,0,2,2,9,10,19,26,14,40,0.000333,0.056639,4,679.668402,37.759356,169.917101,61.748606,1,0
0,0,2,2,9,10,19,26,14,40,0.000333,0.056639,4,679.668402,37.759356,169.917101,61.748606,1,0
0,0,2,2,9,10,19,26,14,40,0.000333,0.056639,4,679.668402,37.759356,169.917101,61.748606,1,0
0,0,4,4,10,13,23,67,37,104,0.000333,0.156817,10,4704.504434,261.361357,470.450443,81.324997,1,0
0,0,2,2,9,10,19,26,14,40,0.000333,0.056639,4,679.668402,37.759356,169.917101,61.748606,1,0
0,0,2,2,9,10,19,26,14,40,0.000333,0.056639,4,679.668402,37.759356,169.917101,61.748606,1,0
0,0,2,2,9,10,19,26,14,40,0.000333,0.056639,4,679.668402,37.759356,169.917101,61.748606,1,0
0,0,3,3,11,11,22,26,15,41,0.000333,0.060946,5,914.183482,50.787971,182.836696,76.107496,3,0
0,0,10,10,15,22,37,70,39,109,0.000333,0.189277,7,3974.812918,220.82294,567.830417,156.710855,6,0
0,0,3,3,11,11,22,26,15,41,0.000333,0.060946,5,914.183482,50.787971,182.836696,76.107496,3,0
0,0,10,10,15,22,37,70,39,109,0.000333,0.189277,7,3974.812918,220.82294,567.830417,156.710855,6,0
0,0,21,21,17,32,49,123,66,189,0.000333,0.353727,16,16978.88257,943.271254,1061.180161,229.486868,8,0
0,0,11,11,12,18,30,64,36,100,0.000333,0.163563,12,5888.268715,327.12604,490.68906,118.0782,3,0
0,0,7,7,11,10,21,36,17,53,0.000333,0.077598,5,1163.964117,64.664673,232.792823,71.273029,4,0
0,0,2,2,7,4,11,13,5,18,0.000333,0.020757,3,186.809307,10.378295,62.269769,27.651484,3,0
0,0,3,3,11,11,22,26,15,41,0.000333,0.060946,5,914.183482,50.787971,182.836696,76.107496,3,0
0,0,10,10,15,22,37,70,39,109,0.000333,0.189277,7,3974.812918,220.82294,567.830417,156.710855,6,0
0,0,5,5,12,12,24,58,26,84,0.000333,0.128379,12,4621.642201,256.7579,385.13685,86.0391,11,0
0,0,4,4,12,12,24,49,23,72,0.000333,0.110039,6,1980.7038,110.0391,330.1173,86.0391,10,0
0,0,2,2,7,4,11,13,5,18,0.000333,0.020757,3,186.809307,10.378295,62.269769,27.651484,3,0
0,0,2,2,9,10,19,26,14,40,0.000333,0.056639,4,679.668402,37.759356,169.917101,61.748606,1,0
0,0,2,2,9,10,19,26,14,40,0.000333,0.056639,4,679.668402,37.759356,169.917101,61.748606,1,0
0,0,3,3,9,9,18,63,34,97,0.000333,0.134828,12,4853.792702,269.65515,404.482725,57.05865,1,0
0,0,2,2,9,10,19,26,14,40,0.000333,0.056639,4,679.668402,37.759356,169.917101,61.748606,1,0
0,0,2,2,9,10,19,26,14,40,0.000333,0.056639,4,679.668402,37.759356,169.917101,61.748606,1,0
0,0,10,10,9,14,23,123,66,189,0.000333,0.284984,16,13679.25136,759.958409,854.95321,81.832294,1,0
0,0,2,2,9,10,19,26,14,40,0.000333,0.056639,4,679.668402,37.759356,169.917101,61.748606,1,0
0,0,2,2,9,10,19,26,14,40,0.000333,0.056639,4,679.668402,37.759356,169.917101,61.748606,1,0
0,0,2,2,9,10,19,26,14,40,0.000333,0.056639,4,679.668402,37.759356,169.917101,61.748606,1,0
0,0,2,2,9,10,19,26,14,40,0.000333,0.056639,4,679.668402,37.759356,169.917101,61.748606,1,0
0,0,5,5,13,101,114,424,267,691,0.000333,1.573842,12,56658.324,3147.684667,4721.527,720.585076,7,0
0,0,2,2,9,10,19,26,14,40,0.000333,0.056639,4,679.668402,37.759356,169.917101,61.748606,1,0
0,0,2,2,9,10,19,26,14,40,0.000333,0.056639,4,679.668402,37.759356,169.917101,61.748606,2,0
0,0,3,3,11,12,23,35,18,53,0.000333,0.079916,5,1198.743918,66.596884,239.748784,81.073298,2,0
0,0,2,2,9,10,19,26,14,40,0.000333,0.056639,4,679.668402,37.759356,169.917101,61.748606,1,0
0,0,2,2,9,10,19,26,14,40,0.000333,0.056639,4,679.668402,37.759356,169.917101,61.748606,2,0
0,0,2,2,9,10,19,26,14,40,0.000333,0.056639,4,679.668402,37.759356,169.917101,61.748606,1,0
0,0,2,2,9,10,19,26,14,40,0.000333,0.056639,4,679.668402,37.759356,169.917101,61.748606,1,0
0,0,2,2,9,10,19,26,14,40,0.000333,0.056639,4,679.668402,37.759356,169.917101,61.748606,1,0
0,0,2,2,9,10,19,26,14,40,0.000333,0.056639,4,679.668402,37.759356,169.917101,61.748606,1,0
0,0,4,4,10,13,23,67,37,104,0.000333,0.156817,10,4704.504434,261.361357,470.450443,81.324997,1,0
0,0,2,2,9,10,19,26,14,40,0.000333,0.056639,4,679.668402,37.759356,169.917101,61.748606,1,0
0,0,2,2,9,10,19,26,14,40,0.000333,0.056639,4,679.668402,37.759356,169.917101,61.748606,1,0
0,0,2,2,9,10,19,26,14,40,0.000333,0.056639,4,679.668402,37.759356,169.917101,61.748606,1,0
0,0,3,3,11,11,22,26,15,41,0.000333,0.060946,5,914.183482,50.787971,182.836696,76.107496,3,0
0,0,10,10,15,22,37,70,39,109,0.000333,0.189277,7,3974.812918,220.82294,567.830417,156.710855,6,0
0,0,2,2,7,4,11,13,5,18,0.000333,0.020757,3,186.809307,10.378295,62.269769,27.651484,3,0
0,0,16,16,13,26,39,93,50,143,0.000333,0.251938,6,4534.875104,251.937506,755.812517,170.317149,5,0
0,0,3,3,11,11,22,26,15,41,0.000333,0.060946,5,914.183482,50.787971,182.836696,76.107496,3,0
0,0,10,10,15,22,37,70,39,109,0.000333,0.189277,7,3974.812918,220.82294,567.830417,156.710855,6,0
0,0,5,5,12,12,24,58,26,84,0.000333,0.128379,12,4621.642201,256.7579,385.13685,86.0391,11,0
0,0,28,28,19,37,56,153,80,233,0.000333,0.451038,18,24356.04654,1353.113697,1353.113697,273.460397,10,0
0,0,4,4,12,12,24,49,23,72,0.000333,0.110039,6,1980.7038,110.0391,330.1173,86.0391,10,0
0,0,29,29,21,38,59,172,92,264,0.000333,0.517673,20,31060.3553,1725.575294,1553.017765,291.659911,9,0
0,0,2,2,7,4,11,13,5,18,0.000333,0.020757,3,186.809307,10.378295,62.269769,27.651484,3,0
0,0,2,2,9,10,19,26,14,40,0.000333,0.056639,4,679.668402,37.759356,169.917101,61.748606,1,0
0,0,2,2,9,10,19,26,14,40,0.000333,0.056639,4,679.668402,37.759356,169.917101,61.748606,1,0
0,0,2,2,9,10,19,26,14,40,0.000333,0.056639,4,679.668402,37.759356,169.917101,61.748606,1,0
0,0,2,2,9,10,19,26,14,40,0.000333,0.056639,4,679.668402,37.759356,169.917101,61.748606,1,0
0,0,2,2,9,10,19,26,14,40,0.000333,0.056639,4,679.668402,37.759356,169.917101,61.748606,1,0
0,0,2,2,9,10,19,26,14,40,0.000333,0.056639,4,679.668402,37.759356,169.917101,61.748606,1,0
0,0,5,5,13,101,114,424,267,691,0.000333,1.573842,12,56658.324,3147.684667,4721.527,720.585076,7,0
0,0,2,2,9,10,19,26,14,40,0.000333,0.056639,4,679.668402,37.759356,169.917101,61.748606,2,0
0,0,2,2,9,10,19,26,14,40,0.000333,0.056639,4,679.668402,37.759356,169.917101,61.748606,1,0
0,0,2,2,9,10,19,26,14,40,0.000333,0.056639,4,679.668402,37.759356,169.917101,61.748606,1,0
0,0,2,2,9,10,19,26,14,40,0.000333,0.056639,4,679.668402,37.759356,169.917101,61.748606,1,0
0,0,2,2,9,10,19,26,14,40,0.000333,0.056639,4,679.668402,37.759356,169.917101,61.748606,1,0
0,0,2,2,9,10,19,26,14,40,0.000333,0.056639,4,679.668402,37.759356,169.917101,61.748606,1,0
0,0,10,10,9,14,23,123,66,189,0.000333,0.284984,16,13679.25136,759.958409,854.95321,81.832294,1,0
0,0,2,2,9,10,19,26,14,40,0.000333,0.056639,4,679.668402,37.759356,169.917101,61.748606,1,0
0,0,4,4,10,13,23,67,37,104,0.000333,0.156817,10,4704.504434,261.361357,470.450443,81.324997,1,0
0,0,2,2,9,10,19,26,14,40,0.000333,0.056639,4,679.668402,37.759356,169.917101,61.748606,1,0
0,0,3,3,9,9,18,63,34,97,0.000333,0.134828,12,4853.792702,269.65515,404.482725,57.05865,1,0
0,0,2,2,9,10,19,26,14,40,0.000333,0.056639,4,679.668402,37.759356,169.917101,61.748606,1,0
0,0,2,2,9,10,19,26,14,40,0.000333,0.056639,4,679.668402,37.759356,169.917101,61.748606,2,0
0,0,3,3,11,12,23,35,18,53,0.000333,0.079916,5,1198.743918,66.596884,239.748784,81.073298,2,0
0,0,2,2,9,10,19,26,14,40,0.000333,0.056639,4,679.668402,37.759356,169.917101,61.748606,1,0
0,0,2,2,9,10,19,26,14,40,0.000333,0.056639,4,679.668402,37.759356,169.917101,61.748606,1,0
0,0,2,2,9,10,19,26,14,40,0.000333,0.056639,4,679.668402,37.759356,169.917101,61.748606,1,0
0,0,5,5,11,13,24,36,21,57,0.000333,0.087114,5,1306.714313,72.59524,261.342863,86.159464,3,0
0,0,33,33,17,44,61,168,90,258,0.000333,0.510043,16,24482.08373,1360.115763,1530.130233,309.70186,10,0
0,0,2,2,7,4,11,13,5,18,0.000333,0.020757,3,186.809307,10.378295,62.269769,27.651484,3,0
0,0,3,3,11,11,22,26,15,41,0.000333,0.060946,5,914.183482,50.787971,182.836696,76.107496,3,0
0,0,10,10,15,22,37,70,39,109,0.000333,0.189277,7,3974.812918,220.82294,567.830417,156.710855,6,0
0,0,5,5,11,13,24,36,21,57,0.000333,0.087114,5,1306.714313,72.59524,261.342863,86.159464,3,0
0,0,31,31,17,41,58,157,84,241,0.000333,0.470591,16,22588.37472,1254.909707,1411.77342,289.1465,10,0
0,0,2,2,7,4,11,13,5,18,0.000333,0.020757,3,186.809307,10.378295,62.269769,27.651484,3,0
0,0,32,32,28,54,82,318,187,505,0.000333,1.070188,42,134843.678,7491.315445,3210.563762,445.369863,20,0
0,0,14,14,16,20,36,94,67,161,0.000333,0.277453,24,19976.59021,1109.810567,832.357925,150.438562,1,0
0,0,32,32,19,40,59,168,91,259,0.000333,0.507868,18,27424.8819,1523.60455,1523.60455,293.587747,11,0
0,0,28,28,17,41,58,144,85,229,0.000333,0.447159,16,21463.64237,1192.424576,1341.477648,289.1465,11,0
0,0,3,3,13,21,34,35,33,68,0.000333,0.115316,6,2075.684839,115.315824,345.947473,140.344382,3,0
0,0,23,23,20,29,49,181,80,261,0.000333,0.48848,20,29308.78539,1628.265855,1465.439269,227.320011,12,0
0,0,19,19,19,27,46,152,72,224,0.000333,0.412426,18,22271.00181,1237.277878,1237.277878,209.092585,9,0
0,0,2,2,7,4,11,13,5,18,0.000333,0.020757,3,186.809307,10.378295,62.269769,27.651484,3,0
0,0,20,20,19,27,46,157,73,230,0.000333,0.423473,18,22867.5465,1270.41925,1270.41925,209.092585,10,0
0,0,7,7,13,28,41,61,51,112,0.000333,0.200015,6,3600.274947,200.015275,600.045825,182.711654,1,0
0,0,2,2,10,3,13,13,5,18,0.000333,0.022203,5,333.039575,18.502199,66.607915,37.974168,1,0
0,0,17,17,16,23,39,110,55,165,0.000333,0.290697,16,13953.46186,775.192325,872.091366,168.041925,7,0
0,0,4,4,9,7,16,21,10,31,0.000333,0.041333,4,496,27.555556,124,48.180809,2,0
0,0,2,2,7,4,11,13,5,18,0.000333,0.020757,3,186.809307,10.378295,62.269769,27.651484,3,0
0,0,14,14,16,20,36,94,67,161,0.000333,0.277453,24,19976.59021,1109.810567,832.357925,150.438562,1,0
0,0,28,28,28,54,82,271,164,435,0.000333,0.921845,42,116152.4751,6452.915285,2765.535122,445.369863,18,0
0,0,7,7,9,12,21,42,26,68,0.000333,0.099559,8,2389.420678,132.745593,298.677585,71.548875,2,0
0,0,5,5,11,13,24,36,21,57,0.000333,0.087114,5,1306.714313,72.59524,261.342863,86.159464,4,0
0,0,2,2,7,4,11,13,5,18,0.000333,0.020757,3,186.809307,10.378295,62.269769,27.651484,3,0
0,0,28,28,19,39,58,158,85,243,0.000333,0.474496,18,25622.80887,1423.489382,1423.489382,286.841309,11,0
0,0,5,5,12,12,24,58,26,84,0.000333,0.128379,12,4621.642201,256.7579,385.13685,86.0391,11,0
0,0,5,5,11,12,23,37,20,57,0.000333,0.085948,5,1289.215157,71.623064,257.843031,81.073298,2,0
0,0,27,27,19,35,54,148,78,226,0.000333,0.433535,18,23410.88236,1300.604575,1300.604575,260.235528,10,0
0,0,4,4,12,12,24,49,23,72,0.000333,0.110039,6,1980.7038,110.0391,330.1173,86.0391,10,0
0,0,2,2,9,10,19,26,14,40,0.000333,0.056639,4,679.668402,37.759356,169.917101,61.748606,1,0
0,0,5,5,13,101,114,424,267,691,0.000333,1.573842,12,56658.324,3147.684667,4721.527,720.585076,7,0
0,0,2,2,9,10,19,26,14,40,0.000333,0.056639,4,679.668402,37.759356,169.917101,61.748606,1,0
0,0,2,2,9,10,19,26,14,40,0.000333,0.056639,4,679.668402,37.759356,169.917101,61.748606,1,0
0,0,2,2,9,10,19,26,14,40,0.000333,0.056639,4,679.668402,37.759356,169.917101,61.748606,1,0
0,0,2,2,9,10,19,26,14,40,0.000333,0.056639,4,679.668402,37.759356,169.917101,61.748606,1,0
0,0,2,2,9,10,19,26,14,40,0.000333,0.056639,4,679.668402,37.759356,169.917101,61.748606,1,0
0,0,2,2,9,10,19,26,14,40,0.000333,0.056639,4,679.668402,37.759356,169.917101,61.748606,1,0
0,0,2,2,9,10,19,26,14,40,0.000333,0.056639,4,679.668402,37.759356,169.917101,61.748606,1,0
0,0,2,2,9,10,19,26,14,40,0.000333,0.056639,4,679.668402,37.759356,169.917101,61.748606,1,0
0,0,2,2,9,10,19,26,14,40,0.000333,0.056639,4,679.668402,37.759356,169.917101,61.748606,1,0
0,0,2,2,9,10,19,26,14,40,0.000333,0.056639,4,679.668402,37.759356,169.917101,61.748606,2,0
0,0,2,2,9,10,19,26,14,40,0.000333,0.056639,4,679.668402,37.759356,169.917101,61.748606,1,0
0,0,2,2,9,10,19,26,14,40,0.000333,0.056639,4,679.668402,37.759356,169.917101,61.748606,2,0
0,0,3,3,11,12,23,35,18,53,0.000333,0.079916,5,1198.743918,66.596884,239.748784,81.073298,2,0
0,0,10,10,9,14,23,123,66,189,0.000333,0.284984,16,13679.25136,759.958409,854.95321,81.832294,1,0
0,0,2,2,9,10,19,26,14,40,0.000333,0.056639,4,679.668402,37.759356,169.917101,61.748606,1,0
0,0,3,3,9,9,18,63,34,97,0.000333,0.134828,12,4853.792702,269.65515,404.482725,57.05865,1,0
0,0,2,2,9,10,19,26,14,40,0.000333,0.056639,4,679.668402,37.759356,169.917101,61.748606,1,0
0,0,4,4,10,13,23,67,37,104,0.000333,0.156817,10,4704.504434,261.361357,470.450443,81.324997,1,0
0,0,2,2,9,10,19,26,14,40,0.000333,0.056639,4,679.668402,37.759356,169.917101,61.748606,1,0
0,0,2,2,9,10,19,26,14,40,0.000333,0.056639,4,679.668402,37.759356,169.917101,61.748606,1,0
0,0,2,2,9,10,19,26,14,40,0.000333,0.056639,4,679.668402,37.759356,169.917101,61.748606,1,0
0,0,2,2,9,10,19,26,14,40,0.000333,0.056639,4,679.668402,37.759356,169.917101,61.748606,1,0
0,0,3,3,11,11,22,26,15,41,0.000333,0.060946,5,914.183482,50.787971,182.836696,76.107496,3,0
0,0,10,10,15,22,37,70,39,109,0.000333,0.189277,7,3974.812918,220.82294,567.830417,156.710855,6,0
0,0,5,5,11,13,24,36,21,57,0.000333,0.087114,5,1306.714313,72.59524,261.342863,86.159464,3,0
0,0,2,2,7,4,11,13,5,18,0.000333,0.020757,3,186.809307,10.378295,62.269769,27.651484,3,0
0,0,17,17,16,23,39,110,55,165,0.000333,0.290697,16,13953.46186,775.192325,872.091366,168.041925,7,0
0,0,2,2,5,6,11,9,7,16,0.000333,0.01845,2,110.701812,6.150101,55.350906,27.119415,1,0
0,0,5,5,11,13,24,36,21,57,0.000333,0.087114,5,1306.714313,72.59524,261.342863,86.159464,4,0
0,0,4,4,12,12,24,49,23,72,0.000333,0.110039,6,1980.7038,110.0391,330.1173,86.0391,10,0
0,0,5,5,12,12,24,58,26,84,0.000333,0.128379,12,4621.642201,256.7579,385.13685,86.0391,11,0
0,0,2,2,7,4,11,13,5,18,0.000333,0.020757,3,186.809307,10.378295,62.269769,27.651484,3,0
0,0,2,2,9,10,19,26,14,40,0.000333,0.056639,4,679.668402,37.759356,169.917101,61.748606,2,0
0,0,2,2,9,10,19,26,14,40,0.000333,0.056639,4,679.668402,37.759356,169.917101,61.748606,1,0
0,0,2,2,9,10,19,26,14,40,0.000333,0.056639,4,679.668402,37.759356,169.917101,61.748606,1,0
0,0,3,3,11,12,23,35,18,53,0.000333,0.079916,5,1198.743918,66.596884,239.748784,81.073298,2,0
0,0,2,2,9,10,19,26,14,40,0.000333,0.056639,4,679.668402,37.759356,169.917101,61.748606,1,0
0,0,4,4,10,13,23,67,37,104,0.000333,0.156817,10,4704.504434,261.361357,470.450443,81.324997,1,0
0,0,10,10,9,14,23,123,66,189,0.000333,0.284984,16,13679.25136,759.958409,854.95321,81.832294,1,0
0,0,2,2,9,10,19,26,14,40,0.000333,0.056639,4,679.668402,37.759356,169.917101,61.748606,1,0
0,0,2,2,9,10,19,26,14,40,0.000333,0.056639,4,679.668402,37.759356,169.917101,61.748606,1,0
0,0,2,2,9,10,19,26,14,40,0.000333,0.056639,4,679.668402,37.759356,169.917101,61.748606,1,0
0,0,2,2,9,10,19,26,14,40,0.000333,0.056639,4,679.668402,37.759356,169.917101,61.748606,1,0
0,0,2,2,9,10,19,26,14,40,0.000333,0.056639,4,679.668402,37.759356,169.917101,61.748606,1,0
0,0,2,2,9,10,19,26,14,40,0.000333,0.056639,4,679.668402,37.759356,169.917101,61.748606,1,0
0,0,2,2,9,10,19,26,14,40,0.000333,0.056639,4,679.668402,37.759356,169.917101,61.748606,1,0
0,0,2,2,9,10,19,26,14,40,0.000333,0.056639,4,679.668402,37.759356,169.917101,61.748606,2,0
0,0,2,2,9,10,19,26,14,40,0.000333,0.056639,4,679.668402,37.759356,169.917101,61.748606,1,0
0,0,5,5,13,101,114,424,267,691,0.000333,1.573842,12,56658.324,3147.684667,4721.527,720.585076,7,0
0,0,2,2,9,10,19,26,14,40,0.000333,0.056639,4,679.668402,37.759356,169.917101,61.748606,1,0
0,0,3,3,9,9,18,63,34,97,0.000333,0.134828,12,4853.792702,269.65515,404.482725,57.05865,1,0
0,0,2,2,9,10,19,26,14,40,0.000333,0.056639,4,679.668402,37.759356,169.917101,61.748606,1,0
0,0,2,2,9,10,19,26,14,40,0.000333,0.056639,4,679.668402,37.759356,169.917101,61.748606,1,0
0,0,2,2,9,10,19,26,14,40,0.000333,0.056639,4,679.668402,37.759356,169.917101,61.748606,1,0
0,0,2,2,9,10,19,26,14,40,0.000333,0.056639,4,679.668402,37.759356,169.917101,61.748606,1,0
0,0,2,2,9,10,19,26,14,40,0.000333,0.056639,4,679.668402,37.759356,169.917101,61.748606,1,0
0,0,5,5,11,13,24,36,21,57,0.000333,0.087114,5,1306.714313,72.59524,261.342863,86.159464,3,0
0,0,4,4,12,12,24,49,23,72,0.000333,0.110039,6,1980.7038,110.0391,330.1173,86.0391,10,0
0,0,2,2,7,4,11,13,5,18,0.000333,0.020757,3,186.809307,10.378295,62.269769,27.651484,3,0
0,0,5,5,12,12,24,58,26,84,0.000333,0.128379,12,4621.642201,256.7579,385.13685,86.0391,11,0
0,0,2,2,9,10,19,26,14,40,0.000333,0.056639,4,679.668402,37.759356,169.917101,61.748606,1,0
0,0,10,10,9,14,23,123,66,189,0.000333,0.284984,16,13679.25136,759.958409,854.95321,81.832294,1,0
0,0,2,2,9,10,19,26,14,40,0.000333,0.056639,4,679.668402,37.759356,169.917101,61.748606,1,0
0,0,4,4,10,13,23,67,37,104,0.000333,0.156817,10,4704.504434,261.361357,470.450443,81.324997,1,0
0,0,2,2,9,10,19,26,14,40,0.000333,0.056639,4,679.668402,37.759356,169.917101,61.748606,1,0
0,0,2,2,9,10,19,26,14,40,0.000333,0.056639,4,679.668402,37.759356,169.917101,61.748606,1,0
0,0,2,2,9,10,19,26,14,40,0.000333,0.056639,4,679.668402,37.759356,169.917101,61.748606,1,0
0,0,2,2,9,10,19,26,14,40,0.000333,0.056639,4,679.668402,37.759356,169.917101,61.748606,1,0
0,0,3,3,11,12,23,35,18,53,0.000333,0.079916,5,1198.743918,66.596884,239.748784,81.073298,2,0
0,0,2,2,9,10,19,26,14,40,0.000333,0.056639,4,679.668402,37.759356,169.917101,61.748606,1,0
0,0,2,2,9,10,19,26,14,40,0.000333,0.056639,4,679.668402,37.759356,169.917101,61.748606,1,0
0,0,3,3,9,9,18,63,34,97,0.000333,0.134828,12,4853.792702,269.65515,404.482725,57.05865,1,0
0,0,2,2,9,10,19,26,14,40,0.000333,0.056639,4,679.668402,37.759356,169.917101,61.748606,1,0
0,0,2,2,9,10,19,26,14,40,0.000333,0.056639,4,679.668402,37.759356,169.917101,61.748606,1,0
0,0,2,2,9,10,19,26,14,40,0.000333,0.056639,4,679.668402,37.759356,169.917101,61.748606,1,0
0,0,2,2,9,10,19,26,14,40,0.000333,0.056639,4,679.668402,37.759356,169.917101,61.748606,1,0
0,0,2,2,9,10,19,26,14,40,0.000333,0.056639,4,679.668402,37.759356,169.917101,61.748606,2,0
0,0,2,2,9,10,19,26,14,40,0.000333,0.056639,4,679.668402,37.759356,169.917101,61.748606,1,0
0,0,2,2,9,10,19,26,14,40,0.000333,0.056639,4,679.668402,37.759356,169.917101,61.748606,2,0
0,0,5,5,13,101,114,424,267,691,0.000333,1.573842,12,56658.324,3147.684667,4721.527,720.585076,7,0
0,0,2,2,9,10,19,26,14,40,0.000333,0.056639,4,679.668402,37.759356,169.917101,61.748606,1,0
0,0,2,2,9,10,19,26,14,40,0.000333,0.056639,4,679.668402,37.759356,169.917101,61.748606,1,0
0,0,2,2,9,10,19,26,14,40,0.000333,0.056639,4,679.668402,37.759356,169.917101,61.748606,1,0
0,0,2,2,9,10,19,26,14,40,0.000333,0.056639,4,679.668402,37.759356,169.917101,61.748606,1,0
0,0,2,2,7,4,11,13,5,18,0.000333,0.020757,3,186.809307,10.378295,62.269769,27.651484,3,0
0,0,5,5,10,20,30,58,36,94,0.000333,0.153749,5,2306.23858,128.124366,461.247716,119.657843,1,0
0,0,3,3,11,11,22,26,15,41,0.000333,0.060946,5,914.183482,50.787971,182.836696,76.107496,3,0
0,0,10,10,15,22,37,70,39,109,0.000333,0.189277,7,3974.812918,220.82294,567.830417,156.710855,6,0
0,0,2,2,7,4,11,13,5,18,0.000333,0.020757,3,186.809307,10.378295,62.269769,27.651484,3,0
0,0,5,5,9,7,16,25,13,38,0.000333,0.050667,4,608,33.777778,152,48.180809,2,0
0,0,17,17,16,23,39,110,55,165,0.000333,0.290697,16,13953.46186,775.192325,872.091366,168.041925,7,0
0,0,5,5,11,13,24,36,21,57,0.000333,0.087114,5,1306.714313,72.59524,261.342863,86.159464,3,0
0,0,2,2,7,4,11,13,5,18,0.000333,0.020757,3,186.809307,10.378295,62.269769,27.651484,3,0
0,0,9,9,13,21,34,53,30,83,0.000333,0.140753,6,2533.556495,140.753139,422.259416,140.344382,1,0
0,0,2,2,7,4,11,13,5,18,0.000333,0.020757,3,186.809307,10.378295,62.269769,27.651484,3,0
0,0,4,4,12,12,24,49,23,72,0.000333,0.110039,6,1980.7038,110.0391,330.1173,86.0391,10,0
0,0,5,5,12,12,24,58,26,84,0.000333,0.128379,12,4621.642201,256.7579,385.13685,86.0391,11,0
0,0,18,18,13,29,42,117,61,178,0.000333,0.319944,12,11517.99002,639.888334,959.832501,188.987165,11,0
0,0,5,5,13,101,114,424,267,691,0.000333,1.573842,12,56658.324,3147.684667,4721.527,720.585076,7,0
0,0,2,2,9,10,19,26,14,40,0.000333,0.056639,4,679.668402,37.759356,169.917101,61.748606,1,0
0,0,3,3,9,9,18,63,34,97,0.000333,0.134828,12,4853.792702,269.65515,404.482725,57.05865,1,0
0,0,2,2,9,10,19,26,14,40,0.000333,0.056639,4,679.668402,37.759356,169.917101,61.748606,1,0
0,0,2,2,9,10,19,26,14,40,0.000333,0.056639,4,679.668402,37.759356,169.917101,61.748606,1,0
0,0,2,2,9,10,19,26,14,40,0.000333,0.056639,4,679.668402,37.759356,169.917101,61.748606,1,0
0,0,2,2,9,10,19,26,14,40,0.000333,0.056639,4,679.668402,37.759356,169.917101,61.748606,1,0
0,0,2,2,9,10,19,26,14,40,0.000333,0.056639,4,679.668402,37.759356,169.917101,61.748606,1,0
0,0,2,2,9,10,19,26,14,40,0.000333,0.056639,4,679.668402,37.759356,169.917101,61.748606,1,0
0,0,2,2,9,10,19,26,14,40,0.000333,0.056639,4,679.668402,37.759356,169.917101,61.748606,1,0
0,0,2,2,9,10,19,26,14,40,0.000333,0.056639,4,679.668402,37.759356,169.917101,61.748606,1,0
0,0,2,2,9,10,19,26,14,40,0.000333,0.056639,4,679.668402,37.759356,169.917101,61.748606,1,0
0,0,2,2,9,10,19,26,14,40,0.000333,0.056639,4,679.668402,37.759356,169.917101,61.748606,1,0
0,0,2,2,9,10,19,26,14,40,0.000333,0.056639,4,679.668402,37.759356,169.917101,61.748606,1,0
0,0,2,2,9,10,19,26,14,40,0.000333,0.056639,4,679.668402,37.759356,169.917101,61.748606,1,0
0,0,2,2,9,10,19,26,14,40,0.000333,0.056639,4,679.668402,37.759356,169.917101,61.748606,1,0
0,0,4,4,10,13,23,67,37,104,0.000333,0.156817,10,4704.504434,261.361357,470.450443,81.324997,1,0
0,0,2,2,9,10,19,26,14,40,0.000333,0.056639,4,679.668402,37.759356,169.917101,61.748606,2,0
0,0,10,10,9,14,23,123,66,189,0.000333,0.284984,16,13679.25136,759.958409,854.95321,81.832294,1,0
0,0,2,2,9,10,19,26,14,40,0.000333,0.056639,4,679.668402,37.759356,169.917101,61.748606,1,0
0,0,2,2,9,10,19,26,14,40,0.000333,0.056639,4,679.668402,37.759356,169.917101,61.748606,1,0
0,0,2,2,9,10,19,26,14,40,0.000333,0.056639,4,679.668402,37.759356,169.917101,61.748606,2,0
0,0,3,3,11,12,23,35,18,53,0.000333,0.079916,5,1198.743918,66.596884,239.748784,81.073298,2,0
0,0,2,2,9,10,19,26,14,40,0.000333,0.056639,4,679.668402,37.759356,169.917101,61.748606,1,0
0,0,3,3,11,11,22,26,15,41,0.000333,0.060946,5,914.183482,50.787971,182.836696,76.107496,3,0
0,0,10,10,15,22,37,70,39,109,0.000333,0.189277,7,3974.812918,220.82294,567.830417,156.710855,6,0
0,0,2,2,7,4,11,13,5,18,0.000333,0.020757,3,186.809307,10.378295,62.269769,27.651484,3,0
0,0,2,2,5,6,11,9,7,16,0.000333,0.01845,2,110.701812,6.150101,55.350906,27.119415,1,0
0,0,19,19,14,27,41,131,58,189,0.000333,0.337526,14,14176.0826,787.560145,1012.577329,181.684931,6,0
0,0,2,2,7,4,11,13,5,18,0.000333,0.020757,3,186.809307,10.378295,62.269769,27.651484,3,0
0,0,27,27,17,38,55,141,81,222,0.000333,0.427821,16,20535.3897,1140.854983,1283.461856,268.908114,10,0
0,0,3,3,11,11,22,26,15,41,0.000333,0.060946,5,914.183482,50.787971,182.836696,76.107496,3,0
0,0,10,10,15,22,37,70,39,109,0.000333,0.189277,7,3974.812918,220.82294,567.830417,156.710855,6,0
0,0,3,3,11,11,22,26,15,41,0.000333,0.060946,5,914.183482,50.787971,182.836696,76.107496,3,0
0,0,10,10,15,22,37,70,39,109,0.000333,0.189277,7,3974.812918,220.82294,567.830417,156.710855,6,0
0,0,17,17,16,23,39,110,55,165,0.000333,0.290697,16,13953.46186,775.192325,872.091366,168.041925,7,0
0,0,2,2,7,4,11,13,5,18,0.000333,0.020757,3,186.809307,10.378295,62.269769,27.651484,3,0
0,0,16,16,12,24,36,86,46,132,0.000333,0.227477,6,4094.580601,227.4767,682.4301,153.05865,6,0
0,0,3,3,14,7,21,33,13,46,0.000333,0.067349,7,1414.32621,78.573678,202.046601,72.954453,2,0
0,0,7,7,12,19,31,51,37,88,0.000333,0.145323,6,2615.815652,145.323092,435.969275,123.730173,5,0
0,0,2,2,11,8,19,25,12,37,0.000333,0.052391,5,785.86659,43.659255,157.173318,62.053748,2,0
0,0,3,3,11,11,22,26,15,41,0.000333,0.060946,5,914.183482,50.787971,182.836696,76.107496,3,0
0,0,10,10,15,22,37,70,39,109,0.000333,0.189277,7,3974.812918,220.82294,567.830417,156.710855,6,0
0,0,5,5,10,9,19,23,14,37,0.000333,0.052391,5,785.86659,43.659255,157.173318,61.748606,2,0
0,0,17,17,16,23,39,110,55,165,0.000333,0.290697,16,13953.46186,775.192325,872.091366,168.041925,7,0
0,0,5,5,11,13,24,26,20,46,0.000333,0.070303,5,1054.541375,58.585632,210.908275,86.159464,1,0
0,0,3,3,11,11,22,26,15,41,0.000333,0.060946,5,914.183482,50.787971,182.836696,76.107496,3,0
0,0,10,10,15,22,37,70,39,109,0.000333,0.189277,7,3974.812918,220.82294,567.830417,156.710855,6,0
0,0,2,2,7,4,11,13,5,18,0.000333,0.020757,3,186.809307,10.378295,62.269769,27.651484,3,0
0,0,6,6,16,12,28,47,24,71,0.000333,0.113774,16,5461.155191,303.397511,341.322199,107.01955,4,0
0,0,35,35,18,50,68,179,103,282,0.000333,0.572222,18,30899.96138,1716.664521,1716.664521,357.25146,10,0
0,0,3,3,11,11,22,26,15,41,0.000333,0.060946,5,914.183482,50.787971,182.836696,76.107496,3,0
0,0,10,10,15,22,37,70,39,109,0.000333,0.189277,7,3974.812918,220.82294,567.830417,156.710855,6,0
0,0,2,2,7,4,11,13,5,18,0.000333,0.020757,3,186.809307,10.378295,62.269769,27.651484,3,0
0,0,2,2,7,4,11,13,5,18,0.000333,0.020757,3,186.809307,10.378295,62.269769,27.651484,3,0
0,0,4,4,12,12,24,49,23,72,0.000333,0.110039,6,1980.7038,110.0391,330.1173,86.0391,10,0
0,0,5,5,12,12,24,58,26,84,0.000333,0.128379,12,4621.642201,256.7579,385.13685,86.0391,11,0
0,0,5,5,13,101,114,424,267,691,0.000333,1.573842,12,56658.324,3147.684667,4721.527,720.585076,7,0
0,0,2,2,9,10,19,26,14,40,0.000333,0.056639,4,679.668402,37.759356,169.917101,61.748606,1,0
0,0,3,3,9,9,18,63,34,97,0.000333,0.134828,12,4853.792702,269.65515,404.482725,57.05865,1,0
0,0,2,2,9,10,19,26,14,40,0.000333,0.056639,4,679.668402,37.759356,169.917101,61.748606,1,0
0,0,2,2,9,10,19,26,14,40,0.000333,0.056639,4,679.668402,37.759356,169.917101,61.748606,1,0
0,0,2,2,9,10,19,26,14,40,0.000333,0.056639,4,679.668402,37.759356,169.917101,61.748606,1,0
0,0,2,2,9,10,19,26,14,40,0.000333,0.056639,4,679.668402,37.759356,169.917101,61.748606,1,0
0,0,2,2,9,10,19,26,14,40,0.000333,0.056639,4,679.668402,37.759356,169.917101,61.748606,1,0
0,0,2,2,9,10,19,26,14,40,0.000333,0.056639,4,679.668402,37.759356,169.917101,61.748606,1,0
0,0,2,2,9,10,19,26,14,40,0.000333,0.056639,4,679.668402,37.759356,169.917101,61.748606,1,0
0,0,2,2,9,10,19,26,14,40,0.000333,0.056639,4,679.668402,37.759356,169.917101,61.748606,1,0
0,0,2,2,9,10,19,26,14,40,0.000333,0.056639,4,679.668402,37.759356,169.917101,61.748606,1,0
0,0,2,2,9,10,19,26,14,40,0.000333,0.056639,4,679.668402,37.759356,169.917101,61.748606,1,0
0,0,2,2,9,10,19,26,14,40,0.000333,0.056639,4,679.668402,37.759356,169.917101,61.748606,1,0
0,0,2,2,9,10,19,26,14,40,0.000333,0.056639,4,679.668402,37.759356,169.917101,61.748606,1,0
0,0,2,2,9,10,19,26,14,40,0.000333,0.056639,4,679.668402,37.759356,169.917101,61.748606,1,0
0,0,4,4,10,13,23,67,37,104,0.000333,0.156817,10,4704.504434,261.361357,470.450443,81.324997,1,0
0,0,2,2,9,10,19,26,14,40,0.000333,0.056639,4,679.668402,37.759356,169.917101,61.748606,2,0
0,0,10,10,9,14,23,123,66,189,0.000333,0.284984,16,13679.25136,759.958409,854.95321,81.832294,1,0
0,0,2,2,9,10,19,26,14,40,0.000333,0.056639,4,679.668402,37.759356,169.917101,61.748606,1,0
0,0,2,2,9,10,19,26,14,40,0.000333,0.056639,4,679.668402,37.759356,169.917101,61.748606,1,0
0,0,2,2,9,10,19,26,14,40,0.000333,0.056639,4,679.668402,37.759356,169.917101,61.748606,2,0
0,0,3,3,11,12,23,35,18,53,0.000333,0.079916,5,1198.743918,66.596884,239.748784,81.073298,2,0
0,0,2,2,9,10,19,26,14,40,0.000333,0.056639,4,679.668402,37.759356,169.917101,61.748606,1,0
0,0,17,17,16,23,39,110,55,165,0.000333,0.290697,16,13953.46186,775.192325,872.091366,168.041925,7,0
0,0,5,5,10,20,30,58,36,94,0.000333,0.153749,5,2306.23858,128.124366,461.247716,119.657843,1,0
0,0,17,17,16,23,39,110,55,165,0.000333,0.290697,16,13953.46186,775.192325,872.091366,168.041925,7,0
0,0,2,2,7,4,11,13,5,18,0.000333,0.020757,3,186.809307,10.378295,62.269769,27.651484,3,0
0,0,16,16,14,27,41,93,50,143,0.000333,0.255377,7,5362.909557,297.93942,766.129937,181.684931,5,0
0,0,3,3,11,11,22,26,15,41,0.000333,0.060946,5,914.183482,50.787971,182.836696,76.107496,3,0
0,0,10,10,15,22,37,70,39,109,0.000333,0.189277,7,3974.812918,220.82294,567.830417,156.710855,6,0
0,0,5,5,11,13,24,36,21,57,0.000333,0.087114,5,1306.714313,72.59524,261.342863,86.159464,3,0
0,0,29,29,20,41,61,157,84,241,0.000333,0.476436,20,28586.15397,1588.119665,1429.307698,306.098194,11,0
0,0,2,2,7,4,11,13,5,18,0.000333,0.020757,3,186.809307,10.378295,62.269769,27.651484,3,0
0,0,19,19,17,27,44,116,70,186,0.000333,0.338485,16,16247.2685,902.626028,1015.454281,197.868831,6,0
0,0,5,5,11,13,24,36,21,57,0.000333,0.087114,5,1306.714313,72.59524,261.342863,86.159464,5,0
0,0,6,6,15,11,26,56,26,82,0.000333,0.128479,14,5396.104796,299.7836,385.436057,96.657107,4,0
0,0,5,5,12,12,24,58,26,84,0.000333,0.128379,12,4621.642201,256.7579,385.13685,86.0391,11,0
0,0,2,2,7,4,11,13,5,18,0.000333,0.020757,3,186.809307,10.378295,62.269769,27.651484,3,0
0,0,4,4,12,12,24,49,23,72,0.000333,0.110039,6,1980.7038,110.0391,330.1173,86.0391,10,0
0,0,2,2,9,10,19,26,14,40,0.000333,0.056639,4,679.668402,37.759356,169.917101,61.748606,2,0
0,0,2,2,9,10,19,26,14,40,0.000333,0.056639,4,679.668402,37.759356,169.917101,61.748606,1,0
0,0,2,2,9,10,19,26,14,40,0.000333,0.056639,4,679.668402,37.759356,169.917101,61.748606,1,0
0,0,3,3,11,12,23,35,18,53,0.000333,0.079916,5,1198.743918,66.596884,239.748784,81.073298,2,0
0,0,2,2,9,10,19,26,14,40,0.000333,0.056639,4,679.668402,37.759356,169.917101,61.748606,1,0
0,0,4,4,10,13,23,67,37,104,0.000333,0.156817,10,4704.504434,261.361357,470.450443,81.324997,1,0
0,0,10,10,9,14,23,123,66,189,0.000333,0.284984,16,13679.25136,759.958409,854.95321,81.832294,1,0
0,0,2,2,9,10,19,26,14,40,0.000333,0.056639,4,679.668402,37.759356,169.917101,61.748606,1,0
0,0,2,2,9,10,19,26,14,40,0.000333,0.056639,4,679.668402,37.759356,169.917101,61.748606,1,0
0,0,2,2,9,10,19,26,14,40,0.000333,0.056639,4,679.668402,37.759356,169.917101,61.748606,1,0
0,0,2,2,9,10,19,26,14,40,0.000333,0.056639,4,679.668402,37.759356,169.917101,61.748606,1,0
0,0,2,2,9,10,19,26,14,40,0.000333,0.056639,4,679.668402,37.759356,169.917101,61.748606,1,0
0,0,2,2,9,10,19,26,14,40,0.000333,0.056639,4,679.668402,37.759356,169.917101,61.748606,1,0
0,0,2,2,9,10,19,26,14,40,0.000333,0.056639,4,679.668402,37.759356,169.917101,61.748606,1,0
0,0,2,2,9,10,19,26,14,40,0.000333,0.056639,4,679.668402,37.759356,169.917101,61.748606,2,0
0,0,2,2,9,10,19,26,14,40,0.000333,0.056639,4,679.668402,37.759356,169.917101,61.748606,1,0
0,0,5,5,13,101,114,424,267,691,0.000333,1.573842,12,56658.324,3147.684667,4721.527,720.585076,7,0
0,0,2,2,9,10,19,26,14,40,0.000333,0.056639,4,679.668402,37.759356,169.917101,61.748606,1,0
0,0,3,3,9,9,18,63,34,97,0.000333,0.134828,12,4853.792702,269.65515,404.482725,57.05865,1,0
0,0,2,2,9,10,19,26,14,40,0.000333,0.056639,4,679.668402,37.759356,169.917101,61.748606,1,0
0,0,2,2,9,10,19,26,14,40,0.000333,0.056639,4,679.668402,37.759356,169.917101,61.748606,1,0
0,0,2,2,9,10,19,26,14,40,0.000333,0.056639,4,679.668402,37.759356,169.917101,61.748606,1,0
0,0,2,2,9,10,19,26,14,40,0.000333,0.056639,4,679.668402,37.759356,169.917101,61.748606,1,0
0,0,2,2,9,10,19,26,14,40,0.000333,0.056639,4,679.668402,37.759356,169.917101,61.748606,1,0
0,0,3,3,11,11,22,26,15,41,0.000333,0.060946,5,914.183482,50.787971,182.836696,76.107496,3,0
0,0,10,10,15,22,37,70,39,109,0.000333,0.189277,7,3974.812918,220.82294,567.830417,156.710855,6,0
0,0,4,4,11,11,22,36,21,57,0.000333,0.084729,5,1270.938011,70.607667,254.187602,76.107496,1,0
0,0,5,5,9,7,16,20,11,31,0.000333,0.041333,4,496,27.555556,124,48.180809,3,0
0,0,5,5,11,13,24,36,21,57,0.000333,0.087114,5,1306.714313,72.59524,261.342863,86.159464,3,0
0,0,28,28,19,38,57,154,81,235,0.000333,0.45691,18,24673.12476,1370.729153,1370.729153,280.131868,10,0
0,0,2,2,7,4,11,13,5,18,0.000333,0.020757,3,186.809307,10.378295,62.269769,27.651484,3,0
0,0,4,4,10,9,19,54,15,69,0.000333,0.097702,5,1465.534992,81.418611,293.106998,61.748606,2,0
0,0,3,3,11,11,22,26,15,41,0.000333,0.060946,5,914.183482,50.787971,182.836696,76.107496,3,0
0,0,10,10,15,22,37,70,39,109,0.000333,0.189277,7,3974.812918,220.82294,567.830417,156.710855,6,0
0,0,23,23,12,31,43,136,71,207,0.000333,0.374412,12,13478.84165,748.824536,1123.236804,196.599636,7,0
0,0,22,22,17,34,51,128,68,196,0.000333,0.370598,16,17788.72587,988.262548,1111.795367,242.460605,8,0
0,0,2,2,7,4,11,13,5,18,0.000333,0.020757,3,186.809307,10.378295,62.269769,27.651484,3,0
0,0,5,5,10,10,20,27,15,42,0.000333,0.060507,5,907.6049,50.422494,181.52098,66.438562,2,0
0,0,3,3,11,11,22,26,15,41,0.000333,0.060946,5,914.183482,50.787971,182.836696,76.107496,3,0
0,0,10,10,15,22,37,70,39,109,0.000333,0.189277,7,3974.812918,220.82294,567.830417,156.710855,6,0
0,0,3,3,11,11,22,26,15,41,0.000333,0.060946,5,914.183482,50.787971,182.836696,76.107496,3,0
0,0,10,10,15,22,37,70,39,109,0.000333,0.189277,7,3974.812918,220.82294,567.830417,156.710855,6,0
0,0,5,5,12,12,24,58,26,84,0.000333,0.128379,12,4621.642201,256.7579,385.13685,86.0391,11,0
0,0,2,2,7,4,11,13,5,18,0.000333,0.020757,3,186.809307,10.378295,62.269769,27.651484,3,0
0,0,4,4,12,12,24,49,23,72,0.000333,0.110039,6,1980.7038,110.0391,330.1173,86.0391,10,0
0,0,26,26,17,35,52,140,73,213,0.000333,0.404731,16,19427.09856,1079.283253,1214.19366,249.011774,10,0
0,0,24,24,13,32,45,141,73,214,0.000333,0.391752,12,14103.07875,783.504375,1175.256563,208.105716,7,0
0,0,2,2,5,6,11,9,7,16,0.000333,0.01845,2,110.701812,6.150101,55.350906,27.119415,1,0
0,0,2,2,9,10,19,26,14,40,0.000333,0.056639,4,679.668402,37.759356,169.917101,61.748606,1,0
0,0,2,2,9,10,19,26,14,40,0.000333,0.056639,4,679.668402,37.759356,169.917101,61.748606,1,0
0,0,2,2,9,10,19,26,14,40,0.000333,0.056639,4,679.668402,37.759356,169.917101,61.748606,1,0
0,0,2,2,9,10,19,26,14,40,0.000333,0.056639,4,679.668402,37.759356,169.917101,61.748606,2,0
0,0,2,2,9,10,19,26,14,40,0.000333,0.056639,4,679.668402,37.759356,169.917101,61.748606,1,0
0,0,2,2,9,10,19,26,14,40,0.000333,0.056639,4,679.668402,37.759356,169.917101,61.748606,1,0
0,0,5,5,13,101,114,424,267,691,0.000333,1.573842,12,56658.324,3147.684667,4721.527,720.585076,7,0
0,0,2,2,9,10,19,26,14,40,0.000333,0.056639,4,679.668402,37.759356,169.917101,61.748606,1,0
0,0,2,2,9,10,19,26,14,40,0.000333,0.056639,4,679.668402,37.759356,169.917101,61.748606,1,0
0,0,3,3,9,9,18,63,34,97,0.000333,0.134828,12,4853.792702,269.65515,404.482725,57.05865,1,0
0,0,2,2,9,10,19,26,14,40,0.000333,0.056639,4,679.668402,37.759356,169.917101,61.748606,1,0
0,0,10,10,9,14,23,123,66,189,0.000333,0.284984,16,13679.25136,759.958409,854.95321,81.832294,1,0
0,0,2,2,9,10,19,26,14,40,0.000333,0.056639,4,679.668402,37.759356,169.917101,61.748606,1,0
0,0,3,3,11,12,23,35,18,53,0.000333,0.079916,5,1198.743918,66.596884,239.748784,81.073298,2,0
0,0,2,2,9,10,19,26,14,40,0.000333,0.056639,4,679.668402,37.759356,169.917101,61.748606,1,0
0,0,2,2,9,10,19,26,14,40,0.000333,0.056639,4,679.668402,37.759356,169.917101,61.748606,1,0
0,0,2,2,9,10,19,26,14,40,0.000333,0.056639,4,679.668402,37.759356,169.917101,61.748606,1,0
0,0,2,2,9,10,19,26,14,40,0.000333,0.056639,4,679.668402,37.759356,169.917101,61.748606,1,0
0,0,2,2,9,10,19,26,14,40,0.000333,0.056639,4,679.668402,37.759356,169.917101,61.748606,2,0
0,0,2,2,9,10,19,26,14,40,0.000333,0.056639,4,679.668402,37.759356,169.917101,61.748606,1,0
0,0,2,2,9,10,19,26,14,40,0.000333,0.056639,4,679.668402,37.759356,169.917101,61.748606,1,0
0,0,2,2,9,10,19,26,14,40,0.000333,0.056639,4,679.668402,37.759356,169.917101,61.748606,1,0
0,0,2,2,9,10,19,26,14,40,0.000333,0.056639,4,679.668402,37.759356,169.917101,61.748606,1,0
0,0,4,4,10,13,23,67,37,104,0.000333,0.156817,10,4704.504434,261.361357,470.450443,81.324997,1,0
0,0,2,2,7,4,11,13,5,18,0.000333,0.020757,3,186.809307,10.378295,62.269769,27.651484,3,0
0,0,4,4,12,12,24,49,23,72,0.000333,0.110039,6,1980.7038,110.0391,330.1173,86.0391,10,0
0,0,28,28,19,37,56,153,80,233,0.000333,0.451038,18,24356.04654,1353.113697,1353.113697,273.460397,10,0
0,0,5,5,12,12,24,58,26,84,0.000333,0.128379,12,4621.642201,256.7579,385.13685,86.0391,11,0
0,0,17,17,12,25,37,105,52,157,0.000333,0.272628,12,9814.610141,545.256119,817.884178,159.115955,6,0
0,0,18,18,13,27,40,107,63,170,0.000333,0.301576,12,10856.73331,603.151851,904.727776,176.487679,1,0
0,0,5,5,13,101,114,424,267,691,0.000333,1.573842,12,56658.324,3147.684667,4721.527,720.585076,7,0
0,0,2,2,9,10,19,26,14,40,0.000333,0.056639,4,679.668402,37.759356,169.917101,61.748606,1,0
0,0,3,3,9,9,18,63,34,97,0.000333,0.134828,12,4853.792702,269.65515,404.482725,57.05865,1,0
0,0,2,2,9,10,19,26,14,40,0.000333,0.056639,4,679.668402,37.759356,169.917101,61.748606,1,0
0,0,2,2,9,10,19,26,14,40,0.000333,0.056639,4,679.668402,37.759356,169.917101,61.748606,1,0
0,0,2,2,9,10,19,26,14,40,0.000333,0.056639,4,679.668402,37.759356,169.917101,61.748606,1,0
0,0,2,2,9,10,19,26,14,40,0.000333,0.056639,4,679.668402,37.759356,169.917101,61.748606,1,0
0,0,2,2,9,10,19,26,14,40,0.000333,0.056639,4,679.668402,37.759356,169.917101,61.748606,1,0
0,0,2,2,9,10,19,26,14,40,0.000333,0.056639,4,679.668402,37.759356,169.917101,61.748606,1,0
0,0,2,2,9,10,19,26,14,40,0.000333,0.056639,4,679.668402,37.759356,169.917101,61.748606,1,0
0,0,2,2,9,10,19,26,14,40,0.000333,0.056639,4,679.668402,37.759356,169.917101,61.748606,1,0
0,0,2,2,9,10,19,26,14,40,0.000333,0.056639,4,679.668402,37.759356,169.917101,61.748606,1,0
0,0,2,2,9,10,19,26,14,40,0.000333,0.056639,4,679.668402,37.759356,169.917101,61.748606,1,0
0,0,2,2,9,10,19,26,14,40,0.000333,0.056639,4,679.668402,37.759356,169.917101,61.748606,1,0
0,0,2,2,9,10,19,26,14,40,0.000333,0.056639,4,679.668402,37.759356,169.917101,61.748606,1,0
0,0,2,2,9,10,19,26,14,40,0.000333,0.056639,4,679.668402,37.759356,169.917101,61.748606,1,0
0,0,4,4,10,13,23,67,37,104,0.000333,0.156817,10,4704.504434,261.361357,470.450443,81.324997,1,0
0,0,2,2,9,10,19,26,14,40,0.000333,0.056639,4,679.668402,37.759356,169.917101,61.748606,2,0
0,0,10,10,9,14,23,123,66,189,0.000333,0.284984,16,13679.25136,759.958409,854.95321,81.832294,1,0
0,0,2,2,9,10,19,26,14,40,0.000333,0.056639,4,679.668402,37.759356,169.917101,61.748606,1,0
0,0,2,2,9,10,19,26,14,40,0.000333,0.056639,4,679.668402,37.759356,169.917101,61.748606,1,0
0,0,2,2,9,10,19,26,14,40,0.000333,0.056639,4,679.668402,37.759356,169.917101,61.748606,2,0
0,0,3,3,11,12,23,35,18,53,0.000333,0.079916,5,1198.743918,66.596884,239.748784,81.073298,2,0
0,0,2,2,9,10,19,26,14,40,0.000333,0.056639,4,679.668402,37.759356,169.917101,61.748606,1,0
0,0,5,5,11,13,24,36,21,57,0.000333,0.087114,5,1306.714313,72.59524,261.342863,86.159464,3,0
0,0,3,3,13,21,34,35,33,68,0.000333,0.115316,6,2075.684839,115.315824,345.947473,140.344382,3,0
0,0,17,17,16,23,39,110,55,165,0.000333,0.290697,16,13953.46186,775.192325,872.091366,168.041925,7,0
0,0,20,20,19,27,46,157,73,230,0.000333,0.423473,18,22867.5465,1270.41925,1270.41925,209.092585,10,0
0,0,2,2,7,4,11,13,5,18,0.000333,0.020757,3,186.809307,10.378295,62.269769,27.651484,3,0
0,0,19,19,19,27,46,152,72,224,0.000333,0.412426,18,22271.00181,1237.277878,1237.277878,209.092585,9,0
0,0,23,23,20,29,49,181,80,261,0.000333,0.48848,20,29308.78539,1628.265855,1465.439269,227.320011,12,0
0,0,7,7,13,28,41,61,51,112,0.000333,0.200015,6,3600.274947,200.015275,600.045825,182.711654,1,0
0,0,2,2,10,3,13,13,5,18,0.000333,0.022203,5,333.039575,18.502199,66.607915,37.974168,1,0
0,0,5,5,11,13,24,36,21,57,0.000333,0.087114,5,1306.714313,72.59524,261.342863,86.159464,3,0
0,0,2,2,7,4,11,13,5,18,0.000333,0.020757,3,186.809307,10.378295,62.269769,27.651484,3,0
0,0,6,6,15,11,26,56,26,82,0.000333,0.128479,14,5396.104796,299.7836,385.436057,96.657107,4,0
0,0,5,5,11,13,24,36,21,57,0.000333,0.087114,5,1306.714313,72.59524,261.342863,86.159464,3,0
0,0,28,28,19,38,57,154,81,235,0.000333,0.45691,18,24673.12476,1370.729153,1370.729153,280.131868,10,0
0,0,2,2,7,4,11,13,5,18,0.000333,0.020757,3,186.809307,10.378295,62.269769,27.651484,3,0
0,0,2,2,7,4,11,13,5,18,0.000333,0.020757,3,186.809307,10.378295,62.269769,27.651484,3,0
0,0,17,17,16,23,39,110,55,165,0.000333,0.290697,16,13953.46186,775.192325,872.091366,168.041925,7,0
0,0,6,6,16,12,28,47,24,71,0.000333,0.113774,16,5461.155191,303.397511,341.322199,107.01955,4,0
0,0,2,2,7,4,11,13,5,18,0.000333,0.020757,3,186.809307,10.378295,62.269769,27.651484,3,0
0,0,17,17,15,28,43,95,51,146,0.000333,0.264078,7,5545.642579,308.091254,792.234654,193.209297,5,0
0,0,17,17,16,23,39,110,55,165,0.000333,0.290697,16,13953.46186,775.192325,872.091366,168.041925,7,0
0,0,2,2,7,4,11,13,5,18,0.000333,0.020757,3,186.809307,10.378295,62.269769,27.651484,3,0
0,0,16,16,13,26,39,87,48,135,0.000333,0.237843,6,4281.175797,237.8431,713.5293,170.317149,5,0
0,0,6,6,13,31,44,240,168,408,0.000333,0.742483,30,66823.44301,3712.413501,2227.4481,201.685802,1,0
0,0,3,3,11,11,22,26,15,41,0.000333,0.060946,5,914.183482,50.787971,182.836696,76.107496,3,0
0,0,10,10,15,22,37,70,39,109,0.000333,0.189277,7,3974.812918,220.82294,567.830417,156.710855,6,0
0,0,26,26,17,35,52,138,73,211,0.000333,0.400931,16,19244.68449,1069.149138,1202.792781,249.011774,10,0
0,0,2,2,5,6,11,9,7,16,0.000333,0.01845,2,110.701812,6.150101,55.350906,27.119415,2,0
0,0,2,2,7,4,11,13,5,18,0.000333,0.020757,3,186.809307,10.378295,62.269769,27.651484,3,0
0,0,18,18,15,35,50,109,62,171,0.000333,0.3217,7,6755.695859,375.316437,965.099408,238.128265,5,0
0,0,17,17,16,23,39,110,55,165,0.000333,0.290697,16,13953.46186,775.192325,872.091366,168.041925,7,0
0,0,2,2,7,4,11,13,5,18,0.000333,0.020757,3,186.809307,10.378295,62.269769,27.651484,3,0
0,0,6,6,14,14,28,39,21,60,0.000333,0.096147,7,2019.089067,112.171615,288.441295,106.605938,2,0
0,0,5,5,11,13,24,36,21,57,0.000333,0.087114,5,1306.714313,72.59524,261.342863,86.159464,3,0
0,0,17,17,16,23,39,110,55,165,0.000333,0.290697,16,13953.46186,775.192325,872.091366,168.041925,7,0
0,0,2,2,7,4,11,13,5,18,0.000333,0.020757,3,186.809307,10.378295,62.269769,27.651484,3,0
0,0,5,5,11,13,24,36,21,57,0.000333,0.087114,5,1306.714313,72.59524,261.342863,86.159464,3,0
0,0,4,4,12,12,24,49,23,72,0.000333,0.110039,6,1980.7038,110.0391,330.1173,86.0391,10,0
0,0,2,2,7,4,11,13,5,18,0.000333,0.020757,3,186.809307,10.378295,62.269769,27.651484,3,0
0,0,5,5,12,12,24,58,26,84,0.000333,0.128379,12,4621.642201,256.7579,385.13685,86.0391,11,0
0,0,2,2,9,10,19,26,14,40,0.000333,0.056639,4,679.668402,37.759356,169.917101,61.748606,1,0
0,0,10,10,9,14,23,123,66,189,0.000333,0.284984,16,13679.25136,759.958409,854.95321,81.832294,1,0
0,0,2,2,9,10,19,26,14,40,0.000333,0.056639,4,679.668402,37.759356,169.917101,61.748606,1,0
0,0,4,4,10,13,23,67,37,104,0.000333,0.156817,10,4704.504434,261.361357,470.450443,81.324997,1,0
0,0,2,2,9,10,19,26,14,40,0.000333,0.056639,4,679.668402,37.759356,169.917101,61.748606,1,0
0,0,2,2,9,10,19,26,14,40,0.000333,0.056639,4,679.668402,37.759356,169.917101,61.748606,1,0
0,0,2,2,9,10,19,26,14,40,0.000333,0.056639,4,679.668402,37.759356,169.917101,61.748606,1,0
0,0,2,2,9,10,19,26,14,40,0.000333,0.056639,4,679.668402,37.759356,169.917101,61.748606,1,0
0,0,3,3,11,12,23,35,18,53,0.000333,0.079916,5,1198.743918,66.596884,239.748784,81.073298,2,0
0,0,2,2,9,10,19,26,14,40,0.000333,0.056639,4,679.668402,37.759356,169.917101,61.748606,1,0
0,0,2,2,9,10,19,26,14,40,0.000333,0.056639,4,679.668402,37.759356,169.917101,61.748606,1,0
0,0,3,3,9,9,18,63,34,97,0.000333,0.134828,12,4853.792702,269.65515,404.482725,57.05865,1,0
0,0,2,2,9,10,19,26,14,40,0.000333,0.056639,4,679.668402,37.759356,169.917101,61.748606,1,0
0,0,2,2,9,10,19,26,14,40,0.000333,0.056639,4,679.668402,37.759356,169.917101,61.748606,1,0
0,0,2,2,9,10,19,26,14,40,0.000333,0.056639,4,679.668402,37.759356,169.917101,61.748606,1,0
0,0,2,2,9,10,19,26,14,40,0.000333,0.056639,4,679.668402,37.759356,169.917101,61.748606,1,0
0,0,2,2,9,10,19,26,14,40,0.000333,0.056639,4,679.668402,37.759356,169.917101,61.748606,2,0
0,0,2,2,9,10,19,26,14,40,0.000333,0.056639,4,679.668402,37.759356,169.917101,61.748606,1,0
0,0,2,2,9,10,19,26,14,40,0.000333,0.056639,4,679.668402,37.759356,169.917101,61.748606,2,0
0,0,5,5,13,101,114,424,267,691,0.000333,1.573842,12,56658.324,3147.684667,4721.527,720.585076,7,0
0,0,2,2,9,10,19,26,14,40,0.000333,0.056639,4,679.668402,37.759356,169.917101,61.748606,1,0
0,0,2,2,9,10,19,26,14,40,0.000333,0.056639,4,679.668402,37.759356,169.917101,61.748606,1,0
0,0,2,2,9,10,19,26,14,40,0.000333,0.056639,4,679.668402,37.759356,169.917101,61.748606,1,0
0,0,2,2,9,10,19,26,14,40,0.000333,0.056639,4,679.668402,37.759356,169.917101,61.748606,1,0
0,0,19,19,13,28,41,127,60,187,0.000333,0.333954,12,12022.3467,667.90815,1001.862225,182.711654,10,0
0,0,2,2,7,4,11,13,5,18,0.000333,0.020757,3,186.809307,10.378295,62.269769,27.651484,3,0
0,0,28,28,19,38,57,153,81,234,0.000333,0.454965,18,24568.13274,1364.896263,1364.896263,280.131868,10,0
0,0,5,5,11,13,24,26,20,46,0.000333,0.070303,5,1054.541375,58.585632,210.908275,86.159464,1,0
0,0,22,22,14,30,44,130,74,204,0.000333,0.371241,14,15592.1367,866.229817,1113.72405,200.509687,5,0
0,0,3,3,11,11,22,26,15,41,0.000333,0.060946,5,914.183482,50.787971,182.836696,76.107496,3,0
0,0,10,10,15,22,37,70,39,109,0.000333,0.189277,7,3974.812918,220.82294,567.830417,156.710855,6,0
0,0,5,5,11,13,24,36,21,57,0.000333,0.087114,5,1306.714313,72.59524,261.342863,86.159464,3,0
0,0,17,17,16,23,39,110,55,165,0.000333,0.290697,16,13953.46186,775.192325,872.091366,168.041925,7,0
0,0,2,2,7,4,11,13,5,18,0.000333,0.020757,3,186.809307,10.378295,62.269769,27.651484,3,0
0,0,14,14,16,20,36,94,67,161,0.000333,0.277453,24,19976.59021,1109.810567,832.357925,150.438562,1,0
0,0,30,30,28,54,82,300,178,478,0.000333,1.01297,42,127634.214,7090.789669,3038.909858,445.369863,20,0
0,0,8,8,13,12,25,43,26,69,0.000333,0.106809,12,3845.112925,213.617385,320.426077,91.125266,4,0
0,0,8,8,12,13,25,41,24,65,0.000333,0.100617,6,1811.103914,100.616884,301.850652,91.125266,4,0
0,0,1,1,10,13,23,26,13,39,0.000333,0.058806,5,882.094581,49.005255,176.418916,81.324997,1,0
0,0,1,1,10,13,23,26,13,39,0.000333,0.058806,5,882.094581,49.005255,176.418916,81.324997,1,0
0,0,1,1,10,13,23,26,13,39,0.000333,0.058806,5,882.094581,49.005255,176.418916,81.324997,1,0
0,0,27,27,19,35,54,148,78,226,0.000333,0.433535,18,23410.88236,1300.604575,1300.604575,260.235528,10,0
0,0,1,1,10,13,23,26,13,39,0.000333,0.058806,5,882.094581,49.005255,176.418916,81.324997,1,0
0,0,8,8,12,12,24,42,26,68,0.000333,0.103926,12,3741.329401,207.851633,311.77745,86.0391,4,0
0,0,9,9,13,12,25,53,31,84,0.000333,0.130028,12,4681.007039,260.055947,390.08392,91.125266,4,0
0,0,9,9,12,12,24,52,31,83,0.000333,0.126851,12,4566.622651,253.701258,380.551888,86.0391,4,0
0,0,1,1,10,13,23,26,13,39,0.000333,0.058806,5,882.094581,49.005255,176.418916,81.324997,1,0
0,0,1,1,10,13,23,26,13,39,0.000333,0.058806,5,882.094581,49.005255,176.418916,81.324997,1,0
0,0,8,8,12,13,25,41,24,65,0.000333,0.100617,6,1811.103914,100.616884,301.850652,91.125266,4,0
0,0,2,2,7,4,11,13,5,18,0.000333,0.020757,3,186.809307,10.378295,62.269769,27.651484,3,0
0,0,8,8,15,17,32,52,30,82,0.000333,0.136667,7,2870,159.444444,410,128.090227,2,0
0,0,3,3,11,11,22,26,15,41,0.000333,0.060946,5,914.183482,50.787971,182.836696,76.107496,3,0
0,0,10,10,15,22,37,70,39,109,0.000333,0.189277,7,3974.812918,220.82294,567.830417,156.710855,6,0
0,0,3,3,11,11,22,26,15,41,0.000333,0.060946,5,914.183482,50.787971,182.836696,76.107496,3,0
0,0,10,10,15,22,37,70,39,109,0.000333,0.189277,7,3974.812918,220.82294,567.830417,156.710855,6,0
0,0,2,2,7,4,11,13,5,18,0.000333,0.020757,3,186.809307,10.378295,62.269769,27.651484,3,0
0,0,33,33,17,53,70,169,105,274,0.000333,0.559808,8,13435.38837,746.410465,1679.423547,373.066652,10,0
0,0,2,2,7,4,11,13,5,18,0.000333,0.020757,3,186.809307,10.378295,62.269769,27.651484,3,0
0,0,3,3,11,11,22,26,15,41,0.000333,0.060946,5,914.183482,50.787971,182.836696,76.107496,3,0
0,0,10,10,15,22,37,70,39,109,0.000333,0.189277,7,3974.812918,220.82294,567.830417,156.710855,6,0
0,0,3,3,11,11,22,26,15,41,0.000333,0.060946,5,914.183482,50.787971,182.836696,76.107496,3,0
0,0,10,10,15,22,37,70,39,109,0.000333,0.189277,7,3974.812918,220.82294,567.830417,156.710855,6,0
0,0,17,17,16,23,39,110,55,165,0.000333,0.290697,16,13953.46186,775.192325,872.091366,168.041925,7,0
0,0,6,6,11,13,24,25,18,43,0.000333,0.065718,5,985.766938,54.76483,197.153388,86.159464,2,0
0,0,5,5,11,13,24,36,21,57,0.000333,0.087114,5,1306.714313,72.59524,261.342863,86.159464,3,0
0,0,17,17,16,23,39,110,55,165,0.000333,0.290697,16,13953.46186,775.192325,872.091366,168.041925,7,0
0,0,2,2,7,4,11,13,5,18,0.000333,0.020757,3,186.809307,10.378295,62.269769,27.651484,3,0
0,0,25,25,18,35,53,134,73,207,0.000333,0.395227,18,21342.23161,1185.679534,1185.679534,254.583556,10,0
0,0,6,6,10,12,22,92,20,112,0.000333,0.166485,5,2497.281706,138.737873,499.456341,76.238831,1,0
0,0,2,2,7,7,14,13,9,22,0.000333,0.027921,3,251.285425,13.960301,83.761808,39.302969,1,0
0,0,2,2,7,6,13,12,8,20,0.000333,0.02467,3,222.026383,12.334799,74.008794,35.161259,1,0
0,0,3,3,8,7,15,18,10,28,0.000333,0.036464,4,437.571747,24.309541,109.392937,43.651484,1,0
0,0,27,27,19,35,54,148,78,226,0.000333,0.433535,18,23410.88236,1300.604575,1300.604575,260.235528,10,0
0,0,28,28,19,38,57,157,84,241,0.000333,0.468575,18,25303.07688,1405.726493,1405.726493,280.131868,10,0
0,0,2,2,7,4,11,13,5,18,0.000333,0.020757,3,186.809307,10.378295,62.269769,27.651484,3,0
0,0,2,2,8,8,16,22,11,33,0.000333,0.044,4,528,29.333333,132,48,1,0
0,0,2,2,7,6,13,12,8,20,0.000333,0.02467,3,222.026383,12.334799,74.008794,35.161259,1,0
0,0,3,3,11,11,22,26,15,41,0.000333,0.060946,5,914.183482,50.787971,182.836696,76.107496,3,0
0,0,10,10,15,22,37,70,39,109,0.000333,0.189277,7,3974.812918,220.82294,567.830417,156.710855,6,0
0,0,5,5,9,9,18,22,14,36,0.000333,0.050039,4,600.4692,33.3594,150.1173,57.05865,2,0
0,0,2,2,7,4,11,13,5,18,0.000333,0.020757,3,186.809307,10.378295,62.269769,27.651484,3,0
0,0,6,6,15,11,26,56,26,82,0.000333,0.128479,14,5396.104796,299.7836,385.436057,96.657107,4,0
0,0,3,3,11,11,22,26,15,41,0.000333,0.060946,5,914.183482,50.787971,182.836696,76.107496,3,0
0,0,10,10,15,22,37,70,39,109,0.000333,0.189277,7,3974.812918,220.82294,567.830417,156.710855,6,0
0,0,3,3,11,11,22,26,15,41,0.000333,0.060946,5,914.183482,50.787971,182.836696,76.107496,3,0
0,0,10,10,15,22,37,70,39,109,0.000333,0.189277,7,3974.812918,220.82294,567.830417,156.710855,6,0
0,0,3,3,11,11,22,26,15,41,0.000333,0.060946,5,914.183482,50.787971,182.836696,76.107496,3,0
0,0,10,10,15,22,37,70,39,109,0.000333,0.189277,7,3974.812918,220.82294,567.830417,156.710855,6,0
0,0,2,2,7,4,11,13,5,18,0.000333,0.020757,3,186.809307,10.378295,62.269769,27.651484,3,0
0,0,7,7,11,10,21,36,17,53,0.000333,0.077598,5,1163.964117,64.664673,232.792823,71.273029,4,0
0,0,2,2,11,6,17,14,8,22,0.000333,0.029975,5,449.620913,24.97894,89.924183,53.563523,2,0
0,0,2,2,7,4,11,13,5,18,0.000333,0.020757,3,186.809307,10.378295,62.269769,27.651484,3,0
0,0,3,3,11,11,22,26,15,41,0.000333,0.060946,5,914.183482,50.787971,182.836696,76.107496,3,0
0,0,10,10,15,22,37,70,39,109,0.000333,0.189277,7,3974.812918,220.82294,567.830417,156.710855,6,0
0,0,7,7,8,15,23,38,26,64,0.000333,0.096503,4,1158.031861,64.335103,289.507965,82.603359,3,0
0,0,6,6,10,9,19,324,15,339,0.000333,0.480016,5,7200.237135,400.013174,1440.047427,61.748606,5,0
0,0,17,17,16,23,39,110,55,165,0.000333,0.290697,16,13953.46186,775.192325,872.091366,168.041925,7,0
0,0,10,10,15,22,37,70,39,109,0.000333,0.189277,7,3974.812918,220.82294,567.830417,156.710855,6,0
0,0,2,2,7,4,11,13,5,18,0.000333,0.020757,3,186.809307,10.378295,62.269769,27.651484,3,0
0,0,5,5,12,12,24,58,26,84,0.000333,0.128379,12,4621.642201,256.7579,385.13685,86.0391,11,0
0,0,4,4,12,12,24,49,23,72,0.000333,0.110039,6,1980.7038,110.0391,330.1173,86.0391,10,0
0,0,2,2,9,10,19,26,14,40,0.000333,0.056639,4,679.668402,37.759356,169.917101,61.748606,1,0
0,0,2,2,9,10,19,26,14,40,0.000333,0.056639,4,679.668402,37.759356,169.917101,61.748606,1,0
0,0,2,2,9,10,19,26,14,40,0.000333,0.056639,4,679.668402,37.759356,169.917101,61.748606,1,0
0,0,2,2,9,10,19,26,14,40,0.000333,0.056639,4,679.668402,37.759356,169.917101,61.748606,1,0
0,0,2,2,9,10,19,26,14,40,0.000333,0.056639,4,679.668402,37.759356,169.917101,61.748606,1,0
0,0,2,2,9,10,19,26,14,40,0.000333,0.056639,4,679.668402,37.759356,169.917101,61.748606,1,0
0,0,5,5,13,101,114,424,267,691,0.000333,1.573842,12,56658.324,3147.684667,4721.527,720.585076,7,0
0,0,2,2,9,10,19,26,14,40,0.000333,0.056639,4,679.668402,37.759356,169.917101,61.748606,2,0
0,0,2,2,9,10,19,26,14,40,0.000333,0.056639,4,679.668402,37.759356,169.917101,61.748606,1,0
0,0,2,2,9,10,19,26,14,40,0.000333,0.056639,4,679.668402,37.759356,169.917101,61.748606,1,0
0,0,2,2,9,10,19,26,14,40,0.000333,0.056639,4,679.668402,37.759356,169.917101,61.748606,1,0
0,0,2,2,9,10,19,26,14,40,0.000333,0.056639,4,679.668402,37.759356,169.917101,61.748606,1,0
0,0,10,10,9,14,23,123,66,189,0.000333,0.284984,16,13679.25136,759.958409,854.95321,81.832294,1,0
0,0,2,2,9,10,19,26,14,40,0.000333,0.056639,4,679.668402,37.759356,169.917101,61.748606,1,0
0,0,4,4,10,13,23,67,37,104,0.000333,0.156817,10,4704.504434,261.361357,470.450443,81.324997,1,0
0,0,2,2,9,10,19,26,14,40,0.000333,0.056639,4,679.668402,37.759356,169.917101,61.748606,1,0
0,0,2,2,9,10,19,26,14,40,0.000333,0.056639,4,679.668402,37.759356,169.917101,61.748606,1,0
0,0,3,3,9,9,18,63,34,97,0.000333,0.134828,12,4853.792702,269.65515,404.482725,57.05865,1,0
0,0,2,2,9,10,19,26,14,40,0.000333,0.056639,4,679.668402,37.759356,169.917101,61.748606,1,0
0,0,2,2,9,10,19,26,14,40,0.000333,0.056639,4,679.668402,37.759356,169.917101,61.748606,2,0
0,0,3,3,11,12,23,35,18,53,0.000333,0.079916,5,1198.743918,66.596884,239.748784,81.073298,2,0
0,0,2,2,9,10,19,26,14,40,0.000333,0.056639,4,679.668402,37.759356,169.917101,61.748606,1,0
0,0,2,2,9,10,19,26,14,40,0.000333,0.056639,4,679.668402,37.759356,169.917101,61.748606,1,0
0,0,2,2,9,10,19,26,14,40,0.000333,0.056639,4,679.668402,37.759356,169.917101,61.748606,1,0
0,0,5,5,11,13,24,36,21,57,0.000333,0.087114,5,1306.714313,72.59524,261.342863,86.159464,3,0
0,0,2,2,7,4,11,13,5,18,0.000333,0.020757,3,186.809307,10.378295,62.269769,27.651484,3,0
0,0,30,30,17,45,62,154,91,245,0.000333,0.486259,16,23340.44954,1296.691641,1458.778096,316.620258,10,0
0,0,5,5,11,13,24,36,21,57,0.000333,0.087114,5,1306.714313,72.59524,261.342863,86.159464,4,0
0,0,2,2,7,4,11,13,5,18,0.000333,0.020757,3,186.809307,10.378295,62.269769,27.651484,3,0
0,0,17,17,16,23,39,110,55,165,0.000333,0.290697,16,13953.46186,775.192325,872.091366,168.041925,7,0
0,0,6,6,11,13,24,36,20,56,0.000333,0.085586,5,1283.7895,71.321639,256.7579,86.159464,2,0
0,0,3,3,11,11,22,26,15,41,0.000333,0.060946,5,914.183482,50.787971,182.836696,76.107496,3,0
0,0,10,10,15,22,37,70,39,109,0.000333,0.189277,7,3974.812918,220.82294,567.830417,156.710855,6,0
0,0,3,3,8,7,15,18,10,28,0.000333,0.036464,4,437.571747,24.309541,109.392937,43.651484,1,0
0,0,2,2,7,6,13,12,8,20,0.000333,0.02467,3,222.026383,12.334799,74.008794,35.161259,1,0
0,0,2,2,7,7,14,13,9,22,0.000333,0.027921,3,251.285425,13.960301,83.761808,39.302969,1,0
0,0,19,19,19,27,46,152,72,224,0.000333,0.412426,18,22271.00181,1237.277878,1237.277878,209.092585,9,0
0,0,2,2,7,4,11,13,5,18,0.000333,0.020757,3,186.809307,10.378295,62.269769,27.651484,3,0
0,0,20,20,19,27,46,157,73,230,0.000333,0.423473,18,22867.5465,1270.41925,1270.41925,209.092585,10,0
0,0,27,27,18,39,57,142,77,219,0.000333,0.425801,9,11496.62622,638.701457,1277.402913,281.189337,10,0
0,0,3,3,13,21,34,35,33,68,0.000333,0.115316,6,2075.684839,115.315824,345.947473,140.344382,3,0
0,0,23,23,20,29,49,181,80,261,0.000333,0.48848,20,29308.78539,1628.265855,1465.439269,227.320011,12,0
0,0,7,7,13,28,41,61,51,112,0.000333,0.200015,6,3600.274947,200.015275,600.045825,182.711654,1,0
0,0,20,20,14,31,45,125,72,197,0.000333,0.360632,14,15146.53084,841.473936,1081.89506,206.883055,1,0
0,0,2,2,10,3,13,13,5,18,0.000333,0.022203,5,333.039575,18.502199,66.607915,37.974168,1,0
0,0,3,3,11,11,22,26,15,41,0.000333,0.060946,5,914.183482,50.787971,182.836696,76.107496,3,0
0,0,10,10,15,22,37,70,39,109,0.000333,0.189277,7,3974.812918,220.82294,567.830417,156.710855,6,0
0,0,2,2,7,4,11,13,5,18,0.000333,0.020757,3,186.809307,10.378295,62.269769,27.651484,3,0
0,0,2,2,7,4,11,13,5,18,0.000333,0.020757,3,186.809307,10.378295,62.269769,27.651484,3,0
0,0,5,5,12,12,24,58,26,84,0.000333,0.128379,12,4621.642201,256.7579,385.13685,86.0391,11,0
0,0,4,4,12,12,24,49,23,72,0.000333,0.110039,6,1980.7038,110.0391,330.1173,86.0391,10,0
0,0,2,2,9,10,19,26,14,40,0.000333,0.056639,4,679.668402,37.759356,169.917101,61.748606,2,0
0,0,2,2,9,10,19,26,14,40,0.000333,0.056639,4,679.668402,37.759356,169.917101,61.748606,1,0
0,0,2,2,9,10,19,26,14,40,0.000333,0.056639,4,679.668402,37.759356,169.917101,61.748606,1,0
0,0,3,3,11,12,23,35,18,53,0.000333,0.079916,5,1198.743918,66.596884,239.748784,81.073298,2,0
0,0,2,2,9,10,19,26,14,40,0.000333,0.056639,4,679.668402,37.759356,169.917101,61.748606,1,0
0,0,4,4,10,13,23,67,37,104,0.000333,0.156817,10,4704.504434,261.361357,470.450443,81.324997,1,0
0,0,10,10,9,14,23,123,66,189,0.000333,0.284984,16,13679.25136,759.958409,854.95321,81.832294,1,0
0,0,2,2,9,10,19,26,14,40,0.000333,0.056639,4,679.668402,37.759356,169.917101,61.748606,1,0
0,0,2,2,9,10,19,26,14,40,0.000333,0.056639,4,679.668402,37.759356,169.917101,61.748606,1,0
0,0,2,2,9,10,19,26,14,40,0.000333,0.056639,4,679.668402,37.759356,169.917101,61.748606,1,0
0,0,2,2,9,10,19,26,14,40,0.000333,0.056639,4,679.668402,37.759356,169.917101,61.748606,1,0
0,0,2,2,9,10,19,26,14,40,0.000333,0.056639,4,679.668402,37.759356,169.917101,61.748606,1,0
0,0,2,2,9,10,19,26,14,40,0.000333,0.056639,4,679.668402,37.759356,169.917101,61.748606,1,0
0,0,2,2,9,10,19,26,14,40,0.000333,0.056639,4,679.668402,37.759356,169.917101,61.748606,1,0
0,0,2,2,9,10,19,26,14,40,0.000333,0.056639,4,679.668402,37.759356,169.917101,61.748606,2,0
0,0,2,2,9,10,19,26,14,40,0.000333,0.056639,4,679.668402,37.759356,169.917101,61.748606,1,0
0,0,5,5,13,101,114,424,267,691,0.000333,1.573842,12,56658.324,3147.684667,4721.527,720.585076,7,0
0,0,2,2,9,10,19,26,14,40,0.000333,0.056639,4,679.668402,37.759356,169.917101,61.748606,1,0
0,0,3,3,9,9,18,63,34,97,0.000333,0.134828,12,4853.792702,269.65515,404.482725,57.05865,1,0
0,0,2,2,9,10,19,26,14,40,0.000333,0.056639,4,679.668402,37.759356,169.917101,61.748606,1,0
0,0,2,2,9,10,19,26,14,40,0.000333,0.056639,4,679.668402,37.759356,169.917101,61.748606,1,0
0,0,2,2,9,10,19,26,14,40,0.000333,0.056639,4,679.668402,37.759356,169.917101,61.748606,1,0
0,0,2,2,9,10,19,26,14,40,0.000333,0.056639,4,679.668402,37.759356,169.917101,61.748606,1,0
0,0,2,2,9,10,19,26,14,40,0.000333,0.056639,4,679.668402,37.759356,169.917101,61.748606,1,0
0,0,5,5,12,12,24,58,26,84,0.000333,0.128379,12,4621.642201,256.7579,385.13685,86.0391,11,0
0,0,2,2,7,4,11,13,5,18,0.000333,0.020757,3,186.809307,10.378295,62.269769,27.651484,3,0
0,0,4,4,12,12,24,49,23,72,0.000333,0.110039,6,1980.7038,110.0391,330.1173,86.0391,10,0
0,0,2,2,9,10,19,26,14,40,0.000333,0.056639,4,679.668402,37.759356,169.917101,61.748606,1,0
0,0,2,2,9,10,19,26,14,40,0.000333,0.056639,4,679.668402,37.759356,169.917101,61.748606,1,0
0,0,3,3,9,9,18,63,34,97,0.000333,0.134828,12,4853.792702,269.65515,404.482725,57.05865,1,0
0,0,2,2,9,10,19,26,14,40,0.000333,0.056639,4,679.668402,37.759356,169.917101,61.748606,1,0
0,0,2,2,9,10,19,26,14,40,0.000333,0.056639,4,679.668402,37.759356,169.917101,61.748606,1,0
0,0,2,2,9,10,19,26,14,40,0.000333,0.056639,4,679.668402,37.759356,169.917101,61.748606,1,0
0,0,2,2,9,10,19,26,14,40,0.000333,0.056639,4,679.668402,37.759356,169.917101,61.748606,1,0
0,0,2,2,9,10,19,26,14,40,0.000333,0.056639,4,679.668402,37.759356,169.917101,61.748606,1,0
0,0,3,3,11,12,23,35,18,53,0.000333,0.079916,5,1198.743918,66.596884,239.748784,81.073298,2,0
0,0,2,2,9,10,19,26,14,40,0.000333,0.056639,4,679.668402,37.759356,169.917101,61.748606,1,0
0,0,2,2,9,10,19,26,14,40,0.000333,0.056639,4,679.668402,37.759356,169.917101,61.748606,1,0
0,0,2,2,9,10,19,26,14,40,0.000333,0.056639,4,679.668402,37.759356,169.917101,61.748606,1,0
0,0,2,2,9,10,19,26,14,40,0.000333,0.056639,4,679.668402,37.759356,169.917101,61.748606,2,0
0,0,2,2,9,10,19,26,14,40,0.000333,0.056639,4,679.668402,37.759356,169.917101,61.748606,1,0
0,0,2,2,9,10,19,26,14,40,0.000333,0.056639,4,679.668402,37.759356,169.917101,61.748606,1,0
0,0,2,2,9,10,19,26,14,40,0.000333,0.056639,4,679.668402,37.759356,169.917101,61.748606,1,0
0,0,2,2,9,10,19,26,14,40,0.000333,0.056639,4,679.668402,37.759356,169.917101,61.748606,1,0
0,0,2,2,9,10,19,26,14,40,0.000333,0.056639,4,679.668402,37.759356,169.917101,61.748606,2,0
0,0,2,2,9,10,19,26,14,40,0.000333,0.056639,4,679.668402,37.759356,169.917101,61.748606,1,0
0,0,2,2,9,10,19,26,14,40,0.000333,0.056639,4,679.668402,37.759356,169.917101,61.748606,1,0
0,0,2,2,9,10,19,26,14,40,0.000333,0.056639,4,679.668402,37.759356,169.917101,61.748606,1,0
0,0,4,4,10,13,23,67,37,104,0.000333,0.156817,10,4704.504434,261.361357,470.450443,81.324997,1,0
0,0,10,10,9,14,23,123,66,189,0.000333,0.284984,16,13679.25136,759.958409,854.95321,81.832294,1,0
0,0,5,5,13,101,114,424,267,691,0.000333,1.573842,12,56658.324,3147.684667,4721.527,720.585076,7,0
0,0,10,10,14,19,33,63,32,95,0.000333,0.159739,7,3354.522089,186.362338,479.217441,134.013592,11,0
0,0,2,2,7,4,11,13,5,18,0.000333,0.020757,3,186.809307,10.378295,62.269769,27.651484,3,0
0,0,4,4,12,12,24,49,23,72,0.000333,0.110039,6,1980.7038,110.0391,330.1173,86.0391,10,0
0,0,5,5,12,12,24,58,26,84,0.000333,0.128379,12,4621.642201,256.7579,385.13685,86.0391,11,0
0,0,2,2,9,10,19,26,14,40,0.000333,0.056639,4,679.668402,37.759356,169.917101,61.748606,1,0
0,0,10,10,9,14,23,123,66,189,0.000333,0.284984,16,13679.25136,759.958409,854.95321,81.832294,1,0
0,0,2,2,9,10,19,26,14,40,0.000333,0.056639,4,679.668402,37.759356,169.917101,61.748606,1,0
0,0,4,4,10,13,23,67,37,104,0.000333,0.156817,10,4704.504434,261.361357,470.450443,81.324997,1,0
0,0,2,2,9,10,19,26,14,40,0.000333,0.056639,4,679.668402,37.759356,169.917101,61.748606,1,0
0,0,2,2,9,10,19,26,14,40,0.000333,0.056639,4,679.668402,37.759356,169.917101,61.748606,1,0
0,0,2,2,9,10,19,26,14,40,0.000333,0.056639,4,679.668402,37.759356,169.917101,61.748606,1,0
0,0,2,2,9,10,19,26,14,40,0.000333,0.056639,4,679.668402,37.759356,169.917101,61.748606,1,0
0,0,3,3,11,12,23,35,18,53,0.000333,0.079916,5,1198.743918,66.596884,239.748784,81.073298,2,0
0,0,2,2,9,10,19,26,14,40,0.000333,0.056639,4,679.668402,37.759356,169.917101,61.748606,1,0
0,0,2,2,9,10,19,26,14,40,0.000333,0.056639,4,679.668402,37.759356,169.917101,61.748606,1,0
0,0,3,3,9,9,18,63,34,97,0.000333,0.134828,12,4853.792702,269.65515,404.482725,57.05865,1,0
0,0,2,2,9,10,19,26,14,40,0.000333,0.056639,4,679.668402,37.759356,169.917101,61.748606,1,0
0,0,2,2,9,10,19,26,14,40,0.000333,0.056639,4,679.668402,37.759356,169.917101,61.748606,1,0
0,0,2,2,9,10,19,26,14,40,0.000333,0.056639,4,679.668402,37.759356,169.917101,61.748606,1,0
0,0,2,2,9,10,19,26,14,40,0.000333,0.056639,4,679.668402,37.759356,169.917101,61.748606,1,0
0,0,2,2,9,10,19,26,14,40,0.000333,0.056639,4,679.668402,37.759356,169.917101,61.748606,2,0
0,0,2,2,9,10,19,26,14,40,0.000333,0.056639,4,679.668402,37.759356,169.917101,61.748606,1,0
0,0,2,2,9,10,19,26,14,40,0.000333,0.056639,4,679.668402,37.759356,169.917101,61.748606,2,0
0,0,5,5,13,101,114,424,267,691,0.000333,1.573842,12,56658.324,3147.684667,4721.527,720.585076,7,0
0,0,2,2,9,10,19,26,14,40,0.000333,0.056639,4,679.668402,37.759356,169.917101,61.748606,1,0
0,0,2,2,9,10,19,26,14,40,0.000333,0.056639,4,679.668402,37.759356,169.917101,61.748606,1,0
0,0,2,2,9,10,19,26,14,40,0.000333,0.056639,4,679.668402,37.759356,169.917101,61.748606,1,0
0,0,2,2,9,10,19,26,14,40,0.000333,0.056639,4,679.668402,37.759356,169.917101,61.748606,1,0
0,0,2,2,7,4,11,13,5,18,0.000333,0.020757,3,186.809307,10.378295,62.269769,27.651484,3,0
0,0,19,19,9,25,34,119,73,192,0.000333,0.325598,8,7814.342924,434.130162,976.792866,144.62573,3,0
0,0,2,2,7,4,11,13,5,18,0.000333,0.020757,3,186.809307,10.378295,62.269769,27.651484,3,0
0,0,4,4,12,12,24,49,23,72,0.000333,0.110039,6,1980.7038,110.0391,330.1173,86.0391,10,0
0,0,5,5,12,12,24,58,26,84,0.000333,0.128379,12,4621.642201,256.7579,385.13685,86.0391,11,0
0,0,2,2,9,10,19,26,14,40,0.000333,0.056639,4,679.668402,37.759356,169.917101,61.748606,1,0
0,0,2,2,9,10,19,26,14,40,0.000333,0.056639,4,679.668402,37.759356,169.917101,61.748606,1,0
0,0,2,2,9,10,19,26,14,40,0.000333,0.056639,4,679.668402,37.759356,169.917101,61.748606,1,0
0,0,5,5,13,101,114,424,267,691,0.000333,1.573842,12,56658.324,3147.684667,4721.527,720.585076,7,0
0,0,2,2,9,10,19,26,14,40,0.000333,0.056639,4,679.668402,37.759356,169.917101,61.748606,1,0
0,0,2,2,9,10,19,26,14,40,0.000333,0.056639,4,679.668402,37.759356,169.917101,61.748606,1,0
0,0,2,2,9,10,19,26,14,40,0.000333,0.056639,4,679.668402,37.759356,169.917101,61.748606,2,0
0,0,2,2,9,10,19,26,14,40,0.000333,0.056639,4,679.668402,37.759356,169.917101,61.748606,1,0
0,0,2,2,9,10,19,26,14,40,0.000333,0.056639,4,679.668402,37.759356,169.917101,61.748606,1,0
0,0,10,10,9,14,23,123,66,189,0.000333,0.284984,16,13679.25136,759.958409,854.95321,81.832294,1,0
0,0,2,2,9,10,19,26,14,40,0.000333,0.056639,4,679.668402,37.759356,169.917101,61.748606,1,0
0,0,2,2,9,10,19,26,14,40,0.000333,0.056639,4,679.668402,37.759356,169.917101,61.748606,1,0
0,0,2,2,9,10,19,26,14,40,0.000333,0.056639,4,679.668402,37.759356,169.917101,61.748606,1,0
0,0,2,2,9,10,19,26,14,40,0.000333,0.056639,4,679.668402,37.759356,169.917101,61.748606,1,0
0,0,2,2,9,10,19,26,14,40,0.000333,0.056639,4,679.668402,37.759356,169.917101,61.748606,1,0
0,0,2,2,9,10,19,26,14,40,0.000333,0.056639,4,679.668402,37.759356,169.917101,61.748606,1,0
0,0,2,2,9,10,19,26,14,40,0.000333,0.056639,4,679.668402,37.759356,169.917101,61.748606,1,0
0,0,2,2,9,10,19,26,14,40,0.000333,0.056639,4,679.668402,37.759356,169.917101,61.748606,2,0
0,0,2,2,9,10,19,26,14,40,0.000333,0.056639,4,679.668402,37.759356,169.917101,61.748606,1,0
0,0,2,2,9,10,19,26,14,40,0.000333,0.056639,4,679.668402,37.759356,169.917101,61.748606,1,0
0,0,3,3,11,12,23,35,18,53,0.000333,0.079916,5,1198.743918,66.596884,239.748784,81.073298,2,0
0,0,2,2,9,10,19,26,14,40,0.000333,0.056639,4,679.668402,37.759356,169.917101,61.748606,1,0
0,0,4,4,10,13,23,67,37,104,0.000333,0.156817,10,4704.504434,261.361357,470.450443,81.324997,1,0
0,0,3,3,9,9,18,63,34,97,0.000333,0.134828,12,4853.792702,269.65515,404.482725,57.05865,1,0
0,0,20,20,12,25,37,126,84,210,0.000333,0.364662,18,19691.73372,1093.985207,1093.985207,159.115955,3,0
0,0,5,5,12,12,24,58,26,84,0.000333,0.128379,12,4621.642201,256.7579,385.13685,86.0391,11,0
0,0,4,4,12,12,24,49,23,72,0.000333,0.110039,6,1980.7038,110.0391,330.1173,86.0391,10,0
0,0,2,2,7,4,11,13,5,18,0.000333,0.020757,3,186.809307,10.378295,62.269769,27.651484,3,0
0,0,2,2,9,10,19,26,14,40,0.000333,0.056639,4,679.668402,37.759356,169.917101,61.748606,1,0
0,0,2,2,9,10,19,26,14,40,0.000333,0.056639,4,679.668402,37.759356,169.917101,61.748606,1,0
0,0,3,3,9,9,18,63,34,97,0.000333,0.134828,12,4853.792702,269.65515,404.482725,57.05865,1,0
0,0,2,2,9,10,19,26,14,40,0.000333,0.056639,4,679.668402,37.759356,169.917101,61.748606,1,0
0,0,2,2,9,10,19,26,14,40,0.000333,0.056639,4,679.668402,37.759356,169.917101,61.748606,1,0
0,0,10,10,9,14,23,123,66,189,0.000333,0.284984,16,13679.25136,759.958409,854.95321,81.832294,1,0
0,0,2,2,9,10,19,26,14,40,0.000333,0.056639,4,679.668402,37.759356,169.917101,61.748606,1,0
0,0,2,2,9,10,19,26,14,40,0.000333,0.056639,4,679.668402,37.759356,169.917101,61.748606,1,0
0,0,2,2,9,10,19,26,14,40,0.000333,0.056639,4,679.668402,37.759356,169.917101,61.748606,1,0
0,0,2,2,9,10,19,26,14,40,0.000333,0.056639,4,679.668402,37.759356,169.917101,61.748606,1,0
0,0,5,5,13,101,114,424,267,691,0.000333,1.573842,12,56658.324,3147.684667,4721.527,720.585076,7,0
0,0,2,2,9,10,19,26,14,40,0.000333,0.056639,4,679.668402,37.759356,169.917101,61.748606,1,0
0,0,2,2,9,10,19,26,14,40,0.000333,0.056639,4,679.668402,37.759356,169.917101,61.748606,2,0
0,0,3,3,11,12,23,35,18,53,0.000333,0.079916,5,1198.743918,66.596884,239.748784,81.073298,2,0
0,0,2,2,9,10,19,26,14,40,0.000333,0.056639,4,679.668402,37.759356,169.917101,61.748606,1,0
0,0,2,2,9,10,19,26,14,40,0.000333,0.056639,4,679.668402,37.759356,169.917101,61.748606,2,0
0,0,2,2,9,10,19,26,14,40,0.000333,0.056639,4,679.668402,37.759356,169.917101,61.748606,1,0
0,0,2,2,9,10,19,26,14,40,0.000333,0.056639,4,679.668402,37.759356,169.917101,61.748606,1,0
0,0,2,2,9,10,19,26,14,40,0.000333,0.056639,4,679.668402,37.759356,169.917101,61.748606,1,0
0,0,2,2,9,10,19,26,14,40,0.000333,0.056639,4,679.668402,37.759356,169.917101,61.748606,1,0
0,0,4,4,10,13,23,67,37,104,0.000333,0.156817,10,4704.504434,261.361357,470.450443,81.324997,1,0
0,0,2,2,9,10,19,26,14,40,0.000333,0.056639,4,679.668402,37.759356,169.917101,61.748606,1,0
0,0,2,2,9,10,19,26,14,40,0.000333,0.056639,4,679.668402,37.759356,169.917101,61.748606,1,0
0,0,2,2,9,10,19,26,14,40,0.000333,0.056639,4,679.668402,37.759356,169.917101,61.748606,1,0
0,0,5,5,12,12,24,58,26,84,0.000333,0.128379,12,4621.642201,256.7579,385.13685,86.0391,11,0
0,0,27,27,19,35,54,148,78,226,0.000333,0.433535,18,23410.88236,1300.604575,1300.604575,260.235528,10,0
0,0,22,22,22,24,46,134,73,207,0.000333,0.381126,33,37731.45172,2096.191762,1143.377325,208.146596,6,0
0,0,4,4,12,12,24,49,23,72,0.000333,0.110039,6,1980.7038,110.0391,330.1173,86.0391,10,0
0,0,2,2,9,10,19,26,14,40,0.000333,0.056639,4,679.668402,37.759356,169.917101,61.748606,1,0
0,0,5,5,13,101,114,424,267,691,0.000333,1.573842,12,56658.324,3147.684667,4721.527,720.585076,7,0
0,0,2,2,9,10,19,26,14,40,0.000333,0.056639,4,679.668402,37.759356,169.917101,61.748606,1,0
0,0,2,2,9,10,19,26,14,40,0.000333,0.056639,4,679.668402,37.759356,169.917101,61.748606,1,0
0,0,2,2,9,10,19,26,14,40,0.000333,0.056639,4,679.668402,37.759356,169.917101,61.748606,1,0
0,0,2,2,9,10,19,26,14,40,0.000333,0.056639,4,679.668402,37.759356,169.917101,61.748606,1,0
0,0,2,2,9,10,19,26,14,40,0.000333,0.056639,4,679.668402,37.759356,169.917101,61.748606,1,0
0,0,2,2,9,10,19,26,14,40,0.000333,0.056639,4,679.668402,37.759356,169.917101,61.748606,1,0
0,0,2,2,9,10,19,26,14,40,0.000333,0.056639,4,679.668402,37.759356,169.917101,61.748606,1,0
0,0,2,2,9,10,19,26,14,40,0.000333,0.056639,4,679.668402,37.759356,169.917101,61.748606,1,0
0,0,2,2,9,10,19,26,14,40,0.000333,0.056639,4,679.668402,37.759356,169.917101,61.748606,1,0
0,0,2,2,9,10,19,26,14,40,0.000333,0.056639,4,679.668402,37.759356,169.917101,61.748606,2,0
0,0,2,2,9,10,19,26,14,40,0.000333,0.056639,4,679.668402,37.759356,169.917101,61.748606,1,0
0,0,2,2,9,10,19,26,14,40,0.000333,0.056639,4,679.668402,37.759356,169.917101,61.748606,2,0
0,0,3,3,11,12,23,35,18,53,0.000333,0.079916,5,1198.743918,66.596884,239.748784,81.073298,2,0
0,0,10,10,9,14,23,123,66,189,0.000333,0.284984,16,13679.25136,759.958409,854.95321,81.832294,1,0
0,0,2,2,9,10,19,26,14,40,0.000333,0.056639,4,679.668402,37.759356,169.917101,61.748606,1,0
0,0,3,3,9,9,18,63,34,97,0.000333,0.134828,12,4853.792702,269.65515,404.482725,57.05865,1,0
0,0,2,2,9,10,19,26,14,40,0.000333,0.056639,4,679.668402,37.759356,169.917101,61.748606,1,0
0,0,4,4,10,13,23,67,37,104,0.000333,0.156817,10,4704.504434,261.361357,470.450443,81.324997,1,0
0,0,2,2,9,10,19,26,14,40,0.000333,0.056639,4,679.668402,37.759356,169.917101,61.748606,1,0
0,0,2,2,9,10,19,26,14,40,0.000333,0.056639,4,679.668402,37.759356,169.917101,61.748606,1,0
0,0,2,2,9,10,19,26,14,40,0.000333,0.056639,4,679.668402,37.759356,169.917101,61.748606,1,0
0,0,2,2,9,10,19,26,14,40,0.000333,0.056639,4,679.668402,37.759356,169.917101,61.748606,1,0
0,0,3,3,11,11,22,26,15,41,0.000333,0.060946,5,914.183482,50.787971,182.836696,76.107496,3,0
0,0,10,10,15,22,37,70,39,109,0.000333,0.189277,7,3974.812918,220.82294,567.830417,156.710855,6,0
0,0,3,3,11,11,22,26,15,41,0.000333,0.060946,5,914.183482,50.787971,182.836696,76.107496,3,0
0,0,10,10,15,22,37,70,39,109,0.000333,0.189277,7,3974.812918,220.82294,567.830417,156.710855,6,0
0,0,3,3,11,11,22,26,15,41,0.000333,0.060946,5,914.183482,50.787971,182.836696,76.107496,3,0
0,0,10,10,15,22,37,70,39,109,0.000333,0.189277,7,3974.812918,220.82294,567.830417,156.710855,6,0
0,0,4,4,11,14,25,29,21,50,0.000333,0.077398,5,1160.964047,64.498003,232.192809,91.356717,2,0
0,0,7,7,11,11,22,26,17,43,0.000333,0.063919,5,958.777798,53.265433,191.75556,76.107496,6,0
0,0,6,6,13,31,44,240,168,408,0.000333,0.742483,30,66823.44301,3712.413501,2227.4481,201.685802,1,0
0,0,9,9,11,15,26,55,30,85,0.000333,0.133179,10,3995.37376,221.965209,399.537376,96.657107,7,0
0,0,21,21,17,32,49,123,66,189,0.000333,0.353727,16,16978.88257,943.271254,1061.180161,229.486868,8,0
0,0,5,5,11,13,24,26,20,46,0.000333,0.070303,5,1054.541375,58.585632,210.908275,86.159464,1,0
0,0,3,3,12,10,22,20,15,35,0.000333,0.052027,6,936.48064,52.026702,156.080107,76.238831,2,0
0,0,1,1,8,6,14,9,7,16,0.000333,0.020306,4,243.670715,13.537262,60.917679,39.509775,1,0
0,0,15,15,13,24,37,89,46,135,0.000333,0.234425,6,4219.657226,234.425401,703.276204,158.144816,5,0
0,0,2,2,7,4,11,13,5,18,0.000333,0.020757,3,186.809307,10.378295,62.269769,27.651484,3,0
0,0,28,28,19,37,56,153,80,233,0.000333,0.451038,18,24356.04654,1353.113697,1353.113697,273.460397,10,0
0,0,3,3,11,11,22,26,15,41,0.000333,0.060946,5,914.183482,50.787971,182.836696,76.107496,3,0
0,0,10,10,15,22,37,70,39,109,0.000333,0.189277,7,3974.812918,220.82294,567.830417,156.710855,6,0
0,0,5,5,12,12,24,58,26,84,0.000333,0.128379,12,4621.642201,256.7579,385.13685,86.0391,11,0
0,0,4,4,12,12,24,49,23,72,0.000333,0.110039,6,1980.7038,110.0391,330.1173,86.0391,10,0
0,0,3,3,9,9,18,63,34,97,0.000333,0.134828,12,4853.792702,269.65515,404.482725,57.05865,1,0
0,0,2,2,9,10,19,26,14,40,0.000333,0.056639,4,679.668402,37.759356,169.917101,61.748606,2,0
0,0,3,3,11,12,23,35,18,53,0.000333,0.079916,5,1198.743918,66.596884,239.748784,81.073298,2,0
0,0,2,2,9,10,19,26,14,40,0.000333,0.056639,4,679.668402,37.759356,169.917101,61.748606,1,0
0,0,2,2,9,10,19,26,14,40,0.000333,0.056639,4,679.668402,37.759356,169.917101,61.748606,1,0
0,0,2,2,9,10,19,26,14,40,0.000333,0.056639,4,679.668402,37.759356,169.917101,61.748606,1,0
0,0,2,2,9,10,19,26,14,40,0.000333,0.056639,4,679.668402,37.759356,169.917101,61.748606,1,0
0,0,2,2,9,10,19,26,14,40,0.000333,0.056639,4,679.668402,37.759356,169.917101,61.748606,1,0
0,0,10,10,9,14,23,123,66,189,0.000333,0.284984,16,13679.25136,759.958409,854.95321,81.832294,1,0
0,0,2,2,9,10,19,26,14,40,0.000333,0.056639,4,679.668402,37.759356,169.917101,61.748606,1,0
0,0,2,2,9,10,19,26,14,40,0.000333,0.056639,4,679.668402,37.759356,169.917101,61.748606,1,0
0,0,2,2,9,10,19,26,14,40,0.000333,0.056639,4,679.668402,37.759356,169.917101,61.748606,1,0
0,0,2,2,9,10,19,26,14,40,0.000333,0.056639,4,679.668402,37.759356,169.917101,61.748606,1,0
0,0,4,4,10,13,23,67,37,104,0.000333,0.156817,10,4704.504434,261.361357,470.450443,81.324997,1,0
0,0,2,2,9,10,19,26,14,40,0.000333,0.056639,4,679.668402,37.759356,169.917101,61.748606,1,0
0,0,2,2,9,10,19,26,14,40,0.000333,0.056639,4,679.668402,37.759356,169.917101,61.748606,1,0
0,0,2,2,9,10,19,26,14,40,0.000333,0.056639,4,679.668402,37.759356,169.917101,61.748606,2,0
0,0,5,5,13,101,114,424,267,691,0.000333,1.573842,12,56658.324,3147.684667,4721.527,720.585076,7,0
0,0,2,2,9,10,19,26,14,40,0.000333,0.056639,4,679.668402,37.759356,169.917101,61.748606,1,0
0,0,2,2,9,10,19,26,14,40,0.000333,0.056639,4,679.668402,37.759356,169.917101,61.748606,1,0
0,0,2,2,9,10,19,26,14,40,0.000333,0.056639,4,679.668402,37.759356,169.917101,61.748606,1,0
0,0,2,2,9,10,19,26,14,40,0.000333,0.056639,4,679.668402,37.759356,169.917101,61.748606,1,0
0,0,2,2,9,10,19,26,14,40,0.000333,0.056639,4,679.668402,37.759356,169.917101,61.748606,1,0
0,0,2,2,9,10,19,26,14,40,0.000333,0.056639,4,679.668402,37.759356,169.917101,61.748606,1,0
0,0,2,2,7,4,11,13,5,18,0.000333,0.020757,3,186.809307,10.378295,62.269769,27.651484,3,0
0,0,3,3,9,9,18,25,13,38,0.000333,0.052819,4,633.8286,35.2127,158.45715,57.05865,1,0
0,0,6,6,16,12,28,47,24,71,0.000333,0.113774,16,5461.155191,303.397511,341.322199,107.01955,4,0
0,0,2,2,7,4,11,13,5,18,0.000333,0.020757,3,186.809307,10.378295,62.269769,27.651484,3,0
0,0,2,2,7,4,11,13,5,18,0.000333,0.020757,3,186.809307,10.378295,62.269769,27.651484,3,0
0,0,5,5,11,13,24,36,21,57,0.000333,0.087114,5,1306.714313,72.59524,261.342863,86.159464,3,0
0,0,2,2,7,4,11,13,5,18,0.000333,0.020757,3,186.809307,10.378295,62.269769,27.651484,3,0
0,0,7,7,11,10,21,36,17,53,0.000333,0.077598,5,1163.964117,64.664673,232.792823,71.273029,4,0
0,0,16,16,13,25,38,93,49,142,0.000333,0.248402,6,4471.234241,248.401902,745.205707,164.202121,5,0
0,0,17,17,16,23,39,110,55,165,0.000333,0.290697,16,13953.46186,775.192325,872.091366,168.041925,7,0
0,0,2,2,7,4,11,13,5,18,0.000333,0.020757,3,186.809307,10.378295,62.269769,27.651484,3,0
0,0,5,5,12,12,24,58,26,84,0.000333,0.128379,12,4621.642201,256.7579,385.13685,86.0391,11,0
0,0,4,4,12,12,24,49,23,72,0.000333,0.110039,6,1980.7038,110.0391,330.1173,86.0391,10,0
0,0,2,2,7,4,11,13,5,18,0.000333,0.020757,3,186.809307,10.378295,62.269769,27.651484,3,0
0,0,2,2,5,6,11,9,7,16,0.000333,0.01845,2,110.701812,6.150101,55.350906,27.119415,1,0
0,0,4,4,10,13,23,67,37,104,0.000333,0.156817,10,4704.504434,261.361357,470.450443,81.324997,1,0
0,0,10,10,9,14,23,123,66,189,0.000333,0.284984,16,13679.25136,759.958409,854.95321,81.832294,1,0
0,0,5,5,13,101,114,424,267,691,0.000333,1.573842,12,56658.324,3147.684667,4721.527,720.585076,7,0
0,0,2,2,9,10,19,26,14,40,0.000333,0.056639,4,679.668402,37.759356,169.917101,61.748606,1,0
0,0,2,2,9,10,19,26,14,40,0.000333,0.056639,4,679.668402,37.759356,169.917101,61.748606,1,0
0,0,2,2,9,10,19,26,14,40,0.000333,0.056639,4,679.668402,37.759356,169.917101,61.748606,2,0
0,0,2,2,9,10,19,26,14,40,0.000333,0.056639,4,679.668402,37.759356,169.917101,61.748606,1,0
0,0,3,3,9,9,18,63,34,97,0.000333,0.134828,12,4853.792702,269.65515,404.482725,57.05865,1,0
0,0,2,2,9,10,19,26,14,40,0.000333,0.056639,4,679.668402,37.759356,169.917101,61.748606,2,0
0,0,2,2,9,10,19,26,14,40,0.000333,0.056639,4,679.668402,37.759356,169.917101,61.748606,1,0
0,0,2,2,9,10,19,26,14,40,0.000333,0.056639,4,679.668402,37.759356,169.917101,61.748606,1,0
0,0,2,2,9,10,19,26,14,40,0.000333,0.056639,4,679.668402,37.759356,169.917101,61.748606,1,0
0,0,2,2,9,10,19,26,14,40,0.000333,0.056639,4,679.668402,37.759356,169.917101,61.748606,1,0
0,0,3,3,11,12,23,35,18,53,0.000333,0.079916,5,1198.743918,66.596884,239.748784,81.073298,2,0
0,0,2,2,9,10,19,26,14,40,0.000333,0.056639,4,679.668402,37.759356,169.917101,61.748606,1,0
0,0,2,2,9,10,19,26,14,40,0.000333,0.056639,4,679.668402,37.759356,169.917101,61.748606,1,0
0,0,2,2,9,10,19,26,14,40,0.000333,0.056639,4,679.668402,37.759356,169.917101,61.748606,1,0
0,0,2,2,9,10,19,26,14,40,0.000333,0.056639,4,679.668402,37.759356,169.917101,61.748606,1,0
0,0,2,2,9,10,19,26,14,40,0.000333,0.056639,4,679.668402,37.759356,169.917101,61.748606,1,0
0,0,2,2,9,10,19,26,14,40,0.000333,0.056639,4,679.668402,37.759356,169.917101,61.748606,1,0
0,0,2,2,9,10,19,26,14,40,0.000333,0.056639,4,679.668402,37.759356,169.917101,61.748606,1,0
0,0,2,2,9,10,19,26,14,40,0.000333,0.056639,4,679.668402,37.759356,169.917101,61.748606,1,0
0,0,2,2,9,10,19,26,14,40,0.000333,0.056639,4,679.668402,37.759356,169.917101,61.748606,1,0
0,0,2,2,9,10,19,26,14,40,0.000333,0.056639,4,679.668402,37.759356,169.917101,61.748606,1,0
0,0,5,5,11,13,24,36,21,57,0.000333,0.087114,5,1306.714313,72.59524,261.342863,86.159464,3,0
0,0,2,2,7,4,11,13,5,18,0.000333,0.020757,3,186.809307,10.378295,62.269769,27.651484,3,0
0,0,3,3,11,11,22,26,15,41,0.000333,0.060946,5,914.183482,50.787971,182.836696,76.107496,3,0
0,0,10,10,15,22,37,70,39,109,0.000333,0.189277,7,3974.812918,220.82294,567.830417,156.710855,6,0
0,0,3,3,11,11,22,26,15,41,0.000333,0.060946,5,914.183482,50.787971,182.836696,76.107496,3,0
0,0,10,10,15,22,37,70,39,109,0.000333,0.189277,7,3974.812918,220.82294,567.830417,156.710855,6,0
0,0,2,2,7,4,11,13,5,18,0.000333,0.020757,3,186.809307,10.378295,62.269769,27.651484,3,0
0,0,4,4,12,12,24,49,23,72,0.000333,0.110039,6,1980.7038,110.0391,330.1173,86.0391,10,0
0,0,5,5,12,12,24,58,26,84,0.000333,0.128379,12,4621.642201,256.7579,385.13685,86.0391,11,0
0,0,2,2,9,10,19,26,14,40,0.000333,0.056639,4,679.668402,37.759356,169.917101,61.748606,2,0
0,0,2,2,9,10,19,26,14,40,0.000333,0.056639,4,679.668402,37.759356,169.917101,61.748606,1,0
0,0,2,2,9,10,19,26,14,40,0.000333,0.056639,4,679.668402,37.759356,169.917101,61.748606,1,0
0,0,2,2,9,10,19,26,14,40,0.000333,0.056639,4,679.668402,37.759356,169.917101,61.748606,1,0
0,0,2,2,9,10,19,26,14,40,0.000333,0.056639,4,679.668402,37.759356,169.917101,61.748606,1,0
0,0,2,2,9,10,19,26,14,40,0.000333,0.056639,4,679.668402,37.759356,169.917101,61.748606,1,0
0,0,3,3,9,9,18,63,34,97,0.000333,0.134828,12,4853.792702,269.65515,404.482725,57.05865,1,0
0,0,2,2,9,10,19,26,14,40,0.000333,0.056639,4,679.668402,37.759356,169.917101,61.748606,1,0
0,0,5,5,13,101,114,424,267,691,0.000333,1.573842,12,56658.324,3147.684667,4721.527,720.585076,7,0
0,0,4,4,10,13,23,67,37,104,0.000333,0.156817,10,4704.504434,261.361357,470.450443,81.324997,1,0
0,0,2,2,9,10,19,26,14,40,0.000333,0.056639,4,679.668402,37.759356,169.917101,61.748606,1,0
0,0,2,2,9,10,19,26,14,40,0.000333,0.056639,4,679.668402,37.759356,169.917101,61.748606,1,0
0,0,2,2,9,10,19,26,14,40,0.000333,0.056639,4,679.668402,37.759356,169.917101,61.748606,1,0
0,0,2,2,9,10,19,26,14,40,0.000333,0.056639,4,679.668402,37.759356,169.917101,61.748606,1,0
0,0,2,2,9,10,19,26,14,40,0.000333,0.056639,4,679.668402,37.759356,169.917101,61.748606,1,0
0,0,2,2,9,10,19,26,14,40,0.000333,0.056639,4,679.668402,37.759356,169.917101,61.748606,1,0
0,0,10,10,9,14,23,123,66,189,0.000333,0.284984,16,13679.25136,759.958409,854.95321,81.832294,1,0
0,0,2,2,9,10,19,26,14,40,0.000333,0.056639,4,679.668402,37.759356,169.917101,61.748606,1,0
0,0,2,2,9,10,19,26,14,40,0.000333,0.056639,4,679.668402,37.759356,169.917101,61.748606,1,0
0,0,3,3,11,12,23,35,18,53,0.000333,0.079916,5,1198.743918,66.596884,239.748784,81.073298,2,0
0,0,2,2,9,10,19,26,14,40,0.000333,0.056639,4,679.668402,37.759356,169.917101,61.748606,1,0
0,0,2,2,9,10,19,26,14,40,0.000333,0.056639,4,679.668402,37.759356,169.917101,61.748606,1,0
0,0,2,2,9,10,19,26,14,40,0.000333,0.056639,4,679.668402,37.759356,169.917101,61.748606,1,0
0,0,2,2,9,10,19,26,14,40,0.000333,0.056639,4,679.668402,37.759356,169.917101,61.748606,2,0
0,0,2,2,7,4,11,13,5,18,0.000333,0.020757,3,186.809307,10.378295,62.269769,27.651484,3,0
0,0,27,27,16,37,53,169,86,255,0.000333,0.486873,16,23369.91546,1298.328636,1460.619716,256.749775,9,0
0,0,3,3,11,11,22,26,15,41,0.000333,0.060946,5,914.183482,50.787971,182.836696,76.107496,3,0
0,0,10,10,15,22,37,70,39,109,0.000333,0.189277,7,3974.812918,220.82294,567.830417,156.710855,6,0
0,0,3,3,11,11,22,26,15,41,0.000333,0.060946,5,914.183482,50.787971,182.836696,76.107496,3,0
0,0,10,10,15,22,37,70,39,109,0.000333,0.189277,7,3974.812918,220.82294,567.830417,156.710855,6,0
0,0,2,2,11,6,17,14,8,22,0.000333,0.029975,5,449.620913,24.97894,89.924183,53.563523,2,0
0,0,27,27,20,36,56,148,79,227,0.000333,0.439423,20,26365.39135,1464.743964,1318.269567,272.555862,10,0
0,0,7,7,13,12,25,38,19,57,0.000333,0.088233,6,1588.198817,88.233268,264.699803,91.125266,2,0
0,0,10,10,11,15,26,45,28,73,0.000333,0.114377,5,1715.660497,95.314472,343.132099,96.657107,1,0
0,0,5,5,11,13,24,36,21,57,0.000333,0.087114,5,1306.714313,72.59524,261.342863,86.159464,4,0
0,0,17,17,16,23,39,110,55,165,0.000333,0.290697,16,13953.46186,775.192325,872.091366,168.041925,7,0
0,0,2,2,7,4,11,13,5,18,0.000333,0.020757,3,186.809307,10.378295,62.269769,27.651484,3,0
0,0,3,3,11,11,22,26,15,41,0.000333,0.060946,5,914.183482,50.787971,182.836696,76.107496,3,0
0,0,10,10,15,22,37,70,39,109,0.000333,0.189277,7,3974.812918,220.82294,567.830417,156.710855,6,0
0,0,3,3,11,11,22,26,15,41,0.000333,0.060946,5,914.183482,50.787971,182.836696,76.107496,3,0
0,0,10,10,15,22,37,70,39,109,0.000333,0.189277,7,3974.812918,220.82294,567.830417,156.710855,6,0
0,0,9,9,13,12,25,53,31,84,0.000333,0.130028,12,4681.007039,260.055947,390.08392,91.125266,4,0
0,0,8,8,12,13,25,41,24,65,0.000333,0.100617,6,1811.103914,100.616884,301.850652,91.125266,4,0
0,0,1,1,10,13,23,26,13,39,0.000333,0.058806,5,882.094581,49.005255,176.418916,81.324997,1,0
0,0,8,8,13,12,25,43,26,69,0.000333,0.106809,12,3845.112925,213.617385,320.426077,91.125266,4,0
0,0,17,17,16,23,39,110,55,165,0.000333,0.290697,16,13953.46186,775.192325,872.091366,168.041925,7,0
0,0,1,1,10,13,23,26,13,39,0.000333,0.058806,5,882.094581,49.005255,176.418916,81.324997,1,0
0,0,8,8,12,12,24,42,26,68,0.000333,0.103926,12,3741.329401,207.851633,311.77745,86.0391,4,0
0,0,9,9,12,12,24,52,31,83,0.000333,0.126851,12,4566.622651,253.701258,380.551888,86.0391,4,0
0,0,1,1,10,13,23,26,13,39,0.000333,0.058806,5,882.094581,49.005255,176.418916,81.324997,1,0
0,0,6,6,11,11,22,29,18,47,0.000333,0.069864,5,1047.96643,58.220357,209.593286,76.107496,2,0
0,0,1,1,10,13,23,26,13,39,0.000333,0.058806,5,882.094581,49.005255,176.418916,81.324997,1,0
0,0,1,1,10,13,23,26,13,39,0.000333,0.058806,5,882.094581,49.005255,176.418916,81.324997,1,0
0,0,8,8,12,13,25,41,24,65,0.000333,0.100617,6,1811.103914,100.616884,301.850652,91.125266,4,0
0,0,1,1,10,13,23,26,13,39,0.000333,0.058806,5,882.094581,49.005255,176.418916,81.324997,1,0
0,0,3,3,11,11,22,26,15,41,0.000333,0.060946,5,914.183482,50.787971,182.836696,76.107496,3,0
0,0,10,10,15,22,37,70,39,109,0.000333,0.189277,7,3974.812918,220.82294,567.830417,156.710855,6,0
0,0,5,5,12,12,24,58,26,84,0.000333,0.128379,12,4621.642201,256.7579,385.13685,86.0391,11,0
0,0,4,4,12,12,24,49,23,72,0.000333,0.110039,6,1980.7038,110.0391,330.1173,86.0391,10,0
0,0,2,2,9,10,19,26,14,40,0.000333,0.056639,4,679.668402,37.759356,169.917101,61.748606,1,0
0,0,5,5,13,101,114,424,267,691,0.000333,1.573842,12,56658.324,3147.684667,4721.527,720.585076,7,0
0,0,2,2,9,10,19,26,14,40,0.000333,0.056639,4,679.668402,37.759356,169.917101,61.748606,1,0
0,0,2,2,9,10,19,26,14,40,0.000333,0.056639,4,679.668402,37.759356,169.917101,61.748606,1,0
0,0,2,2,9,10,19,26,14,40,0.000333,0.056639,4,679.668402,37.759356,169.917101,61.748606,1,0
0,0,2,2,9,10,19,26,14,40,0.000333,0.056639,4,679.668402,37.759356,169.917101,61.748606,1,0
0,0,2,2,9,10,19,26,14,40,0.000333,0.056639,4,679.668402,37.759356,169.917101,61.748606,1,0
0,0,2,2,9,10,19,26,14,40,0.000333,0.056639,4,679.668402,37.759356,169.917101,61.748606,1,0
0,0,2,2,9,10,19,26,14,40,0.000333,0.056639,4,679.668402,37.759356,169.917101,61.748606,1,0
0,0,2,2,9,10,19,26,14,40,0.000333,0.056639,4,679.668402,37.759356,169.917101,61.748606,1,0
0,0,2,2,9,10,19,26,14,40,0.000333,0.056639,4,679.668402,37.759356,169.917101,61.748606,1,0
0,0,2,2,9,10,19,26,14,40,0.000333,0.056639,4,679.668402,37.759356,169.917101,61.748606,2,0
0,0,2,2,9,10,19,26,14,40,0.000333,0.056639,4,679.668402,37.759356,169.917101,61.748606,1,0
0,0,2,2,9,10,19,26,14,40,0.000333,0.056639,4,679.668402,37.759356,169.917101,61.748606,2,0
0,0,3,3,11,12,23,35,18,53,0.000333,0.079916,5,1198.743918,66.596884,239.748784,81.073298,2,0
0,0,10,10,9,14,23,123,66,189,0.000333,0.284984,16,13679.25136,759.958409,854.95321,81.832294,1,0
0,0,2,2,9,10,19,26,14,40,0.000333,0.056639,4,679.668402,37.759356,169.917101,61.748606,1,0
0,0,3,3,9,9,18,63,34,97,0.000333,0.134828,12,4853.792702,269.65515,404.482725,57.05865,1,0
0,0,2,2,9,10,19,26,14,40,0.000333,0.056639,4,679.668402,37.759356,169.917101,61.748606,1,0
0,0,4,4,10,13,23,67,37,104,0.000333,0.156817,10,4704.504434,261.361357,470.450443,81.324997,1,0
0,0,2,2,9,10,19,26,14,40,0.000333,0.056639,4,679.668402,37.759356,169.917101,61.748606,1,0
0,0,2,2,9,10,19,26,14,40,0.000333,0.056639,4,679.668402,37.759356,169.917101,61.748606,1,0
0,0,2,2,9,10,19,26,14,40,0.000333,0.056639,4,679.668402,37.759356,169.917101,61.748606,1,0
0,0,2,2,9,10,19,26,14,40,0.000333,0.056639,4,679.668402,37.759356,169.917101,61.748606,1,0
0,0,8,8,13,15,28,106,24,130,0.000333,0.208319,6,3749.736839,208.318713,624.95614,106.709075,5,0
0,0,3,3,10,7,17,16,11,27,0.000333,0.036787,5,551.807484,30.655971,110.361497,52.870765,2,0
0,0,16,16,13,26,39,88,49,137,0.000333,0.241367,6,4344.600624,241.366701,724.100104,170.317149,7,0
0,0,2,2,7,4,11,13,5,18,0.000333,0.020757,3,186.809307,10.378295,62.269769,27.651484,3,0
0,0,29,29,19,39,58,157,83,240,0.000333,0.468638,18,25306.4779,1405.915439,1405.915439,286.841309,11,0
0,0,5,5,11,13,24,36,21,57,0.000333,0.087114,5,1306.714313,72.59524,261.342863,86.159464,3,0
0,0,2,2,7,4,11,13,5,18,0.000333,0.020757,3,186.809307,10.378295,62.269769,27.651484,3,0
0,0,3,3,11,11,22,26,15,41,0.000333,0.060946,5,914.183482,50.787971,182.836696,76.107496,3,0
0,0,10,10,15,22,37,70,39,109,0.000333,0.189277,7,3974.812918,220.82294,567.830417,156.710855,6,0
0,0,5,5,11,13,24,36,21,57,0.000333,0.087114,5,1306.714313,72.59524,261.342863,86.159464,3,0
0,0,2,2,7,4,11,13,5,18,0.000333,0.020757,3,186.809307,10.378295,62.269769,27.651484,3,0
0,0,17,17,16,23,39,110,55,165,0.000333,0.290697,16,13953.46186,775.192325,872.091366,168.041925,7,0
0,0,25,25,17,33,50,135,71,206,0.000333,0.387545,16,18602.15,1033.452778,1162.634375,235.951874,10,0
0,0,5,5,10,8,18,19,12,31,0.000333,0.043089,5,646.338375,35.907688,129.267675,57.219281,2,0
0,0,2,2,5,6,11,9,7,16,0.000333,0.01845,2,110.701812,6.150101,55.350906,27.119415,1,0
0,0,5,5,11,13,24,36,21,57,0.000333,0.087114,5,1306.714313,72.59524,261.342863,86.159464,3,0
0,0,5,5,12,12,24,58,26,84,0.000333,0.128379,12,4621.642201,256.7579,385.13685,86.0391,11,0
0,0,4,4,12,12,24,49,23,72,0.000333,0.110039,6,1980.7038,110.0391,330.1173,86.0391,10,0
0,0,5,5,14,9,23,39,20,59,0.000333,0.088963,14,3736.462176,207.581232,266.890155,81.832294,4,0
0,0,2,2,7,4,11,13,5,18,0.000333,0.020757,3,186.809307,10.378295,62.269769,27.651484,3,0
0,0,2,2,9,10,19,26,14,40,0.000333,0.056639,4,679.668402,37.759356,169.917101,61.748606,1,0
0,0,2,2,9,10,19,26,14,40,0.000333,0.056639,4,679.668402,37.759356,169.917101,61.748606,1,0
0,0,2,2,9,10,19,26,14,40,0.000333,0.056639,4,679.668402,37.759356,169.917101,61.748606,1,0
0,0,2,2,9,10,19,26,14,40,0.000333,0.056639,4,679.668402,37.759356,169.917101,61.748606,1,0
0,0,2,2,9,10,19,26,14,40,0.000333,0.056639,4,679.668402,37.759356,169.917101,61.748606,1,0
0,0,2,2,9,10,19,26,14,40,0.000333,0.056639,4,679.668402,37.759356,169.917101,61.748606,1,0
0,0,5,5,13,101,114,424,267,691,0.000333,1.573842,12,56658.324,3147.684667,4721.527,720.585076,7,0
0,0,2,2,9,10,19,26,14,40,0.000333,0.056639,4,679.668402,37.759356,169.917101,61.748606,2,0
0,0,2,2,9,10,19,26,14,40,0.000333,0.056639,4,679.668402,37.759356,169.917101,61.748606,1,0
0,0,2,2,9,10,19,26,14,40,0.000333,0.056639,4,679.668402,37.759356,169.917101,61.748606,1,0
0,0,2,2,9,10,19,26,14,40,0.000333,0.056639,4,679.668402,37.759356,169.917101,61.748606,1,0
0,0,2,2,9,10,19,26,14,40,0.000333,0.056639,4,679.668402,37.759356,169.917101,61.748606,1,0
0,0,10,10,9,14,23,123,66,189,0.000333,0.284984,16,13679.25136,759.958409,854.95321,81.832294,1,0
0,0,2,2,9,10,19,26,14,40,0.000333,0.056639,4,679.668402,37.759356,169.917101,61.748606,1,0
0,0,4,4,10,13,23,67,37,104,0.000333,0.156817,10,4704.504434,261.361357,470.450443,81.324997,1,0
0,0,2,2,9,10,19,26,14,40,0.000333,0.056639,4,679.668402,37.759356,169.917101,61.748606,1,0
0,0,2,2,9,10,19,26,14,40,0.000333,0.056639,4,679.668402,37.759356,169.917101,61.748606,1,0
0,0,3,3,9,9,18,63,34,97,0.000333,0.134828,12,4853.792702,269.65515,404.482725,57.05865,1,0
0,0,2,2,9,10,19,26,14,40,0.000333,0.056639,4,679.668402,37.759356,169.917101,61.748606,1,0
0,0,2,2,9,10,19,26,14,40,0.000333,0.056639,4,679.668402,37.759356,169.917101,61.748606,2,0
0,0,3,3,11,12,23,35,18,53,0.000333,0.079916,5,1198.743918,66.596884,239.748784,81.073298,2,0
0,0,2,2,9,10,19,26,14,40,0.000333,0.056639,4,679.668402,37.759356,169.917101,61.748606,1,0
0,0,2,2,9,10,19,26,14,40,0.000333,0.056639,4,679.668402,37.759356,169.917101,61.748606,1,0
0,0,2,2,9,10,19,26,14,40,0.000333,0.056639,4,679.668402,37.759356,169.917101,61.748606,1,0
0,0,31,31,20,37,57,176,96,272,0.000333,0.528849,20,31730.92168,1762.828982,1586.546084,279.188336,11,0
0,0,14,14,16,20,36,94,67,161,0.000333,0.277453,24,19976.59021,1109.810567,832.357925,150.438562,1,0
0,0,32,32,28,54,82,318,187,505,0.000333,1.070188,42,134843.678,7491.315445,3210.563762,445.369863,20,0
0,0,5,5,11,13,24,36,21,57,0.000333,0.087114,5,1306.714313,72.59524,261.342863,86.159464,3,0
0,0,2,2,7,4,11,13,5,18,0.000333,0.020757,3,186.809307,10.378295,62.269769,27.651484,3,0
0,0,17,17,16,23,39,110,55,165,0.000333,0.290697,16,13953.46186,775.192325,872.091366,168.041925,7,0
0,0,5,5,11,13,24,36,21,57,0.000333,0.087114,5,1306.714313,72.59524,261.342863,86.159464,3,0
0,0,2,2,7,4,11,13,5,18,0.000333,0.020757,3,186.809307,10.378295,62.269769,27.651484,3,0
0,0,28,28,17,40,57,145,84,229,0.000333,0.445244,16,21371.70901,1187.317167,1335.731813,282.363992,10,0
0,0,2,2,7,4,11,13,5,18,0.000333,0.020757,3,186.809307,10.378295,62.269769,27.651484,3,0
0,0,5,5,12,12,24,58,26,84,0.000333,0.128379,12,4621.642201,256.7579,385.13685,86.0391,11,0
0,0,27,27,19,36,55,148,79,227,0.000333,0.437456,18,23622.63579,1312.368655,1312.368655,266.827923,10,0
0,0,4,4,12,12,24,49,23,72,0.000333,0.110039,6,1980.7038,110.0391,330.1173,86.0391,10,0
0,0,4,4,10,7,17,25,11,36,0.000333,0.04905,5,735.743311,40.874628,147.148662,52.870765,2,0
0,0,5,5,9,9,18,26,15,41,0.000333,0.056989,4,683.8677,37.99265,170.966925,57.05865,1,0
0,0,2,2,9,10,19,26,14,40,0.000333,0.056639,4,679.668402,37.759356,169.917101,61.748606,1,0
0,0,2,2,9,10,19,26,14,40,0.000333,0.056639,4,679.668402,37.759356,169.917101,61.748606,1,0
0,0,2,2,9,10,19,26,14,40,0.000333,0.056639,4,679.668402,37.759356,169.917101,61.748606,1,0
0,0,2,2,9,10,19,26,14,40,0.000333,0.056639,4,679.668402,37.759356,169.917101,61.748606,1,0
0,0,2,2,9,10,19,26,14,40,0.000333,0.056639,4,679.668402,37.759356,169.917101,61.748606,1,0
0,0,3,3,11,12,23,35,18,53,0.000333,0.079916,5,1198.743918,66.596884,239.748784,81.073298,2,0
0,0,2,2,9,10,19,26,14,40,0.000333,0.056639,4,679.668402,37.759356,169.917101,61.748606,1,0
0,0,2,2,9,10,19,26,14,40,0.000333,0.056639,4,679.668402,37.759356,169.917101,61.748606,1,0
0,0,2,2,9,10,19,26,14,40,0.000333,0.056639,4,679.668402,37.759356,169.917101,61.748606,2,0
0,0,2,2,9,10,19,26,14,40,0.000333,0.056639,4,679.668402,37.759356,169.917101,61.748606,1,0
0,0,5,5,13,101,114,424,267,691,0.000333,1.573842,12,56658.324,3147.684667,4721.527,720.585076,7,0
0,0,2,2,9,10,19,26,14,40,0.000333,0.056639,4,679.668402,37.759356,169.917101,61.748606,1,0
0,0,2,2,9,10,19,26,14,40,0.000333,0.056639,4,679.668402,37.759356,169.917101,61.748606,1,0
0,0,2,2,9,10,19,26,14,40,0.000333,0.056639,4,679.668402,37.759356,169.917101,61.748606,1,0
0,0,3,3,9,9,18,63,34,97,0.000333,0.134828,12,4853.792702,269.65515,404.482725,57.05865,1,0
0,0,4,4,10,13,23,67,37,104,0.000333,0.156817,10,4704.504434,261.361357,470.450443,81.324997,1,0
0,0,10,10,9,14,23,123,66,189,0.000333,0.284984,16,13679.25136,759.958409,854.95321,81.832294,1,0
0,0,2,2,9,10,19,26,14,40,0.000333,0.056639,4,679.668402,37.759356,169.917101,61.748606,1,0
0,0,2,2,9,10,19,26,14,40,0.000333,0.056639,4,679.668402,37.759356,169.917101,61.748606,1,0
0,0,2,2,9,10,19,26,14,40,0.000333,0.056639,4,679.668402,37.759356,169.917101,61.748606,1,0
0,0,2,2,9,10,19,26,14,40,0.000333,0.056639,4,679.668402,37.759356,169.917101,61.748606,1,0
0,0,2,2,9,10,19,26,14,40,0.000333,0.056639,4,679.668402,37.759356,169.917101,61.748606,1,0
0,0,2,2,9,10,19,26,14,40,0.000333,0.056639,4,679.668402,37.759356,169.917101,61.748606,2,0
0,0,2,2,9,10,19,26,14,40,0.000333,0.056639,4,679.668402,37.759356,169.917101,61.748606,1,0
0,0,5,5,11,13,24,36,21,57,0.000333,0.087114,5,1306.714313,72.59524,261.342863,86.159464,4,0
0,0,2,2,7,4,11,13,5,18,0.000333,0.020757,3,186.809307,10.378295,62.269769,27.651484,3,0
0,0,7,7,11,10,21,36,17,53,0.000333,0.077598,5,1163.964117,64.664673,232.792823,71.273029,4,0
0,0,17,17,16,23,39,110,55,165,0.000333,0.290697,16,13953.46186,775.192325,872.091366,168.041925,7,0
0,0,2,2,7,5,12,8,6,14,0.000333,0.01673,3,150.568425,8.364913,50.189475,31.261125,1,0
0,0,2,2,7,4,11,13,5,18,0.000333,0.020757,3,186.809307,10.378295,62.269769,27.651484,3,0
0,0,39,39,16,34,50,282,159,441,0.000333,0.829647,32,79646.09855,4424.783253,2488.94058,236.973737,9,0
0,0,4,4,15,18,33,51,32,83,0.000333,0.139562,7,2930.792983,162.821832,418.684712,133.662009,1,0
0,0,15,15,17,37,54,135,91,226,0.000333,0.433535,16,20809.67321,1156.092956,1300.604575,262.236643,9,0
0,0,16,16,26,34,60,287,186,473,0.000333,0.93132,65,181607.3514,10089.2973,2793.959252,295.185169,19,0
0,0,22,22,27,38,65,305,199,504,0.000333,1.011758,65,197292.7696,10960.70942,3035.273378,327.803208,10,0
0,0,79,79,28,80,108,846,581,1427,0.000333,3.213075,98,944643.9976,52480.22209,9639.224466,640.360185,10,0
0,0,34,34,27,62,89,478,324,802,0.000333,1.731179,65,337579.9838,18754.44354,5193.538212,497.542134,10,0
0,0,3,3,10,17,27,36,24,60,0.000333,0.095098,5,1426.466251,79.248125,285.29325,102.706149,4,0
0,0,22,22,27,38,65,315,208,523,0.000333,1.049899,65,204730.3938,11373.91077,3149.698366,327.803208,10,0
0,0,9,9,22,17,39,295,185,480,0.000333,0.845664,110,279069.2372,15503.84651,2536.993065,167.594364,37,0
0,0,31,31,27,50,77,492,340,832,0.000333,1.737989,78,406689.3793,22593.85441,5213.966402,410.574772,10,0
0,0,19,19,27,35,62,251,166,417,0.000333,0.827633,52,129110.7928,7172.821822,2482.899861,307.906868,10,0
0,0,28,28,27,53,80,417,277,694,0.000333,1.462473,65,285182.1764,15843.45424,4387.418098,431.961747,10,0
0,0,28,28,27,49,76,434,291,725,0.000333,1.509916,65,294433.5841,16357.42134,4529.747447,403.502745,10,0
0,0,26,26,27,41,68,338,218,556,0.000333,1.12821,65,220000.9071,12222.27262,3384.62934,348.041595,10,0
0,0,36,36,27,63,90,505,342,847,0.000333,1.832867,65,357408.9722,19856.05401,5498.599573,504.950598,10,0
0,0,22,22,10,23,33,154,87,241,0.000333,0.405233,15,18235.48474,1013.082486,1215.698983,137.261206,1,0
0,0,2,2,7,4,11,13,5,18,0.000333,0.020757,3,186.809307,10.378295,62.269769,27.651484,3,0
0,0,5,5,12,12,24,58,26,84,0.000333,0.128379,12,4621.642201,256.7579,385.13685,86.0391,11,0
0,0,4,4,12,12,24,49,23,72,0.000333,0.110039,6,1980.7038,110.0391,330.1173,86.0391,10,0
0,0,2,2,9,10,19,26,14,40,0.000333,0.056639,4,679.668402,37.759356,169.917101,61.748606,1,0
0,0,2,2,9,10,19,26,14,40,0.000333,0.056639,4,679.668402,37.759356,169.917101,61.748606,1,0
0,0,2,2,9,10,19,26,14,40,0.000333,0.056639,4,679.668402,37.759356,169.917101,61.748606,1,0
0,0,2,2,9,10,19,26,14,40,0.000333,0.056639,4,679.668402,37.759356,169.917101,61.748606,1,0
0,0,2,2,9,10,19,26,14,40,0.000333,0.056639,4,679.668402,37.759356,169.917101,61.748606,1,0
0,0,2,2,9,10,19,26,14,40,0.000333,0.056639,4,679.668402,37.759356,169.917101,61.748606,1,0
0,0,5,5,13,101,114,424,267,691,0.000333,1.573842,12,56658.324,3147.684667,4721.527,720.585076,7,0
0,0,2,2,9,10,19,26,14,40,0.000333,0.056639,4,679.668402,37.759356,169.917101,61.748606,2,0
0,0,2,2,9,10,19,26,14,40,0.000333,0.056639,4,679.668402,37.759356,169.917101,61.748606,1,0
0,0,2,2,9,10,19,26,14,40,0.000333,0.056639,4,679.668402,37.759356,169.917101,61.748606,1,0
0,0,2,2,9,10,19,26,14,40,0.000333,0.056639,4,679.668402,37.759356,169.917101,61.748606,1,0
0,0,2,2,9,10,19,26,14,40,0.000333,0.056639,4,679.668402,37.759356,169.917101,61.748606,1,0
0,0,10,10,9,14,23,123,66,189,0.000333,0.284984,16,13679.25136,759.958409,854.95321,81.832294,1,0
0,0,2,2,9,10,19,26,14,40,0.000333,0.056639,4,679.668402,37.759356,169.917101,61.748606,1,0
0,0,4,4,10,13,23,67,37,104,0.000333,0.156817,10,4704.504434,261.361357,470.450443,81.324997,1,0
0,0,2,2,9,10,19,26,14,40,0.000333,0.056639,4,679.668402,37.759356,169.917101,61.748606,1,0
0,0,2,2,9,10,19,26,14,40,0.000333,0.056639,4,679.668402,37.759356,169.917101,61.748606,1,0
0,0,3,3,9,9,18,63,34,97,0.000333,0.134828,12,4853.792702,269.65515,404.482725,57.05865,1,0
0,0,2,2,9,10,19,26,14,40,0.000333,0.056639,4,679.668402,37.759356,169.917101,61.748606,1,0
0,0,2,2,9,10,19,26,14,40,0.000333,0.056639,4,679.668402,37.759356,169.917101,61.748606,2,0
0,0,3,3,11,12,23,35,18,53,0.000333,0.079916,5,1198.743918,66.596884,239.748784,81.073298,2,0
0,0,2,2,9,10,19,26,14,40,0.000333,0.056639,4,679.668402,37.759356,169.917101,61.748606,1,0
0,0,2,2,9,10,19,26,14,40,0.000333,0.056639,4,679.668402,37.759356,169.917101,61.748606,1,0
0,0,2,2,9,10,19,26,14,40,0.000333,0.056639,4,679.668402,37.759356,169.917101,61.748606,1,0
0,0,3,3,11,11,22,26,15,41,0.000333,0.060946,5,914.183482,50.787971,182.836696,76.107496,3,0
0,0,10,10,15,22,37,70,39,109,0.000333,0.189277,7,3974.812918,220.82294,567.830417,156.710855,6,0
0,0,5,5,11,13,24,36,21,57,0.000333,0.087114,5,1306.714313,72.59524,261.342863,86.159464,4,0
0,0,17,17,16,23,39,110,55,165,0.000333,0.290697,16,13953.46186,775.192325,872.091366,168.041925,7,0
0,0,2,2,7,4,11,13,5,18,0.000333,0.020757,3,186.809307,10.378295,62.269769,27.651484,3,0
0,0,2,2,7,4,11,13,5,18,0.000333,0.020757,3,186.809307,10.378295,62.269769,27.651484,3,0
0,0,29,29,17,40,57,153,81,234,0.000333,0.454965,16,21838.34021,1213.241123,1364.896263,282.363992,10,0
0,0,2,2,10,5,15,12,6,18,0.000333,0.023441,5,351.620154,19.534453,70.324031,44.828921,2,0
0,0,6,6,16,18,34,49,29,78,0.000333,0.132274,8,3174.576813,176.365378,396.822102,139.05865,4,0
0,0,2,2,7,4,11,13,5,18,0.000333,0.020757,3,186.809307,10.378295,62.269769,27.651484,3,0
0,0,8,8,17,13,30,41,27,68,0.000333,0.111223,16,5338.696968,296.594276,333.668561,117.592585,4,0
0,0,3,3,14,18,32,26,25,51,0.000333,0.085,7,1785,99.166667,255,128.361619,3,0
0,0,64,64,27,65,92,611,387,998,0.000333,2.170172,65,423183.4641,23510.19245,6510.514832,519.83587,9,0
0,0,36,36,19,47,66,273,206,479,0.000333,0.965088,36,104229.5322,5790.529566,2895.264783,341.776299,20,0
0,0,61,61,30,113,143,680,485,1165,0.000333,2.780417,60,500475.0064,27804.16702,8341.250107,917.886941,64,0
0,0,13,13,19,44,63,123,96,219,0.000333,0.436341,18,23562.43746,1309.024303,1309.024303,320.925614,7,0
0,0,66,66,28,69,97,596,382,978,0.000333,2.151572,70,451830.0332,25101.66851,6454.71476,556.094125,9,0
0,0,61,61,30,104,134,620,416,1036,0.000333,2.440156,60,439228.1041,24401.56134,7320.468401,844.052449,33,0
0,0,19,19,20,53,73,252,171,423,0.000333,0.872765,30,78548.87365,4363.826314,2618.295788,390.018346,3,0
0,0,3,3,13,22,35,34,32,66,0.000333,0.112844,6,2031.196075,112.844226,338.532679,146.213212,2,0
0,0,39,39,29,51,80,459,287,746,0.000333,1.572053,70,330131.0851,18340.61584,4716.158359,430.175141,7,0
0,0,39,39,29,68,97,463,287,750,0.000333,1.649978,56,277196.3394,15399.79663,4949.934632,554.828922,7,0
0,0,69,69,25,67,92,544,394,938,0.000333,2.0397,60,367146.0669,20397.00372,6119.101115,522.524381,8,0
0,0,25,25,21,58,79,227,167,394,0.000333,0.827897,20,49673.7923,2759.655128,2483.689615,432.001564,3,0
0,0,106,106,32,119,151,1002,638,1640,0.000333,3.956995,80,949678.7018,52759.92788,11870.98377,980.483314,19,0
0,0,25,25,24,42,66,341,223,564,0.000333,1.136346,60,204542.297,11363.46094,3409.038283,336.516432,3,0
0,0,47,47,29,63,92,514,321,835,0.000333,1.815725,70,381302.1963,21183.45535,5447.174233,517.450084,9,0
0,0,17,17,20,45,65,167,114,281,0.000333,0.564095,20,33845.70711,1880.317062,1692.285355,333.571951,3,0
0,0,36,36,25,50,75,454,283,737,0.000333,1.530213,60,275438.3625,15302.13125,4590.639375,398.289214,5,0
0,0,17,17,14,19,33,131,74,205,0.000333,0.3447,21,21716.11668,1206.450927,1034.100794,134.013592,1,0
0,0,3,3,11,11,22,26,15,41,0.000333,0.060946,5,914.183482,50.787971,182.836696,76.107496,3,0
0,0,10,10,15,22,37,70,39,109,0.000333,0.189277,7,3974.812918,220.82294,567.830417,156.710855,6,0
0,0,18,18,15,30,45,101,56,157,0.000333,0.287407,7,6035.546553,335.308142,862.220936,205.810077,6,0
0,0,2,2,7,4,11,13,5,18,0.000333,0.020757,3,186.809307,10.378295,62.269769,27.651484,3,0
0,0,17,17,16,23,39,110,55,165,0.000333,0.290697,16,13953.46186,775.192325,872.091366,168.041925,7,0
0,0,3,3,11,11,22,26,15,41,0.000333,0.060946,5,914.183482,50.787971,182.836696,76.107496,3,0
0,0,10,10,15,22,37,70,39,109,0.000333,0.189277,7,3974.812918,220.82294,567.830417,156.710855,6,0
0,0,5,5,12,12,24,58,26,84,0.000333,0.128379,12,4621.642201,256.7579,385.13685,86.0391,11,0
0,0,27,27,20,36,56,148,79,227,0.000333,0.439423,20,26365.39135,1464.743964,1318.269567,272.555862,10,0
0,0,4,4,10,7,17,25,11,36,0.000333,0.04905,5,735.743311,40.874628,147.148662,52.870765,2,0
0,0,4,4,12,12,24,49,23,72,0.000333,0.110039,6,1980.7038,110.0391,330.1173,86.0391,10,0
0,0,5,5,9,9,18,27,16,43,0.000333,0.059769,4,717.2271,39.84595,179.306775,57.05865,1,0
0,0,2,2,9,10,19,26,14,40,0.000333,0.056639,4,679.668402,37.759356,169.917101,61.748606,1,0
0,0,2,2,9,10,19,26,14,40,0.000333,0.056639,4,679.668402,37.759356,169.917101,61.748606,1,0
0,0,2,2,9,10,19,26,14,40,0.000333,0.056639,4,679.668402,37.759356,169.917101,61.748606,1,0
0,0,2,2,9,10,19,26,14,40,0.000333,0.056639,4,679.668402,37.759356,169.917101,61.748606,1,0
0,0,2,2,9,10,19,26,14,40,0.000333,0.056639,4,679.668402,37.759356,169.917101,61.748606,1,0
0,0,3,3,11,12,23,35,18,53,0.000333,0.079916,5,1198.743918,66.596884,239.748784,81.073298,2,0
0,0,2,2,9,10,19,26,14,40,0.000333,0.056639,4,679.668402,37.759356,169.917101,61.748606,1,0
0,0,2,2,9,10,19,26,14,40,0.000333,0.056639,4,679.668402,37.759356,169.917101,61.748606,1,0
0,0,2,2,9,10,19,26,14,40,0.000333,0.056639,4,679.668402,37.759356,169.917101,61.748606,2,0
0,0,2,2,9,10,19,26,14,40,0.000333,0.056639,4,679.668402,37.759356,169.917101,61.748606,1,0
0,0,5,5,13,101,114,424,267,691,0.000333,1.573842,12,56658.324,3147.684667,4721.527,720.585076,7,0
0,0,2,2,9,10,19,26,14,40,0.000333,0.056639,4,679.668402,37.759356,169.917101,61.748606,1,0
0,0,2,2,9,10,19,26,14,40,0.000333,0.056639,4,679.668402,37.759356,169.917101,61.748606,1,0
0,0,2,2,9,10,19,26,14,40,0.000333,0.056639,4,679.668402,37.759356,169.917101,61.748606,1,0
0,0,3,3,9,9,18,63,34,97,0.000333,0.134828,12,4853.792702,269.65515,404.482725,57.05865,1,0
0,0,4,4,10,13,23,67,37,104,0.000333,0.156817,10,4704.504434,261.361357,470.450443,81.324997,1,0
0,0,10,10,9,14,23,123,66,189,0.000333,0.284984,16,13679.25136,759.958409,854.95321,81.832294,1,0
0,0,2,2,9,10,19,26,14,40,0.000333,0.056639,4,679.668402,37.759356,169.917101,61.748606,1,0
0,0,2,2,9,10,19,26,14,40,0.000333,0.056639,4,679.668402,37.759356,169.917101,61.748606,1,0
0,0,2,2,9,10,19,26,14,40,0.000333,0.056639,4,679.668402,37.759356,169.917101,61.748606,1,0
0,0,2,2,9,10,19,26,14,40,0.000333,0.056639,4,679.668402,37.759356,169.917101,61.748606,1,0
0,0,2,2,9,10,19,26,14,40,0.000333,0.056639,4,679.668402,37.759356,169.917101,61.748606,1,0
0,0,2,2,9,10,19,26,14,40,0.000333,0.056639,4,679.668402,37.759356,169.917101,61.748606,2,0
0,0,2,2,9,10,19,26,14,40,0.000333,0.056639,4,679.668402,37.759356,169.917101,61.748606,1,0
0,0,2,2,9,10,19,26,14,40,0.000333,0.056639,4,679.668402,37.759356,169.917101,61.748606,1,0
0,0,2,2,9,10,19,26,14,40,0.000333,0.056639,4,679.668402,37.759356,169.917101,61.748606,1,0
0,0,2,2,9,10,19,26,14,40,0.000333,0.056639,4,679.668402,37.759356,169.917101,61.748606,1,0
0,0,3,3,11,12,23,35,18,53,0.000333,0.079916,5,1198.743918,66.596884,239.748784,81.073298,2,0
0,0,2,2,9,10,19,26,14,40,0.000333,0.056639,4,679.668402,37.759356,169.917101,61.748606,1,0
0,0,2,2,9,10,19,26,14,40,0.000333,0.056639,4,679.668402,37.759356,169.917101,61.748606,1,0
0,0,2,2,9,10,19,26,14,40,0.000333,0.056639,4,679.668402,37.759356,169.917101,61.748606,2,0
0,0,2,2,9,10,19,26,14,40,0.000333,0.056639,4,679.668402,37.759356,169.917101,61.748606,1,0
0,0,5,5,13,101,114,424,267,691,0.000333,1.573842,12,56658.324,3147.684667,4721.527,720.585076,7,0
0,0,2,2,9,10,19,26,14,40,0.000333,0.056639,4,679.668402,37.759356,169.917101,61.748606,1,0
0,0,2,2,9,10,19,26,14,40,0.000333,0.056639,4,679.668402,37.759356,169.917101,61.748606,1,0
0,0,2,2,9,10,19,26,14,40,0.000333,0.056639,4,679.668402,37.759356,169.917101,61.748606,1,0
0,0,3,3,9,9,18,63,34,97,0.000333,0.134828,12,4853.792702,269.65515,404.482725,57.05865,1,0
0,0,4,4,10,13,23,67,37,104,0.000333,0.156817,10,4704.504434,261.361357,470.450443,81.324997,1,0
0,0,10,10,9,14,23,123,66,189,0.000333,0.284984,16,13679.25136,759.958409,854.95321,81.832294,1,0
0,0,2,2,9,10,19,26,14,40,0.000333,0.056639,4,679.668402,37.759356,169.917101,61.748606,1,0
0,0,2,2,9,10,19,26,14,40,0.000333,0.056639,4,679.668402,37.759356,169.917101,61.748606,1,0
0,0,2,2,9,10,19,26,14,40,0.000333,0.056639,4,679.668402,37.759356,169.917101,61.748606,1,0
0,0,2,2,9,10,19,26,14,40,0.000333,0.056639,4,679.668402,37.759356,169.917101,61.748606,1,0
0,0,1,1,6,5,11,8,5,13,0.000333,0.014991,3,134.917833,7.495435,44.972611,27.119415,1,0
0,0,2,2,9,10,19,26,14,40,0.000333,0.056639,4,679.668402,37.759356,169.917101,61.748606,2,0
0,0,2,2,9,10,19,26,14,40,0.000333,0.056639,4,679.668402,37.759356,169.917101,61.748606,1,0
0,0,7,7,12,19,31,51,37,88,0.000333,0.145323,6,2615.815652,145.323092,435.969275,123.730173,5,0
0,0,4,4,12,12,24,49,23,72,0.000333,0.110039,6,1980.7038,110.0391,330.1173,86.0391,10,0
0,0,5,5,12,12,24,58,26,84,0.000333,0.128379,12,4621.642201,256.7579,385.13685,86.0391,11,0
0,0,2,2,7,4,11,13,5,18,0.000333,0.020757,3,186.809307,10.378295,62.269769,27.651484,3,0
0,0,1,1,5,3,8,11,3,14,0.000333,0.014,2,84,4.666667,42,16.364528,2,0
0,0,2,2,9,10,19,26,14,40,0.000333,0.056639,4,679.668402,37.759356,169.917101,61.748606,1,0
0,0,2,2,9,10,19,26,14,40,0.000333,0.056639,4,679.668402,37.759356,169.917101,61.748606,1,0
0,0,2,2,9,10,19,26,14,40,0.000333,0.056639,4,679.668402,37.759356,169.917101,61.748606,1,0
0,0,2,2,9,10,19,26,14,40,0.000333,0.056639,4,679.668402,37.759356,169.917101,61.748606,1,0
0,0,2,2,9,10,19,26,14,40,0.000333,0.056639,4,679.668402,37.759356,169.917101,61.748606,1,0
0,0,2,2,9,10,19,26,14,40,0.000333,0.056639,4,679.668402,37.759356,169.917101,61.748606,1,0
0,0,2,2,9,10,19,26,14,40,0.000333,0.056639,4,679.668402,37.759356,169.917101,61.748606,1,0
0,0,2,2,9,10,19,26,14,40,0.000333,0.056639,4,679.668402,37.759356,169.917101,61.748606,1,0
0,0,10,10,9,14,23,123,66,189,0.000333,0.284984,16,13679.25136,759.958409,854.95321,81.832294,1,0
0,0,2,2,9,10,19,26,14,40,0.000333,0.056639,4,679.668402,37.759356,169.917101,61.748606,1,0
0,0,2,2,9,10,19,26,14,40,0.000333,0.056639,4,679.668402,37.759356,169.917101,61.748606,1,0
0,0,4,4,10,13,23,67,37,104,0.000333,0.156817,10,4704.504434,261.361357,470.450443,81.324997,1,0
0,0,2,2,9,10,19,26,14,40,0.000333,0.056639,4,679.668402,37.759356,169.917101,61.748606,2,0
0,0,2,2,9,10,19,26,14,40,0.000333,0.056639,4,679.668402,37.759356,169.917101,61.748606,1,0
0,0,2,2,9,10,19,26,14,40,0.000333,0.056639,4,679.668402,37.759356,169.917101,61.748606,1,0
0,0,5,5,13,101,114,424,267,691,0.000333,1.573842,12,56658.324,3147.684667,4721.527,720.585076,7,0
0,0,2,2,9,10,19,26,14,40,0.000333,0.056639,4,679.668402,37.759356,169.917101,61.748606,1,0
0,0,3,3,9,9,18,63,34,97,0.000333,0.134828,12,4853.792702,269.65515,404.482725,57.05865,1,0
0,0,2,2,9,10,19,26,14,40,0.000333,0.056639,4,679.668402,37.759356,169.917101,61.748606,1,0
0,0,2,2,9,10,19,26,14,40,0.000333,0.056639,4,679.668402,37.759356,169.917101,61.748606,2,0
0,0,2,2,9,10,19,26,14,40,0.000333,0.056639,4,679.668402,37.759356,169.917101,61.748606,1,0
0,0,3,3,11,12,23,35,18,53,0.000333,0.079916,5,1198.743918,66.596884,239.748784,81.073298,2,0
0,0,2,2,9,10,19,26,14,40,0.000333,0.056639,4,679.668402,37.759356,169.917101,61.748606,1,0
0,0,2,2,9,10,19,26,14,40,0.000333,0.056639,4,679.668402,37.759356,169.917101,61.748606,1,0
0,0,6,6,16,12,28,47,24,71,0.000333,0.113774,16,5461.155191,303.397511,341.322199,107.01955,4,0
0,0,1,1,5,3,8,11,3,14,0.000333,0.014,2,84,4.666667,42,16.364528,2,0
0,0,26,26,17,31,48,130,71,201,0.000333,0.374192,16,17961.2394,997.846633,1122.577463,223.066954,10,0
0,0,5,5,12,12,24,58,26,84,0.000333,0.128379,12,4621.642201,256.7579,385.13685,86.0391,11,0
0,0,9,9,18,18,36,80,39,119,0.000333,0.205074,18,11073.97935,615.221075,615.221075,150.1173,4,0
0,0,4,4,12,12,24,49,23,72,0.000333,0.110039,6,1980.7038,110.0391,330.1173,86.0391,10,0
0,0,2,2,9,10,19,26,14,40,0.000333,0.056639,4,679.668402,37.759356,169.917101,61.748606,1,0
0,0,2,2,9,10,19,26,14,40,0.000333,0.056639,4,679.668402,37.759356,169.917101,61.748606,1,0
0,0,3,3,9,9,18,63,34,97,0.000333,0.134828,12,4853.792702,269.65515,404.482725,57.05865,1,0
0,0,2,2,9,10,19,26,14,40,0.000333,0.056639,4,679.668402,37.759356,169.917101,61.748606,2,0
0,0,3,3,11,12,23,35,18,53,0.000333,0.079916,5,1198.743918,66.596884,239.748784,81.073298,2,0
0,0,2,2,9,10,19,26,14,40,0.000333,0.056639,4,679.668402,37.759356,169.917101,61.748606,1,0
0,0,2,2,9,10,19,26,14,40,0.000333,0.056639,4,679.668402,37.759356,169.917101,61.748606,1,0
0,0,2,2,9,10,19,26,14,40,0.000333,0.056639,4,679.668402,37.759356,169.917101,61.748606,1,0
0,0,4,4,10,13,23,67,37,104,0.000333,0.156817,10,4704.504434,261.361357,470.450443,81.324997,1,0
0,0,10,10,9,14,23,123,66,189,0.000333,0.284984,16,13679.25136,759.958409,854.95321,81.832294,1,0
0,0,2,2,9,10,19,26,14,40,0.000333,0.056639,4,679.668402,37.759356,169.917101,61.748606,1,0
0,0,2,2,9,10,19,26,14,40,0.000333,0.056639,4,679.668402,37.759356,169.917101,61.748606,1,0
0,0,2,2,9,10,19,26,14,40,0.000333,0.056639,4,679.668402,37.759356,169.917101,61.748606,1,0
0,0,5,5,13,101,114,424,267,691,0.000333,1.573842,12,56658.324,3147.684667,4721.527,720.585076,7,0
0,0,2,2,9,10,19,26,14,40,0.000333,0.056639,4,679.668402,37.759356,169.917101,61.748606,1,0
0,0,2,2,9,10,19,26,14,40,0.000333,0.056639,4,679.668402,37.759356,169.917101,61.748606,1,0
0,0,2,2,9,10,19,26,14,40,0.000333,0.056639,4,679.668402,37.759356,169.917101,61.748606,1,0
0,0,2,2,9,10,19,26,14,40,0.000333,0.056639,4,679.668402,37.759356,169.917101,61.748606,1,0
0,0,2,2,9,10,19,26,14,40,0.000333,0.056639,4,679.668402,37.759356,169.917101,61.748606,1,0
0,0,2,2,9,10,19,26,14,40,0.000333,0.056639,4,679.668402,37.759356,169.917101,61.748606,2,0
0,0,2,2,9,10,19,26,14,40,0.000333,0.056639,4,679.668402,37.759356,169.917101,61.748606,1,0
0,0,2,2,9,10,19,26,14,40,0.000333,0.056639,4,679.668402,37.759356,169.917101,61.748606,1,0
0,0,2,2,9,10,19,26,14,40,0.000333,0.056639,4,679.668402,37.759356,169.917101,61.748606,1,0
0,0,2,2,9,10,19,26,14,40,0.000333,0.056639,4,679.668402,37.759356,169.917101,61.748606,1,0
0,0,2,2,7,4,11,13,5,18,0.000333,0.020757,3,186.809307,10.378295,62.269769,27.651484,3,0
0,0,6,6,11,12,23,39,19,58,0.000333,0.087456,5,1311.832967,72.879609,262.366593,81.073298,2,0
0,0,17,17,16,23,39,110,55,165,0.000333,0.290697,16,13953.46186,775.192325,872.091366,168.041925,7,0
0,0,2,2,5,6,11,9,7,16,0.000333,0.01845,2,110.701812,6.150101,55.350906,27.119415,1,0
0,0,5,5,11,13,24,36,21,57,0.000333,0.087114,5,1306.714313,72.59524,261.342863,86.159464,3,0
0,0,4,4,12,12,24,49,23,72,0.000333,0.110039,6,1980.7038,110.0391,330.1173,86.0391,10,0
0,0,27,27,17,39,56,142,82,224,0.000333,0.433616,16,20813.56004,1156.308891,1300.847503,275.617555,10,0
0,0,5,5,12,12,24,58,26,84,0.000333,0.128379,12,4621.642201,256.7579,385.13685,86.0391,11,0
0,0,1,1,5,3,8,11,3,14,0.000333,0.014,2,84,4.666667,42,16.364528,2,0
0,0,2,2,7,4,11,13,5,18,0.000333,0.020757,3,186.809307,10.378295,62.269769,27.651484,3,0
0,0,2,2,9,10,19,26,14,40,0.000333,0.056639,4,679.668402,37.759356,169.917101,61.748606,2,0
0,0,2,2,9,10,19,26,14,40,0.000333,0.056639,4,679.668402,37.759356,169.917101,61.748606,1,0
0,0,3,3,9,9,18,63,34,97,0.000333,0.134828,12,4853.792702,269.65515,404.482725,57.05865,1,0
0,0,2,2,9,10,19,26,14,40,0.000333,0.056639,4,679.668402,37.759356,169.917101,61.748606,1,0
0,0,3,3,11,12,23,35,18,53,0.000333,0.079916,5,1198.743918,66.596884,239.748784,81.073298,2,0
0,0,2,2,9,10,19,26,14,40,0.000333,0.056639,4,679.668402,37.759356,169.917101,61.748606,1,0
0,0,2,2,9,10,19,26,14,40,0.000333,0.056639,4,679.668402,37.759356,169.917101,61.748606,1,0
0,0,2,2,9,10,19,26,14,40,0.000333,0.056639,4,679.668402,37.759356,169.917101,61.748606,1,0
0,0,2,2,9,10,19,26,14,40,0.000333,0.056639,4,679.668402,37.759356,169.917101,61.748606,1,0
0,0,2,2,9,10,19,26,14,40,0.000333,0.056639,4,679.668402,37.759356,169.917101,61.748606,1,0
0,0,2,2,9,10,19,26,14,40,0.000333,0.056639,4,679.668402,37.759356,169.917101,61.748606,1,0
0,0,2,2,9,10,19,26,14,40,0.000333,0.056639,4,679.668402,37.759356,169.917101,61.748606,1,0
0,0,2,2,9,10,19,26,14,40,0.000333,0.056639,4,679.668402,37.759356,169.917101,61.748606,1,0
0,0,2,2,9,10,19,26,14,40,0.000333,0.056639,4,679.668402,37.759356,169.917101,61.748606,1,0
0,0,2,2,9,10,19,26,14,40,0.000333,0.056639,4,679.668402,37.759356,169.917101,61.748606,1,0
0,0,2,2,9,10,19,26,14,40,0.000333,0.056639,4,679.668402,37.759356,169.917101,61.748606,1,0
0,0,10,10,9,14,23,123,66,189,0.000333,0.284984,16,13679.25136,759.958409,854.95321,81.832294,1,0
0,0,2,2,9,10,19,26,14,40,0.000333,0.056639,4,679.668402,37.759356,169.917101,61.748606,1,0
0,0,2,2,9,10,19,26,14,40,0.000333,0.056639,4,679.668402,37.759356,169.917101,61.748606,1,0
0,0,2,2,9,10,19,26,14,40,0.000333,0.056639,4,679.668402,37.759356,169.917101,61.748606,1,0
0,0,5,5,13,101,114,424,267,691,0.000333,1.573842,12,56658.324,3147.684667,4721.527,720.585076,7,0
0,0,4,4,10,13,23,67,37,104,0.000333,0.156817,10,4704.504434,261.361357,470.450443,81.324997,1,0
0,0,2,2,9,10,19,26,14,40,0.000333,0.056639,4,679.668402,37.759356,169.917101,61.748606,1,0
0,0,2,2,9,10,19,26,14,40,0.000333,0.056639,4,679.668402,37.759356,169.917101,61.748606,2,0
0,0,5,5,11,13,24,36,21,57,0.000333,0.087114,5,1306.714313,72.59524,261.342863,86.159464,3,0
0,0,5,5,12,12,24,58,26,84,0.000333,0.128379,12,4621.642201,256.7579,385.13685,86.0391,11,0
0,0,36,36,19,42,61,206,111,317,0.000333,0.626681,18,33840.78725,1880.043736,1880.043736,307.187955,12,0
0,0,4,4,12,12,24,49,23,72,0.000333,0.110039,6,1980.7038,110.0391,330.1173,86.0391,10,0
0,0,2,2,7,4,11,13,5,18,0.000333,0.020757,3,186.809307,10.378295,62.269769,27.651484,3,0
0,0,1,1,5,3,8,11,3,14,0.000333,0.014,2,84,4.666667,42,16.364528,2,0
0,0,5,5,13,101,114,424,267,691,0.000333,1.573842,12,56658.324,3147.684667,4721.527,720.585076,7,0
0,0,2,2,9,10,19,26,14,40,0.000333,0.056639,4,679.668402,37.759356,169.917101,61.748606,1,0
0,0,3,3,9,9,18,63,34,97,0.000333,0.134828,12,4853.792702,269.65515,404.482725,57.05865,1,0
0,0,2,2,9,10,19,26,14,40,0.000333,0.056639,4,679.668402,37.759356,169.917101,61.748606,1,0
0,0,2,2,9,10,19,26,14,40,0.000333,0.056639,4,679.668402,37.759356,169.917101,61.748606,1,0
0,0,2,2,9,10,19,26,14,40,0.000333,0.056639,4,679.668402,37.759356,169.917101,61.748606,1,0
0,0,2,2,9,10,19,26,14,40,0.000333,0.056639,4,679.668402,37.759356,169.917101,61.748606,1,0
0,0,2,2,9,10,19,26,14,40,0.000333,0.056639,4,679.668402,37.759356,169.917101,61.748606,1,0
0,0,2,2,9,10,19,26,14,40,0.000333,0.056639,4,679.668402,37.759356,169.917101,61.748606,1,0
0,0,2,2,9,10,19,26,14,40,0.000333,0.056639,4,679.668402,37.759356,169.917101,61.748606,1,0
0,0,2,2,9,10,19,26,14,40,0.000333,0.056639,4,679.668402,37.759356,169.917101,61.748606,1,0
0,0,2,2,9,10,19,26,14,40,0.000333,0.056639,4,679.668402,37.759356,169.917101,61.748606,1,0
0,0,2,2,9,10,19,26,14,40,0.000333,0.056639,4,679.668402,37.759356,169.917101,61.748606,1,0
0,0,2,2,9,10,19,26,14,40,0.000333,0.056639,4,679.668402,37.759356,169.917101,61.748606,1,0
0,0,2,2,9,10,19,26,14,40,0.000333,0.056639,4,679.668402,37.759356,169.917101,61.748606,1,0
0,0,2,2,9,10,19,26,14,40,0.000333,0.056639,4,679.668402,37.759356,169.917101,61.748606,1,0
0,0,4,4,10,13,23,67,37,104,0.000333,0.156817,10,4704.504434,261.361357,470.450443,81.324997,1,0
0,0,2,2,9,10,19,26,14,40,0.000333,0.056639,4,679.668402,37.759356,169.917101,61.748606,2,0
0,0,10,10,9,14,23,123,66,189,0.000333,0.284984,16,13679.25136,759.958409,854.95321,81.832294,1,0
0,0,2,2,9,10,19,26,14,40,0.000333,0.056639,4,679.668402,37.759356,169.917101,61.748606,1,0
0,0,2,2,9,10,19,26,14,40,0.000333,0.056639,4,679.668402,37.759356,169.917101,61.748606,1,0
0,0,2,2,9,10,19,26,14,40,0.000333,0.056639,4,679.668402,37.759356,169.917101,61.748606,2,0
0,0,3,3,11,12,23,35,18,53,0.000333,0.079916,5,1198.743918,66.596884,239.748784,81.073298,2,0
0,0,2,2,9,10,19,26,14,40,0.000333,0.056639,4,679.668402,37.759356,169.917101,61.748606,1,0
0,0,2,2,7,4,11,13,5,18,0.000333,0.020757,3,186.809307,10.378295,62.269769,27.651484,3,0
0,0,1,1,5,3,8,11,3,14,0.000333,0.014,2,84,4.666667,42,16.364528,2,0
0,0,5,5,12,12,24,58,26,84,0.000333,0.128379,12,4621.642201,256.7579,385.13685,86.0391,11,0
0,0,31,31,19,38,57,167,91,258,0.000333,0.501629,18,27087.94123,1504.885624,1504.885624,280.131868,11,0
0,0,26,26,22,36,58,163,92,255,0.000333,0.497928,22,32863.27338,1825.73741,1493.785154,284.224796,9,0
0,0,4,4,12,12,24,49,23,72,0.000333,0.110039,6,1980.7038,110.0391,330.1173,86.0391,10,0
0,0,2,2,9,10,19,26,14,40,0.000333,0.056639,4,679.668402,37.759356,169.917101,61.748606,2,0
0,0,2,2,9,10,19,26,14,40,0.000333,0.056639,4,679.668402,37.759356,169.917101,61.748606,1,0
0,0,2,2,9,10,19,26,14,40,0.000333,0.056639,4,679.668402,37.759356,169.917101,61.748606,1,0
0,0,3,3,11,12,23,35,18,53,0.000333,0.079916,5,1198.743918,66.596884,239.748784,81.073298,2,0
0,0,2,2,9,10,19,26,14,40,0.000333,0.056639,4,679.668402,37.759356,169.917101,61.748606,1,0
0,0,4,4,10,13,23,67,37,104,0.000333,0.156817,10,4704.504434,261.361357,470.450443,81.324997,1,0
0,0,10,10,9,14,23,123,66,189,0.000333,0.284984,16,13679.25136,759.958409,854.95321,81.832294,1,0
0,0,2,2,9,10,19,26,14,40,0.000333,0.056639,4,679.668402,37.759356,169.917101,61.748606,1,0
0,0,2,2,9,10,19,26,14,40,0.000333,0.056639,4,679.668402,37.759356,169.917101,61.748606,1,0
0,0,2,2,9,10,19,26,14,40,0.000333,0.056639,4,679.668402,37.759356,169.917101,61.748606,1,0
0,0,2,2,9,10,19,26,14,40,0.000333,0.056639,4,679.668402,37.759356,169.917101,61.748606,1,0
0,0,2,2,9,10,19,26,14,40,0.000333,0.056639,4,679.668402,37.759356,169.917101,61.748606,1,0
0,0,2,2,9,10,19,26,14,40,0.000333,0.056639,4,679.668402,37.759356,169.917101,61.748606,1,0
0,0,2,2,9,10,19,26,14,40,0.000333,0.056639,4,679.668402,37.759356,169.917101,61.748606,1,0
0,0,2,2,9,10,19,26,14,40,0.000333,0.056639,4,679.668402,37.759356,169.917101,61.748606,2,0
0,0,2,2,9,10,19,26,14,40,0.000333,0.056639,4,679.668402,37.759356,169.917101,61.748606,1,0
0,0,5,5,13,101,114,424,267,691,0.000333,1.573842,12,56658.324,3147.684667,4721.527,720.585076,7,0
0,0,2,2,9,10,19,26,14,40,0.000333,0.056639,4,679.668402,37.759356,169.917101,61.748606,1,0
0,0,3,3,9,9,18,63,34,97,0.000333,0.134828,12,4853.792702,269.65515,404.482725,57.05865,1,0
0,0,2,2,9,10,19,26,14,40,0.000333,0.056639,4,679.668402,37.759356,169.917101,61.748606,1,0
0,0,2,2,9,10,19,26,14,40,0.000333,0.056639,4,679.668402,37.759356,169.917101,61.748606,1,0
0,0,2,2,9,10,19,26,14,40,0.000333,0.056639,4,679.668402,37.759356,169.917101,61.748606,1,0
0,0,2,2,9,10,19,26,14,40,0.000333,0.056639,4,679.668402,37.759356,169.917101,61.748606,1,0
0,0,2,2,9,10,19,26,14,40,0.000333,0.056639,4,679.668402,37.759356,169.917101,61.748606,1,0
0,0,4,4,12,12,24,49,23,72,0.000333,0.110039,6,1980.7038,110.0391,330.1173,86.0391,10,0
0,0,5,5,12,12,24,58,26,84,0.000333,0.128379,12,4621.642201,256.7579,385.13685,86.0391,11,0
0,0,1,1,5,3,8,11,3,14,0.000333,0.014,2,84,4.666667,42,16.364528,2,0
0,0,2,2,7,4,11,13,5,18,0.000333,0.020757,3,186.809307,10.378295,62.269769,27.651484,3,0
0,0,3,3,9,9,18,63,34,97,0.000333,0.134828,12,4853.792702,269.65515,404.482725,57.05865,1,0
0,0,2,2,9,10,19,26,14,40,0.000333,0.056639,4,679.668402,37.759356,169.917101,61.748606,1,0
0,0,2,2,9,10,19,26,14,40,0.000333,0.056639,4,679.668402,37.759356,169.917101,61.748606,2,0
0,0,2,2,9,10,19,26,14,40,0.000333,0.056639,4,679.668402,37.759356,169.917101,61.748606,1,0
0,0,2,2,9,10,19,26,14,40,0.000333,0.056639,4,679.668402,37.759356,169.917101,61.748606,1,0
0,0,2,2,9,10,19,26,14,40,0.000333,0.056639,4,679.668402,37.759356,169.917101,61.748606,1,0
0,0,5,5,13,101,114,424,267,691,0.000333,1.573842,12,56658.324,3147.684667,4721.527,720.585076,7,0
0,0,2,2,9,10,19,26,14,40,0.000333,0.056639,4,679.668402,37.759356,169.917101,61.748606,1,0
0,0,2,2,9,10,19,26,14,40,0.000333,0.056639,4,679.668402,37.759356,169.917101,61.748606,1,0
0,0,2,2,9,10,19,26,14,40,0.000333,0.056639,4,679.668402,37.759356,169.917101,61.748606,1,0
0,0,10,10,9,14,23,123,66,189,0.000333,0.284984,16,13679.25136,759.958409,854.95321,81.832294,1,0
0,0,2,2,9,10,19,26,14,40,0.000333,0.056639,4,679.668402,37.759356,169.917101,61.748606,1,0
0,0,4,4,10,13,23,67,37,104,0.000333,0.156817,10,4704.504434,261.361357,470.450443,81.324997,1,0
0,0,2,2,9,10,19,26,14,40,0.000333,0.056639,4,679.668402,37.759356,169.917101,61.748606,1,0
0,0,2,2,9,10,19,26,14,40,0.000333,0.056639,4,679.668402,37.759356,169.917101,61.748606,2,0
0,0,3,3,11,12,23,35,18,53,0.000333,0.079916,5,1198.743918,66.596884,239.748784,81.073298,2,0
0,0,2,2,9,10,19,26,14,40,0.000333,0.056639,4,679.668402,37.759356,169.917101,61.748606,1,0
0,0,2,2,9,10,19,26,14,40,0.000333,0.056639,4,679.668402,37.759356,169.917101,61.748606,1,0
0,0,2,2,9,10,19,26,14,40,0.000333,0.056639,4,679.668402,37.759356,169.917101,61.748606,1,0
0,0,2,2,9,10,19,26,14,40,0.000333,0.056639,4,679.668402,37.759356,169.917101,61.748606,1,0
0,0,2,2,9,10,19,26,14,40,0.000333,0.056639,4,679.668402,37.759356,169.917101,61.748606,1,0
0,0,2,2,9,10,19,26,14,40,0.000333,0.056639,4,679.668402,37.759356,169.917101,61.748606,1,0
0,0,2,2,9,10,19,26,14,40,0.000333,0.056639,4,679.668402,37.759356,169.917101,61.748606,1,0
0,0,2,2,9,10,19,26,14,40,0.000333,0.056639,4,679.668402,37.759356,169.917101,61.748606,1,0
0,0,5,5,9,7,16,20,11,31,0.000333,0.041333,4,496,27.555556,124,48.180809,3,0
0,0,31,31,20,37,57,176,96,272,0.000333,0.528849,20,31730.92168,1762.828982,1586.546084,279.188336,11,0
0,0,2,2,7,4,11,13,5,18,0.000333,0.020757,3,186.809307,10.378295,62.269769,27.651484,3,0
0,0,26,26,27,41,68,338,218,556,0.000333,1.12821,65,220000.9071,12222.27262,3384.62934,348.041595,10,0
0,0,3,3,10,17,27,36,24,60,0.000333,0.095098,5,1426.466251,79.248125,285.29325,102.706149,4,0
0,0,9,9,22,17,39,295,185,480,0.000333,0.845664,110,279069.2372,15503.84651,2536.993065,167.594364,37,0
0,0,30,30,27,50,77,471,324,795,0.000333,1.660698,78,388603.4334,21589.07963,4982.0953,410.574772,10,0
0,0,26,26,27,38,65,355,228,583,0.000333,1.170347,78,273861.1539,15214.50855,3511.040435,327.803208,10,0
0,0,30,30,27,49,76,470,316,786,0.000333,1.636957,78,383047.94,21280.44111,4910.871026,403.502745,10,0
0,0,36,36,27,63,90,505,342,847,0.000333,1.832867,65,357408.9722,19856.05401,5498.599573,504.950598,10,0
0,0,19,19,27,38,65,275,184,459,0.000333,0.921422,52,143741.875,7985.65972,2764.266826,327.803208,10,0
0,0,15,15,17,37,54,135,91,226,0.000333,0.433535,16,20809.67321,1156.092956,1300.604575,262.236643,9,0
0,0,4,4,15,18,33,51,32,83,0.000333,0.139562,7,2930.792983,162.821832,418.684712,133.662009,1,0
0,0,19,19,27,35,62,251,166,417,0.000333,0.827633,52,129110.7928,7172.821822,2482.899861,307.906868,10,0
0,0,31,31,27,62,89,445,301,746,0.000333,1.610299,52,251206.6513,13955.92507,4830.89714,497.542134,10,0
0,0,67,67,28,79,107,726,495,1221,0.000333,2.743777,84,691431.82,38412.87889,8231.33119,632.604617,10,0
0,0,28,28,27,53,80,417,277,694,0.000333,1.462473,65,285182.1764,15843.45424,4387.418098,431.961747,10,0
0,0,20,20,26,34,60,342,224,566,0.000333,1.114433,78,260777.406,14487.63367,3343.300077,295.185169,19,0
0,0,39,39,16,34,50,282,159,441,0.000333,0.829647,32,79646.09855,4424.783253,2488.94058,236.973737,9,0
0,0,30,30,20,43,63,161,87,248,0.000333,0.494122,20,29647.30842,1647.07269,1482.365421,319.767946,14,0
0,0,2,2,7,4,11,13,5,18,0.000333,0.020757,3,186.809307,10.378295,62.269769,27.651484,3,0
0,0,19,19,14,36,50,119,66,185,0.000333,0.348038,7,7308.793766,406.044098,1044.113395,239.420269,14,0
0,0,4,4,11,10,21,30,16,46,0.000333,0.067349,5,1010.233007,56.124056,202.046601,71.273029,1,0
0,0,3,3,11,11,22,26,15,41,0.000333,0.060946,5,914.183482,50.787971,182.836696,76.107496,3,0
0,0,10,10,15,22,37,70,39,109,0.000333,0.189277,7,3974.812918,220.82294,567.830417,156.710855,6,0
0,0,7,7,11,10,21,36,17,53,0.000333,0.077598,5,1163.964117,64.664673,232.792823,71.273029,4,0
0,0,2,2,7,4,11,13,5,18,0.000333,0.020757,3,186.809307,10.378295,62.269769,27.651484,3,0
0,0,8,8,10,13,23,50,26,76,0.000333,0.114597,10,3437.907087,190.994838,343.790709,81.324997,3,0
0,0,21,21,17,32,49,123,66,189,0.000333,0.353727,16,16978.88257,943.271254,1061.180161,229.486868,8,0
0,0,30,30,15,42,57,242,104,346,0.000333,0.672727,14,28254.51923,1569.695513,2018.179945,285.080691,12,0
0,0,33,33,20,45,65,173,96,269,0.000333,0.540006,20,32400.33883,1800.018824,1620.016942,333.571951,11,0
0,0,2,2,7,4,11,13,5,18,0.000333,0.020757,3,186.809307,10.378295,62.269769,27.651484,3,0
0,0,3,3,11,11,22,26,15,41,0.000333,0.060946,5,914.183482,50.787971,182.836696,76.107496,3,0
0,0,10,10,15,22,37,70,39,109,0.000333,0.189277,7,3974.812918,220.82294,567.830417,156.710855,6,0
0,0,24,24,17,36,53,135,73,208,0.000333,0.397136,16,19062.51927,1059.028848,1191.407455,255.604168,8,0
0,0,11,11,12,20,32,62,38,100,0.000333,0.166667,6,3000,166.666667,500,129.458112,15,0
0,0,31,31,20,37,57,176,96,272,0.000333,0.528849,20,31730.92168,1762.828982,1586.546084,279.188336,13,0
0,0,20,20,24,31,55,156,84,240,0.000333,0.462509,24,33300.63195,1850.035108,1387.526331,263.619186,8,0
0,0,5,5,11,13,24,26,20,46,0.000333,0.070303,5,1054.541375,58.585632,210.908275,86.159464,1,0
0,0,2,2,7,4,11,13,5,18,0.000333,0.020757,3,186.809307,10.378295,62.269769,27.651484,3,0
0,0,9,9,22,17,39,295,185,480,0.000333,0.845664,110,279069.2372,15503.84651,2536.993065,167.594364,37,0
0,0,31,31,27,50,77,492,340,832,0.000333,1.737989,78,406689.3793,22593.85441,5213.966402,410.574772,10,0
0,0,39,39,16,34,50,282,159,441,0.000333,0.829647,32,79646.09855,4424.783253,2488.94058,236.973737,9,0
0,0,36,36,27,63,90,505,342,847,0.000333,1.832867,65,357408.9722,19856.05401,5498.599573,504.950598,10,0
0,0,15,15,17,37,54,135,91,226,0.000333,0.433535,16,20809.67321,1156.092956,1300.604575,262.236643,9,0
0,0,28,28,27,53,80,417,277,694,0.000333,1.462473,65,285182.1764,15843.45424,4387.418098,431.961747,10,0
0,0,19,19,27,35,62,251,166,417,0.000333,0.827633,52,129110.7928,7172.821822,2482.899861,307.906868,10,0
0,0,17,17,26,34,60,302,195,497,0.000333,0.978575,65,190822.1007,10601.22782,2935.724626,295.185169,19,0
0,0,22,22,27,38,65,305,199,504,0.000333,1.011758,65,197292.7696,10960.70942,3035.273378,327.803208,10,0
0,0,29,29,27,49,76,449,300,749,0.000333,1.559899,78,365016.4212,20278.69007,4679.697708,403.502745,10,0
0,0,4,4,15,18,33,51,32,83,0.000333,0.139562,7,2930.792983,162.821832,418.684712,133.662009,1,0
0,0,64,64,28,79,107,675,461,1136,0.000333,2.552769,70,536081.4548,29782.30304,7658.306497,632.604617,10,0
0,0,26,26,27,41,68,338,218,556,0.000333,1.12821,65,220000.9071,12222.27262,3384.62934,348.041595,10,0
0,0,31,31,27,62,89,445,301,746,0.000333,1.610299,52,251206.6513,13955.92507,4830.89714,497.542134,10,0
0,0,3,3,10,17,27,36,24,60,0.000333,0.095098,5,1426.466251,79.248125,285.29325,102.706149,4,0
0,0,19,19,27,38,65,275,184,459,0.000333,0.921422,52,143741.875,7985.65972,2764.266826,327.803208,10,0
0,0,3,3,11,11,22,26,15,41,0.000333,0.060946,5,914.183482,50.787971,182.836696,76.107496,3,0
0,0,10,10,15,22,37,70,39,109,0.000333,0.189277,7,3974.812918,220.82294,567.830417,156.710855,6,0
0,0,2,2,7,4,11,13,5,18,0.000333,0.020757,3,186.809307,10.378295,62.269769,27.651484,3,0
0,0,17,17,16,23,39,110,55,165,0.000333,0.290697,16,13953.46186,775.192325,872.091366,168.041925,7,0
0,0,2,2,7,4,11,13,5,18,0.000333,0.020757,3,186.809307,10.378295,62.269769,27.651484,3,0
0,0,17,17,15,28,43,100,52,152,0.000333,0.274931,7,5773.545699,320.752539,824.792243,193.209297,7,0
0,0,2,2,8,8,16,22,11,33,0.000333,0.044,4,528,29.333333,132,48,1,0
0,0,2,2,7,4,11,13,5,18,0.000333,0.020757,3,186.809307,10.378295,62.269769,27.651484,3,0
0,0,16,16,13,26,39,87,48,135,0.000333,0.237843,6,4281.175797,237.8431,713.5293,170.317149,5,0
0,0,17,17,16,23,39,110,55,165,0.000333,0.290697,16,13953.46186,775.192325,872.091366,168.041925,7,0
0,0,8,8,11,11,22,54,31,85,0.000333,0.126351,10,3790.516876,210.584271,379.051688,76.107496,1,0
0,0,5,5,11,13,24,36,21,57,0.000333,0.087114,5,1306.714313,72.59524,261.342863,86.159464,3,0
0,0,2,2,7,4,11,13,5,18,0.000333,0.020757,3,186.809307,10.378295,62.269769,27.651484,3,0
0,0,6,6,15,11,26,56,26,82,0.000333,0.128479,14,5396.104796,299.7836,385.436057,96.657107,4,0
0,0,22,22,17,35,52,129,69,198,0.000333,0.376229,8,9029.496514,501.638695,1128.687064,249.011774,8,0
0,0,5,5,14,9,23,39,20,59,0.000333,0.088963,14,3736.462176,207.581232,266.890155,81.832294,4,0
0,0,2,2,7,4,11,13,5,18,0.000333,0.020757,3,186.809307,10.378295,62.269769,27.651484,3,0
0,0,5,5,11,13,24,27,17,44,0.000333,0.067246,5,1008.69175,56.038431,201.73835,86.159464,2,0
0,0,17,17,16,23,39,110,55,165,0.000333,0.290697,16,13953.46186,775.192325,872.091366,168.041925,7,0
0,0,7,7,10,12,22,51,24,75,0.000333,0.111486,10,3344.573714,185.809651,334.457371,76.238831,1,0
0,0,8,8,10,14,24,66,30,96,0.000333,0.146719,10,4401.564001,244.531333,440.1564,86.52225,1,0
0,0,5,5,7,8,15,19,13,32,0.000333,0.041673,3,375.061497,20.83675,125.020499,43.651484,2,0
0,0,32,32,19,40,59,169,94,263,0.000333,0.515712,18,27848.4322,1547.135122,1547.135122,293.587747,11,0
0,0,17,17,16,23,39,110,55,165,0.000333,0.290697,16,13953.46186,775.192325,872.091366,168.041925,7,0
0,0,3,3,9,6,15,18,8,26,0.000333,0.03386,4,406.316622,22.573146,101.579155,44.0391,2,0
0,0,17,17,16,23,39,110,55,165,0.000333,0.290697,16,13953.46186,775.192325,872.091366,168.041925,7,0
0,0,3,3,8,4,12,13,6,19,0.000333,0.022705,4,272.45715,15.136508,68.114288,32,6,0
0,0,5,5,14,9,23,39,20,59,0.000333,0.088963,14,3736.462176,207.581232,266.890155,81.832294,4,0
0,0,26,26,17,31,48,130,71,201,0.000333,0.374192,16,17961.2394,997.846633,1122.577463,223.066954,10,0
0,0,5,5,14,9,23,39,20,59,0.000333,0.088963,14,3736.462176,207.581232,266.890155,81.832294,4,0
0,0,11,11,18,19,37,86,41,127,0.000333,0.220534,18,11908.81039,661.600577,661.600577,155.769273,5,0
0,0,17,17,16,23,39,110,55,165,0.000333,0.290697,16,13953.46186,775.192325,872.091366,168.041925,7,0
0,0,2,2,7,4,11,13,5,18,0.000333,0.020757,3,186.809307,10.378295,62.269769,27.651484,3,0
0,0,25,25,13,34,47,114,65,179,0.000333,0.331424,6,5965.628427,331.423801,994.271404,221.079453,6,0
0,0,17,17,16,23,39,110,55,165,0.000333,0.290697,16,13953.46186,775.192325,872.091366,168.041925,7,0
0,0,4,4,8,5,13,15,8,23,0.000333,0.02837,4,340.440454,18.913359,85.110114,35.60964,4,0
1,0,17,18,16,37,53,123,72,195,0.000333,0.372315,8,8935.555909,496.419773,1116.944489,256.749775,1,0
0,0,5,5,12,12,24,58,26,84,0.000333,0.128379,12,4621.642201,256.7579,385.13685,86.0391,11,0
0,0,4,4,12,12,24,49,23,72,0.000333,0.110039,6,1980.7038,110.0391,330.1173,86.0391,10,0
0,0,2,2,7,4,11,13,5,18,0.000333,0.020757,3,186.809307,10.378295,62.269769,27.651484,3,0
0,0,1,1,5,3,8,11,3,14,0.000333,0.014,2,84,4.666667,42,16.364528,2,0
0,0,2,2,9,10,19,26,14,40,0.000333,0.056639,4,679.668402,37.759356,169.917101,61.748606,1,0
0,0,2,2,9,10,19,26,14,40,0.000333,0.056639,4,679.668402,37.759356,169.917101,61.748606,1,0
0,0,3,3,9,9,18,63,34,97,0.000333,0.134828,12,4853.792702,269.65515,404.482725,57.05865,1,0
0,0,2,2,9,10,19,26,14,40,0.000333,0.056639,4,679.668402,37.759356,169.917101,61.748606,1,0
0,0,2,2,9,10,19,26,14,40,0.000333,0.056639,4,679.668402,37.759356,169.917101,61.748606,1,0
0,0,10,10,9,14,23,123,66,189,0.000333,0.284984,16,13679.25136,759.958409,854.95321,81.832294,1,0
0,0,2,2,9,10,19,26,14,40,0.000333,0.056639,4,679.668402,37.759356,169.917101,61.748606,1,0
0,0,2,2,9,10,19,26,14,40,0.000333,0.056639,4,679.668402,37.759356,169.917101,61.748606,1,0
0,0,2,2,9,10,19,26,14,40,0.000333,0.056639,4,679.668402,37.759356,169.917101,61.748606,1,0
0,0,2,2,9,10,19,26,14,40,0.000333,0.056639,4,679.668402,37.759356,169.917101,61.748606,1,0
0,0,5,5,13,101,114,424,267,691,0.000333,1.573842,12,56658.324,3147.684667,4721.527,720.585076,7,0
0,0,2,2,9,10,19,26,14,40,0.000333,0.056639,4,679.668402,37.759356,169.917101,61.748606,1,0
0,0,2,2,9,10,19,26,14,40,0.000333,0.056639,4,679.668402,37.759356,169.917101,61.748606,2,0
0,0,3,3,11,12,23,35,18,53,0.000333,0.079916,5,1198.743918,66.596884,239.748784,81.073298,2,0
0,0,2,2,9,10,19,26,14,40,0.000333,0.056639,4,679.668402,37.759356,169.917101,61.748606,1,0
0,0,2,2,9,10,19,26,14,40,0.000333,0.056639,4,679.668402,37.759356,169.917101,61.748606,2,0
0,0,2,2,9,10,19,26,14,40,0.000333,0.056639,4,679.668402,37.759356,169.917101,61.748606,1,0
0,0,2,2,9,10,19,26,14,40,0.000333,0.056639,4,679.668402,37.759356,169.917101,61.748606,1,0
0,0,2,2,9,10,19,26,14,40,0.000333,0.056639,4,679.668402,37.759356,169.917101,61.748606,1,0
0,0,2,2,9,10,19,26,14,40,0.000333,0.056639,4,679.668402,37.759356,169.917101,61.748606,1,0
0,0,4,4,10,13,23,67,37,104,0.000333,0.156817,10,4704.504434,261.361357,470.450443,81.324997,1,0
0,0,2,2,9,10,19,26,14,40,0.000333,0.056639,4,679.668402,37.759356,169.917101,61.748606,1,0
0,0,2,2,9,10,19,26,14,40,0.000333,0.056639,4,679.668402,37.759356,169.917101,61.748606,1,0
0,0,2,2,9,10,19,26,14,40,0.000333,0.056639,4,679.668402,37.759356,169.917101,61.748606,1,0
0,0,30,30,19,40,59,160,85,245,0.000333,0.480416,18,25942.45585,1441.247547,1441.247547,293.587747,10,0
0,0,15,15,12,24,36,87,47,134,0.000333,0.230923,6,4156.619701,230.923317,692.76995,153.05865,5,0
0,0,2,2,7,4,11,13,5,18,0.000333,0.020757,3,186.809307,10.378295,62.269769,27.651484,3,0
0,0,2,2,9,4,13,17,9,26,0.000333,0.03207,8,769.691461,42.760637,96.211433,36.529325,1,0
0,0,2,2,8,6,14,12,9,21,0.000333,0.026651,4,319.817813,17.767656,79.954453,39.509775,1,0
0,0,3,3,11,11,22,26,15,41,0.000333,0.060946,5,914.183482,50.787971,182.836696,76.107496,3,0
0,0,10,10,15,22,37,70,39,109,0.000333,0.189277,7,3974.812918,220.82294,567.830417,156.710855,6,0
0,0,3,3,11,11,22,26,15,41,0.000333,0.060946,5,914.183482,50.787971,182.836696,76.107496,3,0
0,0,10,10,15,22,37,70,39,109,0.000333,0.189277,7,3974.812918,220.82294,567.830417,156.710855,6,0
0,0,6,6,11,17,28,47,33,80,0.000333,0.128196,5,1922.941969,106.830109,384.588394,107.540616,3,0
0,0,5,5,11,13,24,36,21,57,0.000333,0.087114,5,1306.714313,72.59524,261.342863,86.159464,4,0
0,0,7,7,9,14,23,41,25,66,0.000333,0.099518,4,1194.220356,66.345575,298.555089,81.832294,3,0
0,0,6,6,16,18,34,49,29,78,0.000333,0.132274,8,3174.576813,176.365378,396.822102,139.05865,4,0
0,0,2,2,10,5,15,12,6,18,0.000333,0.023441,5,351.620154,19.534453,70.324031,44.828921,2,0
0,0,8,8,17,13,30,41,27,68,0.000333,0.111223,16,5338.696968,296.594276,333.668561,117.592585,4,0
0,0,17,17,16,23,39,110,55,165,0.000333,0.290697,16,13953.46186,775.192325,872.091366,168.041925,7,0
0,0,2,2,7,4,11,13,5,18,0.000333,0.020757,3,186.809307,10.378295,62.269769,27.651484,3,0
0,0,1,1,8,3,11,10,3,13,0.000333,0.014991,4,179.890444,9.993914,44.972611,28.754888,2,0
0,0,73,73,30,104,134,726,485,1211,0.000333,2.852345,60,513422.0406,28523.4467,8557.03401,844.052449,42,0
0,0,3,3,14,18,32,26,25,51,0.000333,0.085,7,1785,99.166667,255,128.361619,3,0
0,0,25,25,24,42,66,341,223,564,0.000333,1.136346,60,204542.297,11363.46094,3409.038283,336.516432,3,0
0,0,57,57,27,65,92,628,389,1017,0.000333,2.211488,65,431240.0631,23957.78128,6634.462509,519.83587,11,0
0,0,3,3,13,22,35,34,32,66,0.000333,0.112844,6,2031.196075,112.844226,338.532679,146.213212,2,0
0,0,17,17,19,44,63,160,124,284,0.000333,0.565849,18,30555.85497,1697.547498,1697.547498,320.925614,8,0
0,0,39,39,29,68,97,463,287,750,0.000333,1.649978,56,277196.3394,15399.79663,4949.934632,554.828922,7,0
0,0,25,25,21,58,79,227,167,394,0.000333,0.827897,20,49673.7923,2759.655128,2483.689615,432.001564,3,0
0,0,17,17,20,45,65,167,114,281,0.000333,0.564095,20,33845.70711,1880.317062,1692.285355,333.571951,3,0
0,0,49,49,29,63,92,541,339,880,0.000333,1.913578,70,401851.4165,22325.07869,5740.734521,517.450084,9,0
0,0,69,69,30,113,143,777,549,1326,0.000333,3.164663,60,569639.3636,31646.63131,9493.989393,917.886941,70,0
0,0,17,17,14,19,33,131,74,205,0.000333,0.3447,21,21716.11668,1206.450927,1034.100794,134.013592,1,0
0,0,19,19,20,53,73,252,171,423,0.000333,0.872765,30,78548.87365,4363.826314,2618.295788,390.018346,3,0
0,0,108,108,32,119,151,1067,676,1743,0.000333,4.205513,80,1009323.157,56073.50871,12616.53946,980.483314,20,0
0,0,42,42,29,51,80,509,316,825,0.000333,1.73853,84,438109.617,24339.42317,5215.590678,430.175141,7,0
0,0,38,38,25,50,75,505,307,812,0.000333,1.685934,72,364161.6559,20231.20311,5057.800777,398.289214,5,0
0,0,37,37,19,47,66,280,209,489,0.000333,0.985236,36,106405.5141,5911.417449,2955.708724,341.776299,21,0
0,0,72,72,25,67,92,618,447,1065,0.000333,2.315864,72,500226.7308,27790.37393,6947.593483,522.524381,8,0
0,0,72,72,28,69,97,688,437,1125,0.000333,2.474967,84,623691.7636,34649.54242,7424.901947,556.094125,11,0
0,0,26,26,17,33,50,140,73,213,0.000333,0.400714,16,19234.2619,1068.570105,1202.141368,235.951874,10,0
0,0,2,2,7,4,11,13,5,18,0.000333,0.020757,3,186.809307,10.378295,62.269769,27.651484,3,0
0,0,6,6,13,31,44,240,168,408,0.000333,0.742483,30,66823.44301,3712.413501,2227.4481,201.685802,1,0
0,0,2,2,7,4,11,13,5,18,0.000333,0.020757,3,186.809307,10.378295,62.269769,27.651484,3,0
0,0,5,5,10,12,22,31,18,49,0.000333,0.072837,5,1092.560747,60.697819,218.512149,76.238831,1,0
0,0,7,7,13,20,33,55,39,94,0.000333,0.158058,6,2845.038283,158.057682,474.173047,134.544278,2,0
0,0,5,5,12,12,24,58,26,84,0.000333,0.128379,12,4621.642201,256.7579,385.13685,86.0391,11,0
0,0,4,4,12,12,24,49,23,72,0.000333,0.110039,6,1980.7038,110.0391,330.1173,86.0391,10,0
0,0,2,2,7,4,11,13,5,18,0.000333,0.020757,3,186.809307,10.378295,62.269769,27.651484,3,0
0,0,1,1,5,3,8,11,3,14,0.000333,0.014,2,84,4.666667,42,16.364528,2,0
0,0,2,2,9,10,19,26,14,40,0.000333,0.056639,4,679.668402,37.759356,169.917101,61.748606,1,0
0,0,2,2,9,10,19,26,14,40,0.000333,0.056639,4,679.668402,37.759356,169.917101,61.748606,1,0
0,0,3,3,9,9,18,63,34,97,0.000333,0.134828,12,4853.792702,269.65515,404.482725,57.05865,1,0
0,0,2,2,9,10,19,26,14,40,0.000333,0.056639,4,679.668402,37.759356,169.917101,61.748606,1,0
0,0,2,2,9,10,19,26,14,40,0.000333,0.056639,4,679.668402,37.759356,169.917101,61.748606,1,0
0,0,10,10,9,14,23,123,66,189,0.000333,0.284984,16,13679.25136,759.958409,854.95321,81.832294,1,0
0,0,2,2,9,10,19,26,14,40,0.000333,0.056639,4,679.668402,37.759356,169.917101,61.748606,1,0
0,0,2,2,9,10,19,26,14,40,0.000333,0.056639,4,679.668402,37.759356,169.917101,61.748606,1,0
0,0,2,2,9,10,19,26,14,40,0.000333,0.056639,4,679.668402,37.759356,169.917101,61.748606,1,0
0,0,2,2,9,10,19,26,14,40,0.000333,0.056639,4,679.668402,37.759356,169.917101,61.748606,1,0
0,0,5,5,13,101,114,424,267,691,0.000333,1.573842,12,56658.324,3147.684667,4721.527,720.585076,7,0
0,0,2,2,9,10,19,26,14,40,0.000333,0.056639,4,679.668402,37.759356,169.917101,61.748606,1,0
0,0,2,2,9,10,19,26,14,40,0.000333,0.056639,4,679.668402,37.759356,169.917101,61.748606,2,0
0,0,3,3,11,12,23,35,18,53,0.000333,0.079916,5,1198.743918,66.596884,239.748784,81.073298,2,0
0,0,2,2,9,10,19,26,14,40,0.000333,0.056639,4,679.668402,37.759356,169.917101,61.748606,1,0
0,0,2,2,9,10,19,26,14,40,0.000333,0.056639,4,679.668402,37.759356,169.917101,61.748606,2,0
0,0,2,2,9,10,19,26,14,40,0.000333,0.056639,4,679.668402,37.759356,169.917101,61.748606,1,0
0,0,2,2,9,10,19,26,14,40,0.000333,0.056639,4,679.668402,37.759356,169.917101,61.748606,1,0
0,0,2,2,9,10,19,26,14,40,0.000333,0.056639,4,679.668402,37.759356,169.917101,61.748606,1,0
0,0,2,2,9,10,19,26,14,40,0.000333,0.056639,4,679.668402,37.759356,169.917101,61.748606,1,0
0,0,4,4,10,13,23,67,37,104,0.000333,0.156817,10,4704.504434,261.361357,470.450443,81.324997,1,0
0,0,2,2,9,10,19,26,14,40,0.000333,0.056639,4,679.668402,37.759356,169.917101,61.748606,1,0
0,0,2,2,9,10,19,26,14,40,0.000333,0.056639,4,679.668402,37.759356,169.917101,61.748606,1,0
0,0,2,2,9,10,19,26,14,40,0.000333,0.056639,4,679.668402,37.759356,169.917101,61.748606,1,0
0,0,3,3,11,11,22,26,15,41,0.000333,0.060946,5,914.183482,50.787971,182.836696,76.107496,3,0
0,0,10,10,15,22,37,70,39,109,0.000333,0.189277,7,3974.812918,220.82294,567.830417,156.710855,6,0
0,0,10,10,12,21,33,53,39,92,0.000333,0.154695,6,2784.505554,154.694753,464.084259,135.258216,3,0
0,0,17,17,16,23,39,110,55,165,0.000333,0.290697,16,13953.46186,775.192325,872.091366,168.041925,7,0
0,0,5,5,11,9,20,22,13,35,0.000333,0.050422,5,756.337417,42.018745,151.267483,66.583073,2,0
0,0,2,2,7,7,14,9,8,17,0.000333,0.021575,3,194.175101,10.787506,64.725034,39.302969,2,0
0,0,3,3,11,11,22,26,15,41,0.000333,0.060946,5,914.183482,50.787971,182.836696,76.107496,3,0
0,0,10,10,15,22,37,70,39,109,0.000333,0.189277,7,3974.812918,220.82294,567.830417,156.710855,6,0
0,0,5,5,11,13,24,36,21,57,0.000333,0.087114,5,1306.714313,72.59524,261.342863,86.159464,3,0
0,0,2,2,7,4,11,13,5,18,0.000333,0.020757,3,186.809307,10.378295,62.269769,27.651484,3,0
0,0,32,32,20,40,60,182,99,281,0.000333,0.553279,20,33196.72515,1844.262508,1659.836257,299.315686,13,0
0,0,2,2,7,4,11,13,5,18,0.000333,0.020757,3,186.809307,10.378295,62.269769,27.651484,3,0
0,0,14,14,16,20,36,94,67,161,0.000333,0.277453,24,19976.59021,1109.810567,832.357925,150.438562,1,0
0,0,2,2,5,6,11,9,7,16,0.000333,0.01845,2,110.701812,6.150101,55.350906,27.119415,1,0
0,0,32,32,28,54,82,318,187,505,0.000333,1.070188,42,134843.678,7491.315445,3210.563762,445.369863,20,0
0,0,5,5,11,13,24,36,21,57,0.000333,0.087114,5,1306.714313,72.59524,261.342863,86.159464,3,0
0,0,28,28,20,39,59,158,85,243,0.000333,0.476494,20,28589.64522,1588.313623,1429.482261,292.569248,10,0
0,0,2,2,7,4,11,13,5,18,0.000333,0.020757,3,186.809307,10.378295,62.269769,27.651484,3,0
0,0,2,2,7,4,11,13,5,18,0.000333,0.020757,3,186.809307,10.378295,62.269769,27.651484,3,0
0,0,8,8,9,15,24,33,26,59,0.000333,0.090171,4,1082.05115,60.113953,270.512788,87.132684,3,0
0,0,18,18,16,34,50,102,59,161,0.000333,0.302887,8,7269.286772,403.849265,908.660847,236.973737,14,0
0,0,2,2,7,4,11,13,5,18,0.000333,0.020757,3,186.809307,10.378295,62.269769,27.651484,3,0
0,0,17,17,16,23,39,110,55,165,0.000333,0.290697,16,13953.46186,775.192325,872.091366,168.041925,7,0
0,0,6,6,16,12,28,47,24,71,0.000333,0.113774,16,5461.155191,303.397511,341.322199,107.01955,4,0
0,0,60,60,28,80,108,639,434,1073,0.000333,2.415998,70,507359.6003,28186.64446,7247.99429,640.360185,10,0
0,0,3,3,10,17,27,36,24,60,0.000333,0.095098,5,1426.466251,79.248125,285.29325,102.706149,4,0
0,0,21,21,27,38,65,286,184,470,0.000333,0.943504,52,147186.6694,8177.037186,2830.512872,327.803208,10,0
0,0,26,26,27,53,80,397,266,663,0.000333,1.397146,65,272443.4912,15135.74951,4191.438327,431.961747,10,0
0,0,15,15,17,37,54,135,91,226,0.000333,0.433535,16,20809.67321,1156.092956,1300.604575,262.236643,9,0
0,0,9,9,22,17,39,295,185,480,0.000333,0.845664,110,279069.2372,15503.84651,2536.993065,167.594364,37,0
0,0,38,38,27,63,90,541,367,908,0.000333,1.964868,65,383149.1697,21286.06499,5894.602611,504.950598,10,0
0,0,39,39,16,34,50,282,159,441,0.000333,0.829647,32,79646.09855,4424.783253,2488.94058,236.973737,9,0
0,0,32,32,27,50,77,507,349,856,0.000333,1.788123,78,418420.8037,23245.60021,5364.369279,410.574772,10,0
0,0,19,19,27,35,62,251,166,417,0.000333,0.827633,52,129110.7928,7172.821822,2482.899861,307.906868,10,0
0,0,26,26,27,41,68,338,218,556,0.000333,1.12821,65,220000.9071,12222.27262,3384.62934,348.041595,10,0
0,0,19,19,27,38,65,275,184,459,0.000333,0.921422,52,143741.875,7985.65972,2764.266826,327.803208,10,0
0,0,29,29,27,49,76,449,300,749,0.000333,1.559899,78,365016.4212,20278.69007,4679.697708,403.502745,10,0
0,0,4,4,15,18,33,51,32,83,0.000333,0.139562,7,2930.792983,162.821832,418.684712,133.662009,1,0
0,0,16,16,26,34,60,287,186,473,0.000333,0.93132,65,181607.3514,10089.2973,2793.959252,295.185169,19,0
0,0,35,35,27,62,89,493,333,826,0.000333,1.782985,65,347682.1279,19315.67377,5348.955814,497.542134,10,0
0,0,6,6,13,16,29,32,23,55,0.000333,0.089063,6,1603.133728,89.062985,267.188955,112.105716,2,0
0,0,5,5,11,14,25,27,22,49,0.000333,0.07585,5,1137.744766,63.208043,227.548953,91.356717,1,0
0,0,2,2,7,4,11,13,5,18,0.000333,0.020757,3,186.809307,10.378295,62.269769,27.651484,3,0
0,0,15,15,14,12,26,87,46,133,0.000333,0.208386,21,13128.32813,729.351563,625.158483,96.322519,5,0
0,0,17,17,16,23,39,110,55,165,0.000333,0.290697,16,13953.46186,775.192325,872.091366,168.041925,7,0
0,0,6,6,15,11,26,56,26,82,0.000333,0.128479,14,5396.104796,299.7836,385.436057,96.657107,4,0
0,0,4,4,9,8,17,19,11,30,0.000333,0.040875,4,490.495541,27.249752,122.623885,52.529325,2,0
0,0,3,3,11,11,22,26,15,41,0.000333,0.060946,5,914.183482,50.787971,182.836696,76.107496,3,0
0,0,10,10,15,22,37,70,39,109,0.000333,0.189277,7,3974.812918,220.82294,567.830417,156.710855,6,0
0,0,2,2,7,4,11,13,5,18,0.000333,0.020757,3,186.809307,10.378295,62.269769,27.651484,3,0
0,0,5,5,12,12,24,58,26,84,0.000333,0.128379,12,4621.642201,256.7579,385.13685,86.0391,11,0
0,0,27,27,19,35,54,145,76,221,0.000333,0.423943,18,22892.94248,1271.830138,1271.830138,260.235528,10,0
0,0,4,4,10,7,17,25,11,36,0.000333,0.04905,5,735.743311,40.874628,147.148662,52.870765,2,0
0,0,1,1,5,3,8,11,3,14,0.000333,0.014,2,84,4.666667,42,16.364528,2,0
0,0,5,5,9,9,18,27,16,43,0.000333,0.059769,4,717.2271,39.84595,179.306775,57.05865,1,0
0,0,2,2,9,10,19,26,14,40,0.000333,0.056639,4,679.668402,37.759356,169.917101,61.748606,1,0
0,0,5,5,13,101,114,424,267,691,0.000333,1.573842,12,56658.324,3147.684667,4721.527,720.585076,7,0
0,0,2,2,9,10,19,26,14,40,0.000333,0.056639,4,679.668402,37.759356,169.917101,61.748606,1,0
0,0,2,2,9,10,19,26,14,40,0.000333,0.056639,4,679.668402,37.759356,169.917101,61.748606,1,0
0,0,2,2,9,10,19,26,14,40,0.000333,0.056639,4,679.668402,37.759356,169.917101,61.748606,1,0
0,0,2,2,9,10,19,26,14,40,0.000333,0.056639,4,679.668402,37.759356,169.917101,61.748606,1,0
0,0,2,2,9,10,19,26,14,40,0.000333,0.056639,4,679.668402,37.759356,169.917101,61.748606,1,0
0,0,2,2,9,10,19,26,14,40,0.000333,0.056639,4,679.668402,37.759356,169.917101,61.748606,1,0
0,0,2,2,9,10,19,26,14,40,0.000333,0.056639,4,679.668402,37.759356,169.917101,61.748606,1,0
0,0,2,2,9,10,19,26,14,40,0.000333,0.056639,4,679.668402,37.759356,169.917101,61.748606,1,0
0,0,2,2,9,10,19,26,14,40,0.000333,0.056639,4,679.668402,37.759356,169.917101,61.748606,1,0
0,0,2,2,9,10,19,26,14,40,0.000333,0.056639,4,679.668402,37.759356,169.917101,61.748606,2,0
0,0,2,2,9,10,19,26,14,40,0.000333,0.056639,4,679.668402,37.759356,169.917101,61.748606,1,0
0,0,2,2,9,10,19,26,14,40,0.000333,0.056639,4,679.668402,37.759356,169.917101,61.748606,2,0
0,0,3,3,11,12,23,35,18,53,0.000333,0.079916,5,1198.743918,66.596884,239.748784,81.073298,2,0
0,0,10,10,9,14,23,123,66,189,0.000333,0.284984,16,13679.25136,759.958409,854.95321,81.832294,1,0
0,0,2,2,9,10,19,26,14,40,0.000333,0.056639,4,679.668402,37.759356,169.917101,61.748606,1,0
0,0,3,3,9,9,18,63,34,97,0.000333,0.134828,12,4853.792702,269.65515,404.482725,57.05865,1,0
0,0,2,2,9,10,19,26,14,40,0.000333,0.056639,4,679.668402,37.759356,169.917101,61.748606,1,0
0,0,4,4,10,13,23,67,37,104,0.000333,0.156817,10,4704.504434,261.361357,470.450443,81.324997,1,0
0,0,2,2,9,10,19,26,14,40,0.000333,0.056639,4,679.668402,37.759356,169.917101,61.748606,1,0
0,0,2,2,9,10,19,26,14,40,0.000333,0.056639,4,679.668402,37.759356,169.917101,61.748606,1,0
0,0,2,2,9,10,19,26,14,40,0.000333,0.056639,4,679.668402,37.759356,169.917101,61.748606,1,0
0,0,2,2,9,10,19,26,14,40,0.000333,0.056639,4,679.668402,37.759356,169.917101,61.748606,1,0
0,0,5,5,11,13,24,36,21,57,0.000333,0.087114,5,1306.714313,72.59524,261.342863,86.159464,4,0
0,0,17,17,16,23,39,110,55,165,0.000333,0.290697,16,13953.46186,775.192325,872.091366,168.041925,7,0
0,0,2,2,7,4,11,13,5,18,0.000333,0.020757,3,186.809307,10.378295,62.269769,27.651484,3,0
0,0,1,1,5,3,8,11,3,14,0.000333,0.014,2,84,4.666667,42,16.364528,2,0
0,0,31,31,20,37,57,168,91,259,0.000333,0.503573,20,30214.37027,1678.576126,1510.718514,279.188336,11,0
0,0,5,5,11,10,21,30,14,44,0.000333,0.064421,5,966.309833,53.68388,193.261967,71.273029,3,0
0,0,4,4,12,12,24,49,23,72,0.000333,0.110039,6,1980.7038,110.0391,330.1173,86.0391,10,0
0,0,5,5,12,12,24,58,26,84,0.000333,0.128379,12,4621.642201,256.7579,385.13685,86.0391,11,0
0,0,2,2,9,10,19,26,14,40,0.000333,0.056639,4,679.668402,37.759356,169.917101,61.748606,1,0
0,0,10,10,9,14,23,123,66,189,0.000333,0.284984,16,13679.25136,759.958409,854.95321,81.832294,1,0
0,0,2,2,9,10,19,26,14,40,0.000333,0.056639,4,679.668402,37.759356,169.917101,61.748606,1,0
0,0,3,3,11,12,23,35,18,53,0.000333,0.079916,5,1198.743918,66.596884,239.748784,81.073298,2,0
0,0,5,5,13,101,114,424,267,691,0.000333,1.573842,12,56658.324,3147.684667,4721.527,720.585076,7,0
0,0,2,2,9,10,19,26,14,40,0.000333,0.056639,4,679.668402,37.759356,169.917101,61.748606,2,0
0,0,2,2,9,10,19,26,14,40,0.000333,0.056639,4,679.668402,37.759356,169.917101,61.748606,1,0
0,0,2,2,9,10,19,26,14,40,0.000333,0.056639,4,679.668402,37.759356,169.917101,61.748606,1,0
0,0,2,2,9,10,19,26,14,40,0.000333,0.056639,4,679.668402,37.759356,169.917101,61.748606,1,0
0,0,2,2,9,10,19,26,14,40,0.000333,0.056639,4,679.668402,37.759356,169.917101,61.748606,1,0
0,0,2,2,9,10,19,26,14,40,0.000333,0.056639,4,679.668402,37.759356,169.917101,61.748606,2,0
0,0,2,2,9,10,19,26,14,40,0.000333,0.056639,4,679.668402,37.759356,169.917101,61.748606,1,0
0,0,2,2,9,10,19,26,14,40,0.000333,0.056639,4,679.668402,37.759356,169.917101,61.748606,1,0
0,0,2,2,9,10,19,26,14,40,0.000333,0.056639,4,679.668402,37.759356,169.917101,61.748606,1,0
0,0,2,2,9,10,19,26,14,40,0.000333,0.056639,4,679.668402,37.759356,169.917101,61.748606,1,0
0,0,2,2,9,10,19,26,14,40,0.000333,0.056639,4,679.668402,37.759356,169.917101,61.748606,1,0
0,0,2,2,9,10,19,26,14,40,0.000333,0.056639,4,679.668402,37.759356,169.917101,61.748606,1,0
0,0,2,2,9,10,19,26,14,40,0.000333,0.056639,4,679.668402,37.759356,169.917101,61.748606,1,0
0,0,2,2,9,10,19,26,14,40,0.000333,0.056639,4,679.668402,37.759356,169.917101,61.748606,1,0
0,0,3,3,9,9,18,63,34,97,0.000333,0.134828,12,4853.792702,269.65515,404.482725,57.05865,1,0
0,0,2,2,9,10,19,26,14,40,0.000333,0.056639,4,679.668402,37.759356,169.917101,61.748606,1,0
0,0,2,2,9,10,19,26,14,40,0.000333,0.056639,4,679.668402,37.759356,169.917101,61.748606,1,0
0,0,2,2,9,10,19,26,14,40,0.000333,0.056639,4,679.668402,37.759356,169.917101,61.748606,1,0
0,0,4,4,10,13,23,67,37,104,0.000333,0.156817,10,4704.504434,261.361357,470.450443,81.324997,1,0
0,0,2,2,9,10,19,13,13,26,0.000333,0.036815,4,441.784461,24.543581,110.446115,61.748606,1,0
0,0,2,2,9,8,17,15,12,27,0.000333,0.036787,4,441.445987,24.524777,110.361497,52.529325,1,0
0,0,2,2,9,6,15,11,8,19,0.000333,0.024744,4,296.923685,16.49576,74.230921,44.0391,2,0
0,0,5,5,11,13,24,36,21,57,0.000333,0.087114,5,1306.714313,72.59524,261.342863,86.159464,3,0
0,0,36,36,21,45,66,198,112,310,0.000333,0.624587,20,37475.24354,2081.957974,1873.762177,339.372055,12,0
0,0,2,2,7,4,11,13,5,18,0.000333,0.020757,3,186.809307,10.378295,62.269769,27.651484,3,0
0,0,5,5,12,12,24,58,26,84,0.000333,0.128379,12,4621.642201,256.7579,385.13685,86.0391,11,0
0,0,4,4,12,12,24,49,23,72,0.000333,0.110039,6,1980.7038,110.0391,330.1173,86.0391,10,0
0,0,1,1,5,3,8,11,3,14,0.000333,0.014,2,84,4.666667,42,16.364528,2,0
0,0,2,2,7,4,11,13,5,18,0.000333,0.020757,3,186.809307,10.378295,62.269769,27.651484,3,0
0,0,2,2,9,10,19,26,14,40,0.000333,0.056639,4,679.668402,37.759356,169.917101,61.748606,1,0
0,0,2,2,9,10,19,26,14,40,0.000333,0.056639,4,679.668402,37.759356,169.917101,61.748606,1,0
0,0,2,2,9,10,19,26,14,40,0.000333,0.056639,4,679.668402,37.759356,169.917101,61.748606,1,0
0,0,2,2,9,10,19,26,14,40,0.000333,0.056639,4,679.668402,37.759356,169.917101,61.748606,1,0
0,0,2,2,9,10,19,26,14,40,0.000333,0.056639,4,679.668402,37.759356,169.917101,61.748606,1,0
0,0,3,3,11,12,23,35,18,53,0.000333,0.079916,5,1198.743918,66.596884,239.748784,81.073298,2,0
0,0,2,2,9,10,19,26,14,40,0.000333,0.056639,4,679.668402,37.759356,169.917101,61.748606,1,0
0,0,4,4,10,13,23,67,37,104,0.000333,0.156817,10,4704.504434,261.361357,470.450443,81.324997,1,0
0,0,10,10,9,14,23,123,66,189,0.000333,0.284984,16,13679.25136,759.958409,854.95321,81.832294,1,0
0,0,2,2,9,10,19,26,14,40,0.000333,0.056639,4,679.668402,37.759356,169.917101,61.748606,2,0
0,0,3,3,9,9,18,63,34,97,0.000333,0.134828,12,4853.792702,269.65515,404.482725,57.05865,1,0
0,0,2,2,9,10,19,26,14,40,0.000333,0.056639,4,679.668402,37.759356,169.917101,61.748606,2,0
0,0,2,2,9,10,19,26,14,40,0.000333,0.056639,4,679.668402,37.759356,169.917101,61.748606,1,0
0,0,2,2,9,10,19,26,14,40,0.000333,0.056639,4,679.668402,37.759356,169.917101,61.748606,1,0
0,0,2,2,9,10,19,26,14,40,0.000333,0.056639,4,679.668402,37.759356,169.917101,61.748606,1,0
0,0,2,2,9,10,19,26,14,40,0.000333,0.056639,4,679.668402,37.759356,169.917101,61.748606,1,0
0,0,2,2,9,10,19,26,14,40,0.000333,0.056639,4,679.668402,37.759356,169.917101,61.748606,1,0
0,0,2,2,9,10,19,26,14,40,0.000333,0.056639,4,679.668402,37.759356,169.917101,61.748606,1,0
0,0,5,5,13,101,114,424,267,691,0.000333,1.573842,12,56658.324,3147.684667,4721.527,720.585076,7,0
0,0,2,2,9,10,19,26,14,40,0.000333,0.056639,4,679.668402,37.759356,169.917101,61.748606,1,0
0,0,2,2,9,10,19,26,14,40,0.000333,0.056639,4,679.668402,37.759356,169.917101,61.748606,1,0
0,0,2,2,9,10,19,26,14,40,0.000333,0.056639,4,679.668402,37.759356,169.917101,61.748606,1,0
0,0,2,2,9,10,19,26,14,40,0.000333,0.056639,4,679.668402,37.759356,169.917101,61.748606,1,0
0,0,2,2,9,10,19,26,14,40,0.000333,0.056639,4,679.668402,37.759356,169.917101,61.748606,1,0
0,0,5,5,12,12,24,58,26,84,0.000333,0.128379,12,4621.642201,256.7579,385.13685,86.0391,11,0
0,0,4,4,12,12,24,49,23,72,0.000333,0.110039,6,1980.7038,110.0391,330.1173,86.0391,10,0
0,0,1,1,5,3,8,11,3,14,0.000333,0.014,2,84,4.666667,42,16.364528,2,0
0,0,2,2,7,4,11,13,5,18,0.000333,0.020757,3,186.809307,10.378295,62.269769,27.651484,3,0
0,0,2,2,9,10,19,26,14,40,0.000333,0.056639,4,679.668402,37.759356,169.917101,61.748606,1,0
0,0,2,2,9,10,19,26,14,40,0.000333,0.056639,4,679.668402,37.759356,169.917101,61.748606,1,0
0,0,2,2,9,10,19,26,14,40,0.000333,0.056639,4,679.668402,37.759356,169.917101,61.748606,1,0
0,0,2,2,9,10,19,26,14,40,0.000333,0.056639,4,679.668402,37.759356,169.917101,61.748606,1,0
0,0,2,2,9,10,19,26,14,40,0.000333,0.056639,4,679.668402,37.759356,169.917101,61.748606,1,0
0,0,3,3,11,12,23,35,18,53,0.000333,0.079916,5,1198.743918,66.596884,239.748784,81.073298,2,0
0,0,2,2,9,10,19,26,14,40,0.000333,0.056639,4,679.668402,37.759356,169.917101,61.748606,1,0
0,0,4,4,10,13,23,67,37,104,0.000333,0.156817,10,4704.504434,261.361357,470.450443,81.324997,1,0
0,0,10,10,9,14,23,123,66,189,0.000333,0.284984,16,13679.25136,759.958409,854.95321,81.832294,1,0
0,0,2,2,9,10,19,26,14,40,0.000333,0.056639,4,679.668402,37.759356,169.917101,61.748606,2,0
0,0,3,3,9,9,18,63,34,97,0.000333,0.134828,12,4853.792702,269.65515,404.482725,57.05865,1,0
0,0,2,2,9,10,19,26,14,40,0.000333,0.056639,4,679.668402,37.759356,169.917101,61.748606,2,0
0,0,2,2,9,10,19,26,14,40,0.000333,0.056639,4,679.668402,37.759356,169.917101,61.748606,1,0
0,0,2,2,9,10,19,26,14,40,0.000333,0.056639,4,679.668402,37.759356,169.917101,61.748606,1,0
0,0,2,2,9,10,19,26,14,40,0.000333,0.056639,4,679.668402,37.759356,169.917101,61.748606,1,0
0,0,2,2,9,10,19,26,14,40,0.000333,0.056639,4,679.668402,37.759356,169.917101,61.748606,1,0
0,0,2,2,9,10,19,26,14,40,0.000333,0.056639,4,679.668402,37.759356,169.917101,61.748606,1,0
0,0,2,2,9,10,19,26,14,40,0.000333,0.056639,4,679.668402,37.759356,169.917101,61.748606,1,0
0,0,16,16,11,23,34,103,64,167,0.000333,0.283202,10,8496.062945,472.003497,849.606294,142.095673,1,0
0,0,5,5,13,101,114,424,267,691,0.000333,1.573842,12,56658.324,3147.684667,4721.527,720.585076,7,0
0,0,2,2,9,10,19,26,14,40,0.000333,0.056639,4,679.668402,37.759356,169.917101,61.748606,1,0
0,0,2,2,9,10,19,26,14,40,0.000333,0.056639,4,679.668402,37.759356,169.917101,61.748606,1,0
0,0,2,2,9,10,19,26,14,40,0.000333,0.056639,4,679.668402,37.759356,169.917101,61.748606,1,0
0,0,2,2,9,10,19,26,14,40,0.000333,0.056639,4,679.668402,37.759356,169.917101,61.748606,1,0
0,0,2,2,9,10,19,26,14,40,0.000333,0.056639,4,679.668402,37.759356,169.917101,61.748606,1,0
0,0,29,29,18,44,62,151,84,235,0.000333,0.466412,9,12593.1252,699.618066,1399.236133,315.273641,12,0
0,0,2,2,7,4,11,13,5,18,0.000333,0.020757,3,186.809307,10.378295,62.269769,27.651484,3,0
0,0,22,22,12,31,43,136,72,208,0.000333,0.376221,12,13543.95683,752.442046,1128.663069,196.599636,7,0
0,0,7,7,8,16,24,40,27,67,0.000333,0.102397,4,1228.76995,68.264997,307.192488,88,4,0
0,0,32,32,17,44,61,161,92,253,0.000333,0.500159,16,24007.62474,1333.75693,1500.476546,309.70186,10,0
0,0,2,2,7,4,11,13,5,18,0.000333,0.020757,3,186.809307,10.378295,62.269769,27.651484,3,0
0,0,29,29,17,39,56,179,95,274,0.000333,0.530405,16,25459.44398,1414.413554,1591.215249,275.617555,14,0
0,0,2,2,7,4,11,13,5,18,0.000333,0.020757,3,186.809307,10.378295,62.269769,27.651484,3,0
0,0,1,1,5,3,8,11,3,14,0.000333,0.014,2,84,4.666667,42,16.364528,2,0
0,0,4,4,12,12,24,49,23,72,0.000333,0.110039,6,1980.7038,110.0391,330.1173,86.0391,10,0
0,0,28,28,19,37,56,153,80,233,0.000333,0.451038,18,24356.04654,1353.113697,1353.113697,273.460397,10,0
0,0,5,5,12,12,24,58,26,84,0.000333,0.128379,12,4621.642201,256.7579,385.13685,86.0391,11,0
0,0,18,18,13,29,42,117,61,178,0.000333,0.319944,12,11517.99002,639.888334,959.832501,188.987165,6,0
0,0,5,5,13,101,114,424,267,691,0.000333,1.573842,12,56658.324,3147.684667,4721.527,720.585076,7,0
0,0,2,2,9,10,19,26,14,40,0.000333,0.056639,4,679.668402,37.759356,169.917101,61.748606,1,0
0,0,3,3,9,9,18,63,34,97,0.000333,0.134828,12,4853.792702,269.65515,404.482725,57.05865,1,0
0,0,2,2,9,10,19,26,14,40,0.000333,0.056639,4,679.668402,37.759356,169.917101,61.748606,1,0
0,0,2,2,9,10,19,26,14,40,0.000333,0.056639,4,679.668402,37.759356,169.917101,61.748606,1,0
0,0,2,2,9,10,19,26,14,40,0.000333,0.056639,4,679.668402,37.759356,169.917101,61.748606,1,0
0,0,2,2,9,10,19,26,14,40,0.000333,0.056639,4,679.668402,37.759356,169.917101,61.748606,1,0
0,0,2,2,9,10,19,26,14,40,0.000333,0.056639,4,679.668402,37.759356,169.917101,61.748606,1,0
0,0,2,2,9,10,19,26,14,40,0.000333,0.056639,4,679.668402,37.759356,169.917101,61.748606,1,0
0,0,2,2,9,10,19,26,14,40,0.000333,0.056639,4,679.668402,37.759356,169.917101,61.748606,1,0
0,0,2,2,9,10,19,26,14,40,0.000333,0.056639,4,679.668402,37.759356,169.917101,61.748606,1,0
0,0,2,2,9,10,19,26,14,40,0.000333,0.056639,4,679.668402,37.759356,169.917101,61.748606,1,0
0,0,2,2,9,10,19,26,14,40,0.000333,0.056639,4,679.668402,37.759356,169.917101,61.748606,1,0
0,0,2,2,9,10,19,26,14,40,0.000333,0.056639,4,679.668402,37.759356,169.917101,61.748606,1,0
0,0,2,2,9,10,19,26,14,40,0.000333,0.056639,4,679.668402,37.759356,169.917101,61.748606,1,0
0,0,2,2,9,10,19,26,14,40,0.000333,0.056639,4,679.668402,37.759356,169.917101,61.748606,1,0
0,0,4,4,10,13,23,67,37,104,0.000333,0.156817,10,4704.504434,261.361357,470.450443,81.324997,1,0
0,0,2,2,9,10,19,26,14,40,0.000333,0.056639,4,679.668402,37.759356,169.917101,61.748606,2,0
0,0,10,10,9,14,23,123,66,189,0.000333,0.284984,16,13679.25136,759.958409,854.95321,81.832294,1,0
0,0,2,2,9,10,19,26,14,40,0.000333,0.056639,4,679.668402,37.759356,169.917101,61.748606,1,0
0,0,2,2,9,10,19,26,14,40,0.000333,0.056639,4,679.668402,37.759356,169.917101,61.748606,1,0
0,0,2,2,9,10,19,26,14,40,0.000333,0.056639,4,679.668402,37.759356,169.917101,61.748606,2,0
0,0,3,3,11,12,23,35,18,53,0.000333,0.079916,5,1198.743918,66.596884,239.748784,81.073298,2,0
0,0,2,2,9,10,19,26,14,40,0.000333,0.056639,4,679.668402,37.759356,169.917101,61.748606,1,0
0,0,7,7,11,17,28,29,25,54,0.000333,0.086532,5,1297.985829,72.110324,259.597166,107.540616,1,0
0,0,3,3,11,11,22,26,15,41,0.000333,0.060946,5,914.183482,50.787971,182.836696,76.107496,3,0
0,0,10,10,15,22,37,70,39,109,0.000333,0.189277,7,3974.812918,220.82294,567.830417,156.710855,6,0
0,0,5,5,11,13,24,36,21,57,0.000333,0.087114,5,1306.714313,72.59524,261.342863,86.159464,3,0
0,0,28,28,19,38,57,154,81,235,0.000333,0.45691,18,24673.12476,1370.729153,1370.729153,280.131868,10,0
0,0,2,2,7,4,11,13,5,18,0.000333,0.020757,3,186.809307,10.378295,62.269769,27.651484,3,0
0,0,9,9,13,15,28,53,27,80,0.000333,0.128196,6,2307.530363,128.196131,384.588394,106.709075,4,0
0,0,31,31,20,37,57,168,91,259,0.000333,0.503573,20,30214.37027,1678.576126,1510.718514,279.188336,11,0
0,0,2,2,7,4,11,13,5,18,0.000333,0.020757,3,186.809307,10.378295,62.269769,27.651484,3,0
0,0,4,4,9,7,16,18,10,28,0.000333,0.037333,4,448,24.888889,112,48.180809,2,0
0,0,17,17,16,23,39,110,55,165,0.000333,0.290697,16,13953.46186,775.192325,872.091366,168.041925,7,0
0,0,5,5,11,13,24,36,21,57,0.000333,0.087114,5,1306.714313,72.59524,261.342863,86.159464,3,0
0,0,2,2,7,4,11,13,5,18,0.000333,0.020757,3,186.809307,10.378295,62.269769,27.651484,3,0
0,0,17,17,16,23,39,110,55,165,0.000333,0.290697,16,13953.46186,775.192325,872.091366,168.041925,7,0
0,0,15,15,12,24,36,88,45,133,0.000333,0.2292,6,4125.600151,229.200008,687.600025,153.05865,5,0
0,0,17,17,16,23,39,110,55,165,0.000333,0.290697,16,13953.46186,775.192325,872.091366,168.041925,7,0
0,0,2,2,7,4,11,13,5,18,0.000333,0.020757,3,186.809307,10.378295,62.269769,27.651484,3,0
0,0,22,22,17,34,51,128,68,196,0.000333,0.370598,16,17788.72587,988.262548,1111.795367,242.460605,8,0
0,0,23,23,12,32,44,136,72,208,0.000333,0.378521,12,13626.74132,757.041184,1135.561777,203.01955,7,0
0,0,2,2,7,4,11,13,5,18,0.000333,0.020757,3,186.809307,10.378295,62.269769,27.651484,3,0
0,0,4,4,10,11,21,33,17,50,0.000333,0.073205,5,1098.079356,61.004409,219.615871,71.273029,1,0
0,0,2,2,11,6,17,14,8,22,0.000333,0.029975,5,449.620913,24.97894,89.924183,53.563523,2,0
0,0,2,2,7,4,11,13,5,18,0.000333,0.020757,3,186.809307,10.378295,62.269769,27.651484,3,0
0,0,26,26,13,30,43,181,102,283,0.000333,0.511878,18,27641.39266,1535.632926,1535.632926,195.312434,1,0
0,0,3,3,11,11,22,26,15,41,0.000333,0.060946,5,914.183482,50.787971,182.836696,76.107496,3,0
0,0,10,10,15,22,37,70,39,109,0.000333,0.189277,7,3974.812918,220.82294,567.830417,156.710855,6,0
0,0,5,5,11,13,24,36,21,57,0.000333,0.087114,5,1306.714313,72.59524,261.342863,86.159464,3,0
0,0,17,17,16,23,39,110,55,165,0.000333,0.290697,16,13953.46186,775.192325,872.091366,168.041925,7,0
0,0,3,3,10,6,16,21,9,30,0.000333,0.04,5,600,33.333333,120,48.729056,3,0
0,0,2,2,7,4,11,13,5,18,0.000333,0.020757,3,186.809307,10.378295,62.269769,27.651484,3,0
0,0,2,2,8,3,11,9,5,14,0.000333,0.016144,4,193.728171,10.762676,48.432043,28.754888,3,0
0,0,4,4,9,6,15,15,11,26,0.000333,0.03386,4,406.316622,22.573146,101.579155,44.0391,3,0
0,0,4,4,14,11,25,57,30,87,0.000333,0.134672,14,5656.216839,314.234269,404.015489,91.356717,1,0
0,0,5,5,10,10,20,201,18,219,0.000333,0.315501,5,4732.511264,262.917292,946.502253,66.438562,1,0
0,0,40,40,23,42,65,295,165,460,0.000333,0.92343,33,91419.5434,5078.863522,2770.289194,330.519257,16,0
0,0,8,8,16,17,33,121,69,190,0.000333,0.319478,32,30669.91625,1703.884236,958.434883,133.486868,1,0
0,0,2,2,7,4,11,13,5,18,0.000333,0.020757,3,186.809307,10.378295,62.269769,27.651484,3,0
0,0,3,3,11,11,22,26,15,41,0.000333,0.060946,5,914.183482,50.787971,182.836696,76.107496,3,0
0,0,10,10,15,22,37,70,39,109,0.000333,0.189277,7,3974.812918,220.82294,567.830417,156.710855,6,0
0,0,2,2,7,4,11,13,5,18,0.000333,0.020757,3,186.809307,10.378295,62.269769,27.651484,3,0
0,0,7,7,8,17,25,34,27,61,0.000333,0.094425,4,1133.10091,62.950051,283.275228,93.486868,3,0
0,0,2,2,7,4,11,13,5,18,0.000333,0.020757,3,186.809307,10.378295,62.269769,27.651484,3,0
0,0,5,5,12,12,24,58,26,84,0.000333,0.128379,12,4621.642201,256.7579,385.13685,86.0391,11,0
0,0,4,4,12,12,24,49,23,72,0.000333,0.110039,6,1980.7038,110.0391,330.1173,86.0391,10,0
0,0,27,27,17,38,55,141,81,222,0.000333,0.427821,16,20535.3897,1140.854983,1283.461856,268.908114,10,0
0,0,25,25,17,35,52,148,81,229,0.000333,0.435134,16,20886.41113,1160.356174,1305.400695,249.011774,10,0
0,0,1,1,5,3,8,11,3,14,0.000333,0.014,2,84,4.666667,42,16.364528,2,0
0,0,2,2,7,4,11,13,5,18,0.000333,0.020757,3,186.809307,10.378295,62.269769,27.651484,3,0
0,0,2,2,9,10,19,26,14,40,0.000333,0.056639,4,679.668402,37.759356,169.917101,61.748606,1,0
0,0,5,5,13,101,114,424,267,691,0.000333,1.573842,12,56658.324,3147.684667,4721.527,720.585076,7,0
0,0,2,2,9,10,19,26,14,40,0.000333,0.056639,4,679.668402,37.759356,169.917101,61.748606,1,0
0,0,2,2,9,10,19,26,14,40,0.000333,0.056639,4,679.668402,37.759356,169.917101,61.748606,1,0
0,0,2,2,9,10,19,26,14,40,0.000333,0.056639,4,679.668402,37.759356,169.917101,61.748606,1,0
0,0,2,2,9,10,19,26,14,40,0.000333,0.056639,4,679.668402,37.759356,169.917101,61.748606,2,0
0,0,2,2,9,10,19,26,14,40,0.000333,0.056639,4,679.668402,37.759356,169.917101,61.748606,1,0
0,0,2,2,9,10,19,26,14,40,0.000333,0.056639,4,679.668402,37.759356,169.917101,61.748606,1,0
0,0,3,3,9,9,18,63,34,97,0.000333,0.134828,12,4853.792702,269.65515,404.482725,57.05865,1,0
0,0,2,2,9,10,19,26,14,40,0.000333,0.056639,4,679.668402,37.759356,169.917101,61.748606,1,0
0,0,2,2,9,10,19,26,14,40,0.000333,0.056639,4,679.668402,37.759356,169.917101,61.748606,1,0
0,0,2,2,9,10,19,26,14,40,0.000333,0.056639,4,679.668402,37.759356,169.917101,61.748606,1,0
0,0,2,2,9,10,19,26,14,40,0.000333,0.056639,4,679.668402,37.759356,169.917101,61.748606,1,0
0,0,2,2,9,10,19,26,14,40,0.000333,0.056639,4,679.668402,37.759356,169.917101,61.748606,1,0
0,0,2,2,9,10,19,26,14,40,0.000333,0.056639,4,679.668402,37.759356,169.917101,61.748606,1,0
0,0,2,2,9,10,19,26,14,40,0.000333,0.056639,4,679.668402,37.759356,169.917101,61.748606,2,0
0,0,10,10,9,14,23,123,66,189,0.000333,0.284984,16,13679.25136,759.958409,854.95321,81.832294,1,0
0,0,2,2,9,10,19,26,14,40,0.000333,0.056639,4,679.668402,37.759356,169.917101,61.748606,1,0
0,0,4,4,10,13,23,67,37,104,0.000333,0.156817,10,4704.504434,261.361357,470.450443,81.324997,1,0
0,0,2,2,9,10,19,26,14,40,0.000333,0.056639,4,679.668402,37.759356,169.917101,61.748606,1,0
0,0,2,2,9,10,19,26,14,40,0.000333,0.056639,4,679.668402,37.759356,169.917101,61.748606,1,0
0,0,3,3,11,12,23,35,18,53,0.000333,0.079916,5,1198.743918,66.596884,239.748784,81.073298,2,0
0,0,2,2,9,10,19,26,14,40,0.000333,0.056639,4,679.668402,37.759356,169.917101,61.748606,1,0
0,0,2,2,9,10,19,26,14,40,0.000333,0.056639,4,679.668402,37.759356,169.917101,61.748606,1,0
0,0,31,31,19,37,56,165,87,252,0.000333,0.487818,18,26342.16193,1463.45344,1463.45344,273.460397,11,0
0,0,2,2,7,4,11,13,5,18,0.000333,0.020757,3,186.809307,10.378295,62.269769,27.651484,3,0
0,0,16,16,13,26,39,87,48,135,0.000333,0.237843,6,4281.175797,237.8431,713.5293,170.317149,5,0
0,0,36,36,20,37,57,170,118,288,0.000333,0.559957,30,50396.16972,2799.787207,1679.872324,279.188336,14,0
0,0,1,1,5,3,8,11,3,14,0.000333,0.014,2,84,4.666667,42,16.364528,2,0
0,0,27,27,19,35,54,148,78,226,0.000333,0.433535,18,23410.88236,1300.604575,1300.604575,260.235528,10,0
0,0,4,4,12,12,24,49,23,72,0.000333,0.110039,6,1980.7038,110.0391,330.1173,86.0391,10,0
0,0,14,14,18,20,38,79,45,124,0.000333,0.216914,18,11713.37421,650.743012,650.743012,161.497212,5,0
0,0,5,5,12,12,24,58,26,84,0.000333,0.128379,12,4621.642201,256.7579,385.13685,86.0391,11,0
0,0,2,2,9,10,19,26,14,40,0.000333,0.056639,4,679.668402,37.759356,169.917101,61.748606,1,0
0,0,2,2,9,10,19,26,14,40,0.000333,0.056639,4,679.668402,37.759356,169.917101,61.748606,1,0
0,0,3,3,9,9,18,63,34,97,0.000333,0.134828,12,4853.792702,269.65515,404.482725,57.05865,1,0
0,0,2,2,9,10,19,26,14,40,0.000333,0.056639,4,679.668402,37.759356,169.917101,61.748606,2,0
0,0,3,3,11,12,23,35,18,53,0.000333,0.079916,5,1198.743918,66.596884,239.748784,81.073298,2,0
0,0,2,2,9,10,19,26,14,40,0.000333,0.056639,4,679.668402,37.759356,169.917101,61.748606,1,0
0,0,6,6,9,12,21,31,19,50,0.000333,0.073205,4,878.463485,48.803527,219.615871,71.548875,1,0
0,0,2,2,9,10,19,26,14,40,0.000333,0.056639,4,679.668402,37.759356,169.917101,61.748606,1,0
0,0,2,2,9,10,19,26,14,40,0.000333,0.056639,4,679.668402,37.759356,169.917101,61.748606,1,0
0,0,4,4,10,13,23,67,37,104,0.000333,0.156817,10,4704.504434,261.361357,470.450443,81.324997,1,0
0,0,10,10,9,14,23,123,66,189,0.000333,0.284984,16,13679.25136,759.958409,854.95321,81.832294,1,0
0,0,2,2,9,10,19,26,14,40,0.000333,0.056639,4,679.668402,37.759356,169.917101,61.748606,1,0
0,0,2,2,9,10,19,26,14,40,0.000333,0.056639,4,679.668402,37.759356,169.917101,61.748606,1,0
0,0,2,2,9,10,19,26,14,40,0.000333,0.056639,4,679.668402,37.759356,169.917101,61.748606,1,0
0,0,5,5,13,101,114,424,267,691,0.000333,1.573842,12,56658.324,3147.684667,4721.527,720.585076,7,0
0,0,2,2,9,10,19,26,14,40,0.000333,0.056639,4,679.668402,37.759356,169.917101,61.748606,1,0
0,0,2,2,9,10,19,26,14,40,0.000333,0.056639,4,679.668402,37.759356,169.917101,61.748606,1,0
0,0,2,2,9,10,19,26,14,40,0.000333,0.056639,4,679.668402,37.759356,169.917101,61.748606,1,0
0,0,2,2,9,10,19,26,14,40,0.000333,0.056639,4,679.668402,37.759356,169.917101,61.748606,1,0
0,0,2,2,9,10,19,26,14,40,0.000333,0.056639,4,679.668402,37.759356,169.917101,61.748606,1,0
0,0,2,2,9,10,19,26,14,40,0.000333,0.056639,4,679.668402,37.759356,169.917101,61.748606,2,0
0,0,2,2,9,10,19,26,14,40,0.000333,0.056639,4,679.668402,37.759356,169.917101,61.748606,1,0
0,0,2,2,9,10,19,26,14,40,0.000333,0.056639,4,679.668402,37.759356,169.917101,61.748606,1,0
0,0,2,2,9,10,19,26,14,40,0.000333,0.056639,4,679.668402,37.759356,169.917101,61.748606,1,0
0,0,2,2,9,10,19,26,14,40,0.000333,0.056639,4,679.668402,37.759356,169.917101,61.748606,1,0
0,0,3,3,11,11,22,26,15,41,0.000333,0.060946,5,914.183482,50.787971,182.836696,76.107496,3,0
0,0,10,10,15,22,37,70,39,109,0.000333,0.189277,7,3974.812918,220.82294,567.830417,156.710855,6,0
0,0,3,3,13,21,34,35,33,68,0.000333,0.115316,6,2075.684839,115.315824,345.947473,140.344382,3,0
0,0,4,4,9,7,16,21,10,31,0.000333,0.041333,4,496,27.555556,124,48.180809,2,0
0,0,20,20,19,27,46,157,73,230,0.000333,0.423473,18,22867.5465,1270.41925,1270.41925,209.092585,10,0
0,0,17,17,16,23,39,110,55,165,0.000333,0.290697,16,13953.46186,775.192325,872.091366,168.041925,7,0
0,0,19,19,19,27,46,152,72,224,0.000333,0.412426,18,22271.00181,1237.277878,1237.277878,209.092585,9,0
0,0,23,23,20,29,49,181,80,261,0.000333,0.48848,20,29308.78539,1628.265855,1465.439269,227.320011,12,0
0,0,7,7,13,28,41,61,51,112,0.000333,0.200015,6,3600.274947,200.015275,600.045825,182.711654,1,0
0,0,4,4,12,14,26,41,22,63,0.000333,0.098709,6,1776.766213,98.709234,296.127702,96.322519,1,0
0,0,2,2,10,3,13,13,5,18,0.000333,0.022203,5,333.039575,18.502199,66.607915,37.974168,1,0
0,0,14,14,13,23,36,81,43,124,0.000333,0.21369,6,3846.424201,213.690233,641.0707,152.147641,5,0
0,0,2,2,7,4,11,13,5,18,0.000333,0.020757,3,186.809307,10.378295,62.269769,27.651484,3,0
0,0,17,17,16,23,39,110,55,165,0.000333,0.290697,16,13953.46186,775.192325,872.091366,168.041925,7,0
0,0,7,7,10,14,24,48,30,78,0.000333,0.119209,10,3576.270751,198.681708,357.627075,86.52225,1,0
0,0,2,2,11,6,17,14,8,22,0.000333,0.029975,5,449.620913,24.97894,89.924183,53.563523,2,0
0,0,2,2,7,4,11,13,5,18,0.000333,0.020757,3,186.809307,10.378295,62.269769,27.651484,3,0
0,0,4,4,9,6,15,16,9,25,0.000333,0.032557,4,390.68906,21.704948,97.672265,44.0391,3,0
0,0,17,17,16,23,39,110,55,165,0.000333,0.290697,16,13953.46186,775.192325,872.091366,168.041925,7,0
0,0,30,30,20,35,55,160,85,245,0.000333,0.472144,20,28328.6626,1573.814589,1416.43313,265.963467,11,0
0,0,5,5,12,13,25,38,18,56,0.000333,0.086685,6,1560.33568,86.685316,260.055947,91.125266,2,0
0,0,3,3,11,11,22,26,15,41,0.000333,0.060946,5,914.183482,50.787971,182.836696,76.107496,3,0
0,0,10,10,15,22,37,70,39,109,0.000333,0.189277,7,3974.812918,220.82294,567.830417,156.710855,6,0
0,0,17,17,16,23,39,110,55,165,0.000333,0.290697,16,13953.46186,775.192325,872.091366,168.041925,7,0
0,0,2,2,7,4,11,13,5,18,0.000333,0.020757,3,186.809307,10.378295,62.269769,27.651484,3,0
0,0,14,14,13,23,36,86,44,130,0.000333,0.22403,6,4032.541501,224.030083,672.09025,152.147641,5,0
0,0,15,15,17,37,54,135,91,226,0.000333,0.433535,16,20809.67321,1156.092956,1300.604575,262.236643,9,0
0,0,59,59,28,80,108,635,432,1067,0.000333,2.402488,70,504522.5475,28029.03042,7207.464965,640.360185,10,0
0,0,19,19,27,35,62,251,166,417,0.000333,0.827633,52,129110.7928,7172.821822,2482.899861,307.906868,10,0
0,0,23,23,27,38,65,342,230,572,0.000333,1.148265,78,268693.9623,14927.44235,3444.794389,327.803208,10,0
0,0,16,16,26,34,60,287,186,473,0.000333,0.93132,65,181607.3514,10089.2973,2793.959252,295.185169,19,0
0,0,24,24,27,49,76,372,249,621,0.000333,1.293321,65,252197.5941,14010.97745,3879.962986,403.502745,10,0
0,0,22,22,27,38,65,305,199,504,0.000333,1.011758,65,197292.7696,10960.70942,3035.273378,327.803208,10,0
0,0,9,9,22,17,39,295,185,480,0.000333,0.845664,110,279069.2372,15503.84651,2536.993065,167.594364,37,0
0,0,37,37,27,62,89,529,358,887,0.000333,1.914659,65,373358.411,20742.13394,5743.975553,497.542134,10,0
0,0,36,36,27,63,90,505,342,847,0.000333,1.832867,65,357408.9722,19856.05401,5498.599573,504.950598,10,0
0,0,3,3,10,17,27,36,24,60,0.000333,0.095098,5,1426.466251,79.248125,285.29325,102.706149,4,0
0,0,4,4,15,18,33,51,32,83,0.000333,0.139562,7,2930.792983,162.821832,418.684712,133.662009,1,0
0,0,26,26,27,41,68,338,218,556,0.000333,1.12821,65,220000.9071,12222.27262,3384.62934,348.041595,10,0
0,0,39,39,16,34,50,282,159,441,0.000333,0.829647,32,79646.09855,4424.783253,2488.94058,236.973737,9,0
0,0,31,31,27,50,77,492,340,832,0.000333,1.737989,78,406689.3793,22593.85441,5213.966402,410.574772,10,0
0,0,28,28,27,53,80,417,277,694,0.000333,1.462473,65,285182.1764,15843.45424,4387.418098,431.961747,10,0
0,0,3,3,11,11,22,26,15,41,0.000333,0.060946,5,914.183482,50.787971,182.836696,76.107496,3,0
0,0,10,10,15,22,37,70,39,109,0.000333,0.189277,7,3974.812918,220.82294,567.830417,156.710855,6,0
0,0,5,5,10,13,23,21,18,39,0.000333,0.058806,5,882.094581,49.005255,176.418916,81.324997,1,0
0,0,2,2,6,4,10,7,5,12,0.000333,0.013288,3,119.589411,6.643856,39.863137,23.509775,1,0
0,0,2,2,7,4,11,13,5,18,0.000333,0.020757,3,186.809307,10.378295,62.269769,27.651484,3,0
0,0,5,5,12,12,24,58,26,84,0.000333,0.128379,12,4621.642201,256.7579,385.13685,86.0391,11,0
0,0,4,4,12,12,24,49,23,72,0.000333,0.110039,6,1980.7038,110.0391,330.1173,86.0391,10,0
0,0,27,27,17,33,50,135,73,208,0.000333,0.391307,16,18782.7534,1043.4863,1173.922087,235.951874,10,0
0,0,5,5,14,9,23,39,20,59,0.000333,0.088963,14,3736.462176,207.581232,266.890155,81.832294,4,0
0,0,21,21,20,35,55,152,76,228,0.000333,0.439383,20,26363.00029,1464.611127,1318.150015,265.963467,8,0
0,0,2,2,9,10,19,26,14,40,0.000333,0.056639,4,679.668402,37.759356,169.917101,61.748606,1,0
0,0,2,2,9,10,19,26,14,40,0.000333,0.056639,4,679.668402,37.759356,169.917101,61.748606,1,0
0,0,2,2,9,10,19,26,14,40,0.000333,0.056639,4,679.668402,37.759356,169.917101,61.748606,1,0
0,0,2,2,9,10,19,26,14,40,0.000333,0.056639,4,679.668402,37.759356,169.917101,61.748606,1,0
0,0,2,2,9,10,19,26,14,40,0.000333,0.056639,4,679.668402,37.759356,169.917101,61.748606,1,0
0,0,2,2,9,10,19,26,14,40,0.000333,0.056639,4,679.668402,37.759356,169.917101,61.748606,1,0
0,0,5,5,13,101,114,424,267,691,0.000333,1.573842,12,56658.324,3147.684667,4721.527,720.585076,7,0
0,0,2,2,9,10,19,26,14,40,0.000333,0.056639,4,679.668402,37.759356,169.917101,61.748606,2,0
0,0,2,2,9,10,19,26,14,40,0.000333,0.056639,4,679.668402,37.759356,169.917101,61.748606,1,0
0,0,2,2,9,10,19,26,14,40,0.000333,0.056639,4,679.668402,37.759356,169.917101,61.748606,1,0
0,0,2,2,9,10,19,26,14,40,0.000333,0.056639,4,679.668402,37.759356,169.917101,61.748606,1,0
0,0,2,2,9,10,19,26,14,40,0.000333,0.056639,4,679.668402,37.759356,169.917101,61.748606,1,0
0,0,10,10,9,14,23,123,66,189,0.000333,0.284984,16,13679.25136,759.958409,854.95321,81.832294,1,0
0,0,2,2,9,10,19,26,14,40,0.000333,0.056639,4,679.668402,37.759356,169.917101,61.748606,1,0
0,0,4,4,10,13,23,67,37,104,0.000333,0.156817,10,4704.504434,261.361357,470.450443,81.324997,1,0
0,0,2,2,9,10,19,26,14,40,0.000333,0.056639,4,679.668402,37.759356,169.917101,61.748606,1,0
0,0,2,2,9,10,19,26,14,40,0.000333,0.056639,4,679.668402,37.759356,169.917101,61.748606,1,0
0,0,3,3,9,9,18,63,34,97,0.000333,0.134828,12,4853.792702,269.65515,404.482725,57.05865,1,0
0,0,2,2,9,10,19,26,14,40,0.000333,0.056639,4,679.668402,37.759356,169.917101,61.748606,1,0
0,0,2,2,9,10,19,26,14,40,0.000333,0.056639,4,679.668402,37.759356,169.917101,61.748606,2,0
0,0,3,3,11,12,23,35,18,53,0.000333,0.079916,5,1198.743918,66.596884,239.748784,81.073298,2,0
0,0,2,2,9,10,19,26,14,40,0.000333,0.056639,4,679.668402,37.759356,169.917101,61.748606,1,0
0,0,2,2,9,10,19,26,14,40,0.000333,0.056639,4,679.668402,37.759356,169.917101,61.748606,1,0
0,0,2,2,9,10,19,26,14,40,0.000333,0.056639,4,679.668402,37.759356,169.917101,61.748606,1,0
0,0,2,2,11,6,17,14,8,22,0.000333,0.029975,5,449.620913,24.97894,89.924183,53.563523,2,0
0,0,2,2,7,4,11,13,5,18,0.000333,0.020757,3,186.809307,10.378295,62.269769,27.651484,3,0
0,0,6,6,11,17,28,47,33,80,0.000333,0.128196,5,1922.941969,106.830109,384.588394,107.540616,3,0
0,0,31,31,19,36,55,163,85,248,0.000333,0.477926,18,25807.98976,1433.777209,1433.777209,266.827923,11,0
0,0,20,20,17,30,47,125,61,186,0.000333,0.344385,16,16530.45642,918.35869,1033.153526,216.693586,7,0
0,0,2,2,7,4,11,13,5,18,0.000333,0.020757,3,186.809307,10.378295,62.269769,27.651484,3,0
0,0,6,6,13,31,44,240,168,408,0.000333,0.742483,30,66823.44301,3712.413501,2227.4481,201.685802,1,0
0,0,5,5,11,13,24,36,21,57,0.000333,0.087114,5,1306.714313,72.59524,261.342863,86.159464,3,0
0,0,32,32,20,40,60,174,94,268,0.000333,0.527682,20,31660.93359,1758.940755,1583.04668,299.315686,11,0
0,0,1,1,5,3,8,11,3,14,0.000333,0.014,2,84,4.666667,42,16.364528,2,0
0,0,5,5,12,12,24,58,26,84,0.000333,0.128379,12,4621.642201,256.7579,385.13685,86.0391,11,0
0,0,2,2,7,4,11,13,5,18,0.000333,0.020757,3,186.809307,10.378295,62.269769,27.651484,3,0
0,0,4,4,12,12,24,49,23,72,0.000333,0.110039,6,1980.7038,110.0391,330.1173,86.0391,10,0
0,0,2,2,9,10,19,26,14,40,0.000333,0.056639,4,679.668402,37.759356,169.917101,61.748606,1,0
0,0,2,2,9,10,19,26,14,40,0.000333,0.056639,4,679.668402,37.759356,169.917101,61.748606,1,0
0,0,5,5,13,101,114,424,267,691,0.000333,1.573842,12,56658.324,3147.684667,4721.527,720.585076,7,0
0,0,10,10,9,14,23,123,66,189,0.000333,0.284984,16,13679.25136,759.958409,854.95321,81.832294,1,0
0,0,2,2,9,10,19,26,14,40,0.000333,0.056639,4,679.668402,37.759356,169.917101,61.748606,1,0
0,0,2,2,9,10,19,26,14,40,0.000333,0.056639,4,679.668402,37.759356,169.917101,61.748606,2,0
0,0,2,2,9,10,19,26,14,40,0.000333,0.056639,4,679.668402,37.759356,169.917101,61.748606,1,0
0,0,3,3,9,9,18,63,34,97,0.000333,0.134828,12,4853.792702,269.65515,404.482725,57.05865,1,0
0,0,2,2,9,10,19,26,14,40,0.000333,0.056639,4,679.668402,37.759356,169.917101,61.748606,1,0
0,0,2,2,9,10,19,26,14,40,0.000333,0.056639,4,679.668402,37.759356,169.917101,61.748606,1,0
0,0,2,2,9,10,19,26,14,40,0.000333,0.056639,4,679.668402,37.759356,169.917101,61.748606,1,0
0,0,2,2,9,10,19,26,14,40,0.000333,0.056639,4,679.668402,37.759356,169.917101,61.748606,1,0
0,0,2,2,9,10,19,26,14,40,0.000333,0.056639,4,679.668402,37.759356,169.917101,61.748606,1,0
0,0,2,2,9,10,19,26,14,40,0.000333,0.056639,4,679.668402,37.759356,169.917101,61.748606,1,0
0,0,3,3,11,12,23,35,18,53,0.000333,0.079916,5,1198.743918,66.596884,239.748784,81.073298,2,0
0,0,2,2,9,10,19,26,14,40,0.000333,0.056639,4,679.668402,37.759356,169.917101,61.748606,1,0
0,0,2,2,9,10,19,26,14,40,0.000333,0.056639,4,679.668402,37.759356,169.917101,61.748606,1,0
0,0,2,2,9,10,19,26,14,40,0.000333,0.056639,4,679.668402,37.759356,169.917101,61.748606,1,0
0,0,2,2,9,10,19,26,14,40,0.000333,0.056639,4,679.668402,37.759356,169.917101,61.748606,1,0
0,0,4,4,10,13,23,67,37,104,0.000333,0.156817,10,4704.504434,261.361357,470.450443,81.324997,1,0
0,0,2,2,9,10,19,26,14,40,0.000333,0.056639,4,679.668402,37.759356,169.917101,61.748606,1,0
0,0,2,2,9,10,19,26,14,40,0.000333,0.056639,4,679.668402,37.759356,169.917101,61.748606,2,0
0,0,2,2,9,10,19,26,14,40,0.000333,0.056639,4,679.668402,37.759356,169.917101,61.748606,1,0
0,0,2,2,9,10,19,26,14,40,0.000333,0.056639,4,679.668402,37.759356,169.917101,61.748606,1,0
0,0,5,5,11,13,24,36,21,57,0.000333,0.087114,5,1306.714313,72.59524,261.342863,86.159464,4,0
0,0,2,2,7,4,11,13,5,18,0.000333,0.020757,3,186.809307,10.378295,62.269769,27.651484,3,0
0,0,4,4,9,6,15,15,11,26,0.000333,0.03386,4,406.316622,22.573146,101.579155,44.0391,3,0
0,0,3,3,10,6,16,21,9,30,0.000333,0.04,5,600,33.333333,120,48.729056,3,0
0,0,2,2,8,3,11,9,5,14,0.000333,0.016144,4,193.728171,10.762676,48.432043,28.754888,3,0
0,0,33,33,20,42,62,185,101,286,0.000333,0.567633,20,34058.0029,1892.111272,1702.900145,312.915894,14,0
0,0,8,8,16,17,33,121,69,190,0.000333,0.319478,32,30669.91625,1703.884236,958.434883,133.486868,1,0
0,0,4,4,14,11,25,57,30,87,0.000333,0.134672,14,5656.216839,314.234269,404.015489,91.356717,1,0
0,0,40,40,23,42,65,303,167,470,0.000333,0.943504,33,93406.92478,5189.273599,2830.512872,330.519257,16,0
0,0,1,1,5,3,8,11,3,14,0.000333,0.014,2,84,4.666667,42,16.364528,2,0
0,0,30,30,20,35,55,160,85,245,0.000333,0.472144,20,28328.6626,1573.814589,1416.43313,265.963467,11,0
0,0,4,4,12,12,24,49,23,72,0.000333,0.110039,6,1980.7038,110.0391,330.1173,86.0391,10,0
0,0,5,5,12,12,24,58,26,84,0.000333,0.128379,12,4621.642201,256.7579,385.13685,86.0391,11,0
0,0,2,2,9,10,19,26,14,40,0.000333,0.056639,4,679.668402,37.759356,169.917101,61.748606,1,0
0,0,2,2,9,10,19,26,14,40,0.000333,0.056639,4,679.668402,37.759356,169.917101,61.748606,1,0
0,0,3,3,9,9,18,63,34,97,0.000333,0.134828,12,4853.792702,269.65515,404.482725,57.05865,1,0
0,0,2,2,9,10,19,26,14,40,0.000333,0.056639,4,679.668402,37.759356,169.917101,61.748606,2,0
0,0,3,3,11,12,23,35,18,53,0.000333,0.079916,5,1198.743918,66.596884,239.748784,81.073298,2,0
0,0,2,2,9,10,19,26,14,40,0.000333,0.056639,4,679.668402,37.759356,169.917101,61.748606,1,0
0,0,2,2,9,10,19,26,14,40,0.000333,0.056639,4,679.668402,37.759356,169.917101,61.748606,1,0
0,0,2,2,9,10,19,26,14,40,0.000333,0.056639,4,679.668402,37.759356,169.917101,61.748606,1,0
0,0,4,4,10,13,23,67,37,104,0.000333,0.156817,10,4704.504434,261.361357,470.450443,81.324997,1,0
0,0,10,10,9,14,23,123,66,189,0.000333,0.284984,16,13679.25136,759.958409,854.95321,81.832294,1,0
0,0,2,2,9,10,19,26,14,40,0.000333,0.056639,4,679.668402,37.759356,169.917101,61.748606,1,0
0,0,2,2,9,10,19,26,14,40,0.000333,0.056639,4,679.668402,37.759356,169.917101,61.748606,1,0
0,0,2,2,9,10,19,26,14,40,0.000333,0.056639,4,679.668402,37.759356,169.917101,61.748606,1,0
0,0,5,5,13,101,114,424,267,691,0.000333,1.573842,12,56658.324,3147.684667,4721.527,720.585076,7,0
0,0,2,2,9,10,19,26,14,40,0.000333,0.056639,4,679.668402,37.759356,169.917101,61.748606,1,0
0,0,2,2,9,10,19,26,14,40,0.000333,0.056639,4,679.668402,37.759356,169.917101,61.748606,1,0
0,0,2,2,9,10,19,26,14,40,0.000333,0.056639,4,679.668402,37.759356,169.917101,61.748606,1,0
0,0,2,2,9,10,19,26,14,40,0.000333,0.056639,4,679.668402,37.759356,169.917101,61.748606,1,0
0,0,2,2,9,10,19,26,14,40,0.000333,0.056639,4,679.668402,37.759356,169.917101,61.748606,1,0
0,0,2,2,9,10,19,26,14,40,0.000333,0.056639,4,679.668402,37.759356,169.917101,61.748606,2,0
0,0,2,2,9,10,19,26,14,40,0.000333,0.056639,4,679.668402,37.759356,169.917101,61.748606,1,0
0,0,2,2,9,10,19,26,14,40,0.000333,0.056639,4,679.668402,37.759356,169.917101,61.748606,1,0
0,0,2,2,9,10,19,26,14,40,0.000333,0.056639,4,679.668402,37.759356,169.917101,61.748606,1,0
0,0,2,2,9,10,19,26,14,40,0.000333,0.056639,4,679.668402,37.759356,169.917101,61.748606,1,0
0,0,1,1,5,3,8,11,3,14,0.000333,0.014,2,84,4.666667,42,16.364528,2,0
0,0,5,5,12,12,24,58,26,84,0.000333,0.128379,12,4621.642201,256.7579,385.13685,86.0391,11,0
0,0,2,2,7,4,11,13,5,18,0.000333,0.020757,3,186.809307,10.378295,62.269769,27.651484,3,0
0,0,4,4,12,12,24,49,23,72,0.000333,0.110039,6,1980.7038,110.0391,330.1173,86.0391,10,0
0,0,2,2,9,10,19,26,14,40,0.000333,0.056639,4,679.668402,37.759356,169.917101,61.748606,1,0
0,0,2,2,9,10,19,26,14,40,0.000333,0.056639,4,679.668402,37.759356,169.917101,61.748606,1,0
0,0,3,3,9,9,18,63,34,97,0.000333,0.134828,12,4853.792702,269.65515,404.482725,57.05865,1,0
0,0,2,2,9,10,19,26,14,40,0.000333,0.056639,4,679.668402,37.759356,169.917101,61.748606,1,0
0,0,2,2,9,10,19,26,14,40,0.000333,0.056639,4,679.668402,37.759356,169.917101,61.748606,1,0
0,0,2,2,9,10,19,26,14,40,0.000333,0.056639,4,679.668402,37.759356,169.917101,61.748606,1,0
0,0,2,2,9,10,19,26,14,40,0.000333,0.056639,4,679.668402,37.759356,169.917101,61.748606,1,0
0,0,2,2,9,10,19,26,14,40,0.000333,0.056639,4,679.668402,37.759356,169.917101,61.748606,1,0
0,0,3,3,11,12,23,35,18,53,0.000333,0.079916,5,1198.743918,66.596884,239.748784,81.073298,2,0
0,0,2,2,9,10,19,26,14,40,0.000333,0.056639,4,679.668402,37.759356,169.917101,61.748606,1,0
0,0,2,2,9,10,19,26,14,40,0.000333,0.056639,4,679.668402,37.759356,169.917101,61.748606,1,0
0,0,2,2,9,10,19,26,14,40,0.000333,0.056639,4,679.668402,37.759356,169.917101,61.748606,1,0
0,0,2,2,9,10,19,26,14,40,0.000333,0.056639,4,679.668402,37.759356,169.917101,61.748606,2,0
0,0,2,2,9,10,19,26,14,40,0.000333,0.056639,4,679.668402,37.759356,169.917101,61.748606,1,0
0,0,2,2,9,10,19,26,14,40,0.000333,0.056639,4,679.668402,37.759356,169.917101,61.748606,1,0
0,0,2,2,9,10,19,26,14,40,0.000333,0.056639,4,679.668402,37.759356,169.917101,61.748606,1,0
0,0,2,2,9,10,19,26,14,40,0.000333,0.056639,4,679.668402,37.759356,169.917101,61.748606,1,0
0,0,2,2,9,10,19,26,14,40,0.000333,0.056639,4,679.668402,37.759356,169.917101,61.748606,2,0
0,0,2,2,9,10,19,26,14,40,0.000333,0.056639,4,679.668402,37.759356,169.917101,61.748606,1,0
0,0,2,2,9,10,19,26,14,40,0.000333,0.056639,4,679.668402,37.759356,169.917101,61.748606,1,0
0,0,2,2,9,10,19,26,14,40,0.000333,0.056639,4,679.668402,37.759356,169.917101,61.748606,1,0
0,0,4,4,10,13,23,67,37,104,0.000333,0.156817,10,4704.504434,261.361357,470.450443,81.324997,1,0
0,0,10,10,9,14,23,123,66,189,0.000333,0.284984,16,13679.25136,759.958409,854.95321,81.832294,1,0
0,0,5,5,13,101,114,424,267,691,0.000333,1.573842,12,56658.324,3147.684667,4721.527,720.585076,7,0
0,0,3,3,11,11,22,26,15,41,0.000333,0.060946,5,914.183482,50.787971,182.836696,76.107496,3,0
0,0,10,10,15,22,37,70,39,109,0.000333,0.189277,7,3974.812918,220.82294,567.830417,156.710855,6,0
0,0,32,32,20,40,60,187,103,290,0.000333,0.570999,20,34259.96546,1903.331414,1712.998273,299.315686,13,0
0,0,19,19,22,29,51,388,61,449,0.000333,0.848973,22,56032.21753,3112.900974,2546.918979,238.988944,7,0
0,0,11,11,13,21,34,346,34,380,0.000333,0.644412,6,11599.41528,644.41196,1933.23588,140.344382,2,0
0,0,2,2,7,4,11,13,5,18,0.000333,0.020757,3,186.809307,10.378295,62.269769,27.651484,3,0
0,0,6,6,16,12,28,47,24,71,0.000333,0.113774,16,5461.155191,303.397511,341.322199,107.01955,4,0
0,0,3,3,11,11,22,26,15,41,0.000333,0.060946,5,914.183482,50.787971,182.836696,76.107496,3,0
0,0,10,10,15,22,37,70,39,109,0.000333,0.189277,7,3974.812918,220.82294,567.830417,156.710855,6,0
0,0,2,2,7,4,11,13,5,18,0.000333,0.020757,3,186.809307,10.378295,62.269769,27.651484,3,0
0,0,6,6,16,12,28,47,24,71,0.000333,0.113774,16,5461.155191,303.397511,341.322199,107.01955,4,0
0,0,4,4,12,12,24,49,23,72,0.000333,0.110039,6,1980.7038,110.0391,330.1173,86.0391,10,0
0,0,5,5,12,12,24,58,26,84,0.000333,0.128379,12,4621.642201,256.7579,385.13685,86.0391,11,0
0,0,1,1,5,3,8,11,3,14,0.000333,0.014,2,84,4.666667,42,16.364528,2,0
0,0,2,2,9,10,19,26,14,40,0.000333,0.056639,4,679.668402,37.759356,169.917101,61.748606,2,0
0,0,2,2,9,10,19,26,14,40,0.000333,0.056639,4,679.668402,37.759356,169.917101,61.748606,1,0
0,0,2,2,9,10,19,26,14,40,0.000333,0.056639,4,679.668402,37.759356,169.917101,61.748606,1,0
0,0,2,2,9,10,19,26,14,40,0.000333,0.056639,4,679.668402,37.759356,169.917101,61.748606,1,0
0,0,2,2,9,10,19,26,14,40,0.000333,0.056639,4,679.668402,37.759356,169.917101,61.748606,1,0
0,0,2,2,9,10,19,26,14,40,0.000333,0.056639,4,679.668402,37.759356,169.917101,61.748606,1,0
0,0,3,3,9,9,18,63,34,97,0.000333,0.134828,12,4853.792702,269.65515,404.482725,57.05865,1,0
0,0,2,2,9,10,19,26,14,40,0.000333,0.056639,4,679.668402,37.759356,169.917101,61.748606,1,0
0,0,5,5,13,101,114,424,267,691,0.000333,1.573842,12,56658.324,3147.684667,4721.527,720.585076,7,0
0,0,4,4,10,13,23,67,37,104,0.000333,0.156817,10,4704.504434,261.361357,470.450443,81.324997,1,0
0,0,2,2,9,10,19,26,14,40,0.000333,0.056639,4,679.668402,37.759356,169.917101,61.748606,1,0
0,0,2,2,9,10,19,26,14,40,0.000333,0.056639,4,679.668402,37.759356,169.917101,61.748606,1,0
0,0,2,2,9,10,19,26,14,40,0.000333,0.056639,4,679.668402,37.759356,169.917101,61.748606,1,0
0,0,2,2,9,10,19,26,14,40,0.000333,0.056639,4,679.668402,37.759356,169.917101,61.748606,1,0
0,0,2,2,9,10,19,26,14,40,0.000333,0.056639,4,679.668402,37.759356,169.917101,61.748606,1,0
0,0,2,2,9,10,19,26,14,40,0.000333,0.056639,4,679.668402,37.759356,169.917101,61.748606,1,0
0,0,10,10,9,14,23,123,66,189,0.000333,0.284984,16,13679.25136,759.958409,854.95321,81.832294,1,0
0,0,2,2,9,10,19,26,14,40,0.000333,0.056639,4,679.668402,37.759356,169.917101,61.748606,1,0
0,0,2,2,9,10,19,26,14,40,0.000333,0.056639,4,679.668402,37.759356,169.917101,61.748606,1,0
0,0,3,3,11,12,23,35,18,53,0.000333,0.079916,5,1198.743918,66.596884,239.748784,81.073298,2,0
0,0,2,2,9,10,19,26,14,40,0.000333,0.056639,4,679.668402,37.759356,169.917101,61.748606,1,0
0,0,2,2,9,10,19,26,14,40,0.000333,0.056639,4,679.668402,37.759356,169.917101,61.748606,1,0
0,0,2,2,9,10,19,26,14,40,0.000333,0.056639,4,679.668402,37.759356,169.917101,61.748606,1,0
0,0,2,2,9,10,19,26,14,40,0.000333,0.056639,4,679.668402,37.759356,169.917101,61.748606,2,0
0,0,16,16,15,27,42,89,49,138,0.000333,0.248047,7,5208.97863,289.387702,744.139804,186.985321,5,0
0,0,2,2,7,4,11,13,5,18,0.000333,0.020757,3,186.809307,10.378295,62.269769,27.651484,3,0
0,0,17,17,16,23,39,110,55,165,0.000333,0.290697,16,13953.46186,775.192325,872.091366,168.041925,7,0
0,0,5,5,14,9,23,39,20,59,0.000333,0.088963,14,3736.462176,207.581232,266.890155,81.832294,4,0
0,0,2,2,7,4,11,13,5,18,0.000333,0.020757,3,186.809307,10.378295,62.269769,27.651484,3,0
0,0,8,8,10,14,24,66,30,96,0.000333,0.146719,10,4401.564001,244.531333,440.1564,86.52225,1,0
0,0,7,7,10,12,22,51,24,75,0.000333,0.111486,10,3344.573714,185.809651,334.457371,76.238831,1,0
0,0,4,4,12,12,24,49,23,72,0.000333,0.110039,6,1980.7038,110.0391,330.1173,86.0391,10,0
0,0,5,5,12,12,24,58,26,84,0.000333,0.128379,12,4621.642201,256.7579,385.13685,86.0391,11,0
0,0,1,1,5,3,8,11,3,14,0.000333,0.014,2,84,4.666667,42,16.364528,2,0
0,0,2,2,7,4,11,13,5,18,0.000333,0.020757,3,186.809307,10.378295,62.269769,27.651484,3,0
0,0,18,18,10,24,34,121,70,191,0.000333,0.323902,10,9717.054027,539.836335,971.705403,143.258381,1,0
0,0,2,2,9,10,19,26,14,40,0.000333,0.056639,4,679.668402,37.759356,169.917101,61.748606,1,0
0,0,10,10,9,14,23,123,66,189,0.000333,0.284984,16,13679.25136,759.958409,854.95321,81.832294,1,0
0,0,2,2,9,10,19,26,14,40,0.000333,0.056639,4,679.668402,37.759356,169.917101,61.748606,1,0
0,0,3,3,11,12,23,35,18,53,0.000333,0.079916,5,1198.743918,66.596884,239.748784,81.073298,2,0
0,0,5,5,13,101,114,424,267,691,0.000333,1.573842,12,56658.324,3147.684667,4721.527,720.585076,7,0
0,0,2,2,9,10,19,26,14,40,0.000333,0.056639,4,679.668402,37.759356,169.917101,61.748606,2,0
0,0,2,2,9,10,19,26,14,40,0.000333,0.056639,4,679.668402,37.759356,169.917101,61.748606,1,0
0,0,2,2,9,10,19,26,14,40,0.000333,0.056639,4,679.668402,37.759356,169.917101,61.748606,1,0
0,0,2,2,9,10,19,26,14,40,0.000333,0.056639,4,679.668402,37.759356,169.917101,61.748606,1,0
0,0,2,2,9,10,19,26,14,40,0.000333,0.056639,4,679.668402,37.759356,169.917101,61.748606,1,0
0,0,2,2,9,10,19,26,14,40,0.000333,0.056639,4,679.668402,37.759356,169.917101,61.748606,2,0
0,0,2,2,9,10,19,26,14,40,0.000333,0.056639,4,679.668402,37.759356,169.917101,61.748606,1,0
0,0,2,2,9,10,19,26,14,40,0.000333,0.056639,4,679.668402,37.759356,169.917101,61.748606,1,0
0,0,2,2,9,10,19,26,14,40,0.000333,0.056639,4,679.668402,37.759356,169.917101,61.748606,1,0
0,0,2,2,9,10,19,26,14,40,0.000333,0.056639,4,679.668402,37.759356,169.917101,61.748606,1,0
0,0,2,2,9,10,19,26,14,40,0.000333,0.056639,4,679.668402,37.759356,169.917101,61.748606,1,0
0,0,2,2,9,10,19,26,14,40,0.000333,0.056639,4,679.668402,37.759356,169.917101,61.748606,1,0
0,0,2,2,9,10,19,26,14,40,0.000333,0.056639,4,679.668402,37.759356,169.917101,61.748606,1,0
0,0,2,2,9,10,19,26,14,40,0.000333,0.056639,4,679.668402,37.759356,169.917101,61.748606,1,0
0,0,3,3,9,9,18,63,34,97,0.000333,0.134828,12,4853.792702,269.65515,404.482725,57.05865,1,0
0,0,2,2,9,10,19,26,14,40,0.000333,0.056639,4,679.668402,37.759356,169.917101,61.748606,1,0
0,0,2,2,9,10,19,26,14,40,0.000333,0.056639,4,679.668402,37.759356,169.917101,61.748606,1,0
0,0,2,2,9,10,19,26,14,40,0.000333,0.056639,4,679.668402,37.759356,169.917101,61.748606,1,0
0,0,4,4,10,13,23,67,37,104,0.000333,0.156817,10,4704.504434,261.361357,470.450443,81.324997,1,0
0,0,3,3,11,11,22,26,15,41,0.000333,0.060946,5,914.183482,50.787971,182.836696,76.107496,3,0
0,0,10,10,15,22,37,70,39,109,0.000333,0.189277,7,3974.812918,220.82294,567.830417,156.710855,6,0
0,0,5,5,11,13,24,36,21,57,0.000333,0.087114,5,1306.714313,72.59524,261.342863,86.159464,3,0
0,0,35,35,21,43,64,186,104,290,0.000333,0.58,20,34800,1933.333333,1740,325.56805,12,0
0,0,2,2,7,4,11,13,5,18,0.000333,0.020757,3,186.809307,10.378295,62.269769,27.651484,3,0
0,0,29,29,17,37,54,152,80,232,0.000333,0.445045,16,21362.14241,1186.785689,1335.133901,262.236643,10,0
0,0,5,5,11,13,24,36,21,57,0.000333,0.087114,5,1306.714313,72.59524,261.342863,86.159464,3,0
0,0,28,28,19,38,57,154,81,235,0.000333,0.45691,18,24673.12476,1370.729153,1370.729153,280.131868,10,0
0,0,1,1,5,3,8,11,3,14,0.000333,0.014,2,84,4.666667,42,16.364528,2,0
0,0,4,4,12,12,24,49,23,72,0.000333,0.110039,6,1980.7038,110.0391,330.1173,86.0391,10,0
0,0,5,5,12,12,24,58,26,84,0.000333,0.128379,12,4621.642201,256.7579,385.13685,86.0391,11,0
0,0,2,2,7,4,11,13,5,18,0.000333,0.020757,3,186.809307,10.378295,62.269769,27.651484,3,0
0,0,2,2,9,10,19,26,14,40,0.000333,0.056639,4,679.668402,37.759356,169.917101,61.748606,1,0
0,0,2,2,9,10,19,26,14,40,0.000333,0.056639,4,679.668402,37.759356,169.917101,61.748606,1,0
0,0,2,2,9,10,19,26,14,40,0.000333,0.056639,4,679.668402,37.759356,169.917101,61.748606,1,0
0,0,2,2,9,10,19,26,14,40,0.000333,0.056639,4,679.668402,37.759356,169.917101,61.748606,1,0
0,0,2,2,9,10,19,26,14,40,0.000333,0.056639,4,679.668402,37.759356,169.917101,61.748606,1,0
0,0,2,2,9,10,19,26,14,40,0.000333,0.056639,4,679.668402,37.759356,169.917101,61.748606,1,0
0,0,2,2,9,10,19,26,14,40,0.000333,0.056639,4,679.668402,37.759356,169.917101,61.748606,2,0
0,0,5,5,13,101,114,424,267,691,0.000333,1.573842,12,56658.324,3147.684667,4721.527,720.585076,7,0
0,0,2,2,9,10,19,26,14,40,0.000333,0.056639,4,679.668402,37.759356,169.917101,61.748606,1,0
0,0,2,2,9,10,19,26,14,40,0.000333,0.056639,4,679.668402,37.759356,169.917101,61.748606,1,0
0,0,2,2,9,10,19,26,14,40,0.000333,0.056639,4,679.668402,37.759356,169.917101,61.748606,1,0
0,0,2,2,9,10,19,26,14,40,0.000333,0.056639,4,679.668402,37.759356,169.917101,61.748606,1,0
0,0,10,10,9,14,23,123,66,189,0.000333,0.284984,16,13679.25136,759.958409,854.95321,81.832294,1,0
0,0,2,2,9,10,19,26,14,40,0.000333,0.056639,4,679.668402,37.759356,169.917101,61.748606,1,0
0,0,4,4,10,13,23,67,37,104,0.000333,0.156817,10,4704.504434,261.361357,470.450443,81.324997,1,0
0,0,2,2,9,10,19,26,14,40,0.000333,0.056639,4,679.668402,37.759356,169.917101,61.748606,1,0
0,0,2,2,9,10,19,26,14,40,0.000333,0.056639,4,679.668402,37.759356,169.917101,61.748606,1,0
0,0,3,3,9,9,18,63,34,97,0.000333,0.134828,12,4853.792702,269.65515,404.482725,57.05865,1,0
0,0,2,2,9,10,19,26,14,40,0.000333,0.056639,4,679.668402,37.759356,169.917101,61.748606,1,0
0,0,16,16,15,25,40,91,57,148,0.000333,0.262548,14,11027.03501,612.613056,787.645358,174.699764,2,0
0,0,2,2,9,10,19,26,14,40,0.000333,0.056639,4,679.668402,37.759356,169.917101,61.748606,2,0
0,0,3,3,11,12,23,35,18,53,0.000333,0.079916,5,1198.743918,66.596884,239.748784,81.073298,2,0
0,0,2,2,9,10,19,26,14,40,0.000333,0.056639,4,679.668402,37.759356,169.917101,61.748606,1,0
0,0,2,2,9,10,19,26,14,40,0.000333,0.056639,4,679.668402,37.759356,169.917101,61.748606,1,0
0,0,2,2,9,10,19,26,14,40,0.000333,0.056639,4,679.668402,37.759356,169.917101,61.748606,1,0
0,0,5,5,11,13,24,36,21,57,0.000333,0.087114,5,1306.714313,72.59524,261.342863,86.159464,4,0
0,0,32,32,20,40,60,182,99,281,0.000333,0.553279,20,33196.72515,1844.262508,1659.836257,299.315686,12,0
0,0,4,4,12,12,24,49,23,72,0.000333,0.110039,6,1980.7038,110.0391,330.1173,86.0391,10,0
0,0,1,1,5,3,8,11,3,14,0.000333,0.014,2,84,4.666667,42,16.364528,2,0
0,0,2,2,7,4,11,13,5,18,0.000333,0.020757,3,186.809307,10.378295,62.269769,27.651484,3,0
0,0,5,5,12,12,24,58,26,84,0.000333,0.128379,12,4621.642201,256.7579,385.13685,86.0391,11,0
0,0,2,2,9,10,19,26,14,40,0.000333,0.056639,4,679.668402,37.759356,169.917101,61.748606,1,0
0,0,10,10,9,14,23,123,66,189,0.000333,0.284984,16,13679.25136,759.958409,854.95321,81.832294,1,0
0,0,2,2,9,10,19,26,14,40,0.000333,0.056639,4,679.668402,37.759356,169.917101,61.748606,1,0
0,0,4,4,10,13,23,67,37,104,0.000333,0.156817,10,4704.504434,261.361357,470.450443,81.324997,1,0
0,0,2,2,9,10,19,26,14,40,0.000333,0.056639,4,679.668402,37.759356,169.917101,61.748606,1,0
0,0,2,2,9,10,19,26,14,40,0.000333,0.056639,4,679.668402,37.759356,169.917101,61.748606,1,0
0,0,2,2,9,10,19,26,14,40,0.000333,0.056639,4,679.668402,37.759356,169.917101,61.748606,1,0
0,0,2,2,9,10,19,26,14,40,0.000333,0.056639,4,679.668402,37.759356,169.917101,61.748606,1,0
0,0,3,3,11,12,23,35,18,53,0.000333,0.079916,5,1198.743918,66.596884,239.748784,81.073298,2,0
0,0,2,2,9,10,19,26,14,40,0.000333,0.056639,4,679.668402,37.759356,169.917101,61.748606,1,0
0,0,2,2,9,10,19,26,14,40,0.000333,0.056639,4,679.668402,37.759356,169.917101,61.748606,1,0
0,0,3,3,9,9,18,63,34,97,0.000333,0.134828,12,4853.792702,269.65515,404.482725,57.05865,1,0
0,0,2,2,9,10,19,26,14,40,0.000333,0.056639,4,679.668402,37.759356,169.917101,61.748606,1,0
0,0,2,2,9,10,19,26,14,40,0.000333,0.056639,4,679.668402,37.759356,169.917101,61.748606,1,0
0,0,2,2,9,10,19,26,14,40,0.000333,0.056639,4,679.668402,37.759356,169.917101,61.748606,1,0
0,0,2,2,9,10,19,26,14,40,0.000333,0.056639,4,679.668402,37.759356,169.917101,61.748606,1,0
0,0,2,2,9,10,19,26,14,40,0.000333,0.056639,4,679.668402,37.759356,169.917101,61.748606,2,0
0,0,2,2,9,10,19,26,14,40,0.000333,0.056639,4,679.668402,37.759356,169.917101,61.748606,1,0
0,0,5,5,13,101,114,424,267,691,0.000333,1.573842,12,56658.324,3147.684667,4721.527,720.585076,7,0
0,0,2,2,9,10,19,26,14,40,0.000333,0.056639,4,679.668402,37.759356,169.917101,61.748606,2,0
0,0,2,2,9,10,19,26,14,40,0.000333,0.056639,4,679.668402,37.759356,169.917101,61.748606,1,0
0,0,2,2,9,10,19,26,14,40,0.000333,0.056639,4,679.668402,37.759356,169.917101,61.748606,1,0
0,0,2,2,9,10,19,26,14,40,0.000333,0.056639,4,679.668402,37.759356,169.917101,61.748606,1,0
0,0,2,2,9,10,19,26,14,40,0.000333,0.056639,4,679.668402,37.759356,169.917101,61.748606,1,0
0,0,29,29,23,42,65,186,106,292,0.000333,0.586177,22,38687.69083,2149.316157,1758.531401,330.519257,12,0
0,0,2,2,7,4,11,13,5,18,0.000333,0.020757,3,186.809307,10.378295,62.269769,27.651484,3,0
0,0,31,31,19,38,57,167,91,258,0.000333,0.501629,18,27087.94123,1504.885624,1504.885624,280.131868,11,0
0,0,2,2,7,4,11,13,5,18,0.000333,0.020757,3,186.809307,10.378295,62.269769,27.651484,3,0
0,0,2,2,7,4,11,13,5,18,0.000333,0.020757,3,186.809307,10.378295,62.269769,27.651484,3,0
0,0,3,3,13,21,34,35,33,68,0.000333,0.115316,6,2075.684839,115.315824,345.947473,140.344382,3,0
0,0,19,19,19,27,46,152,72,224,0.000333,0.412426,18,22271.00181,1237.277878,1237.277878,209.092585,9,0
0,0,23,23,20,29,49,181,80,261,0.000333,0.48848,20,29308.78539,1628.265855,1465.439269,227.320011,12,0
0,0,20,20,19,27,46,157,73,230,0.000333,0.423473,18,22867.5465,1270.41925,1270.41925,209.092585,10,0
0,0,7,7,13,28,41,61,51,112,0.000333,0.200015,6,3600.274947,200.015275,600.045825,182.711654,1,0
0,0,2,2,10,3,13,13,5,18,0.000333,0.022203,5,333.039575,18.502199,66.607915,37.974168,1,0
0,0,5,5,11,13,24,36,21,57,0.000333,0.087114,5,1306.714313,72.59524,261.342863,86.159464,3,0
0,0,5,5,12,12,24,58,26,84,0.000333,0.128379,12,4621.642201,256.7579,385.13685,86.0391,11,0
0,0,28,28,19,38,57,154,81,235,0.000333,0.45691,18,24673.12476,1370.729153,1370.729153,280.131868,10,0
0,0,4,4,12,12,24,49,23,72,0.000333,0.110039,6,1980.7038,110.0391,330.1173,86.0391,10,0
0,0,2,2,7,4,11,13,5,18,0.000333,0.020757,3,186.809307,10.378295,62.269769,27.651484,3,0
0,0,1,1,5,3,8,11,3,14,0.000333,0.014,2,84,4.666667,42,16.364528,2,0
0,0,5,5,13,101,114,424,267,691,0.000333,1.573842,12,56658.324,3147.684667,4721.527,720.585076,7,0
0,0,2,2,9,10,19,26,14,40,0.000333,0.056639,4,679.668402,37.759356,169.917101,61.748606,1,0
0,0,3,3,9,9,18,63,34,97,0.000333,0.134828,12,4853.792702,269.65515,404.482725,57.05865,1,0
0,0,2,2,9,10,19,26,14,40,0.000333,0.056639,4,679.668402,37.759356,169.917101,61.748606,1,0
0,0,2,2,9,10,19,26,14,40,0.000333,0.056639,4,679.668402,37.759356,169.917101,61.748606,1,0
0,0,2,2,9,10,19,26,14,40,0.000333,0.056639,4,679.668402,37.759356,169.917101,61.748606,1,0
0,0,2,2,9,10,19,26,14,40,0.000333,0.056639,4,679.668402,37.759356,169.917101,61.748606,1,0
0,0,2,2,9,10,19,26,14,40,0.000333,0.056639,4,679.668402,37.759356,169.917101,61.748606,1,0
0,0,2,2,9,10,19,26,14,40,0.000333,0.056639,4,679.668402,37.759356,169.917101,61.748606,1,0
0,0,2,2,9,10,19,26,14,40,0.000333,0.056639,4,679.668402,37.759356,169.917101,61.748606,1,0
0,0,2,2,9,10,19,26,14,40,0.000333,0.056639,4,679.668402,37.759356,169.917101,61.748606,1,0
0,0,2,2,9,10,19,26,14,40,0.000333,0.056639,4,679.668402,37.759356,169.917101,61.748606,1,0
0,0,2,2,9,10,19,26,14,40,0.000333,0.056639,4,679.668402,37.759356,169.917101,61.748606,1,0
0,0,2,2,9,10,19,26,14,40,0.000333,0.056639,4,679.668402,37.759356,169.917101,61.748606,1,0
0,0,2,2,9,10,19,26,14,40,0.000333,0.056639,4,679.668402,37.759356,169.917101,61.748606,1,0
0,0,2,2,9,10,19,26,14,40,0.000333,0.056639,4,679.668402,37.759356,169.917101,61.748606,1,0
0,0,4,4,10,13,23,67,37,104,0.000333,0.156817,10,4704.504434,261.361357,470.450443,81.324997,1,0
0,0,2,2,9,10,19,26,14,40,0.000333,0.056639,4,679.668402,37.759356,169.917101,61.748606,2,0
0,0,10,10,9,14,23,123,66,189,0.000333,0.284984,16,13679.25136,759.958409,854.95321,81.832294,1,0
0,0,2,2,9,10,19,26,14,40,0.000333,0.056639,4,679.668402,37.759356,169.917101,61.748606,1,0
0,0,2,2,9,10,19,26,14,40,0.000333,0.056639,4,679.668402,37.759356,169.917101,61.748606,1,0
0,0,2,2,9,10,19,26,14,40,0.000333,0.056639,4,679.668402,37.759356,169.917101,61.748606,2,0
0,0,3,3,11,12,23,35,18,53,0.000333,0.079916,5,1198.743918,66.596884,239.748784,81.073298,2,0
0,0,2,2,9,10,19,26,14,40,0.000333,0.056639,4,679.668402,37.759356,169.917101,61.748606,1,0
0,0,3,3,11,11,22,26,15,41,0.000333,0.060946,5,914.183482,50.787971,182.836696,76.107496,3,0
0,0,10,10,15,22,37,70,39,109,0.000333,0.189277,7,3974.812918,220.82294,567.830417,156.710855,6,0
0,0,35,35,21,55,76,196,120,316,0.000333,0.658115,20,39486.90189,2193.716771,1974.345094,410.21345,11,0
0,0,14,14,12,21,33,84,45,129,0.000333,0.216909,12,7808.722097,433.817894,650.726841,135.258216,7,0
0,0,21,21,18,32,50,430,68,498,0.000333,0.93688,18,50591.52689,2810.640383,2810.640383,235.05865,9,0
0,0,2,2,7,4,11,13,5,18,0.000333,0.020757,3,186.809307,10.378295,62.269769,27.651484,3,0
0,0,31,31,19,36,55,163,85,248,0.000333,0.477926,18,25807.98976,1433.777209,1433.777209,266.827923,11,0
0,0,8,8,10,14,24,66,30,96,0.000333,0.146719,10,4401.564001,244.531333,440.1564,86.52225,1,0
0,0,7,7,10,12,22,51,24,75,0.000333,0.111486,10,3344.573714,185.809651,334.457371,76.238831,1,0
0,0,3,3,11,11,22,26,15,41,0.000333,0.060946,5,914.183482,50.787971,182.836696,76.107496,3,0
0,0,10,10,15,22,37,70,39,109,0.000333,0.189277,7,3974.812918,220.82294,567.830417,156.710855,6,0
0,0,3,3,11,11,22,26,15,41,0.000333,0.060946,5,914.183482,50.787971,182.836696,76.107496,3,0
0,0,10,10,15,22,37,70,39,109,0.000333,0.189277,7,3974.812918,220.82294,567.830417,156.710855,6,0
0,0,3,3,12,10,22,28,16,44,0.000333,0.065405,6,1177.289947,65.404997,196.214991,76.238831,3,0
0,0,8,8,13,18,31,46,29,75,0.000333,0.123855,6,2229.38834,123.854908,371.564723,123.164366,4,0
0,0,29,29,20,41,61,156,85,241,0.000333,0.476436,20,28586.15397,1588.119665,1429.307698,306.098194,10,0
0,0,4,4,11,10,21,30,16,46,0.000333,0.067349,5,1010.233007,56.124056,202.046601,71.273029,1,0
0,0,3,3,11,11,22,26,15,41,0.000333,0.060946,5,914.183482,50.787971,182.836696,76.107496,3,0
0,0,10,10,15,22,37,70,39,109,0.000333,0.189277,7,3974.812918,220.82294,567.830417,156.710855,6,0
0,0,5,5,11,13,24,36,21,57,0.000333,0.087114,5,1306.714313,72.59524,261.342863,86.159464,3,0
0,0,32,32,19,40,59,174,94,268,0.000333,0.525516,18,28377.87007,1576.548337,1576.548337,293.587747,11,0
0,0,2,2,7,4,11,13,5,18,0.000333,0.020757,3,186.809307,10.378295,62.269769,27.651484,3,0
0,0,5,5,11,13,24,36,21,57,0.000333,0.087114,5,1306.714313,72.59524,261.342863,86.159464,4,0
0,0,2,2,7,4,11,13,5,18,0.000333,0.020757,3,186.809307,10.378295,62.269769,27.651484,3,0
0,0,5,5,14,9,23,39,20,59,0.000333,0.088963,14,3736.462176,207.581232,266.890155,81.832294,4,0
0,0,17,17,16,23,39,110,55,165,0.000333,0.290697,16,13953.46186,775.192325,872.091366,168.041925,7,0
0,0,5,5,11,13,24,36,21,57,0.000333,0.087114,5,1306.714313,72.59524,261.342863,86.159464,3,0
0,0,17,17,16,23,39,110,55,165,0.000333,0.290697,16,13953.46186,775.192325,872.091366,168.041925,7,0
0,0,2,2,7,4,11,13,5,18,0.000333,0.020757,3,186.809307,10.378295,62.269769,27.651484,3,0
0,0,7,7,10,13,23,33,24,57,0.000333,0.085948,5,1289.215157,71.623064,257.843031,81.324997,3,0
0,0,5,5,11,13,24,36,21,57,0.000333,0.087114,5,1306.714313,72.59524,261.342863,86.159464,4,0
0,0,2,2,7,4,11,13,5,18,0.000333,0.020757,3,186.809307,10.378295,62.269769,27.651484,3,0
0,0,17,17,16,23,39,110,55,165,0.000333,0.290697,16,13953.46186,775.192325,872.091366,168.041925,7,0
0,0,5,5,11,13,24,36,21,57,0.000333,0.087114,5,1306.714313,72.59524,261.342863,86.159464,3,0
0,0,2,2,7,4,11,13,5,18,0.000333,0.020757,3,186.809307,10.378295,62.269769,27.651484,3,0
0,0,28,28,17,41,58,149,80,229,0.000333,0.447159,8,10731.82118,596.212288,1341.477648,289.1465,10,0
0,0,2,2,5,6,11,9,7,16,0.000333,0.01845,2,110.701812,6.150101,55.350906,27.119415,1,0
0,0,2,2,7,4,11,13,5,18,0.000333,0.020757,3,186.809307,10.378295,62.269769,27.651484,3,0
0,0,5,5,14,9,23,39,20,59,0.000333,0.088963,14,3736.462176,207.581232,266.890155,81.832294,4,0
0,0,3,3,11,11,22,26,15,41,0.000333,0.060946,5,914.183482,50.787971,182.836696,76.107496,3,0
0,0,10,10,15,22,37,70,39,109,0.000333,0.189277,7,3974.812918,220.82294,567.830417,156.710855,6,0
0,0,5,5,11,9,20,29,15,44,0.000333,0.063388,5,950.824181,52.823566,190.164836,66.583073,2,0
0,0,27,27,19,35,54,148,78,226,0.000333,0.433535,18,23410.88236,1300.604575,1300.604575,260.235528,10,0
0,0,6,6,10,11,21,31,20,51,0.000333,0.074669,5,1120.040943,62.224497,224.008189,71.273029,1,0
0,0,5,5,10,20,30,58,36,94,0.000333,0.153749,5,2306.23858,128.124366,461.247716,119.657843,1,0
0,0,3,3,11,11,22,26,15,41,0.000333,0.060946,5,914.183482,50.787971,182.836696,76.107496,3,0
0,0,10,10,15,22,37,70,39,109,0.000333,0.189277,7,3974.812918,220.82294,567.830417,156.710855,6,0
0,0,4,4,12,12,24,49,23,72,0.000333,0.110039,6,1980.7038,110.0391,330.1173,86.0391,10,0
0,0,5,5,12,12,24,58,26,84,0.000333,0.128379,12,4621.642201,256.7579,385.13685,86.0391,11,0
0,0,1,1,5,3,8,11,3,14,0.000333,0.014,2,84,4.666667,42,16.364528,2,0
0,0,2,2,7,4,11,13,5,18,0.000333,0.020757,3,186.809307,10.378295,62.269769,27.651484,3,0
0,0,2,2,9,10,19,26,14,40,0.000333,0.056639,4,679.668402,37.759356,169.917101,61.748606,1,0
0,0,10,10,9,14,23,123,66,189,0.000333,0.284984,16,13679.25136,759.958409,854.95321,81.832294,1,0
0,0,2,2,9,10,19,26,14,40,0.000333,0.056639,4,679.668402,37.759356,169.917101,61.748606,1,0
0,0,3,3,11,12,23,35,18,53,0.000333,0.079916,5,1198.743918,66.596884,239.748784,81.073298,2,0
0,0,5,5,13,101,114,424,267,691,0.000333,1.573842,12,56658.324,3147.684667,4721.527,720.585076,7,0
0,0,2,2,9,10,19,26,14,40,0.000333,0.056639,4,679.668402,37.759356,169.917101,61.748606,2,0
0,0,2,2,9,10,19,26,14,40,0.000333,0.056639,4,679.668402,37.759356,169.917101,61.748606,1,0
0,0,2,2,9,10,19,26,14,40,0.000333,0.056639,4,679.668402,37.759356,169.917101,61.748606,1,0
0,0,2,2,9,10,19,26,14,40,0.000333,0.056639,4,679.668402,37.759356,169.917101,61.748606,1,0
0,0,2,2,9,10,19,26,14,40,0.000333,0.056639,4,679.668402,37.759356,169.917101,61.748606,1,0
0,0,2,2,9,10,19,26,14,40,0.000333,0.056639,4,679.668402,37.759356,169.917101,61.748606,2,0
0,0,2,2,9,10,19,26,14,40,0.000333,0.056639,4,679.668402,37.759356,169.917101,61.748606,1,0
0,0,2,2,9,10,19,26,14,40,0.000333,0.056639,4,679.668402,37.759356,169.917101,61.748606,1,0
0,0,2,2,9,10,19,26,14,40,0.000333,0.056639,4,679.668402,37.759356,169.917101,61.748606,1,0
0,0,2,2,9,10,19,26,14,40,0.000333,0.056639,4,679.668402,37.759356,169.917101,61.748606,1,0
0,0,2,2,9,10,19,26,14,40,0.000333,0.056639,4,679.668402,37.759356,169.917101,61.748606,1,0
0,0,2,2,9,10,19,26,14,40,0.000333,0.056639,4,679.668402,37.759356,169.917101,61.748606,1,0
0,0,2,2,9,10,19,26,14,40,0.000333,0.056639,4,679.668402,37.759356,169.917101,61.748606,1,0
0,0,2,2,9,10,19,26,14,40,0.000333,0.056639,4,679.668402,37.759356,169.917101,61.748606,1,0
0,0,3,3,9,9,18,63,34,97,0.000333,0.134828,12,4853.792702,269.65515,404.482725,57.05865,1,0
0,0,2,2,9,10,19,26,14,40,0.000333,0.056639,4,679.668402,37.759356,169.917101,61.748606,1,0
0,0,2,2,9,10,19,26,14,40,0.000333,0.056639,4,679.668402,37.759356,169.917101,61.748606,1,0
0,0,2,2,9,10,19,26,14,40,0.000333,0.056639,4,679.668402,37.759356,169.917101,61.748606,1,0
0,0,4,4,10,13,23,67,37,104,0.000333,0.156817,10,4704.504434,261.361357,470.450443,81.324997,1,0
0,0,22,22,17,34,51,128,68,196,0.000333,0.370598,16,17788.72587,988.262548,1111.795367,242.460605,8,0
0,0,2,2,7,4,11,13,5,18,0.000333,0.020757,3,186.809307,10.378295,62.269769,27.651484,3,0
0,0,23,23,14,33,47,142,74,216,0.000333,0.39993,14,16797.07669,933.170927,1199.791192,219.767975,14,0
0,0,5,5,11,13,24,26,20,46,0.000333,0.070303,5,1054.541375,58.585632,210.908275,86.159464,1,0
0,0,5,5,10,13,23,30,20,50,0.000333,0.075393,5,1130.890489,62.827249,226.178098,81.324997,2,0
0,0,31,31,19,37,56,163,87,250,0.000333,0.483946,18,26133.09715,1451.838731,1451.838731,273.460397,11,0
0,0,2,2,7,4,11,13,5,18,0.000333,0.020757,3,186.809307,10.378295,62.269769,27.651484,3,0
0,0,28,28,16,37,53,191,92,283,0.000333,0.540334,16,25936.02382,1440.890212,1621.001489,256.749775,9,0
0,0,22,22,14,40,54,144,81,225,0.000333,0.431617,14,18127.89563,1007.105313,1294.849688,266.180093,1,0
0,0,28,28,19,37,56,153,80,233,0.000333,0.451038,18,24356.04654,1353.113697,1353.113697,273.460397,10,0
0,0,21,21,14,30,44,124,63,187,0.000333,0.340305,14,14292.79198,794.043999,1020.913713,200.509687,7,0
0,0,2,2,7,4,11,13,5,18,0.000333,0.020757,3,186.809307,10.378295,62.269769,27.651484,3,0
0,0,25,25,13,32,45,140,84,224,0.000333,0.410058,12,14762.10112,820.116729,1230.175094,208.105716,1,0
0,0,20,20,15,33,48,128,67,195,0.000333,0.363023,14,15246.94763,847.052646,1089.067688,225.068365,7,0
0,0,2,2,7,4,11,13,5,18,0.000333,0.020757,3,186.809307,10.378295,62.269769,27.651484,3,0
0,0,4,4,9,6,15,15,11,26,0.000333,0.03386,4,406.316622,22.573146,101.579155,44.0391,3,0
0,0,28,28,19,37,56,153,80,233,0.000333,0.451038,18,24356.04654,1353.113697,1353.113697,273.460397,10,0
0,0,2,2,8,3,11,9,5,14,0.000333,0.016144,4,193.728171,10.762676,48.432043,28.754888,3,0
0,0,3,3,10,6,16,21,9,30,0.000333,0.04,5,600,33.333333,120,48.729056,3,0
0,0,8,8,16,17,33,121,69,190,0.000333,0.319478,32,30669.91625,1703.884236,958.434883,133.486868,1,0
0,0,4,4,14,11,25,57,30,87,0.000333,0.134672,14,5656.216839,314.234269,404.015489,91.356717,1,0
0,0,40,40,23,42,65,303,167,470,0.000333,0.943504,33,93406.92478,5189.273599,2830.512872,330.519257,16,0
0,0,24,24,21,28,49,166,86,252,0.000333,0.471636,30,42447.20642,2358.178135,1414.906881,226.844604,8,0
0,0,36,36,19,41,60,203,110,313,0.000333,0.616286,18,33279.42162,1848.856756,1848.856756,300.370255,13,0
0,0,17,17,16,23,39,110,55,165,0.000333,0.290697,16,13953.46186,775.192325,872.091366,168.041925,7,0
0,0,5,5,7,8,15,19,13,32,0.000333,0.041673,3,375.061497,20.83675,125.020499,43.651484,2,0
0,0,5,5,9,11,20,24,17,41,0.000333,0.059066,4,708.796208,39.377567,177.199052,66.583073,1,0
0,0,3,3,11,11,22,26,15,41,0.000333,0.060946,5,914.183482,50.787971,182.836696,76.107496,3,0
0,0,10,10,15,22,37,70,39,109,0.000333,0.189277,7,3974.812918,220.82294,567.830417,156.710855,6,0
0,0,2,2,7,4,11,13,5,18,0.000333,0.020757,3,186.809307,10.378295,62.269769,27.651484,3,0
0,0,17,17,16,23,39,110,55,165,0.000333,0.290697,16,13953.46186,775.192325,872.091366,168.041925,7,0
0,0,34,34,12,43,55,145,83,228,0.000333,0.439383,6,7908.900088,439.383338,1318.150015,276.348934,11,0
0,0,3,3,11,11,22,26,15,41,0.000333,0.060946,5,914.183482,50.787971,182.836696,76.107496,3,0
0,0,10,10,15,22,37,70,39,109,0.000333,0.189277,7,3974.812918,220.82294,567.830417,156.710855,6,0
0,0,5,5,11,13,24,36,21,57,0.000333,0.087114,5,1306.714313,72.59524,261.342863,86.159464,3,0
0,0,2,2,7,4,11,13,5,18,0.000333,0.020757,3,186.809307,10.378295,62.269769,27.651484,3,0
0,0,17,17,16,23,39,110,55,165,0.000333,0.290697,16,13953.46186,775.192325,872.091366,168.041925,7,0
0,0,5,5,11,13,24,36,21,57,0.000333,0.087114,5,1306.714313,72.59524,261.342863,86.159464,3,0
0,0,32,32,19,39,58,168,89,257,0.000333,0.501834,18,27099.02008,1505.501116,1505.501116,286.841309,11,0
0,0,2,2,7,4,11,13,5,18,0.000333,0.020757,3,186.809307,10.378295,62.269769,27.651484,3,0
0,0,2,2,11,6,17,14,8,22,0.000333,0.029975,5,449.620913,24.97894,89.924183,53.563523,2,0
0,0,3,3,11,11,22,26,15,41,0.000333,0.060946,5,914.183482,50.787971,182.836696,76.107496,3,0
0,0,10,10,15,22,37,70,39,109,0.000333,0.189277,7,3974.812918,220.82294,567.830417,156.710855,6,0
0,0,16,16,13,25,38,92,48,140,0.000333,0.244903,6,4408.259111,244.903284,734.709852,164.202121,7,0
0,0,2,2,7,4,11,13,5,18,0.000333,0.020757,3,186.809307,10.378295,62.269769,27.651484,3,0
0,0,32,32,19,39,58,173,93,266,0.000333,0.519408,18,28048.01301,1558.222945,1558.222945,286.841309,11,0
0,0,13,13,15,13,28,49,31,80,0.000333,0.128196,14,5384.237513,299.124306,384.588394,106.709075,4,0
0,0,8,8,15,15,30,39,28,67,0.000333,0.109587,7,2301.331689,127.851761,328.76167,117.206718,1,0
0,0,5,5,11,13,24,36,21,57,0.000333,0.087114,5,1306.714313,72.59524,261.342863,86.159464,3,0
0,0,2,2,7,4,11,13,5,18,0.000333,0.020757,3,186.809307,10.378295,62.269769,27.651484,3,0
0,0,22,22,17,35,52,129,69,198,0.000333,0.376229,8,9029.496514,501.638695,1128.687064,249.011774,8,0
0,0,4,4,8,10,18,27,16,43,0.000333,0.059769,4,717.2271,39.84595,179.306775,57.219281,1,0
0,0,2,2,7,4,11,13,5,18,0.000333,0.020757,3,186.809307,10.378295,62.269769,27.651484,3,0
0,0,5,5,11,13,24,36,21,57,0.000333,0.087114,5,1306.714313,72.59524,261.342863,86.159464,3,0
0,0,17,17,16,23,39,110,55,165,0.000333,0.290697,16,13953.46186,775.192325,872.091366,168.041925,7,0
0,0,2,2,7,4,11,13,5,18,0.000333,0.020757,3,186.809307,10.378295,62.269769,27.651484,3,0
0,0,14,14,16,20,36,94,67,161,0.000333,0.277453,24,19976.59021,1109.810567,832.357925,150.438562,1,0
0,0,32,32,28,54,82,318,187,505,0.000333,1.070188,42,134843.678,7491.315445,3210.563762,445.369863,20,0
0,0,18,18,13,27,40,101,64,165,0.000333,0.292706,12,10537.41763,585.41209,878.118136,176.487679,10,0
0,0,5,5,11,13,24,36,21,57,0.000333,0.087114,5,1306.714313,72.59524,261.342863,86.159464,4,0
0,0,1,1,5,3,8,11,3,14,0.000333,0.014,2,84,4.666667,42,16.364528,2,0
0,0,28,28,17,39,56,146,79,225,0.000333,0.435552,16,20906.47772,1161.470984,1306.654857,275.617555,12,0
0,0,4,4,12,12,24,49,23,72,0.000333,0.110039,6,1980.7038,110.0391,330.1173,86.0391,10,0
0,0,2,2,7,4,11,13,5,18,0.000333,0.020757,3,186.809307,10.378295,62.269769,27.651484,3,0
0,0,5,5,12,12,24,58,26,84,0.000333,0.128379,12,4621.642201,256.7579,385.13685,86.0391,11,0
0,0,2,2,9,10,19,26,14,40,0.000333,0.056639,4,679.668402,37.759356,169.917101,61.748606,1,0
0,0,2,2,9,10,19,26,14,40,0.000333,0.056639,4,679.668402,37.759356,169.917101,61.748606,1,0
0,0,3,3,9,9,18,63,34,97,0.000333,0.134828,12,4853.792702,269.65515,404.482725,57.05865,1,0
0,0,2,2,9,10,19,26,14,40,0.000333,0.056639,4,679.668402,37.759356,169.917101,61.748606,2,0
0,0,2,2,9,10,19,26,14,40,0.000333,0.056639,4,679.668402,37.759356,169.917101,61.748606,1,0
0,0,2,2,9,10,19,26,14,40,0.000333,0.056639,4,679.668402,37.759356,169.917101,61.748606,1,0
0,0,2,2,9,10,19,26,14,40,0.000333,0.056639,4,679.668402,37.759356,169.917101,61.748606,1,0
0,0,2,2,9,10,19,26,14,40,0.000333,0.056639,4,679.668402,37.759356,169.917101,61.748606,1,0
0,0,2,2,9,10,19,26,14,40,0.000333,0.056639,4,679.668402,37.759356,169.917101,61.748606,1,0
0,0,2,2,9,10,19,26,14,40,0.000333,0.056639,4,679.668402,37.759356,169.917101,61.748606,1,0
0,0,2,2,9,10,19,26,14,40,0.000333,0.056639,4,679.668402,37.759356,169.917101,61.748606,1,0
0,0,2,2,9,10,19,26,14,40,0.000333,0.056639,4,679.668402,37.759356,169.917101,61.748606,1,0
0,0,2,2,9,10,19,26,14,40,0.000333,0.056639,4,679.668402,37.759356,169.917101,61.748606,1,0
0,0,2,2,9,10,19,26,14,40,0.000333,0.056639,4,679.668402,37.759356,169.917101,61.748606,1,0
0,0,10,10,9,14,23,123,66,189,0.000333,0.284984,16,13679.25136,759.958409,854.95321,81.832294,1,0
0,0,2,2,9,10,19,26,14,40,0.000333,0.056639,4,679.668402,37.759356,169.917101,61.748606,1,0
0,0,3,3,11,12,23,35,18,53,0.000333,0.079916,5,1198.743918,66.596884,239.748784,81.073298,2,0
0,0,5,5,13,101,114,424,267,691,0.000333,1.573842,12,56658.324,3147.684667,4721.527,720.585076,7,0
0,0,4,4,10,13,23,67,37,104,0.000333,0.156817,10,4704.504434,261.361357,470.450443,81.324997,1,0
0,0,2,2,9,10,19,26,14,40,0.000333,0.056639,4,679.668402,37.759356,169.917101,61.748606,1,0
0,0,2,2,9,10,19,26,14,40,0.000333,0.056639,4,679.668402,37.759356,169.917101,61.748606,1,0
0,0,2,2,9,10,19,26,14,40,0.000333,0.056639,4,679.668402,37.759356,169.917101,61.748606,2,0
0,0,2,2,9,10,19,26,14,40,0.000333,0.056639,4,679.668402,37.759356,169.917101,61.748606,1,0
0,0,2,2,9,10,19,26,14,40,0.000333,0.056639,4,679.668402,37.759356,169.917101,61.748606,1,0
0,0,17,17,16,23,39,110,55,165,0.000333,0.290697,16,13953.46186,775.192325,872.091366,168.041925,7,0
0,0,15,15,14,24,38,85,45,130,0.000333,0.22741,7,4775.614037,265.311891,682.230577,163.342069,5,0
0,0,2,2,7,4,11,13,5,18,0.000333,0.020757,3,186.809307,10.378295,62.269769,27.651484,3,0
0,0,2,2,7,4,11,13,5,18,0.000333,0.020757,3,186.809307,10.378295,62.269769,27.651484,3,0
0,0,6,6,10,16,26,39,22,61,0.000333,0.095576,5,1433.634114,79.64634,286.726823,97.219281,1,0
0,0,6,6,12,12,24,40,18,58,0.000333,0.088643,6,1595.56695,88.642608,265.927825,86.0391,3,0
0,0,30,30,19,35,54,158,85,243,0.000333,0.466146,18,25171.87793,1398.437663,1398.437663,260.235528,11,0
0,0,4,4,12,12,24,49,23,72,0.000333,0.110039,6,1980.7038,110.0391,330.1173,86.0391,10,0
0,0,5,5,12,12,24,58,26,84,0.000333,0.128379,12,4621.642201,256.7579,385.13685,86.0391,11,0
0,0,1,1,5,3,8,11,3,14,0.000333,0.014,2,84,4.666667,42,16.364528,2,0
0,0,6,6,9,14,23,38,19,57,0.000333,0.085948,4,1031.372126,57.298451,257.843031,81.832294,1,0
0,0,3,3,9,9,18,63,34,97,0.000333,0.134828,12,4853.792702,269.65515,404.482725,57.05865,1,0
0,0,2,2,9,10,19,26,14,40,0.000333,0.056639,4,679.668402,37.759356,169.917101,61.748606,2,0
0,0,3,3,11,12,23,35,18,53,0.000333,0.079916,5,1198.743918,66.596884,239.748784,81.073298,2,0
0,0,2,2,9,10,19,26,14,40,0.000333,0.056639,4,679.668402,37.759356,169.917101,61.748606,1,0
0,0,2,2,9,10,19,26,14,40,0.000333,0.056639,4,679.668402,37.759356,169.917101,61.748606,1,0
0,0,2,2,9,10,19,26,14,40,0.000333,0.056639,4,679.668402,37.759356,169.917101,61.748606,1,0
0,0,2,2,9,10,19,26,14,40,0.000333,0.056639,4,679.668402,37.759356,169.917101,61.748606,1,0
0,0,2,2,9,10,19,26,14,40,0.000333,0.056639,4,679.668402,37.759356,169.917101,61.748606,1,0
0,0,10,10,9,14,23,123,66,189,0.000333,0.284984,16,13679.25136,759.958409,854.95321,81.832294,1,0
0,0,2,2,9,10,19,26,14,40,0.000333,0.056639,4,679.668402,37.759356,169.917101,61.748606,1,0
0,0,2,2,9,10,19,26,14,40,0.000333,0.056639,4,679.668402,37.759356,169.917101,61.748606,1,0
0,0,2,2,9,10,19,26,14,40,0.000333,0.056639,4,679.668402,37.759356,169.917101,61.748606,1,0
0,0,2,2,9,10,19,26,14,40,0.000333,0.056639,4,679.668402,37.759356,169.917101,61.748606,1,0
0,0,4,4,10,13,23,67,37,104,0.000333,0.156817,10,4704.504434,261.361357,470.450443,81.324997,1,0
0,0,2,2,9,10,19,26,14,40,0.000333,0.056639,4,679.668402,37.759356,169.917101,61.748606,1,0
0,0,2,2,9,10,19,26,14,40,0.000333,0.056639,4,679.668402,37.759356,169.917101,61.748606,1,0
0,0,2,2,9,10,19,26,14,40,0.000333,0.056639,4,679.668402,37.759356,169.917101,61.748606,2,0
0,0,2,2,9,10,19,26,14,40,0.000333,0.056639,4,679.668402,37.759356,169.917101,61.748606,2,0
0,0,5,5,13,101,114,424,267,691,0.000333,1.573842,12,56658.324,3147.684667,4721.527,720.585076,7,0
0,0,2,2,9,10,19,26,14,40,0.000333,0.056639,4,679.668402,37.759356,169.917101,61.748606,1,0
0,0,2,2,9,10,19,26,14,40,0.000333,0.056639,4,679.668402,37.759356,169.917101,61.748606,1,0
0,0,2,2,9,10,19,26,14,40,0.000333,0.056639,4,679.668402,37.759356,169.917101,61.748606,1,0
0,0,2,2,9,10,19,26,14,40,0.000333,0.056639,4,679.668402,37.759356,169.917101,61.748606,1,0
0,0,2,2,9,10,19,26,14,40,0.000333,0.056639,4,679.668402,37.759356,169.917101,61.748606,1,0
0,0,2,2,9,10,19,26,14,40,0.000333,0.056639,4,679.668402,37.759356,169.917101,61.748606,1,0
0,0,5,5,11,13,24,36,21,57,0.000333,0.087114,5,1306.714313,72.59524,261.342863,86.159464,3,0
0,0,28,28,19,39,58,154,82,236,0.000333,0.460828,18,24884.70327,1382.483515,1382.483515,286.841309,10,0
0,0,2,2,7,4,11,13,5,18,0.000333,0.020757,3,186.809307,10.378295,62.269769,27.651484,3,0
0,0,17,17,14,23,37,102,58,160,0.000333,0.277838,14,11669.17554,648.28753,833.512539,157.344894,6,0
0,0,2,2,7,4,11,13,5,18,0.000333,0.020757,3,186.809307,10.378295,62.269769,27.651484,3,0
0,0,1,1,5,3,8,11,3,14,0.000333,0.014,2,84,4.666667,42,16.364528,2,0
0,0,28,28,20,38,58,153,81,234,0.000333,0.456923,20,27415.35106,1523.075059,1370.767553,285.859807,10,0
0,0,5,5,12,12,24,58,26,84,0.000333,0.128379,12,4621.642201,256.7579,385.13685,86.0391,11,0
0,0,17,17,12,25,37,105,52,157,0.000333,0.272628,12,9814.610141,545.256119,817.884178,159.115955,6,0
0,0,4,4,12,12,24,49,23,72,0.000333,0.110039,6,1980.7038,110.0391,330.1173,86.0391,10,0
0,0,18,18,13,27,40,107,63,170,0.000333,0.301576,12,10856.73331,603.151851,904.727776,176.487679,1,0
0,0,2,2,9,10,19,26,14,40,0.000333,0.056639,4,679.668402,37.759356,169.917101,61.748606,2,0
0,0,2,2,9,10,19,26,14,40,0.000333,0.056639,4,679.668402,37.759356,169.917101,61.748606,1,0
0,0,2,2,9,10,19,26,14,40,0.000333,0.056639,4,679.668402,37.759356,169.917101,61.748606,1,0
0,0,2,2,9,10,19,26,14,40,0.000333,0.056639,4,679.668402,37.759356,169.917101,61.748606,1,0
0,0,2,2,9,10,19,26,14,40,0.000333,0.056639,4,679.668402,37.759356,169.917101,61.748606,1,0
0,0,2,2,9,10,19,26,14,40,0.000333,0.056639,4,679.668402,37.759356,169.917101,61.748606,1,0
0,0,2,2,9,10,19,26,14,40,0.000333,0.056639,4,679.668402,37.759356,169.917101,61.748606,1,0
0,0,5,5,13,101,114,424,267,691,0.000333,1.573842,12,56658.324,3147.684667,4721.527,720.585076,7,0
0,0,10,10,9,14,23,123,66,189,0.000333,0.284984,16,13679.25136,759.958409,854.95321,81.832294,1,0
0,0,2,2,9,10,19,26,14,40,0.000333,0.056639,4,679.668402,37.759356,169.917101,61.748606,1,0
0,0,2,2,9,10,19,26,14,40,0.000333,0.056639,4,679.668402,37.759356,169.917101,61.748606,2,0
0,0,2,2,9,10,19,26,14,40,0.000333,0.056639,4,679.668402,37.759356,169.917101,61.748606,1,0
0,0,2,2,9,10,19,26,14,40,0.000333,0.056639,4,679.668402,37.759356,169.917101,61.748606,1,0
0,0,4,4,10,13,23,67,37,104,0.000333,0.156817,10,4704.504434,261.361357,470.450443,81.324997,1,0
0,0,2,2,9,10,19,26,14,40,0.000333,0.056639,4,679.668402,37.759356,169.917101,61.748606,1,0
0,0,2,2,9,10,19,26,14,40,0.000333,0.056639,4,679.668402,37.759356,169.917101,61.748606,1,0
0,0,3,3,11,12,23,35,18,53,0.000333,0.079916,5,1198.743918,66.596884,239.748784,81.073298,2,0
0,0,2,2,9,10,19,26,14,40,0.000333,0.056639,4,679.668402,37.759356,169.917101,61.748606,1,0
0,0,2,2,9,10,19,26,14,40,0.000333,0.056639,4,679.668402,37.759356,169.917101,61.748606,1,0
0,0,2,2,9,10,19,26,14,40,0.000333,0.056639,4,679.668402,37.759356,169.917101,61.748606,1,0
0,0,3,3,9,9,18,63,34,97,0.000333,0.134828,12,4853.792702,269.65515,404.482725,57.05865,1,0
0,0,2,2,9,10,19,26,14,40,0.000333,0.056639,4,679.668402,37.759356,169.917101,61.748606,1,0
0,0,2,2,9,10,19,26,14,40,0.000333,0.056639,4,679.668402,37.759356,169.917101,61.748606,1,0
0,0,2,2,9,10,19,26,14,40,0.000333,0.056639,4,679.668402,37.759356,169.917101,61.748606,1,0
0,0,5,5,11,13,24,36,21,57,0.000333,0.087114,5,1306.714313,72.59524,261.342863,86.159464,3,0
0,0,28,28,20,39,59,158,85,243,0.000333,0.476494,20,28589.64522,1588.313623,1429.482261,292.569248,10,0
0,0,1,1,5,3,8,11,3,14,0.000333,0.014,2,84,4.666667,42,16.364528,2,0
0,0,5,5,12,12,24,58,26,84,0.000333,0.128379,12,4621.642201,256.7579,385.13685,86.0391,11,0
0,0,2,2,7,4,11,13,5,18,0.000333,0.020757,3,186.809307,10.378295,62.269769,27.651484,3,0
0,0,4,4,12,12,24,49,23,72,0.000333,0.110039,6,1980.7038,110.0391,330.1173,86.0391,10,0
0,0,2,2,9,10,19,26,14,40,0.000333,0.056639,4,679.668402,37.759356,169.917101,61.748606,1,0
0,0,2,2,9,10,19,26,14,40,0.000333,0.056639,4,679.668402,37.759356,169.917101,61.748606,1,0
0,0,5,5,13,101,114,424,267,691,0.000333,1.573842,12,56658.324,3147.684667,4721.527,720.585076,7,0
0,0,10,10,9,14,23,123,66,189,0.000333,0.284984,16,13679.25136,759.958409,854.95321,81.832294,1,0
0,0,2,2,9,10,19,26,14,40,0.000333,0.056639,4,679.668402,37.759356,169.917101,61.748606,1,0
0,0,2,2,9,10,19,26,14,40,0.000333,0.056639,4,679.668402,37.759356,169.917101,61.748606,2,0
0,0,2,2,9,10,19,26,14,40,0.000333,0.056639,4,679.668402,37.759356,169.917101,61.748606,1,0
0,0,3,3,9,9,18,63,34,97,0.000333,0.134828,12,4853.792702,269.65515,404.482725,57.05865,1,0
0,0,2,2,9,10,19,26,14,40,0.000333,0.056639,4,679.668402,37.759356,169.917101,61.748606,1,0
0,0,2,2,9,10,19,26,14,40,0.000333,0.056639,4,679.668402,37.759356,169.917101,61.748606,1,0
0,0,2,2,9,10,19,26,14,40,0.000333,0.056639,4,679.668402,37.759356,169.917101,61.748606,1,0
0,0,2,2,9,10,19,26,14,40,0.000333,0.056639,4,679.668402,37.759356,169.917101,61.748606,1,0
0,0,2,2,9,10,19,26,14,40,0.000333,0.056639,4,679.668402,37.759356,169.917101,61.748606,1,0
0,0,2,2,9,10,19,26,14,40,0.000333,0.056639,4,679.668402,37.759356,169.917101,61.748606,1,0
0,0,3,3,11,12,23,35,18,53,0.000333,0.079916,5,1198.743918,66.596884,239.748784,81.073298,2,0
0,0,2,2,9,10,19,26,14,40,0.000333,0.056639,4,679.668402,37.759356,169.917101,61.748606,1,0
0,0,2,2,9,10,19,26,14,40,0.000333,0.056639,4,679.668402,37.759356,169.917101,61.748606,1,0
0,0,2,2,9,10,19,26,14,40,0.000333,0.056639,4,679.668402,37.759356,169.917101,61.748606,1,0
0,0,2,2,9,10,19,26,14,40,0.000333,0.056639,4,679.668402,37.759356,169.917101,61.748606,1,0
0,0,4,4,10,13,23,67,37,104,0.000333,0.156817,10,4704.504434,261.361357,470.450443,81.324997,1,0
0,0,2,2,9,10,19,26,14,40,0.000333,0.056639,4,679.668402,37.759356,169.917101,61.748606,1,0
0,0,2,2,9,10,19,26,14,40,0.000333,0.056639,4,679.668402,37.759356,169.917101,61.748606,2,0
0,0,2,2,9,10,19,26,14,40,0.000333,0.056639,4,679.668402,37.759356,169.917101,61.748606,1,0
0,0,2,2,9,10,19,26,14,40,0.000333,0.056639,4,679.668402,37.759356,169.917101,61.748606,1,0
0,0,216,216,37,125,162,1126,852,1978,0.000333,4.839408,108,1567968.117,87109.33983,14518.22331,1063.47281,43,0
0,0,236,236,39,118,157,1246,943,2189,0.000333,5.322642,133,2123734.001,117985.2223,15967.92482,1018.282566,48,0
0,0,217,217,38,126,164,1170,862,2032,0.000333,4.983515,114,1704362.207,94686.78927,14950.54567,1078.558516,50,0
0,0,267,267,37,110,147,1375,1067,2442,0.000333,5.860533,162,2848219.178,158234.3988,17581.59987,938.699343,41,0
0,0,3,3,11,11,22,26,15,41,0.000333,0.060946,5,914.183482,50.787971,182.836696,76.107496,3,0
0,0,10,10,15,22,37,70,39,109,0.000333,0.189277,7,3974.812918,220.82294,567.830417,156.710855,6,0
0,0,5,5,11,13,24,36,21,57,0.000333,0.087114,5,1306.714313,72.59524,261.342863,86.159464,4,0
0,0,17,17,16,23,39,110,55,165,0.000333,0.290697,16,13953.46186,775.192325,872.091366,168.041925,7,0
0,0,2,2,7,4,11,13,5,18,0.000333,0.020757,3,186.809307,10.378295,62.269769,27.651484,3,0
0,0,3,3,11,11,22,26,15,41,0.000333,0.060946,5,914.183482,50.787971,182.836696,76.107496,3,0
0,0,10,10,15,22,37,70,39,109,0.000333,0.189277,7,3974.812918,220.82294,567.830417,156.710855,6,0
0,0,2,2,7,4,11,13,5,18,0.000333,0.020757,3,186.809307,10.378295,62.269769,27.651484,3,0
0,0,5,5,14,9,23,39,20,59,0.000333,0.088963,14,3736.462176,207.581232,266.890155,81.832294,4,0
0,0,4,4,12,12,24,49,23,72,0.000333,0.110039,6,1980.7038,110.0391,330.1173,86.0391,10,0
0,0,5,5,12,12,24,58,26,84,0.000333,0.128379,12,4621.642201,256.7579,385.13685,86.0391,11,0
0,0,1,1,5,3,8,11,3,14,0.000333,0.014,2,84,4.666667,42,16.364528,2,0
0,0,2,2,9,10,19,26,14,40,0.000333,0.056639,4,679.668402,37.759356,169.917101,61.748606,2,0
0,0,2,2,9,10,19,26,14,40,0.000333,0.056639,4,679.668402,37.759356,169.917101,61.748606,1,0
0,0,2,2,9,10,19,26,14,40,0.000333,0.056639,4,679.668402,37.759356,169.917101,61.748606,1,0
0,0,2,2,9,10,19,26,14,40,0.000333,0.056639,4,679.668402,37.759356,169.917101,61.748606,1,0
0,0,2,2,9,10,19,26,14,40,0.000333,0.056639,4,679.668402,37.759356,169.917101,61.748606,1,0
0,0,2,2,9,10,19,26,14,40,0.000333,0.056639,4,679.668402,37.759356,169.917101,61.748606,1,0
0,0,3,3,9,9,18,63,34,97,0.000333,0.134828,12,4853.792702,269.65515,404.482725,57.05865,1,0
0,0,2,2,9,10,19,26,14,40,0.000333,0.056639,4,679.668402,37.759356,169.917101,61.748606,1,0
0,0,5,5,13,101,114,424,267,691,0.000333,1.573842,12,56658.324,3147.684667,4721.527,720.585076,7,0
0,0,4,4,10,13,23,67,37,104,0.000333,0.156817,10,4704.504434,261.361357,470.450443,81.324997,1,0
0,0,2,2,9,10,19,26,14,40,0.000333,0.056639,4,679.668402,37.759356,169.917101,61.748606,1,0
0,0,2,2,9,10,19,26,14,40,0.000333,0.056639,4,679.668402,37.759356,169.917101,61.748606,1,0
0,0,2,2,9,10,19,26,14,40,0.000333,0.056639,4,679.668402,37.759356,169.917101,61.748606,1,0
0,0,2,2,9,10,19,26,14,40,0.000333,0.056639,4,679.668402,37.759356,169.917101,61.748606,1,0
0,0,2,2,9,10,19,26,14,40,0.000333,0.056639,4,679.668402,37.759356,169.917101,61.748606,1,0
0,0,2,2,9,10,19,26,14,40,0.000333,0.056639,4,679.668402,37.759356,169.917101,61.748606,1,0
0,0,10,10,9,14,23,123,66,189,0.000333,0.284984,16,13679.25136,759.958409,854.95321,81.832294,1,0
0,0,2,2,9,10,19,26,14,40,0.000333,0.056639,4,679.668402,37.759356,169.917101,61.748606,1,0
0,0,2,2,9,10,19,26,14,40,0.000333,0.056639,4,679.668402,37.759356,169.917101,61.748606,1,0
0,0,3,3,11,12,23,35,18,53,0.000333,0.079916,5,1198.743918,66.596884,239.748784,81.073298,2,0
0,0,2,2,9,10,19,26,14,40,0.000333,0.056639,4,679.668402,37.759356,169.917101,61.748606,1,0
0,0,2,2,9,10,19,26,14,40,0.000333,0.056639,4,679.668402,37.759356,169.917101,61.748606,1,0
0,0,2,2,9,10,19,26,14,40,0.000333,0.056639,4,679.668402,37.759356,169.917101,61.748606,1,0
0,0,2,2,9,10,19,26,14,40,0.000333,0.056639,4,679.668402,37.759356,169.917101,61.748606,2,0
0,0,5,5,12,12,24,58,26,84,0.000333,0.128379,12,4621.642201,256.7579,385.13685,86.0391,11,0
0,0,4,4,12,12,24,49,23,72,0.000333,0.110039,6,1980.7038,110.0391,330.1173,86.0391,10,0
0,0,27,27,19,35,54,145,76,221,0.000333,0.423943,18,22892.94248,1271.830138,1271.830138,260.235528,10,0
1,0,5,6,10,9,19,29,13,42,0.000333,0.059471,5,892.064778,49.559154,178.412956,61.748606,3,0
0,0,1,1,5,3,8,11,3,14,0.000333,0.014,2,84,4.666667,42,16.364528,2,0
0,0,2,2,9,10,19,26,14,40,0.000333,0.056639,4,679.668402,37.759356,169.917101,61.748606,1,0
0,0,5,5,13,101,114,424,267,691,0.000333,1.573842,12,56658.324,3147.684667,4721.527,720.585076,7,0
0,0,2,2,9,10,19,26,14,40,0.000333,0.056639,4,679.668402,37.759356,169.917101,61.748606,1,0
0,0,2,2,9,10,19,26,14,40,0.000333,0.056639,4,679.668402,37.759356,169.917101,61.748606,1,0
0,0,2,2,9,10,19,26,14,40,0.000333,0.056639,4,679.668402,37.759356,169.917101,61.748606,1,0
0,0,2,2,9,10,19,26,14,40,0.000333,0.056639,4,679.668402,37.759356,169.917101,61.748606,1,0
0,0,2,2,9,10,19,26,14,40,0.000333,0.056639,4,679.668402,37.759356,169.917101,61.748606,1,0
0,0,2,2,9,10,19,26,14,40,0.000333,0.056639,4,679.668402,37.759356,169.917101,61.748606,1,0
0,0,2,2,9,10,19,26,14,40,0.000333,0.056639,4,679.668402,37.759356,169.917101,61.748606,1,0
0,0,2,2,9,10,19,26,14,40,0.000333,0.056639,4,679.668402,37.759356,169.917101,61.748606,1,0
0,0,2,2,9,10,19,26,14,40,0.000333,0.056639,4,679.668402,37.759356,169.917101,61.748606,1,0
0,0,2,2,9,10,19,26,14,40,0.000333,0.056639,4,679.668402,37.759356,169.917101,61.748606,2,0
0,0,2,2,9,10,19,26,14,40,0.000333,0.056639,4,679.668402,37.759356,169.917101,61.748606,1,0
0,0,2,2,9,10,19,26,14,40,0.000333,0.056639,4,679.668402,37.759356,169.917101,61.748606,2,0
0,0,3,3,11,12,23,35,18,53,0.000333,0.079916,5,1198.743918,66.596884,239.748784,81.073298,2,0
0,0,10,10,9,14,23,123,66,189,0.000333,0.284984,16,13679.25136,759.958409,854.95321,81.832294,1,0
0,0,2,2,9,10,19,26,14,40,0.000333,0.056639,4,679.668402,37.759356,169.917101,61.748606,1,0
0,0,3,3,9,9,18,63,34,97,0.000333,0.134828,12,4853.792702,269.65515,404.482725,57.05865,1,0
0,0,2,2,9,10,19,26,14,40,0.000333,0.056639,4,679.668402,37.759356,169.917101,61.748606,1,0
0,0,4,4,10,13,23,67,37,104,0.000333,0.156817,10,4704.504434,261.361357,470.450443,81.324997,1,0
0,0,2,2,9,10,19,26,14,40,0.000333,0.056639,4,679.668402,37.759356,169.917101,61.748606,1,0
0,0,2,2,9,10,19,26,14,40,0.000333,0.056639,4,679.668402,37.759356,169.917101,61.748606,1,0
0,0,2,2,9,10,19,26,14,40,0.000333,0.056639,4,679.668402,37.759356,169.917101,61.748606,1,0
0,0,2,2,9,10,19,26,14,40,0.000333,0.056639,4,679.668402,37.759356,169.917101,61.748606,1,0
0,0,4,4,9,7,16,21,10,31,0.000333,0.041333,4,496,27.555556,124,48.180809,2,0
0,0,17,17,16,23,39,110,55,165,0.000333,0.290697,16,13953.46186,775.192325,872.091366,168.041925,7,0
0,0,3,3,11,11,22,26,15,41,0.000333,0.060946,5,914.183482,50.787971,182.836696,76.107496,3,0
0,0,10,10,15,22,37,70,39,109,0.000333,0.189277,7,3974.812918,220.82294,567.830417,156.710855,6,0
0,0,27,27,19,35,54,145,76,221,0.000333,0.423943,18,22892.94248,1271.830138,1271.830138,260.235528,10,0
0,0,7,7,13,13,26,42,21,63,0.000333,0.098709,6,1776.766213,98.709234,296.127702,96.211433,2,0
0,0,10,10,11,16,27,49,30,79,0.000333,0.125212,5,1878.180563,104.343365,375.636113,102.053748,1,0
0,0,5,5,12,12,24,58,26,84,0.000333,0.128379,12,4621.642201,256.7579,385.13685,86.0391,11,0
0,0,4,4,12,12,24,49,23,72,0.000333,0.110039,6,1980.7038,110.0391,330.1173,86.0391,10,0
0,0,1,1,5,3,8,11,3,14,0.000333,0.014,2,84,4.666667,42,16.364528,2,0
0,0,2,2,7,4,11,13,5,18,0.000333,0.020757,3,186.809307,10.378295,62.269769,27.651484,3,0
0,0,2,2,9,10,19,26,14,40,0.000333,0.056639,4,679.668402,37.759356,169.917101,61.748606,1,0
0,0,2,2,9,10,19,26,14,40,0.000333,0.056639,4,679.668402,37.759356,169.917101,61.748606,1,0
0,0,2,2,9,10,19,26,14,40,0.000333,0.056639,4,679.668402,37.759356,169.917101,61.748606,1,0
0,0,2,2,9,10,19,26,14,40,0.000333,0.056639,4,679.668402,37.759356,169.917101,61.748606,1,0
0,0,2,2,9,10,19,26,14,40,0.000333,0.056639,4,679.668402,37.759356,169.917101,61.748606,1,0
0,0,3,3,11,12,23,35,18,53,0.000333,0.079916,5,1198.743918,66.596884,239.748784,81.073298,2,0
0,0,2,2,9,10,19,26,14,40,0.000333,0.056639,4,679.668402,37.759356,169.917101,61.748606,1,0
0,0,4,4,10,13,23,67,37,104,0.000333,0.156817,10,4704.504434,261.361357,470.450443,81.324997,1,0
0,0,10,10,9,14,23,123,66,189,0.000333,0.284984,16,13679.25136,759.958409,854.95321,81.832294,1,0
0,0,2,2,9,10,19,26,14,40,0.000333,0.056639,4,679.668402,37.759356,169.917101,61.748606,2,0
0,0,3,3,9,9,18,63,34,97,0.000333,0.134828,12,4853.792702,269.65515,404.482725,57.05865,1,0
0,0,2,2,9,10,19,26,14,40,0.000333,0.056639,4,679.668402,37.759356,169.917101,61.748606,2,0
0,0,2,2,9,10,19,26,14,40,0.000333,0.056639,4,679.668402,37.759356,169.917101,61.748606,1,0
0,0,2,2,9,10,19,26,14,40,0.000333,0.056639,4,679.668402,37.759356,169.917101,61.748606,1,0
0,0,2,2,9,10,19,26,14,40,0.000333,0.056639,4,679.668402,37.759356,169.917101,61.748606,1,0
0,0,2,2,9,10,19,26,14,40,0.000333,0.056639,4,679.668402,37.759356,169.917101,61.748606,1,0
0,0,2,2,9,10,19,26,14,40,0.000333,0.056639,4,679.668402,37.759356,169.917101,61.748606,1,0
0,0,2,2,9,10,19,26,14,40,0.000333,0.056639,4,679.668402,37.759356,169.917101,61.748606,1,0
0,0,5,5,13,101,114,424,267,691,0.000333,1.573842,12,56658.324,3147.684667,4721.527,720.585076,7,0
0,0,2,2,9,10,19,26,14,40,0.000333,0.056639,4,679.668402,37.759356,169.917101,61.748606,1,0
0,0,2,2,9,10,19,26,14,40,0.000333,0.056639,4,679.668402,37.759356,169.917101,61.748606,1,0
0,0,2,2,9,10,19,26,14,40,0.000333,0.056639,4,679.668402,37.759356,169.917101,61.748606,1,0
0,0,2,2,9,10,19,26,14,40,0.000333,0.056639,4,679.668402,37.759356,169.917101,61.748606,1,0
0,0,2,2,9,10,19,26,14,40,0.000333,0.056639,4,679.668402,37.759356,169.917101,61.748606,1,0
0,0,5,5,11,13,24,36,21,57,0.000333,0.087114,5,1306.714313,72.59524,261.342863,86.159464,3,0
0,0,34,34,23,56,79,224,129,353,0.000333,0.741745,22,48955.16129,2719.731183,2225.234604,429.253801,10,0
0,0,2,2,7,4,11,13,5,18,0.000333,0.020757,3,186.809307,10.378295,62.269769,27.651484,3,0
0,0,2,2,7,4,11,13,5,18,0.000333,0.020757,3,186.809307,10.378295,62.269769,27.651484,3,0
0,0,31,31,21,41,62,169,94,263,0.000333,0.521985,20,31319.07259,1739.948477,1565.95363,311.898298,11,0
0,0,35,35,14,45,59,285,107,392,0.000333,0.768665,14,32283.94506,1793.552503,2305.996075,300.436358,15,0
0,0,2,2,7,4,11,13,5,18,0.000333,0.020757,3,186.809307,10.378295,62.269769,27.651484,3,0
0,0,2,2,7,4,11,13,5,18,0.000333,0.020757,3,186.809307,10.378295,62.269769,27.651484,3,0
0,0,29,29,20,40,60,160,86,246,0.000333,0.484365,20,29061.90173,1614.550096,1453.095087,299.315686,10,0
0,0,24,24,14,39,53,151,80,231,0.000333,0.44105,14,18524.09475,1029.116375,1323.149625,259.433655,7,0
0,0,2,2,7,4,11,13,5,18,0.000333,0.020757,3,186.809307,10.378295,62.269769,27.651484,3,0
0,0,2,2,8,8,16,22,11,33,0.000333,0.044,4,528,29.333333,132,48,1,0
0,0,2,2,7,4,11,13,5,18,0.000333,0.020757,3,186.809307,10.378295,62.269769,27.651484,3,0
0,0,2,2,7,4,11,13,5,18,0.000333,0.020757,3,186.809307,10.378295,62.269769,27.651484,3,0
0,0,32,32,20,39,59,180,99,279,0.000333,0.547086,20,32825.14822,1823.619345,1641.257411,292.569248,11,0
0,0,3,3,9,6,15,18,8,26,0.000333,0.03386,4,406.316622,22.573146,101.579155,44.0391,2,0
0,0,7,7,10,15,25,44,26,70,0.000333,0.108357,5,1625.349666,90.297204,325.069933,91.82264,3,0
0,0,2,2,7,4,11,13,5,18,0.000333,0.020757,3,186.809307,10.378295,62.269769,27.651484,3,0
0,0,3,3,11,11,22,26,15,41,0.000333,0.060946,5,914.183482,50.787971,182.836696,76.107496,3,0
0,0,10,10,15,22,37,70,39,109,0.000333,0.189277,7,3974.812918,220.82294,567.830417,156.710855,6,0
0,0,31,31,19,37,56,162,88,250,0.000333,0.483946,18,26133.09715,1451.838731,1451.838731,273.460397,11,0
0,0,5,5,9,9,18,20,13,33,0.000333,0.045869,4,550.4301,30.57945,137.607525,57.05865,5,0
0,0,9,9,9,20,29,48,29,77,0.000333,0.124688,4,1496.258146,83.125453,374.064537,114.967887,1,0
0,0,31,31,18,42,60,156,93,249,0.000333,0.490272,18,26474.68365,1470.815758,1470.815758,301.535982,12,0
0,0,2,2,7,4,11,13,5,18,0.000333,0.020757,3,186.809307,10.378295,62.269769,27.651484,3,0
0,0,34,34,14,40,54,193,104,297,0.000333,0.569734,14,23928.82223,1329.379013,1709.201588,266.180093,18,0
0,0,2,2,7,4,11,13,5,18,0.000333,0.020757,3,186.809307,10.378295,62.269769,27.651484,3,0
0,0,3,3,11,11,22,26,15,41,0.000333,0.060946,5,914.183482,50.787971,182.836696,76.107496,3,0
0,0,10,10,15,22,37,70,39,109,0.000333,0.189277,7,3974.812918,220.82294,567.830417,156.710855,6,0
0,0,3,3,11,11,22,26,15,41,0.000333,0.060946,5,914.183482,50.787971,182.836696,76.107496,3,0
0,0,10,10,15,22,37,70,39,109,0.000333,0.189277,7,3974.812918,220.82294,567.830417,156.710855,6,0
0,0,3,3,11,11,22,26,15,41,0.000333,0.060946,5,914.183482,50.787971,182.836696,76.107496,3,0
0,0,10,10,15,22,37,70,39,109,0.000333,0.189277,7,3974.812918,220.82294,567.830417,156.710855,6,0
0,0,28,28,20,38,58,157,84,241,0.000333,0.470591,20,28235.4684,1568.637133,1411.77342,285.859807,10,0
0,0,16,16,13,25,38,92,48,140,0.000333,0.244903,6,4408.259111,244.903284,734.709852,164.202121,7,0
0,0,2,2,7,4,11,13,5,18,0.000333,0.020757,3,186.809307,10.378295,62.269769,27.651484,3,0
0,0,15,15,13,24,37,84,45,129,0.000333,0.224006,6,4032.116905,224.006495,672.019484,158.144816,6,0
0,0,2,2,7,4,11,13,5,18,0.000333,0.020757,3,186.809307,10.378295,62.269769,27.651484,3,0
0,0,17,17,16,23,39,110,55,165,0.000333,0.290697,16,13953.46186,775.192325,872.091366,168.041925,7,0
0,0,2,2,8,8,16,22,11,33,0.000333,0.044,4,528,29.333333,132,48,1,0
0,0,2,2,7,4,11,13,5,18,0.000333,0.020757,3,186.809307,10.378295,62.269769,27.651484,3,0
0,0,3,3,9,9,18,25,13,38,0.000333,0.052819,4,633.8286,35.2127,158.45715,57.05865,1,0
0,0,5,5,11,13,24,36,21,57,0.000333,0.087114,5,1306.714313,72.59524,261.342863,86.159464,3,0
0,0,2,2,7,4,11,13,5,18,0.000333,0.020757,3,186.809307,10.378295,62.269769,27.651484,3,0
0,0,28,28,19,38,57,151,79,230,0.000333,0.447188,18,24148.16466,1341.564703,1341.564703,280.131868,10,0
0,0,17,17,14,23,37,95,59,154,0.000333,0.267419,14,11231.58146,623.976748,802.255818,157.344894,2,0
0,0,5,5,11,13,24,36,21,57,0.000333,0.087114,5,1306.714313,72.59524,261.342863,86.159464,3,0
0,0,1,1,5,3,8,11,3,14,0.000333,0.014,2,84,4.666667,42,16.364528,2,0
0,0,28,28,19,39,58,154,82,236,0.000333,0.460828,18,24884.70327,1382.483515,1382.483515,286.841309,10,0
0,0,4,4,12,12,24,49,23,72,0.000333,0.110039,6,1980.7038,110.0391,330.1173,86.0391,10,0
0,0,2,2,7,4,11,13,5,18,0.000333,0.020757,3,186.809307,10.378295,62.269769,27.651484,3,0
0,0,5,5,12,12,24,58,26,84,0.000333,0.128379,12,4621.642201,256.7579,385.13685,86.0391,11,0
0,0,15,15,14,22,36,90,54,144,0.000333,0.248156,14,10422.5688,579.0316,744.4692,151.410465,2,0
0,0,2,2,9,10,19,26,14,40,0.000333,0.056639,4,679.668402,37.759356,169.917101,61.748606,2,0
0,0,2,2,9,10,19,26,14,40,0.000333,0.056639,4,679.668402,37.759356,169.917101,61.748606,1,0
0,0,2,2,9,10,19,26,14,40,0.000333,0.056639,4,679.668402,37.759356,169.917101,61.748606,1,0
0,0,2,2,9,10,19,26,14,40,0.000333,0.056639,4,679.668402,37.759356,169.917101,61.748606,1,0
0,0,2,2,9,10,19,26,14,40,0.000333,0.056639,4,679.668402,37.759356,169.917101,61.748606,1,0
0,0,2,2,9,10,19,26,14,40,0.000333,0.056639,4,679.668402,37.759356,169.917101,61.748606,1,0
0,0,2,2,9,10,19,26,14,40,0.000333,0.056639,4,679.668402,37.759356,169.917101,61.748606,1,0
0,0,5,5,13,101,114,424,267,691,0.000333,1.573842,12,56658.324,3147.684667,4721.527,720.585076,7,0
0,0,10,10,9,14,23,123,66,189,0.000333,0.284984,16,13679.25136,759.958409,854.95321,81.832294,1,0
0,0,2,2,9,10,19,26,14,40,0.000333,0.056639,4,679.668402,37.759356,169.917101,61.748606,1,0
0,0,2,2,9,10,19,26,14,40,0.000333,0.056639,4,679.668402,37.759356,169.917101,61.748606,2,0
0,0,2,2,9,10,19,26,14,40,0.000333,0.056639,4,679.668402,37.759356,169.917101,61.748606,1,0
0,0,2,2,9,10,19,26,14,40,0.000333,0.056639,4,679.668402,37.759356,169.917101,61.748606,1,0
0,0,4,4,10,13,23,67,37,104,0.000333,0.156817,10,4704.504434,261.361357,470.450443,81.324997,1,0
0,0,2,2,9,10,19,26,14,40,0.000333,0.056639,4,679.668402,37.759356,169.917101,61.748606,1,0
0,0,2,2,9,10,19,26,14,40,0.000333,0.056639,4,679.668402,37.759356,169.917101,61.748606,1,0
0,0,3,3,11,12,23,35,18,53,0.000333,0.079916,5,1198.743918,66.596884,239.748784,81.073298,2,0
0,0,2,2,9,10,19,26,14,40,0.000333,0.056639,4,679.668402,37.759356,169.917101,61.748606,1,0
0,0,2,2,9,10,19,26,14,40,0.000333,0.056639,4,679.668402,37.759356,169.917101,61.748606,1,0
0,0,2,2,9,10,19,26,14,40,0.000333,0.056639,4,679.668402,37.759356,169.917101,61.748606,1,0
0,0,3,3,9,9,18,63,34,97,0.000333,0.134828,12,4853.792702,269.65515,404.482725,57.05865,1,0
0,0,2,2,9,10,19,26,14,40,0.000333,0.056639,4,679.668402,37.759356,169.917101,61.748606,1,0
0,0,2,2,9,10,19,26,14,40,0.000333,0.056639,4,679.668402,37.759356,169.917101,61.748606,1,0
0,0,2,2,9,10,19,26,14,40,0.000333,0.056639,4,679.668402,37.759356,169.917101,61.748606,1,0
0,0,3,3,11,11,22,26,15,41,0.000333,0.060946,5,914.183482,50.787971,182.836696,76.107496,3,0
0,0,10,10,15,22,37,70,39,109,0.000333,0.189277,7,3974.812918,220.82294,567.830417,156.710855,6,0
0,0,5,5,11,13,24,36,21,57,0.000333,0.087114,5,1306.714313,72.59524,261.342863,86.159464,4,0
0,0,31,31,21,42,63,170,95,265,0.000333,0.527993,20,31679.5836,1759.976866,1583.97918,318.715998,12,0
0,0,2,2,7,4,11,13,5,18,0.000333,0.020757,3,186.809307,10.378295,62.269769,27.651484,3,0
0,0,5,5,11,13,24,36,21,57,0.000333,0.087114,5,1306.714313,72.59524,261.342863,86.159464,5,0
0,0,32,32,20,44,64,173,97,270,0.000333,0.54,20,32400,1800,1620,326.653553,13,0
0,0,2,2,7,4,11,13,5,18,0.000333,0.020757,3,186.809307,10.378295,62.269769,27.651484,3,0
0,0,5,5,12,12,24,58,26,84,0.000333,0.128379,12,4621.642201,256.7579,385.13685,86.0391,11,0
0,0,4,4,12,12,24,49,23,72,0.000333,0.110039,6,1980.7038,110.0391,330.1173,86.0391,10,0
0,0,27,27,19,35,54,148,78,226,0.000333,0.433535,18,23410.88236,1300.604575,1300.604575,260.235528,10,0
0,0,1,1,5,3,8,11,3,14,0.000333,0.014,2,84,4.666667,42,16.364528,2,0
0,0,4,4,10,7,17,25,11,36,0.000333,0.04905,5,735.743311,40.874628,147.148662,52.870765,2,0
0,0,5,5,9,9,18,27,16,43,0.000333,0.059769,4,717.2271,39.84595,179.306775,57.05865,1,0
0,0,2,2,9,10,19,26,14,40,0.000333,0.056639,4,679.668402,37.759356,169.917101,61.748606,1,0
0,0,5,5,13,101,114,424,267,691,0.000333,1.573842,12,56658.324,3147.684667,4721.527,720.585076,7,0
0,0,2,2,9,10,19,26,14,40,0.000333,0.056639,4,679.668402,37.759356,169.917101,61.748606,1,0
0,0,2,2,9,10,19,26,14,40,0.000333,0.056639,4,679.668402,37.759356,169.917101,61.748606,1,0
0,0,2,2,9,10,19,26,14,40,0.000333,0.056639,4,679.668402,37.759356,169.917101,61.748606,1,0
0,0,2,2,9,10,19,26,14,40,0.000333,0.056639,4,679.668402,37.759356,169.917101,61.748606,1,0
0,0,2,2,9,10,19,26,14,40,0.000333,0.056639,4,679.668402,37.759356,169.917101,61.748606,1,0
0,0,2,2,9,10,19,26,14,40,0.000333,0.056639,4,679.668402,37.759356,169.917101,61.748606,1,0
0,0,2,2,9,10,19,26,14,40,0.000333,0.056639,4,679.668402,37.759356,169.917101,61.748606,1,0
0,0,2,2,9,10,19,26,14,40,0.000333,0.056639,4,679.668402,37.759356,169.917101,61.748606,1,0
0,0,2,2,9,10,19,26,14,40,0.000333,0.056639,4,679.668402,37.759356,169.917101,61.748606,1,0
0,0,2,2,9,10,19,26,14,40,0.000333,0.056639,4,679.668402,37.759356,169.917101,61.748606,2,0
0,0,2,2,9,10,19,26,14,40,0.000333,0.056639,4,679.668402,37.759356,169.917101,61.748606,1,0
0,0,2,2,9,10,19,26,14,40,0.000333,0.056639,4,679.668402,37.759356,169.917101,61.748606,2,0
0,0,3,3,11,12,23,35,18,53,0.000333,0.079916,5,1198.743918,66.596884,239.748784,81.073298,2,0
0,0,10,10,9,14,23,123,66,189,0.000333,0.284984,16,13679.25136,759.958409,854.95321,81.832294,1,0
0,0,2,2,9,10,19,26,14,40,0.000333,0.056639,4,679.668402,37.759356,169.917101,61.748606,1,0
0,0,3,3,9,9,18,63,34,97,0.000333,0.134828,12,4853.792702,269.65515,404.482725,57.05865,1,0
0,0,2,2,9,10,19,26,14,40,0.000333,0.056639,4,679.668402,37.759356,169.917101,61.748606,1,0
0,0,4,4,10,13,23,67,37,104,0.000333,0.156817,10,4704.504434,261.361357,470.450443,81.324997,1,0
0,0,2,2,9,10,19,26,14,40,0.000333,0.056639,4,679.668402,37.759356,169.917101,61.748606,1,0
0,0,2,2,9,10,19,26,14,40,0.000333,0.056639,4,679.668402,37.759356,169.917101,61.748606,1,0
0,0,2,2,9,10,19,26,14,40,0.000333,0.056639,4,679.668402,37.759356,169.917101,61.748606,1,0
0,0,2,2,9,10,19,26,14,40,0.000333,0.056639,4,679.668402,37.759356,169.917101,61.748606,1,0
0,0,3,3,11,11,22,26,15,41,0.000333,0.060946,5,914.183482,50.787971,182.836696,76.107496,3,0
0,0,10,10,15,22,37,70,39,109,0.000333,0.189277,7,3974.812918,220.82294,567.830417,156.710855,6,0
0,0,7,7,11,10,21,36,17,53,0.000333,0.077598,5,1163.964117,64.664673,232.792823,71.273029,4,0
0,0,2,2,7,4,11,13,5,18,0.000333,0.020757,3,186.809307,10.378295,62.269769,27.651484,3,0
0,0,3,3,11,11,22,26,15,41,0.000333,0.060946,5,914.183482,50.787971,182.836696,76.107496,3,0
0,0,10,10,15,22,37,70,39,109,0.000333,0.189277,7,3974.812918,220.82294,567.830417,156.710855,6,0
0,0,13,13,21,25,46,84,45,129,0.000333,0.237513,10,7125.394923,395.855274,712.539492,208.335071,4,0
0,0,34,34,20,44,64,180,96,276,0.000333,0.552,20,33120,1840,1656,326.653553,11,0
0,0,6,6,10,9,19,22,23,45,0.000333,0.063719,10,1911.567381,106.198188,191.156738,61.748606,1,0
0,0,2,2,6,4,10,7,5,12,0.000333,0.013288,3,119.589411,6.643856,39.863137,23.509775,1,0
0,0,8,8,10,11,21,30,35,65,0.000333,0.095167,15,4282.509487,237.917194,285.500632,71.273029,1,0
0,0,5,5,11,13,24,36,21,57,0.000333,0.087114,5,1306.714313,72.59524,261.342863,86.159464,3,0
0,0,27,27,17,34,51,136,74,210,0.000333,0.39707,16,19059.34915,1058.852731,1191.209322,242.460605,10,0
0,0,5,5,12,12,24,58,26,84,0.000333,0.128379,12,4621.642201,256.7579,385.13685,86.0391,11,0
0,0,4,4,12,12,24,49,23,72,0.000333,0.110039,6,1980.7038,110.0391,330.1173,86.0391,10,0
0,0,1,1,5,3,8,11,3,14,0.000333,0.014,2,84,4.666667,42,16.364528,2,0
0,0,2,2,7,4,11,13,5,18,0.000333,0.020757,3,186.809307,10.378295,62.269769,27.651484,3,0
0,0,6,6,16,12,28,47,24,71,0.000333,0.113774,16,5461.155191,303.397511,341.322199,107.01955,4,0
0,0,2,2,9,10,19,26,14,40,0.000333,0.056639,4,679.668402,37.759356,169.917101,61.748606,1,0
0,0,2,2,9,10,19,26,14,40,0.000333,0.056639,4,679.668402,37.759356,169.917101,61.748606,1,0
0,0,2,2,9,10,19,26,14,40,0.000333,0.056639,4,679.668402,37.759356,169.917101,61.748606,1,0
0,0,2,2,9,10,19,26,14,40,0.000333,0.056639,4,679.668402,37.759356,169.917101,61.748606,1,0
0,0,2,2,9,10,19,26,14,40,0.000333,0.056639,4,679.668402,37.759356,169.917101,61.748606,1,0
0,0,2,2,9,10,19,26,14,40,0.000333,0.056639,4,679.668402,37.759356,169.917101,61.748606,1,0
0,0,5,5,13,101,114,424,267,691,0.000333,1.573842,12,56658.324,3147.684667,4721.527,720.585076,7,0
0,0,2,2,9,10,19,26,14,40,0.000333,0.056639,4,679.668402,37.759356,169.917101,61.748606,2,0
0,0,2,2,9,10,19,26,14,40,0.000333,0.056639,4,679.668402,37.759356,169.917101,61.748606,1,0
0,0,2,2,9,10,19,26,14,40,0.000333,0.056639,4,679.668402,37.759356,169.917101,61.748606,1,0
0,0,2,2,9,10,19,26,14,40,0.000333,0.056639,4,679.668402,37.759356,169.917101,61.748606,1,0
0,0,2,2,9,10,19,26,14,40,0.000333,0.056639,4,679.668402,37.759356,169.917101,61.748606,1,0
0,0,10,10,9,14,23,123,66,189,0.000333,0.284984,16,13679.25136,759.958409,854.95321,81.832294,1,0
0,0,2,2,9,10,19,26,14,40,0.000333,0.056639,4,679.668402,37.759356,169.917101,61.748606,1,0
0,0,4,4,10,13,23,67,37,104,0.000333,0.156817,10,4704.504434,261.361357,470.450443,81.324997,1,0
0,0,2,2,9,10,19,26,14,40,0.000333,0.056639,4,679.668402,37.759356,169.917101,61.748606,1,0
0,0,2,2,9,10,19,26,14,40,0.000333,0.056639,4,679.668402,37.759356,169.917101,61.748606,1,0
0,0,3,3,9,9,18,63,34,97,0.000333,0.134828,12,4853.792702,269.65515,404.482725,57.05865,1,0
0,0,2,2,9,10,19,26,14,40,0.000333,0.056639,4,679.668402,37.759356,169.917101,61.748606,1,0
0,0,2,2,9,10,19,26,14,40,0.000333,0.056639,4,679.668402,37.759356,169.917101,61.748606,2,0
0,0,3,3,11,12,23,35,18,53,0.000333,0.079916,5,1198.743918,66.596884,239.748784,81.073298,2,0
0,0,2,2,9,10,19,26,14,40,0.000333,0.056639,4,679.668402,37.759356,169.917101,61.748606,1,0
0,0,2,2,9,10,19,26,14,40,0.000333,0.056639,4,679.668402,37.759356,169.917101,61.748606,1,0
0,0,2,2,9,10,19,26,14,40,0.000333,0.056639,4,679.668402,37.759356,169.917101,61.748606,1,0
0,0,17,17,18,18,36,71,49,120,0.000333,0.206797,18,11167.038,620.391,620.391,150.1173,2,0
0,0,5,5,15,18,33,51,30,81,0.000333,0.136199,7,2860.171466,158.898415,408.595924,133.662009,3,0
0,0,2,2,7,4,11,13,5,18,0.000333,0.020757,3,186.809307,10.378295,62.269769,27.651484,3,0
0,0,2,2,7,4,11,13,5,18,0.000333,0.020757,3,186.809307,10.378295,62.269769,27.651484,3,0
0,0,28,28,19,38,57,157,84,241,0.000333,0.468575,18,25303.07688,1405.726493,1405.726493,280.131868,10,0
0,0,5,5,12,12,24,58,26,84,0.000333,0.128379,12,4621.642201,256.7579,385.13685,86.0391,11,0
0,0,18,18,14,30,44,118,62,180,0.000333,0.327566,14,13757.76768,764.320427,982.697691,200.509687,6,0
0,0,4,4,12,12,24,49,23,72,0.000333,0.110039,6,1980.7038,110.0391,330.1173,86.0391,10,0
0,0,1,1,5,3,8,11,3,14,0.000333,0.014,2,84,4.666667,42,16.364528,2,0
0,0,2,2,9,10,19,26,14,40,0.000333,0.056639,4,679.668402,37.759356,169.917101,61.748606,1,0
0,0,2,2,9,10,19,26,14,40,0.000333,0.056639,4,679.668402,37.759356,169.917101,61.748606,1,0
0,0,5,5,13,101,114,424,267,691,0.000333,1.573842,12,56658.324,3147.684667,4721.527,720.585076,7,0
0,0,10,10,9,14,23,123,66,189,0.000333,0.284984,16,13679.25136,759.958409,854.95321,81.832294,1,0
0,0,2,2,9,10,19,26,14,40,0.000333,0.056639,4,679.668402,37.759356,169.917101,61.748606,1,0
0,0,2,2,9,10,19,26,14,40,0.000333,0.056639,4,679.668402,37.759356,169.917101,61.748606,2,0
0,0,2,2,9,10,19,26,14,40,0.000333,0.056639,4,679.668402,37.759356,169.917101,61.748606,1,0
0,0,3,3,9,9,18,63,34,97,0.000333,0.134828,12,4853.792702,269.65515,404.482725,57.05865,1,0
0,0,2,2,9,10,19,26,14,40,0.000333,0.056639,4,679.668402,37.759356,169.917101,61.748606,1,0
0,0,2,2,9,10,19,26,14,40,0.000333,0.056639,4,679.668402,37.759356,169.917101,61.748606,1,0
0,0,2,2,9,10,19,26,14,40,0.000333,0.056639,4,679.668402,37.759356,169.917101,61.748606,1,0
0,0,2,2,9,10,19,26,14,40,0.000333,0.056639,4,679.668402,37.759356,169.917101,61.748606,1,0
0,0,2,2,9,10,19,26,14,40,0.000333,0.056639,4,679.668402,37.759356,169.917101,61.748606,1,0
0,0,2,2,9,10,19,26,14,40,0.000333,0.056639,4,679.668402,37.759356,169.917101,61.748606,1,0
0,0,3,3,11,12,23,35,18,53,0.000333,0.079916,5,1198.743918,66.596884,239.748784,81.073298,2,0
0,0,2,2,9,10,19,26,14,40,0.000333,0.056639,4,679.668402,37.759356,169.917101,61.748606,1,0
0,0,2,2,9,10,19,26,14,40,0.000333,0.056639,4,679.668402,37.759356,169.917101,61.748606,1,0
0,0,2,2,9,10,19,26,14,40,0.000333,0.056639,4,679.668402,37.759356,169.917101,61.748606,1,0
0,0,2,2,9,10,19,26,14,40,0.000333,0.056639,4,679.668402,37.759356,169.917101,61.748606,1,0
0,0,4,4,10,13,23,67,37,104,0.000333,0.156817,10,4704.504434,261.361357,470.450443,81.324997,1,0
0,0,2,2,9,10,19,26,14,40,0.000333,0.056639,4,679.668402,37.759356,169.917101,61.748606,1,0
0,0,2,2,9,10,19,26,14,40,0.000333,0.056639,4,679.668402,37.759356,169.917101,61.748606,2,0
0,0,2,2,9,10,19,26,14,40,0.000333,0.056639,4,679.668402,37.759356,169.917101,61.748606,1,0
0,0,2,2,9,10,19,26,14,40,0.000333,0.056639,4,679.668402,37.759356,169.917101,61.748606,1,0
0,0,5,5,11,13,24,36,21,57,0.000333,0.087114,5,1306.714313,72.59524,261.342863,86.159464,3,0
0,0,2,2,7,4,11,13,5,18,0.000333,0.020757,3,186.809307,10.378295,62.269769,27.651484,3,0
0,0,33,33,19,42,61,177,96,273,0.000333,0.539697,18,29143.64328,1619.091293,1619.091293,307.187955,11,0
0,0,3,3,9,6,15,18,8,26,0.000333,0.03386,4,406.316622,22.573146,101.579155,44.0391,2,0
0,0,32,32,19,39,58,180,99,279,0.000333,0.544792,18,29418.78056,1634.376698,1634.376698,286.841309,13,0
0,0,7,7,12,19,31,51,37,88,0.000333,0.145323,6,2615.815652,145.323092,435.969275,123.730173,5,0
0,0,2,2,8,8,16,11,10,21,0.000333,0.028,4,336,18.666667,84,48,1,0
0,0,21,21,20,26,46,105,64,169,0.000333,0.311161,20,18669.63941,1037.20219,933.481971,208.649995,8,0
0,0,28,28,19,43,62,152,82,234,0.000333,0.464427,9,12539.53743,696.640968,1393.281937,314.040007,11,0
0,0,5,5,10,20,30,58,36,94,0.000333,0.153749,5,2306.23858,128.124366,461.247716,119.657843,1,0
0,0,8,8,9,16,25,42,24,66,0.000333,0.102165,4,1225.978034,68.109891,306.494509,92.529325,3,0
0,0,2,2,7,6,13,12,8,20,0.000333,0.02467,3,222.026383,12.334799,74.008794,35.161259,1,0
0,0,2,2,7,7,14,13,9,22,0.000333,0.027921,3,251.285425,13.960301,83.761808,39.302969,1,0
0,0,3,3,8,7,15,18,10,28,0.000333,0.036464,4,437.571747,24.309541,109.392937,43.651484,1,0
0,0,7,7,12,19,31,51,37,88,0.000333,0.145323,6,2615.815652,145.323092,435.969275,123.730173,5,0
0,0,5,5,11,13,24,36,21,57,0.000333,0.087114,5,1306.714313,72.59524,261.342863,86.159464,3,0
0,0,26,26,18,38,56,140,76,216,0.000333,0.41813,18,22578.99594,1254.388663,1254.388663,274.479896,10,0
0,0,1,1,5,3,8,11,3,14,0.000333,0.014,2,84,4.666667,42,16.364528,2,0
0,0,5,5,12,12,24,58,26,84,0.000333,0.128379,12,4621.642201,256.7579,385.13685,86.0391,11,0
0,0,4,4,12,12,24,49,23,72,0.000333,0.110039,6,1980.7038,110.0391,330.1173,86.0391,10,0
0,0,2,2,7,4,11,13,5,18,0.000333,0.020757,3,186.809307,10.378295,62.269769,27.651484,3,0
0,0,2,2,9,10,19,26,14,40,0.000333,0.056639,4,679.668402,37.759356,169.917101,61.748606,1,0
0,0,4,4,10,13,23,67,37,104,0.000333,0.156817,10,4704.504434,261.361357,470.450443,81.324997,1,0
0,0,2,2,9,10,19,26,14,40,0.000333,0.056639,4,679.668402,37.759356,169.917101,61.748606,1,0
0,0,2,2,9,10,19,26,14,40,0.000333,0.056639,4,679.668402,37.759356,169.917101,61.748606,1,0
0,0,2,2,9,10,19,26,14,40,0.000333,0.056639,4,679.668402,37.759356,169.917101,61.748606,1,0
0,0,2,2,9,10,19,26,14,40,0.000333,0.056639,4,679.668402,37.759356,169.917101,61.748606,1,0
0,0,2,2,9,10,19,26,14,40,0.000333,0.056639,4,679.668402,37.759356,169.917101,61.748606,1,0
0,0,3,3,9,9,18,63,34,97,0.000333,0.134828,12,4853.792702,269.65515,404.482725,57.05865,1,0
0,0,2,2,9,10,19,26,14,40,0.000333,0.056639,4,679.668402,37.759356,169.917101,61.748606,1,0
0,0,2,2,9,10,19,26,14,40,0.000333,0.056639,4,679.668402,37.759356,169.917101,61.748606,1,0
0,0,3,3,11,12,23,35,18,53,0.000333,0.079916,5,1198.743918,66.596884,239.748784,81.073298,2,0
0,0,2,2,9,10,19,26,14,40,0.000333,0.056639,4,679.668402,37.759356,169.917101,61.748606,1,0
0,0,2,2,9,10,19,26,14,40,0.000333,0.056639,4,679.668402,37.759356,169.917101,61.748606,2,0
0,0,2,2,9,10,19,26,14,40,0.000333,0.056639,4,679.668402,37.759356,169.917101,61.748606,1,0
0,0,5,5,13,101,114,424,267,691,0.000333,1.573842,12,56658.324,3147.684667,4721.527,720.585076,7,0
0,0,2,2,9,10,19,26,14,40,0.000333,0.056639,4,679.668402,37.759356,169.917101,61.748606,1,0
0,0,2,2,9,10,19,26,14,40,0.000333,0.056639,4,679.668402,37.759356,169.917101,61.748606,1,0
0,0,2,2,9,10,19,26,14,40,0.000333,0.056639,4,679.668402,37.759356,169.917101,61.748606,1,0
0,0,2,2,9,10,19,26,14,40,0.000333,0.056639,4,679.668402,37.759356,169.917101,61.748606,1,0
0,0,2,2,9,10,19,26,14,40,0.000333,0.056639,4,679.668402,37.759356,169.917101,61.748606,1,0
0,0,2,2,9,10,19,26,14,40,0.000333,0.056639,4,679.668402,37.759356,169.917101,61.748606,1,0
0,0,2,2,9,10,19,26,14,40,0.000333,0.056639,4,679.668402,37.759356,169.917101,61.748606,2,0
0,0,15,15,13,23,36,101,58,159,0.000333,0.274006,12,9864.216903,548.01205,822.018075,152.147641,2,0
0,0,2,2,9,10,19,26,14,40,0.000333,0.056639,4,679.668402,37.759356,169.917101,61.748606,1,0
0,0,10,10,9,14,23,123,66,189,0.000333,0.284984,16,13679.25136,759.958409,854.95321,81.832294,1,0
0,0,1,1,5,3,8,11,3,14,0.000333,0.014,2,84,4.666667,42,16.364528,2,0
0,0,5,5,12,12,24,58,26,84,0.000333,0.128379,12,4621.642201,256.7579,385.13685,86.0391,11,0
0,0,2,2,7,4,11,13,5,18,0.000333,0.020757,3,186.809307,10.378295,62.269769,27.651484,3,0
0,0,4,4,12,12,24,49,23,72,0.000333,0.110039,6,1980.7038,110.0391,330.1173,86.0391,10,0
0,0,2,2,9,10,19,26,14,40,0.000333,0.056639,4,679.668402,37.759356,169.917101,61.748606,1,0
0,0,2,2,9,10,19,26,14,40,0.000333,0.056639,4,679.668402,37.759356,169.917101,61.748606,1,0
0,0,3,3,9,9,18,63,34,97,0.000333,0.134828,12,4853.792702,269.65515,404.482725,57.05865,1,0
0,0,2,2,9,10,19,26,14,40,0.000333,0.056639,4,679.668402,37.759356,169.917101,61.748606,1,0
0,0,2,2,9,10,19,26,14,40,0.000333,0.056639,4,679.668402,37.759356,169.917101,61.748606,1,0
0,0,2,2,9,10,19,26,14,40,0.000333,0.056639,4,679.668402,37.759356,169.917101,61.748606,1,0
0,0,2,2,9,10,19,26,14,40,0.000333,0.056639,4,679.668402,37.759356,169.917101,61.748606,1,0
0,0,2,2,9,10,19,26,14,40,0.000333,0.056639,4,679.668402,37.759356,169.917101,61.748606,1,0
0,0,3,3,11,12,23,35,18,53,0.000333,0.079916,5,1198.743918,66.596884,239.748784,81.073298,2,0
0,0,2,2,9,10,19,26,14,40,0.000333,0.056639,4,679.668402,37.759356,169.917101,61.748606,1,0
0,0,2,2,9,10,19,26,14,40,0.000333,0.056639,4,679.668402,37.759356,169.917101,61.748606,1,0
0,0,2,2,9,10,19,26,14,40,0.000333,0.056639,4,679.668402,37.759356,169.917101,61.748606,1,0
0,0,2,2,9,10,19,26,14,40,0.000333,0.056639,4,679.668402,37.759356,169.917101,61.748606,2,0
0,0,2,2,9,10,19,26,14,40,0.000333,0.056639,4,679.668402,37.759356,169.917101,61.748606,1,0
0,0,2,2,9,10,19,26,14,40,0.000333,0.056639,4,679.668402,37.759356,169.917101,61.748606,1,0
0,0,2,2,9,10,19,26,14,40,0.000333,0.056639,4,679.668402,37.759356,169.917101,61.748606,1,0
0,0,2,2,9,10,19,26,14,40,0.000333,0.056639,4,679.668402,37.759356,169.917101,61.748606,1,0
0,0,2,2,9,10,19,26,14,40,0.000333,0.056639,4,679.668402,37.759356,169.917101,61.748606,2,0
0,0,2,2,9,10,19,26,14,40,0.000333,0.056639,4,679.668402,37.759356,169.917101,61.748606,1,0
0,0,2,2,9,10,19,26,14,40,0.000333,0.056639,4,679.668402,37.759356,169.917101,61.748606,1,0
0,0,2,2,9,10,19,26,14,40,0.000333,0.056639,4,679.668402,37.759356,169.917101,61.748606,1,0
0,0,4,4,10,13,23,67,37,104,0.000333,0.156817,10,4704.504434,261.361357,470.450443,81.324997,1,0
0,0,10,10,9,14,23,123,66,189,0.000333,0.284984,16,13679.25136,759.958409,854.95321,81.832294,1,0
0,0,5,5,13,101,114,424,267,691,0.000333,1.573842,12,56658.324,3147.684667,4721.527,720.585076,7,0
0,0,5,5,9,9,18,22,14,36,0.000333,0.050039,4,600.4692,33.3594,150.1173,57.05865,3,0
0,0,17,17,16,23,39,110,55,165,0.000333,0.290697,16,13953.46186,775.192325,872.091366,168.041925,7,0
0,0,5,5,11,13,24,36,21,57,0.000333,0.087114,5,1306.714313,72.59524,261.342863,86.159464,3,0
0,0,17,17,16,23,39,110,55,165,0.000333,0.290697,16,13953.46186,775.192325,872.091366,168.041925,7,0
0,0,2,2,7,4,11,13,5,18,0.000333,0.020757,3,186.809307,10.378295,62.269769,27.651484,3,0
0,0,2,2,7,4,11,13,5,18,0.000333,0.020757,3,186.809307,10.378295,62.269769,27.651484,3,0
0,0,4,4,12,12,24,49,23,72,0.000333,0.110039,6,1980.7038,110.0391,330.1173,86.0391,10,0
0,0,1,1,5,3,8,11,3,14,0.000333,0.014,2,84,4.666667,42,16.364528,2,0
0,0,5,5,12,12,24,58,26,84,0.000333,0.128379,12,4621.642201,256.7579,385.13685,86.0391,11,0
0,0,17,17,16,23,39,110,55,165,0.000333,0.290697,16,13953.46186,775.192325,872.091366,168.041925,7,0
0,0,11,11,11,19,30,67,36,103,0.000333,0.16847,5,2527.048657,140.391592,505.409731,118.764371,4,0
0,0,2,2,9,10,19,26,14,40,0.000333,0.056639,4,679.668402,37.759356,169.917101,61.748606,1,0
0,0,10,10,9,14,23,123,66,189,0.000333,0.284984,16,13679.25136,759.958409,854.95321,81.832294,1,0
0,0,2,2,9,10,19,26,14,40,0.000333,0.056639,4,679.668402,37.759356,169.917101,61.748606,1,0
0,0,4,4,10,13,23,67,37,104,0.000333,0.156817,10,4704.504434,261.361357,470.450443,81.324997,1,0
0,0,2,2,9,10,19,26,14,40,0.000333,0.056639,4,679.668402,37.759356,169.917101,61.748606,1,0
0,0,2,2,9,10,19,26,14,40,0.000333,0.056639,4,679.668402,37.759356,169.917101,61.748606,1,0
0,0,2,2,9,10,19,26,14,40,0.000333,0.056639,4,679.668402,37.759356,169.917101,61.748606,1,0
0,0,2,2,9,10,19,26,14,40,0.000333,0.056639,4,679.668402,37.759356,169.917101,61.748606,1,0
0,0,3,3,11,12,23,35,18,53,0.000333,0.079916,5,1198.743918,66.596884,239.748784,81.073298,2,0
0,0,2,2,9,10,19,26,14,40,0.000333,0.056639,4,679.668402,37.759356,169.917101,61.748606,1,0
0,0,2,2,9,10,19,26,14,40,0.000333,0.056639,4,679.668402,37.759356,169.917101,61.748606,1,0
0,0,3,3,9,9,18,63,34,97,0.000333,0.134828,12,4853.792702,269.65515,404.482725,57.05865,1,0
0,0,2,2,9,10,19,26,14,40,0.000333,0.056639,4,679.668402,37.759356,169.917101,61.748606,1,0
0,0,2,2,9,10,19,26,14,40,0.000333,0.056639,4,679.668402,37.759356,169.917101,61.748606,1,0
0,0,2,2,9,10,19,26,14,40,0.000333,0.056639,4,679.668402,37.759356,169.917101,61.748606,1,0
0,0,2,2,9,10,19,26,14,40,0.000333,0.056639,4,679.668402,37.759356,169.917101,61.748606,1,0
0,0,2,2,9,10,19,26,14,40,0.000333,0.056639,4,679.668402,37.759356,169.917101,61.748606,2,0
0,0,2,2,9,10,19,26,14,40,0.000333,0.056639,4,679.668402,37.759356,169.917101,61.748606,1,0
0,0,2,2,9,10,19,26,14,40,0.000333,0.056639,4,679.668402,37.759356,169.917101,61.748606,2,0
0,0,5,5,13,101,114,424,267,691,0.000333,1.573842,12,56658.324,3147.684667,4721.527,720.585076,7,0
0,0,2,2,9,10,19,26,14,40,0.000333,0.056639,4,679.668402,37.759356,169.917101,61.748606,1,0
0,0,2,2,9,10,19,26,14,40,0.000333,0.056639,4,679.668402,37.759356,169.917101,61.748606,1,0
0,0,2,2,9,10,19,26,14,40,0.000333,0.056639,4,679.668402,37.759356,169.917101,61.748606,1,0
0,0,2,2,9,10,19,26,14,40,0.000333,0.056639,4,679.668402,37.759356,169.917101,61.748606,1,0
0,0,3,3,11,11,22,26,15,41,0.000333,0.060946,5,914.183482,50.787971,182.836696,76.107496,3,0
0,0,10,10,15,22,37,70,39,109,0.000333,0.189277,7,3974.812918,220.82294,567.830417,156.710855,6,0
0,0,8,8,11,11,22,36,23,59,0.000333,0.087702,10,2631.064655,146.170259,263.106465,76.107496,4,0
0,0,8,8,10,12,22,34,21,55,0.000333,0.081756,5,1226.343695,68.130205,245.268739,76.238831,4,0
0,0,13,13,13,19,32,62,34,96,0.000333,0.16,6,2880,160,480,128.816339,4,0
0,0,9,9,11,11,22,43,27,70,0.000333,0.104053,10,3121.602133,173.422341,312.160213,76.107496,4,0
0,0,9,9,10,11,21,42,27,69,0.000333,0.101023,10,3030.699022,168.372168,303.069902,71.273029,4,0
0,0,8,8,10,12,22,34,21,55,0.000333,0.081756,5,1226.343695,68.130205,245.268739,76.238831,4,0
0,0,2,2,7,4,11,13,5,18,0.000333,0.020757,3,186.809307,10.378295,62.269769,27.651484,3,0
0,0,1,1,5,3,8,11,3,14,0.000333,0.014,2,84,4.666667,42,16.364528,2,0
0,0,4,4,12,12,24,49,23,72,0.000333,0.110039,6,1980.7038,110.0391,330.1173,86.0391,10,0
0,0,28,28,19,37,56,153,80,233,0.000333,0.451038,18,24356.04654,1353.113697,1353.113697,273.460397,10,0
0,0,5,5,12,12,24,58,26,84,0.000333,0.128379,12,4621.642201,256.7579,385.13685,86.0391,11,0
0,0,18,18,13,27,40,108,54,162,0.000333,0.287384,12,10345.82822,574.768234,862.152351,176.487679,7,0
0,0,5,5,13,101,114,424,267,691,0.000333,1.573842,12,56658.324,3147.684667,4721.527,720.585076,7,0
0,0,2,2,9,10,19,26,14,40,0.000333,0.056639,4,679.668402,37.759356,169.917101,61.748606,1,0
0,0,3,3,9,9,18,63,34,97,0.000333,0.134828,12,4853.792702,269.65515,404.482725,57.05865,1,0
0,0,2,2,9,10,19,26,14,40,0.000333,0.056639,4,679.668402,37.759356,169.917101,61.748606,1,0
0,0,2,2,9,10,19,26,14,40,0.000333,0.056639,4,679.668402,37.759356,169.917101,61.748606,1,0
0,0,2,2,9,10,19,26,14,40,0.000333,0.056639,4,679.668402,37.759356,169.917101,61.748606,1,0
0,0,2,2,9,10,19,26,14,40,0.000333,0.056639,4,679.668402,37.759356,169.917101,61.748606,1,0
0,0,2,2,9,10,19,26,14,40,0.000333,0.056639,4,679.668402,37.759356,169.917101,61.748606,1,0
0,0,2,2,9,10,19,26,14,40,0.000333,0.056639,4,679.668402,37.759356,169.917101,61.748606,1,0
0,0,2,2,9,10,19,26,14,40,0.000333,0.056639,4,679.668402,37.759356,169.917101,61.748606,1,0
0,0,2,2,9,10,19,26,14,40,0.000333,0.056639,4,679.668402,37.759356,169.917101,61.748606,1,0
0,0,2,2,9,10,19,26,14,40,0.000333,0.056639,4,679.668402,37.759356,169.917101,61.748606,1,0
0,0,2,2,9,10,19,26,14,40,0.000333,0.056639,4,679.668402,37.759356,169.917101,61.748606,1,0
0,0,2,2,9,10,19,26,14,40,0.000333,0.056639,4,679.668402,37.759356,169.917101,61.748606,1,0
0,0,2,2,9,10,19,26,14,40,0.000333,0.056639,4,679.668402,37.759356,169.917101,61.748606,1,0
0,0,2,2,9,10,19,26,14,40,0.000333,0.056639,4,679.668402,37.759356,169.917101,61.748606,1,0
0,0,4,4,10,13,23,67,37,104,0.000333,0.156817,10,4704.504434,261.361357,470.450443,81.324997,1,0
0,0,2,2,9,10,19,26,14,40,0.000333,0.056639,4,679.668402,37.759356,169.917101,61.748606,2,0
0,0,10,10,9,14,23,123,66,189,0.000333,0.284984,16,13679.25136,759.958409,854.95321,81.832294,1,0
0,0,2,2,9,10,19,26,14,40,0.000333,0.056639,4,679.668402,37.759356,169.917101,61.748606,1,0
0,0,2,2,9,10,19,26,14,40,0.000333,0.056639,4,679.668402,37.759356,169.917101,61.748606,1,0
0,0,2,2,9,10,19,26,14,40,0.000333,0.056639,4,679.668402,37.759356,169.917101,61.748606,2,0
0,0,3,3,11,12,23,35,18,53,0.000333,0.079916,5,1198.743918,66.596884,239.748784,81.073298,2,0
0,0,2,2,9,10,19,26,14,40,0.000333,0.056639,4,679.668402,37.759356,169.917101,61.748606,1,0
0,0,1,1,5,3,8,11,3,14,0.000333,0.014,2,84,4.666667,42,16.364528,2,0
0,0,5,5,12,12,24,58,26,84,0.000333,0.128379,12,4621.642201,256.7579,385.13685,86.0391,11,0
0,0,4,4,12,12,24,49,23,72,0.000333,0.110039,6,1980.7038,110.0391,330.1173,86.0391,10,0
0,0,2,2,7,4,11,13,5,18,0.000333,0.020757,3,186.809307,10.378295,62.269769,27.651484,3,0
0,0,2,2,9,10,19,26,14,40,0.000333,0.056639,4,679.668402,37.759356,169.917101,61.748606,1,0
0,0,2,2,9,10,19,26,14,40,0.000333,0.056639,4,679.668402,37.759356,169.917101,61.748606,1,0
0,0,4,4,10,13,23,67,37,104,0.000333,0.156817,10,4704.504434,261.361357,470.450443,81.324997,1,0
0,0,2,2,9,10,19,26,14,40,0.000333,0.056639,4,679.668402,37.759356,169.917101,61.748606,1,0
0,0,2,2,9,10,19,26,14,40,0.000333,0.056639,4,679.668402,37.759356,169.917101,61.748606,2,0
0,0,3,3,9,9,18,63,34,97,0.000333,0.134828,12,4853.792702,269.65515,404.482725,57.05865,1,0
0,0,3,3,11,12,23,35,18,53,0.000333,0.079916,5,1198.743918,66.596884,239.748784,81.073298,2,0
0,0,2,2,9,10,19,26,14,40,0.000333,0.056639,4,679.668402,37.759356,169.917101,61.748606,1,0
0,0,2,2,9,10,19,26,14,40,0.000333,0.056639,4,679.668402,37.759356,169.917101,61.748606,1,0
0,0,2,2,9,10,19,26,14,40,0.000333,0.056639,4,679.668402,37.759356,169.917101,61.748606,1,0
0,0,2,2,9,10,19,26,14,40,0.000333,0.056639,4,679.668402,37.759356,169.917101,61.748606,1,0
0,0,2,2,9,10,19,26,14,40,0.000333,0.056639,4,679.668402,37.759356,169.917101,61.748606,2,0
0,0,5,5,13,101,114,424,267,691,0.000333,1.573842,12,56658.324,3147.684667,4721.527,720.585076,7,0
0,0,10,10,9,14,23,123,66,189,0.000333,0.284984,16,13679.25136,759.958409,854.95321,81.832294,1,0
0,0,2,2,9,10,19,26,14,40,0.000333,0.056639,4,679.668402,37.759356,169.917101,61.748606,1,0
0,0,2,2,9,10,19,26,14,40,0.000333,0.056639,4,679.668402,37.759356,169.917101,61.748606,1,0
0,0,2,2,9,10,19,26,14,40,0.000333,0.056639,4,679.668402,37.759356,169.917101,61.748606,1,0
0,0,2,2,9,10,19,26,14,40,0.000333,0.056639,4,679.668402,37.759356,169.917101,61.748606,1,0
0,0,2,2,9,10,19,26,14,40,0.000333,0.056639,4,679.668402,37.759356,169.917101,61.748606,1,0
0,0,2,2,9,10,19,26,14,40,0.000333,0.056639,4,679.668402,37.759356,169.917101,61.748606,1,0
0,0,2,2,9,10,19,26,14,40,0.000333,0.056639,4,679.668402,37.759356,169.917101,61.748606,1,0
0,0,2,2,9,10,19,26,14,40,0.000333,0.056639,4,679.668402,37.759356,169.917101,61.748606,1,0
0,0,2,2,9,10,19,26,14,40,0.000333,0.056639,4,679.668402,37.759356,169.917101,61.748606,1,0
0,0,2,2,9,10,19,26,14,40,0.000333,0.056639,4,679.668402,37.759356,169.917101,61.748606,1,0
0,0,12,12,8,19,27,73,45,118,0.000333,0.187026,8,4488.613802,249.367433,561.076725,104.710623,1,0
0,0,2,2,6,4,10,7,5,12,0.000333,0.013288,3,119.589411,6.643856,39.863137,23.509775,1,0
0,0,6,6,12,12,24,28,21,49,0.000333,0.074888,6,1347.978975,74.887721,224.663163,86.0391,2,0
0,0,3,3,11,11,22,26,15,41,0.000333,0.060946,5,914.183482,50.787971,182.836696,76.107496,3,0
0,0,10,10,15,22,37,70,39,109,0.000333,0.189277,7,3974.812918,220.82294,567.830417,156.710855,6,0
0,0,2,2,7,4,11,13,5,18,0.000333,0.020757,3,186.809307,10.378295,62.269769,27.651484,3,0
0,0,11,11,11,15,26,54,37,91,0.000333,0.14258,10,4277.400144,237.633341,427.740014,96.657107,1,0
0,0,8,8,13,22,35,48,33,81,0.000333,0.138491,6,2492.831546,138.490641,415.471924,146.213212,2,0
0,0,5,5,11,13,24,36,21,57,0.000333,0.087114,5,1306.714313,72.59524,261.342863,86.159464,3,0
0,0,2,2,7,4,11,13,5,18,0.000333,0.020757,3,186.809307,10.378295,62.269769,27.651484,3,0
0,0,17,17,16,23,39,110,55,165,0.000333,0.290697,16,13953.46186,775.192325,872.091366,168.041925,7,0
0,0,2,2,5,6,11,9,7,16,0.000333,0.01845,2,110.701812,6.150101,55.350906,27.119415,1,0
0,0,2,2,7,4,11,13,5,18,0.000333,0.020757,3,186.809307,10.378295,62.269769,27.651484,3,0
0,0,1,1,5,3,8,11,3,14,0.000333,0.014,2,84,4.666667,42,16.364528,2,0
0,0,5,5,12,12,24,58,26,84,0.000333,0.128379,12,4621.642201,256.7579,385.13685,86.0391,11,0
0,0,32,32,19,39,58,173,93,266,0.000333,0.519408,18,28048.01301,1558.222945,1558.222945,286.841309,11,0
0,0,18,18,14,28,42,109,55,164,0.000333,0.29478,7,6190.380401,343.910022,884.340057,187.908907,7,0
0,0,4,4,12,12,24,49,23,72,0.000333,0.110039,6,1980.7038,110.0391,330.1173,86.0391,10,0
0,0,2,2,9,10,19,26,14,40,0.000333,0.056639,4,679.668402,37.759356,169.917101,61.748606,1,0
0,0,2,2,9,10,19,26,14,40,0.000333,0.056639,4,679.668402,37.759356,169.917101,61.748606,1,0
0,0,5,5,13,101,114,424,267,691,0.000333,1.573842,12,56658.324,3147.684667,4721.527,720.585076,7,0
0,0,10,10,9,14,23,123,66,189,0.000333,0.284984,16,13679.25136,759.958409,854.95321,81.832294,1,0
0,0,2,2,9,10,19,26,14,40,0.000333,0.056639,4,679.668402,37.759356,169.917101,61.748606,1,0
0,0,2,2,9,10,19,26,14,40,0.000333,0.056639,4,679.668402,37.759356,169.917101,61.748606,2,0
0,0,2,2,9,10,19,26,14,40,0.000333,0.056639,4,679.668402,37.759356,169.917101,61.748606,1,0
0,0,3,3,9,9,18,63,34,97,0.000333,0.134828,12,4853.792702,269.65515,404.482725,57.05865,1,0
0,0,2,2,9,10,19,26,14,40,0.000333,0.056639,4,679.668402,37.759356,169.917101,61.748606,1,0
0,0,2,2,9,10,19,26,14,40,0.000333,0.056639,4,679.668402,37.759356,169.917101,61.748606,1,0
0,0,2,2,9,10,19,26,14,40,0.000333,0.056639,4,679.668402,37.759356,169.917101,61.748606,1,0
0,0,2,2,9,10,19,26,14,40,0.000333,0.056639,4,679.668402,37.759356,169.917101,61.748606,1,0
0,0,2,2,9,10,19,26,14,40,0.000333,0.056639,4,679.668402,37.759356,169.917101,61.748606,1,0
0,0,2,2,9,10,19,26,14,40,0.000333,0.056639,4,679.668402,37.759356,169.917101,61.748606,1,0
0,0,3,3,11,12,23,35,18,53,0.000333,0.079916,5,1198.743918,66.596884,239.748784,81.073298,2,0
0,0,2,2,9,10,19,26,14,40,0.000333,0.056639,4,679.668402,37.759356,169.917101,61.748606,1,0
0,0,2,2,9,10,19,26,14,40,0.000333,0.056639,4,679.668402,37.759356,169.917101,61.748606,1,0
0,0,2,2,9,10,19,26,14,40,0.000333,0.056639,4,679.668402,37.759356,169.917101,61.748606,1,0
0,0,2,2,9,10,19,26,14,40,0.000333,0.056639,4,679.668402,37.759356,169.917101,61.748606,1,0
0,0,4,4,10,13,23,67,37,104,0.000333,0.156817,10,4704.504434,261.361357,470.450443,81.324997,1,0
0,0,2,2,9,10,19,26,14,40,0.000333,0.056639,4,679.668402,37.759356,169.917101,61.748606,1,0
0,0,2,2,9,10,19,26,14,40,0.000333,0.056639,4,679.668402,37.759356,169.917101,61.748606,2,0
0,0,2,2,9,10,19,26,14,40,0.000333,0.056639,4,679.668402,37.759356,169.917101,61.748606,1,0
0,0,2,2,9,10,19,26,14,40,0.000333,0.056639,4,679.668402,37.759356,169.917101,61.748606,1,0
0,0,5,5,11,13,24,36,21,57,0.000333,0.087114,5,1306.714313,72.59524,261.342863,86.159464,3,0
0,0,2,2,7,4,11,13,5,18,0.000333,0.020757,3,186.809307,10.378295,62.269769,27.651484,3,0
0,0,31,31,20,47,67,174,92,266,0.000333,0.53786,10,16135.79725,896.43318,1613.579725,347.504238,11,0
0,0,5,5,10,20,30,58,36,94,0.000333,0.153749,5,2306.23858,128.124366,461.247716,119.657843,1,0
0,0,3,3,11,11,22,26,15,41,0.000333,0.060946,5,914.183482,50.787971,182.836696,76.107496,3,0
0,0,10,10,15,22,37,70,39,109,0.000333,0.189277,7,3974.812918,220.82294,567.830417,156.710855,6,0
0,0,17,17,16,23,39,110,55,165,0.000333,0.290697,16,13953.46186,775.192325,872.091366,168.041925,7,0
0,0,2,2,7,4,11,13,5,18,0.000333,0.020757,3,186.809307,10.378295,62.269769,27.651484,3,0
0,0,18,18,13,28,41,98,54,152,0.000333,0.271449,6,4886.087428,271.449302,814.347905,182.711654,7,0
0,0,24,24,12,39,51,146,86,232,0.000333,0.438668,12,15792.03215,877.33512,1316.002679,249.150237,3,0
0,0,2,2,7,4,11,13,5,18,0.000333,0.020757,3,186.809307,10.378295,62.269769,27.651484,3,0
0,0,36,36,16,44,60,221,109,330,0.000333,0.649758,16,31188.38235,1732.687908,1949.273897,304.214991,14,0
0,0,2,2,8,8,16,22,11,33,0.000333,0.044,4,528,29.333333,132,48,1,0
0,0,31,31,18,41,59,157,88,245,0.000333,0.480416,18,25942.45585,1441.247547,1441.247547,294.718282,12,0
0,0,2,2,7,4,11,13,5,18,0.000333,0.020757,3,186.809307,10.378295,62.269769,27.651484,3,0
0,0,28,28,15,36,51,222,88,310,0.000333,0.586151,14,24618.32598,1367.684777,1758.451856,244.720659,13,0
0,0,26,26,17,35,52,140,73,213,0.000333,0.404731,16,19427.09856,1079.283253,1214.19366,249.011774,10,0
0,0,5,5,11,13,24,36,21,57,0.000333,0.087114,5,1306.714313,72.59524,261.342863,86.159464,3,0
0,0,31,31,19,37,56,164,86,250,0.000333,0.483946,18,26133.09715,1451.838731,1451.838731,273.460397,11,0
0,0,2,2,7,4,11,13,5,18,0.000333,0.020757,3,186.809307,10.378295,62.269769,27.651484,3,0
0,0,20,20,26,34,60,342,224,566,0.000333,1.114433,78,260777.406,14487.63367,3343.300077,295.185169,19,0
0,0,36,36,27,63,90,505,342,847,0.000333,1.832867,65,357408.9722,19856.05401,5498.599573,504.950598,10,0
0,0,22,22,27,38,65,305,199,504,0.000333,1.011758,65,197292.7696,10960.70942,3035.273378,327.803208,10,0
0,0,71,71,28,80,108,719,493,1212,0.000333,2.728975,84,687701.5868,38205.64371,8186.923653,640.360185,10,0
0,0,35,35,27,62,89,493,333,826,0.000333,1.782985,65,347682.1279,19315.67377,5348.955814,497.542134,10,0
0,0,19,19,27,38,65,275,184,459,0.000333,0.921422,52,143741.875,7985.65972,2764.266826,327.803208,10,0
0,0,28,28,27,53,80,417,277,694,0.000333,1.462473,65,285182.1764,15843.45424,4387.418098,431.961747,10,0
0,0,39,39,16,34,50,282,159,441,0.000333,0.829647,32,79646.09855,4424.783253,2488.94058,236.973737,9,0
0,0,9,9,22,17,39,295,185,480,0.000333,0.845664,110,279069.2372,15503.84651,2536.993065,167.594364,37,0
0,0,3,3,10,17,27,36,24,60,0.000333,0.095098,5,1426.466251,79.248125,285.29325,102.706149,4,0
0,0,4,4,15,18,33,51,32,83,0.000333,0.139562,7,2930.792983,162.821832,418.684712,133.662009,1,0
0,0,29,29,27,49,76,449,300,749,0.000333,1.559899,78,365016.4212,20278.69007,4679.697708,403.502745,10,0
0,0,22,22,27,35,62,283,184,467,0.000333,0.92687,65,180739.629,10041.0905,2780.609677,307.906868,10,0
0,0,27,27,27,50,77,424,291,715,0.000333,1.493584,65,291248.9045,16180.49469,4480.752377,410.574772,10,0
0,0,15,15,17,37,54,135,91,226,0.000333,0.433535,16,20809.67321,1156.092956,1300.604575,262.236643,9,0
0,0,31,31,27,41,68,398,256,654,0.000333,1.327067,78,310533.6545,17251.86969,3981.200698,348.041595,10,0
0,0,2,2,8,8,16,22,11,33,0.000333,0.044,4,528,29.333333,132,48,1,0
0,0,17,17,14,27,41,90,50,140,0.000333,0.250019,7,5250.400965,291.688942,750.057281,181.684931,5,0
0,0,17,17,16,23,39,110,55,165,0.000333,0.290697,16,13953.46186,775.192325,872.091366,168.041925,7,0
0,0,2,2,7,4,11,13,5,18,0.000333,0.020757,3,186.809307,10.378295,62.269769,27.651484,3,0
0,0,3,3,11,11,22,26,15,41,0.000333,0.060946,5,914.183482,50.787971,182.836696,76.107496,3,0
0,0,10,10,15,22,37,70,39,109,0.000333,0.189277,7,3974.812918,220.82294,567.830417,156.710855,6,0
0,0,2,2,10,6,16,21,8,29,0.000333,0.038667,5,580,32.222222,116,48.729056,2,0
0,0,9,9,12,12,24,52,31,83,0.000333,0.126851,12,4566.622651,253.701258,380.551888,86.0391,4,0
0,0,8,8,13,12,25,43,26,69,0.000333,0.106809,12,3845.112925,213.617385,320.426077,91.125266,4,0
0,0,9,9,13,12,25,53,31,84,0.000333,0.130028,12,4681.007039,260.055947,390.08392,91.125266,4,0
0,0,1,1,10,13,23,26,13,39,0.000333,0.058806,5,882.094581,49.005255,176.418916,81.324997,1,0
0,0,8,8,12,12,24,42,26,68,0.000333,0.103926,12,3741.329401,207.851633,311.77745,86.0391,4,0
0,0,8,8,12,13,25,41,24,65,0.000333,0.100617,6,1811.103914,100.616884,301.850652,91.125266,4,0
0,0,1,1,10,13,23,26,13,39,0.000333,0.058806,5,882.094581,49.005255,176.418916,81.324997,1,0
0,0,1,1,10,13,23,26,13,39,0.000333,0.058806,5,882.094581,49.005255,176.418916,81.324997,1,0
0,0,1,1,10,13,23,26,13,39,0.000333,0.058806,5,882.094581,49.005255,176.418916,81.324997,1,0
0,0,1,1,10,13,23,26,13,39,0.000333,0.058806,5,882.094581,49.005255,176.418916,81.324997,1,0
0,0,8,8,12,13,25,41,24,65,0.000333,0.100617,6,1811.103914,100.616884,301.850652,91.125266,4,0
0,0,2,2,7,4,11,13,5,18,0.000333,0.020757,3,186.809307,10.378295,62.269769,27.651484,3,0
0,0,6,6,12,10,22,31,17,48,0.000333,0.071351,6,1284.316306,71.350906,214.052718,76.238831,2,0
0,0,27,27,19,35,54,145,76,221,0.000333,0.423943,18,22892.94248,1271.830138,1271.830138,260.235528,10,0
0,0,4,4,10,10,20,28,16,44,0.000333,0.063388,5,950.824181,52.823566,190.164836,66.438562,1,0
0,0,22,22,17,34,51,128,68,196,0.000333,0.370598,16,17788.72587,988.262548,1111.795367,242.460605,8,0
0,0,2,2,7,4,11,13,5,18,0.000333,0.020757,3,186.809307,10.378295,62.269769,27.651484,3,0
0,0,22,22,13,31,44,135,71,206,0.000333,0.374881,12,13495.71496,749.761942,1124.642913,201.685802,7,0
0,0,5,5,11,13,24,36,21,57,0.000333,0.087114,5,1306.714313,72.59524,261.342863,86.159464,3,0
0,0,28,28,19,39,58,166,85,251,0.000333,0.490118,18,26466.35814,1470.35323,1470.35323,286.841309,10,0
0,0,2,2,7,4,11,13,5,18,0.000333,0.020757,3,186.809307,10.378295,62.269769,27.651484,3,0
0,0,1,1,5,3,8,11,3,14,0.000333,0.014,2,84,4.666667,42,16.364528,2,0
0,0,5,5,12,12,24,58,26,84,0.000333,0.128379,12,4621.642201,256.7579,385.13685,86.0391,11,0
0,0,2,2,7,4,11,13,5,18,0.000333,0.020757,3,186.809307,10.378295,62.269769,27.651484,3,0
0,0,4,4,12,12,24,49,23,72,0.000333,0.110039,6,1980.7038,110.0391,330.1173,86.0391,10,0
0,0,2,2,9,10,19,26,14,40,0.000333,0.056639,4,679.668402,37.759356,169.917101,61.748606,1,0
0,0,2,2,9,10,19,26,14,40,0.000333,0.056639,4,679.668402,37.759356,169.917101,61.748606,1,0
0,0,3,3,9,9,18,63,34,97,0.000333,0.134828,12,4853.792702,269.65515,404.482725,57.05865,1,0
0,0,2,2,9,10,19,26,14,40,0.000333,0.056639,4,679.668402,37.759356,169.917101,61.748606,1,0
0,0,2,2,9,10,19,26,14,40,0.000333,0.056639,4,679.668402,37.759356,169.917101,61.748606,1,0
0,0,2,2,9,10,19,26,14,40,0.000333,0.056639,4,679.668402,37.759356,169.917101,61.748606,1,0
0,0,2,2,9,10,19,26,14,40,0.000333,0.056639,4,679.668402,37.759356,169.917101,61.748606,1,0
0,0,2,2,9,10,19,26,14,40,0.000333,0.056639,4,679.668402,37.759356,169.917101,61.748606,1,0
0,0,3,3,11,12,23,35,18,53,0.000333,0.079916,5,1198.743918,66.596884,239.748784,81.073298,2,0
0,0,2,2,9,10,19,26,14,40,0.000333,0.056639,4,679.668402,37.759356,169.917101,61.748606,1,0
0,0,2,2,9,10,19,26,14,40,0.000333,0.056639,4,679.668402,37.759356,169.917101,61.748606,1,0
0,0,2,2,9,10,19,26,14,40,0.000333,0.056639,4,679.668402,37.759356,169.917101,61.748606,1,0
0,0,2,2,9,10,19,26,14,40,0.000333,0.056639,4,679.668402,37.759356,169.917101,61.748606,2,0
0,0,2,2,9,10,19,26,14,40,0.000333,0.056639,4,679.668402,37.759356,169.917101,61.748606,1,0
0,0,2,2,9,10,19,26,14,40,0.000333,0.056639,4,679.668402,37.759356,169.917101,61.748606,1,0
0,0,2,2,9,10,19,26,14,40,0.000333,0.056639,4,679.668402,37.759356,169.917101,61.748606,1,0
0,0,2,2,9,10,19,26,14,40,0.000333,0.056639,4,679.668402,37.759356,169.917101,61.748606,1,0
0,0,2,2,9,10,19,26,14,40,0.000333,0.056639,4,679.668402,37.759356,169.917101,61.748606,2,0
0,0,2,2,9,10,19,26,14,40,0.000333,0.056639,4,679.668402,37.759356,169.917101,61.748606,1,0
0,0,2,2,9,10,19,26,14,40,0.000333,0.056639,4,679.668402,37.759356,169.917101,61.748606,1,0
0,0,2,2,9,10,19,26,14,40,0.000333,0.056639,4,679.668402,37.759356,169.917101,61.748606,1,0
0,0,4,4,10,13,23,67,37,104,0.000333,0.156817,10,4704.504434,261.361357,470.450443,81.324997,1,0
0,0,10,10,9,14,23,123,66,189,0.000333,0.284984,16,13679.25136,759.958409,854.95321,81.832294,1,0
0,0,5,5,13,101,114,424,267,691,0.000333,1.573842,12,56658.324,3147.684667,4721.527,720.585076,7,0
0,0,5,5,11,13,24,36,21,57,0.000333,0.087114,5,1306.714313,72.59524,261.342863,86.159464,3,0
0,0,5,5,12,12,24,58,26,84,0.000333,0.128379,12,4621.642201,256.7579,385.13685,86.0391,11,0
0,0,28,28,19,38,57,154,81,235,0.000333,0.45691,18,24673.12476,1370.729153,1370.729153,280.131868,10,0
0,0,4,4,12,12,24,49,23,72,0.000333,0.110039,6,1980.7038,110.0391,330.1173,86.0391,10,0
0,0,2,2,7,4,11,13,5,18,0.000333,0.020757,3,186.809307,10.378295,62.269769,27.651484,3,0
0,0,1,1,5,3,8,11,3,14,0.000333,0.014,2,84,4.666667,42,16.364528,2,0
0,0,15,15,14,22,36,91,55,146,0.000333,0.251603,14,10567.3267,587.073706,754.80905,151.410465,2,0
0,0,5,5,13,101,114,424,267,691,0.000333,1.573842,12,56658.324,3147.684667,4721.527,720.585076,7,0
0,0,2,2,9,10,19,26,14,40,0.000333,0.056639,4,679.668402,37.759356,169.917101,61.748606,1,0
0,0,3,3,9,9,18,63,34,97,0.000333,0.134828,12,4853.792702,269.65515,404.482725,57.05865,1,0
0,0,2,2,9,10,19,26,14,40,0.000333,0.056639,4,679.668402,37.759356,169.917101,61.748606,1,0
0,0,2,2,9,10,19,26,14,40,0.000333,0.056639,4,679.668402,37.759356,169.917101,61.748606,1,0
0,0,2,2,9,10,19,26,14,40,0.000333,0.056639,4,679.668402,37.759356,169.917101,61.748606,1,0
0,0,2,2,9,10,19,26,14,40,0.000333,0.056639,4,679.668402,37.759356,169.917101,61.748606,1,0
0,0,2,2,9,10,19,26,14,40,0.000333,0.056639,4,679.668402,37.759356,169.917101,61.748606,1,0
0,0,2,2,9,10,19,26,14,40,0.000333,0.056639,4,679.668402,37.759356,169.917101,61.748606,1,0
0,0,2,2,9,10,19,26,14,40,0.000333,0.056639,4,679.668402,37.759356,169.917101,61.748606,1,0
0,0,2,2,9,10,19,26,14,40,0.000333,0.056639,4,679.668402,37.759356,169.917101,61.748606,1,0
0,0,2,2,9,10,19,26,14,40,0.000333,0.056639,4,679.668402,37.759356,169.917101,61.748606,1,0
0,0,2,2,9,10,19,26,14,40,0.000333,0.056639,4,679.668402,37.759356,169.917101,61.748606,1,0
0,0,2,2,9,10,19,26,14,40,0.000333,0.056639,4,679.668402,37.759356,169.917101,61.748606,1,0
0,0,2,2,9,10,19,26,14,40,0.000333,0.056639,4,679.668402,37.759356,169.917101,61.748606,1,0
0,0,2,2,9,10,19,26,14,40,0.000333,0.056639,4,679.668402,37.759356,169.917101,61.748606,1,0
0,0,4,4,10,13,23,67,37,104,0.000333,0.156817,10,4704.504434,261.361357,470.450443,81.324997,1,0
0,0,2,2,9,10,19,26,14,40,0.000333,0.056639,4,679.668402,37.759356,169.917101,61.748606,2,0
0,0,10,10,9,14,23,123,66,189,0.000333,0.284984,16,13679.25136,759.958409,854.95321,81.832294,1,0
0,0,2,2,9,10,19,26,14,40,0.000333,0.056639,4,679.668402,37.759356,169.917101,61.748606,1,0
0,0,2,2,9,10,19,26,14,40,0.000333,0.056639,4,679.668402,37.759356,169.917101,61.748606,1,0
0,0,2,2,9,10,19,26,14,40,0.000333,0.056639,4,679.668402,37.759356,169.917101,61.748606,2,0
0,0,3,3,11,12,23,35,18,53,0.000333,0.079916,5,1198.743918,66.596884,239.748784,81.073298,2,0
0,0,2,2,9,10,19,26,14,40,0.000333,0.056639,4,679.668402,37.759356,169.917101,61.748606,1,0
0,0,5,5,12,12,24,58,26,84,0.000333,0.128379,12,4621.642201,256.7579,385.13685,86.0391,11,0
0,0,4,4,12,12,24,49,23,72,0.000333,0.110039,6,1980.7038,110.0391,330.1173,86.0391,10,0
0,0,2,2,7,4,11,13,5,18,0.000333,0.020757,3,186.809307,10.378295,62.269769,27.651484,3,0
0,0,1,1,5,3,8,11,3,14,0.000333,0.014,2,84,4.666667,42,16.364528,2,0
0,0,2,2,9,10,19,26,14,40,0.000333,0.056639,4,679.668402,37.759356,169.917101,61.748606,1,0
0,0,2,2,9,10,19,26,14,40,0.000333,0.056639,4,679.668402,37.759356,169.917101,61.748606,1,0
0,0,3,3,9,9,18,63,34,97,0.000333,0.134828,12,4853.792702,269.65515,404.482725,57.05865,1,0
0,0,2,2,9,10,19,26,14,40,0.000333,0.056639,4,679.668402,37.759356,169.917101,61.748606,1,0
0,0,2,2,9,10,19,26,14,40,0.000333,0.056639,4,679.668402,37.759356,169.917101,61.748606,1,0
0,0,10,10,9,14,23,123,66,189,0.000333,0.284984,16,13679.25136,759.958409,854.95321,81.832294,1,0
0,0,2,2,9,10,19,26,14,40,0.000333,0.056639,4,679.668402,37.759356,169.917101,61.748606,1,0
0,0,2,2,9,10,19,26,14,40,0.000333,0.056639,4,679.668402,37.759356,169.917101,61.748606,1,0
0,0,2,2,9,10,19,26,14,40,0.000333,0.056639,4,679.668402,37.759356,169.917101,61.748606,1,0
0,0,2,2,9,10,19,26,14,40,0.000333,0.056639,4,679.668402,37.759356,169.917101,61.748606,1,0
0,0,5,5,13,101,114,424,267,691,0.000333,1.573842,12,56658.324,3147.684667,4721.527,720.585076,7,0
0,0,2,2,9,10,19,26,14,40,0.000333,0.056639,4,679.668402,37.759356,169.917101,61.748606,1,0
0,0,2,2,9,10,19,26,14,40,0.000333,0.056639,4,679.668402,37.759356,169.917101,61.748606,2,0
0,0,3,3,11,12,23,35,18,53,0.000333,0.079916,5,1198.743918,66.596884,239.748784,81.073298,2,0
0,0,2,2,9,10,19,26,14,40,0.000333,0.056639,4,679.668402,37.759356,169.917101,61.748606,1,0
0,0,2,2,9,10,19,26,14,40,0.000333,0.056639,4,679.668402,37.759356,169.917101,61.748606,2,0
0,0,2,2,9,10,19,26,14,40,0.000333,0.056639,4,679.668402,37.759356,169.917101,61.748606,1,0
0,0,2,2,9,10,19,26,14,40,0.000333,0.056639,4,679.668402,37.759356,169.917101,61.748606,1,0
0,0,2,2,9,10,19,26,14,40,0.000333,0.056639,4,679.668402,37.759356,169.917101,61.748606,1,0
0,0,2,2,9,10,19,26,14,40,0.000333,0.056639,4,679.668402,37.759356,169.917101,61.748606,1,0
0,0,4,4,10,13,23,67,37,104,0.000333,0.156817,10,4704.504434,261.361357,470.450443,81.324997,1,0
0,0,2,2,9,10,19,26,14,40,0.000333,0.056639,4,679.668402,37.759356,169.917101,61.748606,1,0
0,0,2,2,9,10,19,26,14,40,0.000333,0.056639,4,679.668402,37.759356,169.917101,61.748606,1,0
0,0,2,2,9,10,19,26,14,40,0.000333,0.056639,4,679.668402,37.759356,169.917101,61.748606,1,0
0,0,2,2,7,4,11,13,5,18,0.000333,0.020757,3,186.809307,10.378295,62.269769,27.651484,3,0
0,0,1,1,5,3,8,11,3,14,0.000333,0.014,2,84,4.666667,42,16.364528,2,0
0,0,5,5,12,12,24,58,26,84,0.000333,0.128379,12,4621.642201,256.7579,385.13685,86.0391,11,0
0,0,31,31,19,36,55,163,85,248,0.000333,0.477926,18,25807.98976,1433.777209,1433.777209,266.827923,11,0
0,0,18,18,15,27,42,115,55,170,0.000333,0.305565,14,12833.71547,712.984193,916.693962,186.985321,7,0
0,0,4,4,12,12,24,49,23,72,0.000333,0.110039,6,1980.7038,110.0391,330.1173,86.0391,10,0
0,0,2,2,9,10,19,26,14,40,0.000333,0.056639,4,679.668402,37.759356,169.917101,61.748606,2,0
0,0,2,2,9,10,19,26,14,40,0.000333,0.056639,4,679.668402,37.759356,169.917101,61.748606,1,0
0,0,2,2,9,10,19,26,14,40,0.000333,0.056639,4,679.668402,37.759356,169.917101,61.748606,1,0
0,0,3,3,11,12,23,35,18,53,0.000333,0.079916,5,1198.743918,66.596884,239.748784,81.073298,2,0
0,0,2,2,9,10,19,26,14,40,0.000333,0.056639,4,679.668402,37.759356,169.917101,61.748606,1,0
0,0,4,4,10,13,23,67,37,104,0.000333,0.156817,10,4704.504434,261.361357,470.450443,81.324997,1,0
0,0,10,10,9,14,23,123,66,189,0.000333,0.284984,16,13679.25136,759.958409,854.95321,81.832294,1,0
0,0,2,2,9,10,19,26,14,40,0.000333,0.056639,4,679.668402,37.759356,169.917101,61.748606,1,0
0,0,2,2,9,10,19,26,14,40,0.000333,0.056639,4,679.668402,37.759356,169.917101,61.748606,1,0
0,0,2,2,9,10,19,26,14,40,0.000333,0.056639,4,679.668402,37.759356,169.917101,61.748606,1,0
0,0,2,2,9,10,19,26,14,40,0.000333,0.056639,4,679.668402,37.759356,169.917101,61.748606,1,0
0,0,2,2,9,10,19,26,14,40,0.000333,0.056639,4,679.668402,37.759356,169.917101,61.748606,1,0
0,0,2,2,9,10,19,26,14,40,0.000333,0.056639,4,679.668402,37.759356,169.917101,61.748606,1,0
0,0,2,2,9,10,19,26,14,40,0.000333,0.056639,4,679.668402,37.759356,169.917101,61.748606,1,0
0,0,2,2,9,10,19,26,14,40,0.000333,0.056639,4,679.668402,37.759356,169.917101,61.748606,2,0
0,0,2,2,9,10,19,26,14,40,0.000333,0.056639,4,679.668402,37.759356,169.917101,61.748606,1,0
0,0,5,5,13,101,114,424,267,691,0.000333,1.573842,12,56658.324,3147.684667,4721.527,720.585076,7,0
0,0,2,2,9,10,19,26,14,40,0.000333,0.056639,4,679.668402,37.759356,169.917101,61.748606,1,0
0,0,3,3,9,9,18,63,34,97,0.000333,0.134828,12,4853.792702,269.65515,404.482725,57.05865,1,0
0,0,2,2,9,10,19,26,14,40,0.000333,0.056639,4,679.668402,37.759356,169.917101,61.748606,1,0
0,0,2,2,9,10,19,26,14,40,0.000333,0.056639,4,679.668402,37.759356,169.917101,61.748606,1,0
0,0,2,2,9,10,19,26,14,40,0.000333,0.056639,4,679.668402,37.759356,169.917101,61.748606,1,0
0,0,2,2,9,10,19,26,14,40,0.000333,0.056639,4,679.668402,37.759356,169.917101,61.748606,1,0
0,0,2,2,9,10,19,26,14,40,0.000333,0.056639,4,679.668402,37.759356,169.917101,61.748606,1,0
0,0,2,2,7,4,11,13,5,18,0.000333,0.020757,3,186.809307,10.378295,62.269769,27.651484,3,0
0,0,1,1,5,3,8,11,3,14,0.000333,0.014,2,84,4.666667,42,16.364528,2,0
0,0,4,4,12,12,24,49,23,72,0.000333,0.110039,6,1980.7038,110.0391,330.1173,86.0391,10,0
0,0,28,28,19,37,56,150,78,228,0.000333,0.441359,18,23833.3846,1324.076922,1324.076922,273.460397,10,0
0,0,5,5,12,12,24,58,26,84,0.000333,0.128379,12,4621.642201,256.7579,385.13685,86.0391,11,0
0,0,18,18,13,27,40,109,54,163,0.000333,0.289158,12,10409.69135,578.316186,867.474279,176.487679,7,0
0,0,5,5,13,101,114,424,267,691,0.000333,1.573842,12,56658.324,3147.684667,4721.527,720.585076,7,0
0,0,2,2,9,10,19,26,14,40,0.000333,0.056639,4,679.668402,37.759356,169.917101,61.748606,1,0
0,0,3,3,9,9,18,63,34,97,0.000333,0.134828,12,4853.792702,269.65515,404.482725,57.05865,1,0
0,0,2,2,9,10,19,26,14,40,0.000333,0.056639,4,679.668402,37.759356,169.917101,61.748606,1,0
0,0,2,2,9,10,19,26,14,40,0.000333,0.056639,4,679.668402,37.759356,169.917101,61.748606,1,0
0,0,2,2,9,10,19,26,14,40,0.000333,0.056639,4,679.668402,37.759356,169.917101,61.748606,1,0
0,0,2,2,9,10,19,26,14,40,0.000333,0.056639,4,679.668402,37.759356,169.917101,61.748606,1,0
0,0,2,2,9,10,19,26,14,40,0.000333,0.056639,4,679.668402,37.759356,169.917101,61.748606,1,0
0,0,2,2,9,10,19,26,14,40,0.000333,0.056639,4,679.668402,37.759356,169.917101,61.748606,1,0
0,0,2,2,9,10,19,26,14,40,0.000333,0.056639,4,679.668402,37.759356,169.917101,61.748606,1,0
0,0,2,2,9,10,19,26,14,40,0.000333,0.056639,4,679.668402,37.759356,169.917101,61.748606,1,0
0,0,2,2,9,10,19,26,14,40,0.000333,0.056639,4,679.668402,37.759356,169.917101,61.748606,1,0
0,0,2,2,9,10,19,26,14,40,0.000333,0.056639,4,679.668402,37.759356,169.917101,61.748606,1,0
0,0,2,2,9,10,19,26,14,40,0.000333,0.056639,4,679.668402,37.759356,169.917101,61.748606,1,0
0,0,2,2,9,10,19,26,14,40,0.000333,0.056639,4,679.668402,37.759356,169.917101,61.748606,1,0
0,0,2,2,9,10,19,26,14,40,0.000333,0.056639,4,679.668402,37.759356,169.917101,61.748606,1,0
0,0,4,4,10,13,23,67,37,104,0.000333,0.156817,10,4704.504434,261.361357,470.450443,81.324997,1,0
0,0,2,2,9,10,19,26,14,40,0.000333,0.056639,4,679.668402,37.759356,169.917101,61.748606,2,0
0,0,10,10,9,14,23,123,66,189,0.000333,0.284984,16,13679.25136,759.958409,854.95321,81.832294,1,0
0,0,2,2,9,10,19,26,14,40,0.000333,0.056639,4,679.668402,37.759356,169.917101,61.748606,1,0
0,0,2,2,9,10,19,26,14,40,0.000333,0.056639,4,679.668402,37.759356,169.917101,61.748606,1,0
0,0,2,2,9,10,19,26,14,40,0.000333,0.056639,4,679.668402,37.759356,169.917101,61.748606,2,0
0,0,3,3,11,12,23,35,18,53,0.000333,0.079916,5,1198.743918,66.596884,239.748784,81.073298,2,0
0,0,2,2,9,10,19,26,14,40,0.000333,0.056639,4,679.668402,37.759356,169.917101,61.748606,1,0
0,0,155,155,19,93,112,1105,859,1964,0.000333,4.456548,81,1082941.25,60163.4028,13369.64507,688.852392,9,0
0,0,3,3,11,11,22,26,15,41,0.000333,0.060946,5,914.183482,50.787971,182.836696,76.107496,3,0
0,0,10,10,15,22,37,70,39,109,0.000333,0.189277,7,3974.812918,220.82294,567.830417,156.710855,6,0
0,0,2,2,7,4,11,13,5,18,0.000333,0.020757,3,186.809307,10.378295,62.269769,27.651484,3,0
0,0,5,5,10,20,30,58,36,94,0.000333,0.153749,5,2306.23858,128.124366,461.247716,119.657843,1,0
0,0,3,3,11,11,22,26,15,41,0.000333,0.060946,5,914.183482,50.787971,182.836696,76.107496,3,0
0,0,10,10,15,22,37,70,39,109,0.000333,0.189277,7,3974.812918,220.82294,567.830417,156.710855,6,0
0,0,2,2,7,4,11,13,5,18,0.000333,0.020757,3,186.809307,10.378295,62.269769,27.651484,3,0
0,0,17,17,16,23,39,110,55,165,0.000333,0.290697,16,13953.46186,775.192325,872.091366,168.041925,7,0
0,0,24,24,14,33,47,112,63,175,0.000333,0.324018,7,6804.371343,378.02063,972.053049,219.767975,7,0
0,0,1,1,10,13,23,26,13,39,0.000333,0.058806,5,882.094581,49.005255,176.418916,81.324997,1,0
0,0,1,1,10,13,23,26,13,39,0.000333,0.058806,5,882.094581,49.005255,176.418916,81.324997,1,0
0,0,8,8,12,12,24,42,26,68,0.000333,0.103926,12,3741.329401,207.851633,311.77745,86.0391,4,0
0,0,9,9,13,12,25,53,31,84,0.000333,0.130028,12,4681.007039,260.055947,390.08392,91.125266,4,0
0,0,1,1,10,13,23,26,13,39,0.000333,0.058806,5,882.094581,49.005255,176.418916,81.324997,1,0
0,0,2,2,7,4,11,13,5,18,0.000333,0.020757,3,186.809307,10.378295,62.269769,27.651484,3,0
0,0,1,1,10,13,23,26,13,39,0.000333,0.058806,5,882.094581,49.005255,176.418916,81.324997,1,0
0,0,1,1,10,13,23,26,13,39,0.000333,0.058806,5,882.094581,49.005255,176.418916,81.324997,1,0
0,0,8,8,12,13,25,41,24,65,0.000333,0.100617,6,1811.103914,100.616884,301.850652,91.125266,4,0
0,0,9,9,12,12,24,52,31,83,0.000333,0.126851,12,4566.622651,253.701258,380.551888,86.0391,4,0
0,0,8,8,12,13,25,41,24,65,0.000333,0.100617,6,1811.103914,100.616884,301.850652,91.125266,4,0
0,0,8,8,13,12,25,43,26,69,0.000333,0.106809,12,3845.112925,213.617385,320.426077,91.125266,4,0
0,0,1,1,10,13,23,26,13,39,0.000333,0.058806,5,882.094581,49.005255,176.418916,81.324997,1,0
0,0,4,4,12,12,24,49,23,72,0.000333,0.110039,6,1980.7038,110.0391,330.1173,86.0391,10,0
0,0,12,12,15,18,33,68,40,108,0.000333,0.181598,14,7627.123908,423.729106,544.794565,133.662009,6,0
0,0,26,26,17,36,53,136,79,215,0.000333,0.410501,16,19704.04636,1094.669242,1231.502898,255.604168,10,0
0,0,5,5,12,12,24,58,26,84,0.000333,0.128379,12,4621.642201,256.7579,385.13685,86.0391,11,0
0,0,1,1,5,3,8,11,3,14,0.000333,0.014,2,84,4.666667,42,16.364528,2,0
0,0,2,2,9,10,19,26,14,40,0.000333,0.056639,4,679.668402,37.759356,169.917101,61.748606,1,0
0,0,2,2,9,10,19,26,14,40,0.000333,0.056639,4,679.668402,37.759356,169.917101,61.748606,1,0
0,0,2,2,9,10,19,26,14,40,0.000333,0.056639,4,679.668402,37.759356,169.917101,61.748606,1,0
0,0,2,2,9,10,19,26,14,40,0.000333,0.056639,4,679.668402,37.759356,169.917101,61.748606,1,0
0,0,2,2,9,10,19,26,14,40,0.000333,0.056639,4,679.668402,37.759356,169.917101,61.748606,1,0
0,0,2,2,9,10,19,26,14,40,0.000333,0.056639,4,679.668402,37.759356,169.917101,61.748606,1,0
0,0,2,2,9,10,19,26,14,40,0.000333,0.056639,4,679.668402,37.759356,169.917101,61.748606,1,0
0,0,5,5,13,101,114,424,267,691,0.000333,1.573842,12,56658.324,3147.684667,4721.527,720.585076,7,0
0,0,2,2,9,10,19,26,14,40,0.000333,0.056639,4,679.668402,37.759356,169.917101,61.748606,1,0
0,0,2,2,9,10,19,26,14,40,0.000333,0.056639,4,679.668402,37.759356,169.917101,61.748606,1,0
0,0,2,2,9,10,19,26,14,40,0.000333,0.056639,4,679.668402,37.759356,169.917101,61.748606,1,0
0,0,2,2,9,10,19,26,14,40,0.000333,0.056639,4,679.668402,37.759356,169.917101,61.748606,1,0
0,0,2,2,9,10,19,26,14,40,0.000333,0.056639,4,679.668402,37.759356,169.917101,61.748606,1,0
0,0,2,2,9,10,19,26,14,40,0.000333,0.056639,4,679.668402,37.759356,169.917101,61.748606,1,0
0,0,2,2,9,10,19,26,14,40,0.000333,0.056639,4,679.668402,37.759356,169.917101,61.748606,1,0
0,0,2,2,9,10,19,26,14,40,0.000333,0.056639,4,679.668402,37.759356,169.917101,61.748606,1,0
0,0,3,3,11,12,23,35,18,53,0.000333,0.079916,5,1198.743918,66.596884,239.748784,81.073298,2,0
0,0,2,2,9,10,19,26,14,40,0.000333,0.056639,4,679.668402,37.759356,169.917101,61.748606,2,0
0,0,4,4,10,13,23,67,37,104,0.000333,0.156817,10,4704.504434,261.361357,470.450443,81.324997,1,0
0,0,3,3,9,9,18,63,34,97,0.000333,0.134828,12,4853.792702,269.65515,404.482725,57.05865,1,0
0,0,10,10,9,14,23,123,66,189,0.000333,0.284984,16,13679.25136,759.958409,854.95321,81.832294,1,0
0,0,2,2,9,10,19,26,14,40,0.000333,0.056639,4,679.668402,37.759356,169.917101,61.748606,1,0
0,0,2,2,9,10,19,26,14,40,0.000333,0.056639,4,679.668402,37.759356,169.917101,61.748606,2,0
0,0,2,2,9,10,19,26,14,40,0.000333,0.056639,4,679.668402,37.759356,169.917101,61.748606,1,0
0,0,5,5,11,13,24,36,21,57,0.000333,0.087114,5,1306.714313,72.59524,261.342863,86.159464,3,0
0,0,5,5,12,12,24,58,26,84,0.000333,0.128379,12,4621.642201,256.7579,385.13685,86.0391,11,0
0,0,28,28,19,38,57,154,81,235,0.000333,0.45691,18,24673.12476,1370.729153,1370.729153,280.131868,10,0
0,0,4,4,12,12,24,49,23,72,0.000333,0.110039,6,1980.7038,110.0391,330.1173,86.0391,10,0
0,0,2,2,7,4,11,13,5,18,0.000333,0.020757,3,186.809307,10.378295,62.269769,27.651484,3,0
0,0,1,1,5,3,8,11,3,14,0.000333,0.014,2,84,4.666667,42,16.364528,2,0
0,0,5,5,13,101,114,424,267,691,0.000333,1.573842,12,56658.324,3147.684667,4721.527,720.585076,7,0
0,0,2,2,9,10,19,26,14,40,0.000333,0.056639,4,679.668402,37.759356,169.917101,61.748606,1,0
0,0,3,3,9,9,18,63,34,97,0.000333,0.134828,12,4853.792702,269.65515,404.482725,57.05865,1,0
0,0,2,2,9,10,19,26,14,40,0.000333,0.056639,4,679.668402,37.759356,169.917101,61.748606,1,0
0,0,2,2,9,10,19,26,14,40,0.000333,0.056639,4,679.668402,37.759356,169.917101,61.748606,1,0
0,0,2,2,9,10,19,26,14,40,0.000333,0.056639,4,679.668402,37.759356,169.917101,61.748606,1,0
0,0,2,2,9,10,19,26,14,40,0.000333,0.056639,4,679.668402,37.759356,169.917101,61.748606,1,0
0,0,2,2,9,10,19,26,14,40,0.000333,0.056639,4,679.668402,37.759356,169.917101,61.748606,1,0
0,0,2,2,9,10,19,26,14,40,0.000333,0.056639,4,679.668402,37.759356,169.917101,61.748606,1,0
0,0,2,2,9,10,19,26,14,40,0.000333,0.056639,4,679.668402,37.759356,169.917101,61.748606,1,0
0,0,2,2,9,10,19,26,14,40,0.000333,0.056639,4,679.668402,37.759356,169.917101,61.748606,1,0
0,0,2,2,9,10,19,26,14,40,0.000333,0.056639,4,679.668402,37.759356,169.917101,61.748606,1,0
0,0,3,3,11,12,23,35,18,53,0.000333,0.079916,5,1198.743918,66.596884,239.748784,81.073298,2,0
0,0,2,2,9,10,19,26,14,40,0.000333,0.056639,4,679.668402,37.759356,169.917101,61.748606,1,0
0,0,2,2,9,10,19,26,14,40,0.000333,0.056639,4,679.668402,37.759356,169.917101,61.748606,1,0
0,0,2,2,9,10,19,26,14,40,0.000333,0.056639,4,679.668402,37.759356,169.917101,61.748606,1,0
0,0,2,2,9,10,19,26,14,40,0.000333,0.056639,4,679.668402,37.759356,169.917101,61.748606,1,0
0,0,4,4,10,13,23,67,37,104,0.000333,0.156817,10,4704.504434,261.361357,470.450443,81.324997,1,0
0,0,2,2,9,10,19,26,14,40,0.000333,0.056639,4,679.668402,37.759356,169.917101,61.748606,2,0
0,0,10,10,9,14,23,123,66,189,0.000333,0.284984,16,13679.25136,759.958409,854.95321,81.832294,1,0
0,0,2,2,9,10,19,26,14,40,0.000333,0.056639,4,679.668402,37.759356,169.917101,61.748606,1,0
0,0,2,2,9,10,19,26,14,40,0.000333,0.056639,4,679.668402,37.759356,169.917101,61.748606,1,0
0,0,2,2,9,10,19,26,14,40,0.000333,0.056639,4,679.668402,37.759356,169.917101,61.748606,2,0
0,0,2,2,9,10,19,26,14,40,0.000333,0.056639,4,679.668402,37.759356,169.917101,61.748606,1,0
0,0,17,17,16,23,39,110,55,165,0.000333,0.290697,16,13953.46186,775.192325,872.091366,168.041925,7,0
0,0,2,2,7,4,11,13,5,18,0.000333,0.020757,3,186.809307,10.378295,62.269769,27.651484,3,0
0,0,14,14,12,22,34,81,42,123,0.000333,0.208586,6,3754.547577,208.585976,625.757929,141.127046,5,0
0,0,3,3,11,11,22,26,15,41,0.000333,0.060946,5,914.183482,50.787971,182.836696,76.107496,3,0
0,0,10,10,15,22,37,70,39,109,0.000333,0.189277,7,3974.812918,220.82294,567.830417,156.710855,6,0
0,0,3,3,11,11,22,26,15,41,0.000333,0.060946,5,914.183482,50.787971,182.836696,76.107496,3,0
0,0,10,10,15,22,37,70,39,109,0.000333,0.189277,7,3974.812918,220.82294,567.830417,156.710855,6,0
0,0,5,5,11,13,24,36,21,57,0.000333,0.087114,5,1306.714313,72.59524,261.342863,86.159464,3,0
0,0,29,29,18,48,66,166,95,261,0.000333,0.525862,9,14198.28179,788.793433,1577.586865,343.13685,8,0
0,0,2,2,7,4,11,13,5,18,0.000333,0.020757,3,186.809307,10.378295,62.269769,27.651484,3,0
0,0,4,4,8,12,20,28,18,46,0.000333,0.06627,4,795.234769,44.179709,198.808692,67.01955,1,0
0,0,3,3,11,11,22,26,15,41,0.000333,0.060946,5,914.183482,50.787971,182.836696,76.107496,3,0
0,0,10,10,15,22,37,70,39,109,0.000333,0.189277,7,3974.812918,220.82294,567.830417,156.710855,6,0
0,0,3,3,11,11,22,26,15,41,0.000333,0.060946,5,914.183482,50.787971,182.836696,76.107496,3,0
0,0,10,10,15,22,37,70,39,109,0.000333,0.189277,7,3974.812918,220.82294,567.830417,156.710855,6,0
0,0,1,1,5,3,8,11,3,14,0.000333,0.014,2,84,4.666667,42,16.364528,2,0
0,0,27,27,19,36,55,152,82,234,0.000333,0.450946,18,24351.08711,1352.838173,1352.838173,266.827923,10,0
0,0,5,5,12,13,25,38,21,59,0.000333,0.091329,6,1643.925091,91.329172,273.987515,91.125266,2,0
0,0,4,4,12,12,24,49,23,72,0.000333,0.110039,6,1980.7038,110.0391,330.1173,86.0391,10,0
0,0,5,5,12,12,24,58,26,84,0.000333,0.128379,12,4621.642201,256.7579,385.13685,86.0391,11,0
0,0,2,2,9,10,19,26,14,40,0.000333,0.056639,4,679.668402,37.759356,169.917101,61.748606,1,0
0,0,10,10,9,14,23,123,66,189,0.000333,0.284984,16,13679.25136,759.958409,854.95321,81.832294,1,0
0,0,2,2,9,10,19,26,14,40,0.000333,0.056639,4,679.668402,37.759356,169.917101,61.748606,1,0
0,0,3,3,11,12,23,35,18,53,0.000333,0.079916,5,1198.743918,66.596884,239.748784,81.073298,2,0
0,0,5,5,13,101,114,424,267,691,0.000333,1.573842,12,56658.324,3147.684667,4721.527,720.585076,7,0
0,0,2,2,9,10,19,26,14,40,0.000333,0.056639,4,679.668402,37.759356,169.917101,61.748606,2,0
0,0,2,2,9,10,19,26,14,40,0.000333,0.056639,4,679.668402,37.759356,169.917101,61.748606,1,0
0,0,2,2,9,10,19,26,14,40,0.000333,0.056639,4,679.668402,37.759356,169.917101,61.748606,1,0
0,0,2,2,9,10,19,26,14,40,0.000333,0.056639,4,679.668402,37.759356,169.917101,61.748606,1,0
0,0,2,2,9,10,19,26,14,40,0.000333,0.056639,4,679.668402,37.759356,169.917101,61.748606,1,0
0,0,2,2,9,10,19,26,14,40,0.000333,0.056639,4,679.668402,37.759356,169.917101,61.748606,2,0
0,0,2,2,9,10,19,26,14,40,0.000333,0.056639,4,679.668402,37.759356,169.917101,61.748606,1,0
0,0,2,2,9,10,19,26,14,40,0.000333,0.056639,4,679.668402,37.759356,169.917101,61.748606,1,0
0,0,2,2,9,10,19,26,14,40,0.000333,0.056639,4,679.668402,37.759356,169.917101,61.748606,1,0
0,0,2,2,9,10,19,26,14,40,0.000333,0.056639,4,679.668402,37.759356,169.917101,61.748606,1,0
0,0,2,2,9,10,19,26,14,40,0.000333,0.056639,4,679.668402,37.759356,169.917101,61.748606,1,0
0,0,2,2,9,10,19,26,14,40,0.000333,0.056639,4,679.668402,37.759356,169.917101,61.748606,1,0
0,0,2,2,9,10,19,26,14,40,0.000333,0.056639,4,679.668402,37.759356,169.917101,61.748606,1,0
0,0,2,2,9,10,19,26,14,40,0.000333,0.056639,4,679.668402,37.759356,169.917101,61.748606,1,0
0,0,3,3,9,9,18,63,34,97,0.000333,0.134828,12,4853.792702,269.65515,404.482725,57.05865,1,0
0,0,2,2,9,10,19,26,14,40,0.000333,0.056639,4,679.668402,37.759356,169.917101,61.748606,1,0
0,0,2,2,9,10,19,26,14,40,0.000333,0.056639,4,679.668402,37.759356,169.917101,61.748606,1,0
0,0,2,2,9,10,19,26,14,40,0.000333,0.056639,4,679.668402,37.759356,169.917101,61.748606,1,0
0,0,4,4,10,13,23,67,37,104,0.000333,0.156817,10,4704.504434,261.361357,470.450443,81.324997,1,0
0,0,2,2,7,4,11,13,5,18,0.000333,0.020757,3,186.809307,10.378295,62.269769,27.651484,3,0
0,0,1,1,5,3,8,11,3,14,0.000333,0.014,2,84,4.666667,42,16.364528,2,0
0,0,6,6,15,11,26,56,26,82,0.000333,0.128479,14,5396.104796,299.7836,385.436057,96.657107,4,0
0,0,5,5,12,12,24,58,26,84,0.000333,0.128379,12,4621.642201,256.7579,385.13685,86.0391,11,0
0,0,27,27,17,33,50,135,73,208,0.000333,0.391307,16,18782.7534,1043.4863,1173.922087,235.951874,10,0
0,0,21,21,19,34,53,151,75,226,0.000333,0.431503,18,23301.18041,1294.510023,1294.510023,253.684359,8,0
0,0,4,4,12,12,24,49,23,72,0.000333,0.110039,6,1980.7038,110.0391,330.1173,86.0391,10,0
0,0,2,2,9,10,19,26,14,40,0.000333,0.056639,4,679.668402,37.759356,169.917101,61.748606,2,0
0,0,2,2,9,10,19,26,14,40,0.000333,0.056639,4,679.668402,37.759356,169.917101,61.748606,1,0
0,0,2,2,9,10,19,26,14,40,0.000333,0.056639,4,679.668402,37.759356,169.917101,61.748606,1,0
0,0,3,3,11,12,23,35,18,53,0.000333,0.079916,5,1198.743918,66.596884,239.748784,81.073298,2,0
0,0,2,2,9,10,19,26,14,40,0.000333,0.056639,4,679.668402,37.759356,169.917101,61.748606,1,0
0,0,4,4,10,13,23,67,37,104,0.000333,0.156817,10,4704.504434,261.361357,470.450443,81.324997,1,0
0,0,10,10,9,14,23,123,66,189,0.000333,0.284984,16,13679.25136,759.958409,854.95321,81.832294,1,0
0,0,2,2,9,10,19,26,14,40,0.000333,0.056639,4,679.668402,37.759356,169.917101,61.748606,1,0
0,0,2,2,9,10,19,26,14,40,0.000333,0.056639,4,679.668402,37.759356,169.917101,61.748606,1,0
0,0,2,2,9,10,19,26,14,40,0.000333,0.056639,4,679.668402,37.759356,169.917101,61.748606,1,0
0,0,2,2,9,10,19,26,14,40,0.000333,0.056639,4,679.668402,37.759356,169.917101,61.748606,1,0
0,0,2,2,9,10,19,26,14,40,0.000333,0.056639,4,679.668402,37.759356,169.917101,61.748606,1,0
0,0,2,2,9,10,19,26,14,40,0.000333,0.056639,4,679.668402,37.759356,169.917101,61.748606,1,0
0,0,2,2,9,10,19,26,14,40,0.000333,0.056639,4,679.668402,37.759356,169.917101,61.748606,1,0
0,0,2,2,9,10,19,26,14,40,0.000333,0.056639,4,679.668402,37.759356,169.917101,61.748606,2,0
0,0,2,2,9,10,19,26,14,40,0.000333,0.056639,4,679.668402,37.759356,169.917101,61.748606,1,0
0,0,5,5,13,101,114,424,267,691,0.000333,1.573842,12,56658.324,3147.684667,4721.527,720.585076,7,0
0,0,2,2,9,10,19,26,14,40,0.000333,0.056639,4,679.668402,37.759356,169.917101,61.748606,1,0
0,0,3,3,9,9,18,63,34,97,0.000333,0.134828,12,4853.792702,269.65515,404.482725,57.05865,1,0
0,0,2,2,9,10,19,26,14,40,0.000333,0.056639,4,679.668402,37.759356,169.917101,61.748606,1,0
0,0,2,2,9,10,19,26,14,40,0.000333,0.056639,4,679.668402,37.759356,169.917101,61.748606,1,0
0,0,2,2,9,10,19,26,14,40,0.000333,0.056639,4,679.668402,37.759356,169.917101,61.748606,1,0
0,0,2,2,9,10,19,26,14,40,0.000333,0.056639,4,679.668402,37.759356,169.917101,61.748606,1,0
0,0,2,2,9,10,19,26,14,40,0.000333,0.056639,4,679.668402,37.759356,169.917101,61.748606,1,0
0,0,3,3,11,11,22,26,15,41,0.000333,0.060946,5,914.183482,50.787971,182.836696,76.107496,3,0
0,0,10,10,15,22,37,70,39,109,0.000333,0.189277,7,3974.812918,220.82294,567.830417,156.710855,6,0
0,0,3,3,7,7,14,16,10,26,0.000333,0.032997,3,296.973684,16.498538,98.991228,39.302969,1,0
0,0,1,1,5,3,8,11,3,14,0.000333,0.014,2,84,4.666667,42,16.364528,2,0
0,0,31,31,19,37,56,168,91,259,0.000333,0.501368,18,27073.88865,1504.104925,1504.104925,273.460397,11,0
0,0,5,5,12,12,24,58,26,84,0.000333,0.128379,12,4621.642201,256.7579,385.13685,86.0391,11,0
0,0,4,4,12,12,24,49,23,72,0.000333,0.110039,6,1980.7038,110.0391,330.1173,86.0391,10,0
0,0,2,2,9,10,19,26,14,40,0.000333,0.056639,4,679.668402,37.759356,169.917101,61.748606,1,0
0,0,10,10,9,14,23,123,66,189,0.000333,0.284984,16,13679.25136,759.958409,854.95321,81.832294,1,0
0,0,2,2,9,10,19,26,14,40,0.000333,0.056639,4,679.668402,37.759356,169.917101,61.748606,1,0
0,0,3,3,11,12,23,35,18,53,0.000333,0.079916,5,1198.743918,66.596884,239.748784,81.073298,2,0
0,0,5,5,13,101,114,424,267,691,0.000333,1.573842,12,56658.324,3147.684667,4721.527,720.585076,7,0
0,0,2,2,9,10,19,26,14,40,0.000333,0.056639,4,679.668402,37.759356,169.917101,61.748606,2,0
0,0,2,2,9,10,19,26,14,40,0.000333,0.056639,4,679.668402,37.759356,169.917101,61.748606,1,0
0,0,2,2,9,10,19,26,14,40,0.000333,0.056639,4,679.668402,37.759356,169.917101,61.748606,1,0
0,0,2,2,9,10,19,26,14,40,0.000333,0.056639,4,679.668402,37.759356,169.917101,61.748606,1,0
0,0,2,2,9,10,19,26,14,40,0.000333,0.056639,4,679.668402,37.759356,169.917101,61.748606,1,0
0,0,2,2,9,10,19,26,14,40,0.000333,0.056639,4,679.668402,37.759356,169.917101,61.748606,2,0
0,0,2,2,9,10,19,26,14,40,0.000333,0.056639,4,679.668402,37.759356,169.917101,61.748606,1,0
0,0,2,2,9,10,19,26,14,40,0.000333,0.056639,4,679.668402,37.759356,169.917101,61.748606,1,0
0,0,2,2,9,10,19,26,14,40,0.000333,0.056639,4,679.668402,37.759356,169.917101,61.748606,1,0
0,0,2,2,9,10,19,26,14,40,0.000333,0.056639,4,679.668402,37.759356,169.917101,61.748606,1,0
0,0,2,2,9,10,19,26,14,40,0.000333,0.056639,4,679.668402,37.759356,169.917101,61.748606,1,0
0,0,2,2,9,10,19,26,14,40,0.000333,0.056639,4,679.668402,37.759356,169.917101,61.748606,1,0
0,0,2,2,9,10,19,26,14,40,0.000333,0.056639,4,679.668402,37.759356,169.917101,61.748606,1,0
0,0,2,2,9,10,19,26,14,40,0.000333,0.056639,4,679.668402,37.759356,169.917101,61.748606,1,0
0,0,3,3,9,9,18,63,34,97,0.000333,0.134828,12,4853.792702,269.65515,404.482725,57.05865,1,0
0,0,2,2,9,10,19,26,14,40,0.000333,0.056639,4,679.668402,37.759356,169.917101,61.748606,1,0
0,0,2,2,9,10,19,26,14,40,0.000333,0.056639,4,679.668402,37.759356,169.917101,61.748606,1,0
0,0,2,2,9,10,19,26,14,40,0.000333,0.056639,4,679.668402,37.759356,169.917101,61.748606,1,0
0,0,4,4,10,13,23,67,37,104,0.000333,0.156817,10,4704.504434,261.361357,470.450443,81.324997,1,0
0,0,3,3,11,11,22,26,15,41,0.000333,0.060946,5,914.183482,50.787971,182.836696,76.107496,3,0
0,0,10,10,15,22,37,70,39,109,0.000333,0.189277,7,3974.812918,220.82294,567.830417,156.710855,6,0
0,0,27,27,16,37,53,456,86,542,0.000333,1.034844,16,49672.52618,2759.584788,3104.532886,256.749775,7,0
0,0,26,26,17,35,52,140,73,213,0.000333,0.404731,16,19427.09856,1079.283253,1214.19366,249.011774,10,0
0,0,2,2,7,4,11,13,5,18,0.000333,0.020757,3,186.809307,10.378295,62.269769,27.651484,3,0
0,0,28,28,19,37,56,153,80,233,0.000333,0.451038,18,24356.04654,1353.113697,1353.113697,273.460397,10,0
0,0,2,2,7,4,11,13,5,18,0.000333,0.020757,3,186.809307,10.378295,62.269769,27.651484,3,0
0,0,17,17,12,25,37,105,52,157,0.000333,0.272628,12,9814.610141,545.256119,817.884178,159.115955,6,0
0,0,18,18,13,27,40,107,63,170,0.000333,0.301576,12,10856.73331,603.151851,904.727776,176.487679,1,0
0,0,5,5,8,7,15,24,13,37,0.000333,0.048185,4,578.219808,32.123323,144.554952,43.651484,2,0
0,0,17,17,16,23,39,110,55,165,0.000333,0.290697,16,13953.46186,775.192325,872.091366,168.041925,7,0
0,0,3,3,11,11,22,26,15,41,0.000333,0.060946,5,914.183482,50.787971,182.836696,76.107496,3,0
0,0,10,10,15,22,37,70,39,109,0.000333,0.189277,7,3974.812918,220.82294,567.830417,156.710855,6,0
0,0,5,5,11,13,24,36,21,57,0.000333,0.087114,5,1306.714313,72.59524,261.342863,86.159464,3,0
0,0,32,32,19,41,60,170,91,261,0.000333,0.513899,18,27750.57202,1541.698445,1541.698445,300.370255,12,0
0,0,2,2,7,4,11,13,5,18,0.000333,0.020757,3,186.809307,10.378295,62.269769,27.651484,3,0
0,0,5,5,11,13,24,36,21,57,0.000333,0.087114,5,1306.714313,72.59524,261.342863,86.159464,3,0
0,0,28,28,19,38,57,154,81,235,0.000333,0.45691,18,24673.12476,1370.729153,1370.729153,280.131868,10,0
0,0,2,2,7,4,11,13,5,18,0.000333,0.020757,3,186.809307,10.378295,62.269769,27.651484,3,0
0,0,2,2,7,4,11,13,5,18,0.000333,0.020757,3,186.809307,10.378295,62.269769,27.651484,3,0
0,0,5,5,9,12,21,32,21,53,0.000333,0.077598,4,931.171294,51.731739,232.792823,71.548875,1,0
0,0,27,27,20,36,56,152,82,234,0.000333,0.452974,20,27178.42104,1509.91228,1358.921052,272.555862,10,0
0,0,1,1,5,3,8,11,3,14,0.000333,0.014,2,84,4.666667,42,16.364528,2,0
0,0,4,4,12,12,24,49,23,72,0.000333,0.110039,6,1980.7038,110.0391,330.1173,86.0391,10,0
0,0,5,5,12,12,24,58,26,84,0.000333,0.128379,12,4621.642201,256.7579,385.13685,86.0391,11,0
0,0,2,2,9,10,19,26,14,40,0.000333,0.056639,4,679.668402,37.759356,169.917101,61.748606,1,0
0,0,10,10,9,14,23,123,66,189,0.000333,0.284984,16,13679.25136,759.958409,854.95321,81.832294,1,0
0,0,2,2,9,10,19,26,14,40,0.000333,0.056639,4,679.668402,37.759356,169.917101,61.748606,1,0
0,0,3,3,11,12,23,35,18,53,0.000333,0.079916,5,1198.743918,66.596884,239.748784,81.073298,2,0
0,0,5,5,13,101,114,424,267,691,0.000333,1.573842,12,56658.324,3147.684667,4721.527,720.585076,7,0
0,0,2,2,9,10,19,26,14,40,0.000333,0.056639,4,679.668402,37.759356,169.917101,61.748606,2,0
0,0,2,2,9,10,19,26,14,40,0.000333,0.056639,4,679.668402,37.759356,169.917101,61.748606,1,0
0,0,2,2,9,10,19,26,14,40,0.000333,0.056639,4,679.668402,37.759356,169.917101,61.748606,1,0
0,0,2,2,9,10,19,26,14,40,0.000333,0.056639,4,679.668402,37.759356,169.917101,61.748606,1,0
0,0,2,2,9,10,19,26,14,40,0.000333,0.056639,4,679.668402,37.759356,169.917101,61.748606,1,0
0,0,2,2,9,10,19,26,14,40,0.000333,0.056639,4,679.668402,37.759356,169.917101,61.748606,2,0
0,0,2,2,9,10,19,26,14,40,0.000333,0.056639,4,679.668402,37.759356,169.917101,61.748606,1,0
0,0,2,2,9,10,19,26,14,40,0.000333,0.056639,4,679.668402,37.759356,169.917101,61.748606,1,0
0,0,2,2,9,10,19,26,14,40,0.000333,0.056639,4,679.668402,37.759356,169.917101,61.748606,1,0
0,0,2,2,9,10,19,26,14,40,0.000333,0.056639,4,679.668402,37.759356,169.917101,61.748606,1,0
0,0,2,2,9,10,19,26,14,40,0.000333,0.056639,4,679.668402,37.759356,169.917101,61.748606,1,0
0,0,2,2,9,10,19,26,14,40,0.000333,0.056639,4,679.668402,37.759356,169.917101,61.748606,1,0
0,0,2,2,9,10,19,26,14,40,0.000333,0.056639,4,679.668402,37.759356,169.917101,61.748606,1,0
0,0,2,2,9,10,19,26,14,40,0.000333,0.056639,4,679.668402,37.759356,169.917101,61.748606,1,0
0,0,3,3,9,9,18,63,34,97,0.000333,0.134828,12,4853.792702,269.65515,404.482725,57.05865,1,0
0,0,2,2,9,10,19,26,14,40,0.000333,0.056639,4,679.668402,37.759356,169.917101,61.748606,1,0
0,0,2,2,9,10,19,26,14,40,0.000333,0.056639,4,679.668402,37.759356,169.917101,61.748606,1,0
0,0,2,2,9,10,19,26,14,40,0.000333,0.056639,4,679.668402,37.759356,169.917101,61.748606,1,0
0,0,4,4,10,13,23,67,37,104,0.000333,0.156817,10,4704.504434,261.361357,470.450443,81.324997,1,0
0,0,2,2,7,4,11,13,5,18,0.000333,0.020757,3,186.809307,10.378295,62.269769,27.651484,3,0
0,0,5,5,12,12,24,58,26,84,0.000333,0.128379,12,4621.642201,256.7579,385.13685,86.0391,11,0
0,0,4,4,12,12,24,49,23,72,0.000333,0.110039,6,1980.7038,110.0391,330.1173,86.0391,10,0
0,0,27,27,17,33,50,135,73,208,0.000333,0.391307,16,18782.7534,1043.4863,1173.922087,235.951874,11,0
0,0,1,1,5,3,8,11,3,14,0.000333,0.014,2,84,4.666667,42,16.364528,2,0
0,0,6,6,16,12,28,47,24,71,0.000333,0.113774,16,5461.155191,303.397511,341.322199,107.01955,4,0
0,0,22,22,20,36,56,160,80,240,0.000333,0.464588,20,27875.30363,1548.627979,1393.765181,272.555862,13,0
0,0,2,2,9,10,19,26,14,40,0.000333,0.056639,4,679.668402,37.759356,169.917101,61.748606,1,0
0,0,2,2,9,10,19,26,14,40,0.000333,0.056639,4,679.668402,37.759356,169.917101,61.748606,1,0
0,0,2,2,9,10,19,26,14,40,0.000333,0.056639,4,679.668402,37.759356,169.917101,61.748606,1,0
0,0,2,2,9,10,19,26,14,40,0.000333,0.056639,4,679.668402,37.759356,169.917101,61.748606,1,0
0,0,2,2,9,10,19,26,14,40,0.000333,0.056639,4,679.668402,37.759356,169.917101,61.748606,1,0
0,0,2,2,9,10,19,26,14,40,0.000333,0.056639,4,679.668402,37.759356,169.917101,61.748606,1,0
0,0,5,5,13,101,114,424,267,691,0.000333,1.573842,12,56658.324,3147.684667,4721.527,720.585076,7,0
0,0,2,2,9,10,19,26,14,40,0.000333,0.056639,4,679.668402,37.759356,169.917101,61.748606,2,0
0,0,2,2,9,10,19,26,14,40,0.000333,0.056639,4,679.668402,37.759356,169.917101,61.748606,1,0
0,0,2,2,9,10,19,26,14,40,0.000333,0.056639,4,679.668402,37.759356,169.917101,61.748606,1,0
0,0,2,2,9,10,19,26,14,40,0.000333,0.056639,4,679.668402,37.759356,169.917101,61.748606,1,0
0,0,2,2,9,10,19,26,14,40,0.000333,0.056639,4,679.668402,37.759356,169.917101,61.748606,1,0
0,0,10,10,9,14,23,123,66,189,0.000333,0.284984,16,13679.25136,759.958409,854.95321,81.832294,1,0
0,0,2,2,9,10,19,26,14,40,0.000333,0.056639,4,679.668402,37.759356,169.917101,61.748606,1,0
0,0,4,4,10,13,23,67,37,104,0.000333,0.156817,10,4704.504434,261.361357,470.450443,81.324997,1,0
0,0,2,2,9,10,19,26,14,40,0.000333,0.056639,4,679.668402,37.759356,169.917101,61.748606,1,0
0,0,2,2,9,10,19,26,14,40,0.000333,0.056639,4,679.668402,37.759356,169.917101,61.748606,1,0
0,0,3,3,9,9,18,63,34,97,0.000333,0.134828,12,4853.792702,269.65515,404.482725,57.05865,1,0
0,0,2,2,9,10,19,26,14,40,0.000333,0.056639,4,679.668402,37.759356,169.917101,61.748606,1,0
0,0,2,2,9,10,19,26,14,40,0.000333,0.056639,4,679.668402,37.759356,169.917101,61.748606,2,0
0,0,3,3,11,12,23,35,18,53,0.000333,0.079916,5,1198.743918,66.596884,239.748784,81.073298,2,0
0,0,2,2,9,10,19,26,14,40,0.000333,0.056639,4,679.668402,37.759356,169.917101,61.748606,1,0
0,0,2,2,9,10,19,26,14,40,0.000333,0.056639,4,679.668402,37.759356,169.917101,61.748606,1,0
0,0,2,2,9,10,19,26,14,40,0.000333,0.056639,4,679.668402,37.759356,169.917101,61.748606,1,0
0,0,7,7,12,19,31,51,37,88,0.000333,0.145323,6,2615.815652,145.323092,435.969275,123.730173,5,0
0,0,32,32,19,39,58,173,93,266,0.000333,0.519408,18,28048.01301,1558.222945,1558.222945,286.841309,11,0
0,0,19,19,14,30,44,115,61,176,0.000333,0.320287,14,13452.03951,747.335528,960.859965,200.509687,7,0
0,0,2,2,7,4,11,13,5,18,0.000333,0.020757,3,186.809307,10.378295,62.269769,27.651484,3,0
0,0,3,3,11,11,22,26,15,41,0.000333,0.060946,5,914.183482,50.787971,182.836696,76.107496,3,0
0,0,10,10,15,22,37,70,39,109,0.000333,0.189277,7,3974.812918,220.82294,567.830417,156.710855,6,0
0,0,5,5,11,13,24,36,21,57,0.000333,0.087114,5,1306.714313,72.59524,261.342863,86.159464,3,0
0,0,2,2,7,4,11,13,5,18,0.000333,0.020757,3,186.809307,10.378295,62.269769,27.651484,3,0
0,0,17,17,16,23,39,110,55,165,0.000333,0.290697,16,13953.46186,775.192325,872.091366,168.041925,7,0
0,0,4,4,11,10,21,30,16,46,0.000333,0.067349,5,1010.233007,56.124056,202.046601,71.273029,1,0
0,0,5,5,11,13,24,36,21,57,0.000333,0.087114,5,1306.714313,72.59524,261.342863,86.159464,3,0
0,0,5,5,12,12,24,58,26,84,0.000333,0.128379,12,4621.642201,256.7579,385.13685,86.0391,11,0
0,0,28,28,19,39,58,166,85,251,0.000333,0.490118,18,26466.35814,1470.35323,1470.35323,286.841309,10,0
0,0,4,4,12,12,24,49,23,72,0.000333,0.110039,6,1980.7038,110.0391,330.1173,86.0391,10,0
0,0,2,2,7,4,11,13,5,18,0.000333,0.020757,3,186.809307,10.378295,62.269769,27.651484,3,0
0,0,1,1,5,3,8,11,3,14,0.000333,0.014,2,84,4.666667,42,16.364528,2,0
0,0,5,5,13,101,114,424,267,691,0.000333,1.573842,12,56658.324,3147.684667,4721.527,720.585076,7,0
0,0,2,2,9,10,19,26,14,40,0.000333,0.056639,4,679.668402,37.759356,169.917101,61.748606,1,0
0,0,3,3,9,9,18,63,34,97,0.000333,0.134828,12,4853.792702,269.65515,404.482725,57.05865,1,0
0,0,2,2,9,10,19,26,14,40,0.000333,0.056639,4,679.668402,37.759356,169.917101,61.748606,1,0
0,0,2,2,9,10,19,26,14,40,0.000333,0.056639,4,679.668402,37.759356,169.917101,61.748606,1,0
0,0,2,2,9,10,19,26,14,40,0.000333,0.056639,4,679.668402,37.759356,169.917101,61.748606,1,0
0,0,2,2,9,10,19,26,14,40,0.000333,0.056639,4,679.668402,37.759356,169.917101,61.748606,1,0
0,0,2,2,9,10,19,26,14,40,0.000333,0.056639,4,679.668402,37.759356,169.917101,61.748606,1,0
0,0,2,2,9,10,19,26,14,40,0.000333,0.056639,4,679.668402,37.759356,169.917101,61.748606,1,0
0,0,2,2,9,10,19,26,14,40,0.000333,0.056639,4,679.668402,37.759356,169.917101,61.748606,1,0
0,0,2,2,9,10,19,26,14,40,0.000333,0.056639,4,679.668402,37.759356,169.917101,61.748606,1,0
0,0,2,2,9,10,19,26,14,40,0.000333,0.056639,4,679.668402,37.759356,169.917101,61.748606,1,0
0,0,2,2,9,10,19,26,14,40,0.000333,0.056639,4,679.668402,37.759356,169.917101,61.748606,1,0
0,0,2,2,9,10,19,26,14,40,0.000333,0.056639,4,679.668402,37.759356,169.917101,61.748606,1,0
0,0,2,2,9,10,19,26,14,40,0.000333,0.056639,4,679.668402,37.759356,169.917101,61.748606,1,0
0,0,2,2,9,10,19,26,14,40,0.000333,0.056639,4,679.668402,37.759356,169.917101,61.748606,1,0
0,0,4,4,10,13,23,67,37,104,0.000333,0.156817,10,4704.504434,261.361357,470.450443,81.324997,1,0
0,0,2,2,9,10,19,26,14,40,0.000333,0.056639,4,679.668402,37.759356,169.917101,61.748606,2,0
0,0,10,10,9,14,23,123,66,189,0.000333,0.284984,16,13679.25136,759.958409,854.95321,81.832294,1,0
0,0,2,2,9,10,19,26,14,40,0.000333,0.056639,4,679.668402,37.759356,169.917101,61.748606,1,0
0,0,2,2,9,10,19,26,14,40,0.000333,0.056639,4,679.668402,37.759356,169.917101,61.748606,1,0
0,0,2,2,9,10,19,26,14,40,0.000333,0.056639,4,679.668402,37.759356,169.917101,61.748606,2,0
0,0,3,3,11,12,23,35,18,53,0.000333,0.079916,5,1198.743918,66.596884,239.748784,81.073298,2,0
0,0,2,2,9,10,19,26,14,40,0.000333,0.056639,4,679.668402,37.759356,169.917101,61.748606,1,0
0,0,2,2,7,4,11,13,5,18,0.000333,0.020757,3,186.809307,10.378295,62.269769,27.651484,3,0
0,0,3,3,11,11,22,26,15,41,0.000333,0.060946,5,914.183482,50.787971,182.836696,76.107496,3,0
0,0,10,10,15,22,37,70,39,109,0.000333,0.189277,7,3974.812918,220.82294,567.830417,156.710855,6,0
0,0,5,5,11,13,24,36,21,57,0.000333,0.087114,5,1306.714313,72.59524,261.342863,86.159464,3,0
0,0,2,2,7,4,11,13,5,18,0.000333,0.020757,3,186.809307,10.378295,62.269769,27.651484,3,0
0,0,17,17,16,23,39,110,55,165,0.000333,0.290697,16,13953.46186,775.192325,872.091366,168.041925,7,0
0,0,36,36,20,37,57,170,118,288,0.000333,0.559957,30,50396.16972,2799.787207,1679.872324,279.188336,14,0
0,0,17,17,16,23,39,110,55,165,0.000333,0.290697,16,13953.46186,775.192325,872.091366,168.041925,7,0
0,0,2,2,7,4,11,13,5,18,0.000333,0.020757,3,186.809307,10.378295,62.269769,27.651484,3,0
0,0,14,14,12,22,34,81,42,123,0.000333,0.208586,6,3754.547577,208.585976,625.757929,141.127046,5,0
0,0,20,20,26,34,60,342,224,566,0.000333,1.114433,78,260777.406,14487.63367,3343.300077,295.185169,19,0
0,0,22,22,27,38,65,305,199,504,0.000333,1.011758,65,197292.7696,10960.70942,3035.273378,327.803208,10,0
0,0,26,26,27,49,76,408,274,682,0.000333,1.420362,65,276970.6267,15387.25704,4261.086564,403.502745,10,0
0,0,4,4,15,18,33,51,32,83,0.000333,0.139562,7,2930.792983,162.821832,418.684712,133.662009,1,0
0,0,30,30,27,50,77,471,324,795,0.000333,1.660698,78,388603.4334,21589.07963,4982.0953,410.574772,10,0
0,0,26,26,27,53,80,397,266,663,0.000333,1.397146,65,272443.4912,15135.74951,4191.438327,431.961747,10,0
0,0,33,33,27,62,89,481,326,807,0.000333,1.741972,65,339684.5971,18871.36651,5225.916879,497.542134,10,0
0,0,59,59,28,80,108,635,432,1067,0.000333,2.402488,70,504522.5475,28029.03042,7207.464965,640.360185,10,0
0,0,9,9,11,14,25,45,28,73,0.000333,0.113001,10,3390.015019,188.334168,339.001502,91.356717,3,0
0,0,22,22,27,38,65,315,208,523,0.000333,1.049899,65,204730.3938,11373.91077,3149.698366,327.803208,10,0
0,0,9,9,22,17,39,295,185,480,0.000333,0.845664,110,279069.2372,15503.84651,2536.993065,167.594364,37,0
0,0,39,39,16,34,50,282,159,441,0.000333,0.829647,32,79646.09855,4424.783253,2488.94058,236.973737,9,0
0,0,38,38,27,63,90,541,367,908,0.000333,1.964868,65,383149.1697,21286.06499,5894.602611,504.950598,10,0
0,0,15,15,17,37,54,135,91,226,0.000333,0.433535,16,20809.67321,1156.092956,1300.604575,262.236643,9,0
0,0,26,26,27,41,68,338,218,556,0.000333,1.12821,65,220000.9071,12222.27262,3384.62934,348.041595,10,0
0,0,3,3,10,17,27,36,24,60,0.000333,0.095098,5,1426.466251,79.248125,285.29325,102.706149,4,0
0,0,22,22,27,35,62,283,184,467,0.000333,0.92687,65,180739.629,10041.0905,2780.609677,307.906868,10,0
0,0,3,3,11,11,22,26,15,41,0.000333,0.060946,5,914.183482,50.787971,182.836696,76.107496,3,0
0,0,10,10,15,22,37,70,39,109,0.000333,0.189277,7,3974.812918,220.82294,567.830417,156.710855,6,0
0,0,4,4,12,10,22,22,17,39,0.000333,0.057973,6,1043.506999,57.972611,173.917833,76.238831,2,0
1,0,5,6,10,9,19,28,13,41,0.000333,0.058055,5,870.82514,48.379174,174.165028,61.748606,3,0
0,0,5,5,12,12,24,58,26,84,0.000333,0.128379,12,4621.642201,256.7579,385.13685,86.0391,11,0
0,0,4,4,12,12,24,49,23,72,0.000333,0.110039,6,1980.7038,110.0391,330.1173,86.0391,10,0
0,0,27,27,19,35,54,148,78,226,0.000333,0.433535,18,23410.88236,1300.604575,1300.604575,260.235528,10,0
0,0,1,1,5,3,8,11,3,14,0.000333,0.014,2,84,4.666667,42,16.364528,2,0
0,0,2,2,9,10,19,26,14,40,0.000333,0.056639,4,679.668402,37.759356,169.917101,61.748606,1,0
0,0,5,5,13,101,114,424,267,691,0.000333,1.573842,12,56658.324,3147.684667,4721.527,720.585076,7,0
0,0,2,2,9,10,19,26,14,40,0.000333,0.056639,4,679.668402,37.759356,169.917101,61.748606,1,0
0,0,2,2,9,10,19,26,14,40,0.000333,0.056639,4,679.668402,37.759356,169.917101,61.748606,1,0
0,0,2,2,9,10,19,26,14,40,0.000333,0.056639,4,679.668402,37.759356,169.917101,61.748606,1,0
0,0,2,2,9,10,19,26,14,40,0.000333,0.056639,4,679.668402,37.759356,169.917101,61.748606,1,0
0,0,2,2,9,10,19,26,14,40,0.000333,0.056639,4,679.668402,37.759356,169.917101,61.748606,1,0
0,0,2,2,9,10,19,26,14,40,0.000333,0.056639,4,679.668402,37.759356,169.917101,61.748606,1,0
0,0,2,2,9,10,19,26,14,40,0.000333,0.056639,4,679.668402,37.759356,169.917101,61.748606,1,0
0,0,2,2,9,10,19,26,14,40,0.000333,0.056639,4,679.668402,37.759356,169.917101,61.748606,1,0
0,0,2,2,9,10,19,26,14,40,0.000333,0.056639,4,679.668402,37.759356,169.917101,61.748606,1,0
0,0,2,2,9,10,19,26,14,40,0.000333,0.056639,4,679.668402,37.759356,169.917101,61.748606,2,0
0,0,2,2,9,10,19,26,14,40,0.000333,0.056639,4,679.668402,37.759356,169.917101,61.748606,1,0
0,0,2,2,9,10,19,26,14,40,0.000333,0.056639,4,679.668402,37.759356,169.917101,61.748606,2,0
0,0,3,3,11,12,23,35,18,53,0.000333,0.079916,5,1198.743918,66.596884,239.748784,81.073298,2,0
0,0,10,10,9,14,23,123,66,189,0.000333,0.284984,16,13679.25136,759.958409,854.95321,81.832294,1,0
0,0,2,2,9,10,19,26,14,40,0.000333,0.056639,4,679.668402,37.759356,169.917101,61.748606,1,0
0,0,3,3,9,9,18,63,34,97,0.000333,0.134828,12,4853.792702,269.65515,404.482725,57.05865,1,0
0,0,2,2,9,10,19,26,14,40,0.000333,0.056639,4,679.668402,37.759356,169.917101,61.748606,1,0
0,0,4,4,10,13,23,67,37,104,0.000333,0.156817,10,4704.504434,261.361357,470.450443,81.324997,1,0
0,0,2,2,9,10,19,26,14,40,0.000333,0.056639,4,679.668402,37.759356,169.917101,61.748606,1,0
0,0,2,2,9,10,19,26,14,40,0.000333,0.056639,4,679.668402,37.759356,169.917101,61.748606,1,0
0,0,2,2,9,10,19,26,14,40,0.000333,0.056639,4,679.668402,37.759356,169.917101,61.748606,1,0
0,0,2,2,9,10,19,26,14,40,0.000333,0.056639,4,679.668402,37.759356,169.917101,61.748606,1,0
0,0,5,5,11,13,24,36,21,57,0.000333,0.087114,5,1306.714313,72.59524,261.342863,86.159464,3,0
0,0,2,2,7,4,11,13,5,18,0.000333,0.020757,3,186.809307,10.378295,62.269769,27.651484,3,0
0,0,5,5,14,9,23,39,20,59,0.000333,0.088963,14,3736.462176,207.581232,266.890155,81.832294,4,0
0,0,17,17,16,23,39,110,55,165,0.000333,0.290697,16,13953.46186,775.192325,872.091366,168.041925,7,0
0,0,2,2,7,4,11,13,5,18,0.000333,0.020757,3,186.809307,10.378295,62.269769,27.651484,3,0
0,0,5,5,11,13,24,26,20,46,0.000333,0.070303,5,1054.541375,58.585632,210.908275,86.159464,1,0
0,0,5,5,11,13,24,36,21,57,0.000333,0.087114,5,1306.714313,72.59524,261.342863,86.159464,3,0
0,0,2,2,7,4,11,13,5,18,0.000333,0.020757,3,186.809307,10.378295,62.269769,27.651484,3,0
0,0,17,17,16,23,39,110,55,165,0.000333,0.290697,16,13953.46186,775.192325,872.091366,168.041925,7,0
0,0,3,3,11,11,22,26,15,41,0.000333,0.060946,5,914.183482,50.787971,182.836696,76.107496,3,0
0,0,10,10,15,22,37,70,39,109,0.000333,0.189277,7,3974.812918,220.82294,567.830417,156.710855,6,0
0,0,3,3,11,11,22,26,15,41,0.000333,0.060946,5,914.183482,50.787971,182.836696,76.107496,3,0
0,0,10,10,15,22,37,70,39,109,0.000333,0.189277,7,3974.812918,220.82294,567.830417,156.710855,6,0
0,0,5,5,12,12,24,58,26,84,0.000333,0.128379,12,4621.642201,256.7579,385.13685,86.0391,11,0
0,0,4,4,12,12,24,49,23,72,0.000333,0.110039,6,1980.7038,110.0391,330.1173,86.0391,10,0
0,0,1,1,5,3,8,11,3,14,0.000333,0.014,2,84,4.666667,42,16.364528,2,0
0,0,2,2,7,4,11,13,5,18,0.000333,0.020757,3,186.809307,10.378295,62.269769,27.651484,3,0
0,0,2,2,9,10,19,26,14,40,0.000333,0.056639,4,679.668402,37.759356,169.917101,61.748606,1,0
0,0,2,2,9,10,19,26,14,40,0.000333,0.056639,4,679.668402,37.759356,169.917101,61.748606,1,0
0,0,2,2,9,10,19,26,14,40,0.000333,0.056639,4,679.668402,37.759356,169.917101,61.748606,1,0
0,0,2,2,9,10,19,26,14,40,0.000333,0.056639,4,679.668402,37.759356,169.917101,61.748606,1,0
0,0,2,2,9,10,19,26,14,40,0.000333,0.056639,4,679.668402,37.759356,169.917101,61.748606,1,0
0,0,3,3,11,12,23,35,18,53,0.000333,0.079916,5,1198.743918,66.596884,239.748784,81.073298,2,0
0,0,2,2,9,10,19,26,14,40,0.000333,0.056639,4,679.668402,37.759356,169.917101,61.748606,1,0
0,0,4,4,10,13,23,67,37,104,0.000333,0.156817,10,4704.504434,261.361357,470.450443,81.324997,1,0
0,0,10,10,9,14,23,123,66,189,0.000333,0.284984,16,13679.25136,759.958409,854.95321,81.832294,1,0
0,0,2,2,9,10,19,26,14,40,0.000333,0.056639,4,679.668402,37.759356,169.917101,61.748606,2,0
0,0,3,3,9,9,18,63,34,97,0.000333,0.134828,12,4853.792702,269.65515,404.482725,57.05865,1,0
0,0,2,2,9,10,19,26,14,40,0.000333,0.056639,4,679.668402,37.759356,169.917101,61.748606,2,0
0,0,2,2,9,10,19,26,14,40,0.000333,0.056639,4,679.668402,37.759356,169.917101,61.748606,1,0
0,0,2,2,9,10,19,26,14,40,0.000333,0.056639,4,679.668402,37.759356,169.917101,61.748606,1,0
0,0,2,2,9,10,19,26,14,40,0.000333,0.056639,4,679.668402,37.759356,169.917101,61.748606,1,0
0,0,2,2,9,10,19,26,14,40,0.000333,0.056639,4,679.668402,37.759356,169.917101,61.748606,1,0
0,0,2,2,9,10,19,26,14,40,0.000333,0.056639,4,679.668402,37.759356,169.917101,61.748606,1,0
0,0,2,2,9,10,19,26,14,40,0.000333,0.056639,4,679.668402,37.759356,169.917101,61.748606,1,0
0,0,5,5,13,101,114,424,267,691,0.000333,1.573842,12,56658.324,3147.684667,4721.527,720.585076,7,0
0,0,2,2,9,10,19,26,14,40,0.000333,0.056639,4,679.668402,37.759356,169.917101,61.748606,1,0
0,0,2,2,9,10,19,26,14,40,0.000333,0.056639,4,679.668402,37.759356,169.917101,61.748606,1,0
0,0,2,2,9,10,19,26,14,40,0.000333,0.056639,4,679.668402,37.759356,169.917101,61.748606,1,0
0,0,2,2,9,10,19,26,14,40,0.000333,0.056639,4,679.668402,37.759356,169.917101,61.748606,1,0
0,0,2,2,9,10,19,26,14,40,0.000333,0.056639,4,679.668402,37.759356,169.917101,61.748606,1,0
0,0,32,32,20,39,59,179,98,277,0.000333,0.543164,20,32589.84249,1810.546805,1629.492125,292.569248,11,0
0,0,7,7,11,12,23,31,18,49,0.000333,0.073885,5,1108.272679,61.570704,221.654536,81.073298,2,0
0,0,5,5,11,13,24,36,21,57,0.000333,0.087114,5,1306.714313,72.59524,261.342863,86.159464,3,0
0,0,2,2,7,4,11,13,5,18,0.000333,0.020757,3,186.809307,10.378295,62.269769,27.651484,3,0
0,0,29,29,19,40,59,157,83,240,0.000333,0.470611,18,25413.01797,1411.834332,1411.834332,293.587747,10,0
0,0,23,23,20,29,49,181,80,261,0.000333,0.48848,20,29308.78539,1628.265855,1465.439269,227.320011,12,0
0,0,2,2,7,4,11,13,5,18,0.000333,0.020757,3,186.809307,10.378295,62.269769,27.651484,3,0
0,0,20,20,19,27,46,157,73,230,0.000333,0.423473,18,22867.5465,1270.41925,1270.41925,209.092585,10,0
0,0,3,3,13,21,34,35,33,68,0.000333,0.115316,6,2075.684839,115.315824,345.947473,140.344382,3,0
0,0,19,19,19,27,46,152,72,224,0.000333,0.412426,18,22271.00181,1237.277878,1237.277878,209.092585,9,0
0,0,7,7,13,28,41,61,51,112,0.000333,0.200015,6,3600.274947,200.015275,600.045825,182.711654,1,0
0,0,2,2,10,3,13,13,5,18,0.000333,0.022203,5,333.039575,18.502199,66.607915,37.974168,1,0
0,0,5,5,11,13,24,36,21,57,0.000333,0.087114,5,1306.714313,72.59524,261.342863,86.159464,4,0
0,0,27,27,17,39,56,142,82,224,0.000333,0.433616,16,20813.56004,1156.308891,1300.847503,275.617555,11,0
0,0,4,4,12,12,24,49,23,72,0.000333,0.110039,6,1980.7038,110.0391,330.1173,86.0391,10,0
0,0,5,5,12,12,24,58,26,84,0.000333,0.128379,12,4621.642201,256.7579,385.13685,86.0391,11,0
0,0,1,1,5,3,8,11,3,14,0.000333,0.014,2,84,4.666667,42,16.364528,2,0
0,0,2,2,7,4,11,13,5,18,0.000333,0.020757,3,186.809307,10.378295,62.269769,27.651484,3,0
0,0,2,2,9,10,19,26,14,40,0.000333,0.056639,4,679.668402,37.759356,169.917101,61.748606,1,0
0,0,5,5,13,101,114,424,267,691,0.000333,1.573842,12,56658.324,3147.684667,4721.527,720.585076,7,0
0,0,2,2,9,10,19,26,14,40,0.000333,0.056639,4,679.668402,37.759356,169.917101,61.748606,1,0
0,0,2,2,9,10,19,26,14,40,0.000333,0.056639,4,679.668402,37.759356,169.917101,61.748606,1,0
0,0,2,2,9,10,19,26,14,40,0.000333,0.056639,4,679.668402,37.759356,169.917101,61.748606,1,0
0,0,2,2,9,10,19,26,14,40,0.000333,0.056639,4,679.668402,37.759356,169.917101,61.748606,2,0
0,0,2,2,9,10,19,26,14,40,0.000333,0.056639,4,679.668402,37.759356,169.917101,61.748606,1,0
0,0,2,2,9,10,19,26,14,40,0.000333,0.056639,4,679.668402,37.759356,169.917101,61.748606,1,0
0,0,3,3,9,9,18,63,34,97,0.000333,0.134828,12,4853.792702,269.65515,404.482725,57.05865,1,0
0,0,2,2,9,10,19,26,14,40,0.000333,0.056639,4,679.668402,37.759356,169.917101,61.748606,1,0
0,0,2,2,9,10,19,26,14,40,0.000333,0.056639,4,679.668402,37.759356,169.917101,61.748606,1,0
0,0,2,2,9,10,19,26,14,40,0.000333,0.056639,4,679.668402,37.759356,169.917101,61.748606,1,0
0,0,2,2,9,10,19,26,14,40,0.000333,0.056639,4,679.668402,37.759356,169.917101,61.748606,1,0
0,0,2,2,9,10,19,26,14,40,0.000333,0.056639,4,679.668402,37.759356,169.917101,61.748606,1,0
0,0,2,2,9,10,19,26,14,40,0.000333,0.056639,4,679.668402,37.759356,169.917101,61.748606,1,0
0,0,2,2,9,10,19,26,14,40,0.000333,0.056639,4,679.668402,37.759356,169.917101,61.748606,2,0
0,0,10,10,9,14,23,123,66,189,0.000333,0.284984,16,13679.25136,759.958409,854.95321,81.832294,1,0
0,0,2,2,9,10,19,26,14,40,0.000333,0.056639,4,679.668402,37.759356,169.917101,61.748606,1,0
0,0,4,4,10,13,23,67,37,104,0.000333,0.156817,10,4704.504434,261.361357,470.450443,81.324997,1,0
0,0,2,2,9,10,19,26,14,40,0.000333,0.056639,4,679.668402,37.759356,169.917101,61.748606,1,0
0,0,2,2,9,10,19,26,14,40,0.000333,0.056639,4,679.668402,37.759356,169.917101,61.748606,1,0
0,0,3,3,11,12,23,35,18,53,0.000333,0.079916,5,1198.743918,66.596884,239.748784,81.073298,2,0
0,0,2,2,9,10,19,26,14,40,0.000333,0.056639,4,679.668402,37.759356,169.917101,61.748606,1,0
0,0,2,2,9,10,19,26,14,40,0.000333,0.056639,4,679.668402,37.759356,169.917101,61.748606,1,0
0,0,9,9,11,15,26,55,31,86,0.000333,0.134746,10,4042.378158,224.576564,404.237816,96.657107,3,0
0,0,36,36,19,41,60,204,111,315,0.000333,0.620224,18,33492.06968,1860.670538,1860.670538,300.370255,12,0
0,0,5,5,11,9,20,35,14,49,0.000333,0.070591,5,1058.872383,58.826244,211.774477,66.583073,3,0
0,0,30,30,19,34,53,158,83,241,0.000333,0.460143,18,24847.71893,1380.42883,1380.42883,253.684359,11,0
0,0,4,4,12,12,24,49,23,72,0.000333,0.110039,6,1980.7038,110.0391,330.1173,86.0391,10,0
0,0,5,5,12,12,24,58,26,84,0.000333,0.128379,12,4621.642201,256.7579,385.13685,86.0391,11,0
0,0,1,1,5,3,8,11,3,14,0.000333,0.014,2,84,4.666667,42,16.364528,2,0
0,0,3,3,9,9,18,63,34,97,0.000333,0.134828,12,4853.792702,269.65515,404.482725,57.05865,1,0
0,0,17,17,16,23,39,110,55,165,0.000333,0.290697,16,13953.46186,775.192325,872.091366,168.041925,7,0
0,0,6,6,12,12,24,62,28,90,0.000333,0.137549,12,4951.759501,275.09775,412.646625,86.0391,11,0
0,0,3,3,9,9,18,63,34,97,0.000333,0.134828,12,4853.792702,269.65515,404.482725,57.05865,1,0
0,0,2,2,9,10,19,26,14,40,0.000333,0.056639,4,679.668402,37.759356,169.917101,61.748606,2,0
0,0,3,3,11,12,23,35,18,53,0.000333,0.079916,5,1198.743918,66.596884,239.748784,81.073298,2,0
0,0,2,2,9,10,19,26,14,40,0.000333,0.056639,4,679.668402,37.759356,169.917101,61.748606,1,0
0,0,2,2,9,10,19,26,14,40,0.000333,0.056639,4,679.668402,37.759356,169.917101,61.748606,1,0
0,0,2,2,9,10,19,26,14,40,0.000333,0.056639,4,679.668402,37.759356,169.917101,61.748606,1,0
0,0,2,2,9,10,19,26,14,40,0.000333,0.056639,4,679.668402,37.759356,169.917101,61.748606,1,0
0,0,2,2,9,10,19,26,14,40,0.000333,0.056639,4,679.668402,37.759356,169.917101,61.748606,1,0
0,0,10,10,9,14,23,123,66,189,0.000333,0.284984,16,13679.25136,759.958409,854.95321,81.832294,1,0
0,0,2,2,9,10,19,26,14,40,0.000333,0.056639,4,679.668402,37.759356,169.917101,61.748606,1,0
0,0,2,2,9,10,19,26,14,40,0.000333,0.056639,4,679.668402,37.759356,169.917101,61.748606,1,0
0,0,2,2,9,10,19,26,14,40,0.000333,0.056639,4,679.668402,37.759356,169.917101,61.748606,1,0
0,0,2,2,9,10,19,26,14,40,0.000333,0.056639,4,679.668402,37.759356,169.917101,61.748606,1,0
0,0,4,4,10,13,23,67,37,104,0.000333,0.156817,10,4704.504434,261.361357,470.450443,81.324997,1,0
0,0,2,2,9,10,19,26,14,40,0.000333,0.056639,4,679.668402,37.759356,169.917101,61.748606,1,0
0,0,2,2,9,10,19,26,14,40,0.000333,0.056639,4,679.668402,37.759356,169.917101,61.748606,1,0
0,0,2,2,9,10,19,26,14,40,0.000333,0.056639,4,679.668402,37.759356,169.917101,61.748606,2,0
0,0,5,5,13,101,114,424,267,691,0.000333,1.573842,12,56658.324,3147.684667,4721.527,720.585076,7,0
0,0,2,2,9,10,19,26,14,40,0.000333,0.056639,4,679.668402,37.759356,169.917101,61.748606,1,0
0,0,2,2,9,10,19,26,14,40,0.000333,0.056639,4,679.668402,37.759356,169.917101,61.748606,1,0
0,0,2,2,9,10,19,26,14,40,0.000333,0.056639,4,679.668402,37.759356,169.917101,61.748606,1,0
0,0,2,2,9,10,19,26,14,40,0.000333,0.056639,4,679.668402,37.759356,169.917101,61.748606,1,0
0,0,2,2,9,10,19,26,14,40,0.000333,0.056639,4,679.668402,37.759356,169.917101,61.748606,1,0
0,0,2,2,9,10,19,26,14,40,0.000333,0.056639,4,679.668402,37.759356,169.917101,61.748606,1,0
0,0,9,9,13,14,27,58,33,91,0.000333,0.144232,12,5192.337152,288.463175,432.694763,101.408685,5,0
0,0,9,9,13,14,27,59,33,92,0.000333,0.145817,12,5249.395802,291.6331,437.44965,101.408685,5,0
0,0,18,18,16,24,40,112,57,169,0.000333,0.299802,16,14390.49357,799.471865,899.405848,174.0391,7,0
0,0,19,19,16,25,41,112,58,170,0.000333,0.303595,16,14572.54145,809.585636,910.783841,180.096405,7,0
0,0,2,2,11,6,17,14,8,22,0.000333,0.029975,5,449.620913,24.97894,89.924183,53.563523,2,0
0,0,4,4,11,13,24,25,17,42,0.000333,0.064189,5,962.842125,53.491229,192.568425,86.159464,3,0
0,0,19,19,16,25,41,112,58,170,0.000333,0.303595,16,14572.54145,809.585636,910.783841,180.096405,7,0
0,0,4,4,12,12,24,49,23,72,0.000333,0.110039,6,1980.7038,110.0391,330.1173,86.0391,10,0
0,0,2,2,7,4,11,13,5,18,0.000333,0.020757,3,186.809307,10.378295,62.269769,27.651484,3,0
0,0,5,5,12,12,24,58,26,84,0.000333,0.128379,12,4621.642201,256.7579,385.13685,86.0391,11,0
0,0,2,2,9,10,19,26,14,40,0.000333,0.056639,4,679.668402,37.759356,169.917101,61.748606,1,0
0,0,10,10,9,14,23,123,66,189,0.000333,0.284984,16,13679.25136,759.958409,854.95321,81.832294,1,0
0,0,2,2,9,10,19,26,14,40,0.000333,0.056639,4,679.668402,37.759356,169.917101,61.748606,1,0
0,0,4,4,10,13,23,67,37,104,0.000333,0.156817,10,4704.504434,261.361357,470.450443,81.324997,1,0
0,0,2,2,9,10,19,26,14,40,0.000333,0.056639,4,679.668402,37.759356,169.917101,61.748606,1,0
0,0,2,2,9,10,19,26,14,40,0.000333,0.056639,4,679.668402,37.759356,169.917101,61.748606,1,0
0,0,2,2,9,10,19,26,14,40,0.000333,0.056639,4,679.668402,37.759356,169.917101,61.748606,1,0
0,0,2,2,9,10,19,26,14,40,0.000333,0.056639,4,679.668402,37.759356,169.917101,61.748606,1,0
0,0,3,3,11,12,23,35,18,53,0.000333,0.079916,5,1198.743918,66.596884,239.748784,81.073298,2,0
0,0,2,2,9,10,19,26,14,40,0.000333,0.056639,4,679.668402,37.759356,169.917101,61.748606,1,0
0,0,2,2,9,10,19,26,14,40,0.000333,0.056639,4,679.668402,37.759356,169.917101,61.748606,1,0
0,0,3,3,9,9,18,63,34,97,0.000333,0.134828,12,4853.792702,269.65515,404.482725,57.05865,1,0
0,0,2,2,9,10,19,26,14,40,0.000333,0.056639,4,679.668402,37.759356,169.917101,61.748606,1,0
0,0,2,2,9,10,19,26,14,40,0.000333,0.056639,4,679.668402,37.759356,169.917101,61.748606,1,0
0,0,2,2,9,10,19,26,14,40,0.000333,0.056639,4,679.668402,37.759356,169.917101,61.748606,1,0
0,0,2,2,9,10,19,26,14,40,0.000333,0.056639,4,679.668402,37.759356,169.917101,61.748606,1,0
0,0,2,2,9,10,19,26,14,40,0.000333,0.056639,4,679.668402,37.759356,169.917101,61.748606,2,0
0,0,2,2,9,10,19,26,14,40,0.000333,0.056639,4,679.668402,37.759356,169.917101,61.748606,1,0
0,0,2,2,9,10,19,26,14,40,0.000333,0.056639,4,679.668402,37.759356,169.917101,61.748606,2,0
0,0,5,5,13,101,114,424,267,691,0.000333,1.573842,12,56658.324,3147.684667,4721.527,720.585076,7,0
0,0,2,2,9,10,19,26,14,40,0.000333,0.056639,4,679.668402,37.759356,169.917101,61.748606,1,0
0,0,2,2,9,10,19,26,14,40,0.000333,0.056639,4,679.668402,37.759356,169.917101,61.748606,1,0
0,0,2,2,9,10,19,26,14,40,0.000333,0.056639,4,679.668402,37.759356,169.917101,61.748606,1,0
0,0,2,2,9,10,19,26,14,40,0.000333,0.056639,4,679.668402,37.759356,169.917101,61.748606,1,0
0,0,4,4,11,13,24,25,17,42,0.000333,0.064189,5,962.842125,53.491229,192.568425,86.159464,2,0
0,0,2,2,7,4,11,13,5,18,0.000333,0.020757,3,186.809307,10.378295,62.269769,27.651484,3,0
0,0,2,2,11,8,19,25,12,37,0.000333,0.052391,5,785.86659,43.659255,157.173318,62.053748,2,0
0,0,5,5,12,12,24,58,26,84,0.000333,0.128379,12,4621.642201,256.7579,385.13685,86.0391,11,0
0,0,4,4,12,12,24,49,23,72,0.000333,0.110039,6,1980.7038,110.0391,330.1173,86.0391,10,0
0,0,2,2,7,4,11,13,5,18,0.000333,0.020757,3,186.809307,10.378295,62.269769,27.651484,3,0
0,0,16,16,9,20,29,105,63,168,0.000333,0.272047,12,9793.689686,544.093871,816.140807,114.967887,1,0
0,0,2,2,9,10,19,26,14,40,0.000333,0.056639,4,679.668402,37.759356,169.917101,61.748606,1,0
0,0,2,2,9,10,19,26,14,40,0.000333,0.056639,4,679.668402,37.759356,169.917101,61.748606,1,0
0,0,3,3,9,9,18,63,34,97,0.000333,0.134828,12,4853.792702,269.65515,404.482725,57.05865,1,0
0,0,2,2,9,10,19,26,14,40,0.000333,0.056639,4,679.668402,37.759356,169.917101,61.748606,1,0
0,0,2,2,9,10,19,26,14,40,0.000333,0.056639,4,679.668402,37.759356,169.917101,61.748606,1,0
0,0,10,10,9,14,23,123,66,189,0.000333,0.284984,16,13679.25136,759.958409,854.95321,81.832294,1,0
0,0,2,2,9,10,19,26,14,40,0.000333,0.056639,4,679.668402,37.759356,169.917101,61.748606,1,0
0,0,2,2,9,10,19,26,14,40,0.000333,0.056639,4,679.668402,37.759356,169.917101,61.748606,1,0
0,0,2,2,9,10,19,26,14,40,0.000333,0.056639,4,679.668402,37.759356,169.917101,61.748606,1,0
0,0,2,2,9,10,19,26,14,40,0.000333,0.056639,4,679.668402,37.759356,169.917101,61.748606,1,0
0,0,5,5,13,101,114,424,267,691,0.000333,1.573842,12,56658.324,3147.684667,4721.527,720.585076,7,0
0,0,2,2,9,10,19,26,14,40,0.000333,0.056639,4,679.668402,37.759356,169.917101,61.748606,1,0
0,0,2,2,9,10,19,26,14,40,0.000333,0.056639,4,679.668402,37.759356,169.917101,61.748606,2,0
0,0,3,3,11,12,23,35,18,53,0.000333,0.079916,5,1198.743918,66.596884,239.748784,81.073298,2,0
0,0,2,2,9,10,19,26,14,40,0.000333,0.056639,4,679.668402,37.759356,169.917101,61.748606,1,0
0,0,2,2,9,10,19,26,14,40,0.000333,0.056639,4,679.668402,37.759356,169.917101,61.748606,2,0
0,0,2,2,9,10,19,26,14,40,0.000333,0.056639,4,679.668402,37.759356,169.917101,61.748606,1,0
0,0,2,2,9,10,19,26,14,40,0.000333,0.056639,4,679.668402,37.759356,169.917101,61.748606,1,0
0,0,2,2,9,10,19,26,14,40,0.000333,0.056639,4,679.668402,37.759356,169.917101,61.748606,1,0
0,0,2,2,9,10,19,26,14,40,0.000333,0.056639,4,679.668402,37.759356,169.917101,61.748606,1,0
0,0,4,4,10,13,23,67,37,104,0.000333,0.156817,10,4704.504434,261.361357,470.450443,81.324997,1,0
0,0,2,2,9,10,19,26,14,40,0.000333,0.056639,4,679.668402,37.759356,169.917101,61.748606,1,0
0,0,2,2,9,10,19,26,14,40,0.000333,0.056639,4,679.668402,37.759356,169.917101,61.748606,1,0
0,0,2,2,9,10,19,26,14,40,0.000333,0.056639,4,679.668402,37.759356,169.917101,61.748606,1,0
0,0,2,2,7,4,11,13,5,18,0.000333,0.020757,3,186.809307,10.378295,62.269769,27.651484,3,0
0,0,4,4,11,13,24,25,17,42,0.000333,0.064189,5,962.842125,53.491229,192.568425,86.159464,4,0
0,0,26,26,17,39,56,139,77,216,0.000333,0.41813,8,10035.10931,557.506073,1254.388663,275.617555,12,0
0,0,2,2,7,4,11,13,5,18,0.000333,0.020757,3,186.809307,10.378295,62.269769,27.651484,3,0
0,0,2,2,7,4,11,13,5,18,0.000333,0.020757,3,186.809307,10.378295,62.269769,27.651484,3,0
0,0,5,5,11,13,24,26,20,46,0.000333,0.070303,5,1054.541375,58.585632,210.908275,86.159464,1,0
0,0,4,4,11,13,24,25,17,42,0.000333,0.064189,5,962.842125,53.491229,192.568425,86.159464,2,0
0,0,22,22,17,35,52,129,69,198,0.000333,0.376229,8,9029.496514,501.638695,1128.687064,249.011774,8,0
0,0,2,2,7,4,11,13,5,18,0.000333,0.020757,3,186.809307,10.378295,62.269769,27.651484,3,0
0,0,26,26,21,31,52,198,87,285,0.000333,0.541542,20,32492.50639,1805.139244,1624.62532,245.818752,12,0
0,0,3,3,13,21,34,35,33,68,0.000333,0.115316,6,2075.684839,115.315824,345.947473,140.344382,3,0
0,0,2,2,7,4,11,13,5,18,0.000333,0.020757,3,186.809307,10.378295,62.269769,27.651484,3,0
0,0,4,4,12,27,39,39,41,80,0.000333,0.140944,6,2536.993065,140.944059,422.832178,171.401513,1,0
0,0,2,2,10,3,13,13,5,18,0.000333,0.022203,5,333.039575,18.502199,66.607915,37.974168,1,0
0,0,2,2,7,6,13,12,8,20,0.000333,0.02467,3,222.026383,12.334799,74.008794,35.161259,1,0
0,0,2,2,7,7,14,13,9,22,0.000333,0.027921,3,251.285425,13.960301,83.761808,39.302969,1,0
0,0,3,3,8,7,15,18,10,28,0.000333,0.036464,4,437.571747,24.309541,109.392937,43.651484,1,0
0,0,26,26,17,33,50,140,73,213,0.000333,0.400714,16,19234.2619,1068.570105,1202.141368,235.951874,10,0
0,0,3,3,13,10,23,23,15,38,0.000333,0.057298,6,1031.372126,57.298451,171.895354,81.324997,2,0
0,0,3,3,13,11,24,28,16,44,0.000333,0.067246,6,1210.4301,67.246117,201.73835,86.159464,2,0
0,0,4,4,11,13,24,25,17,42,0.000333,0.064189,5,962.842125,53.491229,192.568425,86.159464,3,0
0,0,1,1,5,3,8,11,3,14,0.000333,0.014,2,84,4.666667,42,16.364528,2,0
0,0,4,4,12,12,24,49,23,72,0.000333,0.110039,6,1980.7038,110.0391,330.1173,86.0391,10,0
0,0,5,5,12,12,24,58,26,84,0.000333,0.128379,12,4621.642201,256.7579,385.13685,86.0391,11,0
0,0,2,2,7,4,11,13,5,18,0.000333,0.020757,3,186.809307,10.378295,62.269769,27.651484,3,0
0,0,2,2,9,10,19,26,14,40,0.000333,0.056639,4,679.668402,37.759356,169.917101,61.748606,2,0
0,0,2,2,9,10,19,26,14,40,0.000333,0.056639,4,679.668402,37.759356,169.917101,61.748606,1,0
0,0,2,2,9,10,19,26,14,40,0.000333,0.056639,4,679.668402,37.759356,169.917101,61.748606,1,0
0,0,3,3,11,12,23,35,18,53,0.000333,0.079916,5,1198.743918,66.596884,239.748784,81.073298,2,0
0,0,2,2,9,10,19,26,14,40,0.000333,0.056639,4,679.668402,37.759356,169.917101,61.748606,1,0
0,0,4,4,10,13,23,67,37,104,0.000333,0.156817,10,4704.504434,261.361357,470.450443,81.324997,1,0
0,0,10,10,9,14,23,123,66,189,0.000333,0.284984,16,13679.25136,759.958409,854.95321,81.832294,1,0
0,0,2,2,9,10,19,26,14,40,0.000333,0.056639,4,679.668402,37.759356,169.917101,61.748606,1,0
0,0,2,2,9,10,19,26,14,40,0.000333,0.056639,4,679.668402,37.759356,169.917101,61.748606,1,0
0,0,2,2,9,10,19,26,14,40,0.000333,0.056639,4,679.668402,37.759356,169.917101,61.748606,1,0
0,0,2,2,9,10,19,26,14,40,0.000333,0.056639,4,679.668402,37.759356,169.917101,61.748606,1,0
0,0,2,2,9,10,19,26,14,40,0.000333,0.056639,4,679.668402,37.759356,169.917101,61.748606,1,0
0,0,2,2,9,10,19,26,14,40,0.000333,0.056639,4,679.668402,37.759356,169.917101,61.748606,1,0
0,0,2,2,9,10,19,26,14,40,0.000333,0.056639,4,679.668402,37.759356,169.917101,61.748606,1,0
0,0,2,2,9,10,19,26,14,40,0.000333,0.056639,4,679.668402,37.759356,169.917101,61.748606,2,0
0,0,2,2,9,10,19,26,14,40,0.000333,0.056639,4,679.668402,37.759356,169.917101,61.748606,1,0
0,0,5,5,13,101,114,424,267,691,0.000333,1.573842,12,56658.324,3147.684667,4721.527,720.585076,7,0
0,0,2,2,9,10,19,26,14,40,0.000333,0.056639,4,679.668402,37.759356,169.917101,61.748606,1,0
0,0,3,3,9,9,18,63,34,97,0.000333,0.134828,12,4853.792702,269.65515,404.482725,57.05865,1,0
0,0,2,2,9,10,19,26,14,40,0.000333,0.056639,4,679.668402,37.759356,169.917101,61.748606,1,0
0,0,2,2,9,10,19,26,14,40,0.000333,0.056639,4,679.668402,37.759356,169.917101,61.748606,1,0
0,0,2,2,9,10,19,26,14,40,0.000333,0.056639,4,679.668402,37.759356,169.917101,61.748606,1,0
0,0,2,2,9,10,19,26,14,40,0.000333,0.056639,4,679.668402,37.759356,169.917101,61.748606,1,0
0,0,2,2,9,10,19,26,14,40,0.000333,0.056639,4,679.668402,37.759356,169.917101,61.748606,1,0
0,0,28,28,17,46,63,158,90,248,0.000333,0.494122,8,11858.92337,658.829076,1482.365421,323.570718,8,0
0,0,2,2,7,4,11,13,5,18,0.000333,0.020757,3,186.809307,10.378295,62.269769,27.651484,3,0
0,0,21,21,12,29,41,130,67,197,0.000333,0.351813,12,12665.25294,703.625163,1055.437745,183.900999,7,0
0,0,5,5,9,10,19,31,19,50,0.000333,0.070799,4,849.585503,47.199195,212.396376,61.748606,1,0
0,0,4,4,11,13,24,25,17,42,0.000333,0.064189,5,962.842125,53.491229,192.568425,86.159464,2,0
0,0,17,17,16,23,39,110,55,165,0.000333,0.290697,16,13953.46186,775.192325,872.091366,168.041925,7,0
0,0,2,2,7,4,11,13,5,18,0.000333,0.020757,3,186.809307,10.378295,62.269769,27.651484,3,0
0,0,1,1,5,3,8,11,3,14,0.000333,0.014,2,84,4.666667,42,16.364528,2,0
0,0,5,5,12,12,24,58,26,84,0.000333,0.128379,12,4621.642201,256.7579,385.13685,86.0391,11,0
0,0,4,4,12,12,24,49,23,72,0.000333,0.110039,6,1980.7038,110.0391,330.1173,86.0391,10,0
0,0,2,2,9,10,19,26,14,40,0.000333,0.056639,4,679.668402,37.759356,169.917101,61.748606,1,0
0,0,2,2,9,10,19,26,14,40,0.000333,0.056639,4,679.668402,37.759356,169.917101,61.748606,1,0
0,0,2,2,9,10,19,26,14,40,0.000333,0.056639,4,679.668402,37.759356,169.917101,61.748606,1,0
0,0,2,2,9,10,19,26,14,40,0.000333,0.056639,4,679.668402,37.759356,169.917101,61.748606,1,0
0,0,2,2,9,10,19,26,14,40,0.000333,0.056639,4,679.668402,37.759356,169.917101,61.748606,1,0
0,0,2,2,9,10,19,26,14,40,0.000333,0.056639,4,679.668402,37.759356,169.917101,61.748606,1,0
0,0,5,5,13,101,114,424,267,691,0.000333,1.573842,12,56658.324,3147.684667,4721.527,720.585076,7,0
0,0,2,2,9,10,19,26,14,40,0.000333,0.056639,4,679.668402,37.759356,169.917101,61.748606,2,0
0,0,2,2,9,10,19,26,14,40,0.000333,0.056639,4,679.668402,37.759356,169.917101,61.748606,1,0
0,0,2,2,9,10,19,26,14,40,0.000333,0.056639,4,679.668402,37.759356,169.917101,61.748606,1,0
0,0,2,2,9,10,19,26,14,40,0.000333,0.056639,4,679.668402,37.759356,169.917101,61.748606,1,0
0,0,2,2,9,10,19,26,14,40,0.000333,0.056639,4,679.668402,37.759356,169.917101,61.748606,1,0
0,0,10,10,9,14,23,123,66,189,0.000333,0.284984,16,13679.25136,759.958409,854.95321,81.832294,1,0
0,0,2,2,9,10,19,26,14,40,0.000333,0.056639,4,679.668402,37.759356,169.917101,61.748606,1,0
0,0,4,4,10,13,23,67,37,104,0.000333,0.156817,10,4704.504434,261.361357,470.450443,81.324997,1,0
0,0,2,2,9,10,19,26,14,40,0.000333,0.056639,4,679.668402,37.759356,169.917101,61.748606,1,0
0,0,2,2,9,10,19,26,14,40,0.000333,0.056639,4,679.668402,37.759356,169.917101,61.748606,1,0
0,0,3,3,9,9,18,63,34,97,0.000333,0.134828,12,4853.792702,269.65515,404.482725,57.05865,1,0
0,0,2,2,9,10,19,26,14,40,0.000333,0.056639,4,679.668402,37.759356,169.917101,61.748606,1,0
0,0,2,2,9,10,19,26,14,40,0.000333,0.056639,4,679.668402,37.759356,169.917101,61.748606,2,0
0,0,3,3,11,12,23,35,18,53,0.000333,0.079916,5,1198.743918,66.596884,239.748784,81.073298,2,0
0,0,2,2,9,10,19,26,14,40,0.000333,0.056639,4,679.668402,37.759356,169.917101,61.748606,1,0
0,0,2,2,9,10,19,26,14,40,0.000333,0.056639,4,679.668402,37.759356,169.917101,61.748606,1,0
0,0,2,2,9,10,19,26,14,40,0.000333,0.056639,4,679.668402,37.759356,169.917101,61.748606,1,0
0,0,7,7,10,17,27,34,26,60,0.000333,0.095098,5,1426.466251,79.248125,285.29325,102.706149,3,0
0,0,17,17,16,23,39,110,55,165,0.000333,0.290697,16,13953.46186,775.192325,872.091366,168.041925,7,0
0,0,2,2,7,4,11,13,5,18,0.000333,0.020757,3,186.809307,10.378295,62.269769,27.651484,3,0
0,0,18,18,16,24,40,111,56,167,0.000333,0.296254,16,14220.19187,790.010659,888.761992,174.0391,7,0
0,0,2,2,7,4,11,13,5,18,0.000333,0.020757,3,186.809307,10.378295,62.269769,27.651484,3,0
0,0,22,22,13,31,44,137,74,211,0.000333,0.38398,12,13823.28086,767.960048,1151.940072,201.685802,7,0
0,0,4,4,11,13,24,25,17,42,0.000333,0.064189,5,962.842125,53.491229,192.568425,86.159464,4,0
0,0,29,29,17,44,61,150,88,238,0.000333,0.470505,16,22584.24778,1254.680432,1411.515486,309.70186,12,0
0,0,2,2,7,4,11,13,5,18,0.000333,0.020757,3,186.809307,10.378295,62.269769,27.651484,3,0
0,0,4,4,12,12,24,49,23,72,0.000333,0.110039,6,1980.7038,110.0391,330.1173,86.0391,10,0
0,0,5,5,12,12,24,58,26,84,0.000333,0.128379,12,4621.642201,256.7579,385.13685,86.0391,11,0
0,0,1,1,5,3,8,11,3,14,0.000333,0.014,2,84,4.666667,42,16.364528,2,0
0,0,2,2,7,4,11,13,5,18,0.000333,0.020757,3,186.809307,10.378295,62.269769,27.651484,3,0
0,0,2,2,9,10,19,26,14,40,0.000333,0.056639,4,679.668402,37.759356,169.917101,61.748606,1,0
0,0,10,10,9,14,23,123,66,189,0.000333,0.284984,16,13679.25136,759.958409,854.95321,81.832294,1,0
0,0,2,2,9,10,19,26,14,40,0.000333,0.056639,4,679.668402,37.759356,169.917101,61.748606,1,0
0,0,3,3,11,12,23,35,18,53,0.000333,0.079916,5,1198.743918,66.596884,239.748784,81.073298,2,0
0,0,5,5,13,101,114,424,267,691,0.000333,1.573842,12,56658.324,3147.684667,4721.527,720.585076,7,0
0,0,2,2,9,10,19,26,14,40,0.000333,0.056639,4,679.668402,37.759356,169.917101,61.748606,2,0
0,0,2,2,9,10,19,26,14,40,0.000333,0.056639,4,679.668402,37.759356,169.917101,61.748606,1,0
0,0,2,2,9,10,19,26,14,40,0.000333,0.056639,4,679.668402,37.759356,169.917101,61.748606,1,0
0,0,2,2,9,10,19,26,14,40,0.000333,0.056639,4,679.668402,37.759356,169.917101,61.748606,1,0
0,0,2,2,9,10,19,26,14,40,0.000333,0.056639,4,679.668402,37.759356,169.917101,61.748606,1,0
0,0,2,2,9,10,19,26,14,40,0.000333,0.056639,4,679.668402,37.759356,169.917101,61.748606,2,0
0,0,2,2,9,10,19,26,14,40,0.000333,0.056639,4,679.668402,37.759356,169.917101,61.748606,1,0
0,0,2,2,9,10,19,26,14,40,0.000333,0.056639,4,679.668402,37.759356,169.917101,61.748606,1,0
0,0,2,2,9,10,19,26,14,40,0.000333,0.056639,4,679.668402,37.759356,169.917101,61.748606,1,0
0,0,2,2,9,10,19,26,14,40,0.000333,0.056639,4,679.668402,37.759356,169.917101,61.748606,1,0
0,0,2,2,9,10,19,26,14,40,0.000333,0.056639,4,679.668402,37.759356,169.917101,61.748606,1,0
0,0,2,2,9,10,19,26,14,40,0.000333,0.056639,4,679.668402,37.759356,169.917101,61.748606,1,0
0,0,2,2,9,10,19,26,14,40,0.000333,0.056639,4,679.668402,37.759356,169.917101,61.748606,1,0
0,0,2,2,9,10,19,26,14,40,0.000333,0.056639,4,679.668402,37.759356,169.917101,61.748606,1,0
0,0,3,3,9,9,18,63,34,97,0.000333,0.134828,12,4853.792702,269.65515,404.482725,57.05865,1,0
0,0,2,2,9,10,19,26,14,40,0.000333,0.056639,4,679.668402,37.759356,169.917101,61.748606,1,0
0,0,2,2,9,10,19,26,14,40,0.000333,0.056639,4,679.668402,37.759356,169.917101,61.748606,1,0
0,0,2,2,9,10,19,26,14,40,0.000333,0.056639,4,679.668402,37.759356,169.917101,61.748606,1,0
0,0,4,4,10,13,23,67,37,104,0.000333,0.156817,10,4704.504434,261.361357,470.450443,81.324997,1,0
0,0,2,2,7,4,11,13,5,18,0.000333,0.020757,3,186.809307,10.378295,62.269769,27.651484,3,0
0,0,4,4,12,12,24,49,23,72,0.000333,0.110039,6,1980.7038,110.0391,330.1173,86.0391,10,0
0,0,5,5,12,12,24,58,26,84,0.000333,0.128379,12,4621.642201,256.7579,385.13685,86.0391,11,0
0,0,1,1,5,3,8,11,3,14,0.000333,0.014,2,84,4.666667,42,16.364528,2,0
0,0,2,2,9,10,19,26,14,40,0.000333,0.056639,4,679.668402,37.759356,169.917101,61.748606,2,0
0,0,2,2,9,10,19,26,14,40,0.000333,0.056639,4,679.668402,37.759356,169.917101,61.748606,1,0
0,0,2,2,9,10,19,26,14,40,0.000333,0.056639,4,679.668402,37.759356,169.917101,61.748606,1,0
0,0,2,2,9,10,19,26,14,40,0.000333,0.056639,4,679.668402,37.759356,169.917101,61.748606,1,0
0,0,2,2,9,10,19,26,14,40,0.000333,0.056639,4,679.668402,37.759356,169.917101,61.748606,1,0
0,0,2,2,9,10,19,26,14,40,0.000333,0.056639,4,679.668402,37.759356,169.917101,61.748606,1,0
0,0,3,3,9,9,18,63,34,97,0.000333,0.134828,12,4853.792702,269.65515,404.482725,57.05865,1,0
0,0,2,2,9,10,19,26,14,40,0.000333,0.056639,4,679.668402,37.759356,169.917101,61.748606,1,0
0,0,5,5,13,101,114,424,267,691,0.000333,1.573842,12,56658.324,3147.684667,4721.527,720.585076,7,0
0,0,4,4,10,13,23,67,37,104,0.000333,0.156817,10,4704.504434,261.361357,470.450443,81.324997,1,0
0,0,2,2,9,10,19,26,14,40,0.000333,0.056639,4,679.668402,37.759356,169.917101,61.748606,1,0
0,0,2,2,9,10,19,26,14,40,0.000333,0.056639,4,679.668402,37.759356,169.917101,61.748606,1,0
0,0,2,2,9,10,19,26,14,40,0.000333,0.056639,4,679.668402,37.759356,169.917101,61.748606,1,0
0,0,2,2,9,10,19,26,14,40,0.000333,0.056639,4,679.668402,37.759356,169.917101,61.748606,1,0
0,0,2,2,9,10,19,26,14,40,0.000333,0.056639,4,679.668402,37.759356,169.917101,61.748606,1,0
0,0,2,2,9,10,19,26,14,40,0.000333,0.056639,4,679.668402,37.759356,169.917101,61.748606,1,0
0,0,10,10,9,14,23,123,66,189,0.000333,0.284984,16,13679.25136,759.958409,854.95321,81.832294,1,0
0,0,2,2,9,10,19,26,14,40,0.000333,0.056639,4,679.668402,37.759356,169.917101,61.748606,1,0
0,0,2,2,9,10,19,26,14,40,0.000333,0.056639,4,679.668402,37.759356,169.917101,61.748606,1,0
0,0,3,3,11,12,23,35,18,53,0.000333,0.079916,5,1198.743918,66.596884,239.748784,81.073298,2,0
0,0,2,2,9,10,19,26,14,40,0.000333,0.056639,4,679.668402,37.759356,169.917101,61.748606,1,0
0,0,2,2,9,10,19,26,14,40,0.000333,0.056639,4,679.668402,37.759356,169.917101,61.748606,1,0
0,0,2,2,9,10,19,26,14,40,0.000333,0.056639,4,679.668402,37.759356,169.917101,61.748606,1,0
0,0,2,2,9,10,19,26,14,40,0.000333,0.056639,4,679.668402,37.759356,169.917101,61.748606,2,0
0,0,19,19,16,26,42,116,58,174,0.000333,0.312754,16,15012.21171,834.011761,938.263232,186.211433,7,0
0,0,2,2,7,4,11,13,5,18,0.000333,0.020757,3,186.809307,10.378295,62.269769,27.651484,3,0
0,0,16,16,13,26,39,92,49,141,0.000333,0.248414,6,4471.450277,248.413904,745.241713,170.317149,5,0
0,0,18,18,16,24,40,111,56,167,0.000333,0.296254,16,14220.19187,790.010659,888.761992,174.0391,7,0
0,0,2,2,7,4,11,15,5,20,0.000333,0.023063,3,207.565897,11.531439,69.188632,27.651484,3,0
0,0,4,4,9,6,15,15,11,26,0.000333,0.03386,4,406.316622,22.573146,101.579155,44.0391,3,0
0,0,2,2,8,3,11,9,5,14,0.000333,0.016144,4,193.728171,10.762676,48.432043,28.754888,3,0
0,0,8,8,16,17,33,121,69,190,0.000333,0.319478,32,30669.91625,1703.884236,958.434883,133.486868,1,0
0,0,4,4,14,11,25,57,30,87,0.000333,0.134672,14,5656.216839,314.234269,404.015489,91.356717,1,0
0,0,2,2,7,4,11,13,5,18,0.000333,0.020757,3,186.809307,10.378295,62.269769,27.651484,3,0
0,0,14,14,16,20,36,94,67,161,0.000333,0.277453,24,19976.59021,1109.810567,832.357925,150.438562,1,0
0,0,20,20,16,30,46,121,62,183,0.000333,0.336937,16,16172.98941,898.499412,1010.811838,211.206718,7,0
0,0,2,2,7,4,11,13,5,18,0.000333,0.020757,3,186.809307,10.378295,62.269769,27.651484,3,0
0,0,23,23,27,41,68,210,125,335,0.000333,0.679767,39,79532.70202,4418.483446,2039.300052,348.041595,11,0
0,0,14,14,16,20,36,94,67,161,0.000333,0.277453,24,19976.59021,1109.810567,832.357925,150.438562,1,0
0,0,17,17,16,23,39,110,55,165,0.000333,0.290697,16,13953.46186,775.192325,872.091366,168.041925,7,0
0,0,2,2,7,4,11,13,5,18,0.000333,0.020757,3,186.809307,10.378295,62.269769,27.651484,3,0
0,0,17,17,15,28,43,96,52,148,0.000333,0.267696,7,5621.610286,312.311683,803.087184,193.209297,5,0
0,0,1,1,5,3,8,11,3,14,0.000333,0.014,2,84,4.666667,42,16.364528,2,0
0,0,18,18,16,24,40,111,56,167,0.000333,0.296254,16,14220.19187,790.010659,888.761992,174.0391,7,0
0,0,5,5,12,12,24,58,26,84,0.000333,0.128379,12,4621.642201,256.7579,385.13685,86.0391,11,0
0,0,4,4,12,12,24,49,23,72,0.000333,0.110039,6,1980.7038,110.0391,330.1173,86.0391,10,0
0,0,2,2,9,10,19,26,14,40,0.000333,0.056639,4,679.668402,37.759356,169.917101,61.748606,1,0
0,0,2,2,9,10,19,26,14,40,0.000333,0.056639,4,679.668402,37.759356,169.917101,61.748606,1,0
0,0,3,3,9,9,18,63,34,97,0.000333,0.134828,12,4853.792702,269.65515,404.482725,57.05865,1,0
0,0,2,2,9,10,19,26,14,40,0.000333,0.056639,4,679.668402,37.759356,169.917101,61.748606,1,0
0,0,2,2,9,10,19,26,14,40,0.000333,0.056639,4,679.668402,37.759356,169.917101,61.748606,1,0
0,0,2,2,9,10,19,26,14,40,0.000333,0.056639,4,679.668402,37.759356,169.917101,61.748606,1,0
0,0,2,2,9,10,19,26,14,40,0.000333,0.056639,4,679.668402,37.759356,169.917101,61.748606,1,0
0,0,2,2,9,10,19,26,14,40,0.000333,0.056639,4,679.668402,37.759356,169.917101,61.748606,1,0
0,0,3,3,11,12,23,35,18,53,0.000333,0.079916,5,1198.743918,66.596884,239.748784,81.073298,2,0
0,0,2,2,9,10,19,26,14,40,0.000333,0.056639,4,679.668402,37.759356,169.917101,61.748606,1,0
0,0,2,2,9,10,19,26,14,40,0.000333,0.056639,4,679.668402,37.759356,169.917101,61.748606,1,0
0,0,2,2,9,10,19,26,14,40,0.000333,0.056639,4,679.668402,37.759356,169.917101,61.748606,1,0
0,0,2,2,9,10,19,26,14,40,0.000333,0.056639,4,679.668402,37.759356,169.917101,61.748606,2,0
0,0,2,2,9,10,19,26,14,40,0.000333,0.056639,4,679.668402,37.759356,169.917101,61.748606,1,0
0,0,2,2,9,10,19,26,14,40,0.000333,0.056639,4,679.668402,37.759356,169.917101,61.748606,1,0
0,0,2,2,9,10,19,26,14,40,0.000333,0.056639,4,679.668402,37.759356,169.917101,61.748606,1,0
0,0,2,2,9,10,19,26,14,40,0.000333,0.056639,4,679.668402,37.759356,169.917101,61.748606,1,0
0,0,2,2,9,10,19,26,14,40,0.000333,0.056639,4,679.668402,37.759356,169.917101,61.748606,2,0
0,0,2,2,9,10,19,26,14,40,0.000333,0.056639,4,679.668402,37.759356,169.917101,61.748606,1,0
0,0,2,2,9,10,19,26,14,40,0.000333,0.056639,4,679.668402,37.759356,169.917101,61.748606,1,0
0,0,2,2,9,10,19,26,14,40,0.000333,0.056639,4,679.668402,37.759356,169.917101,61.748606,1,0
0,0,4,4,10,13,23,67,37,104,0.000333,0.156817,10,4704.504434,261.361357,470.450443,81.324997,1,0
0,0,10,10,9,14,23,123,66,189,0.000333,0.284984,16,13679.25136,759.958409,854.95321,81.832294,1,0
0,0,5,5,13,101,114,424,267,691,0.000333,1.573842,12,56658.324,3147.684667,4721.527,720.585076,7,0
0,0,5,5,9,9,18,20,13,33,0.000333,0.045869,4,550.4301,30.57945,137.607525,57.05865,5,0
0,0,18,18,16,24,40,111,56,167,0.000333,0.296254,16,14220.19187,790.010659,888.761992,174.0391,7,0
0,0,23,23,13,35,48,149,77,226,0.000333,0.420734,12,15146.4183,841.467683,1262.201525,227.630622,7,0
0,0,22,22,17,34,51,128,68,196,0.000333,0.370598,16,17788.72587,988.262548,1111.795367,242.460605,8,0
0,0,2,2,7,4,11,13,5,18,0.000333,0.020757,3,186.809307,10.378295,62.269769,27.651484,3,0
0,0,19,19,16,34,50,109,85,194,0.000333,0.364969,16,17518.52961,973.251645,1094.908101,236.973737,2,0
0,0,2,2,7,4,11,13,5,18,0.000333,0.020757,3,186.809307,10.378295,62.269769,27.651484,3,0
0,0,18,18,16,24,40,111,56,167,0.000333,0.296254,16,14220.19187,790.010659,888.761992,174.0391,7,0
0,0,3,3,8,5,13,13,7,20,0.000333,0.02467,4,296.035177,16.446399,74.008794,35.60964,2,0
0,0,19,19,16,26,42,116,58,174,0.000333,0.312754,16,15012.21171,834.011761,938.263232,186.211433,7,0
0,0,2,2,7,4,11,13,5,18,0.000333,0.020757,3,186.809307,10.378295,62.269769,27.651484,3,0
0,0,16,16,14,30,44,101,53,154,0.000333,0.280251,7,5885.267285,326.959294,840.752469,200.509687,6,0
0,0,7,7,12,19,31,51,37,88,0.000333,0.145323,6,2615.815652,145.323092,435.969275,123.730173,5,0
0,0,2,2,7,4,11,13,5,18,0.000333,0.020757,3,186.809307,10.378295,62.269769,27.651484,3,0
0,0,18,18,16,24,40,111,56,167,0.000333,0.296254,16,14220.19187,790.010659,888.761992,174.0391,7,0
0,0,1,1,5,3,8,11,3,14,0.000333,0.014,2,84,4.666667,42,16.364528,2,0
0,0,18,18,16,24,40,111,56,167,0.000333,0.296254,16,14220.19187,790.010659,888.761992,174.0391,7,0
0,0,4,4,12,12,24,49,23,72,0.000333,0.110039,6,1980.7038,110.0391,330.1173,86.0391,10,0
0,0,5,5,12,12,24,58,26,84,0.000333,0.128379,12,4621.642201,256.7579,385.13685,86.0391,11,0
0,0,2,2,9,10,19,26,14,40,0.000333,0.056639,4,679.668402,37.759356,169.917101,61.748606,1,0
0,0,2,2,9,10,19,26,14,40,0.000333,0.056639,4,679.668402,37.759356,169.917101,61.748606,1,0
0,0,3,3,9,9,18,63,34,97,0.000333,0.134828,12,4853.792702,269.65515,404.482725,57.05865,1,0
0,0,2,2,9,10,19,26,14,40,0.000333,0.056639,4,679.668402,37.759356,169.917101,61.748606,2,0
0,0,3,3,11,12,23,35,18,53,0.000333,0.079916,5,1198.743918,66.596884,239.748784,81.073298,2,0
0,0,2,2,9,10,19,26,14,40,0.000333,0.056639,4,679.668402,37.759356,169.917101,61.748606,1,0
0,0,2,2,9,10,19,26,14,40,0.000333,0.056639,4,679.668402,37.759356,169.917101,61.748606,1,0
0,0,2,2,9,10,19,26,14,40,0.000333,0.056639,4,679.668402,37.759356,169.917101,61.748606,1,0
0,0,4,4,10,13,23,67,37,104,0.000333,0.156817,10,4704.504434,261.361357,470.450443,81.324997,1,0
0,0,10,10,9,14,23,123,66,189,0.000333,0.284984,16,13679.25136,759.958409,854.95321,81.832294,1,0
0,0,2,2,9,10,19,26,14,40,0.000333,0.056639,4,679.668402,37.759356,169.917101,61.748606,1,0
0,0,2,2,9,10,19,26,14,40,0.000333,0.056639,4,679.668402,37.759356,169.917101,61.748606,1,0
0,0,2,2,9,10,19,26,14,40,0.000333,0.056639,4,679.668402,37.759356,169.917101,61.748606,1,0
0,0,5,5,13,101,114,424,267,691,0.000333,1.573842,12,56658.324,3147.684667,4721.527,720.585076,7,0
0,0,2,2,9,10,19,26,14,40,0.000333,0.056639,4,679.668402,37.759356,169.917101,61.748606,1,0
0,0,2,2,9,10,19,26,14,40,0.000333,0.056639,4,679.668402,37.759356,169.917101,61.748606,1,0
0,0,2,2,9,10,19,26,14,40,0.000333,0.056639,4,679.668402,37.759356,169.917101,61.748606,1,0
0,0,2,2,9,10,19,26,14,40,0.000333,0.056639,4,679.668402,37.759356,169.917101,61.748606,1,0
0,0,2,2,9,10,19,26,14,40,0.000333,0.056639,4,679.668402,37.759356,169.917101,61.748606,1,0
0,0,2,2,9,10,19,26,14,40,0.000333,0.056639,4,679.668402,37.759356,169.917101,61.748606,2,0
0,0,2,2,9,10,19,26,14,40,0.000333,0.056639,4,679.668402,37.759356,169.917101,61.748606,1,0
0,0,2,2,9,10,19,26,14,40,0.000333,0.056639,4,679.668402,37.759356,169.917101,61.748606,1,0
0,0,2,2,9,10,19,26,14,40,0.000333,0.056639,4,679.668402,37.759356,169.917101,61.748606,1,0
0,0,2,2,9,10,19,26,14,40,0.000333,0.056639,4,679.668402,37.759356,169.917101,61.748606,1,0
0,0,2,2,7,4,11,13,5,18,0.000333,0.020757,3,186.809307,10.378295,62.269769,27.651484,3,0
0,0,5,5,9,12,21,32,21,53,0.000333,0.077598,4,931.171294,51.731739,232.792823,71.548875,1,0
0,0,2,2,7,4,11,13,5,18,0.000333,0.020757,3,186.809307,10.378295,62.269769,27.651484,3,0
0,0,8,8,11,15,26,41,27,68,0.000333,0.106543,5,1598.149504,88.786084,319.629901,96.657107,2,0
0,0,4,4,11,13,24,25,17,42,0.000333,0.064189,5,962.842125,53.491229,192.568425,86.159464,2,0
0,0,18,18,16,24,40,111,56,167,0.000333,0.296254,16,14220.19187,790.010659,888.761992,174.0391,7,0
0,0,2,2,7,4,11,13,5,18,0.000333,0.020757,3,186.809307,10.378295,62.269769,27.651484,3,0
0,0,4,4,12,12,24,49,23,72,0.000333,0.110039,6,1980.7038,110.0391,330.1173,86.0391,10,0
0,0,5,5,12,12,24,58,26,84,0.000333,0.128379,12,4621.642201,256.7579,385.13685,86.0391,11,0
0,0,18,18,16,24,40,111,56,167,0.000333,0.296254,16,14220.19187,790.010659,888.761992,174.0391,7,0
0,0,1,1,5,3,8,11,3,14,0.000333,0.014,2,84,4.666667,42,16.364528,2,0
0,0,2,2,9,10,19,26,14,40,0.000333,0.056639,4,679.668402,37.759356,169.917101,61.748606,1,0
0,0,3,3,9,9,18,63,34,97,0.000333,0.134828,12,4853.792702,269.65515,404.482725,57.05865,1,0
0,0,2,2,9,10,19,26,14,40,0.000333,0.056639,4,679.668402,37.759356,169.917101,61.748606,1,0
0,0,2,2,9,10,19,26,14,40,0.000333,0.056639,4,679.668402,37.759356,169.917101,61.748606,2,0
0,0,2,2,9,10,19,26,14,40,0.000333,0.056639,4,679.668402,37.759356,169.917101,61.748606,1,0
0,0,2,2,9,10,19,26,14,40,0.000333,0.056639,4,679.668402,37.759356,169.917101,61.748606,1,0
0,0,2,2,9,10,19,26,14,40,0.000333,0.056639,4,679.668402,37.759356,169.917101,61.748606,1,0
0,0,4,4,10,13,23,67,37,104,0.000333,0.156817,10,4704.504434,261.361357,470.450443,81.324997,1,0
0,0,10,10,9,14,23,123,66,189,0.000333,0.284984,16,13679.25136,759.958409,854.95321,81.832294,1,0
0,0,2,2,9,10,19,26,14,40,0.000333,0.056639,4,679.668402,37.759356,169.917101,61.748606,1,0
0,0,2,2,9,10,19,26,14,40,0.000333,0.056639,4,679.668402,37.759356,169.917101,61.748606,1,0
0,0,2,2,9,10,19,26,14,40,0.000333,0.056639,4,679.668402,37.759356,169.917101,61.748606,1,0
0,0,2,2,9,10,19,26,14,40,0.000333,0.056639,4,679.668402,37.759356,169.917101,61.748606,1,0
0,0,2,2,9,10,19,26,14,40,0.000333,0.056639,4,679.668402,37.759356,169.917101,61.748606,1,0
0,0,2,2,9,10,19,26,14,40,0.000333,0.056639,4,679.668402,37.759356,169.917101,61.748606,1,0
0,0,2,2,9,10,19,26,14,40,0.000333,0.056639,4,679.668402,37.759356,169.917101,61.748606,1,0
0,0,2,2,9,10,19,26,14,40,0.000333,0.056639,4,679.668402,37.759356,169.917101,61.748606,1,0
0,0,2,2,9,10,19,26,14,40,0.000333,0.056639,4,679.668402,37.759356,169.917101,61.748606,1,0
0,0,2,2,9,10,19,26,14,40,0.000333,0.056639,4,679.668402,37.759356,169.917101,61.748606,2,0
0,0,2,2,9,10,19,26,14,40,0.000333,0.056639,4,679.668402,37.759356,169.917101,61.748606,1,0
0,0,3,3,11,12,23,35,18,53,0.000333,0.079916,5,1198.743918,66.596884,239.748784,81.073298,2,0
0,0,5,5,13,101,114,424,267,691,0.000333,1.573842,12,56658.324,3147.684667,4721.527,720.585076,7,0
0,0,2,2,9,10,19,26,14,40,0.000333,0.056639,4,679.668402,37.759356,169.917101,61.748606,1,0
0,0,2,2,9,10,19,26,14,40,0.000333,0.056639,4,679.668402,37.759356,169.917101,61.748606,1,0
0,0,18,18,16,24,40,111,56,167,0.000333,0.296254,16,14220.19187,790.010659,888.761992,174.0391,7,0
0,0,5,5,9,7,16,19,11,30,0.000333,0.04,4,480,26.666667,120,48.180809,4,0
0,0,4,4,11,13,24,25,17,42,0.000333,0.064189,5,962.842125,53.491229,192.568425,86.159464,2,0
0,0,17,17,16,23,39,110,55,165,0.000333,0.290697,16,13953.46186,775.192325,872.091366,168.041925,7,0
0,0,2,2,7,4,11,13,5,18,0.000333,0.020757,3,186.809307,10.378295,62.269769,27.651484,3,0
0,0,17,17,16,23,39,110,55,165,0.000333,0.290697,16,13953.46186,775.192325,872.091366,168.041925,7,0
0,0,6,6,12,12,24,33,17,50,0.000333,0.076416,6,1375.48875,76.416042,229.248125,86.0391,2,0
0,0,22,22,13,30,43,136,73,209,0.000333,0.37803,12,13609.07201,756.059556,1134.089334,195.312434,13,0
0,0,22,22,17,34,51,128,68,196,0.000333,0.370598,16,17788.72587,988.262548,1111.795367,242.460605,9,0
0,0,2,2,7,4,11,13,5,18,0.000333,0.020757,3,186.809307,10.378295,62.269769,27.651484,3,0
0,0,18,18,16,24,40,111,56,167,0.000333,0.296254,16,14220.19187,790.010659,888.761992,174.0391,7,0
0,0,4,4,11,13,24,25,17,42,0.000333,0.064189,5,962.842125,53.491229,192.568425,86.159464,2,0
0,0,2,2,7,4,11,13,5,18,0.000333,0.020757,3,186.809307,10.378295,62.269769,27.651484,3,0
0,0,17,17,16,23,39,110,55,165,0.000333,0.290697,16,13953.46186,775.192325,872.091366,168.041925,7,0
0,0,7,7,10,11,21,34,20,54,0.000333,0.079062,5,1185.925704,65.884761,237.185141,71.273029,1,0
0,0,2,2,7,4,11,13,5,18,0.000333,0.020757,3,186.809307,10.378295,62.269769,27.651484,3,0
0,0,18,18,16,24,40,111,56,167,0.000333,0.296254,16,14220.19187,790.010659,888.761992,174.0391,7,0
0,0,18,18,16,24,40,111,56,167,0.000333,0.296254,16,14220.19187,790.010659,888.761992,174.0391,7,0
0,0,2,2,6,5,11,11,6,17,0.000333,0.019603,3,176.431013,9.801723,58.810338,27.119415,3,0
0,0,3,3,7,7,14,16,10,26,0.000333,0.032997,3,296.973684,16.498538,98.991228,39.302969,1,0
0,0,4,4,11,13,24,25,17,42,0.000333,0.064189,5,962.842125,53.491229,192.568425,86.159464,2,0
0,0,18,18,16,24,40,111,56,167,0.000333,0.296254,16,14220.19187,790.010659,888.761992,174.0391,7,0
0,0,2,2,7,4,11,13,5,18,0.000333,0.020757,3,186.809307,10.378295,62.269769,27.651484,3,0
0,0,17,17,17,34,51,110,62,172,0.000333,0.325219,8,7805.257271,433.625404,975.657159,242.460605,3,0
0,0,4,4,11,13,24,25,17,42,0.000333,0.064189,5,962.842125,53.491229,192.568425,86.159464,2,0
0,0,2,2,7,4,11,13,5,18,0.000333,0.020757,3,186.809307,10.378295,62.269769,27.651484,3,0
0,0,18,18,16,24,40,111,56,167,0.000333,0.296254,16,14220.19187,790.010659,888.761992,174.0391,7,0
0,0,14,14,16,27,43,77,51,128,0.000333,0.231521,8,5556.495109,308.694173,694.561889,192.381963,6,0
0,0,18,18,16,24,40,111,56,167,0.000333,0.296254,16,14220.19187,790.010659,888.761992,174.0391,7,0
0,0,2,2,7,4,11,13,5,18,0.000333,0.020757,3,186.809307,10.378295,62.269769,27.651484,3,0
0,0,28,28,16,37,53,147,89,236,0.000333,0.450596,16,21628.62764,1201.590424,1351.789227,256.749775,13,0
0,0,18,18,16,24,40,111,56,167,0.000333,0.296254,16,14220.19187,790.010659,888.761992,174.0391,7,0
0,0,2,2,7,4,11,13,5,18,0.000333,0.020757,3,186.809307,10.378295,62.269769,27.651484,3,0
0,0,15,15,12,24,36,89,46,135,0.000333,0.232647,6,4187.639251,232.646625,697.939875,153.05865,5,0
0,0,2,2,7,4,11,13,5,18,0.000333,0.020757,3,186.809307,10.378295,62.269769,27.651484,3,0
0,0,2,2,7,4,11,13,5,18,0.000333,0.020757,3,186.809307,10.378295,62.269769,27.651484,3,0
0,0,4,4,10,9,19,30,15,45,0.000333,0.063719,5,955.783691,53.099094,191.156738,61.748606,1,0
0,0,4,4,11,13,24,25,17,42,0.000333,0.064189,5,962.842125,53.491229,192.568425,86.159464,2,0
0,0,17,17,16,23,39,110,55,165,0.000333,0.290697,16,13953.46186,775.192325,872.091366,168.041925,7,0
0,0,2,2,7,4,11,13,5,18,0.000333,0.020757,3,186.809307,10.378295,62.269769,27.651484,3,0
0,0,4,4,11,13,24,25,17,42,0.000333,0.064189,5,962.842125,53.491229,192.568425,86.159464,2,0
0,0,1,1,5,3,8,11,3,14,0.000333,0.014,2,84,4.666667,42,16.364528,2,0
0,0,18,18,16,24,40,111,56,167,0.000333,0.296254,16,14220.19187,790.010659,888.761992,174.0391,7,0
0,0,4,4,12,12,24,49,23,72,0.000333,0.110039,6,1980.7038,110.0391,330.1173,86.0391,10,0
0,0,5,5,12,12,24,58,26,84,0.000333,0.128379,12,4621.642201,256.7579,385.13685,86.0391,11,0
0,0,2,2,7,4,11,13,5,18,0.000333,0.020757,3,186.809307,10.378295,62.269769,27.651484,3,0
0,0,2,2,9,10,19,26,14,40,0.000333,0.056639,4,679.668402,37.759356,169.917101,61.748606,2,0
0,0,2,2,9,10,19,26,14,40,0.000333,0.056639,4,679.668402,37.759356,169.917101,61.748606,1,0
0,0,2,2,9,10,19,26,14,40,0.000333,0.056639,4,679.668402,37.759356,169.917101,61.748606,1,0
0,0,3,3,11,12,23,35,18,53,0.000333,0.079916,5,1198.743918,66.596884,239.748784,81.073298,2,0
0,0,2,2,9,10,19,26,14,40,0.000333,0.056639,4,679.668402,37.759356,169.917101,61.748606,1,0
0,0,4,4,10,13,23,67,37,104,0.000333,0.156817,10,4704.504434,261.361357,470.450443,81.324997,1,0
0,0,10,10,9,14,23,123,66,189,0.000333,0.284984,16,13679.25136,759.958409,854.95321,81.832294,1,0
0,0,2,2,9,10,19,26,14,40,0.000333,0.056639,4,679.668402,37.759356,169.917101,61.748606,1,0
0,0,2,2,9,10,19,26,14,40,0.000333,0.056639,4,679.668402,37.759356,169.917101,61.748606,1,0
0,0,2,2,9,10,19,26,14,40,0.000333,0.056639,4,679.668402,37.759356,169.917101,61.748606,1,0
0,0,2,2,9,10,19,26,14,40,0.000333,0.056639,4,679.668402,37.759356,169.917101,61.748606,1,0
0,0,2,2,9,10,19,26,14,40,0.000333,0.056639,4,679.668402,37.759356,169.917101,61.748606,1,0
0,0,2,2,9,10,19,26,14,40,0.000333,0.056639,4,679.668402,37.759356,169.917101,61.748606,1,0
0,0,2,2,9,10,19,26,14,40,0.000333,0.056639,4,679.668402,37.759356,169.917101,61.748606,1,0
0,0,2,2,9,10,19,26,14,40,0.000333,0.056639,4,679.668402,37.759356,169.917101,61.748606,2,0
0,0,2,2,9,10,19,26,14,40,0.000333,0.056639,4,679.668402,37.759356,169.917101,61.748606,1,0
0,0,5,5,13,101,114,424,267,691,0.000333,1.573842,12,56658.324,3147.684667,4721.527,720.585076,7,0
0,0,2,2,9,10,19,26,14,40,0.000333,0.056639,4,679.668402,37.759356,169.917101,61.748606,1,0
0,0,3,3,9,9,18,63,34,97,0.000333,0.134828,12,4853.792702,269.65515,404.482725,57.05865,1,0
0,0,2,2,9,10,19,26,14,40,0.000333,0.056639,4,679.668402,37.759356,169.917101,61.748606,1,0
0,0,2,2,9,10,19,26,14,40,0.000333,0.056639,4,679.668402,37.759356,169.917101,61.748606,1,0
0,0,2,2,9,10,19,26,14,40,0.000333,0.056639,4,679.668402,37.759356,169.917101,61.748606,1,0
0,0,2,2,9,10,19,26,14,40,0.000333,0.056639,4,679.668402,37.759356,169.917101,61.748606,1,0
0,0,2,2,9,10,19,26,14,40,0.000333,0.056639,4,679.668402,37.759356,169.917101,61.748606,1,0
0,0,4,4,12,12,24,49,23,72,0.000333,0.110039,6,1980.7038,110.0391,330.1173,86.0391,10,0
0,0,5,5,12,12,24,58,26,84,0.000333,0.128379,12,4621.642201,256.7579,385.13685,86.0391,11,0
0,0,1,1,5,3,8,11,3,14,0.000333,0.014,2,84,4.666667,42,16.364528,2,0
0,0,2,2,7,4,11,13,5,18,0.000333,0.020757,3,186.809307,10.378295,62.269769,27.651484,3,0
0,0,2,2,9,10,19,26,14,40,0.000333,0.056639,4,679.668402,37.759356,169.917101,61.748606,1,0
0,0,10,10,9,14,23,123,66,189,0.000333,0.284984,16,13679.25136,759.958409,854.95321,81.832294,1,0
0,0,2,2,9,10,19,26,14,40,0.000333,0.056639,4,679.668402,37.759356,169.917101,61.748606,1,0
0,0,3,3,11,12,23,35,18,53,0.000333,0.079916,5,1198.743918,66.596884,239.748784,81.073298,2,0
0,0,5,5,13,101,114,424,267,691,0.000333,1.573842,12,56658.324,3147.684667,4721.527,720.585076,7,0
0,0,2,2,9,10,19,26,14,40,0.000333,0.056639,4,679.668402,37.759356,169.917101,61.748606,2,0
0,0,2,2,9,10,19,26,14,40,0.000333,0.056639,4,679.668402,37.759356,169.917101,61.748606,1,0
0,0,2,2,9,10,19,26,14,40,0.000333,0.056639,4,679.668402,37.759356,169.917101,61.748606,1,0
0,0,2,2,9,10,19,26,14,40,0.000333,0.056639,4,679.668402,37.759356,169.917101,61.748606,1,0
0,0,2,2,9,10,19,26,14,40,0.000333,0.056639,4,679.668402,37.759356,169.917101,61.748606,1,0
0,0,2,2,9,10,19,26,14,40,0.000333,0.056639,4,679.668402,37.759356,169.917101,61.748606,2,0
0,0,2,2,9,10,19,26,14,40,0.000333,0.056639,4,679.668402,37.759356,169.917101,61.748606,1,0
0,0,2,2,9,10,19,26,14,40,0.000333,0.056639,4,679.668402,37.759356,169.917101,61.748606,1,0
0,0,2,2,9,10,19,26,14,40,0.000333,0.056639,4,679.668402,37.759356,169.917101,61.748606,1,0
0,0,2,2,9,10,19,26,14,40,0.000333,0.056639,4,679.668402,37.759356,169.917101,61.748606,1,0
0,0,2,2,9,10,19,26,14,40,0.000333,0.056639,4,679.668402,37.759356,169.917101,61.748606,1,0
0,0,2,2,9,10,19,26,14,40,0.000333,0.056639,4,679.668402,37.759356,169.917101,61.748606,1,0
0,0,2,2,9,10,19,26,14,40,0.000333,0.056639,4,679.668402,37.759356,169.917101,61.748606,1,0
0,0,2,2,9,10,19,26,14,40,0.000333,0.056639,4,679.668402,37.759356,169.917101,61.748606,1,0
0,0,3,3,9,9,18,63,34,97,0.000333,0.134828,12,4853.792702,269.65515,404.482725,57.05865,1,0
0,0,2,2,9,10,19,26,14,40,0.000333,0.056639,4,679.668402,37.759356,169.917101,61.748606,1,0
0,0,2,2,9,10,19,26,14,40,0.000333,0.056639,4,679.668402,37.759356,169.917101,61.748606,1,0
0,0,2,2,9,10,19,26,14,40,0.000333,0.056639,4,679.668402,37.759356,169.917101,61.748606,1,0
0,0,4,4,10,13,23,67,37,104,0.000333,0.156817,10,4704.504434,261.361357,470.450443,81.324997,1,0
0,0,20,20,19,28,47,142,60,202,0.000333,0.374009,18,20196.48507,1122.026948,1122.026948,215.316561,9,0
0,0,18,18,16,24,40,111,56,167,0.000333,0.296254,16,14220.19187,790.010659,888.761992,174.0391,7,0
0,0,3,3,13,21,34,35,33,68,0.000333,0.115316,6,2075.684839,115.315824,345.947473,140.344382,3,0
0,0,2,2,7,4,11,13,5,18,0.000333,0.020757,3,186.809307,10.378295,62.269769,27.651484,3,0
0,0,4,4,12,27,39,39,41,80,0.000333,0.140944,6,2536.993065,140.944059,422.832178,171.401513,1,0
0,0,2,2,10,3,13,13,5,18,0.000333,0.022203,5,333.039575,18.502199,66.607915,37.974168,1,0
0,0,1,1,5,3,8,11,3,14,0.000333,0.014,2,84,4.666667,42,16.364528,2,0
0,0,25,25,17,33,50,135,71,206,0.000333,0.387545,16,18602.15,1033.452778,1162.634375,235.951874,10,0
0,0,4,4,12,12,24,49,23,72,0.000333,0.110039,6,1980.7038,110.0391,330.1173,86.0391,10,0
0,0,5,5,12,12,24,58,26,84,0.000333,0.128379,12,4621.642201,256.7579,385.13685,86.0391,11,0
0,0,6,6,9,11,20,28,16,44,0.000333,0.063388,4,760.659345,42.258852,190.164836,66.583073,2,0
0,0,2,2,9,10,19,26,14,40,0.000333,0.056639,4,679.668402,37.759356,169.917101,61.748606,1,0
0,0,3,3,11,12,23,35,18,53,0.000333,0.079916,5,1198.743918,66.596884,239.748784,81.073298,2,0
0,0,2,2,9,10,19,26,14,40,0.000333,0.056639,4,679.668402,37.759356,169.917101,61.748606,1,0
0,0,4,4,10,13,23,67,37,104,0.000333,0.156817,10,4704.504434,261.361357,470.450443,81.324997,1,0
0,0,2,2,9,10,19,26,14,40,0.000333,0.056639,4,679.668402,37.759356,169.917101,61.748606,1,0
0,0,2,2,9,10,19,26,14,40,0.000333,0.056639,4,679.668402,37.759356,169.917101,61.748606,1,0
0,0,2,2,9,10,19,26,14,40,0.000333,0.056639,4,679.668402,37.759356,169.917101,61.748606,1,0
0,0,2,2,9,10,19,26,14,40,0.000333,0.056639,4,679.668402,37.759356,169.917101,61.748606,1,0
0,0,2,2,9,10,19,26,14,40,0.000333,0.056639,4,679.668402,37.759356,169.917101,61.748606,1,0
0,0,2,2,9,10,19,26,14,40,0.000333,0.056639,4,679.668402,37.759356,169.917101,61.748606,1,0
0,0,2,2,9,10,19,26,14,40,0.000333,0.056639,4,679.668402,37.759356,169.917101,61.748606,2,0
0,0,2,2,9,10,19,26,14,40,0.000333,0.056639,4,679.668402,37.759356,169.917101,61.748606,1,0
0,0,2,2,9,10,19,26,14,40,0.000333,0.056639,4,679.668402,37.759356,169.917101,61.748606,1,0
0,0,2,2,9,10,19,26,14,40,0.000333,0.056639,4,679.668402,37.759356,169.917101,61.748606,2,0
0,0,5,5,13,101,114,424,267,691,0.000333,1.573842,12,56658.324,3147.684667,4721.527,720.585076,7,0
0,0,10,10,9,14,23,123,66,189,0.000333,0.284984,16,13679.25136,759.958409,854.95321,81.832294,1,0
0,0,2,2,9,10,19,26,14,40,0.000333,0.056639,4,679.668402,37.759356,169.917101,61.748606,1,0
0,0,2,2,9,10,19,26,14,40,0.000333,0.056639,4,679.668402,37.759356,169.917101,61.748606,1,0
0,0,2,2,9,10,19,26,14,40,0.000333,0.056639,4,679.668402,37.759356,169.917101,61.748606,1,0
0,0,2,2,9,10,19,26,14,40,0.000333,0.056639,4,679.668402,37.759356,169.917101,61.748606,1,0
0,0,2,2,9,10,19,26,14,40,0.000333,0.056639,4,679.668402,37.759356,169.917101,61.748606,1,0
0,0,2,2,9,10,19,26,14,40,0.000333,0.056639,4,679.668402,37.759356,169.917101,61.748606,1,0
0,0,2,2,9,10,19,26,14,40,0.000333,0.056639,4,679.668402,37.759356,169.917101,61.748606,1,0
0,0,3,3,9,9,18,63,34,97,0.000333,0.134828,12,4853.792702,269.65515,404.482725,57.05865,1,0
0,0,1,1,5,3,8,11,3,14,0.000333,0.014,2,84,4.666667,42,16.364528,2,0
0,0,2,2,7,4,11,13,5,18,0.000333,0.020757,3,186.809307,10.378295,62.269769,27.651484,3,0
0,0,4,4,12,12,24,49,23,72,0.000333,0.110039,6,1980.7038,110.0391,330.1173,86.0391,10,0
0,0,5,5,12,12,24,58,26,84,0.000333,0.128379,12,4621.642201,256.7579,385.13685,86.0391,11,0
0,0,11,11,9,18,27,56,37,93,0.000333,0.147402,8,3537.636302,196.53535,442.204538,103.587975,1,0
0,0,2,2,9,10,19,26,14,40,0.000333,0.056639,4,679.668402,37.759356,169.917101,61.748606,1,0
0,0,2,2,9,10,19,26,14,40,0.000333,0.056639,4,679.668402,37.759356,169.917101,61.748606,1,0
0,0,2,2,9,10,19,26,14,40,0.000333,0.056639,4,679.668402,37.759356,169.917101,61.748606,2,0
0,0,2,2,9,10,19,26,14,40,0.000333,0.056639,4,679.668402,37.759356,169.917101,61.748606,1,0
0,0,2,2,9,10,19,26,14,40,0.000333,0.056639,4,679.668402,37.759356,169.917101,61.748606,1,0
0,0,2,2,9,10,19,26,14,40,0.000333,0.056639,4,679.668402,37.759356,169.917101,61.748606,1,0
0,0,2,2,9,10,19,26,14,40,0.000333,0.056639,4,679.668402,37.759356,169.917101,61.748606,1,0
0,0,2,2,9,10,19,26,14,40,0.000333,0.056639,4,679.668402,37.759356,169.917101,61.748606,1,0
0,0,2,2,9,10,19,26,14,40,0.000333,0.056639,4,679.668402,37.759356,169.917101,61.748606,1,0
0,0,2,2,9,10,19,26,14,40,0.000333,0.056639,4,679.668402,37.759356,169.917101,61.748606,1,0
0,0,2,2,9,10,19,26,14,40,0.000333,0.056639,4,679.668402,37.759356,169.917101,61.748606,1,0
0,0,5,5,13,101,114,424,267,691,0.000333,1.573842,12,56658.324,3147.684667,4721.527,720.585076,7,0
0,0,2,2,9,10,19,26,14,40,0.000333,0.056639,4,679.668402,37.759356,169.917101,61.748606,1,0
0,0,2,2,9,10,19,26,14,40,0.000333,0.056639,4,679.668402,37.759356,169.917101,61.748606,1,0
0,0,2,2,9,10,19,26,14,40,0.000333,0.056639,4,679.668402,37.759356,169.917101,61.748606,1,0
0,0,2,2,9,10,19,26,14,40,0.000333,0.056639,4,679.668402,37.759356,169.917101,61.748606,1,0
0,0,2,2,9,10,19,26,14,40,0.000333,0.056639,4,679.668402,37.759356,169.917101,61.748606,1,0
0,0,2,2,9,10,19,26,14,40,0.000333,0.056639,4,679.668402,37.759356,169.917101,61.748606,1,0
0,0,2,2,9,10,19,26,14,40,0.000333,0.056639,4,679.668402,37.759356,169.917101,61.748606,1,0
0,0,2,2,9,10,19,26,14,40,0.000333,0.056639,4,679.668402,37.759356,169.917101,61.748606,2,0
0,0,4,4,10,13,23,67,37,104,0.000333,0.156817,10,4704.504434,261.361357,470.450443,81.324997,1,0
0,0,3,3,9,9,18,63,34,97,0.000333,0.134828,12,4853.792702,269.65515,404.482725,57.05865,1,0
0,0,10,10,9,14,23,123,66,189,0.000333,0.284984,16,13679.25136,759.958409,854.95321,81.832294,1,0
0,0,3,3,11,12,23,35,18,53,0.000333,0.079916,5,1198.743918,66.596884,239.748784,81.073298,2,0
0,0,4,4,11,13,24,25,17,42,0.000333,0.064189,5,962.842125,53.491229,192.568425,86.159464,2,0
0,0,18,18,16,24,40,111,56,167,0.000333,0.296254,16,14220.19187,790.010659,888.761992,174.0391,7,0
0,0,26,26,21,31,52,198,87,285,0.000333,0.541542,20,32492.50639,1805.139244,1624.62532,245.818752,12,0
0,0,3,3,13,21,34,35,33,68,0.000333,0.115316,6,2075.684839,115.315824,345.947473,140.344382,3,0
0,0,2,2,7,4,11,13,5,18,0.000333,0.020757,3,186.809307,10.378295,62.269769,27.651484,3,0
0,0,4,4,12,27,39,39,41,80,0.000333,0.140944,6,2536.993065,140.944059,422.832178,171.401513,1,0
0,0,5,5,9,9,18,31,18,49,0.000333,0.068109,8,1634.610601,90.8117,204.326325,57.05865,1,0
0,0,2,2,10,3,13,13,5,18,0.000333,0.022203,5,333.039575,18.502199,66.607915,37.974168,1,0
0,0,4,4,11,13,24,25,17,42,0.000333,0.064189,5,962.842125,53.491229,192.568425,86.159464,2,0
0,0,2,2,7,4,11,13,5,18,0.000333,0.020757,3,186.809307,10.378295,62.269769,27.651484,3,0
0,0,18,18,16,24,40,111,56,167,0.000333,0.296254,16,14220.19187,790.010659,888.761992,174.0391,7,0
0,0,18,18,16,24,40,111,56,167,0.000333,0.296254,16,14220.19187,790.010659,888.761992,174.0391,7,0
0,0,2,2,7,4,11,13,5,18,0.000333,0.020757,3,186.809307,10.378295,62.269769,27.651484,3,0
0,0,22,22,27,38,65,305,199,504,0.000333,1.011758,65,197292.7696,10960.70942,3035.273378,327.803208,10,0
0,0,59,59,28,80,108,635,432,1067,0.000333,2.402488,70,504522.5475,28029.03042,7207.464965,640.360185,10,0
0,0,26,26,27,41,68,338,218,556,0.000333,1.12821,65,220000.9071,12222.27262,3384.62934,348.041595,10,0
0,0,30,30,27,49,76,470,316,786,0.000333,1.636957,78,383047.94,21280.44111,4910.871026,403.502745,10,0
0,0,3,3,10,17,27,36,24,60,0.000333,0.095098,5,1426.466251,79.248125,285.29325,102.706149,4,0
0,0,36,36,27,63,90,505,342,847,0.000333,1.832867,65,357408.9722,19856.05401,5498.599573,504.950598,10,0
0,0,28,28,27,53,80,417,277,694,0.000333,1.462473,65,285182.1764,15843.45424,4387.418098,431.961747,10,0
0,0,15,15,17,37,54,135,91,226,0.000333,0.433535,16,20809.67321,1156.092956,1300.604575,262.236643,9,0
0,0,9,9,22,17,39,295,185,480,0.000333,0.845664,110,279069.2372,15503.84651,2536.993065,167.594364,37,0
0,0,35,35,27,62,89,493,333,826,0.000333,1.782985,65,347682.1279,19315.67377,5348.955814,497.542134,10,0
0,0,19,19,27,35,62,251,166,417,0.000333,0.827633,52,129110.7928,7172.821822,2482.899861,307.906868,10,0
0,0,22,22,27,38,65,319,214,533,0.000333,1.069974,65,208644.9329,11591.38516,3209.922044,327.803208,10,0
0,0,16,16,26,34,60,287,186,473,0.000333,0.93132,65,181607.3514,10089.2973,2793.959252,295.185169,19,0
0,0,39,39,16,34,50,282,159,441,0.000333,0.829647,32,79646.09855,4424.783253,2488.94058,236.973737,9,0
0,0,29,29,27,50,77,456,315,771,0.000333,1.610564,78,376872.009,20937.33383,4831.692423,410.574772,10,0
0,0,4,4,15,18,33,51,32,83,0.000333,0.139562,7,2930.792983,162.821832,418.684712,133.662009,1,0
0,0,2,2,7,4,11,13,5,18,0.000333,0.020757,3,186.809307,10.378295,62.269769,27.651484,3,0
0,0,14,14,16,20,36,94,67,161,0.000333,0.277453,24,19976.59021,1109.810567,832.357925,150.438562,1,0
0,0,2,2,7,4,11,13,5,18,0.000333,0.020757,3,186.809307,10.378295,62.269769,27.651484,3,0
0,0,4,4,11,13,24,25,17,42,0.000333,0.064189,5,962.842125,53.491229,192.568425,86.159464,2,0
0,0,2,2,7,4,11,13,5,18,0.000333,0.020757,3,186.809307,10.378295,62.269769,27.651484,3,0
0,0,18,18,16,24,40,111,56,167,0.000333,0.296254,16,14220.19187,790.010659,888.761992,174.0391,7,0
0,0,2,2,7,4,11,13,5,18,0.000333,0.020757,3,186.809307,10.378295,62.269769,27.651484,3,0
0,0,2,2,7,4,11,13,5,18,0.000333,0.020757,3,186.809307,10.378295,62.269769,27.651484,3,0
0,0,3,3,13,10,23,23,15,38,0.000333,0.057298,6,1031.372126,57.298451,171.895354,81.324997,2,0
0,0,3,3,13,11,24,28,16,44,0.000333,0.067246,6,1210.4301,67.246117,201.73835,86.159464,2,0
0,0,2,2,7,4,11,13,5,18,0.000333,0.020757,3,186.809307,10.378295,62.269769,27.651484,3,0
0,0,18,18,16,24,40,111,56,167,0.000333,0.296254,16,14220.19187,790.010659,888.761992,174.0391,7,0
0,0,2,2,7,4,11,13,5,18,0.000333,0.020757,3,186.809307,10.378295,62.269769,27.651484,3,0
0,0,18,18,14,35,49,118,66,184,0.000333,0.344369,7,7231.746279,401.763682,1033.106611,232.827875,3,0
0,0,4,4,11,13,24,25,17,42,0.000333,0.064189,5,962.842125,53.491229,192.568425,86.159464,2,0
0,0,2,2,7,4,11,13,5,18,0.000333,0.020757,3,186.809307,10.378295,62.269769,27.651484,3,0
0,0,17,17,16,23,39,110,55,165,0.000333,0.290697,16,13953.46186,775.192325,872.091366,168.041925,7,0
0,0,5,5,10,20,30,58,36,94,0.000333,0.153749,5,2306.23858,128.124366,461.247716,119.657843,1,0
0,0,4,4,11,13,24,25,17,42,0.000333,0.064189,5,962.842125,53.491229,192.568425,86.159464,3,0
0,0,17,17,16,23,39,110,55,165,0.000333,0.290697,16,13953.46186,775.192325,872.091366,168.041925,7,0
0,0,2,2,7,4,11,13,5,18,0.000333,0.020757,3,186.809307,10.378295,62.269769,27.651484,3,0
0,0,2,2,7,4,11,13,5,18,0.000333,0.020757,3,186.809307,10.378295,62.269769,27.651484,3,0
0,0,18,18,16,24,40,111,56,167,0.000333,0.296254,16,14220.19187,790.010659,888.761992,174.0391,7,0
0,0,30,30,10,32,42,95,61,156,0.000333,0.280401,5,4206.00759,233.667088,841.201518,193.219281,2,0
0,0,18,18,16,24,40,111,56,167,0.000333,0.296254,16,14220.19187,790.010659,888.761992,174.0391,7,0
0,0,2,2,7,4,11,13,5,18,0.000333,0.020757,3,186.809307,10.378295,62.269769,27.651484,3,0
0,0,21,21,14,31,45,133,67,200,0.000333,0.366124,14,15377.18867,854.288259,1098.370619,206.883055,7,0
0,0,19,19,13,33,46,106,66,172,0.000333,0.316684,12,11400.63188,633.368438,950.052656,214.570722,1,0
0,0,5,5,10,9,19,17,19,36,0.000333,0.050975,10,1529.253905,84.95855,152.92539,61.748606,1,0
0,0,2,2,6,4,10,7,5,12,0.000333,0.013288,3,119.589411,6.643856,39.863137,23.509775,1,0
0,0,7,7,10,11,21,25,31,56,0.000333,0.08199,10,2459.697757,136.649875,245.969776,71.273029,1,0
0,0,2,2,7,4,11,13,5,18,0.000333,0.020757,3,186.809307,10.378295,62.269769,27.651484,3,0
0,0,3,3,13,10,23,23,15,38,0.000333,0.057298,6,1031.372126,57.298451,171.895354,81.324997,2,0
0,0,3,3,13,11,24,28,16,44,0.000333,0.067246,6,1210.4301,67.246117,201.73835,86.159464,2,0
0,0,18,18,16,24,40,111,56,167,0.000333,0.296254,16,14220.19187,790.010659,888.761992,174.0391,7,0
0,0,2,2,8,3,11,9,5,14,0.000333,0.016144,4,193.728171,10.762676,48.432043,28.754888,3,0
0,0,3,3,10,6,16,21,9,30,0.000333,0.04,5,600,33.333333,120,48.729056,3,0
0,0,10,10,11,16,27,56,31,87,0.000333,0.137892,5,2068.376063,114.909781,413.675213,102.053748,3,0
0,0,4,4,9,6,15,15,11,26,0.000333,0.03386,4,406.316622,22.573146,101.579155,44.0391,3,0
0,0,37,37,23,42,65,282,155,437,0.000333,0.877258,33,86848.56623,4824.920346,2631.774734,330.519257,16,0
0,0,4,4,14,11,25,57,30,87,0.000333,0.134672,14,5656.216839,314.234269,404.015489,91.356717,1,0
0,0,8,8,16,17,33,121,69,190,0.000333,0.319478,32,30669.91625,1703.884236,958.434883,133.486868,1,0
0,0,7,7,11,10,21,36,17,53,0.000333,0.077598,5,1163.964117,64.664673,232.792823,71.273029,4,0
0,0,2,2,7,4,11,13,5,18,0.000333,0.020757,3,186.809307,10.378295,62.269769,27.651484,3,0
0,0,18,18,16,24,40,111,56,167,0.000333,0.296254,16,14220.19187,790.010659,888.761992,174.0391,7,0
0,0,2,2,11,6,17,14,8,22,0.000333,0.029975,5,449.620913,24.97894,89.924183,53.563523,2,0
0,0,2,2,7,4,11,13,5,18,0.000333,0.020757,3,186.809307,10.378295,62.269769,27.651484,3,0
0,0,16,16,11,31,42,99,61,160,0.000333,0.28759,5,4313.853938,239.658552,862.770788,191.633833,1,0
0,0,4,4,11,13,24,25,17,42,0.000333,0.064189,5,962.842125,53.491229,192.568425,86.159464,2,0
0,0,26,26,18,35,53,150,80,230,0.000333,0.439141,18,23713.59068,1317.421705,1317.421705,254.583556,9,0
0,0,4,4,12,12,24,49,23,72,0.000333,0.110039,6,1980.7038,110.0391,330.1173,86.0391,10,0
0,0,5,5,12,12,24,58,26,84,0.000333,0.128379,12,4621.642201,256.7579,385.13685,86.0391,11,0
0,0,1,1,5,3,8,11,3,14,0.000333,0.014,2,84,4.666667,42,16.364528,2,0
0,0,2,2,7,4,11,13,5,18,0.000333,0.020757,3,186.809307,10.378295,62.269769,27.651484,3,0
0,0,13,13,15,28,43,89,51,140,0.000333,0.253226,7,5317.73946,295.42997,759.677066,193.209297,2,0
0,0,2,2,9,10,19,26,14,40,0.000333,0.056639,4,679.668402,37.759356,169.917101,61.748606,2,0
0,0,2,2,9,10,19,26,14,40,0.000333,0.056639,4,679.668402,37.759356,169.917101,61.748606,1,0
0,0,2,2,9,10,19,26,14,40,0.000333,0.056639,4,679.668402,37.759356,169.917101,61.748606,1,0
0,0,3,3,11,12,23,35,18,53,0.000333,0.079916,5,1198.743918,66.596884,239.748784,81.073298,2,0
0,0,2,2,9,10,19,26,14,40,0.000333,0.056639,4,679.668402,37.759356,169.917101,61.748606,1,0
0,0,4,4,10,13,23,67,37,104,0.000333,0.156817,10,4704.504434,261.361357,470.450443,81.324997,1,0
0,0,10,10,9,14,23,123,66,189,0.000333,0.284984,16,13679.25136,759.958409,854.95321,81.832294,1,0
0,0,2,2,9,10,19,26,14,40,0.000333,0.056639,4,679.668402,37.759356,169.917101,61.748606,1,0
0,0,2,2,9,10,19,26,14,40,0.000333,0.056639,4,679.668402,37.759356,169.917101,61.748606,1,0
0,0,2,2,9,10,19,26,14,40,0.000333,0.056639,4,679.668402,37.759356,169.917101,61.748606,1,0
0,0,2,2,9,10,19,26,14,40,0.000333,0.056639,4,679.668402,37.759356,169.917101,61.748606,1,0
0,0,2,2,9,10,19,26,14,40,0.000333,0.056639,4,679.668402,37.759356,169.917101,61.748606,1,0
0,0,2,2,9,10,19,26,14,40,0.000333,0.056639,4,679.668402,37.759356,169.917101,61.748606,1,0
0,0,2,2,9,10,19,26,14,40,0.000333,0.056639,4,679.668402,37.759356,169.917101,61.748606,1,0
0,0,2,2,9,10,19,26,14,40,0.000333,0.056639,4,679.668402,37.759356,169.917101,61.748606,2,0
0,0,2,2,9,10,19,26,14,40,0.000333,0.056639,4,679.668402,37.759356,169.917101,61.748606,1,0
0,0,5,5,13,101,114,424,267,691,0.000333,1.573842,12,56658.324,3147.684667,4721.527,720.585076,7,0
0,0,2,2,9,10,19,26,14,40,0.000333,0.056639,4,679.668402,37.759356,169.917101,61.748606,1,0
0,0,3,3,9,9,18,63,34,97,0.000333,0.134828,12,4853.792702,269.65515,404.482725,57.05865,1,0
0,0,2,2,9,10,19,26,14,40,0.000333,0.056639,4,679.668402,37.759356,169.917101,61.748606,1,0
0,0,2,2,9,10,19,26,14,40,0.000333,0.056639,4,679.668402,37.759356,169.917101,61.748606,1,0
0,0,2,2,9,10,19,26,14,40,0.000333,0.056639,4,679.668402,37.759356,169.917101,61.748606,1,0
0,0,2,2,9,10,19,26,14,40,0.000333,0.056639,4,679.668402,37.759356,169.917101,61.748606,1,0
0,0,2,2,9,10,19,26,14,40,0.000333,0.056639,4,679.668402,37.759356,169.917101,61.748606,1,0
0,0,4,4,12,12,24,49,23,72,0.000333,0.110039,6,1980.7038,110.0391,330.1173,86.0391,10,0
0,0,5,5,12,12,24,58,26,84,0.000333,0.128379,12,4621.642201,256.7579,385.13685,86.0391,11,0
0,0,18,18,16,24,40,111,56,167,0.000333,0.296254,16,14220.19187,790.010659,888.761992,174.0391,7,0
0,0,1,1,5,3,8,11,3,14,0.000333,0.014,2,84,4.666667,42,16.364528,2,0
0,0,2,2,9,10,19,26,14,40,0.000333,0.056639,4,679.668402,37.759356,169.917101,61.748606,1,0
0,0,3,3,9,9,18,63,34,97,0.000333,0.134828,12,4853.792702,269.65515,404.482725,57.05865,1,0
0,0,2,2,9,10,19,26,14,40,0.000333,0.056639,4,679.668402,37.759356,169.917101,61.748606,1,0
0,0,2,2,9,10,19,26,14,40,0.000333,0.056639,4,679.668402,37.759356,169.917101,61.748606,2,0
0,0,2,2,9,10,19,26,14,40,0.000333,0.056639,4,679.668402,37.759356,169.917101,61.748606,1,0
0,0,2,2,9,10,19,26,14,40,0.000333,0.056639,4,679.668402,37.759356,169.917101,61.748606,1,0
0,0,2,2,9,10,19,26,14,40,0.000333,0.056639,4,679.668402,37.759356,169.917101,61.748606,1,0
0,0,4,4,10,13,23,67,37,104,0.000333,0.156817,10,4704.504434,261.361357,470.450443,81.324997,1,0
0,0,10,10,9,14,23,123,66,189,0.000333,0.284984,16,13679.25136,759.958409,854.95321,81.832294,1,0
0,0,2,2,9,10,19,26,14,40,0.000333,0.056639,4,679.668402,37.759356,169.917101,61.748606,1,0
0,0,2,2,9,10,19,26,14,40,0.000333,0.056639,4,679.668402,37.759356,169.917101,61.748606,1,0
0,0,2,2,9,10,19,26,14,40,0.000333,0.056639,4,679.668402,37.759356,169.917101,61.748606,1,0
0,0,2,2,9,10,19,26,14,40,0.000333,0.056639,4,679.668402,37.759356,169.917101,61.748606,1,0
0,0,2,2,9,10,19,26,14,40,0.000333,0.056639,4,679.668402,37.759356,169.917101,61.748606,1,0
0,0,2,2,9,10,19,26,14,40,0.000333,0.056639,4,679.668402,37.759356,169.917101,61.748606,1,0
0,0,2,2,9,10,19,26,14,40,0.000333,0.056639,4,679.668402,37.759356,169.917101,61.748606,1,0
0,0,2,2,9,10,19,26,14,40,0.000333,0.056639,4,679.668402,37.759356,169.917101,61.748606,1,0
0,0,2,2,9,10,19,26,14,40,0.000333,0.056639,4,679.668402,37.759356,169.917101,61.748606,1,0
0,0,2,2,9,10,19,26,14,40,0.000333,0.056639,4,679.668402,37.759356,169.917101,61.748606,2,0
0,0,2,2,9,10,19,26,14,40,0.000333,0.056639,4,679.668402,37.759356,169.917101,61.748606,1,0
0,0,3,3,11,12,23,35,18,53,0.000333,0.079916,5,1198.743918,66.596884,239.748784,81.073298,2,0
0,0,5,5,13,101,114,424,267,691,0.000333,1.573842,12,56658.324,3147.684667,4721.527,720.585076,7,0
0,0,2,2,9,10,19,26,14,40,0.000333,0.056639,4,679.668402,37.759356,169.917101,61.748606,1,0
0,0,2,2,9,10,19,26,14,40,0.000333,0.056639,4,679.668402,37.759356,169.917101,61.748606,1,0
0,0,18,18,16,24,40,111,56,167,0.000333,0.296254,16,14220.19187,790.010659,888.761992,174.0391,7,0
0,0,2,2,7,4,11,13,5,18,0.000333,0.020757,3,186.809307,10.378295,62.269769,27.651484,3,0
0,0,6,6,10,9,19,84,15,99,0.000333,0.140182,5,2102.724119,116.818007,420.544824,61.748606,2,0
0,0,17,17,16,23,39,110,55,165,0.000333,0.290697,16,13953.46186,775.192325,872.091366,168.041925,7,0
0,0,4,4,11,13,24,25,17,42,0.000333,0.064189,5,962.842125,53.491229,192.568425,86.159464,2,0
0,0,2,2,7,4,11,13,5,18,0.000333,0.020757,3,186.809307,10.378295,62.269769,27.651484,3,0
0,0,18,18,16,24,40,111,56,167,0.000333,0.296254,16,14220.19187,790.010659,888.761992,174.0391,7,0
0,0,4,4,11,13,24,25,17,42,0.000333,0.064189,5,962.842125,53.491229,192.568425,86.159464,2,0
0,0,2,2,7,4,11,13,5,18,0.000333,0.020757,3,186.809307,10.378295,62.269769,27.651484,3,0
0,0,18,18,16,24,40,111,56,167,0.000333,0.296254,16,14220.19187,790.010659,888.761992,174.0391,7,0
0,0,7,7,11,10,21,36,17,53,0.000333,0.077598,5,1163.964117,64.664673,232.792823,71.273029,4,0
0,0,18,18,16,24,40,111,56,167,0.000333,0.296254,16,14220.19187,790.010659,888.761992,174.0391,7,0
0,0,6,6,11,17,28,47,33,80,0.000333,0.128196,5,1922.941969,106.830109,384.588394,107.540616,3,0
0,0,17,17,16,23,39,110,55,165,0.000333,0.290697,16,13953.46186,775.192325,872.091366,168.041925,7,0
0,0,6,6,11,10,21,28,15,43,0.000333,0.062957,5,944.348246,52.463791,188.869649,71.273029,2,0
0,0,6,6,11,17,28,47,33,80,0.000333,0.128196,5,1922.941969,106.830109,384.588394,107.540616,3,0
0,0,8,8,12,13,25,29,20,49,0.000333,0.07585,6,1365.29372,75.849651,227.548953,91.125266,2,0
0,0,18,18,16,24,40,111,56,167,0.000333,0.296254,16,14220.19187,790.010659,888.761992,174.0391,7,0
0,0,4,4,11,13,24,25,17,42,0.000333,0.064189,5,962.842125,53.491229,192.568425,86.159464,2,0
0,0,18,18,16,24,40,111,56,167,0.000333,0.296254,16,14220.19187,790.010659,888.761992,174.0391,7,0
0,0,2,2,7,4,11,13,5,18,0.000333,0.020757,3,186.809307,10.378295,62.269769,27.651484,3,0
0,0,2,2,7,4,11,13,5,18,0.000333,0.020757,3,186.809307,10.378295,62.269769,27.651484,3,0
0,0,18,18,16,24,40,111,56,167,0.000333,0.296254,16,14220.19187,790.010659,888.761992,174.0391,7,0
0,0,5,5,12,12,24,58,26,84,0.000333,0.128379,12,4621.642201,256.7579,385.13685,86.0391,11,0
0,0,4,4,12,12,24,49,23,72,0.000333,0.110039,6,1980.7038,110.0391,330.1173,86.0391,10,0
0,0,1,1,5,3,8,11,3,14,0.000333,0.014,2,84,4.666667,42,16.364528,2,0
0,0,2,2,9,10,19,26,14,40,0.000333,0.056639,4,679.668402,37.759356,169.917101,61.748606,1,0
0,0,4,4,10,13,23,67,37,104,0.000333,0.156817,10,4704.504434,261.361357,470.450443,81.324997,1,0
0,0,2,2,9,10,19,26,14,40,0.000333,0.056639,4,679.668402,37.759356,169.917101,61.748606,1,0
0,0,2,2,9,10,19,26,14,40,0.000333,0.056639,4,679.668402,37.759356,169.917101,61.748606,1,0
0,0,2,2,9,10,19,26,14,40,0.000333,0.056639,4,679.668402,37.759356,169.917101,61.748606,1,0
0,0,2,2,9,10,19,26,14,40,0.000333,0.056639,4,679.668402,37.759356,169.917101,61.748606,1,0
0,0,2,2,9,10,19,26,14,40,0.000333,0.056639,4,679.668402,37.759356,169.917101,61.748606,1,0
0,0,3,3,9,9,18,63,34,97,0.000333,0.134828,12,4853.792702,269.65515,404.482725,57.05865,1,0
0,0,2,2,9,10,19,26,14,40,0.000333,0.056639,4,679.668402,37.759356,169.917101,61.748606,1,0
0,0,2,2,9,10,19,26,14,40,0.000333,0.056639,4,679.668402,37.759356,169.917101,61.748606,1,0
0,0,3,3,11,12,23,35,18,53,0.000333,0.079916,5,1198.743918,66.596884,239.748784,81.073298,2,0
0,0,2,2,9,10,19,26,14,40,0.000333,0.056639,4,679.668402,37.759356,169.917101,61.748606,1,0
0,0,2,2,9,10,19,26,14,40,0.000333,0.056639,4,679.668402,37.759356,169.917101,61.748606,2,0
0,0,2,2,9,10,19,26,14,40,0.000333,0.056639,4,679.668402,37.759356,169.917101,61.748606,1,0
0,0,5,5,13,101,114,424,267,691,0.000333,1.573842,12,56658.324,3147.684667,4721.527,720.585076,7,0
0,0,2,2,9,10,19,26,14,40,0.000333,0.056639,4,679.668402,37.759356,169.917101,61.748606,1,0
0,0,2,2,9,10,19,26,14,40,0.000333,0.056639,4,679.668402,37.759356,169.917101,61.748606,1,0
0,0,2,2,9,10,19,26,14,40,0.000333,0.056639,4,679.668402,37.759356,169.917101,61.748606,1,0
0,0,2,2,9,10,19,26,14,40,0.000333,0.056639,4,679.668402,37.759356,169.917101,61.748606,1,0
0,0,2,2,9,10,19,26,14,40,0.000333,0.056639,4,679.668402,37.759356,169.917101,61.748606,1,0
0,0,13,13,11,25,36,85,50,135,0.000333,0.232647,10,6979.398752,387.744375,697.939875,154.150153,1,0
0,0,2,2,9,10,19,26,14,40,0.000333,0.056639,4,679.668402,37.759356,169.917101,61.748606,1,0
0,0,2,2,9,10,19,26,14,40,0.000333,0.056639,4,679.668402,37.759356,169.917101,61.748606,2,0
0,0,2,2,9,10,19,26,14,40,0.000333,0.056639,4,679.668402,37.759356,169.917101,61.748606,1,0
0,0,10,10,9,14,23,123,66,189,0.000333,0.284984,16,13679.25136,759.958409,854.95321,81.832294,1,0
0,0,3,3,14,7,21,33,13,46,0.000333,0.067349,7,1414.32621,78.573678,202.046601,72.954453,2,0
0,0,18,18,16,24,40,111,56,167,0.000333,0.296254,16,14220.19187,790.010659,888.761992,174.0391,7,0
0,0,3,3,13,10,23,23,15,38,0.000333,0.057298,6,1031.372126,57.298451,171.895354,81.324997,2,0
0,0,3,3,13,11,24,28,16,44,0.000333,0.067246,6,1210.4301,67.246117,201.73835,86.159464,2,0
0,0,1,1,5,3,8,11,3,14,0.000333,0.014,2,84,4.666667,42,16.364528,2,0
0,0,2,2,7,4,11,13,5,18,0.000333,0.020757,3,186.809307,10.378295,62.269769,27.651484,3,0
0,0,4,4,12,12,24,49,23,72,0.000333,0.110039,6,1980.7038,110.0391,330.1173,86.0391,10,0
0,0,5,5,12,12,24,58,26,84,0.000333,0.128379,12,4621.642201,256.7579,385.13685,86.0391,11,0
0,0,13,13,9,20,29,72,47,119,0.000333,0.1927,8,4624.797907,256.933217,578.099738,114.967887,1,0
0,0,2,2,9,10,19,26,14,40,0.000333,0.056639,4,679.668402,37.759356,169.917101,61.748606,1,0
0,0,2,2,9,10,19,26,14,40,0.000333,0.056639,4,679.668402,37.759356,169.917101,61.748606,1,0
0,0,2,2,9,10,19,26,14,40,0.000333,0.056639,4,679.668402,37.759356,169.917101,61.748606,2,0
0,0,2,2,9,10,19,26,14,40,0.000333,0.056639,4,679.668402,37.759356,169.917101,61.748606,1,0
0,0,2,2,9,10,19,26,14,40,0.000333,0.056639,4,679.668402,37.759356,169.917101,61.748606,1,0
0,0,2,2,9,10,19,26,14,40,0.000333,0.056639,4,679.668402,37.759356,169.917101,61.748606,1,0
0,0,2,2,9,10,19,26,14,40,0.000333,0.056639,4,679.668402,37.759356,169.917101,61.748606,1,0
0,0,2,2,9,10,19,26,14,40,0.000333,0.056639,4,679.668402,37.759356,169.917101,61.748606,1,0
0,0,2,2,9,10,19,26,14,40,0.000333,0.056639,4,679.668402,37.759356,169.917101,61.748606,1,0
0,0,2,2,9,10,19,26,14,40,0.000333,0.056639,4,679.668402,37.759356,169.917101,61.748606,1,0
0,0,2,2,9,10,19,26,14,40,0.000333,0.056639,4,679.668402,37.759356,169.917101,61.748606,1,0
0,0,5,5,13,101,114,424,267,691,0.000333,1.573842,12,56658.324,3147.684667,4721.527,720.585076,7,0
0,0,2,2,9,10,19,26,14,40,0.000333,0.056639,4,679.668402,37.759356,169.917101,61.748606,1,0
0,0,2,2,9,10,19,26,14,40,0.000333,0.056639,4,679.668402,37.759356,169.917101,61.748606,1,0
0,0,2,2,9,10,19,26,14,40,0.000333,0.056639,4,679.668402,37.759356,169.917101,61.748606,1,0
0,0,2,2,9,10,19,26,14,40,0.000333,0.056639,4,679.668402,37.759356,169.917101,61.748606,1,0
0,0,2,2,9,10,19,26,14,40,0.000333,0.056639,4,679.668402,37.759356,169.917101,61.748606,1,0
0,0,2,2,9,10,19,26,14,40,0.000333,0.056639,4,679.668402,37.759356,169.917101,61.748606,1,0
0,0,2,2,9,10,19,26,14,40,0.000333,0.056639,4,679.668402,37.759356,169.917101,61.748606,1,0
0,0,2,2,9,10,19,26,14,40,0.000333,0.056639,4,679.668402,37.759356,169.917101,61.748606,2,0
0,0,4,4,10,13,23,67,37,104,0.000333,0.156817,10,4704.504434,261.361357,470.450443,81.324997,1,0
0,0,3,3,9,9,18,63,34,97,0.000333,0.134828,12,4853.792702,269.65515,404.482725,57.05865,1,0
0,0,10,10,9,14,23,123,66,189,0.000333,0.284984,16,13679.25136,759.958409,854.95321,81.832294,1,0
0,0,3,3,11,12,23,35,18,53,0.000333,0.079916,5,1198.743918,66.596884,239.748784,81.073298,2,0
0,0,6,6,11,8,19,35,15,50,0.000333,0.070799,5,1061.981878,58.998993,212.396376,62.053748,4,0
0,0,18,18,16,24,40,111,56,167,0.000333,0.296254,16,14220.19187,790.010659,888.761992,174.0391,7,0
0,0,21,21,16,28,44,123,63,186,0.000333,0.338485,16,16247.2685,902.626028,1015.454281,198.605938,7,0
0,0,18,18,16,24,40,111,56,167,0.000333,0.296254,16,14220.19187,790.010659,888.761992,174.0391,7,0
0,0,2,2,7,4,11,13,5,18,0.000333,0.020757,3,186.809307,10.378295,62.269769,27.651484,3,0
0,0,4,4,11,13,24,25,17,42,0.000333,0.064189,5,962.842125,53.491229,192.568425,86.159464,2,0
0,0,18,18,16,24,40,111,56,167,0.000333,0.296254,16,14220.19187,790.010659,888.761992,174.0391,7,0
0,0,2,2,7,4,11,13,5,18,0.000333,0.020757,3,186.809307,10.378295,62.269769,27.651484,3,0
0,0,4,4,12,12,24,49,23,72,0.000333,0.110039,6,1980.7038,110.0391,330.1173,86.0391,10,0
0,0,5,5,12,12,24,58,26,84,0.000333,0.128379,12,4621.642201,256.7579,385.13685,86.0391,11,0
0,0,1,1,5,3,8,11,3,14,0.000333,0.014,2,84,4.666667,42,16.364528,2,0
0,0,2,2,9,10,19,26,14,40,0.000333,0.056639,4,679.668402,37.759356,169.917101,61.748606,1,0
0,0,2,2,9,10,19,26,14,40,0.000333,0.056639,4,679.668402,37.759356,169.917101,61.748606,1,0
0,0,2,2,9,10,19,26,14,40,0.000333,0.056639,4,679.668402,37.759356,169.917101,61.748606,1,0
0,0,2,2,9,10,19,26,14,40,0.000333,0.056639,4,679.668402,37.759356,169.917101,61.748606,1,0
0,0,2,2,9,10,19,26,14,40,0.000333,0.056639,4,679.668402,37.759356,169.917101,61.748606,1,0
0,0,2,2,9,10,19,26,14,40,0.000333,0.056639,4,679.668402,37.759356,169.917101,61.748606,1,0
0,0,5,5,13,101,114,424,267,691,0.000333,1.573842,12,56658.324,3147.684667,4721.527,720.585076,7,0
0,0,2,2,9,10,19,26,14,40,0.000333,0.056639,4,679.668402,37.759356,169.917101,61.748606,2,0
0,0,2,2,9,10,19,26,14,40,0.000333,0.056639,4,679.668402,37.759356,169.917101,61.748606,1,0
0,0,2,2,9,10,19,26,14,40,0.000333,0.056639,4,679.668402,37.759356,169.917101,61.748606,1,0
0,0,2,2,9,10,19,26,14,40,0.000333,0.056639,4,679.668402,37.759356,169.917101,61.748606,1,0
0,0,2,2,9,10,19,26,14,40,0.000333,0.056639,4,679.668402,37.759356,169.917101,61.748606,1,0
0,0,10,10,9,14,23,123,66,189,0.000333,0.284984,16,13679.25136,759.958409,854.95321,81.832294,1,0
0,0,2,2,9,10,19,26,14,40,0.000333,0.056639,4,679.668402,37.759356,169.917101,61.748606,1,0
0,0,4,4,10,13,23,67,37,104,0.000333,0.156817,10,4704.504434,261.361357,470.450443,81.324997,1,0
0,0,2,2,9,10,19,26,14,40,0.000333,0.056639,4,679.668402,37.759356,169.917101,61.748606,1,0
0,0,2,2,9,10,19,26,14,40,0.000333,0.056639,4,679.668402,37.759356,169.917101,61.748606,1,0
0,0,3,3,9,9,18,63,34,97,0.000333,0.134828,12,4853.792702,269.65515,404.482725,57.05865,1,0
0,0,2,2,9,10,19,26,14,40,0.000333,0.056639,4,679.668402,37.759356,169.917101,61.748606,1,0
0,0,2,2,9,10,19,26,14,40,0.000333,0.056639,4,679.668402,37.759356,169.917101,61.748606,2,0
0,0,3,3,11,12,23,35,18,53,0.000333,0.079916,5,1198.743918,66.596884,239.748784,81.073298,2,0
0,0,2,2,9,10,19,26,14,40,0.000333,0.056639,4,679.668402,37.759356,169.917101,61.748606,1,0
0,0,2,2,9,10,19,26,14,40,0.000333,0.056639,4,679.668402,37.759356,169.917101,61.748606,1,0
0,0,2,2,9,10,19,26,14,40,0.000333,0.056639,4,679.668402,37.759356,169.917101,61.748606,1,0
0,0,2,2,7,4,11,13,5,18,0.000333,0.020757,3,186.809307,10.378295,62.269769,27.651484,3,0
0,0,4,4,12,12,24,49,23,72,0.000333,0.110039,6,1980.7038,110.0391,330.1173,86.0391,10,0
0,0,1,1,5,3,8,11,3,14,0.000333,0.014,2,84,4.666667,42,16.364528,2,0
0,0,5,5,12,12,24,58,26,84,0.000333,0.128379,12,4621.642201,256.7579,385.13685,86.0391,11,0
0,0,18,18,16,24,40,111,56,167,0.000333,0.296254,16,14220.19187,790.010659,888.761992,174.0391,7,0
0,0,2,2,9,10,19,26,14,40,0.000333,0.056639,4,679.668402,37.759356,169.917101,61.748606,1,0
0,0,10,10,9,14,23,123,66,189,0.000333,0.284984,16,13679.25136,759.958409,854.95321,81.832294,1,0
0,0,2,2,9,10,19,26,14,40,0.000333,0.056639,4,679.668402,37.759356,169.917101,61.748606,1,0
0,0,4,4,10,13,23,67,37,104,0.000333,0.156817,10,4704.504434,261.361357,470.450443,81.324997,1,0
0,0,2,2,9,10,19,26,14,40,0.000333,0.056639,4,679.668402,37.759356,169.917101,61.748606,1,0
0,0,2,2,9,10,19,26,14,40,0.000333,0.056639,4,679.668402,37.759356,169.917101,61.748606,1,0
0,0,2,2,9,10,19,26,14,40,0.000333,0.056639,4,679.668402,37.759356,169.917101,61.748606,1,0
0,0,2,2,9,10,19,26,14,40,0.000333,0.056639,4,679.668402,37.759356,169.917101,61.748606,1,0
0,0,3,3,11,12,23,35,18,53,0.000333,0.079916,5,1198.743918,66.596884,239.748784,81.073298,2,0
0,0,2,2,9,10,19,26,14,40,0.000333,0.056639,4,679.668402,37.759356,169.917101,61.748606,1,0
0,0,2,2,9,10,19,26,14,40,0.000333,0.056639,4,679.668402,37.759356,169.917101,61.748606,1,0
0,0,3,3,9,9,18,63,34,97,0.000333,0.134828,12,4853.792702,269.65515,404.482725,57.05865,1,0
0,0,2,2,9,10,19,26,14,40,0.000333,0.056639,4,679.668402,37.759356,169.917101,61.748606,1,0
0,0,2,2,9,10,19,26,14,40,0.000333,0.056639,4,679.668402,37.759356,169.917101,61.748606,1,0
0,0,2,2,9,10,19,26,14,40,0.000333,0.056639,4,679.668402,37.759356,169.917101,61.748606,1,0
0,0,2,2,9,10,19,26,14,40,0.000333,0.056639,4,679.668402,37.759356,169.917101,61.748606,1,0
0,0,2,2,9,10,19,26,14,40,0.000333,0.056639,4,679.668402,37.759356,169.917101,61.748606,1,0
0,0,2,2,9,10,19,26,14,40,0.000333,0.056639,4,679.668402,37.759356,169.917101,61.748606,2,0
0,0,2,2,9,10,19,26,14,40,0.000333,0.056639,4,679.668402,37.759356,169.917101,61.748606,2,0
0,0,5,5,13,101,114,424,267,691,0.000333,1.573842,12,56658.324,3147.684667,4721.527,720.585076,7,0
0,0,2,2,9,10,19,26,14,40,0.000333,0.056639,4,679.668402,37.759356,169.917101,61.748606,1,0
0,0,2,2,9,10,19,26,14,40,0.000333,0.056639,4,679.668402,37.759356,169.917101,61.748606,1,0
0,0,2,2,9,10,19,26,14,40,0.000333,0.056639,4,679.668402,37.759356,169.917101,61.748606,1,0
0,0,2,2,9,10,19,26,14,40,0.000333,0.056639,4,679.668402,37.759356,169.917101,61.748606,1,0
0,0,4,4,11,13,24,25,17,42,0.000333,0.064189,5,962.842125,53.491229,192.568425,86.159464,2,0
0,0,2,2,7,4,11,13,5,18,0.000333,0.020757,3,186.809307,10.378295,62.269769,27.651484,3,0
0,0,18,18,16,24,40,111,56,167,0.000333,0.296254,16,14220.19187,790.010659,888.761992,174.0391,7,0
0,0,17,17,16,36,52,116,71,187,0.000333,0.355327,8,8527.857818,473.769879,1065.982227,250.1173,5,0
0,0,4,4,12,12,24,49,23,72,0.000333,0.110039,6,1980.7038,110.0391,330.1173,86.0391,10,0
0,0,5,5,12,12,24,58,26,84,0.000333,0.128379,12,4621.642201,256.7579,385.13685,86.0391,11,0
0,0,18,18,16,24,40,111,56,167,0.000333,0.296254,16,14220.19187,790.010659,888.761992,174.0391,7,0
0,0,1,1,5,3,8,11,3,14,0.000333,0.014,2,84,4.666667,42,16.364528,2,0
0,0,2,2,9,10,19,26,14,40,0.000333,0.056639,4,679.668402,37.759356,169.917101,61.748606,1,0
0,0,3,3,9,9,18,63,34,97,0.000333,0.134828,12,4853.792702,269.65515,404.482725,57.05865,1,0
0,0,2,2,9,10,19,26,14,40,0.000333,0.056639,4,679.668402,37.759356,169.917101,61.748606,1,0
0,0,2,2,9,10,19,26,14,40,0.000333,0.056639,4,679.668402,37.759356,169.917101,61.748606,2,0
0,0,2,2,9,10,19,26,14,40,0.000333,0.056639,4,679.668402,37.759356,169.917101,61.748606,1,0
0,0,2,2,9,10,19,26,14,40,0.000333,0.056639,4,679.668402,37.759356,169.917101,61.748606,1,0
0,0,2,2,9,10,19,26,14,40,0.000333,0.056639,4,679.668402,37.759356,169.917101,61.748606,1,0
0,0,4,4,10,13,23,67,37,104,0.000333,0.156817,10,4704.504434,261.361357,470.450443,81.324997,1,0
0,0,10,10,9,14,23,123,66,189,0.000333,0.284984,16,13679.25136,759.958409,854.95321,81.832294,1,0
0,0,2,2,9,10,19,26,14,40,0.000333,0.056639,4,679.668402,37.759356,169.917101,61.748606,1,0
0,0,2,2,9,10,19,26,14,40,0.000333,0.056639,4,679.668402,37.759356,169.917101,61.748606,1,0
0,0,2,2,9,10,19,26,14,40,0.000333,0.056639,4,679.668402,37.759356,169.917101,61.748606,1,0
0,0,2,2,9,10,19,26,14,40,0.000333,0.056639,4,679.668402,37.759356,169.917101,61.748606,1,0
0,0,2,2,9,10,19,26,14,40,0.000333,0.056639,4,679.668402,37.759356,169.917101,61.748606,1,0
0,0,2,2,9,10,19,26,14,40,0.000333,0.056639,4,679.668402,37.759356,169.917101,61.748606,1,0
0,0,2,2,9,10,19,26,14,40,0.000333,0.056639,4,679.668402,37.759356,169.917101,61.748606,1,0
0,0,2,2,9,10,19,26,14,40,0.000333,0.056639,4,679.668402,37.759356,169.917101,61.748606,1,0
0,0,2,2,9,10,19,26,14,40,0.000333,0.056639,4,679.668402,37.759356,169.917101,61.748606,1,0
0,0,2,2,9,10,19,26,14,40,0.000333,0.056639,4,679.668402,37.759356,169.917101,61.748606,2,0
0,0,2,2,9,10,19,26,14,40,0.000333,0.056639,4,679.668402,37.759356,169.917101,61.748606,1,0
0,0,3,3,11,12,23,35,18,53,0.000333,0.079916,5,1198.743918,66.596884,239.748784,81.073298,2,0
0,0,5,5,13,101,114,424,267,691,0.000333,1.573842,12,56658.324,3147.684667,4721.527,720.585076,7,0
0,0,2,2,9,10,19,26,14,40,0.000333,0.056639,4,679.668402,37.759356,169.917101,61.748606,1,0
0,0,2,2,9,10,19,26,14,40,0.000333,0.056639,4,679.668402,37.759356,169.917101,61.748606,1,0
0,0,4,4,11,13,24,25,17,42,0.000333,0.064189,5,962.842125,53.491229,192.568425,86.159464,2,0
0,0,18,18,16,24,40,111,56,167,0.000333,0.296254,16,14220.19187,790.010659,888.761992,174.0391,7,0
0,0,1,1,5,3,8,11,3,14,0.000333,0.014,2,84,4.666667,42,16.364528,2,0
0,0,5,5,12,12,24,58,26,84,0.000333,0.128379,12,4621.642201,256.7579,385.13685,86.0391,11,0
0,0,2,2,7,4,11,13,5,18,0.000333,0.020757,3,186.809307,10.378295,62.269769,27.651484,3,0
0,0,4,4,12,12,24,49,23,72,0.000333,0.110039,6,1980.7038,110.0391,330.1173,86.0391,10,0
0,0,2,2,9,10,19,26,14,40,0.000333,0.056639,4,679.668402,37.759356,169.917101,61.748606,1,0
0,0,2,2,9,10,19,26,14,40,0.000333,0.056639,4,679.668402,37.759356,169.917101,61.748606,1,0
0,0,5,5,13,101,114,424,267,691,0.000333,1.573842,12,56658.324,3147.684667,4721.527,720.585076,7,0
0,0,10,10,9,14,23,123,66,189,0.000333,0.284984,16,13679.25136,759.958409,854.95321,81.832294,1,0
0,0,2,2,9,10,19,26,14,40,0.000333,0.056639,4,679.668402,37.759356,169.917101,61.748606,1,0
0,0,2,2,9,10,19,26,14,40,0.000333,0.056639,4,679.668402,37.759356,169.917101,61.748606,2,0
0,0,2,2,9,10,19,26,14,40,0.000333,0.056639,4,679.668402,37.759356,169.917101,61.748606,1,0
0,0,3,3,9,9,18,63,34,97,0.000333,0.134828,12,4853.792702,269.65515,404.482725,57.05865,1,0
0,0,2,2,9,10,19,26,14,40,0.000333,0.056639,4,679.668402,37.759356,169.917101,61.748606,1,0
0,0,2,2,9,10,19,26,14,40,0.000333,0.056639,4,679.668402,37.759356,169.917101,61.748606,1,0
0,0,2,2,9,10,19,26,14,40,0.000333,0.056639,4,679.668402,37.759356,169.917101,61.748606,1,0
0,0,2,2,9,10,19,26,14,40,0.000333,0.056639,4,679.668402,37.759356,169.917101,61.748606,1,0
0,0,2,2,9,10,19,26,14,40,0.000333,0.056639,4,679.668402,37.759356,169.917101,61.748606,1,0
0,0,2,2,9,10,19,26,14,40,0.000333,0.056639,4,679.668402,37.759356,169.917101,61.748606,1,0
0,0,3,3,11,12,23,35,18,53,0.000333,0.079916,5,1198.743918,66.596884,239.748784,81.073298,2,0
0,0,2,2,9,10,19,26,14,40,0.000333,0.056639,4,679.668402,37.759356,169.917101,61.748606,1,0
0,0,2,2,9,10,19,26,14,40,0.000333,0.056639,4,679.668402,37.759356,169.917101,61.748606,1,0
0,0,2,2,9,10,19,26,14,40,0.000333,0.056639,4,679.668402,37.759356,169.917101,61.748606,1,0
0,0,2,2,9,10,19,26,14,40,0.000333,0.056639,4,679.668402,37.759356,169.917101,61.748606,1,0
0,0,4,4,10,13,23,67,37,104,0.000333,0.156817,10,4704.504434,261.361357,470.450443,81.324997,1,0
0,0,2,2,9,10,19,26,14,40,0.000333,0.056639,4,679.668402,37.759356,169.917101,61.748606,1,0
0,0,2,2,9,10,19,26,14,40,0.000333,0.056639,4,679.668402,37.759356,169.917101,61.748606,2,0
0,0,2,2,9,10,19,26,14,40,0.000333,0.056639,4,679.668402,37.759356,169.917101,61.748606,1,0
0,0,2,2,9,10,19,26,14,40,0.000333,0.056639,4,679.668402,37.759356,169.917101,61.748606,1,0
0,0,18,18,15,28,43,394,57,451,0.000333,0.815748,14,34261.43566,1903.413092,2447.245404,193.209297,6,0
0,0,17,17,16,23,39,110,55,165,0.000333,0.290697,16,13953.46186,775.192325,872.091366,168.041925,7,0
0,0,2,2,7,4,11,13,5,18,0.000333,0.020757,3,186.809307,10.378295,62.269769,27.651484,3,0
0,0,5,5,9,13,22,26,20,46,0.000333,0.068378,4,820.535418,45.585301,205.133854,76.635041,1,0
0,0,1,1,5,3,8,11,3,14,0.000333,0.014,2,84,4.666667,42,16.364528,2,0
0,0,18,18,16,24,40,111,56,167,0.000333,0.296254,16,14220.19187,790.010659,888.761992,174.0391,7,0
0,0,5,5,12,12,24,58,26,84,0.000333,0.128379,12,4621.642201,256.7579,385.13685,86.0391,11,0
0,0,4,4,12,12,24,49,23,72,0.000333,0.110039,6,1980.7038,110.0391,330.1173,86.0391,10,0
0,0,2,2,9,10,19,26,14,40,0.000333,0.056639,4,679.668402,37.759356,169.917101,61.748606,1,0
0,0,2,2,9,10,19,26,14,40,0.000333,0.056639,4,679.668402,37.759356,169.917101,61.748606,1,0
0,0,3,3,9,9,18,63,34,97,0.000333,0.134828,12,4853.792702,269.65515,404.482725,57.05865,1,0
0,0,2,2,9,10,19,26,14,40,0.000333,0.056639,4,679.668402,37.759356,169.917101,61.748606,2,0
0,0,3,3,11,12,23,35,18,53,0.000333,0.079916,5,1198.743918,66.596884,239.748784,81.073298,2,0
0,0,2,2,9,10,19,26,14,40,0.000333,0.056639,4,679.668402,37.759356,169.917101,61.748606,1,0
0,0,2,2,9,10,19,26,14,40,0.000333,0.056639,4,679.668402,37.759356,169.917101,61.748606,1,0
0,0,2,2,9,10,19,26,14,40,0.000333,0.056639,4,679.668402,37.759356,169.917101,61.748606,1,0
0,0,4,4,10,13,23,67,37,104,0.000333,0.156817,10,4704.504434,261.361357,470.450443,81.324997,1,0
0,0,10,10,9,14,23,123,66,189,0.000333,0.284984,16,13679.25136,759.958409,854.95321,81.832294,1,0
0,0,2,2,9,10,19,26,14,40,0.000333,0.056639,4,679.668402,37.759356,169.917101,61.748606,1,0
0,0,2,2,9,10,19,26,14,40,0.000333,0.056639,4,679.668402,37.759356,169.917101,61.748606,1,0
0,0,2,2,9,10,19,26,14,40,0.000333,0.056639,4,679.668402,37.759356,169.917101,61.748606,1,0
0,0,5,5,13,101,114,424,267,691,0.000333,1.573842,12,56658.324,3147.684667,4721.527,720.585076,7,0
0,0,2,2,9,10,19,26,14,40,0.000333,0.056639,4,679.668402,37.759356,169.917101,61.748606,1,0
0,0,2,2,9,10,19,26,14,40,0.000333,0.056639,4,679.668402,37.759356,169.917101,61.748606,1,0
0,0,2,2,9,10,19,26,14,40,0.000333,0.056639,4,679.668402,37.759356,169.917101,61.748606,1,0
0,0,2,2,9,10,19,26,14,40,0.000333,0.056639,4,679.668402,37.759356,169.917101,61.748606,1,0
0,0,2,2,9,10,19,26,14,40,0.000333,0.056639,4,679.668402,37.759356,169.917101,61.748606,1,0
0,0,2,2,9,10,19,26,14,40,0.000333,0.056639,4,679.668402,37.759356,169.917101,61.748606,2,0
0,0,2,2,9,10,19,26,14,40,0.000333,0.056639,4,679.668402,37.759356,169.917101,61.748606,1,0
0,0,2,2,9,10,19,26,14,40,0.000333,0.056639,4,679.668402,37.759356,169.917101,61.748606,1,0
0,0,2,2,9,10,19,26,14,40,0.000333,0.056639,4,679.668402,37.759356,169.917101,61.748606,1,0
0,0,2,2,9,10,19,26,14,40,0.000333,0.056639,4,679.668402,37.759356,169.917101,61.748606,1,0
0,0,17,17,16,23,39,110,55,165,0.000333,0.290697,16,13953.46186,775.192325,872.091366,168.041925,7,0
0,0,4,4,8,5,13,15,8,23,0.000333,0.02837,4,340.440454,18.913359,85.110114,35.60964,2,0
0,0,7,7,10,11,21,34,20,54,0.000333,0.079062,5,1185.925704,65.884761,237.185141,71.273029,2,0
0,0,2,2,7,5,12,8,6,14,0.000333,0.01673,3,150.568425,8.364913,50.189475,31.261125,1,0
0,0,2,2,7,4,11,8,5,13,0.000333,0.014991,3,134.917833,7.495435,44.972611,27.651484,1,0
0,0,2,2,7,4,11,13,5,18,0.000333,0.020757,3,186.809307,10.378295,62.269769,27.651484,3,0
0,0,18,18,16,24,40,111,56,167,0.000333,0.296254,16,14220.19187,790.010659,888.761992,174.0391,7,0
0,0,5,5,12,12,24,58,26,84,0.000333,0.128379,12,4621.642201,256.7579,385.13685,86.0391,11,0
0,0,4,4,12,12,24,49,23,72,0.000333,0.110039,6,1980.7038,110.0391,330.1173,86.0391,10,0
0,0,1,1,5,3,8,11,3,14,0.000333,0.014,2,84,4.666667,42,16.364528,2,0
0,0,2,2,9,10,19,26,14,40,0.000333,0.056639,4,679.668402,37.759356,169.917101,61.748606,1,0
0,0,2,2,9,10,19,26,14,40,0.000333,0.056639,4,679.668402,37.759356,169.917101,61.748606,1,0
0,0,5,5,13,101,114,424,267,691,0.000333,1.573842,12,56658.324,3147.684667,4721.527,720.585076,7,0
0,0,10,10,9,14,23,123,66,189,0.000333,0.284984,16,13679.25136,759.958409,854.95321,81.832294,1,0
0,0,2,2,9,10,19,26,14,40,0.000333,0.056639,4,679.668402,37.759356,169.917101,61.748606,1,0
0,0,2,2,9,10,19,26,14,40,0.000333,0.056639,4,679.668402,37.759356,169.917101,61.748606,2,0
0,0,2,2,9,10,19,26,14,40,0.000333,0.056639,4,679.668402,37.759356,169.917101,61.748606,1,0
0,0,3,3,9,9,18,63,34,97,0.000333,0.134828,12,4853.792702,269.65515,404.482725,57.05865,1,0
0,0,2,2,9,10,19,26,14,40,0.000333,0.056639,4,679.668402,37.759356,169.917101,61.748606,1,0
0,0,2,2,9,10,19,26,14,40,0.000333,0.056639,4,679.668402,37.759356,169.917101,61.748606,1,0
0,0,2,2,9,10,19,26,14,40,0.000333,0.056639,4,679.668402,37.759356,169.917101,61.748606,1,0
0,0,2,2,9,10,19,26,14,40,0.000333,0.056639,4,679.668402,37.759356,169.917101,61.748606,1,0
0,0,2,2,9,10,19,26,14,40,0.000333,0.056639,4,679.668402,37.759356,169.917101,61.748606,1,0
0,0,2,2,9,10,19,26,14,40,0.000333,0.056639,4,679.668402,37.759356,169.917101,61.748606,1,0
0,0,3,3,11,12,23,35,18,53,0.000333,0.079916,5,1198.743918,66.596884,239.748784,81.073298,2,0
0,0,2,2,9,10,19,26,14,40,0.000333,0.056639,4,679.668402,37.759356,169.917101,61.748606,1,0
0,0,2,2,9,10,19,26,14,40,0.000333,0.056639,4,679.668402,37.759356,169.917101,61.748606,1,0
0,0,2,2,9,10,19,26,14,40,0.000333,0.056639,4,679.668402,37.759356,169.917101,61.748606,1,0
0,0,2,2,9,10,19,26,14,40,0.000333,0.056639,4,679.668402,37.759356,169.917101,61.748606,1,0
0,0,4,4,10,13,23,67,37,104,0.000333,0.156817,10,4704.504434,261.361357,470.450443,81.324997,1,0
0,0,2,2,9,10,19,26,14,40,0.000333,0.056639,4,679.668402,37.759356,169.917101,61.748606,1,0
0,0,2,2,9,10,19,26,14,40,0.000333,0.056639,4,679.668402,37.759356,169.917101,61.748606,2,0
0,0,2,2,9,10,19,26,14,40,0.000333,0.056639,4,679.668402,37.759356,169.917101,61.748606,1,0
0,0,2,2,9,10,19,26,14,40,0.000333,0.056639,4,679.668402,37.759356,169.917101,61.748606,1,0
0,0,4,4,11,13,24,25,17,42,0.000333,0.064189,5,962.842125,53.491229,192.568425,86.159464,2,0
0,0,17,17,16,23,39,110,55,165,0.000333,0.290697,16,13953.46186,775.192325,872.091366,168.041925,7,0
0,0,2,2,7,4,11,13,5,18,0.000333,0.020757,3,186.809307,10.378295,62.269769,27.651484,3,0
0,0,18,18,16,24,40,111,56,167,0.000333,0.296254,16,14220.19187,790.010659,888.761992,174.0391,7,0
0,0,4,4,11,13,24,25,17,42,0.000333,0.064189,5,962.842125,53.491229,192.568425,86.159464,3,0
0,0,5,5,12,12,24,58,26,84,0.000333,0.128379,12,4621.642201,256.7579,385.13685,86.0391,11,0
0,0,18,18,16,24,40,111,56,167,0.000333,0.296254,16,14220.19187,790.010659,888.761992,174.0391,7,0
0,0,4,4,12,12,24,49,23,72,0.000333,0.110039,6,1980.7038,110.0391,330.1173,86.0391,10,0
0,0,2,2,7,4,11,13,5,18,0.000333,0.020757,3,186.809307,10.378295,62.269769,27.651484,3,0
0,0,1,1,5,3,8,11,3,14,0.000333,0.014,2,84,4.666667,42,16.364528,2,0
0,0,5,5,13,101,114,424,267,691,0.000333,1.573842,12,56658.324,3147.684667,4721.527,720.585076,7,0
0,0,2,2,9,10,19,26,14,40,0.000333,0.056639,4,679.668402,37.759356,169.917101,61.748606,1,0
0,0,3,3,9,9,18,63,34,97,0.000333,0.134828,12,4853.792702,269.65515,404.482725,57.05865,1,0
0,0,2,2,9,10,19,26,14,40,0.000333,0.056639,4,679.668402,37.759356,169.917101,61.748606,1,0
0,0,2,2,9,10,19,26,14,40,0.000333,0.056639,4,679.668402,37.759356,169.917101,61.748606,1,0
0,0,2,2,9,10,19,26,14,40,0.000333,0.056639,4,679.668402,37.759356,169.917101,61.748606,1,0
0,0,2,2,9,10,19,26,14,40,0.000333,0.056639,4,679.668402,37.759356,169.917101,61.748606,1,0
0,0,2,2,9,10,19,26,14,40,0.000333,0.056639,4,679.668402,37.759356,169.917101,61.748606,1,0
0,0,2,2,9,10,19,26,14,40,0.000333,0.056639,4,679.668402,37.759356,169.917101,61.748606,1,0
0,0,2,2,9,10,19,26,14,40,0.000333,0.056639,4,679.668402,37.759356,169.917101,61.748606,1,0
0,0,2,2,9,10,19,26,14,40,0.000333,0.056639,4,679.668402,37.759356,169.917101,61.748606,1,0
0,0,2,2,9,10,19,26,14,40,0.000333,0.056639,4,679.668402,37.759356,169.917101,61.748606,1,0
0,0,2,2,9,10,19,26,14,40,0.000333,0.056639,4,679.668402,37.759356,169.917101,61.748606,1,0
0,0,2,2,9,10,19,26,14,40,0.000333,0.056639,4,679.668402,37.759356,169.917101,61.748606,1,0
0,0,2,2,9,10,19,26,14,40,0.000333,0.056639,4,679.668402,37.759356,169.917101,61.748606,1,0
0,0,2,2,9,10,19,26,14,40,0.000333,0.056639,4,679.668402,37.759356,169.917101,61.748606,1,0
0,0,4,4,10,13,23,67,37,104,0.000333,0.156817,10,4704.504434,261.361357,470.450443,81.324997,1,0
0,0,2,2,9,10,19,26,14,40,0.000333,0.056639,4,679.668402,37.759356,169.917101,61.748606,2,0
0,0,10,10,9,14,23,123,66,189,0.000333,0.284984,16,13679.25136,759.958409,854.95321,81.832294,1,0
0,0,2,2,9,10,19,26,14,40,0.000333,0.056639,4,679.668402,37.759356,169.917101,61.748606,1,0
0,0,2,2,9,10,19,26,14,40,0.000333,0.056639,4,679.668402,37.759356,169.917101,61.748606,1,0
0,0,2,2,9,10,19,26,14,40,0.000333,0.056639,4,679.668402,37.759356,169.917101,61.748606,2,0
0,0,3,3,11,12,23,35,18,53,0.000333,0.079916,5,1198.743918,66.596884,239.748784,81.073298,2,0
0,0,2,2,9,10,19,26,14,40,0.000333,0.056639,4,679.668402,37.759356,169.917101,61.748606,1,0
0,0,4,4,11,13,24,25,17,42,0.000333,0.064189,5,962.842125,53.491229,192.568425,86.159464,2,0
0,0,2,2,8,8,16,22,11,33,0.000333,0.044,4,528,29.333333,132,48,1,0
0,0,2,2,7,4,11,13,5,18,0.000333,0.020757,3,186.809307,10.378295,62.269769,27.651484,3,0
0,0,18,18,16,24,40,111,56,167,0.000333,0.296254,16,14220.19187,790.010659,888.761992,174.0391,7,0
0,0,15,15,14,30,44,137,58,195,0.000333,0.354863,7,7452.124159,414.006898,1064.589166,200.509687,7,0
0,0,18,18,16,24,40,111,56,167,0.000333,0.296254,16,14220.19187,790.010659,888.761992,174.0391,7,0
0,0,2,2,7,4,11,13,5,18,0.000333,0.020757,3,186.809307,10.378295,62.269769,27.651484,3,0
0,0,18,18,16,29,45,106,59,165,0.000333,0.302052,16,14498.49217,805.471787,906.155761,204.881449,5,0
0,0,24,24,17,38,55,135,81,216,0.000333,0.416258,16,19980.37917,1110.021065,1248.773698,268.908114,5,0
0,0,18,18,16,24,40,111,56,167,0.000333,0.296254,16,14220.19187,790.010659,888.761992,174.0391,7,0
0,0,8,8,12,15,27,39,24,63,0.000333,0.099853,6,1797.347476,99.852638,299.557913,101.622909,4,0
0,0,8,8,13,14,27,41,26,67,0.000333,0.106192,6,1911.464776,106.192488,318.577463,101.408685,4,0
0,0,8,8,12,15,27,39,24,63,0.000333,0.099853,6,1797.347476,99.852638,299.557913,101.622909,4,0
0,0,2,2,7,4,11,13,5,18,0.000333,0.020757,3,186.809307,10.378295,62.269769,27.651484,3,0
0,0,18,18,16,24,40,111,56,167,0.000333,0.296254,16,14220.19187,790.010659,888.761992,174.0391,7,0
0,0,9,9,13,14,27,51,31,82,0.000333,0.129967,12,4678.809302,259.93385,389.900775,101.408685,4,0
0,0,8,8,12,14,26,40,26,66,0.000333,0.10341,6,1861.374128,103.409674,310.229021,96.322519,4,0
0,0,9,9,12,14,26,50,31,81,0.000333,0.126912,12,4568.827406,253.823745,380.735617,96.322519,4,0
0,0,19,19,16,34,50,123,68,191,0.000333,0.359326,16,17247.62452,958.201362,1077.976532,236.973737,4,0
0,0,5,5,12,12,24,58,26,84,0.000333,0.128379,12,4621.642201,256.7579,385.13685,86.0391,11,0
0,0,4,4,12,12,24,49,23,72,0.000333,0.110039,6,1980.7038,110.0391,330.1173,86.0391,10,0
0,0,2,2,7,4,11,13,5,18,0.000333,0.020757,3,186.809307,10.378295,62.269769,27.651484,3,0
0,0,1,1,5,3,8,11,3,14,0.000333,0.014,2,84,4.666667,42,16.364528,2,0
0,0,12,12,9,20,29,61,41,102,0.000333,0.165171,8,3964.112492,220.228472,495.514062,114.967887,1,0
0,0,2,2,9,10,19,26,14,40,0.000333,0.056639,4,679.668402,37.759356,169.917101,61.748606,1,0
0,0,2,2,9,10,19,26,14,40,0.000333,0.056639,4,679.668402,37.759356,169.917101,61.748606,1,0
0,0,3,3,9,9,18,63,34,97,0.000333,0.134828,12,4853.792702,269.65515,404.482725,57.05865,1,0
0,0,2,2,9,10,19,26,14,40,0.000333,0.056639,4,679.668402,37.759356,169.917101,61.748606,1,0
0,0,2,2,9,10,19,26,14,40,0.000333,0.056639,4,679.668402,37.759356,169.917101,61.748606,1,0
0,0,10,10,9,14,23,123,66,189,0.000333,0.284984,16,13679.25136,759.958409,854.95321,81.832294,1,0
0,0,2,2,9,10,19,26,14,40,0.000333,0.056639,4,679.668402,37.759356,169.917101,61.748606,1,0
0,0,2,2,9,10,19,26,14,40,0.000333,0.056639,4,679.668402,37.759356,169.917101,61.748606,1,0
0,0,2,2,9,10,19,26,14,40,0.000333,0.056639,4,679.668402,37.759356,169.917101,61.748606,1,0
0,0,2,2,9,10,19,26,14,40,0.000333,0.056639,4,679.668402,37.759356,169.917101,61.748606,1,0
0,0,5,5,13,101,114,424,267,691,0.000333,1.573842,12,56658.324,3147.684667,4721.527,720.585076,7,0
0,0,2,2,9,10,19,26,14,40,0.000333,0.056639,4,679.668402,37.759356,169.917101,61.748606,1,0
0,0,2,2,9,10,19,26,14,40,0.000333,0.056639,4,679.668402,37.759356,169.917101,61.748606,2,0
0,0,3,3,11,12,23,35,18,53,0.000333,0.079916,5,1198.743918,66.596884,239.748784,81.073298,2,0
0,0,2,2,9,10,19,26,14,40,0.000333,0.056639,4,679.668402,37.759356,169.917101,61.748606,1,0
0,0,2,2,9,10,19,26,14,40,0.000333,0.056639,4,679.668402,37.759356,169.917101,61.748606,2,0
0,0,2,2,9,10,19,26,14,40,0.000333,0.056639,4,679.668402,37.759356,169.917101,61.748606,1,0
0,0,2,2,9,10,19,26,14,40,0.000333,0.056639,4,679.668402,37.759356,169.917101,61.748606,1,0
0,0,2,2,9,10,19,26,14,40,0.000333,0.056639,4,679.668402,37.759356,169.917101,61.748606,1,0
0,0,2,2,9,10,19,26,14,40,0.000333,0.056639,4,679.668402,37.759356,169.917101,61.748606,1,0
0,0,4,4,10,13,23,67,37,104,0.000333,0.156817,10,4704.504434,261.361357,470.450443,81.324997,1,0
0,0,2,2,9,10,19,26,14,40,0.000333,0.056639,4,679.668402,37.759356,169.917101,61.748606,1,0
0,0,2,2,9,10,19,26,14,40,0.000333,0.056639,4,679.668402,37.759356,169.917101,61.748606,1,0
0,0,2,2,9,10,19,26,14,40,0.000333,0.056639,4,679.668402,37.759356,169.917101,61.748606,1,0
0,0,7,7,8,14,22,34,23,57,0.000333,0.084729,4,1016.750409,56.486134,254.187602,77.302969,3,0
0,0,5,5,12,12,24,58,26,84,0.000333,0.128379,12,4621.642201,256.7579,385.13685,86.0391,11,0
0,0,18,18,16,24,40,111,56,167,0.000333,0.296254,16,14220.19187,790.010659,888.761992,174.0391,7,0
0,0,4,4,12,12,24,49,23,72,0.000333,0.110039,6,1980.7038,110.0391,330.1173,86.0391,10,0
0,0,1,1,5,3,8,11,3,14,0.000333,0.014,2,84,4.666667,42,16.364528,2,0
0,0,2,2,9,10,19,26,14,40,0.000333,0.056639,4,679.668402,37.759356,169.917101,61.748606,1,0
0,0,2,2,9,10,19,26,14,40,0.000333,0.056639,4,679.668402,37.759356,169.917101,61.748606,1,0
0,0,3,3,9,9,18,63,34,97,0.000333,0.134828,12,4853.792702,269.65515,404.482725,57.05865,1,0
0,0,2,2,9,10,19,26,14,40,0.000333,0.056639,4,679.668402,37.759356,169.917101,61.748606,1,0
0,0,2,2,9,10,19,26,14,40,0.000333,0.056639,4,679.668402,37.759356,169.917101,61.748606,1,0
0,0,10,10,9,14,23,123,66,189,0.000333,0.284984,16,13679.25136,759.958409,854.95321,81.832294,1,0
0,0,2,2,9,10,19,26,14,40,0.000333,0.056639,4,679.668402,37.759356,169.917101,61.748606,1,0
0,0,2,2,9,10,19,26,14,40,0.000333,0.056639,4,679.668402,37.759356,169.917101,61.748606,1,0
0,0,2,2,9,10,19,26,14,40,0.000333,0.056639,4,679.668402,37.759356,169.917101,61.748606,1,0
0,0,2,2,9,10,19,26,14,40,0.000333,0.056639,4,679.668402,37.759356,169.917101,61.748606,1,0
0,0,5,5,13,101,114,424,267,691,0.000333,1.573842,12,56658.324,3147.684667,4721.527,720.585076,7,0
0,0,2,2,9,10,19,26,14,40,0.000333,0.056639,4,679.668402,37.759356,169.917101,61.748606,1,0
0,0,2,2,9,10,19,26,14,40,0.000333,0.056639,4,679.668402,37.759356,169.917101,61.748606,2,0
0,0,3,3,11,12,23,35,18,53,0.000333,0.079916,5,1198.743918,66.596884,239.748784,81.073298,2,0
0,0,2,2,9,10,19,26,14,40,0.000333,0.056639,4,679.668402,37.759356,169.917101,61.748606,1,0
0,0,2,2,9,10,19,26,14,40,0.000333,0.056639,4,679.668402,37.759356,169.917101,61.748606,2,0
0,0,2,2,9,10,19,26,14,40,0.000333,0.056639,4,679.668402,37.759356,169.917101,61.748606,1,0
0,0,2,2,9,10,19,26,14,40,0.000333,0.056639,4,679.668402,37.759356,169.917101,61.748606,1,0
0,0,2,2,9,10,19,26,14,40,0.000333,0.056639,4,679.668402,37.759356,169.917101,61.748606,1,0
0,0,2,2,9,10,19,26,14,40,0.000333,0.056639,4,679.668402,37.759356,169.917101,61.748606,1,0
0,0,4,4,10,13,23,67,37,104,0.000333,0.156817,10,4704.504434,261.361357,470.450443,81.324997,1,0
0,0,2,2,9,10,19,26,14,40,0.000333,0.056639,4,679.668402,37.759356,169.917101,61.748606,1,0
0,0,2,2,9,10,19,26,14,40,0.000333,0.056639,4,679.668402,37.759356,169.917101,61.748606,1,0
0,0,2,2,9,10,19,26,14,40,0.000333,0.056639,4,679.668402,37.759356,169.917101,61.748606,1,0
0,0,21,21,17,32,49,123,66,189,0.000333,0.353727,16,16978.88257,943.271254,1061.180161,229.486868,8,0
0,0,2,2,8,8,16,22,11,33,0.000333,0.044,4,528,29.333333,132,48,1,0
0,0,8,8,10,13,23,50,26,76,0.000333,0.114597,10,3437.907087,190.994838,343.790709,81.324997,4,0
0,0,2,2,7,4,11,13,5,18,0.000333,0.020757,3,186.809307,10.378295,62.269769,27.651484,3,0
0,0,4,4,11,13,24,25,17,42,0.000333,0.064189,5,962.842125,53.491229,192.568425,86.159464,2,0
0,0,2,2,7,4,11,13,5,18,0.000333,0.020757,3,186.809307,10.378295,62.269769,27.651484,3,0
0,0,17,17,16,23,39,110,55,165,0.000333,0.290697,16,13953.46186,775.192325,872.091366,168.041925,7,0
0,0,7,7,11,10,21,36,17,53,0.000333,0.077598,5,1163.964117,64.664673,232.792823,71.273029,4,0
0,0,2,2,7,4,11,13,5,18,0.000333,0.020757,3,186.809307,10.378295,62.269769,27.651484,3,0
0,0,2,2,7,6,13,15,9,24,0.000333,0.029604,3,266.43166,14.801759,88.810553,35.161259,3,0
0,0,4,4,7,7,14,22,13,35,0.000333,0.044419,3,399.772267,22.20957,133.257422,39.302969,1,0
0,0,11,11,11,20,31,48,35,83,0.000333,0.137066,5,2055.991469,114.221748,411.198294,124.49231,5,0
0,0,18,18,16,24,40,111,56,167,0.000333,0.296254,16,14220.19187,790.010659,888.761992,174.0391,7,0
0,0,2,2,7,4,11,13,5,18,0.000333,0.020757,3,186.809307,10.378295,62.269769,27.651484,3,0
0,0,18,18,16,24,40,111,56,167,0.000333,0.296254,16,14220.19187,790.010659,888.761992,174.0391,7,0
0,0,2,2,7,4,11,13,5,18,0.000333,0.020757,3,186.809307,10.378295,62.269769,27.651484,3,0
0,0,4,4,9,8,17,22,11,33,0.000333,0.044962,4,539.545095,29.974728,134.886274,52.529325,2,0
0,0,17,17,16,23,39,110,55,165,0.000333,0.290697,16,13953.46186,775.192325,872.091366,168.041925,7,0
0,0,2,2,7,4,11,13,5,18,0.000333,0.020757,3,186.809307,10.378295,62.269769,27.651484,3,0
0,0,18,18,16,24,40,111,56,167,0.000333,0.296254,16,14220.19187,790.010659,888.761992,174.0391,7,0
0,0,13,13,10,22,32,64,44,108,0.000333,0.18,10,5400,300,540,131.326777,3,0
0,0,2,2,7,4,11,13,5,18,0.000333,0.020757,3,186.809307,10.378295,62.269769,27.651484,3,0
0,0,5,5,10,20,30,58,36,94,0.000333,0.153749,5,2306.23858,128.124366,461.247716,119.657843,1,0
0,0,2,2,10,5,15,12,6,18,0.000333,0.023441,5,351.620154,19.534453,70.324031,44.828921,2,0
0,0,6,6,16,18,34,49,29,78,0.000333,0.132274,8,3174.576813,176.365378,396.822102,139.05865,4,0
0,0,1,1,8,3,11,10,3,13,0.000333,0.014991,4,179.890444,9.993914,44.972611,28.754888,2,0
0,0,2,2,7,4,11,13,5,18,0.000333,0.020757,3,186.809307,10.378295,62.269769,27.651484,3,0
0,0,61,61,30,104,134,620,416,1036,0.000333,2.440156,60,439228.1041,24401.56134,7320.468401,844.052449,33,0
0,0,76,76,27,65,92,765,486,1251,0.000333,2.720325,91,742648.8166,41258.26759,8160.976007,519.83587,13,0
0,0,103,103,32,119,151,961,609,1570,0.000333,3.788098,80,909143.6353,50507.97974,11364.29544,980.483314,19,0
0,0,80,80,25,67,92,627,451,1078,0.000333,2.344133,72,506332.7848,28129.59916,7032.399789,522.524381,10,0
0,0,69,69,28,69,97,610,399,1009,0.000333,2.219771,70,466151.844,25897.32467,6659.312058,556.094125,9,0
0,0,3,3,13,22,35,34,32,66,0.000333,0.112844,6,2031.196075,112.844226,338.532679,146.213212,2,0
0,0,17,17,20,45,65,167,114,281,0.000333,0.564095,20,33845.70711,1880.317062,1692.285355,333.571951,3,0
0,0,13,13,19,44,63,123,96,219,0.000333,0.436341,18,23562.43746,1309.024303,1309.024303,320.925614,7,0
0,0,25,25,24,42,66,341,223,564,0.000333,1.136346,60,204542.297,11363.46094,3409.038283,336.516432,3,0
0,0,25,25,21,58,79,227,167,394,0.000333,0.827897,20,49673.7923,2759.655128,2483.689615,432.001564,3,0
0,0,35,35,19,47,66,268,202,470,0.000333,0.946955,36,102271.1485,5681.730472,2840.865236,341.776299,20,0
0,0,7,7,12,16,28,43,25,68,0.000333,0.108967,6,1961.400808,108.966712,326.900135,107.01955,1,0
0,0,3,3,11,11,22,26,15,41,0.000333,0.060946,5,914.183482,50.787971,182.836696,76.107496,3,0
0,0,10,10,15,22,37,70,39,109,0.000333,0.189277,7,3974.812918,220.82294,567.830417,156.710855,6,0
0,0,22,22,17,34,51,128,68,196,0.000333,0.370598,16,17788.72587,988.262548,1111.795367,242.460605,9,0
0,0,2,2,7,4,11,13,5,18,0.000333,0.020757,3,186.809307,10.378295,62.269769,27.651484,3,0
0,0,24,24,14,36,50,152,80,232,0.000333,0.436458,14,18331.2449,1018.402495,1309.374636,239.420269,15,0
0,0,8,8,13,16,29,46,24,70,0.000333,0.113353,6,2040.352018,113.35289,340.05867,112.105716,3,0
0,0,27,27,19,35,54,148,78,226,0.000333,0.433535,18,23410.88236,1300.604575,1300.604575,260.235528,10,0
0,0,27,27,19,36,55,160,82,242,0.000333,0.466363,18,25183.60291,1399.089051,1399.089051,266.827923,10,0
0,0,4,4,10,7,17,21,10,31,0.000333,0.042237,5,633.55674,35.197597,126.711348,52.870765,2,0
0,0,5,5,11,13,24,36,21,57,0.000333,0.087114,5,1306.714313,72.59524,261.342863,86.159464,3,0
0,0,33,33,19,43,62,174,94,268,0.000333,0.531908,18,28723.043,1595.724611,1595.724611,314.040007,11,0
0,0,2,2,7,4,11,13,5,18,0.000333,0.020757,3,186.809307,10.378295,62.269769,27.651484,3,0
0,0,2,2,7,4,11,13,5,18,0.000333,0.020757,3,186.809307,10.378295,62.269769,27.651484,3,0
0,0,7,7,12,19,31,51,37,88,0.000333,0.145323,6,2615.815652,145.323092,435.969275,123.730173,5,0
0,0,5,5,11,13,24,36,21,57,0.000333,0.087114,5,1306.714313,72.59524,261.342863,86.159464,4,0
0,0,2,2,7,4,11,13,5,18,0.000333,0.020757,3,186.809307,10.378295,62.269769,27.651484,3,0
0,0,29,29,19,41,60,169,87,256,0.000333,0.504055,18,27218.95187,1512.163992,1512.163992,300.370255,11,0
0,0,3,3,11,11,22,26,15,41,0.000333,0.060946,5,914.183482,50.787971,182.836696,76.107496,3,0
0,0,10,10,15,22,37,70,39,109,0.000333,0.189277,7,3974.812918,220.82294,567.830417,156.710855,6,0
0,0,4,4,12,12,24,49,23,72,0.000333,0.110039,6,1980.7038,110.0391,330.1173,86.0391,10,0
0,0,2,2,7,4,11,13,5,18,0.000333,0.020757,3,186.809307,10.378295,62.269769,27.651484,3,0
0,0,5,5,12,12,24,58,26,84,0.000333,0.128379,12,4621.642201,256.7579,385.13685,86.0391,11,0
0,0,27,27,17,38,55,141,81,222,0.000333,0.427821,16,20535.3897,1140.854983,1283.461856,268.908114,10,0
0,0,1,1,5,3,8,11,3,14,0.000333,0.014,2,84,4.666667,42,16.364528,2,0
0,0,24,24,14,33,47,135,71,206,0.000333,0.381415,14,16019.43425,889.968569,1144.245303,219.767975,10,0
0,0,2,2,9,10,19,26,14,40,0.000333,0.056639,4,679.668402,37.759356,169.917101,61.748606,2,0
0,0,2,2,9,10,19,26,14,40,0.000333,0.056639,4,679.668402,37.759356,169.917101,61.748606,1,0
0,0,3,3,9,9,18,63,34,97,0.000333,0.134828,12,4853.792702,269.65515,404.482725,57.05865,1,0
0,0,2,2,9,10,19,26,14,40,0.000333,0.056639,4,679.668402,37.759356,169.917101,61.748606,1,0
0,0,3,3,11,12,23,35,18,53,0.000333,0.079916,5,1198.743918,66.596884,239.748784,81.073298,2,0
0,0,2,2,9,10,19,26,14,40,0.000333,0.056639,4,679.668402,37.759356,169.917101,61.748606,1,0
0,0,2,2,9,10,19,26,14,40,0.000333,0.056639,4,679.668402,37.759356,169.917101,61.748606,1,0
0,0,2,2,9,10,19,26,14,40,0.000333,0.056639,4,679.668402,37.759356,169.917101,61.748606,1,0
0,0,2,2,9,10,19,26,14,40,0.000333,0.056639,4,679.668402,37.759356,169.917101,61.748606,1,0
0,0,2,2,9,10,19,26,14,40,0.000333,0.056639,4,679.668402,37.759356,169.917101,61.748606,1,0
0,0,2,2,9,10,19,26,14,40,0.000333,0.056639,4,679.668402,37.759356,169.917101,61.748606,1,0
0,0,2,2,9,10,19,26,14,40,0.000333,0.056639,4,679.668402,37.759356,169.917101,61.748606,1,0
0,0,2,2,9,10,19,26,14,40,0.000333,0.056639,4,679.668402,37.759356,169.917101,61.748606,1,0
0,0,2,2,9,10,19,26,14,40,0.000333,0.056639,4,679.668402,37.759356,169.917101,61.748606,1,0
0,0,2,2,9,10,19,26,14,40,0.000333,0.056639,4,679.668402,37.759356,169.917101,61.748606,1,0
0,0,2,2,9,10,19,26,14,40,0.000333,0.056639,4,679.668402,37.759356,169.917101,61.748606,1,0
0,0,10,10,9,14,23,123,66,189,0.000333,0.284984,16,13679.25136,759.958409,854.95321,81.832294,1,0
0,0,2,2,9,10,19,26,14,40,0.000333,0.056639,4,679.668402,37.759356,169.917101,61.748606,1,0
0,0,2,2,9,10,19,26,14,40,0.000333,0.056639,4,679.668402,37.759356,169.917101,61.748606,1,0
0,0,2,2,9,10,19,26,14,40,0.000333,0.056639,4,679.668402,37.759356,169.917101,61.748606,1,0
0,0,5,5,13,101,114,424,267,691,0.000333,1.573842,12,56658.324,3147.684667,4721.527,720.585076,7,0
0,0,4,4,10,13,23,67,37,104,0.000333,0.156817,10,4704.504434,261.361357,470.450443,81.324997,1,0
0,0,2,2,9,10,19,26,14,40,0.000333,0.056639,4,679.668402,37.759356,169.917101,61.748606,1,0
0,0,2,2,9,10,19,26,14,40,0.000333,0.056639,4,679.668402,37.759356,169.917101,61.748606,2,0
0,0,3,3,11,11,22,26,15,41,0.000333,0.060946,5,914.183482,50.787971,182.836696,76.107496,3,0
0,0,10,10,15,22,37,70,39,109,0.000333,0.189277,7,3974.812918,220.82294,567.830417,156.710855,6,0
0,0,6,6,12,12,24,24,19,43,0.000333,0.065718,6,1182.920325,65.717796,197.153388,86.0391,2,0
0,0,6,6,9,12,21,22,20,42,0.000333,0.061492,4,737.909327,40.994963,184.477332,71.548875,1,0
0,0,3,3,11,11,22,26,15,41,0.000333,0.060946,5,914.183482,50.787971,182.836696,76.107496,3,0
0,0,10,10,15,22,37,70,39,109,0.000333,0.189277,7,3974.812918,220.82294,567.830417,156.710855,6,0
0,0,47,47,20,39,59,229,157,386,0.000333,0.7569,40,90828.00868,5046.000482,2270.700217,292.569248,19,0
0,0,2,2,7,4,11,13,5,18,0.000333,0.020757,3,186.809307,10.378295,62.269769,27.651484,3,0
0,0,3,3,11,11,22,26,15,41,0.000333,0.060946,5,914.183482,50.787971,182.836696,76.107496,3,0
0,0,10,10,15,22,37,70,39,109,0.000333,0.189277,7,3974.812918,220.82294,567.830417,156.710855,6,0
0,0,2,2,7,4,11,13,5,18,0.000333,0.020757,3,186.809307,10.378295,62.269769,27.651484,3,0
0,0,2,2,7,4,11,13,5,18,0.000333,0.020757,3,186.809307,10.378295,62.269769,27.651484,3,0
0,0,1,1,5,3,8,11,3,14,0.000333,0.014,2,84,4.666667,42,16.364528,2,0
0,0,5,5,12,12,24,58,26,84,0.000333,0.128379,12,4621.642201,256.7579,385.13685,86.0391,11,0
0,0,28,28,20,38,58,157,84,241,0.000333,0.470591,20,28235.4684,1568.637133,1411.77342,285.859807,10,0
0,0,18,18,14,30,44,118,62,180,0.000333,0.327566,14,13757.76768,764.320427,982.697691,200.509687,6,0
0,0,4,4,12,12,24,49,23,72,0.000333,0.110039,6,1980.7038,110.0391,330.1173,86.0391,10,0
0,0,2,2,9,10,19,26,14,40,0.000333,0.056639,4,679.668402,37.759356,169.917101,61.748606,1,0
0,0,2,2,9,10,19,26,14,40,0.000333,0.056639,4,679.668402,37.759356,169.917101,61.748606,1,0
0,0,5,5,13,101,114,424,267,691,0.000333,1.573842,12,56658.324,3147.684667,4721.527,720.585076,7,0
0,0,10,10,9,14,23,123,66,189,0.000333,0.284984,16,13679.25136,759.958409,854.95321,81.832294,1,0
0,0,2,2,9,10,19,26,14,40,0.000333,0.056639,4,679.668402,37.759356,169.917101,61.748606,1,0
0,0,2,2,9,10,19,26,14,40,0.000333,0.056639,4,679.668402,37.759356,169.917101,61.748606,2,0
0,0,2,2,9,10,19,26,14,40,0.000333,0.056639,4,679.668402,37.759356,169.917101,61.748606,1,0
0,0,3,3,9,9,18,63,34,97,0.000333,0.134828,12,4853.792702,269.65515,404.482725,57.05865,1,0
0,0,2,2,9,10,19,26,14,40,0.000333,0.056639,4,679.668402,37.759356,169.917101,61.748606,1,0
0,0,2,2,9,10,19,26,14,40,0.000333,0.056639,4,679.668402,37.759356,169.917101,61.748606,1,0
0,0,2,2,9,10,19,26,14,40,0.000333,0.056639,4,679.668402,37.759356,169.917101,61.748606,1,0
0,0,2,2,9,10,19,26,14,40,0.000333,0.056639,4,679.668402,37.759356,169.917101,61.748606,1,0
0,0,2,2,9,10,19,26,14,40,0.000333,0.056639,4,679.668402,37.759356,169.917101,61.748606,1,0
0,0,2,2,9,10,19,26,14,40,0.000333,0.056639,4,679.668402,37.759356,169.917101,61.748606,1,0
0,0,3,3,11,12,23,35,18,53,0.000333,0.079916,5,1198.743918,66.596884,239.748784,81.073298,2,0
0,0,2,2,9,10,19,26,14,40,0.000333,0.056639,4,679.668402,37.759356,169.917101,61.748606,1,0
0,0,2,2,9,10,19,26,14,40,0.000333,0.056639,4,679.668402,37.759356,169.917101,61.748606,1,0
0,0,2,2,9,10,19,26,14,40,0.000333,0.056639,4,679.668402,37.759356,169.917101,61.748606,1,0
0,0,2,2,9,10,19,26,14,40,0.000333,0.056639,4,679.668402,37.759356,169.917101,61.748606,1,0
0,0,4,4,10,13,23,67,37,104,0.000333,0.156817,10,4704.504434,261.361357,470.450443,81.324997,1,0
0,0,2,2,9,10,19,26,14,40,0.000333,0.056639,4,679.668402,37.759356,169.917101,61.748606,1,0
0,0,2,2,9,10,19,26,14,40,0.000333,0.056639,4,679.668402,37.759356,169.917101,61.748606,2,0
0,0,2,2,9,10,19,26,14,40,0.000333,0.056639,4,679.668402,37.759356,169.917101,61.748606,1,0
0,0,2,2,9,10,19,26,14,40,0.000333,0.056639,4,679.668402,37.759356,169.917101,61.748606,1,0
0,0,5,5,11,13,24,36,21,57,0.000333,0.087114,5,1306.714313,72.59524,261.342863,86.159464,3,0
0,0,36,36,19,42,61,206,111,317,0.000333,0.626681,18,33840.78725,1880.043736,1880.043736,307.187955,12,0
0,0,2,2,7,4,11,13,5,18,0.000333,0.020757,3,186.809307,10.378295,62.269769,27.651484,3,0
0,0,5,5,11,13,24,26,20,46,0.000333,0.070303,5,1054.541375,58.585632,210.908275,86.159464,1,0
0,0,2,2,7,4,11,13,5,18,0.000333,0.020757,3,186.809307,10.378295,62.269769,27.651484,3,0
0,0,25,25,23,42,65,178,89,267,0.000333,0.535991,22,35375.38853,1965.299363,1607.972206,330.519257,12,0
0,0,2,2,7,4,11,13,5,18,0.000333,0.020757,3,186.809307,10.378295,62.269769,27.651484,3,0
0,0,40,40,23,56,79,244,141,385,0.000333,0.808985,22,53393.02294,2966.279052,2426.955588,429.253801,11,0
0,0,6,6,15,11,26,56,26,82,0.000333,0.128479,14,5396.104796,299.7836,385.436057,96.657107,4,0
0,0,4,4,12,12,24,49,23,72,0.000333,0.110039,6,1980.7038,110.0391,330.1173,86.0391,10,0
0,0,5,5,12,12,24,58,26,84,0.000333,0.128379,12,4621.642201,256.7579,385.13685,86.0391,11,0
0,0,1,1,5,3,8,11,3,14,0.000333,0.014,2,84,4.666667,42,16.364528,2,0
0,0,2,2,7,4,11,13,5,18,0.000333,0.020757,3,186.809307,10.378295,62.269769,27.651484,3,0
0,0,2,2,9,10,19,26,14,40,0.000333,0.056639,4,679.668402,37.759356,169.917101,61.748606,1,0
0,0,10,10,9,14,23,123,66,189,0.000333,0.284984,16,13679.25136,759.958409,854.95321,81.832294,1,0
0,0,2,2,9,10,19,26,14,40,0.000333,0.056639,4,679.668402,37.759356,169.917101,61.748606,1,0
0,0,3,3,11,12,23,35,18,53,0.000333,0.079916,5,1198.743918,66.596884,239.748784,81.073298,2,0
0,0,5,5,13,101,114,424,267,691,0.000333,1.573842,12,56658.324,3147.684667,4721.527,720.585076,7,0
0,0,2,2,9,10,19,26,14,40,0.000333,0.056639,4,679.668402,37.759356,169.917101,61.748606,2,0
0,0,2,2,9,10,19,26,14,40,0.000333,0.056639,4,679.668402,37.759356,169.917101,61.748606,1,0
0,0,2,2,9,10,19,26,14,40,0.000333,0.056639,4,679.668402,37.759356,169.917101,61.748606,1,0
0,0,2,2,9,10,19,26,14,40,0.000333,0.056639,4,679.668402,37.759356,169.917101,61.748606,1,0
0,0,2,2,9,10,19,26,14,40,0.000333,0.056639,4,679.668402,37.759356,169.917101,61.748606,1,0
0,0,2,2,9,10,19,26,14,40,0.000333,0.056639,4,679.668402,37.759356,169.917101,61.748606,2,0
0,0,2,2,9,10,19,26,14,40,0.000333,0.056639,4,679.668402,37.759356,169.917101,61.748606,1,0
0,0,2,2,9,10,19,26,14,40,0.000333,0.056639,4,679.668402,37.759356,169.917101,61.748606,1,0
0,0,2,2,9,10,19,26,14,40,0.000333,0.056639,4,679.668402,37.759356,169.917101,61.748606,1,0
0,0,2,2,9,10,19,26,14,40,0.000333,0.056639,4,679.668402,37.759356,169.917101,61.748606,1,0
0,0,2,2,9,10,19,26,14,40,0.000333,0.056639,4,679.668402,37.759356,169.917101,61.748606,1,0
0,0,2,2,9,10,19,26,14,40,0.000333,0.056639,4,679.668402,37.759356,169.917101,61.748606,1,0
0,0,2,2,9,10,19,26,14,40,0.000333,0.056639,4,679.668402,37.759356,169.917101,61.748606,1,0
0,0,2,2,9,10,19,26,14,40,0.000333,0.056639,4,679.668402,37.759356,169.917101,61.748606,1,0
0,0,3,3,9,9,18,63,34,97,0.000333,0.134828,12,4853.792702,269.65515,404.482725,57.05865,1,0
0,0,2,2,9,10,19,26,14,40,0.000333,0.056639,4,679.668402,37.759356,169.917101,61.748606,1,0
0,0,2,2,9,10,19,26,14,40,0.000333,0.056639,4,679.668402,37.759356,169.917101,61.748606,1,0
0,0,2,2,9,10,19,26,14,40,0.000333,0.056639,4,679.668402,37.759356,169.917101,61.748606,1,0
0,0,4,4,10,13,23,67,37,104,0.000333,0.156817,10,4704.504434,261.361357,470.450443,81.324997,1,0
0,0,2,2,7,4,11,13,5,18,0.000333,0.020757,3,186.809307,10.378295,62.269769,27.651484,3,0
0,0,8,8,9,17,26,43,27,70,0.000333,0.109677,4,1316.123121,73.117951,329.03078,98.016193,3,0
0,0,5,5,11,13,24,36,21,57,0.000333,0.087114,5,1306.714313,72.59524,261.342863,86.159464,3,0
0,0,5,5,14,9,23,39,20,59,0.000333,0.088963,14,3736.462176,207.581232,266.890155,81.832294,4,0
0,0,33,33,17,48,65,171,94,265,0.000333,0.531976,8,12767.41976,709.301098,1595.92747,337.565068,10,0
0,0,2,2,7,4,11,13,5,18,0.000333,0.020757,3,186.809307,10.378295,62.269769,27.651484,3,0
0,0,3,3,11,11,22,26,15,41,0.000333,0.060946,5,914.183482,50.787971,182.836696,76.107496,3,0
0,0,10,10,15,22,37,70,39,109,0.000333,0.189277,7,3974.812918,220.82294,567.830417,156.710855,6,0
0,0,17,17,16,23,39,110,55,165,0.000333,0.290697,16,13953.46186,775.192325,872.091366,168.041925,7,0
0,0,3,3,8,4,12,13,6,19,0.000333,0.022705,4,272.45715,15.136508,68.114288,32,2,0
0,0,13,13,11,20,31,66,41,107,0.000333,0.1767,10,5300.990052,294.499447,530.099005,124.49231,1,0
0,0,28,28,19,37,56,153,80,233,0.000333,0.451038,18,24356.04654,1353.113697,1353.113697,273.460397,10,0
0,0,2,2,7,4,11,13,5,18,0.000333,0.020757,3,186.809307,10.378295,62.269769,27.651484,3,0
0,0,21,21,15,35,50,139,74,213,0.000333,0.400714,14,16829.97916,934.998842,1202.141368,238.128265,6,0
0,0,3,3,11,11,22,26,15,41,0.000333,0.060946,5,914.183482,50.787971,182.836696,76.107496,3,0
0,0,10,10,15,22,37,70,39,109,0.000333,0.189277,7,3974.812918,220.82294,567.830417,156.710855,6,0
0,0,5,5,11,13,24,36,21,57,0.000333,0.087114,5,1306.714313,72.59524,261.342863,86.159464,3,0
0,0,17,17,16,23,39,110,55,165,0.000333,0.290697,16,13953.46186,775.192325,872.091366,168.041925,7,0
0,0,2,2,7,4,11,13,5,18,0.000333,0.020757,3,186.809307,10.378295,62.269769,27.651484,3,0
0,0,17,17,16,23,39,110,55,165,0.000333,0.290697,16,13953.46186,775.192325,872.091366,168.041925,7,0
0,0,2,2,7,4,11,13,5,18,0.000333,0.020757,3,186.809307,10.378295,62.269769,27.651484,3,0
0,0,26,26,15,40,55,130,73,203,0.000333,0.391205,7,8215.312153,456.406231,1173.616022,271.480483,16,0
0,0,2,2,11,6,17,14,8,22,0.000333,0.029975,5,449.620913,24.97894,89.924183,53.563523,2,0
0,0,5,5,12,12,24,58,26,84,0.000333,0.128379,12,4621.642201,256.7579,385.13685,86.0391,11,0
0,0,31,31,20,37,57,176,96,272,0.000333,0.528849,20,31730.92168,1762.828982,1586.546084,279.188336,13,0
0,0,1,1,5,3,8,11,3,14,0.000333,0.014,2,84,4.666667,42,16.364528,2,0
0,0,4,4,12,12,24,49,23,72,0.000333,0.110039,6,1980.7038,110.0391,330.1173,86.0391,10,0
0,0,2,2,9,10,19,26,14,40,0.000333,0.056639,4,679.668402,37.759356,169.917101,61.748606,1,0
0,0,3,3,9,9,18,63,34,97,0.000333,0.134828,12,4853.792702,269.65515,404.482725,57.05865,1,0
0,0,2,2,9,10,19,26,14,40,0.000333,0.056639,4,679.668402,37.759356,169.917101,61.748606,1,0
0,0,2,2,9,10,19,26,14,40,0.000333,0.056639,4,679.668402,37.759356,169.917101,61.748606,2,0
0,0,2,2,9,10,19,26,14,40,0.000333,0.056639,4,679.668402,37.759356,169.917101,61.748606,1,0
0,0,2,2,9,10,19,26,14,40,0.000333,0.056639,4,679.668402,37.759356,169.917101,61.748606,1,0
0,0,2,2,9,10,19,26,14,40,0.000333,0.056639,4,679.668402,37.759356,169.917101,61.748606,1,0
0,0,4,4,10,13,23,67,37,104,0.000333,0.156817,10,4704.504434,261.361357,470.450443,81.324997,1,0
0,0,10,10,9,14,23,123,66,189,0.000333,0.284984,16,13679.25136,759.958409,854.95321,81.832294,1,0
0,0,2,2,9,10,19,26,14,40,0.000333,0.056639,4,679.668402,37.759356,169.917101,61.748606,1,0
0,0,2,2,9,10,19,26,14,40,0.000333,0.056639,4,679.668402,37.759356,169.917101,61.748606,1,0
0,0,2,2,9,10,19,26,14,40,0.000333,0.056639,4,679.668402,37.759356,169.917101,61.748606,1,0
0,0,2,2,9,10,19,26,14,40,0.000333,0.056639,4,679.668402,37.759356,169.917101,61.748606,1,0
0,0,2,2,9,10,19,26,14,40,0.000333,0.056639,4,679.668402,37.759356,169.917101,61.748606,1,0
0,0,2,2,9,10,19,26,14,40,0.000333,0.056639,4,679.668402,37.759356,169.917101,61.748606,1,0
0,0,2,2,9,10,19,26,14,40,0.000333,0.056639,4,679.668402,37.759356,169.917101,61.748606,1,0
0,0,2,2,9,10,19,26,14,40,0.000333,0.056639,4,679.668402,37.759356,169.917101,61.748606,1,0
0,0,2,2,9,10,19,26,14,40,0.000333,0.056639,4,679.668402,37.759356,169.917101,61.748606,1,0
0,0,2,2,9,10,19,26,14,40,0.000333,0.056639,4,679.668402,37.759356,169.917101,61.748606,2,0
0,0,2,2,9,10,19,26,14,40,0.000333,0.056639,4,679.668402,37.759356,169.917101,61.748606,1,0
0,0,3,3,11,12,23,35,18,53,0.000333,0.079916,5,1198.743918,66.596884,239.748784,81.073298,2,0
0,0,5,5,13,101,114,424,267,691,0.000333,1.573842,12,56658.324,3147.684667,4721.527,720.585076,7,0
0,0,2,2,9,10,19,26,14,40,0.000333,0.056639,4,679.668402,37.759356,169.917101,61.748606,1,0
0,0,2,2,9,10,19,26,14,40,0.000333,0.056639,4,679.668402,37.759356,169.917101,61.748606,1,0
0,0,5,5,12,12,24,58,26,84,0.000333,0.128379,12,4621.642201,256.7579,385.13685,86.0391,11,0
0,0,8,8,17,16,33,71,34,105,0.000333,0.176554,16,8474.582121,470.810118,529.661383,133.486868,10,0
0,0,4,4,12,12,24,49,23,72,0.000333,0.110039,6,1980.7038,110.0391,330.1173,86.0391,10,0
0,0,26,26,17,31,48,130,71,201,0.000333,0.374192,16,17961.2394,997.846633,1122.577463,223.066954,10,0
0,0,1,1,5,3,8,11,3,14,0.000333,0.014,2,84,4.666667,42,16.364528,2,0
0,0,6,6,15,11,26,56,26,82,0.000333,0.128479,14,5396.104796,299.7836,385.436057,96.657107,4,0
0,0,3,3,9,9,18,63,34,97,0.000333,0.134828,12,4853.792702,269.65515,404.482725,57.05865,1,0
0,0,2,2,9,10,19,26,14,40,0.000333,0.056639,4,679.668402,37.759356,169.917101,61.748606,2,0
0,0,3,3,11,12,23,35,18,53,0.000333,0.079916,5,1198.743918,66.596884,239.748784,81.073298,2,0
0,0,2,2,9,10,19,26,14,40,0.000333,0.056639,4,679.668402,37.759356,169.917101,61.748606,1,0
0,0,2,2,9,10,19,26,14,40,0.000333,0.056639,4,679.668402,37.759356,169.917101,61.748606,1,0
0,0,2,2,9,10,19,26,14,40,0.000333,0.056639,4,679.668402,37.759356,169.917101,61.748606,1,0
0,0,2,2,9,10,19,26,14,40,0.000333,0.056639,4,679.668402,37.759356,169.917101,61.748606,1,0
0,0,2,2,9,10,19,26,14,40,0.000333,0.056639,4,679.668402,37.759356,169.917101,61.748606,1,0
0,0,10,10,9,14,23,123,66,189,0.000333,0.284984,16,13679.25136,759.958409,854.95321,81.832294,1,0
0,0,2,2,9,10,19,26,14,40,0.000333,0.056639,4,679.668402,37.759356,169.917101,61.748606,1,0
0,0,2,2,9,10,19,26,14,40,0.000333,0.056639,4,679.668402,37.759356,169.917101,61.748606,1,0
0,0,2,2,9,10,19,26,14,40,0.000333,0.056639,4,679.668402,37.759356,169.917101,61.748606,1,0
0,0,2,2,9,10,19,26,14,40,0.000333,0.056639,4,679.668402,37.759356,169.917101,61.748606,1,0
0,0,4,4,10,13,23,67,37,104,0.000333,0.156817,10,4704.504434,261.361357,470.450443,81.324997,1,0
0,0,2,2,9,10,19,26,14,40,0.000333,0.056639,4,679.668402,37.759356,169.917101,61.748606,1,0
0,0,2,2,9,10,19,26,14,40,0.000333,0.056639,4,679.668402,37.759356,169.917101,61.748606,1,0
0,0,2,2,9,10,19,26,14,40,0.000333,0.056639,4,679.668402,37.759356,169.917101,61.748606,2,0
0,0,5,5,13,101,114,424,267,691,0.000333,1.573842,12,56658.324,3147.684667,4721.527,720.585076,7,0
0,0,2,2,9,10,19,26,14,40,0.000333,0.056639,4,679.668402,37.759356,169.917101,61.748606,1,0
0,0,2,2,9,10,19,26,14,40,0.000333,0.056639,4,679.668402,37.759356,169.917101,61.748606,1,0
0,0,2,2,9,10,19,26,14,40,0.000333,0.056639,4,679.668402,37.759356,169.917101,61.748606,1,0
0,0,2,2,9,10,19,26,14,40,0.000333,0.056639,4,679.668402,37.759356,169.917101,61.748606,1,0
0,0,2,2,9,10,19,26,14,40,0.000333,0.056639,4,679.668402,37.759356,169.917101,61.748606,1,0
0,0,2,2,9,10,19,26,14,40,0.000333,0.056639,4,679.668402,37.759356,169.917101,61.748606,1,0
0,0,28,28,19,38,57,151,81,232,0.000333,0.451077,18,24358.1487,1353.230483,1353.230483,280.131868,10,0
0,0,10,10,15,19,34,55,31,86,0.000333,0.145841,7,3062.65263,170.147368,437.521804,139.313982,6,0
0,0,13,13,12,21,33,67,42,109,0.000333,0.18328,12,6598.067508,366.559306,549.838959,135.258216,7,0
0,0,3,3,11,11,22,26,15,41,0.000333,0.060946,5,914.183482,50.787971,182.836696,76.107496,3,0
0,0,10,10,15,22,37,70,39,109,0.000333,0.189277,7,3974.812918,220.82294,567.830417,156.710855,6,0
0,0,5,5,11,13,24,36,21,57,0.000333,0.087114,5,1306.714313,72.59524,261.342863,86.159464,3,0
0,0,19,19,19,27,46,152,72,224,0.000333,0.412426,18,22271.00181,1237.277878,1237.277878,209.092585,9,0
0,0,28,28,19,39,58,158,85,243,0.000333,0.474496,18,25622.80887,1423.489382,1423.489382,286.841309,10,0
0,0,20,20,19,27,46,157,73,230,0.000333,0.423473,18,22867.5465,1270.41925,1270.41925,209.092585,10,0
0,0,3,3,13,21,34,35,33,68,0.000333,0.115316,6,2075.684839,115.315824,345.947473,140.344382,3,0
0,0,2,2,7,4,11,13,5,18,0.000333,0.020757,3,186.809307,10.378295,62.269769,27.651484,3,0
0,0,23,23,20,29,49,181,80,261,0.000333,0.48848,20,29308.78539,1628.265855,1465.439269,227.320011,12,0
0,0,7,7,13,28,41,61,51,112,0.000333,0.200015,6,3600.274947,200.015275,600.045825,182.711654,1,0
0,0,2,2,10,3,13,13,5,18,0.000333,0.022203,5,333.039575,18.502199,66.607915,37.974168,1,0
0,0,2,2,7,4,11,13,5,18,0.000333,0.020757,3,186.809307,10.378295,62.269769,27.651484,3,0
0,0,19,19,10,25,35,123,72,195,0.000333,0.333403,10,10002.10188,555.672327,1000.210188,149.315686,1,0
0,0,7,7,8,18,26,33,27,60,0.000333,0.094009,4,1128.105532,62.67253,282.026383,99.05865,3,0
0,0,7,7,12,15,27,31,21,52,0.000333,0.082418,6,1483.524901,82.41805,247.25415,101.622909,2,0
0,0,17,17,16,23,39,110,55,165,0.000333,0.290697,16,13953.46186,775.192325,872.091366,168.041925,7,0
0,0,6,6,13,31,44,240,168,408,0.000333,0.742483,30,66823.44301,3712.413501,2227.4481,201.685802,1,0
0,0,3,3,11,11,22,26,15,41,0.000333,0.060946,5,914.183482,50.787971,182.836696,76.107496,3,0
0,0,10,10,15,22,37,70,39,109,0.000333,0.189277,7,3974.812918,220.82294,567.830417,156.710855,6,0
0,0,3,3,12,7,19,19,10,29,0.000333,0.041063,6,739.139387,41.063299,123.189898,62.671034,2,0
0,0,16,16,18,22,40,111,61,172,0.000333,0.305124,18,16476.68938,915.371632,915.371632,173.166146,6,0
0,0,2,2,8,8,16,22,11,33,0.000333,0.044,4,528,29.333333,132,48,1,0
0,0,29,29,19,41,60,157,84,241,0.000333,0.47452,18,25624.0914,1423.560634,1423.560634,300.370255,11,0
0,0,2,2,7,4,11,13,5,18,0.000333,0.020757,3,186.809307,10.378295,62.269769,27.651484,3,0
0,0,22,22,15,31,46,125,69,194,0.000333,0.35719,14,15001.99427,833.444126,1071.571019,212.183445,13,0
0,0,25,25,16,33,49,126,82,208,0.000333,0.389287,16,18685.75436,1038.097465,1167.859648,230.465006,10,0
0,0,2,2,7,4,11,13,5,18,0.000333,0.020757,3,186.809307,10.378295,62.269769,27.651484,3,0
0,0,16,16,14,27,41,90,50,140,0.000333,0.250019,7,5250.400965,291.688942,750.057281,181.684931,5,0
0,0,17,17,16,23,39,110,55,165,0.000333,0.290697,16,13953.46186,775.192325,872.091366,168.041925,7,0
0,0,2,2,7,4,11,13,5,18,0.000333,0.020757,3,186.809307,10.378295,62.269769,27.651484,3,0
0,0,19,19,14,36,50,114,65,179,0.000333,0.33675,7,7071.751806,392.8751,1010.250258,239.420269,5,0
0,0,34,34,19,44,63,189,104,293,0.000333,0.583781,18,31524.17432,1751.343018,1751.343018,320.925614,11,0
0,0,2,2,7,4,11,13,5,18,0.000333,0.020757,3,186.809307,10.378295,62.269769,27.651484,3,0
0,0,7,7,10,15,25,54,31,85,0.000333,0.131576,10,3947.277761,219.293209,394.727776,91.82264,1,0
0,0,19,19,14,29,43,114,60,174,0.000333,0.314723,14,13218.38094,734.354497,944.170067,194.184418,10,0
0,0,2,2,7,4,11,13,5,18,0.000333,0.020757,3,186.809307,10.378295,62.269769,27.651484,3,0
0,0,28,28,19,37,56,153,80,233,0.000333,0.451038,18,24356.04654,1353.113697,1353.113697,273.460397,10,0
0,0,17,17,14,27,41,149,52,201,0.000333,0.358956,7,7538.07567,418.781982,1076.867953,181.684931,5,0
0,0,17,17,16,23,39,110,55,165,0.000333,0.290697,16,13953.46186,775.192325,872.091366,168.041925,7,0
0,0,2,2,7,4,11,13,5,18,0.000333,0.020757,3,186.809307,10.378295,62.269769,27.651484,3,0
0,0,5,5,11,13,24,36,21,57,0.000333,0.087114,5,1306.714313,72.59524,261.342863,86.159464,3,0
0,0,1,1,10,13,23,26,13,39,0.000333,0.058806,5,882.094581,49.005255,176.418916,81.324997,1,0
0,0,9,9,12,12,24,52,31,83,0.000333,0.126851,12,4566.622651,253.701258,380.551888,86.0391,4,0
0,0,8,8,12,13,25,41,24,65,0.000333,0.100617,6,1811.103914,100.616884,301.850652,91.125266,4,0
0,0,9,9,13,12,25,53,31,84,0.000333,0.130028,12,4681.007039,260.055947,390.08392,91.125266,4,0
0,0,1,1,10,13,23,26,13,39,0.000333,0.058806,5,882.094581,49.005255,176.418916,81.324997,1,0
0,0,28,28,19,38,57,154,81,235,0.000333,0.45691,18,24673.12476,1370.729153,1370.729153,280.131868,10,0
0,0,8,8,12,13,25,41,24,65,0.000333,0.100617,6,1811.103914,100.616884,301.850652,91.125266,4,0
0,0,1,1,10,13,23,26,13,39,0.000333,0.058806,5,882.094581,49.005255,176.418916,81.324997,1,0
0,0,1,1,10,13,23,26,13,39,0.000333,0.058806,5,882.094581,49.005255,176.418916,81.324997,1,0
0,0,1,1,10,13,23,26,13,39,0.000333,0.058806,5,882.094581,49.005255,176.418916,81.324997,1,0
0,0,2,2,7,4,11,13,5,18,0.000333,0.020757,3,186.809307,10.378295,62.269769,27.651484,3,0
0,0,8,8,13,12,25,43,26,69,0.000333,0.106809,12,3845.112925,213.617385,320.426077,91.125266,4,0
0,0,8,8,12,12,24,42,26,68,0.000333,0.103926,12,3741.329401,207.851633,311.77745,86.0391,4,0
0,0,1,1,10,13,23,26,13,39,0.000333,0.058806,5,882.094581,49.005255,176.418916,81.324997,1,0
0,0,17,17,16,23,39,110,55,165,0.000333,0.290697,16,13953.46186,775.192325,872.091366,168.041925,7,0
0,0,3,3,7,4,11,13,6,19,0.000333,0.02191,3,197.187602,10.954867,65.729201,27.651484,2,0
0,0,5,5,9,10,19,26,18,44,0.000333,0.062303,4,747.635242,41.535291,186.908811,61.748606,3,0
0,0,3,3,11,11,22,26,15,41,0.000333,0.060946,5,914.183482,50.787971,182.836696,76.107496,3,0
0,0,10,10,15,22,37,70,39,109,0.000333,0.189277,7,3974.812918,220.82294,567.830417,156.710855,6,0
0,0,17,17,16,23,39,110,55,165,0.000333,0.290697,16,13953.46186,775.192325,872.091366,168.041925,7,0
0,0,2,2,7,4,11,13,5,18,0.000333,0.020757,3,186.809307,10.378295,62.269769,27.651484,3,0
0,0,14,14,12,22,34,81,42,123,0.000333,0.208586,6,3754.547577,208.585976,625.757929,141.127046,5,0
0,0,13,13,21,20,41,83,51,134,0.000333,0.239304,20,14358.23937,797.679965,717.911969,178.677228,5,0
0,0,30,30,19,36,55,162,89,251,0.000333,0.483707,18,26120.18319,1451.121288,1451.121288,266.827923,11,0
0,0,4,4,12,12,24,49,23,72,0.000333,0.110039,6,1980.7038,110.0391,330.1173,86.0391,10,0
0,0,5,5,12,12,24,58,26,84,0.000333,0.128379,12,4621.642201,256.7579,385.13685,86.0391,11,0
0,0,1,1,5,3,8,11,3,14,0.000333,0.014,2,84,4.666667,42,16.364528,2,0
0,0,3,3,9,9,18,63,34,97,0.000333,0.134828,12,4853.792702,269.65515,404.482725,57.05865,1,0
0,0,2,2,9,10,19,26,14,40,0.000333,0.056639,4,679.668402,37.759356,169.917101,61.748606,2,0
0,0,3,3,11,12,23,35,18,53,0.000333,0.079916,5,1198.743918,66.596884,239.748784,81.073298,2,0
0,0,2,2,9,10,19,26,14,40,0.000333,0.056639,4,679.668402,37.759356,169.917101,61.748606,1,0
0,0,2,2,9,10,19,26,14,40,0.000333,0.056639,4,679.668402,37.759356,169.917101,61.748606,1,0
0,0,2,2,9,10,19,26,14,40,0.000333,0.056639,4,679.668402,37.759356,169.917101,61.748606,1,0
0,0,2,2,9,10,19,26,14,40,0.000333,0.056639,4,679.668402,37.759356,169.917101,61.748606,1,0
0,0,2,2,9,10,19,26,14,40,0.000333,0.056639,4,679.668402,37.759356,169.917101,61.748606,1,0
0,0,10,10,9,14,23,123,66,189,0.000333,0.284984,16,13679.25136,759.958409,854.95321,81.832294,1,0
0,0,2,2,9,10,19,26,14,40,0.000333,0.056639,4,679.668402,37.759356,169.917101,61.748606,1,0
0,0,2,2,9,10,19,26,14,40,0.000333,0.056639,4,679.668402,37.759356,169.917101,61.748606,1,0
0,0,2,2,9,10,19,26,14,40,0.000333,0.056639,4,679.668402,37.759356,169.917101,61.748606,1,0
0,0,2,2,9,10,19,26,14,40,0.000333,0.056639,4,679.668402,37.759356,169.917101,61.748606,1,0
0,0,4,4,10,13,23,67,37,104,0.000333,0.156817,10,4704.504434,261.361357,470.450443,81.324997,1,0
0,0,2,2,9,10,19,26,14,40,0.000333,0.056639,4,679.668402,37.759356,169.917101,61.748606,1,0
0,0,2,2,9,10,19,26,14,40,0.000333,0.056639,4,679.668402,37.759356,169.917101,61.748606,1,0
0,0,2,2,9,10,19,26,14,40,0.000333,0.056639,4,679.668402,37.759356,169.917101,61.748606,2,0
0,0,5,5,13,101,114,424,267,691,0.000333,1.573842,12,56658.324,3147.684667,4721.527,720.585076,7,0
0,0,2,2,9,10,19,26,14,40,0.000333,0.056639,4,679.668402,37.759356,169.917101,61.748606,1,0
0,0,2,2,9,10,19,26,14,40,0.000333,0.056639,4,679.668402,37.759356,169.917101,61.748606,1,0
0,0,2,2,9,10,19,26,14,40,0.000333,0.056639,4,679.668402,37.759356,169.917101,61.748606,1,0
0,0,2,2,9,10,19,26,14,40,0.000333,0.056639,4,679.668402,37.759356,169.917101,61.748606,1,0
0,0,2,2,9,10,19,26,14,40,0.000333,0.056639,4,679.668402,37.759356,169.917101,61.748606,1,0
0,0,2,2,9,10,19,26,14,40,0.000333,0.056639,4,679.668402,37.759356,169.917101,61.748606,1,0
0,0,5,5,11,13,24,36,21,57,0.000333,0.087114,5,1306.714313,72.59524,261.342863,86.159464,3,0
0,0,2,2,7,4,11,13,5,18,0.000333,0.020757,3,186.809307,10.378295,62.269769,27.651484,3,0
0,0,17,17,16,23,39,110,55,165,0.000333,0.290697,16,13953.46186,775.192325,872.091366,168.041925,7,0
0,0,3,3,11,11,22,26,15,41,0.000333,0.060946,5,914.183482,50.787971,182.836696,76.107496,3,0
0,0,10,10,15,22,37,70,39,109,0.000333,0.189277,7,3974.812918,220.82294,567.830417,156.710855,6,0
0,0,5,5,12,12,24,58,26,84,0.000333,0.128379,12,4621.642201,256.7579,385.13685,86.0391,11,0
0,0,4,4,12,12,24,49,23,72,0.000333,0.110039,6,1980.7038,110.0391,330.1173,86.0391,10,0
0,0,27,27,19,35,54,148,78,226,0.000333,0.433535,18,23410.88236,1300.604575,1300.604575,260.235528,10,0
0,0,1,1,5,3,8,11,3,14,0.000333,0.014,2,84,4.666667,42,16.364528,2,0
0,0,5,5,11,12,23,37,20,57,0.000333,0.085948,5,1289.215157,71.623064,257.843031,81.073298,7,0
0,0,2,2,9,10,19,26,14,40,0.000333,0.056639,4,679.668402,37.759356,169.917101,61.748606,1,0
0,0,5,5,13,101,114,424,267,691,0.000333,1.573842,12,56658.324,3147.684667,4721.527,720.585076,7,0
0,0,2,2,9,10,19,26,14,40,0.000333,0.056639,4,679.668402,37.759356,169.917101,61.748606,1,0
0,0,2,2,9,10,19,26,14,40,0.000333,0.056639,4,679.668402,37.759356,169.917101,61.748606,1,0
0,0,2,2,9,10,19,26,14,40,0.000333,0.056639,4,679.668402,37.759356,169.917101,61.748606,1,0
0,0,2,2,9,10,19,26,14,40,0.000333,0.056639,4,679.668402,37.759356,169.917101,61.748606,1,0
0,0,2,2,9,10,19,26,14,40,0.000333,0.056639,4,679.668402,37.759356,169.917101,61.748606,1,0
0,0,2,2,9,10,19,26,14,40,0.000333,0.056639,4,679.668402,37.759356,169.917101,61.748606,1,0
0,0,2,2,9,10,19,26,14,40,0.000333,0.056639,4,679.668402,37.759356,169.917101,61.748606,1,0
0,0,2,2,9,10,19,26,14,40,0.000333,0.056639,4,679.668402,37.759356,169.917101,61.748606,1,0
0,0,2,2,9,10,19,26,14,40,0.000333,0.056639,4,679.668402,37.759356,169.917101,61.748606,1,0
0,0,2,2,9,10,19,26,14,40,0.000333,0.056639,4,679.668402,37.759356,169.917101,61.748606,2,0
0,0,2,2,9,10,19,26,14,40,0.000333,0.056639,4,679.668402,37.759356,169.917101,61.748606,1,0
0,0,2,2,9,10,19,26,14,40,0.000333,0.056639,4,679.668402,37.759356,169.917101,61.748606,2,0
0,0,3,3,11,12,23,35,18,53,0.000333,0.079916,5,1198.743918,66.596884,239.748784,81.073298,2,0
0,0,10,10,9,14,23,123,66,189,0.000333,0.284984,16,13679.25136,759.958409,854.95321,81.832294,1,0
0,0,2,2,9,10,19,26,14,40,0.000333,0.056639,4,679.668402,37.759356,169.917101,61.748606,1,0
0,0,3,3,9,9,18,63,34,97,0.000333,0.134828,12,4853.792702,269.65515,404.482725,57.05865,1,0
0,0,2,2,9,10,19,26,14,40,0.000333,0.056639,4,679.668402,37.759356,169.917101,61.748606,1,0
0,0,4,4,10,13,23,67,37,104,0.000333,0.156817,10,4704.504434,261.361357,470.450443,81.324997,1,0
0,0,2,2,9,10,19,26,14,40,0.000333,0.056639,4,679.668402,37.759356,169.917101,61.748606,1,0
0,0,2,2,9,10,19,26,14,40,0.000333,0.056639,4,679.668402,37.759356,169.917101,61.748606,1,0
0,0,2,2,9,10,19,26,14,40,0.000333,0.056639,4,679.668402,37.759356,169.917101,61.748606,1,0
0,0,2,2,9,10,19,26,14,40,0.000333,0.056639,4,679.668402,37.759356,169.917101,61.748606,1,0
0,0,5,5,11,13,24,36,21,57,0.000333,0.087114,5,1306.714313,72.59524,261.342863,86.159464,3,0
0,0,17,17,16,23,39,110,55,165,0.000333,0.290697,16,13953.46186,775.192325,872.091366,168.041925,7,0
0,0,2,2,7,4,11,13,5,18,0.000333,0.020757,3,186.809307,10.378295,62.269769,27.651484,3,0
0,0,27,27,19,35,54,148,78,226,0.000333,0.433535,18,23410.88236,1300.604575,1300.604575,260.235528,10,0
0,0,17,17,20,26,46,94,55,149,0.000333,0.274337,20,16460.21463,914.456368,823.010731,208.649995,5,0
0,0,12,12,13,20,33,53,35,88,0.000333,0.147969,6,2663.440095,147.968894,443.906683,134.544278,1,0
0,0,5,5,11,13,24,36,21,57,0.000333,0.087114,5,1306.714313,72.59524,261.342863,86.159464,3,0
0,0,2,2,7,4,11,13,5,18,0.000333,0.020757,3,186.809307,10.378295,62.269769,27.651484,3,0
0,0,28,28,19,38,57,154,81,235,0.000333,0.45691,18,24673.12476,1370.729153,1370.729153,280.131868,10,0
0,0,2,2,7,4,11,13,5,18,0.000333,0.020757,3,186.809307,10.378295,62.269769,27.651484,3,0
0,0,1,1,5,3,8,11,3,14,0.000333,0.014,2,84,4.666667,42,16.364528,2,0
0,0,5,5,12,12,24,58,26,84,0.000333,0.128379,12,4621.642201,256.7579,385.13685,86.0391,11,0
0,0,4,4,12,12,24,49,23,72,0.000333,0.110039,6,1980.7038,110.0391,330.1173,86.0391,10,0
0,0,2,2,9,10,19,26,14,40,0.000333,0.056639,4,679.668402,37.759356,169.917101,61.748606,2,0
0,0,2,2,9,10,19,26,14,40,0.000333,0.056639,4,679.668402,37.759356,169.917101,61.748606,1,0
0,0,2,2,9,10,19,26,14,40,0.000333,0.056639,4,679.668402,37.759356,169.917101,61.748606,1,0
0,0,2,2,9,10,19,26,14,40,0.000333,0.056639,4,679.668402,37.759356,169.917101,61.748606,1,0
0,0,2,2,9,10,19,26,14,40,0.000333,0.056639,4,679.668402,37.759356,169.917101,61.748606,1,0
0,0,2,2,9,10,19,26,14,40,0.000333,0.056639,4,679.668402,37.759356,169.917101,61.748606,1,0
0,0,3,3,9,9,18,63,34,97,0.000333,0.134828,12,4853.792702,269.65515,404.482725,57.05865,1,0
0,0,2,2,9,10,19,26,14,40,0.000333,0.056639,4,679.668402,37.759356,169.917101,61.748606,1,0
0,0,5,5,13,101,114,424,267,691,0.000333,1.573842,12,56658.324,3147.684667,4721.527,720.585076,7,0
0,0,4,4,10,13,23,67,37,104,0.000333,0.156817,10,4704.504434,261.361357,470.450443,81.324997,1,0
0,0,2,2,9,10,19,26,14,40,0.000333,0.056639,4,679.668402,37.759356,169.917101,61.748606,1,0
0,0,2,2,9,10,19,26,14,40,0.000333,0.056639,4,679.668402,37.759356,169.917101,61.748606,1,0
0,0,2,2,9,10,19,26,14,40,0.000333,0.056639,4,679.668402,37.759356,169.917101,61.748606,1,0
0,0,2,2,9,10,19,26,14,40,0.000333,0.056639,4,679.668402,37.759356,169.917101,61.748606,1,0
0,0,2,2,9,10,19,26,14,40,0.000333,0.056639,4,679.668402,37.759356,169.917101,61.748606,1,0
0,0,2,2,9,10,19,26,14,40,0.000333,0.056639,4,679.668402,37.759356,169.917101,61.748606,1,0
0,0,10,10,9,14,23,123,66,189,0.000333,0.284984,16,13679.25136,759.958409,854.95321,81.832294,1,0
0,0,2,2,9,10,19,26,14,40,0.000333,0.056639,4,679.668402,37.759356,169.917101,61.748606,1,0
0,0,2,2,9,10,19,26,14,40,0.000333,0.056639,4,679.668402,37.759356,169.917101,61.748606,1,0
0,0,3,3,11,12,23,35,18,53,0.000333,0.079916,5,1198.743918,66.596884,239.748784,81.073298,2,0
0,0,2,2,9,10,19,26,14,40,0.000333,0.056639,4,679.668402,37.759356,169.917101,61.748606,1,0
0,0,2,2,9,10,19,26,14,40,0.000333,0.056639,4,679.668402,37.759356,169.917101,61.748606,1,0
0,0,2,2,9,10,19,26,14,40,0.000333,0.056639,4,679.668402,37.759356,169.917101,61.748606,1,0
0,0,2,2,9,10,19,26,14,40,0.000333,0.056639,4,679.668402,37.759356,169.917101,61.748606,2,0
0,0,17,17,16,23,39,110,55,165,0.000333,0.290697,16,13953.46186,775.192325,872.091366,168.041925,7,0
0,0,6,6,16,12,28,47,24,71,0.000333,0.113774,16,5461.155191,303.397511,341.322199,107.01955,4,0
0,0,2,2,7,4,11,13,5,18,0.000333,0.020757,3,186.809307,10.378295,62.269769,27.651484,3,0
0,0,18,18,15,29,44,100,54,154,0.000333,0.280251,7,5885.267285,326.959294,840.752469,199.484808,7,0
0,0,31,31,20,37,57,176,96,272,0.000333,0.528849,20,31730.92168,1762.828982,1586.546084,279.188336,11,0
0,0,3,3,10,17,27,36,24,60,0.000333,0.095098,5,1426.466251,79.248125,285.29325,102.706149,4,0
0,0,15,15,17,37,54,135,91,226,0.000333,0.433535,16,20809.67321,1156.092956,1300.604575,262.236643,9,0
0,0,30,30,27,49,76,470,316,786,0.000333,1.636957,78,383047.94,21280.44111,4910.871026,403.502745,10,0
0,0,19,19,27,38,65,275,184,459,0.000333,0.921422,52,143741.875,7985.65972,2764.266826,327.803208,10,0
0,0,19,19,27,35,62,251,166,417,0.000333,0.827633,52,129110.7928,7172.821822,2482.899861,307.906868,10,0
0,0,30,30,27,50,77,471,324,795,0.000333,1.660698,78,388603.4334,21589.07963,4982.0953,410.574772,10,0
0,0,38,38,27,63,90,541,367,908,0.000333,1.964868,65,383149.1697,21286.06499,5894.602611,504.950598,10,0
0,0,17,17,26,34,60,302,195,497,0.000333,0.978575,65,190822.1007,10601.22782,2935.724626,295.185169,19,0
0,0,22,22,27,38,65,305,199,504,0.000333,1.011758,65,197292.7696,10960.70942,3035.273378,327.803208,10,0
0,0,59,59,28,80,108,635,432,1067,0.000333,2.402488,70,504522.5475,28029.03042,7207.464965,640.360185,10,0
0,0,35,35,27,62,89,493,333,826,0.000333,1.782985,65,347682.1279,19315.67377,5348.955814,497.542134,10,0
0,0,28,28,27,53,80,417,277,694,0.000333,1.462473,65,285182.1764,15843.45424,4387.418098,431.961747,10,0
0,0,4,4,15,18,33,51,32,83,0.000333,0.139562,7,2930.792983,162.821832,418.684712,133.662009,1,0
0,0,39,39,16,34,50,282,159,441,0.000333,0.829647,32,79646.09855,4424.783253,2488.94058,236.973737,9,0
0,0,9,9,22,17,39,295,185,480,0.000333,0.845664,110,279069.2372,15503.84651,2536.993065,167.594364,37,0
0,0,26,26,27,41,68,338,218,556,0.000333,1.12821,65,220000.9071,12222.27262,3384.62934,348.041595,10,0
0,0,3,3,11,11,22,26,15,41,0.000333,0.060946,5,914.183482,50.787971,182.836696,76.107496,3,0
0,0,10,10,15,22,37,70,39,109,0.000333,0.189277,7,3974.812918,220.82294,567.830417,156.710855,6,0
0,0,17,17,16,23,39,110,55,165,0.000333,0.290697,16,13953.46186,775.192325,872.091366,168.041925,7,0
0,0,2,2,7,4,11,13,5,18,0.000333,0.020757,3,186.809307,10.378295,62.269769,27.651484,3,0
0,0,14,14,13,23,36,86,44,130,0.000333,0.22403,6,4032.541501,224.030083,672.09025,152.147641,5,0
0,0,2,2,7,4,11,13,5,18,0.000333,0.020757,3,186.809307,10.378295,62.269769,27.651484,3,0
0,0,15,15,12,24,36,88,45,133,0.000333,0.2292,6,4125.600151,229.200008,687.600025,153.05865,5,0
0,0,9,9,12,12,24,52,31,83,0.000333,0.126851,12,4566.622651,253.701258,380.551888,86.0391,4,0
0,0,1,1,10,13,23,26,13,39,0.000333,0.058806,5,882.094581,49.005255,176.418916,81.324997,1,0
0,0,1,1,10,13,23,26,13,39,0.000333,0.058806,5,882.094581,49.005255,176.418916,81.324997,1,0
0,0,1,1,10,13,23,26,13,39,0.000333,0.058806,5,882.094581,49.005255,176.418916,81.324997,1,0
0,0,8,8,12,13,25,41,24,65,0.000333,0.100617,6,1811.103914,100.616884,301.850652,91.125266,4,0
0,0,1,1,10,13,23,26,13,39,0.000333,0.058806,5,882.094581,49.005255,176.418916,81.324997,1,0
0,0,9,9,13,12,25,53,31,84,0.000333,0.130028,12,4681.007039,260.055947,390.08392,91.125266,4,0
0,0,1,1,10,13,23,26,13,39,0.000333,0.058806,5,882.094581,49.005255,176.418916,81.324997,1,0
0,0,6,6,15,11,26,56,26,82,0.000333,0.128479,14,5396.104796,299.7836,385.436057,96.657107,4,0
0,0,1,1,10,13,23,26,13,39,0.000333,0.058806,5,882.094581,49.005255,176.418916,81.324997,1,0
0,0,8,8,12,13,25,41,24,65,0.000333,0.100617,6,1811.103914,100.616884,301.850652,91.125266,4,0
0,0,2,2,7,4,11,13,5,18,0.000333,0.020757,3,186.809307,10.378295,62.269769,27.651484,3,0
0,0,8,8,13,12,25,43,26,69,0.000333,0.106809,12,3845.112925,213.617385,320.426077,91.125266,4,0
0,0,17,17,16,23,39,110,55,165,0.000333,0.290697,16,13953.46186,775.192325,872.091366,168.041925,7,0
0,0,8,8,12,12,24,42,26,68,0.000333,0.103926,12,3741.329401,207.851633,311.77745,86.0391,4,0
0,0,17,17,13,30,43,104,56,160,0.000333,0.289401,6,5209.214165,289.400787,868.202361,195.312434,5,0
0,0,17,17,16,23,39,110,55,165,0.000333,0.290697,16,13953.46186,775.192325,872.091366,168.041925,7,0
0,0,2,2,7,4,11,13,5,18,0.000333,0.020757,3,186.809307,10.378295,62.269769,27.651484,3,0
0,0,5,5,11,13,24,36,21,57,0.000333,0.087114,5,1306.714313,72.59524,261.342863,86.159464,3,0
0,0,2,2,7,4,11,13,5,18,0.000333,0.020757,3,186.809307,10.378295,62.269769,27.651484,3,0
0,0,32,32,20,44,64,181,97,278,0.000333,0.556,20,33360,1853.333333,1668,326.653553,11,0
0,0,3,3,11,11,22,26,15,41,0.000333,0.060946,5,914.183482,50.787971,182.836696,76.107496,3,0
0,0,10,10,15,22,37,70,39,109,0.000333,0.189277,7,3974.812918,220.82294,567.830417,156.710855,6,0
0,0,5,5,11,13,24,36,21,57,0.000333,0.087114,5,1306.714313,72.59524,261.342863,86.159464,3,0
0,0,2,2,7,4,11,13,5,18,0.000333,0.020757,3,186.809307,10.378295,62.269769,27.651484,3,0
0,0,28,28,20,39,59,154,82,236,0.000333,0.462768,20,27766.07519,1542.559733,1388.30376,292.569248,10,0
0,0,21,21,16,26,42,119,71,190,0.000333,0.341513,16,16392.64497,910.702498,1024.54031,186.211433,6,0
0,0,5,5,11,13,24,36,21,57,0.000333,0.087114,5,1306.714313,72.59524,261.342863,86.159464,3,0
0,0,2,2,7,4,11,13,5,18,0.000333,0.020757,3,186.809307,10.378295,62.269769,27.651484,3,0
0,0,27,27,17,39,56,142,82,224,0.000333,0.433616,16,20813.56004,1156.308891,1300.847503,275.617555,10,0
0,0,28,28,19,37,56,153,80,233,0.000333,0.451038,18,24356.04654,1353.113697,1353.113697,273.460397,10,0
0,0,2,2,7,4,11,13,5,18,0.000333,0.020757,3,186.809307,10.378295,62.269769,27.651484,3,0
0,0,19,19,16,31,47,134,67,201,0.000333,0.372157,16,17863.55775,992.419875,1116.472359,217.580086,6,0
0,0,7,7,10,12,22,51,24,75,0.000333,0.111486,10,3344.573714,185.809651,334.457371,76.238831,1,0
0,0,8,8,10,14,24,66,30,96,0.000333,0.146719,10,4401.564001,244.531333,440.1564,86.52225,1,0
0,0,2,2,7,4,11,13,5,18,0.000333,0.020757,3,186.809307,10.378295,62.269769,27.651484,3,0
0,0,17,17,16,23,39,110,55,165,0.000333,0.290697,16,13953.46186,775.192325,872.091366,168.041925,7,0
0,0,16,16,15,26,41,91,50,141,0.000333,0.251805,7,5287.903829,293.772435,755.414833,180.814792,5,0
0,0,5,5,11,13,24,36,21,57,0.000333,0.087114,5,1306.714313,72.59524,261.342863,86.159464,3,0
0,0,5,5,12,12,24,58,26,84,0.000333,0.128379,12,4621.642201,256.7579,385.13685,86.0391,11,0
0,0,28,28,19,38,57,151,79,230,0.000333,0.447188,18,24148.16466,1341.564703,1341.564703,280.131868,10,0
0,0,4,4,12,12,24,49,23,72,0.000333,0.110039,6,1980.7038,110.0391,330.1173,86.0391,10,0
0,0,2,2,7,4,11,13,5,18,0.000333,0.020757,3,186.809307,10.378295,62.269769,27.651484,3,0
0,0,1,1,5,3,8,11,3,14,0.000333,0.014,2,84,4.666667,42,16.364528,2,0
0,0,5,5,13,101,114,424,267,691,0.000333,1.573842,12,56658.324,3147.684667,4721.527,720.585076,7,0
0,0,2,2,9,10,19,26,14,40,0.000333,0.056639,4,679.668402,37.759356,169.917101,61.748606,1,0
0,0,3,3,9,9,18,63,34,97,0.000333,0.134828,12,4853.792702,269.65515,404.482725,57.05865,1,0
0,0,2,2,9,10,19,26,14,40,0.000333,0.056639,4,679.668402,37.759356,169.917101,61.748606,1,0
0,0,2,2,9,10,19,26,14,40,0.000333,0.056639,4,679.668402,37.759356,169.917101,61.748606,1,0
0,0,2,2,9,10,19,26,14,40,0.000333,0.056639,4,679.668402,37.759356,169.917101,61.748606,1,0
0,0,2,2,9,10,19,26,14,40,0.000333,0.056639,4,679.668402,37.759356,169.917101,61.748606,1,0
0,0,2,2,9,10,19,26,14,40,0.000333,0.056639,4,679.668402,37.759356,169.917101,61.748606,1,0
0,0,2,2,9,10,19,26,14,40,0.000333,0.056639,4,679.668402,37.759356,169.917101,61.748606,1,0
0,0,2,2,9,10,19,26,14,40,0.000333,0.056639,4,679.668402,37.759356,169.917101,61.748606,1,0
0,0,2,2,9,10,19,26,14,40,0.000333,0.056639,4,679.668402,37.759356,169.917101,61.748606,1,0
0,0,2,2,9,10,19,26,14,40,0.000333,0.056639,4,679.668402,37.759356,169.917101,61.748606,1,0
0,0,2,2,9,10,19,26,14,40,0.000333,0.056639,4,679.668402,37.759356,169.917101,61.748606,1,0
0,0,2,2,9,10,19,26,14,40,0.000333,0.056639,4,679.668402,37.759356,169.917101,61.748606,1,0
0,0,2,2,9,10,19,26,14,40,0.000333,0.056639,4,679.668402,37.759356,169.917101,61.748606,1,0
0,0,2,2,9,10,19,26,14,40,0.000333,0.056639,4,679.668402,37.759356,169.917101,61.748606,1,0
0,0,4,4,10,13,23,67,37,104,0.000333,0.156817,10,4704.504434,261.361357,470.450443,81.324997,1,0
0,0,2,2,9,10,19,26,14,40,0.000333,0.056639,4,679.668402,37.759356,169.917101,61.748606,2,0
0,0,10,10,9,14,23,123,66,189,0.000333,0.284984,16,13679.25136,759.958409,854.95321,81.832294,1,0
0,0,2,2,9,10,19,26,14,40,0.000333,0.056639,4,679.668402,37.759356,169.917101,61.748606,1,0
0,0,2,2,9,10,19,26,14,40,0.000333,0.056639,4,679.668402,37.759356,169.917101,61.748606,1,0
0,0,2,2,9,10,19,26,14,40,0.000333,0.056639,4,679.668402,37.759356,169.917101,61.748606,2,0
0,0,3,3,11,12,23,35,18,53,0.000333,0.079916,5,1198.743918,66.596884,239.748784,81.073298,2,0
0,0,2,2,9,10,19,26,14,40,0.000333,0.056639,4,679.668402,37.759356,169.917101,61.748606,1,0
0,0,17,17,16,32,48,102,78,180,0.000333,0.335098,16,16084.692,893.594,1005.29325,224,1,0
0,0,7,7,11,10,21,36,17,53,0.000333,0.077598,5,1163.964117,64.664673,232.792823,71.273029,4,0
0,0,2,2,7,4,11,13,5,18,0.000333,0.020757,3,186.809307,10.378295,62.269769,27.651484,3,0
0,0,5,5,11,11,22,37,20,57,0.000333,0.084729,5,1270.938011,70.607667,254.187602,76.107496,1,0
0,0,2,2,7,4,11,13,5,18,0.000333,0.020757,3,186.809307,10.378295,62.269769,27.651484,3,0
0,0,1,1,5,3,8,11,3,14,0.000333,0.014,2,84,4.666667,42,16.364528,2,0
0,0,5,5,12,12,24,58,26,84,0.000333,0.128379,12,4621.642201,256.7579,385.13685,86.0391,11,0
0,0,31,31,19,37,56,163,87,250,0.000333,0.483946,18,26133.09715,1451.838731,1451.838731,273.460397,11,0
0,0,19,19,15,30,45,120,59,179,0.000333,0.327681,7,6881.29193,382.293996,983.041704,205.810077,7,0
0,0,4,4,12,12,24,49,23,72,0.000333,0.110039,6,1980.7038,110.0391,330.1173,86.0391,10,0
0,0,20,20,14,33,47,125,70,195,0.000333,0.361048,14,15164.02757,842.445976,1083.144826,219.767975,1,0
0,0,2,2,9,10,19,26,14,40,0.000333,0.056639,4,679.668402,37.759356,169.917101,61.748606,2,0
0,0,2,2,9,10,19,26,14,40,0.000333,0.056639,4,679.668402,37.759356,169.917101,61.748606,1,0
0,0,2,2,9,10,19,26,14,40,0.000333,0.056639,4,679.668402,37.759356,169.917101,61.748606,1,0
0,0,3,3,11,12,23,35,18,53,0.000333,0.079916,5,1198.743918,66.596884,239.748784,81.073298,2,0
0,0,2,2,9,10,19,26,14,40,0.000333,0.056639,4,679.668402,37.759356,169.917101,61.748606,1,0
0,0,4,4,10,13,23,67,37,104,0.000333,0.156817,10,4704.504434,261.361357,470.450443,81.324997,1,0
0,0,10,10,9,14,23,123,66,189,0.000333,0.284984,16,13679.25136,759.958409,854.95321,81.832294,1,0
0,0,2,2,9,10,19,26,14,40,0.000333,0.056639,4,679.668402,37.759356,169.917101,61.748606,1,0
0,0,2,2,9,10,19,26,14,40,0.000333,0.056639,4,679.668402,37.759356,169.917101,61.748606,1,0
0,0,2,2,9,10,19,26,14,40,0.000333,0.056639,4,679.668402,37.759356,169.917101,61.748606,1,0
0,0,2,2,9,10,19,26,14,40,0.000333,0.056639,4,679.668402,37.759356,169.917101,61.748606,1,0
0,0,2,2,9,10,19,26,14,40,0.000333,0.056639,4,679.668402,37.759356,169.917101,61.748606,1,0
0,0,2,2,9,10,19,26,14,40,0.000333,0.056639,4,679.668402,37.759356,169.917101,61.748606,1,0
0,0,2,2,9,10,19,26,14,40,0.000333,0.056639,4,679.668402,37.759356,169.917101,61.748606,1,0
0,0,2,2,9,10,19,26,14,40,0.000333,0.056639,4,679.668402,37.759356,169.917101,61.748606,2,0
0,0,2,2,9,10,19,26,14,40,0.000333,0.056639,4,679.668402,37.759356,169.917101,61.748606,1,0
0,0,5,5,13,101,114,424,267,691,0.000333,1.573842,12,56658.324,3147.684667,4721.527,720.585076,7,0
0,0,2,2,9,10,19,26,14,40,0.000333,0.056639,4,679.668402,37.759356,169.917101,61.748606,1,0
0,0,3,3,9,9,18,63,34,97,0.000333,0.134828,12,4853.792702,269.65515,404.482725,57.05865,1,0
0,0,2,2,9,10,19,26,14,40,0.000333,0.056639,4,679.668402,37.759356,169.917101,61.748606,1,0
0,0,2,2,9,10,19,26,14,40,0.000333,0.056639,4,679.668402,37.759356,169.917101,61.748606,1,0
0,0,2,2,9,10,19,26,14,40,0.000333,0.056639,4,679.668402,37.759356,169.917101,61.748606,1,0
0,0,2,2,9,10,19,26,14,40,0.000333,0.056639,4,679.668402,37.759356,169.917101,61.748606,1,0
0,0,2,2,9,10,19,26,14,40,0.000333,0.056639,4,679.668402,37.759356,169.917101,61.748606,1,0
0,0,5,5,11,13,24,36,21,57,0.000333,0.087114,5,1306.714313,72.59524,261.342863,86.159464,3,0
0,0,2,2,7,4,11,13,5,18,0.000333,0.020757,3,186.809307,10.378295,62.269769,27.651484,3,0
0,0,7,7,11,10,21,36,17,53,0.000333,0.077598,5,1163.964117,64.664673,232.792823,71.273029,4,0
0,0,17,17,16,23,39,110,55,165,0.000333,0.290697,16,13953.46186,775.192325,872.091366,168.041925,7,0
0,0,17,17,16,23,39,110,55,165,0.000333,0.290697,16,13953.46186,775.192325,872.091366,168.041925,7,0
0,0,2,2,7,4,11,13,5,18,0.000333,0.020757,3,186.809307,10.378295,62.269769,27.651484,3,0
0,0,18,18,12,35,47,108,61,169,0.000333,0.312909,6,5632.353096,312.908505,938.725516,222.544456,5,0
0,0,5,5,11,13,24,36,21,57,0.000333,0.087114,5,1306.714313,72.59524,261.342863,86.159464,3,0
0,0,1,1,5,3,8,11,3,14,0.000333,0.014,2,84,4.666667,42,16.364528,2,0
0,0,28,28,20,39,59,154,82,236,0.000333,0.462768,20,27766.07519,1542.559733,1388.30376,292.569248,10,0
0,0,4,4,12,12,24,49,23,72,0.000333,0.110039,6,1980.7038,110.0391,330.1173,86.0391,10,0
0,0,2,2,7,4,11,13,5,18,0.000333,0.020757,3,186.809307,10.378295,62.269769,27.651484,3,0
0,0,5,5,12,12,24,58,26,84,0.000333,0.128379,12,4621.642201,256.7579,385.13685,86.0391,11,0
0,0,15,15,14,22,36,91,55,146,0.000333,0.251603,14,10567.3267,587.073706,754.80905,151.410465,2,0
0,0,2,2,9,10,19,26,14,40,0.000333,0.056639,4,679.668402,37.759356,169.917101,61.748606,2,0
0,0,2,2,9,10,19,26,14,40,0.000333,0.056639,4,679.668402,37.759356,169.917101,61.748606,1,0
0,0,2,2,9,10,19,26,14,40,0.000333,0.056639,4,679.668402,37.759356,169.917101,61.748606,1,0
0,0,2,2,9,10,19,26,14,40,0.000333,0.056639,4,679.668402,37.759356,169.917101,61.748606,1,0
0,0,2,2,9,10,19,26,14,40,0.000333,0.056639,4,679.668402,37.759356,169.917101,61.748606,1,0
0,0,2,2,9,10,19,26,14,40,0.000333,0.056639,4,679.668402,37.759356,169.917101,61.748606,1,0
0,0,2,2,9,10,19,26,14,40,0.000333,0.056639,4,679.668402,37.759356,169.917101,61.748606,1,0
0,0,5,5,13,101,114,424,267,691,0.000333,1.573842,12,56658.324,3147.684667,4721.527,720.585076,7,0
0,0,10,10,9,14,23,123,66,189,0.000333,0.284984,16,13679.25136,759.958409,854.95321,81.832294,1,0
0,0,2,2,9,10,19,26,14,40,0.000333,0.056639,4,679.668402,37.759356,169.917101,61.748606,1,0
0,0,2,2,9,10,19,26,14,40,0.000333,0.056639,4,679.668402,37.759356,169.917101,61.748606,2,0
0,0,2,2,9,10,19,26,14,40,0.000333,0.056639,4,679.668402,37.759356,169.917101,61.748606,1,0
0,0,2,2,9,10,19,26,14,40,0.000333,0.056639,4,679.668402,37.759356,169.917101,61.748606,1,0
0,0,4,4,10,13,23,67,37,104,0.000333,0.156817,10,4704.504434,261.361357,470.450443,81.324997,1,0
0,0,2,2,9,10,19,26,14,40,0.000333,0.056639,4,679.668402,37.759356,169.917101,61.748606,1,0
0,0,2,2,9,10,19,26,14,40,0.000333,0.056639,4,679.668402,37.759356,169.917101,61.748606,1,0
0,0,3,3,11,12,23,35,18,53,0.000333,0.079916,5,1198.743918,66.596884,239.748784,81.073298,2,0
0,0,2,2,9,10,19,26,14,40,0.000333,0.056639,4,679.668402,37.759356,169.917101,61.748606,1,0
0,0,2,2,9,10,19,26,14,40,0.000333,0.056639,4,679.668402,37.759356,169.917101,61.748606,1,0
0,0,2,2,9,10,19,26,14,40,0.000333,0.056639,4,679.668402,37.759356,169.917101,61.748606,1,0
0,0,3,3,9,9,18,63,34,97,0.000333,0.134828,12,4853.792702,269.65515,404.482725,57.05865,1,0
0,0,2,2,9,10,19,26,14,40,0.000333,0.056639,4,679.668402,37.759356,169.917101,61.748606,1,0
0,0,2,2,9,10,19,26,14,40,0.000333,0.056639,4,679.668402,37.759356,169.917101,61.748606,1,0
0,0,2,2,9,10,19,26,14,40,0.000333,0.056639,4,679.668402,37.759356,169.917101,61.748606,1,0
0,0,5,5,11,13,24,36,21,57,0.000333,0.087114,5,1306.714313,72.59524,261.342863,86.159464,3,0
0,0,29,29,19,40,59,154,81,235,0.000333,0.460807,18,24883.5801,1382.421117,1382.421117,293.587747,10,0
0,0,2,2,7,4,11,13,5,18,0.000333,0.020757,3,186.809307,10.378295,62.269769,27.651484,3,0
0,0,4,4,11,10,21,30,16,46,0.000333,0.067349,5,1010.233007,56.124056,202.046601,71.273029,1,0
0,0,3,3,11,11,22,26,15,41,0.000333,0.060946,5,914.183482,50.787971,182.836696,76.107496,3,0
0,0,10,10,15,22,37,70,39,109,0.000333,0.189277,7,3974.812918,220.82294,567.830417,156.710855,6,0
0,0,34,34,23,43,66,235,115,350,0.000333,0.705179,22,46541.83472,2585.657484,2115.537942,337.371309,10,0
0,0,2,2,7,4,11,13,5,18,0.000333,0.020757,3,186.809307,10.378295,62.269769,27.651484,3,0
0,0,28,28,19,38,57,165,84,249,0.000333,0.48413,18,26143.01304,1452.389614,1452.389614,280.131868,10,0
0,0,5,5,14,9,23,39,20,59,0.000333,0.088963,14,3736.462176,207.581232,266.890155,81.832294,4,0
0,0,30,30,18,37,55,145,83,228,0.000333,0.439383,18,23726.70026,1318.150015,1318.150015,267.808425,11,0
0,0,17,17,20,26,46,143,69,212,0.000333,0.390332,20,23419.90269,1301.105705,1170.995135,208.649995,6,0
0,0,2,2,8,8,16,22,11,33,0.000333,0.044,4,528,29.333333,132,48,1,0
0,0,7,7,12,19,31,51,37,88,0.000333,0.145323,6,2615.815652,145.323092,435.969275,123.730173,5,0
0,0,5,5,12,12,24,58,26,84,0.000333,0.128379,12,4621.642201,256.7579,385.13685,86.0391,11,0
0,0,1,1,5,3,8,11,3,14,0.000333,0.014,2,84,4.666667,42,16.364528,2,0
0,0,35,35,19,39,58,200,108,308,0.000333,0.601419,18,32476.64664,1804.258146,1804.258146,286.841309,12,0
0,0,4,4,12,12,24,49,23,72,0.000333,0.110039,6,1980.7038,110.0391,330.1173,86.0391,10,0
0,0,21,21,20,25,45,142,75,217,0.000333,0.397244,30,35751.96366,1986.220203,1191.732122,202.534967,6,0
0,0,2,2,9,10,19,26,14,40,0.000333,0.056639,4,679.668402,37.759356,169.917101,61.748606,1,0
0,0,5,5,13,101,114,424,267,691,0.000333,1.573842,12,56658.324,3147.684667,4721.527,720.585076,7,0
0,0,2,2,9,10,19,26,14,40,0.000333,0.056639,4,679.668402,37.759356,169.917101,61.748606,1,0
0,0,2,2,9,10,19,26,14,40,0.000333,0.056639,4,679.668402,37.759356,169.917101,61.748606,1,0
0,0,2,2,9,10,19,26,14,40,0.000333,0.056639,4,679.668402,37.759356,169.917101,61.748606,1,0
0,0,2,2,9,10,19,26,14,40,0.000333,0.056639,4,679.668402,37.759356,169.917101,61.748606,1,0
0,0,2,2,9,10,19,26,14,40,0.000333,0.056639,4,679.668402,37.759356,169.917101,61.748606,1,0
0,0,2,2,9,10,19,26,14,40,0.000333,0.056639,4,679.668402,37.759356,169.917101,61.748606,1,0
0,0,2,2,9,10,19,26,14,40,0.000333,0.056639,4,679.668402,37.759356,169.917101,61.748606,1,0
0,0,2,2,9,10,19,26,14,40,0.000333,0.056639,4,679.668402,37.759356,169.917101,61.748606,1,0
0,0,2,2,9,10,19,26,14,40,0.000333,0.056639,4,679.668402,37.759356,169.917101,61.748606,1,0
0,0,2,2,9,10,19,26,14,40,0.000333,0.056639,4,679.668402,37.759356,169.917101,61.748606,2,0
0,0,2,2,9,10,19,26,14,40,0.000333,0.056639,4,679.668402,37.759356,169.917101,61.748606,1,0
0,0,2,2,9,10,19,26,14,40,0.000333,0.056639,4,679.668402,37.759356,169.917101,61.748606,2,0
0,0,3,3,11,12,23,35,18,53,0.000333,0.079916,5,1198.743918,66.596884,239.748784,81.073298,2,0
0,0,10,10,9,14,23,123,66,189,0.000333,0.284984,16,13679.25136,759.958409,854.95321,81.832294,1,0
0,0,2,2,9,10,19,26,14,40,0.000333,0.056639,4,679.668402,37.759356,169.917101,61.748606,1,0
0,0,3,3,9,9,18,63,34,97,0.000333,0.134828,12,4853.792702,269.65515,404.482725,57.05865,1,0
0,0,2,2,9,10,19,26,14,40,0.000333,0.056639,4,679.668402,37.759356,169.917101,61.748606,1,0
0,0,4,4,10,13,23,67,37,104,0.000333,0.156817,10,4704.504434,261.361357,470.450443,81.324997,1,0
0,0,2,2,9,10,19,26,14,40,0.000333,0.056639,4,679.668402,37.759356,169.917101,61.748606,1,0
0,0,2,2,9,10,19,26,14,40,0.000333,0.056639,4,679.668402,37.759356,169.917101,61.748606,1,0
0,0,2,2,9,10,19,26,14,40,0.000333,0.056639,4,679.668402,37.759356,169.917101,61.748606,1,0
0,0,2,2,9,10,19,26,14,40,0.000333,0.056639,4,679.668402,37.759356,169.917101,61.748606,1,0
0,0,5,5,11,13,24,36,21,57,0.000333,0.087114,5,1306.714313,72.59524,261.342863,86.159464,4,0
0,0,2,2,7,4,11,13,5,18,0.000333,0.020757,3,186.809307,10.378295,62.269769,27.651484,3,0
0,0,17,17,16,23,39,110,55,165,0.000333,0.290697,16,13953.46186,775.192325,872.091366,168.041925,7,0
0,0,5,5,14,9,23,39,20,59,0.000333,0.088963,14,3736.462176,207.581232,266.890155,81.832294,4,0
0,0,3,3,11,11,22,26,15,41,0.000333,0.060946,5,914.183482,50.787971,182.836696,76.107496,3,0
0,0,10,10,15,22,37,70,39,109,0.000333,0.189277,7,3974.812918,220.82294,567.830417,156.710855,6,0
0,0,14,14,13,23,36,81,43,124,0.000333,0.21369,6,3846.424201,213.690233,641.0707,152.147641,5,0
0,0,17,17,16,23,39,110,55,165,0.000333,0.290697,16,13953.46186,775.192325,872.091366,168.041925,7,0
0,0,2,2,7,4,11,13,5,18,0.000333,0.020757,3,186.809307,10.378295,62.269769,27.651484,3,0
0,0,11,11,13,21,34,58,40,98,0.000333,0.16619,6,2991.428151,166.190453,498.571358,140.344382,3,0
0,0,7,7,10,12,22,51,24,75,0.000333,0.111486,10,3344.573714,185.809651,334.457371,76.238831,1,0
0,0,8,8,10,14,24,66,30,96,0.000333,0.146719,10,4401.564001,244.531333,440.1564,86.52225,1,0
0,0,6,6,16,18,34,49,29,78,0.000333,0.132274,8,3174.576813,176.365378,396.822102,139.05865,4,0
0,0,2,2,10,5,15,12,6,18,0.000333,0.023441,5,351.620154,19.534453,70.324031,44.828921,2,0
0,0,2,2,7,4,11,13,5,18,0.000333,0.020757,3,186.809307,10.378295,62.269769,27.651484,3,0
0,0,8,8,17,13,30,41,27,68,0.000333,0.111223,16,5338.696968,296.594276,333.668561,117.592585,4,0
0,0,45,45,29,51,80,553,348,901,0.000333,1.898686,84,478468.8059,26581.60033,5696.057213,430.175141,9,0
0,0,48,48,29,63,92,519,325,844,0.000333,1.835295,70,385412.0404,21411.78002,5505.886291,517.450084,9,0
0,0,19,19,20,53,73,252,171,423,0.000333,0.872765,30,78548.87365,4363.826314,2618.295788,390.018346,3,0
0,0,62,62,27,65,92,716,446,1162,0.000333,2.526793,78,591269.5614,32848.30897,7580.378993,519.83587,11,0
0,0,3,3,14,18,32,26,25,51,0.000333,0.085,7,1785,99.166667,255,128.361619,3,0
0,0,17,17,20,45,65,167,114,281,0.000333,0.564095,20,33845.70711,1880.317062,1692.285355,333.571951,3,0
0,0,55,55,28,69,97,480,307,787,0.000333,1.731377,56,290871.3588,16159.51993,5194.131407,556.094125,11,0
0,0,3,3,13,22,35,34,32,66,0.000333,0.112844,6,2031.196075,112.844226,338.532679,146.213212,2,0
0,0,17,17,19,44,63,168,133,301,0.000333,0.59972,27,48577.35394,2698.741885,1799.161257,320.925614,11,0
0,0,102,102,32,119,151,945,604,1549,0.000333,3.73743,80,896983.1153,49832.39529,11212.28894,980.483314,17,0
0,0,69,69,25,67,92,546,395,941,0.000333,2.046224,60,368320.308,20462.23934,6138.671801,522.524381,8,0
0,0,25,25,21,58,79,227,167,394,0.000333,0.827897,20,49673.7923,2759.655128,2483.689615,432.001564,3,0
0,0,66,66,30,113,143,715,510,1225,0.000333,2.923614,60,526250.5433,29236.14129,8770.842388,917.886941,69,0
0,0,35,35,19,47,66,268,202,470,0.000333,0.946955,36,102271.1485,5681.730472,2840.865236,341.776299,20,0
0,0,60,60,30,104,134,591,408,999,0.000333,2.353008,45,317656.0396,17647.55775,7059.023101,844.052449,35,0
0,0,39,39,29,68,97,463,287,750,0.000333,1.649978,56,277196.3394,15399.79663,4949.934632,554.828922,7,0
0,0,17,17,14,19,33,131,74,205,0.000333,0.3447,21,21716.11668,1206.450927,1034.100794,134.013592,1,0
0,0,45,45,25,50,75,636,385,1021,0.000333,2.119875,84,534208.4062,29678.24479,6359.623883,398.289214,7,0
0,0,25,25,24,42,66,341,223,564,0.000333,1.136346,60,204542.297,11363.46094,3409.038283,336.516432,3,0
0,0,17,17,16,23,39,110,55,165,0.000333,0.290697,16,13953.46186,775.192325,872.091366,168.041925,7,0
0,0,6,6,10,12,22,34,18,52,0.000333,0.077297,5,1159.452221,64.414012,231.890444,76.238831,2,0
0,0,16,16,13,26,39,88,49,137,0.000333,0.241367,6,4344.600624,241.366701,724.100104,170.317149,5,0
0,0,32,32,20,46,66,177,93,270,0.000333,0.543995,20,32639.72825,1813.318236,1631.986412,340.522412,11,0
0,0,2,2,7,4,11,13,5,18,0.000333,0.020757,3,186.809307,10.378295,62.269769,27.651484,3,0
0,0,8,8,9,14,23,36,25,61,0.000333,0.091979,4,1103.749117,61.319395,275.937279,81.832294,1,0
0,0,5,5,10,20,30,58,36,94,0.000333,0.153749,5,2306.23858,128.124366,461.247716,119.657843,1,0
0,0,2,2,7,4,11,13,5,18,0.000333,0.020757,3,186.809307,10.378295,62.269769,27.651484,3,0
0,0,1,1,5,3,8,11,3,14,0.000333,0.014,2,84,4.666667,42,16.364528,2,0
0,0,28,28,19,38,57,153,81,234,0.000333,0.454965,18,24568.13274,1364.896263,1364.896263,280.131868,10,0
0,0,5,5,12,12,24,58,26,84,0.000333,0.128379,12,4621.642201,256.7579,385.13685,86.0391,11,0
0,0,17,17,12,25,37,105,52,157,0.000333,0.272628,12,9814.610141,545.256119,817.884178,159.115955,6,0
0,0,4,4,12,12,24,49,23,72,0.000333,0.110039,6,1980.7038,110.0391,330.1173,86.0391,10,0
0,0,17,17,13,26,39,103,60,163,0.000333,0.287174,12,10338.24674,574.347041,861.520562,170.317149,1,0
0,0,2,2,9,10,19,26,14,40,0.000333,0.056639,4,679.668402,37.759356,169.917101,61.748606,2,0
0,0,2,2,9,10,19,26,14,40,0.000333,0.056639,4,679.668402,37.759356,169.917101,61.748606,1,0
0,0,2,2,9,10,19,26,14,40,0.000333,0.056639,4,679.668402,37.759356,169.917101,61.748606,1,0
0,0,2,2,9,10,19,26,14,40,0.000333,0.056639,4,679.668402,37.759356,169.917101,61.748606,1,0
0,0,2,2,9,10,19,26,14,40,0.000333,0.056639,4,679.668402,37.759356,169.917101,61.748606,1,0
0,0,2,2,9,10,19,26,14,40,0.000333,0.056639,4,679.668402,37.759356,169.917101,61.748606,1,0
0,0,2,2,9,10,19,26,14,40,0.000333,0.056639,4,679.668402,37.759356,169.917101,61.748606,1,0
0,0,5,5,13,101,114,424,267,691,0.000333,1.573842,12,56658.324,3147.684667,4721.527,720.585076,7,0
0,0,10,10,9,14,23,123,66,189,0.000333,0.284984,16,13679.25136,759.958409,854.95321,81.832294,1,0
0,0,2,2,9,10,19,26,14,40,0.000333,0.056639,4,679.668402,37.759356,169.917101,61.748606,1,0
0,0,2,2,9,10,19,26,14,40,0.000333,0.056639,4,679.668402,37.759356,169.917101,61.748606,2,0
0,0,2,2,9,10,19,26,14,40,0.000333,0.056639,4,679.668402,37.759356,169.917101,61.748606,1,0
0,0,2,2,9,10,19,26,14,40,0.000333,0.056639,4,679.668402,37.759356,169.917101,61.748606,1,0
0,0,4,4,10,13,23,67,37,104,0.000333,0.156817,10,4704.504434,261.361357,470.450443,81.324997,1,0
0,0,2,2,9,10,19,26,14,40,0.000333,0.056639,4,679.668402,37.759356,169.917101,61.748606,1,0
0,0,2,2,9,10,19,26,14,40,0.000333,0.056639,4,679.668402,37.759356,169.917101,61.748606,1,0
0,0,3,3,11,12,23,35,18,53,0.000333,0.079916,5,1198.743918,66.596884,239.748784,81.073298,2,0
0,0,2,2,9,10,19,26,14,40,0.000333,0.056639,4,679.668402,37.759356,169.917101,61.748606,1,0
0,0,2,2,9,10,19,26,14,40,0.000333,0.056639,4,679.668402,37.759356,169.917101,61.748606,1,0
0,0,2,2,9,10,19,26,14,40,0.000333,0.056639,4,679.668402,37.759356,169.917101,61.748606,1,0
0,0,3,3,9,9,18,63,34,97,0.000333,0.134828,12,4853.792702,269.65515,404.482725,57.05865,1,0
0,0,2,2,9,10,19,26,14,40,0.000333,0.056639,4,679.668402,37.759356,169.917101,61.748606,1,0
0,0,2,2,9,10,19,26,14,40,0.000333,0.056639,4,679.668402,37.759356,169.917101,61.748606,1,0
0,0,2,2,9,10,19,26,14,40,0.000333,0.056639,4,679.668402,37.759356,169.917101,61.748606,1,0
0,0,21,21,12,32,44,117,72,189,0.000333,0.343944,12,12381.99091,687.888384,1031.832576,203.01955,4,0
0,0,2,2,7,4,11,13,5,18,0.000333,0.020757,3,186.809307,10.378295,62.269769,27.651484,3,0
0,0,1,1,5,3,8,11,3,14,0.000333,0.014,2,84,4.666667,42,16.364528,2,0
0,0,28,28,17,38,55,145,78,223,0.000333,0.429748,16,20627.89146,1145.99397,1289.243216,268.908114,11,0
0,0,4,4,12,12,24,49,23,72,0.000333,0.110039,6,1980.7038,110.0391,330.1173,86.0391,10,0
0,0,27,27,16,37,53,150,80,230,0.000333,0.439141,16,21078.74727,1171.041515,1317.421705,256.749775,12,0
0,0,5,5,12,12,24,58,26,84,0.000333,0.128379,12,4621.642201,256.7579,385.13685,86.0391,11,0
0,0,2,2,9,10,19,26,14,40,0.000333,0.056639,4,679.668402,37.759356,169.917101,61.748606,1,0
0,0,2,2,9,10,19,26,14,40,0.000333,0.056639,4,679.668402,37.759356,169.917101,61.748606,1,0
0,0,3,3,9,9,18,63,34,97,0.000333,0.134828,12,4853.792702,269.65515,404.482725,57.05865,1,0
0,0,2,2,9,10,19,26,14,40,0.000333,0.056639,4,679.668402,37.759356,169.917101,61.748606,2,0
0,0,2,2,9,10,19,26,14,40,0.000333,0.056639,4,679.668402,37.759356,169.917101,61.748606,1,0
0,0,2,2,9,10,19,26,14,40,0.000333,0.056639,4,679.668402,37.759356,169.917101,61.748606,1,0
0,0,2,2,9,10,19,26,14,40,0.000333,0.056639,4,679.668402,37.759356,169.917101,61.748606,1,0
0,0,2,2,9,10,19,26,14,40,0.000333,0.056639,4,679.668402,37.759356,169.917101,61.748606,1,0
0,0,2,2,9,10,19,26,14,40,0.000333,0.056639,4,679.668402,37.759356,169.917101,61.748606,1,0
0,0,2,2,9,10,19,26,14,40,0.000333,0.056639,4,679.668402,37.759356,169.917101,61.748606,1,0
0,0,2,2,9,10,19,26,14,40,0.000333,0.056639,4,679.668402,37.759356,169.917101,61.748606,1,0
0,0,2,2,9,10,19,26,14,40,0.000333,0.056639,4,679.668402,37.759356,169.917101,61.748606,1,0
0,0,2,2,9,10,19,26,14,40,0.000333,0.056639,4,679.668402,37.759356,169.917101,61.748606,1,0
0,0,2,2,9,10,19,26,14,40,0.000333,0.056639,4,679.668402,37.759356,169.917101,61.748606,1,0
0,0,10,10,9,14,23,123,66,189,0.000333,0.284984,16,13679.25136,759.958409,854.95321,81.832294,1,0
0,0,2,2,9,10,19,26,14,40,0.000333,0.056639,4,679.668402,37.759356,169.917101,61.748606,1,0
0,0,3,3,11,12,23,35,18,53,0.000333,0.079916,5,1198.743918,66.596884,239.748784,81.073298,2,0
0,0,5,5,13,101,114,424,267,691,0.000333,1.573842,12,56658.324,3147.684667,4721.527,720.585076,7,0
0,0,4,4,10,13,23,67,37,104,0.000333,0.156817,10,4704.504434,261.361357,470.450443,81.324997,1,0
0,0,2,2,9,10,19,26,14,40,0.000333,0.056639,4,679.668402,37.759356,169.917101,61.748606,1,0
0,0,2,2,9,10,19,26,14,40,0.000333,0.056639,4,679.668402,37.759356,169.917101,61.748606,1,0
0,0,2,2,9,10,19,26,14,40,0.000333,0.056639,4,679.668402,37.759356,169.917101,61.748606,2,0
0,0,2,2,9,10,19,26,14,40,0.000333,0.056639,4,679.668402,37.759356,169.917101,61.748606,1,0
0,0,2,2,9,10,19,26,14,40,0.000333,0.056639,4,679.668402,37.759356,169.917101,61.748606,1,0
0,0,3,3,11,11,22,26,15,41,0.000333,0.060946,5,914.183482,50.787971,182.836696,76.107496,3,0
0,0,10,10,15,22,37,70,39,109,0.000333,0.189277,7,3974.812918,220.82294,567.830417,156.710855,6,0
0,0,3,3,11,11,22,26,15,41,0.000333,0.060946,5,914.183482,50.787971,182.836696,76.107496,3,0
0,0,10,10,15,22,37,70,39,109,0.000333,0.189277,7,3974.812918,220.82294,567.830417,156.710855,6,0
0,0,3,3,11,11,22,26,15,41,0.000333,0.060946,5,914.183482,50.787971,182.836696,76.107496,3,0
0,0,10,10,15,22,37,70,39,109,0.000333,0.189277,7,3974.812918,220.82294,567.830417,156.710855,6,0
0,0,6,6,16,18,34,49,29,78,0.000333,0.132274,8,3174.576813,176.365378,396.822102,139.05865,4,0
0,0,2,2,10,5,15,12,6,18,0.000333,0.023441,5,351.620154,19.534453,70.324031,44.828921,2,0
0,0,8,8,17,13,30,41,27,68,0.000333,0.111223,16,5338.696968,296.594276,333.668561,117.592585,4,0
0,0,45,45,22,82,104,289,179,468,0.000333,1.045269,22,68987.72734,3832.651519,3135.805788,619.42676,11,0
0,0,5,5,10,9,19,23,14,37,0.000333,0.052391,5,785.86659,43.659255,157.173318,61.748606,5,0
0,0,49,49,27,65,92,468,298,766,0.000333,1.665683,52,259846.5198,14435.91777,4997.048458,519.83587,9,0
0,0,3,3,13,22,35,34,32,66,0.000333,0.112844,6,2031.196075,112.844226,338.532679,146.213212,2,0
0,0,54,54,30,113,143,618,439,1057,0.000333,2.522661,45,340559.2801,18919.96001,7567.984003,917.886941,61,0
0,0,70,70,28,69,97,615,403,1018,0.000333,2.23957,70,470309.7891,26128.32162,6718.711273,556.094125,9,0
0,0,36,36,19,47,66,273,206,479,0.000333,0.965088,36,104229.5322,5790.529566,2895.264783,341.776299,20,0
0,0,39,39,29,51,80,459,287,746,0.000333,1.572053,70,330131.0851,18340.61584,4716.158359,430.175141,7,0
0,0,20,20,19,44,63,201,158,359,0.000333,0.715281,27,57937.7743,3218.765239,2145.843493,320.925614,12,0
0,0,17,17,14,19,33,131,74,205,0.000333,0.3447,21,21716.11668,1206.450927,1034.100794,134.013592,1,0
0,0,59,59,30,104,134,589,407,996,0.000333,2.345942,45,316702.1175,17594.56208,7037.824834,844.052449,36,0
0,0,19,19,20,53,73,252,171,423,0.000333,0.872765,30,78548.87365,4363.826314,2618.295788,390.018346,3,0
0,0,25,25,21,58,79,227,167,394,0.000333,0.827897,20,49673.7923,2759.655128,2483.689615,432.001564,3,0
0,0,102,102,32,119,151,959,606,1565,0.000333,3.776034,80,906248.2734,50347.1263,11328.10342,980.483314,18,0
0,0,17,17,20,45,65,167,114,281,0.000333,0.564095,20,33845.70711,1880.317062,1692.285355,333.571951,3,0
0,0,25,25,24,42,66,341,223,564,0.000333,1.136346,60,204542.297,11363.46094,3409.038283,336.516432,3,0
0,0,38,38,29,68,97,445,276,721,0.000333,1.586179,56,266478.0809,14804.33783,4758.537159,554.828922,7,0
0,0,44,44,29,63,92,482,300,782,0.000333,1.700475,56,285679.8252,15871.1014,5101.42545,517.450084,7,0
0,0,42,42,25,50,75,567,350,917,0.000333,1.903942,84,479793.4461,26655.19145,5711.826739,398.289214,7,0
0,0,73,73,25,67,92,611,442,1053,0.000333,2.28977,72,494590.3733,27477.24296,6869.31074,522.524381,8,0
0,0,3,3,14,18,32,26,25,51,0.000333,0.085,7,1785,99.166667,255,128.361619,3,0
0,0,3,3,11,11,22,26,15,41,0.000333,0.060946,5,914.183482,50.787971,182.836696,76.107496,3,0
0,0,10,10,15,22,37,70,39,109,0.000333,0.189277,7,3974.812918,220.82294,567.830417,156.710855,6,0
0,0,3,3,11,11,22,26,15,41,0.000333,0.060946,5,914.183482,50.787971,182.836696,76.107496,3,0
0,0,10,10,15,22,37,70,39,109,0.000333,0.189277,7,3974.812918,220.82294,567.830417,156.710855,6,0
0,0,1,1,10,13,23,26,13,39,0.000333,0.058806,5,882.094581,49.005255,176.418916,81.324997,1,0
0,0,31,31,19,45,64,162,89,251,0.000333,0.502,9,13554,753,1506,327.844012,10,0
0,0,8,8,12,13,25,41,24,65,0.000333,0.100617,6,1811.103914,100.616884,301.850652,91.125266,4,0
0,0,1,1,10,13,23,26,13,39,0.000333,0.058806,5,882.094581,49.005255,176.418916,81.324997,1,0
0,0,2,2,7,4,11,13,5,18,0.000333,0.020757,3,186.809307,10.378295,62.269769,27.651484,3,0
0,0,1,1,10,13,23,26,13,39,0.000333,0.058806,5,882.094581,49.005255,176.418916,81.324997,1,0
0,0,8,8,13,12,25,43,26,69,0.000333,0.106809,12,3845.112925,213.617385,320.426077,91.125266,4,0
0,0,1,1,10,13,23,26,13,39,0.000333,0.058806,5,882.094581,49.005255,176.418916,81.324997,1,0
0,0,1,1,10,13,23,26,13,39,0.000333,0.058806,5,882.094581,49.005255,176.418916,81.324997,1,0
0,0,32,32,25,42,67,189,112,301,0.000333,0.608631,24,43821.42831,2434.523795,1825.892846,342.573737,10,0
0,0,8,8,12,12,24,42,26,68,0.000333,0.103926,12,3741.329401,207.851633,311.77745,86.0391,4,0
0,0,9,9,13,12,25,53,31,84,0.000333,0.130028,12,4681.007039,260.055947,390.08392,91.125266,4,0
0,0,9,9,12,12,24,52,31,83,0.000333,0.126851,12,4566.622651,253.701258,380.551888,86.0391,4,0
0,0,8,8,12,13,25,41,24,65,0.000333,0.100617,6,1811.103914,100.616884,301.850652,91.125266,4,0
0,0,1,1,10,13,23,26,13,39,0.000333,0.058806,5,882.094581,49.005255,176.418916,81.324997,1,0
0,0,40,40,23,45,68,228,242,470,0.000333,0.953703,55,157360.9144,8742.273025,2861.107535,351.175314,6,0
0,0,6,6,11,10,21,37,16,53,0.000333,0.077598,5,1163.964117,64.664673,232.792823,71.273029,6,0
0,0,17,17,16,23,39,110,55,165,0.000333,0.290697,16,13953.46186,775.192325,872.091366,168.041925,7,0
0,0,7,7,12,19,31,51,37,88,0.000333,0.145323,6,2615.815652,145.323092,435.969275,123.730173,5,0
0,0,5,5,11,13,24,36,21,57,0.000333,0.087114,5,1306.714313,72.59524,261.342863,86.159464,3,0
0,0,28,28,19,39,58,158,85,243,0.000333,0.474496,18,25622.80887,1423.489382,1423.489382,286.841309,10,0
0,0,5,5,12,12,24,58,26,84,0.000333,0.128379,12,4621.642201,256.7579,385.13685,86.0391,11,0
0,0,2,2,7,4,11,13,5,18,0.000333,0.020757,3,186.809307,10.378295,62.269769,27.651484,3,0
0,0,4,4,12,12,24,49,23,72,0.000333,0.110039,6,1980.7038,110.0391,330.1173,86.0391,10,0
0,0,2,2,9,10,19,26,14,40,0.000333,0.056639,4,679.668402,37.759356,169.917101,61.748606,1,0
0,0,2,2,9,10,19,26,14,40,0.000333,0.056639,4,679.668402,37.759356,169.917101,61.748606,1,0
0,0,5,5,13,101,114,424,267,691,0.000333,1.573842,12,56658.324,3147.684667,4721.527,720.585076,7,0
0,0,10,10,9,14,23,123,66,189,0.000333,0.284984,16,13679.25136,759.958409,854.95321,81.832294,1,0
0,0,2,2,9,10,19,26,14,40,0.000333,0.056639,4,679.668402,37.759356,169.917101,61.748606,1,0
0,0,2,2,9,10,19,26,14,40,0.000333,0.056639,4,679.668402,37.759356,169.917101,61.748606,2,0
0,0,2,2,9,10,19,26,14,40,0.000333,0.056639,4,679.668402,37.759356,169.917101,61.748606,1,0
0,0,3,3,9,9,18,63,34,97,0.000333,0.134828,12,4853.792702,269.65515,404.482725,57.05865,1,0
0,0,2,2,9,10,19,26,14,40,0.000333,0.056639,4,679.668402,37.759356,169.917101,61.748606,1,0
0,0,2,2,9,10,19,26,14,40,0.000333,0.056639,4,679.668402,37.759356,169.917101,61.748606,1,0
0,0,2,2,9,10,19,26,14,40,0.000333,0.056639,4,679.668402,37.759356,169.917101,61.748606,1,0
0,0,2,2,9,10,19,26,14,40,0.000333,0.056639,4,679.668402,37.759356,169.917101,61.748606,1,0
0,0,2,2,9,10,19,26,14,40,0.000333,0.056639,4,679.668402,37.759356,169.917101,61.748606,1,0
0,0,2,2,9,10,19,26,14,40,0.000333,0.056639,4,679.668402,37.759356,169.917101,61.748606,1,0
0,0,3,3,11,12,23,35,18,53,0.000333,0.079916,5,1198.743918,66.596884,239.748784,81.073298,2,0
0,0,2,2,9,10,19,26,14,40,0.000333,0.056639,4,679.668402,37.759356,169.917101,61.748606,1,0
0,0,2,2,9,10,19,26,14,40,0.000333,0.056639,4,679.668402,37.759356,169.917101,61.748606,1,0
0,0,2,2,9,10,19,26,14,40,0.000333,0.056639,4,679.668402,37.759356,169.917101,61.748606,1,0
0,0,2,2,9,10,19,26,14,40,0.000333,0.056639,4,679.668402,37.759356,169.917101,61.748606,1,0
0,0,4,4,10,13,23,67,37,104,0.000333,0.156817,10,4704.504434,261.361357,470.450443,81.324997,1,0
0,0,2,2,9,10,19,26,14,40,0.000333,0.056639,4,679.668402,37.759356,169.917101,61.748606,1,0
0,0,2,2,9,10,19,26,14,40,0.000333,0.056639,4,679.668402,37.759356,169.917101,61.748606,2,0
0,0,2,2,9,10,19,26,14,40,0.000333,0.056639,4,679.668402,37.759356,169.917101,61.748606,1,0
0,0,2,2,9,10,19,26,14,40,0.000333,0.056639,4,679.668402,37.759356,169.917101,61.748606,1,0
0,0,5,5,11,13,24,36,21,57,0.000333,0.087114,5,1306.714313,72.59524,261.342863,86.159464,3,0
0,0,5,5,12,12,24,58,26,84,0.000333,0.128379,12,4621.642201,256.7579,385.13685,86.0391,11,0
0,0,28,28,19,38,57,151,79,230,0.000333,0.447188,18,24148.16466,1341.564703,1341.564703,280.131868,10,0
0,0,4,4,12,12,24,49,23,72,0.000333,0.110039,6,1980.7038,110.0391,330.1173,86.0391,10,0
0,0,2,2,7,4,11,13,5,18,0.000333,0.020757,3,186.809307,10.378295,62.269769,27.651484,3,0
0,0,15,15,14,22,36,91,55,146,0.000333,0.251603,14,10567.3267,587.073706,754.80905,151.410465,2,0
0,0,5,5,13,101,114,424,267,691,0.000333,1.573842,12,56658.324,3147.684667,4721.527,720.585076,7,0
0,0,2,2,9,10,19,26,14,40,0.000333,0.056639,4,679.668402,37.759356,169.917101,61.748606,1,0
0,0,3,3,9,9,18,63,34,97,0.000333,0.134828,12,4853.792702,269.65515,404.482725,57.05865,1,0
0,0,2,2,9,10,19,26,14,40,0.000333,0.056639,4,679.668402,37.759356,169.917101,61.748606,1,0
0,0,2,2,9,10,19,26,14,40,0.000333,0.056639,4,679.668402,37.759356,169.917101,61.748606,1,0
0,0,2,2,9,10,19,26,14,40,0.000333,0.056639,4,679.668402,37.759356,169.917101,61.748606,1,0
0,0,2,2,9,10,19,26,14,40,0.000333,0.056639,4,679.668402,37.759356,169.917101,61.748606,1,0
0,0,2,2,9,10,19,26,14,40,0.000333,0.056639,4,679.668402,37.759356,169.917101,61.748606,1,0
0,0,2,2,9,10,19,26,14,40,0.000333,0.056639,4,679.668402,37.759356,169.917101,61.748606,1,0
0,0,2,2,9,10,19,26,14,40,0.000333,0.056639,4,679.668402,37.759356,169.917101,61.748606,1,0
0,0,2,2,9,10,19,26,14,40,0.000333,0.056639,4,679.668402,37.759356,169.917101,61.748606,1,0
0,0,2,2,9,10,19,26,14,40,0.000333,0.056639,4,679.668402,37.759356,169.917101,61.748606,1,0
0,0,2,2,9,10,19,26,14,40,0.000333,0.056639,4,679.668402,37.759356,169.917101,61.748606,1,0
0,0,2,2,9,10,19,26,14,40,0.000333,0.056639,4,679.668402,37.759356,169.917101,61.748606,1,0
0,0,2,2,9,10,19,26,14,40,0.000333,0.056639,4,679.668402,37.759356,169.917101,61.748606,1,0
0,0,2,2,9,10,19,26,14,40,0.000333,0.056639,4,679.668402,37.759356,169.917101,61.748606,1,0
0,0,4,4,10,13,23,67,37,104,0.000333,0.156817,10,4704.504434,261.361357,470.450443,81.324997,1,0
0,0,2,2,9,10,19,26,14,40,0.000333,0.056639,4,679.668402,37.759356,169.917101,61.748606,2,0
0,0,10,10,9,14,23,123,66,189,0.000333,0.284984,16,13679.25136,759.958409,854.95321,81.832294,1,0
0,0,2,2,9,10,19,26,14,40,0.000333,0.056639,4,679.668402,37.759356,169.917101,61.748606,1,0
0,0,2,2,9,10,19,26,14,40,0.000333,0.056639,4,679.668402,37.759356,169.917101,61.748606,1,0
0,0,2,2,9,10,19,26,14,40,0.000333,0.056639,4,679.668402,37.759356,169.917101,61.748606,2,0
0,0,3,3,11,12,23,35,18,53,0.000333,0.079916,5,1198.743918,66.596884,239.748784,81.073298,2,0
0,0,2,2,9,10,19,26,14,40,0.000333,0.056639,4,679.668402,37.759356,169.917101,61.748606,1,0
0,0,2,2,7,4,11,13,5,18,0.000333,0.020757,3,186.809307,10.378295,62.269769,27.651484,3,0
0,0,4,4,12,12,24,49,23,72,0.000333,0.110039,6,1980.7038,110.0391,330.1173,86.0391,10,0
0,0,28,28,19,37,56,153,80,233,0.000333,0.451038,18,24356.04654,1353.113697,1353.113697,273.460397,10,0
0,0,5,5,12,12,24,58,26,84,0.000333,0.128379,12,4621.642201,256.7579,385.13685,86.0391,11,0
0,0,35,35,24,41,65,214,114,328,0.000333,0.658446,24,47408.07942,2633.78219,1975.336643,329.698732,10,0
0,0,5,5,13,101,114,424,267,691,0.000333,1.573842,12,56658.324,3147.684667,4721.527,720.585076,7,0
0,0,2,2,9,10,19,26,14,40,0.000333,0.056639,4,679.668402,37.759356,169.917101,61.748606,1,0
0,0,3,3,9,9,18,63,34,97,0.000333,0.134828,12,4853.792702,269.65515,404.482725,57.05865,1,0
0,0,2,2,9,10,19,26,14,40,0.000333,0.056639,4,679.668402,37.759356,169.917101,61.748606,1,0
0,0,2,2,9,10,19,26,14,40,0.000333,0.056639,4,679.668402,37.759356,169.917101,61.748606,1,0
0,0,2,2,9,10,19,26,14,40,0.000333,0.056639,4,679.668402,37.759356,169.917101,61.748606,1,0
0,0,2,2,9,10,19,26,14,40,0.000333,0.056639,4,679.668402,37.759356,169.917101,61.748606,1,0
0,0,2,2,9,10,19,26,14,40,0.000333,0.056639,4,679.668402,37.759356,169.917101,61.748606,1,0
0,0,2,2,9,10,19,26,14,40,0.000333,0.056639,4,679.668402,37.759356,169.917101,61.748606,1,0
0,0,2,2,9,10,19,26,14,40,0.000333,0.056639,4,679.668402,37.759356,169.917101,61.748606,1,0
0,0,2,2,9,10,19,26,14,40,0.000333,0.056639,4,679.668402,37.759356,169.917101,61.748606,1,0
0,0,2,2,9,10,19,26,14,40,0.000333,0.056639,4,679.668402,37.759356,169.917101,61.748606,1,0
0,0,3,3,11,12,23,35,18,53,0.000333,0.079916,5,1198.743918,66.596884,239.748784,81.073298,2,0
0,0,2,2,9,10,19,26,14,40,0.000333,0.056639,4,679.668402,37.759356,169.917101,61.748606,1,0
0,0,2,2,9,10,19,26,14,40,0.000333,0.056639,4,679.668402,37.759356,169.917101,61.748606,1,0
0,0,2,2,9,10,19,26,14,40,0.000333,0.056639,4,679.668402,37.759356,169.917101,61.748606,1,0
0,0,2,2,9,10,19,26,14,40,0.000333,0.056639,4,679.668402,37.759356,169.917101,61.748606,1,0
0,0,4,4,10,13,23,67,37,104,0.000333,0.156817,10,4704.504434,261.361357,470.450443,81.324997,1,0
0,0,2,2,9,10,19,26,14,40,0.000333,0.056639,4,679.668402,37.759356,169.917101,61.748606,2,0
0,0,10,10,9,14,23,123,66,189,0.000333,0.284984,16,13679.25136,759.958409,854.95321,81.832294,1,0
0,0,2,2,9,10,19,26,14,40,0.000333,0.056639,4,679.668402,37.759356,169.917101,61.748606,1,0
0,0,2,2,9,10,19,26,14,40,0.000333,0.056639,4,679.668402,37.759356,169.917101,61.748606,1,0
0,0,2,2,9,10,19,26,14,40,0.000333,0.056639,4,679.668402,37.759356,169.917101,61.748606,2,0
0,0,2,2,9,10,19,26,14,40,0.000333,0.056639,4,679.668402,37.759356,169.917101,61.748606,1,0
0,0,17,17,16,23,39,110,55,165,0.000333,0.290697,16,13953.46186,775.192325,872.091366,168.041925,7,0
0,0,5,5,9,9,18,21,13,34,0.000333,0.047259,4,567.1098,31.5061,141.77745,57.05865,2,0
0,0,6,6,15,11,26,56,26,82,0.000333,0.128479,14,5396.104796,299.7836,385.436057,96.657107,4,0
0,0,2,2,7,4,11,13,5,18,0.000333,0.020757,3,186.809307,10.378295,62.269769,27.651484,3,0
0,0,17,17,16,23,39,110,55,165,0.000333,0.290697,16,13953.46186,775.192325,872.091366,168.041925,7,0
0,0,2,2,7,4,11,13,5,18,0.000333,0.020757,3,186.809307,10.378295,62.269769,27.651484,3,0
0,0,18,18,16,31,47,105,57,162,0.000333,0.299948,8,7198.747152,399.930397,899.843394,217.580086,7,0
0,0,6,6,12,10,22,27,15,42,0.000333,0.062432,6,1123.776768,62.432043,187.296128,76.238831,2,0
0,0,17,17,16,23,39,110,55,165,0.000333,0.290697,16,13953.46186,775.192325,872.091366,168.041925,7,0
0,0,4,4,10,9,19,24,15,39,0.000333,0.055223,5,828.345865,46.019215,165.669173,61.748606,1,0
0,0,3,3,11,11,22,26,15,41,0.000333,0.060946,5,914.183482,50.787971,182.836696,76.107496,3,0
0,0,10,10,15,22,37,70,39,109,0.000333,0.189277,7,3974.812918,220.82294,567.830417,156.710855,6,0
0,0,5,5,11,13,24,36,21,57,0.000333,0.087114,5,1306.714313,72.59524,261.342863,86.159464,4,0
0,0,2,2,7,4,11,13,5,18,0.000333,0.020757,3,186.809307,10.378295,62.269769,27.651484,3,0
0,0,22,22,17,35,52,129,69,198,0.000333,0.376229,8,9029.496514,501.638695,1128.687064,249.011774,9,0
0,0,2,2,7,4,11,13,5,18,0.000333,0.020757,3,186.809307,10.378295,62.269769,27.651484,3,0
0,0,5,5,14,9,23,39,20,59,0.000333,0.088963,14,3736.462176,207.581232,266.890155,81.832294,4,0
0,0,10,10,14,13,27,39,25,64,0.000333,0.101438,7,2130.189601,118.343867,304.3128,101.408685,3,0
0,0,3,3,11,11,22,26,15,41,0.000333,0.060946,5,914.183482,50.787971,182.836696,76.107496,3,0
0,0,10,10,15,22,37,70,39,109,0.000333,0.189277,7,3974.812918,220.82294,567.830417,156.710855,6,0
0,0,3,3,11,11,22,26,15,41,0.000333,0.060946,5,914.183482,50.787971,182.836696,76.107496,3,0
0,0,10,10,15,22,37,70,39,109,0.000333,0.189277,7,3974.812918,220.82294,567.830417,156.710855,6,0
0,0,2,2,7,4,11,13,5,18,0.000333,0.020757,3,186.809307,10.378295,62.269769,27.651484,3,0
0,0,8,8,14,16,30,53,31,84,0.000333,0.137393,7,2885.25167,160.291759,412.17881,117.302969,3,0
0,0,2,2,7,4,11,13,5,18,0.000333,0.020757,3,186.809307,10.378295,62.269769,27.651484,3,0
0,0,5,5,11,13,24,36,21,57,0.000333,0.087114,5,1306.714313,72.59524,261.342863,86.159464,3,0
0,0,2,2,7,4,11,13,5,18,0.000333,0.020757,3,186.809307,10.378295,62.269769,27.651484,3,0
0,0,17,17,16,23,39,110,55,165,0.000333,0.290697,16,13953.46186,775.192325,872.091366,168.041925,7,0
0,0,2,2,5,6,11,9,7,16,0.000333,0.01845,2,110.701812,6.150101,55.350906,27.119415,1,0
0,0,6,6,14,10,24,29,17,46,0.000333,0.070303,7,1476.357925,82.019885,210.908275,86.52225,3,0
0,0,5,5,11,13,24,36,21,57,0.000333,0.087114,5,1306.714313,72.59524,261.342863,86.159464,3,0
0,0,29,29,20,41,61,157,84,241,0.000333,0.476436,20,28586.15397,1588.119665,1429.307698,306.098194,10,0
0,0,2,2,7,4,11,13,5,18,0.000333,0.020757,3,186.809307,10.378295,62.269769,27.651484,3,0
0,0,18,18,16,31,47,99,63,162,0.000333,0.299948,16,14397.4943,799.860795,899.843394,217.580086,5,0
0,0,5,5,11,13,24,36,21,57,0.000333,0.087114,5,1306.714313,72.59524,261.342863,86.159464,3,0
0,0,2,2,7,4,11,13,5,18,0.000333,0.020757,3,186.809307,10.378295,62.269769,27.651484,3,0
0,0,27,27,17,39,56,142,82,224,0.000333,0.433616,16,20813.56004,1156.308891,1300.847503,275.617555,10,0
0,0,3,3,11,11,22,26,15,41,0.000333,0.060946,5,914.183482,50.787971,182.836696,76.107496,3,0
0,0,10,10,15,22,37,70,39,109,0.000333,0.189277,7,3974.812918,220.82294,567.830417,156.710855,6,0
0,0,15,15,11,18,29,75,43,118,0.000333,0.191081,10,5732.417574,318.467643,573.241757,113.112398,3,0
0,0,26,26,17,36,53,139,74,213,0.000333,0.406682,16,19520.75291,1084.486273,1220.047057,255.604168,10,0
0,0,30,30,27,50,77,471,324,795,0.000333,1.660698,78,388603.4334,21589.07963,4982.0953,410.574772,10,0
0,0,33,33,27,62,89,481,326,807,0.000333,1.741972,65,339684.5971,18871.36651,5225.916879,497.542134,10,0
0,0,37,37,27,63,90,526,358,884,0.000333,1.912933,65,373021.8789,20723.43772,5738.798137,504.950598,10,0
0,0,19,19,27,35,62,247,160,407,0.000333,0.807786,52,126014.6107,7000.811706,2423.357898,307.906868,10,0
0,0,3,3,10,17,27,36,24,60,0.000333,0.095098,5,1426.466251,79.248125,285.29325,102.706149,4,0
0,0,2,2,5,6,11,9,7,16,0.000333,0.01845,2,110.701812,6.150101,55.350906,27.119415,1,0
0,0,79,79,28,80,108,805,551,1356,0.000333,3.053209,84,769408.706,42744.92811,9159.627453,640.360185,10,0
0,0,20,20,26,34,60,342,224,566,0.000333,1.114433,78,260777.406,14487.63367,3343.300077,295.185169,19,0
0,0,26,26,27,38,65,355,228,583,0.000333,1.170347,78,273861.1539,15214.50855,3511.040435,327.803208,10,0
0,0,9,9,22,17,39,295,185,480,0.000333,0.845664,110,279069.2372,15503.84651,2536.993065,167.594364,37,0
0,0,4,4,15,18,33,51,32,83,0.000333,0.139562,7,2930.792983,162.821832,418.684712,133.662009,1,0
0,0,39,39,16,34,50,282,159,441,0.000333,0.829647,32,79646.09855,4424.783253,2488.94058,236.973737,9,0
0,0,30,30,27,41,68,379,241,620,0.000333,1.258076,65,245324.7525,13629.15292,3774.226962,348.041595,10,0
0,0,26,26,27,53,80,397,266,663,0.000333,1.397146,65,272443.4912,15135.74951,4191.438327,431.961747,10,0
0,0,15,15,17,37,54,135,91,226,0.000333,0.433535,16,20809.67321,1156.092956,1300.604575,262.236643,9,0
0,0,19,19,27,38,65,275,184,459,0.000333,0.921422,52,143741.875,7985.65972,2764.266826,327.803208,10,0
0,0,26,26,27,49,76,408,274,682,0.000333,1.420362,65,276970.6267,15387.25704,4261.086564,403.502745,10,0
0,0,2,2,7,4,11,13,5,18,0.000333,0.020757,3,186.809307,10.378295,62.269769,27.651484,3,0
0,0,6,6,15,11,26,56,26,82,0.000333,0.128479,14,5396.104796,299.7836,385.436057,96.657107,4,0
0,0,3,3,11,11,22,26,15,41,0.000333,0.060946,5,914.183482,50.787971,182.836696,76.107496,3,0
0,0,10,10,15,22,37,70,39,109,0.000333,0.189277,7,3974.812918,220.82294,567.830417,156.710855,6,0
0,0,7,7,9,14,23,41,25,66,0.000333,0.099518,4,1194.220356,66.345575,298.555089,81.832294,4,0
0,0,17,17,16,23,39,110,55,165,0.000333,0.290697,16,13953.46186,775.192325,872.091366,168.041925,7,0
0,0,2,2,7,4,11,13,5,18,0.000333,0.020757,3,186.809307,10.378295,62.269769,27.651484,3,0
0,0,16,16,13,25,38,92,48,140,0.000333,0.244903,6,4408.259111,244.903284,734.709852,164.202121,6,0
0,0,30,30,9,32,41,98,61,159,0.000333,0.28395,4,3407.403075,189.300171,851.850769,188.529325,2,0
0,0,17,17,16,23,39,110,55,165,0.000333,0.290697,16,13953.46186,775.192325,872.091366,168.041925,7,0
0,0,7,7,10,12,22,237,25,262,0.000333,0.389457,10,11683.71084,649.095047,1168.371084,76.238831,1,0
0,0,2,2,8,3,11,9,5,14,0.000333,0.016144,4,193.728171,10.762676,48.432043,28.754888,3,0
0,0,2,2,7,4,11,13,5,18,0.000333,0.020757,3,186.809307,10.378295,62.269769,27.651484,3,0
0,0,4,4,9,6,15,15,11,26,0.000333,0.03386,4,406.316622,22.573146,101.579155,44.0391,3,0
0,0,3,3,10,6,16,21,9,30,0.000333,0.04,5,600,33.333333,120,48.729056,3,0
0,0,4,4,14,11,25,57,30,87,0.000333,0.134672,14,5656.216839,314.234269,404.015489,91.356717,1,0
0,0,8,8,16,17,33,121,69,190,0.000333,0.319478,32,30669.91625,1703.884236,958.434883,133.486868,1,0
0,0,40,40,23,42,65,303,167,470,0.000333,0.943504,33,93406.92478,5189.273599,2830.512872,330.519257,16,0
0,0,3,3,11,11,22,26,15,41,0.000333,0.060946,5,914.183482,50.787971,182.836696,76.107496,3,0
0,0,10,10,15,22,37,70,39,109,0.000333,0.189277,7,3974.812918,220.82294,567.830417,156.710855,6,0
0,0,3,3,11,11,22,26,15,41,0.000333,0.060946,5,914.183482,50.787971,182.836696,76.107496,3,0
0,0,10,10,15,22,37,70,39,109,0.000333,0.189277,7,3974.812918,220.82294,567.830417,156.710855,6,0
0,0,16,16,19,20,39,88,52,140,0.000333,0.246652,18,13319.21359,739.956311,739.956311,167.149185,6,0
0,0,25,25,18,35,53,134,73,207,0.000333,0.395227,18,21342.23161,1185.679534,1185.679534,254.583556,10,0
0,0,5,5,12,12,24,58,26,84,0.000333,0.128379,12,4621.642201,256.7579,385.13685,86.0391,11,0
0,0,4,4,12,12,24,49,23,72,0.000333,0.110039,6,1980.7038,110.0391,330.1173,86.0391,10,0
0,0,2,2,9,10,19,26,14,40,0.000333,0.056639,4,679.668402,37.759356,169.917101,61.748606,1,0
0,0,4,4,10,13,23,67,37,104,0.000333,0.156817,10,4704.504434,261.361357,470.450443,81.324997,1,0
0,0,2,2,9,10,19,26,14,40,0.000333,0.056639,4,679.668402,37.759356,169.917101,61.748606,2,0
0,0,10,10,9,14,23,123,66,189,0.000333,0.284984,16,13679.25136,759.958409,854.95321,81.832294,1,0
0,0,4,4,8,9,17,28,14,42,0.000333,0.057224,4,686.693757,38.149653,171.673439,52.529325,1,0
0,0,2,2,9,10,19,26,14,40,0.000333,0.056639,4,679.668402,37.759356,169.917101,61.748606,1,0
0,0,2,2,9,10,19,26,14,40,0.000333,0.056639,4,679.668402,37.759356,169.917101,61.748606,1,0
0,0,2,2,9,10,19,26,14,40,0.000333,0.056639,4,679.668402,37.759356,169.917101,61.748606,1,0
0,0,2,2,9,10,19,26,14,40,0.000333,0.056639,4,679.668402,37.759356,169.917101,61.748606,1,0
0,0,2,2,9,10,19,26,14,40,0.000333,0.056639,4,679.668402,37.759356,169.917101,61.748606,1,0
0,0,2,2,9,10,19,26,14,40,0.000333,0.056639,4,679.668402,37.759356,169.917101,61.748606,2,0
0,0,3,3,11,12,23,35,18,53,0.000333,0.079916,5,1198.743918,66.596884,239.748784,81.073298,2,0
0,0,2,2,9,10,19,26,14,40,0.000333,0.056639,4,679.668402,37.759356,169.917101,61.748606,1,0
0,0,2,2,9,10,19,26,14,40,0.000333,0.056639,4,679.668402,37.759356,169.917101,61.748606,1,0
0,0,2,2,9,10,19,26,14,40,0.000333,0.056639,4,679.668402,37.759356,169.917101,61.748606,1,0
0,0,2,2,9,10,19,26,14,40,0.000333,0.056639,4,679.668402,37.759356,169.917101,61.748606,1,0
0,0,5,5,13,101,114,424,267,691,0.000333,1.573842,12,56658.324,3147.684667,4721.527,720.585076,7,0
0,0,2,2,9,10,19,26,14,40,0.000333,0.056639,4,679.668402,37.759356,169.917101,61.748606,1,0
0,0,2,2,9,10,19,26,14,40,0.000333,0.056639,4,679.668402,37.759356,169.917101,61.748606,1,0
0,0,2,2,9,10,19,26,14,40,0.000333,0.056639,4,679.668402,37.759356,169.917101,61.748606,1,0
0,0,2,2,9,10,19,26,14,40,0.000333,0.056639,4,679.668402,37.759356,169.917101,61.748606,1,0
0,0,2,2,9,10,19,26,14,40,0.000333,0.056639,4,679.668402,37.759356,169.917101,61.748606,1,0
0,0,2,2,9,10,19,26,14,40,0.000333,0.056639,4,679.668402,37.759356,169.917101,61.748606,1,0
0,0,3,3,9,9,18,63,34,97,0.000333,0.134828,12,4853.792702,269.65515,404.482725,57.05865,1,0
0,0,2,2,9,10,19,26,14,40,0.000333,0.056639,4,679.668402,37.759356,169.917101,61.748606,1,0
0,0,33,33,25,47,72,211,120,331,0.000333,0.680748,24,49013.88421,2722.993567,2042.245175,377.162081,10,0
0,0,32,32,19,39,58,181,98,279,0.000333,0.544792,18,29418.78056,1634.376698,1634.376698,286.841309,11,0
0,0,2,2,7,4,11,13,5,18,0.000333,0.020757,3,186.809307,10.378295,62.269769,27.651484,3,0
0,0,2,2,7,4,11,13,5,18,0.000333,0.020757,3,186.809307,10.378295,62.269769,27.651484,3,0
0,0,4,4,12,12,24,49,23,72,0.000333,0.110039,6,1980.7038,110.0391,330.1173,86.0391,10,0
0,0,5,5,12,12,24,58,26,84,0.000333,0.128379,12,4621.642201,256.7579,385.13685,86.0391,11,0
0,0,32,32,19,39,58,181,98,279,0.000333,0.544792,18,29418.78056,1634.376698,1634.376698,286.841309,11,0
0,0,30,30,25,42,67,198,112,310,0.000333,0.626829,24,45131.70358,2507.316865,1880.487649,342.573737,10,0
0,0,2,2,9,10,19,26,14,40,0.000333,0.056639,4,679.668402,37.759356,169.917101,61.748606,1,0
0,0,10,10,9,14,23,123,66,189,0.000333,0.284984,16,13679.25136,759.958409,854.95321,81.832294,1,0
0,0,2,2,9,10,19,26,14,40,0.000333,0.056639,4,679.668402,37.759356,169.917101,61.748606,1,0
0,0,4,4,10,13,23,67,37,104,0.000333,0.156817,10,4704.504434,261.361357,470.450443,81.324997,1,0
0,0,2,2,9,10,19,26,14,40,0.000333,0.056639,4,679.668402,37.759356,169.917101,61.748606,1,0
0,0,2,2,9,10,19,26,14,40,0.000333,0.056639,4,679.668402,37.759356,169.917101,61.748606,1,0
0,0,2,2,9,10,19,26,14,40,0.000333,0.056639,4,679.668402,37.759356,169.917101,61.748606,1,0
0,0,2,2,9,10,19,26,14,40,0.000333,0.056639,4,679.668402,37.759356,169.917101,61.748606,1,0
0,0,3,3,11,12,23,35,18,53,0.000333,0.079916,5,1198.743918,66.596884,239.748784,81.073298,2,0
0,0,2,2,9,10,19,26,14,40,0.000333,0.056639,4,679.668402,37.759356,169.917101,61.748606,1,0
0,0,2,2,9,10,19,26,14,40,0.000333,0.056639,4,679.668402,37.759356,169.917101,61.748606,1,0
0,0,3,3,9,9,18,63,34,97,0.000333,0.134828,12,4853.792702,269.65515,404.482725,57.05865,1,0
0,0,2,2,9,10,19,26,14,40,0.000333,0.056639,4,679.668402,37.759356,169.917101,61.748606,1,0
0,0,2,2,9,10,19,26,14,40,0.000333,0.056639,4,679.668402,37.759356,169.917101,61.748606,1,0
0,0,2,2,9,10,19,26,14,40,0.000333,0.056639,4,679.668402,37.759356,169.917101,61.748606,1,0
0,0,2,2,9,10,19,26,14,40,0.000333,0.056639,4,679.668402,37.759356,169.917101,61.748606,1,0
0,0,2,2,9,10,19,26,14,40,0.000333,0.056639,4,679.668402,37.759356,169.917101,61.748606,2,0
0,0,2,2,9,10,19,26,14,40,0.000333,0.056639,4,679.668402,37.759356,169.917101,61.748606,1,0
0,0,2,2,9,10,19,26,14,40,0.000333,0.056639,4,679.668402,37.759356,169.917101,61.748606,2,0
0,0,5,5,13,101,114,424,267,691,0.000333,1.573842,12,56658.324,3147.684667,4721.527,720.585076,7,0
0,0,2,2,9,10,19,26,14,40,0.000333,0.056639,4,679.668402,37.759356,169.917101,61.748606,1,0
0,0,2,2,9,10,19,26,14,40,0.000333,0.056639,4,679.668402,37.759356,169.917101,61.748606,1,0
0,0,2,2,9,10,19,26,14,40,0.000333,0.056639,4,679.668402,37.759356,169.917101,61.748606,1,0
0,0,2,2,9,10,19,26,14,40,0.000333,0.056639,4,679.668402,37.759356,169.917101,61.748606,1,0
0,0,3,3,11,11,22,26,15,41,0.000333,0.060946,5,914.183482,50.787971,182.836696,76.107496,3,0
0,0,10,10,15,22,37,70,39,109,0.000333,0.189277,7,3974.812918,220.82294,567.830417,156.710855,6,0
0,0,3,3,11,11,22,26,15,41,0.000333,0.060946,5,914.183482,50.787971,182.836696,76.107496,3,0
0,0,10,10,15,22,37,70,39,109,0.000333,0.189277,7,3974.812918,220.82294,567.830417,156.710855,6,0
0,0,5,5,11,13,24,36,21,57,0.000333,0.087114,5,1306.714313,72.59524,261.342863,86.159464,3,0
0,0,32,32,19,40,59,169,90,259,0.000333,0.507868,18,27424.8819,1523.60455,1523.60455,293.587747,11,0
0,0,2,2,7,4,11,13,5,18,0.000333,0.020757,3,186.809307,10.378295,62.269769,27.651484,3,0
0,0,2,2,7,4,11,13,5,18,0.000333,0.020757,3,186.809307,10.378295,62.269769,27.651484,3,0
0,0,5,5,11,13,24,26,20,46,0.000333,0.070303,5,1054.541375,58.585632,210.908275,86.159464,1,0
0,0,7,7,8,15,23,38,26,64,0.000333,0.096503,4,1158.031861,64.335103,289.507965,82.603359,8,0
0,0,17,17,16,23,39,110,55,165,0.000333,0.290697,16,13953.46186,775.192325,872.091366,168.041925,7,0
0,0,17,17,14,27,41,98,51,149,0.000333,0.266092,7,5587.926741,310.440374,798.275249,181.684931,7,0
0,0,2,2,7,4,11,13,5,18,0.000333,0.020757,3,186.809307,10.378295,62.269769,27.651484,3,0
0,0,22,22,22,31,53,165,87,252,0.000333,0.481145,22,31755.591,1764.1995,1443.435955,251.687581,15,0
0,0,31,31,20,37,57,176,96,272,0.000333,0.528849,20,31730.92168,1762.828982,1586.546084,279.188336,13,0
0,0,3,3,13,10,23,23,15,38,0.000333,0.057298,6,1031.372126,57.298451,171.895354,81.324997,2,0
0,0,3,3,13,11,24,28,16,44,0.000333,0.067246,6,1210.4301,67.246117,201.73835,86.159464,2,0
0,0,2,2,7,4,11,13,5,18,0.000333,0.020757,3,186.809307,10.378295,62.269769,27.651484,3,0
0,0,4,4,12,12,24,49,23,72,0.000333,0.110039,6,1980.7038,110.0391,330.1173,86.0391,10,0
0,0,36,36,19,41,60,205,110,315,0.000333,0.620224,18,33492.06968,1860.670538,1860.670538,300.370255,12,0
0,0,5,5,12,12,24,58,26,84,0.000333,0.128379,12,4621.642201,256.7579,385.13685,86.0391,11,0
0,0,34,34,23,43,66,222,116,338,0.000333,0.681002,22,44946.11467,2497.006371,2043.005212,337.371309,10,0
0,0,5,5,13,101,114,424,267,691,0.000333,1.573842,12,56658.324,3147.684667,4721.527,720.585076,7,0
0,0,2,2,9,10,19,26,14,40,0.000333,0.056639,4,679.668402,37.759356,169.917101,61.748606,1,0
0,0,3,3,9,9,18,63,34,97,0.000333,0.134828,12,4853.792702,269.65515,404.482725,57.05865,1,0
0,0,2,2,9,10,19,26,14,40,0.000333,0.056639,4,679.668402,37.759356,169.917101,61.748606,1,0
0,0,2,2,9,10,19,26,14,40,0.000333,0.056639,4,679.668402,37.759356,169.917101,61.748606,1,0
0,0,2,2,9,10,19,26,14,40,0.000333,0.056639,4,679.668402,37.759356,169.917101,61.748606,1,0
0,0,2,2,9,10,19,26,14,40,0.000333,0.056639,4,679.668402,37.759356,169.917101,61.748606,1,0
0,0,2,2,9,10,19,26,14,40,0.000333,0.056639,4,679.668402,37.759356,169.917101,61.748606,1,0
0,0,2,2,9,10,19,26,14,40,0.000333,0.056639,4,679.668402,37.759356,169.917101,61.748606,1,0
0,0,2,2,9,10,19,26,14,40,0.000333,0.056639,4,679.668402,37.759356,169.917101,61.748606,1,0
0,0,2,2,9,10,19,26,14,40,0.000333,0.056639,4,679.668402,37.759356,169.917101,61.748606,1,0
0,0,2,2,9,10,19,26,14,40,0.000333,0.056639,4,679.668402,37.759356,169.917101,61.748606,1,0
0,0,2,2,9,10,19,26,14,40,0.000333,0.056639,4,679.668402,37.759356,169.917101,61.748606,1,0
0,0,2,2,9,10,19,26,14,40,0.000333,0.056639,4,679.668402,37.759356,169.917101,61.748606,1,0
0,0,2,2,9,10,19,26,14,40,0.000333,0.056639,4,679.668402,37.759356,169.917101,61.748606,1,0
0,0,2,2,9,10,19,26,14,40,0.000333,0.056639,4,679.668402,37.759356,169.917101,61.748606,1,0
0,0,4,4,10,13,23,67,37,104,0.000333,0.156817,10,4704.504434,261.361357,470.450443,81.324997,1,0
0,0,2,2,9,10,19,26,14,40,0.000333,0.056639,4,679.668402,37.759356,169.917101,61.748606,2,0
0,0,10,10,9,14,23,123,66,189,0.000333,0.284984,16,13679.25136,759.958409,854.95321,81.832294,1,0
0,0,2,2,9,10,19,26,14,40,0.000333,0.056639,4,679.668402,37.759356,169.917101,61.748606,1,0
0,0,2,2,9,10,19,26,14,40,0.000333,0.056639,4,679.668402,37.759356,169.917101,61.748606,1,0
0,0,2,2,9,10,19,26,14,40,0.000333,0.056639,4,679.668402,37.759356,169.917101,61.748606,2,0
0,0,3,3,11,12,23,35,18,53,0.000333,0.079916,5,1198.743918,66.596884,239.748784,81.073298,2,0
0,0,2,2,9,10,19,26,14,40,0.000333,0.056639,4,679.668402,37.759356,169.917101,61.748606,1,0
0,0,5,5,11,13,24,36,21,57,0.000333,0.087114,5,1306.714313,72.59524,261.342863,86.159464,3,0
0,0,5,5,12,12,24,58,26,84,0.000333,0.128379,12,4621.642201,256.7579,385.13685,86.0391,11,0
0,0,28,28,19,38,57,154,81,235,0.000333,0.45691,18,24673.12476,1370.729153,1370.729153,280.131868,10,0
0,0,4,4,12,12,24,49,23,72,0.000333,0.110039,6,1980.7038,110.0391,330.1173,86.0391,10,0
0,0,2,2,7,4,11,13,5,18,0.000333,0.020757,3,186.809307,10.378295,62.269769,27.651484,3,0
0,0,5,5,13,101,114,424,267,691,0.000333,1.573842,12,56658.324,3147.684667,4721.527,720.585076,7,0
0,0,2,2,9,10,19,26,14,40,0.000333,0.056639,4,679.668402,37.759356,169.917101,61.748606,1,0
0,0,3,3,9,9,18,63,34,97,0.000333,0.134828,12,4853.792702,269.65515,404.482725,57.05865,1,0
0,0,2,2,9,10,19,26,14,40,0.000333,0.056639,4,679.668402,37.759356,169.917101,61.748606,1,0
0,0,2,2,9,10,19,26,14,40,0.000333,0.056639,4,679.668402,37.759356,169.917101,61.748606,1,0
0,0,2,2,9,10,19,26,14,40,0.000333,0.056639,4,679.668402,37.759356,169.917101,61.748606,1,0
0,0,2,2,9,10,19,26,14,40,0.000333,0.056639,4,679.668402,37.759356,169.917101,61.748606,1,0
0,0,2,2,9,10,19,26,14,40,0.000333,0.056639,4,679.668402,37.759356,169.917101,61.748606,1,0
0,0,2,2,9,10,19,26,14,40,0.000333,0.056639,4,679.668402,37.759356,169.917101,61.748606,1,0
0,0,2,2,9,10,19,26,14,40,0.000333,0.056639,4,679.668402,37.759356,169.917101,61.748606,1,0
0,0,2,2,9,10,19,26,14,40,0.000333,0.056639,4,679.668402,37.759356,169.917101,61.748606,1,0
0,0,2,2,9,10,19,26,14,40,0.000333,0.056639,4,679.668402,37.759356,169.917101,61.748606,1,0
0,0,2,2,9,10,19,26,14,40,0.000333,0.056639,4,679.668402,37.759356,169.917101,61.748606,1,0
0,0,2,2,9,10,19,26,14,40,0.000333,0.056639,4,679.668402,37.759356,169.917101,61.748606,1,0
0,0,2,2,9,10,19,26,14,40,0.000333,0.056639,4,679.668402,37.759356,169.917101,61.748606,1,0
0,0,2,2,9,10,19,26,14,40,0.000333,0.056639,4,679.668402,37.759356,169.917101,61.748606,1,0
0,0,4,4,10,13,23,67,37,104,0.000333,0.156817,10,4704.504434,261.361357,470.450443,81.324997,1,0
0,0,2,2,9,10,19,26,14,40,0.000333,0.056639,4,679.668402,37.759356,169.917101,61.748606,2,0
0,0,10,10,9,14,23,123,66,189,0.000333,0.284984,16,13679.25136,759.958409,854.95321,81.832294,1,0
0,0,2,2,9,10,19,26,14,40,0.000333,0.056639,4,679.668402,37.759356,169.917101,61.748606,1,0
0,0,2,2,9,10,19,26,14,40,0.000333,0.056639,4,679.668402,37.759356,169.917101,61.748606,1,0
0,0,2,2,9,10,19,26,14,40,0.000333,0.056639,4,679.668402,37.759356,169.917101,61.748606,2,0
0,0,3,3,11,12,23,35,18,53,0.000333,0.079916,5,1198.743918,66.596884,239.748784,81.073298,2,0
0,0,2,2,9,10,19,26,14,40,0.000333,0.056639,4,679.668402,37.759356,169.917101,61.748606,1,0
0,0,14,14,12,18,30,93,42,135,0.000333,0.22081,12,7949.162765,441.620154,662.43023,118.0782,19,0
0,0,30,30,20,38,58,160,88,248,0.000333,0.48426,20,29055.58574,1614.199208,1452.779287,285.859807,11,0
0,0,3,3,11,11,22,26,15,41,0.000333,0.060946,5,914.183482,50.787971,182.836696,76.107496,3,0
0,0,10,10,15,22,37,70,39,109,0.000333,0.189277,7,3974.812918,220.82294,567.830417,156.710855,6,0
0,0,17,17,16,23,39,110,55,165,0.000333,0.290697,16,13953.46186,775.192325,872.091366,168.041925,7,0
0,0,18,18,15,30,45,100,55,155,0.000333,0.283746,7,5958.66061,331.036701,851.23723,205.810077,7,0
0,0,2,2,7,4,11,13,5,18,0.000333,0.020757,3,186.809307,10.378295,62.269769,27.651484,3,0
0,0,2,2,7,4,11,13,5,18,0.000333,0.020757,3,186.809307,10.378295,62.269769,27.651484,3,0
0,0,9,9,8,19,27,43,30,73,0.000333,0.115702,4,1388.427151,77.134842,347.106788,104.710623,1,0
0,0,3,3,11,11,22,26,15,41,0.000333,0.060946,5,914.183482,50.787971,182.836696,76.107496,3,0
0,0,10,10,15,22,37,70,39,109,0.000333,0.189277,7,3974.812918,220.82294,567.830417,156.710855,6,0
0,0,3,3,11,11,22,26,15,41,0.000333,0.060946,5,914.183482,50.787971,182.836696,76.107496,3,0
0,0,10,10,15,22,37,70,39,109,0.000333,0.189277,7,3974.812918,220.82294,567.830417,156.710855,6,0
0,0,3,3,11,11,22,26,15,41,0.000333,0.060946,5,914.183482,50.787971,182.836696,76.107496,3,0
0,0,10,10,15,22,37,70,39,109,0.000333,0.189277,7,3974.812918,220.82294,567.830417,156.710855,6,0
0,0,3,3,11,11,22,26,15,41,0.000333,0.060946,5,914.183482,50.787971,182.836696,76.107496,3,0
0,0,10,10,15,22,37,70,39,109,0.000333,0.189277,7,3974.812918,220.82294,567.830417,156.710855,6,0
0,0,3,3,11,11,22,26,15,41,0.000333,0.060946,5,914.183482,50.787971,182.836696,76.107496,3,0
0,0,10,10,15,22,37,70,39,109,0.000333,0.189277,7,3974.812918,220.82294,567.830417,156.710855,6,0
0,0,5,5,11,13,24,36,21,57,0.000333,0.087114,5,1306.714313,72.59524,261.342863,86.159464,3,0
0,0,2,2,7,4,11,13,5,18,0.000333,0.020757,3,186.809307,10.378295,62.269769,27.651484,3,0
0,0,30,30,19,43,62,162,87,249,0.000333,0.494198,18,26686.70786,1482.594881,1482.594881,314.040007,10,0
0,0,6,6,13,31,44,240,168,408,0.000333,0.742483,30,66823.44301,3712.413501,2227.4481,201.685802,1,0
0,0,3,3,11,11,22,26,15,41,0.000333,0.060946,5,914.183482,50.787971,182.836696,76.107496,3,0
0,0,10,10,15,22,37,70,39,109,0.000333,0.189277,7,3974.812918,220.82294,567.830417,156.710855,6,0
0,0,17,17,16,23,39,110,55,165,0.000333,0.290697,16,13953.46186,775.192325,872.091366,168.041925,7,0
0,0,5,5,11,10,21,23,14,37,0.000333,0.054172,5,812.578723,45.143262,162.515745,71.273029,2,0
0,0,3,3,11,11,22,26,15,41,0.000333,0.060946,5,914.183482,50.787971,182.836696,76.107496,3,0
0,0,10,10,15,22,37,70,39,109,0.000333,0.189277,7,3974.812918,220.82294,567.830417,156.710855,6,0
0,0,3,3,11,11,22,26,15,41,0.000333,0.060946,5,914.183482,50.787971,182.836696,76.107496,3,0
0,0,10,10,15,22,37,70,39,109,0.000333,0.189277,7,3974.812918,220.82294,567.830417,156.710855,6,0
0,0,5,5,11,13,24,36,21,57,0.000333,0.087114,5,1306.714313,72.59524,261.342863,86.159464,3,0
0,0,28,28,19,38,57,151,79,230,0.000333,0.447188,18,24148.16466,1341.564703,1341.564703,280.131868,10,0
0,0,2,2,7,4,11,13,5,18,0.000333,0.020757,3,186.809307,10.378295,62.269769,27.651484,3,0
0,0,22,22,16,30,46,168,87,255,0.000333,0.469503,16,22536.13278,1252.007377,1408.508299,211.206718,2,0
0,0,5,5,11,13,24,36,21,57,0.000333,0.087114,5,1306.714313,72.59524,261.342863,86.159464,3,0
0,0,2,2,7,4,11,13,5,18,0.000333,0.020757,3,186.809307,10.378295,62.269769,27.651484,3,0
0,0,22,22,17,35,52,129,69,198,0.000333,0.376229,8,9029.496514,501.638695,1128.687064,249.011774,8,0
0,0,3,3,11,11,22,26,15,41,0.000333,0.060946,5,914.183482,50.787971,182.836696,76.107496,3,0
0,0,10,10,15,22,37,70,39,109,0.000333,0.189277,7,3974.812918,220.82294,567.830417,156.710855,6,0
0,0,34,34,20,41,61,174,98,272,0.000333,0.53772,20,32263.21112,1792.400618,1613.160556,306.098194,12,0
0,0,17,17,14,22,36,103,54,157,0.000333,0.270559,14,11363.49515,631.305286,811.678225,151.410465,9,0
0,0,15,15,11,24,35,90,52,142,0.000333,0.242786,10,7283.581884,404.643438,728.358188,148.092848,5,0
0,0,2,2,7,4,11,13,5,18,0.000333,0.020757,3,186.809307,10.378295,62.269769,27.651484,3,0
0,0,4,4,12,12,24,49,23,72,0.000333,0.110039,6,1980.7038,110.0391,330.1173,86.0391,10,0
0,0,28,28,19,37,56,150,78,228,0.000333,0.441359,18,23833.3846,1324.076922,1324.076922,273.460397,10,0
0,0,5,5,12,12,24,58,26,84,0.000333,0.128379,12,4621.642201,256.7579,385.13685,86.0391,11,0
0,0,17,17,12,25,37,105,52,157,0.000333,0.272628,12,9814.610141,545.256119,817.884178,159.115955,6,0
0,0,18,18,13,27,40,107,63,170,0.000333,0.301576,12,10856.73331,603.151851,904.727776,176.487679,1,0
0,0,5,5,13,101,114,424,267,691,0.000333,1.573842,12,56658.324,3147.684667,4721.527,720.585076,7,0
0,0,2,2,9,10,19,26,14,40,0.000333,0.056639,4,679.668402,37.759356,169.917101,61.748606,1,0
0,0,3,3,9,9,18,63,34,97,0.000333,0.134828,12,4853.792702,269.65515,404.482725,57.05865,1,0
0,0,2,2,9,10,19,26,14,40,0.000333,0.056639,4,679.668402,37.759356,169.917101,61.748606,1,0
0,0,2,2,9,10,19,26,14,40,0.000333,0.056639,4,679.668402,37.759356,169.917101,61.748606,1,0
0,0,2,2,9,10,19,26,14,40,0.000333,0.056639,4,679.668402,37.759356,169.917101,61.748606,1,0
0,0,2,2,9,10,19,26,14,40,0.000333,0.056639,4,679.668402,37.759356,169.917101,61.748606,1,0
0,0,2,2,9,10,19,26,14,40,0.000333,0.056639,4,679.668402,37.759356,169.917101,61.748606,1,0
0,0,2,2,9,10,19,26,14,40,0.000333,0.056639,4,679.668402,37.759356,169.917101,61.748606,1,0
0,0,2,2,9,10,19,26,14,40,0.000333,0.056639,4,679.668402,37.759356,169.917101,61.748606,1,0
0,0,2,2,9,10,19,26,14,40,0.000333,0.056639,4,679.668402,37.759356,169.917101,61.748606,1,0
0,0,2,2,9,10,19,26,14,40,0.000333,0.056639,4,679.668402,37.759356,169.917101,61.748606,1,0
0,0,2,2,9,10,19,26,14,40,0.000333,0.056639,4,679.668402,37.759356,169.917101,61.748606,1,0
0,0,2,2,9,10,19,26,14,40,0.000333,0.056639,4,679.668402,37.759356,169.917101,61.748606,1,0
0,0,2,2,9,10,19,26,14,40,0.000333,0.056639,4,679.668402,37.759356,169.917101,61.748606,1,0
0,0,2,2,9,10,19,26,14,40,0.000333,0.056639,4,679.668402,37.759356,169.917101,61.748606,1,0
0,0,4,4,10,13,23,67,37,104,0.000333,0.156817,10,4704.504434,261.361357,470.450443,81.324997,1,0
0,0,2,2,9,10,19,26,14,40,0.000333,0.056639,4,679.668402,37.759356,169.917101,61.748606,2,0
0,0,10,10,9,14,23,123,66,189,0.000333,0.284984,16,13679.25136,759.958409,854.95321,81.832294,1,0
0,0,2,2,9,10,19,26,14,40,0.000333,0.056639,4,679.668402,37.759356,169.917101,61.748606,1,0
0,0,2,2,9,10,19,26,14,40,0.000333,0.056639,4,679.668402,37.759356,169.917101,61.748606,1,0
0,0,2,2,9,10,19,26,14,40,0.000333,0.056639,4,679.668402,37.759356,169.917101,61.748606,2,0
0,0,3,3,11,12,23,35,18,53,0.000333,0.079916,5,1198.743918,66.596884,239.748784,81.073298,2,0
0,0,2,2,9,10,19,26,14,40,0.000333,0.056639,4,679.668402,37.759356,169.917101,61.748606,1,0
0,0,3,3,11,11,22,26,15,41,0.000333,0.060946,5,914.183482,50.787971,182.836696,76.107496,3,0
0,0,10,10,15,22,37,70,39,109,0.000333,0.189277,7,3974.812918,220.82294,567.830417,156.710855,6,0
0,0,21,21,14,32,46,90,64,154,0.000333,0.283543,14,11908.79958,661.599977,850.628541,213.302969,2,0
0,0,34,34,19,45,64,176,94,270,0.000333,0.54,18,29160,1620,1620,327.844012,12,0
0,0,41,41,25,50,75,276,147,423,0.000333,0.878263,24,63234.96735,3513.053741,2634.790306,398.289214,14,0
0,0,2,2,7,4,11,13,5,18,0.000333,0.020757,3,186.809307,10.378295,62.269769,27.651484,3,0
0,0,5,5,10,20,30,58,36,94,0.000333,0.153749,5,2306.23858,128.124366,461.247716,119.657843,1,0
0,0,3,3,11,11,22,26,15,41,0.000333,0.060946,5,914.183482,50.787971,182.836696,76.107496,3,0
0,0,10,10,15,22,37,70,39,109,0.000333,0.189277,7,3974.812918,220.82294,567.830417,156.710855,6,0
0,0,2,2,7,4,11,13,5,18,0.000333,0.020757,3,186.809307,10.378295,62.269769,27.651484,3,0
0,0,6,6,13,31,44,240,168,408,0.000333,0.742483,30,66823.44301,3712.413501,2227.4481,201.685802,1,0
0,0,23,23,12,33,45,121,76,197,0.000333,0.360632,12,12982.74072,721.263373,1081.89506,209.484556,8,0
0,0,28,28,16,38,54,152,82,234,0.000333,0.448881,16,21546.29881,1197.0166,1346.643676,263.421246,16,0
0,0,28,28,17,38,55,145,78,223,0.000333,0.429748,16,20627.89146,1145.99397,1289.243216,268.908114,11,0
0,0,2,2,7,4,11,13,5,18,0.000333,0.020757,3,186.809307,10.378295,62.269769,27.651484,3,0
0,0,3,3,13,11,24,28,16,44,0.000333,0.067246,6,1210.4301,67.246117,201.73835,86.159464,2,0
0,0,3,3,13,10,23,23,15,38,0.000333,0.057298,6,1031.372126,57.298451,171.895354,81.324997,2,0
0,0,5,5,11,13,24,36,21,57,0.000333,0.087114,5,1306.714313,72.59524,261.342863,86.159464,3,0
0,0,2,2,7,4,11,13,5,18,0.000333,0.020757,3,186.809307,10.378295,62.269769,27.651484,3,0
0,0,26,26,18,38,56,140,76,216,0.000333,0.41813,18,22578.99594,1254.388663,1254.388663,274.479896,10,0
0,0,15,15,17,29,46,142,55,197,0.000333,0.362714,8,8705.133643,483.618536,1088.141705,210.368317,4,0
0,0,3,3,11,11,22,26,15,41,0.000333,0.060946,5,914.183482,50.787971,182.836696,76.107496,3,0
0,0,10,10,15,22,37,70,39,109,0.000333,0.189277,7,3974.812918,220.82294,567.830417,156.710855,6,0
0,0,5,5,11,13,24,36,21,57,0.000333,0.087114,5,1306.714313,72.59524,261.342863,86.159464,3,0
0,0,2,2,7,4,11,13,5,18,0.000333,0.020757,3,186.809307,10.378295,62.269769,27.651484,3,0
0,0,28,28,19,38,57,151,79,230,0.000333,0.447188,18,24148.16466,1341.564703,1341.564703,280.131868,10,0
0,0,14,14,16,20,36,94,67,161,0.000333,0.277453,24,19976.59021,1109.810567,832.357925,150.438562,1,0
0,0,33,33,28,54,82,330,193,523,0.000333,1.108333,42,139649.9873,7758.33263,3324.999698,445.369863,20,0
0,0,31,31,20,37,57,168,91,259,0.000333,0.503573,20,30214.37027,1678.576126,1510.718514,279.188336,11,0
0,0,8,8,14,18,32,57,27,84,0.000333,0.14,7,2940,163.333333,420,128.361619,5,0
0,0,15,15,13,21,34,93,48,141,0.000333,0.239111,12,8607.987127,478.221507,717.332261,140.344382,7,0
0,0,26,26,17,35,52,138,73,211,0.000333,0.400931,16,19244.68449,1069.149138,1202.792781,249.011774,10,0
0,0,2,2,5,6,11,9,7,16,0.000333,0.01845,2,110.701812,6.150101,55.350906,27.119415,1,0
0,0,5,5,12,12,24,58,26,84,0.000333,0.128379,12,4621.642201,256.7579,385.13685,86.0391,11,0
0,0,4,4,12,12,24,49,23,72,0.000333,0.110039,6,1980.7038,110.0391,330.1173,86.0391,10,0
0,0,2,2,7,4,11,13,5,18,0.000333,0.020757,3,186.809307,10.378295,62.269769,27.651484,3,0
0,0,2,2,9,10,19,26,14,40,0.000333,0.056639,4,679.668402,37.759356,169.917101,61.748606,1,0
0,0,2,2,9,10,19,26,14,40,0.000333,0.056639,4,679.668402,37.759356,169.917101,61.748606,1,0
0,0,3,3,9,9,18,63,34,97,0.000333,0.134828,12,4853.792702,269.65515,404.482725,57.05865,1,0
0,0,2,2,9,10,19,26,14,40,0.000333,0.056639,4,679.668402,37.759356,169.917101,61.748606,1,0
0,0,2,2,9,10,19,26,14,40,0.000333,0.056639,4,679.668402,37.759356,169.917101,61.748606,1,0
0,0,10,10,9,14,23,123,66,189,0.000333,0.284984,16,13679.25136,759.958409,854.95321,81.832294,1,0
0,0,2,2,9,10,19,26,14,40,0.000333,0.056639,4,679.668402,37.759356,169.917101,61.748606,1,0
0,0,2,2,9,10,19,26,14,40,0.000333,0.056639,4,679.668402,37.759356,169.917101,61.748606,1,0
0,0,2,2,9,10,19,26,14,40,0.000333,0.056639,4,679.668402,37.759356,169.917101,61.748606,1,0
0,0,2,2,9,10,19,26,14,40,0.000333,0.056639,4,679.668402,37.759356,169.917101,61.748606,1,0
0,0,5,5,13,101,114,424,267,691,0.000333,1.573842,12,56658.324,3147.684667,4721.527,720.585076,7,0
0,0,2,2,9,10,19,26,14,40,0.000333,0.056639,4,679.668402,37.759356,169.917101,61.748606,1,0
0,0,2,2,9,10,19,26,14,40,0.000333,0.056639,4,679.668402,37.759356,169.917101,61.748606,2,0
0,0,3,3,11,12,23,35,18,53,0.000333,0.079916,5,1198.743918,66.596884,239.748784,81.073298,2,0
0,0,2,2,9,10,19,26,14,40,0.000333,0.056639,4,679.668402,37.759356,169.917101,61.748606,1,0
0,0,2,2,9,10,19,26,14,40,0.000333,0.056639,4,679.668402,37.759356,169.917101,61.748606,2,0
0,0,2,2,9,10,19,26,14,40,0.000333,0.056639,4,679.668402,37.759356,169.917101,61.748606,1,0
0,0,2,2,9,10,19,26,14,40,0.000333,0.056639,4,679.668402,37.759356,169.917101,61.748606,1,0
0,0,2,2,9,10,19,26,14,40,0.000333,0.056639,4,679.668402,37.759356,169.917101,61.748606,1,0
0,0,2,2,9,10,19,26,14,40,0.000333,0.056639,4,679.668402,37.759356,169.917101,61.748606,1,0
0,0,4,4,10,13,23,67,37,104,0.000333,0.156817,10,4704.504434,261.361357,470.450443,81.324997,1,0
0,0,2,2,9,10,19,26,14,40,0.000333,0.056639,4,679.668402,37.759356,169.917101,61.748606,1,0
0,0,2,2,9,10,19,26,14,40,0.000333,0.056639,4,679.668402,37.759356,169.917101,61.748606,1,0
0,0,2,2,9,10,19,26,14,40,0.000333,0.056639,4,679.668402,37.759356,169.917101,61.748606,1,0
0,0,3,3,11,11,22,26,15,41,0.000333,0.060946,5,914.183482,50.787971,182.836696,76.107496,3,0
0,0,10,10,15,22,37,70,39,109,0.000333,0.189277,7,3974.812918,220.82294,567.830417,156.710855,6,0
0,0,3,3,11,11,22,26,15,41,0.000333,0.060946,5,914.183482,50.787971,182.836696,76.107496,3,0
0,0,10,10,15,22,37,70,39,109,0.000333,0.189277,7,3974.812918,220.82294,567.830417,156.710855,6,0
0,0,5,5,11,13,24,36,21,57,0.000333,0.087114,5,1306.714313,72.59524,261.342863,86.159464,3,0
0,0,5,5,12,12,24,58,26,84,0.000333,0.128379,12,4621.642201,256.7579,385.13685,86.0391,11,0
0,0,26,26,17,36,53,141,74,215,0.000333,0.410501,16,19704.04636,1094.669242,1231.502898,255.604168,10,0
0,0,4,4,12,12,24,49,23,72,0.000333,0.110039,6,1980.7038,110.0391,330.1173,86.0391,10,0
0,0,2,2,7,4,11,13,5,18,0.000333,0.020757,3,186.809307,10.378295,62.269769,27.651484,3,0
0,0,2,2,5,6,11,9,7,16,0.000333,0.01845,2,110.701812,6.150101,55.350906,27.119415,1,0
0,0,2,2,9,10,19,26,14,40,0.000333,0.056639,4,679.668402,37.759356,169.917101,61.748606,1,0
0,0,2,2,9,10,19,26,14,40,0.000333,0.056639,4,679.668402,37.759356,169.917101,61.748606,1,0
0,0,2,2,9,10,19,26,14,40,0.000333,0.056639,4,679.668402,37.759356,169.917101,61.748606,1,0
0,0,2,2,9,10,19,26,14,40,0.000333,0.056639,4,679.668402,37.759356,169.917101,61.748606,2,0
0,0,2,2,9,10,19,26,14,40,0.000333,0.056639,4,679.668402,37.759356,169.917101,61.748606,1,0
0,0,2,2,9,10,19,26,14,40,0.000333,0.056639,4,679.668402,37.759356,169.917101,61.748606,1,0
0,0,5,5,13,101,114,424,267,691,0.000333,1.573842,12,56658.324,3147.684667,4721.527,720.585076,7,0
0,0,2,2,9,10,19,26,14,40,0.000333,0.056639,4,679.668402,37.759356,169.917101,61.748606,1,0
0,0,2,2,9,10,19,26,14,40,0.000333,0.056639,4,679.668402,37.759356,169.917101,61.748606,1,0
0,0,3,3,9,9,18,63,34,97,0.000333,0.134828,12,4853.792702,269.65515,404.482725,57.05865,1,0
0,0,2,2,9,10,19,26,14,40,0.000333,0.056639,4,679.668402,37.759356,169.917101,61.748606,1,0
0,0,10,10,9,14,23,123,66,189,0.000333,0.284984,16,13679.25136,759.958409,854.95321,81.832294,1,0
0,0,2,2,9,10,19,26,14,40,0.000333,0.056639,4,679.668402,37.759356,169.917101,61.748606,1,0
0,0,3,3,11,12,23,35,18,53,0.000333,0.079916,5,1198.743918,66.596884,239.748784,81.073298,2,0
0,0,2,2,9,10,19,26,14,40,0.000333,0.056639,4,679.668402,37.759356,169.917101,61.748606,1,0
0,0,2,2,9,10,19,26,14,40,0.000333,0.056639,4,679.668402,37.759356,169.917101,61.748606,1,0
0,0,2,2,9,10,19,26,14,40,0.000333,0.056639,4,679.668402,37.759356,169.917101,61.748606,1,0
0,0,2,2,9,10,19,26,14,40,0.000333,0.056639,4,679.668402,37.759356,169.917101,61.748606,1,0
0,0,2,2,9,10,19,26,14,40,0.000333,0.056639,4,679.668402,37.759356,169.917101,61.748606,2,0
0,0,2,2,9,10,19,26,14,40,0.000333,0.056639,4,679.668402,37.759356,169.917101,61.748606,1,0
0,0,2,2,9,10,19,26,14,40,0.000333,0.056639,4,679.668402,37.759356,169.917101,61.748606,1,0
0,0,2,2,9,10,19,26,14,40,0.000333,0.056639,4,679.668402,37.759356,169.917101,61.748606,1,0
0,0,2,2,9,10,19,26,14,40,0.000333,0.056639,4,679.668402,37.759356,169.917101,61.748606,1,0
0,0,4,4,10,13,23,67,37,104,0.000333,0.156817,10,4704.504434,261.361357,470.450443,81.324997,1,0
0,0,17,17,16,23,39,110,55,165,0.000333,0.290697,16,13953.46186,775.192325,872.091366,168.041925,7,0
0,0,3,3,8,4,12,13,6,19,0.000333,0.022705,4,272.45715,15.136508,68.114288,32,2,0
0,0,4,4,10,11,21,19,14,33,0.000333,0.048315,5,724.732375,40.26291,144.946475,71.273029,1,0
0,0,3,3,11,11,22,26,15,41,0.000333,0.060946,5,914.183482,50.787971,182.836696,76.107496,3,0
0,0,10,10,15,22,37,70,39,109,0.000333,0.189277,7,3974.812918,220.82294,567.830417,156.710855,6,0
0,0,3,3,11,11,22,26,15,41,0.000333,0.060946,5,914.183482,50.787971,182.836696,76.107496,3,0
0,0,10,10,15,22,37,70,39,109,0.000333,0.189277,7,3974.812918,220.82294,567.830417,156.710855,6,0
0,0,17,17,16,23,39,110,55,165,0.000333,0.290697,16,13953.46186,775.192325,872.091366,168.041925,7,0
0,0,4,4,9,7,16,21,10,31,0.000333,0.041333,4,496,27.555556,124,48.180809,2,0
0,0,3,3,13,11,24,28,16,44,0.000333,0.067246,6,1210.4301,67.246117,201.73835,86.159464,2,0
0,0,3,3,13,10,23,23,15,38,0.000333,0.057298,6,1031.372126,57.298451,171.895354,81.324997,2,0
0,0,13,13,17,17,34,99,59,158,0.000333,0.26794,24,19291.65909,1071.758839,803.819129,138.973737,5,0
0,0,2,2,6,4,10,7,5,12,0.000333,0.013288,3,119.589411,6.643856,39.863137,23.509775,1,0
0,0,2,2,6,4,10,8,6,14,0.000333,0.015502,3,139.52098,7.751166,46.506993,23.509775,1,0
0,0,3,3,8,6,14,13,10,23,0.000333,0.02919,4,350.276653,19.459814,87.569163,39.509775,1,0
0,0,2,2,6,4,10,8,6,14,0.000333,0.015502,3,139.52098,7.751166,46.506993,23.509775,1,0
0,0,4,4,8,7,15,15,12,27,0.000333,0.035162,4,421.944184,23.441344,105.486046,43.651484,1,0
0,0,2,2,6,4,10,8,6,14,0.000333,0.015502,3,139.52098,7.751166,46.506993,23.509775,1,0
0,0,4,4,8,7,15,15,12,27,0.000333,0.035162,4,421.944184,23.441344,105.486046,43.651484,1,0
0,0,5,5,11,8,19,24,15,39,0.000333,0.055223,5,828.345865,46.019215,165.669173,62.053748,2,0
0,0,2,2,6,4,10,8,6,14,0.000333,0.015502,3,139.52098,7.751166,46.506993,23.509775,1,0
0,0,28,28,17,32,49,169,104,273,0.000333,0.510939,24,36787.5789,2043.754383,1532.815787,229.486868,1,0
0,0,4,4,10,13,23,41,24,65,0.000333,0.098011,5,1470.157636,81.675424,294.031527,81.324997,1,0
0,0,6,6,10,14,24,64,38,102,0.000333,0.155889,10,4676.661751,259.814542,467.666175,86.52225,1,0
0,0,8,8,13,18,31,80,46,126,0.000333,0.208076,12,7490.744821,416.15249,624.228735,123.164366,1,0
0,0,9,9,13,20,33,92,54,146,0.000333,0.245494,12,8837.778497,490.987694,736.481541,134.544278,1,0
0,0,2,2,6,5,11,10,6,16,0.000333,0.01845,3,166.052718,9.225151,55.350906,27.119415,1,0
0,0,2,2,7,6,13,12,8,20,0.000333,0.02467,3,222.026383,12.334799,74.008794,35.161259,1,0
0,0,2,2,7,7,14,13,9,22,0.000333,0.027921,3,251.285425,13.960301,83.761808,39.302969,1,0
0,0,3,3,8,7,15,18,10,28,0.000333,0.036464,4,437.571747,24.309541,109.392937,43.651484,1,0
0,0,3,3,9,9,18,21,12,33,0.000333,0.045869,4,550.4301,30.57945,137.607525,57.05865,1,0
0,0,4,4,9,9,18,22,13,35,0.000333,0.048649,4,583.7895,32.43275,145.947375,57.05865,1,0
0,0,3,3,9,8,17,20,11,31,0.000333,0.042237,4,506.845392,28.158077,126.711348,52.529325,1,0
0,0,51,51,19,59,78,305,203,508,0.000333,1.064328,27,86210.57683,4789.476491,3192.984327,427.786563,2,0
0,0,11,11,15,20,35,90,54,144,0.000333,0.246206,14,10340.63456,574.479698,738.616754,145.041921,1,0
0,0,2,2,6,5,11,10,6,16,0.000333,0.01845,3,166.052718,9.225151,55.350906,27.119415,1,0
0,0,51,51,19,59,78,306,205,511,0.000333,1.070614,27,86719.69441,4817.760801,3211.840534,427.786563,2,0
0,0,9,9,13,20,33,92,54,146,0.000333,0.245494,12,8837.778497,490.987694,736.481541,134.544278,1,0
0,0,10,10,15,18,33,78,46,124,0.000333,0.208502,14,8757.068191,486.503788,625.504871,133.662009,1,0
0,0,2,2,6,4,10,10,5,15,0.000333,0.01661,3,149.486764,8.30482,49.828921,23.509775,1,0
0,0,3,3,8,7,15,18,10,28,0.000333,0.036464,4,437.571747,24.309541,109.392937,43.651484,1,0
0,0,2,2,7,7,14,13,9,22,0.000333,0.027921,3,251.285425,13.960301,83.761808,39.302969,1,0
0,0,2,2,7,6,13,12,8,20,0.000333,0.02467,3,222.026383,12.334799,74.008794,35.161259,1,0
0,0,3,3,9,8,17,20,11,31,0.000333,0.042237,4,506.845392,28.158077,126.711348,52.529325,1,0
0,0,3,3,9,9,18,21,12,33,0.000333,0.045869,4,550.4301,30.57945,137.607525,57.05865,1,0
0,0,8,8,13,18,31,80,46,126,0.000333,0.208076,12,7490.744821,416.15249,624.228735,123.164366,1,0
0,0,4,4,10,13,23,41,24,65,0.000333,0.098011,5,1470.157636,81.675424,294.031527,81.324997,1,0
0,0,6,6,10,14,24,64,38,102,0.000333,0.155889,10,4676.661751,259.814542,467.666175,86.52225,1,0
0,0,9,9,13,20,33,92,54,146,0.000333,0.245494,12,8837.778497,490.987694,736.481541,134.544278,1,0
0,0,27,27,17,31,48,167,102,269,0.000333,0.500785,24,36056.51791,2003.139884,1502.354913,223.066954,1,0
0,0,2,2,7,6,13,12,8,20,0.000333,0.02467,3,222.026383,12.334799,74.008794,35.161259,1,0
0,0,2,2,7,7,14,13,9,22,0.000333,0.027921,3,251.285425,13.960301,83.761808,39.302969,1,0
0,0,3,3,8,7,15,18,10,28,0.000333,0.036464,4,437.571747,24.309541,109.392937,43.651484,1,0
0,0,3,3,9,9,18,21,12,33,0.000333,0.045869,4,550.4301,30.57945,137.607525,57.05865,1,0
0,0,3,3,9,8,17,20,11,31,0.000333,0.042237,4,506.845392,28.158077,126.711348,52.529325,1,0
0,0,9,9,13,20,33,92,54,146,0.000333,0.245494,12,8837.778497,490.987694,736.481541,134.544278,1,0
0,0,4,4,10,13,23,41,24,65,0.000333,0.098011,5,1470.157636,81.675424,294.031527,81.324997,1,0
0,0,6,6,10,14,24,64,38,102,0.000333,0.155889,10,4676.661751,259.814542,467.666175,86.52225,1,0
0,0,8,8,13,18,31,80,46,126,0.000333,0.208076,12,7490.744821,416.15249,624.228735,123.164366,1,0
0,0,36,36,21,47,68,251,156,407,0.000333,0.825866,30,74327.92129,4129.328961,2477.597376,353.304342,1,0
0,0,41,41,23,52,75,284,178,462,0.000333,0.959238,33,94964.56976,5275.809431,2877.714235,400.46479,2,0
0,0,38,38,23,52,75,269,168,437,0.000333,0.907331,33,89825.79434,4990.321908,2721.993768,400.46479,2,0
0,0,2,2,7,6,13,12,8,20,0.000333,0.02467,3,222.026383,12.334799,74.008794,35.161259,1,0
0,0,3,3,8,7,15,18,10,28,0.000333,0.036464,4,437.571747,24.309541,109.392937,43.651484,1,0
0,0,2,2,7,7,14,13,9,22,0.000333,0.027921,3,251.285425,13.960301,83.761808,39.302969,1,0
0,0,3,3,9,8,17,20,11,31,0.000333,0.042237,4,506.845392,28.158077,126.711348,52.529325,1,0
0,0,3,3,9,9,18,21,12,33,0.000333,0.045869,4,550.4301,30.57945,137.607525,57.05865,1,0
0,0,4,4,9,9,18,22,13,35,0.000333,0.048649,4,583.7895,32.43275,145.947375,57.05865,1,0
0,0,15,15,16,24,40,94,59,153,0.000333,0.271418,16,13028.07998,723.782221,814.254999,174.0391,1,0
0,0,8,8,13,18,31,80,46,126,0.000333,0.208076,12,7490.744821,416.15249,624.228735,123.164366,1,0
0,0,2,2,7,6,13,12,8,20,0.000333,0.02467,3,222.026383,12.334799,74.008794,35.161259,1,0
0,0,3,3,9,8,17,20,11,31,0.000333,0.042237,4,506.845392,28.158077,126.711348,52.529325,1,0
0,0,7,7,12,22,34,45,31,76,0.000333,0.128882,6,2319.883056,128.882392,386.647176,141.127046,1,0
0,0,26,26,26,49,75,165,106,271,0.000333,0.56267,26,43888.25649,2438.236472,1688.009865,397.332215,6,0
0,0,30,30,25,52,77,188,121,309,0.000333,0.645479,24,46474.48899,2581.916055,1936.437041,412.51927,6,0
0,0,6,6,12,21,33,42,28,70,0.000333,0.117703,6,2118.64553,117.702529,353.107588,135.258216,1,0
0,0,74,74,28,31,59,281,140,421,0.000333,0.825531,56,138689.1925,7704.955141,2476.592724,288.186023,13,0
0,0,31,31,27,26,53,135,66,201,0.000333,0.383771,26,29934.1123,1663.006239,1151.312011,250.593395,8,0
0,0,60,60,27,22,49,214,106,320,0.000333,0.598902,52,93428.77181,5190.487323,1796.70715,226.489458,9,0
0,0,60,60,27,24,51,223,112,335,0.000333,0.633421,52,98813.64946,5489.647192,1900.26249,238.421063,10,0
0,0,29,29,21,16,37,119,53,172,0.000333,0.298675,30,26880.77937,1493.376631,896.025979,156.238666,9,0
0,0,5,5,9,8,17,24,12,36,0.000333,0.04905,4,588.594649,32.699703,147.148662,52.529325,1,0
0,0,3,3,9,5,14,14,7,21,0.000333,0.026651,4,319.817813,17.767656,79.954453,40.138965,1,0
0,0,30,30,23,21,44,126,58,184,0.000333,0.334845,22,22099.77919,1227.765511,1004.535418,196.280591,8,0
0,0,34,34,24,23,47,137,67,204,0.000333,0.377712,24,27195.26702,1510.848168,1133.136126,214.081025,9,0
0,0,2,2,7,4,11,11,5,16,0.000333,0.01845,3,166.052718,9.225151,55.350906,27.651484,1,0
0,0,52,52,27,21,48,179,95,274,0.000333,0.510093,52,79574.54571,4420.808095,1530.279725,220.620628,6,0
0,0,68,68,28,28,56,244,128,372,0.000333,0.720112,56,120978.8177,6721.04543,2160.336031,269.211876,10,0
0,0,74,74,28,31,59,274,139,413,0.000333,0.809844,56,136053.7684,7558.542691,2429.531579,288.186023,12,0
0,0,2,2,7,4,11,8,5,13,0.000333,0.014991,3,134.917833,7.495435,44.972611,27.651484,1,0
0,0,96,96,27,37,64,437,202,639,0.000333,1.278,65,249210,13845,3834,321.131737,66,0
0,0,23,23,19,16,35,108,49,157,0.000333,0.268432,27,21743.03071,1207.94615,805.297434,144.710623,7,0
0,0,2,2,7,5,12,8,6,14,0.000333,0.01673,3,150.568425,8.364913,50.189475,31.261125,1,0
0,0,4,4,11,9,20,22,11,33,0.000333,0.047541,5,713.118136,39.617674,142.623627,66.583073,5,0
0,0,96,96,27,37,64,437,202,639,0.000333,1.278,65,249210,13845,3834,321.131737,66,0
0,0,7,7,11,20,31,42,32,74,0.000333,0.122204,5,1833.052635,101.836257,366.610527,124.49231,1,0
0,0,3,3,8,9,17,28,16,44,0.000333,0.059949,4,719.39346,39.966303,179.848365,52.529325,2,0
0,0,4,4,16,13,29,39,20,59,0.000333,0.09554,8,2292.96703,127.387057,286.620879,112.105716,3,0
0,0,3,3,9,8,17,14,11,25,0.000333,0.034062,4,408.746284,22.708127,102.186571,52.529325,1,0
0,0,4,4,11,12,23,32,20,52,0.000333,0.078408,5,1176.126109,65.340339,235.225222,81.073298,2,0
0,0,11,11,16,28,44,67,51,118,0.000333,0.214738,8,5153.703448,286.316858,644.212931,198.605938,3,0
0,0,6,6,12,12,24,28,21,49,0.000333,0.074888,6,1347.978975,74.887721,224.663163,86.0391,2,0
0,0,2,2,6,4,10,7,5,12,0.000333,0.013288,3,119.589411,6.643856,39.863137,23.509775,1,0
0,0,9,9,16,20,36,45,32,77,0.000333,0.132695,8,3184.673801,176.926322,398.084225,150.438562,3,0
0,0,4,4,16,13,29,39,20,59,0.000333,0.09554,8,2292.96703,127.387057,286.620879,112.105716,3,0
0,0,2,2,7,6,13,11,7,18,0.000333,0.022203,3,199.823745,11.101319,66.607915,35.161259,1,0
0,0,188,188,37,126,163,973,727,1700,0.000333,4.164279,90,1124355.408,62464.18931,12492.83786,1071.887045,39,0
0,0,243,243,38,127,165,1273,964,2237,0.000333,5.492821,133,2191635.552,121757.5306,16478.46279,1086.984201,47,0
0,0,3,3,6,8,14,13,11,24,0.000333,0.030459,3,274.129554,15.22942,91.376518,39.509775,1,0
0,0,4,4,10,12,22,27,18,45,0.000333,0.066891,5,1003.372114,55.742895,200.674423,76.238831,3,0
0,0,3,3,11,27,38,58,45,103,0.000333,0.180179,5,2702.682669,150.149037,540.536534,166.43571,4,0
0,0,125,125,32,95,127,715,529,1244,0.000333,2.897975,80,695513.9,38639.66111,8693.92375,784.136283,27,0
0,0,8,8,16,31,47,60,44,104,0.000333,0.192559,8,4621.417925,256.74544,577.677241,217.580086,3,0
0,0,13,13,12,28,40,78,64,142,0.000333,0.251905,12,9068.565474,503.809193,755.713789,177.625488,3,0
0,0,3,3,7,6,13,13,8,21,0.000333,0.025903,3,233.127702,12.951539,77.709234,35.161259,1,0
0,0,217,217,38,126,164,1170,862,2032,0.000333,4.983515,114,1704362.207,94686.78927,14950.54567,1078.558516,50,0
0,0,267,267,37,110,147,1375,1067,2442,0.000333,5.860533,162,2848219.178,158234.3988,17581.59987,938.699343,41,0
0,0,105,105,27,92,119,572,434,1006,0.000333,2.312062,52,360681.7068,20037.8726,6936.18667,728.549663,19,0
0,0,86,86,28,92,120,489,358,847,0.000333,1.950045,42,245705.726,13650.31811,5850.136334,734.773638,25,0
0,0,54,54,26,65,91,329,230,559,0.000333,1.212619,39,141876.431,7882.023942,3637.857204,513.665341,20,0
0,0,171,171,38,122,160,905,684,1589,0.000333,3.878181,95,1105281.656,61404.53642,11634.54374,1044.971201,38,0
0,0,208,208,40,120,160,1075,811,1886,0.000333,4.603052,120,1657098.766,92061.04258,13809.15639,1041.703995,42,0
0,0,3,3,12,12,24,23,16,39,0.000333,0.059605,6,1072.881225,59.604513,178.813538,86.0391,3,0
0,0,112,112,30,90,120,628,482,1110,0.000333,2.55555,75,574998.6421,31944.36901,7666.648561,731.473497,19,0
0,0,8,8,10,8,18,42,20,62,0.000333,0.086178,10,2585.353501,143.63075,258.53535,57.219281,1,0
0,0,12,12,15,11,26,90,42,132,0.000333,0.206819,21,13029.6189,723.867717,620.458043,96.657107,5,0
0,0,8,8,12,9,21,58,29,87,0.000333,0.127377,18,6878.369084,382.131616,382.131616,71.548875,1,0
0,0,16,16,15,12,27,116,57,173,0.000333,0.274199,28,23032.67506,1279.593059,822.595538,101.622909,5,0
0,0,2,2,6,7,13,20,10,30,0.000333,0.037004,3,333.039575,18.502199,111.013192,35.161259,1,0
0,0,8,8,10,8,18,42,20,62,0.000333,0.086178,10,2585.353501,143.63075,258.53535,57.219281,1,0
0,0,16,16,15,12,27,116,57,173,0.000333,0.274199,28,23032.67506,1279.593059,822.595538,101.622909,5,0
0,0,4,4,8,9,17,26,15,41,0.000333,0.055862,4,670.343906,37.241328,167.585976,52.529325,1,0
0,0,2,2,5,4,9,6,5,11,0.000333,0.011623,2,69.73835,3.874353,34.869175,19.60964,1,0
0,0,13,13,15,11,26,94,45,139,0.000333,0.217787,28,18294.11138,1016.339521,653.361121,96.657107,5,0
0,0,3,3,9,4,13,15,7,22,0.000333,0.027137,4,325.638695,18.091039,81.409674,36.529325,1,0
0,0,7,7,11,17,28,29,25,54,0.000333,0.086532,5,1297.985829,72.110324,259.597166,107.540616,1,0
0,0,6,6,11,16,27,26,22,48,0.000333,0.076078,5,1141.173001,63.3985,228.2346,102.053748,1,0
0,0,3,3,8,5,13,13,7,20,0.000333,0.02467,4,296.035177,16.446399,74.008794,35.60964,1,0
0,0,2,2,8,4,12,9,5,14,0.000333,0.01673,4,200.7579,11.153217,50.189475,32,1,0
0,0,2,2,10,7,17,13,9,22,0.000333,0.029975,5,449.620913,24.97894,89.924183,52.870765,2,0
0,0,2,2,6,4,10,7,5,12,0.000333,0.013288,3,119.589411,6.643856,39.863137,23.509775,1,0
0,0,5,5,10,13,23,21,18,39,0.000333,0.058806,5,882.094581,49.005255,176.418916,81.324997,1,0
0,0,3,3,8,5,13,13,7,20,0.000333,0.02467,4,296.035177,16.446399,74.008794,35.60964,1,0
0,0,2,2,6,4,10,7,5,12,0.000333,0.013288,3,119.589411,6.643856,39.863137,23.509775,1,0
0,0,4,4,10,11,21,18,15,33,0.000333,0.048315,5,724.732375,40.26291,144.946475,71.273029,1,0
0,0,6,6,10,11,21,41,22,63,0.000333,0.092239,10,2767.159976,153.73111,276.715998,71.273029,1,0
0,0,30,30,21,36,57,133,100,233,0.000333,0.453021,20,27181.26747,1510.070415,1359.063373,278.355966,6,0
0,0,6,6,10,11,21,41,22,63,0.000333,0.092239,10,2767.159976,153.73111,276.715998,71.273029,1,0
0,0,26,26,20,32,52,118,84,202,0.000333,0.38383,20,23029.77646,1279.432026,1151.488823,246.438562,6,0
0,0,26,26,18,33,51,124,88,212,0.000333,0.400851,18,21645.97511,1202.554172,1202.554172,241.523656,6,0
0,0,3,3,9,9,18,31,17,48,0.000333,0.066719,4,800.6256,44.4792,200.1564,57.05865,1,0
0,0,9,9,13,21,34,64,42,106,0.000333,0.179757,12,6471.252734,359.514041,539.271061,140.344382,2,0
0,0,21,21,14,32,46,90,64,154,0.000333,0.283543,14,11908.79958,661.599977,850.628541,213.302969,2,0
0,0,3,3,8,7,15,14,10,24,0.000333,0.031255,4,375.061497,20.83675,93.765374,43.651484,1,0
0,0,2,2,7,5,12,20,8,28,0.000333,0.03346,3,301.13685,16.729825,100.37895,31.261125,1,0
0,0,4,4,7,16,23,22,17,39,0.000333,0.058806,3,529.256749,29.403153,176.418916,83.651484,2,0
0,0,2,2,8,8,16,14,11,25,0.000333,0.033333,4,400,22.222222,100,48,1,0
0,0,7,7,11,13,24,38,24,62,0.000333,0.094756,5,1421.338375,78.963243,284.267675,86.159464,2,0
0,0,2,2,6,4,10,10,6,16,0.000333,0.017717,3,159.452549,8.858475,53.15085,23.509775,1,0
0,0,2,2,7,5,12,14,8,22,0.000333,0.02629,3,236.607525,13.144863,78.869175,31.261125,1,0
0,0,2,2,6,4,10,8,5,13,0.000333,0.014395,3,129.555196,7.197511,43.185065,23.509775,1,0
0,0,2,2,6,4,10,8,5,13,0.000333,0.014395,3,129.555196,7.197511,43.185065,23.509775,1,0
0,0,24,24,12,30,42,177,118,295,0.000333,0.530245,18,28633.20552,1590.73364,1590.73364,190.226268,6,0
0,0,2,2,6,4,10,7,5,12,0.000333,0.013288,3,119.589411,6.643856,39.863137,23.509775,1,0
0,0,24,24,12,30,42,177,118,295,0.000333,0.530245,18,28633.20552,1590.73364,1590.73364,190.226268,6,0
0,0,2,2,8,15,23,11,16,27,0.000333,0.040712,4,488.544691,27.141372,122.136173,82.603359,2,0
0,0,19,19,12,30,42,140,93,233,0.000333,0.418803,18,22615.37927,1256.40996,1256.40996,190.226268,4,0
0,0,6,6,13,10,23,24,17,41,0.000333,0.061822,6,1112.796241,61.822013,185.46604,81.324997,2,0
0,0,5,5,10,10,20,19,15,34,0.000333,0.048982,5,734.727776,40.81821,146.945555,66.438562,1,0
0,0,5,5,10,10,20,19,15,34,0.000333,0.048982,5,734.727776,40.81821,146.945555,66.438562,1,0
0,0,10,10,17,15,32,49,32,81,0.000333,0.135,16,6480,360,405,128.090227,3,0
0,0,7,7,12,13,25,31,23,54,0.000333,0.083589,6,1504.609405,83.589411,250.768234,91.125266,1,0
0,0,9,9,14,15,29,44,30,74,0.000333,0.11983,14,5032.868311,279.603795,359.490594,111.906328,2,0
0,0,9,9,14,13,27,36,23,59,0.000333,0.093513,7,1963.768538,109.098252,280.538363,101.408685,3,0
0,0,6,6,11,12,23,24,18,42,0.000333,0.06333,5,949.948011,52.774889,189.989602,81.073298,1,0
0,0,8,8,13,13,26,31,21,52,0.000333,0.081474,6,1466.537192,81.474288,244.422865,96.211433,2,0
0,0,4,4,10,7,17,34,18,52,0.000333,0.070849,10,2125.480677,118.08226,212.548068,52.870765,7,0
0,0,3,3,13,7,20,18,11,29,0.000333,0.041779,6,752.015489,41.778638,125.335915,67.757201,1,0
0,0,6,6,16,11,27,31,19,50,0.000333,0.079248,8,1901.955001,105.664167,237.744375,102.053748,4,0
0,0,3,3,13,7,20,18,11,29,0.000333,0.041779,6,752.015489,41.778638,125.335915,67.757201,1,0
0,0,5,5,13,11,24,26,17,43,0.000333,0.065718,6,1182.920325,65.717796,197.153388,86.159464,3,0
0,0,11,11,19,18,37,59,37,96,0.000333,0.166703,18,9001.935416,500.107523,500.107523,155.769273,3,0
0,0,8,8,15,15,30,38,28,66,0.000333,0.107952,7,2266.983455,125.943525,323.854779,117.206718,1,0
0,0,10,10,17,18,35,54,35,89,0.000333,0.152169,8,3652.049508,202.891639,456.506189,144.545518,2,0
0,0,8,8,15,13,28,42,26,68,0.000333,0.108967,14,4576.601886,254.25566,326.900135,106.709075,3,0
0,0,6,6,12,12,24,31,22,53,0.000333,0.081001,6,1458.018075,81.001004,243.003013,86.0391,1,0
0,0,7,7,14,13,27,37,24,61,0.000333,0.096683,7,2030.336963,112.796498,290.048138,101.408685,2,0
0,0,2,2,8,4,12,14,6,20,0.000333,0.0239,4,286.797,15.933167,71.69925,32,2,0
0,0,3,3,10,6,16,17,9,26,0.000333,0.034667,5,520,28.888889,104,48.729056,2,0
0,0,2,2,8,5,13,11,7,18,0.000333,0.022203,4,266.43166,14.801759,66.607915,35.60964,2,0
0,0,2,2,8,4,12,14,6,20,0.000333,0.0239,4,286.797,15.933167,71.69925,32,2,0
0,0,3,3,10,6,16,17,9,26,0.000333,0.034667,5,520,28.888889,104,48.729056,2,0
0,0,2,2,8,5,13,11,7,18,0.000333,0.022203,4,266.43166,14.801759,66.607915,35.60964,2,0
0,0,12,12,19,23,42,62,45,107,0.000333,0.192326,9,5192.801678,288.488982,576.977964,184.752548,8,0
0,0,11,11,18,22,40,58,43,101,0.000333,0.179172,9,4837.632638,268.757369,537.514738,173.166146,7,0
0,0,12,12,15,13,28,46,29,75,0.000333,0.120184,14,5047.722668,280.429037,360.551619,106.709075,4,0
0,0,6,6,11,12,23,25,19,44,0.000333,0.066346,5,995.18363,55.287979,199.036726,81.073298,1,0
0,0,11,11,14,13,27,41,27,68,0.000333,0.107777,14,4526.652902,251.480717,323.33235,101.408685,3,0
0,0,5,5,11,11,22,20,16,36,0.000333,0.053513,5,802.697691,44.594316,160.539538,76.107496,2,0
0,0,5,5,12,11,23,21,16,37,0.000333,0.055791,6,1004.230754,55.790597,167.371792,81.073298,2,0
0,0,2,2,10,4,14,11,5,16,0.000333,0.020306,5,304.588394,16.921577,60.917679,41.219281,1,0
0,0,14,14,18,20,38,71,52,123,0.000333,0.215165,18,11618.91152,645.495084,645.495084,161.497212,3,0
0,0,15,15,18,20,38,77,56,133,0.000333,0.232658,18,12563.53847,697.974359,697.974359,161.497212,2,0
0,0,14,14,18,20,38,71,57,128,0.000333,0.223912,18,12091.22499,671.734722,671.734722,161.497212,2,0
0,0,12,12,16,19,35,61,49,110,0.000333,0.188074,16,9027.53811,501.529895,564.221132,144.710623,2,0
0,0,3,3,9,11,20,17,15,32,0.000333,0.046101,4,553.206796,30.733711,138.301699,66.583073,1,0
0,0,2,2,4,4,8,8,6,14,0.000333,0.014,2,84,4.666667,42,16,1,0
0,0,3,3,4,5,9,12,9,21,0.000333,0.022189,2,133.13685,7.396492,66.568425,19.60964,1,0
0,0,2,2,4,4,8,8,6,14,0.000333,0.014,2,84,4.666667,42,16,1,0
0,0,3,3,4,5,9,12,9,21,0.000333,0.022189,2,133.13685,7.396492,66.568425,19.60964,1,0
0,0,2,2,10,5,15,12,7,19,0.000333,0.024744,5,371.154607,20.6197,74.230921,44.828921,1,0
0,0,2,2,8,5,13,10,6,16,0.000333,0.019736,4,236.828142,13.157119,59.207035,35.60964,1,0
0,0,2,2,8,5,13,10,6,16,0.000333,0.019736,4,236.828142,13.157119,59.207035,35.60964,1,0
0,0,2,2,4,4,8,8,6,14,0.000333,0.014,2,84,4.666667,42,16,1,0
0,0,3,3,4,5,9,12,9,21,0.000333,0.022189,2,133.13685,7.396492,66.568425,19.60964,1,0
0,0,2,2,8,3,11,9,4,13,0.000333,0.014991,4,179.890444,9.993914,44.972611,28.754888,1,0
0,0,6,6,10,9,19,28,16,44,0.000333,0.062303,5,934.544053,51.919114,186.908811,61.748606,1,0
0,0,5,5,10,8,18,26,15,41,0.000333,0.056989,5,854.834625,47.490813,170.966925,57.219281,1,0
0,0,5,5,10,8,18,26,15,41,0.000333,0.056989,5,854.834625,47.490813,170.966925,57.219281,1,0
0,0,2,2,4,4,8,8,6,14,0.000333,0.014,2,84,4.666667,42,16,1,0
0,0,2,2,9,3,12,10,4,14,0.000333,0.01673,4,200.7579,11.153217,50.189475,33.284213,1,0
0,0,3,3,4,5,9,12,9,21,0.000333,0.022189,2,133.13685,7.396492,66.568425,19.60964,1,0
0,0,2,2,7,5,12,11,7,18,0.000333,0.02151,3,193.587975,10.754888,64.529325,31.261125,1,0
0,0,3,3,9,6,15,29,17,46,0.000333,0.059906,8,1437.735739,79.874208,179.716967,44.0391,1,0
0,0,2,2,8,6,14,12,9,21,0.000333,0.026651,4,319.817813,17.767656,79.954453,39.509775,1,0
0,0,3,3,9,6,15,29,17,46,0.000333,0.059906,8,1437.735739,79.874208,179.716967,44.0391,1,0
0,0,3,3,9,6,15,29,17,46,0.000333,0.059906,8,1437.735739,79.874208,179.716967,44.0391,1,0
0,0,5,5,11,12,23,36,25,61,0.000333,0.091979,10,2759.372793,153.298489,275.937279,81.073298,2,0
0,0,2,2,8,6,14,12,9,21,0.000333,0.026651,4,319.817813,17.767656,79.954453,39.509775,1,0
0,0,3,3,9,6,15,29,17,46,0.000333,0.059906,8,1437.735739,79.874208,179.716967,44.0391,1,0
0,0,4,4,10,11,21,33,23,56,0.000333,0.08199,10,2459.697757,136.649875,245.969776,71.273029,1,0
0,0,5,5,13,12,25,29,20,49,0.000333,0.07585,6,1365.29372,75.849651,227.548953,91.125266,3,0
0,0,5,5,14,12,26,33,22,55,0.000333,0.086175,7,1809.669291,100.537183,258.524184,96.322519,3,0
0,0,5,5,13,12,25,29,20,49,0.000333,0.07585,6,1365.29372,75.849651,227.548953,91.125266,3,0
0,0,2,2,10,8,18,14,12,26,0.000333,0.036139,5,542.09025,30.116125,108.41805,57.219281,3,0
0,0,2,2,9,5,14,13,8,21,0.000333,0.026651,4,319.817813,17.767656,79.954453,40.138965,1,0
0,0,2,2,11,8,19,25,12,37,0.000333,0.052391,5,785.86659,43.659255,157.173318,62.053748,2,0
0,0,7,7,13,10,23,41,20,61,0.000333,0.091979,12,3311.247352,183.958186,275.937279,81.324997,4,0
0,0,2,2,10,6,16,21,8,29,0.000333,0.038667,5,580,32.222222,116,48.729056,2,0
0,0,2,2,9,5,14,13,8,21,0.000333,0.026651,4,319.817813,17.767656,79.954453,40.138965,1,0
0,0,2,2,11,8,19,25,12,37,0.000333,0.052391,5,785.86659,43.659255,157.173318,62.053748,2,0
0,0,5,5,16,8,24,42,16,58,0.000333,0.088643,16,4254.845201,236.380289,265.927825,88,2,0
0,0,3,3,14,7,21,33,13,46,0.000333,0.067349,7,1414.32621,78.573678,202.046601,72.954453,2,0
0,0,4,4,8,8,16,21,12,33,0.000333,0.044,4,528,29.333333,132,48,1,0
0,0,3,3,7,7,14,16,10,26,0.000333,0.032997,3,296.973684,16.498538,98.991228,39.302969,1,0
0,0,2,2,8,6,14,12,9,21,0.000333,0.026651,4,319.817813,17.767656,79.954453,39.509775,1,0
0,0,2,2,8,6,14,12,9,21,0.000333,0.026651,4,319.817813,17.767656,79.954453,39.509775,1,0
0,0,2,2,10,4,14,11,6,17,0.000333,0.021575,5,323.625168,17.979176,64.725034,41.219281,1,0
0,0,4,4,13,10,23,25,18,43,0.000333,0.064838,6,1167.078985,64.837721,194.513164,81.324997,2,0
0,0,2,2,8,6,14,12,9,21,0.000333,0.026651,4,319.817813,17.767656,79.954453,39.509775,1,0
0,0,3,3,11,9,20,20,16,36,0.000333,0.051863,5,777.947057,43.219281,155.589411,66.583073,1,0
0,0,5,5,16,8,24,42,16,58,0.000333,0.088643,16,4254.845201,236.380289,265.927825,88,2,0
0,0,3,3,14,7,21,33,13,46,0.000333,0.067349,7,1414.32621,78.573678,202.046601,72.954453,2,0
0,0,4,4,10,9,19,23,14,37,0.000333,0.052391,5,785.86659,43.659255,157.173318,61.748606,2,0
0,0,4,4,10,9,19,23,14,37,0.000333,0.052391,5,785.86659,43.659255,157.173318,61.748606,2,0
0,0,7,7,13,13,26,32,22,54,0.000333,0.084608,6,1522.942469,84.607915,253.823745,96.211433,2,0
0,0,5,5,9,12,21,20,17,37,0.000333,0.054172,4,650.062979,36.11461,162.515745,71.548875,1,0
0,0,6,6,10,13,23,27,20,47,0.000333,0.070869,5,1063.03706,59.057614,212.607412,81.324997,1,0
0,0,11,11,19,20,39,57,38,95,0.000333,0.167371,9,4519.018897,251.056605,502.113211,167.149185,5,0
0,0,10,10,18,19,37,53,36,89,0.000333,0.154547,9,4172.772146,231.820675,463.64135,155.769273,4,0
0,0,11,11,19,20,39,58,38,96,0.000333,0.169133,9,4566.587517,253.699307,507.398613,167.149185,5,0
0,0,6,6,10,12,22,23,20,43,0.000333,0.063919,5,958.777798,53.265433,191.75556,76.238831,1,0
0,0,6,6,10,12,22,23,20,43,0.000333,0.063919,5,958.777798,53.265433,191.75556,76.238831,1,0
0,0,2,2,10,4,14,11,5,16,0.000333,0.020306,5,304.588394,16.921577,60.917679,41.219281,1,0
0,0,6,6,10,12,22,23,20,43,0.000333,0.063919,5,958.777798,53.265433,191.75556,76.238831,1,0
0,0,5,5,10,11,21,20,17,37,0.000333,0.054172,5,812.578723,45.143262,162.515745,71.273029,1,0
0,0,12,12,18,19,37,59,43,102,0.000333,0.177121,18,9564.556379,531.364243,531.364243,155.769273,3,0
0,0,12,12,18,19,37,59,45,104,0.000333,0.180594,18,9752.0967,541.78315,541.78315,155.769273,2,0
0,0,11,11,18,19,37,54,41,95,0.000333,0.164966,18,8908.165255,494.89807,494.89807,155.769273,2,0
0,0,10,10,16,17,33,49,40,89,0.000333,0.14965,16,7183.217226,399.067624,448.951077,133.486868,2,0
0,0,5,5,10,13,23,23,20,43,0.000333,0.064838,5,972.565821,54.031434,194.513164,81.324997,1,0
0,0,12,12,18,19,37,59,43,102,0.000333,0.177121,18,9564.556379,531.364243,531.364243,155.769273,3,0
0,0,12,12,18,19,37,56,44,100,0.000333,0.173648,18,9377.016058,520.945337,520.945337,155.769273,2,0
0,0,11,11,18,19,37,53,41,94,0.000333,0.16323,18,8814.395095,489.688616,489.688616,155.769273,2,0
0,0,11,11,16,18,34,51,42,93,0.000333,0.157711,16,7570.144708,420.563595,473.134044,139.05865,2,0
0,0,3,3,9,11,20,17,15,32,0.000333,0.046101,4,553.206796,30.733711,138.301699,66.583073,1,0
0,0,8,8,16,14,30,38,25,63,0.000333,0.103045,8,2473.07286,137.392937,309.134108,117.302969,3,0
0,0,7,7,11,13,24,27,21,48,0.000333,0.073359,5,1100.391,61.132833,220.0782,86.159464,1,0
0,0,6,6,9,12,21,21,19,40,0.000333,0.058564,4,702.770788,39.042822,175.692697,71.548875,1,0
0,0,7,7,13,14,27,33,23,56,0.000333,0.088758,6,1597.642201,88.7579,266.2737,101.408685,2,0
0,0,7,7,15,14,29,34,22,56,0.000333,0.090682,7,1904.32855,105.796031,272.046936,111.906328,2,0
0,0,7,7,13,14,27,32,23,55,0.000333,0.087173,6,1569.112876,87.172938,261.518813,101.408685,1,0
0,0,6,6,12,13,25,26,21,47,0.000333,0.072754,6,1309.567446,72.753747,218.261241,91.125266,1,0
0,0,6,6,13,14,27,29,20,49,0.000333,0.077663,6,1397.936926,77.663163,232.989488,101.408685,1,0
0,0,8,8,11,9,20,42,22,64,0.000333,0.092201,10,2766.033981,153.668554,276.603398,66.583073,1,0
0,0,6,6,10,8,18,30,18,48,0.000333,0.066719,10,2001.564001,111.198,200.1564,57.219281,1,0
0,0,7,7,16,15,31,35,23,58,0.000333,0.095781,8,2298.747088,127.708172,287.343386,122.603359,2,0
0,0,7,7,14,16,30,33,24,57,0.000333,0.093231,7,1957.849348,108.769408,279.692764,117.302969,1,0
0,0,6,6,13,15,28,27,22,49,0.000333,0.07852,6,1413.362347,78.52013,235.560391,106.709075,1,0
0,0,6,6,14,15,29,30,21,51,0.000333,0.082586,7,1734.299215,96.349956,247.757031,111.906328,1,0
0,0,18,18,18,18,36,76,51,127,0.000333,0.21886,18,11818.44855,656.580475,656.580475,150.1173,3,0
0,0,16,16,17,20,37,66,47,113,0.000333,0.196223,16,9418.691685,523.260649,588.66823,155.92543,1,0
0,0,3,3,10,5,15,12,7,19,0.000333,0.024744,5,371.154607,20.6197,74.230921,44.828921,1,0
0,0,17,17,18,18,36,71,49,120,0.000333,0.206797,18,11167.038,620.391,620.391,150.1173,2,0
0,0,16,16,17,20,37,66,47,113,0.000333,0.196223,16,9418.691685,523.260649,588.66823,155.92543,1,0
0,0,6,6,12,17,29,30,24,54,0.000333,0.087444,6,1573.985842,87.443658,262.330974,112.506418,1,0
0,0,14,14,15,20,35,63,44,107,0.000333,0.182944,14,7683.665959,426.870331,548.833283,145.041921,1,0
0,0,8,8,17,17,34,41,26,67,0.000333,0.11362,8,2726.880083,151.493338,340.86001,138.973737,3,0
0,0,8,8,16,17,33,39,27,66,0.000333,0.110977,8,2663.440095,147.968894,332.930012,133.486868,2,0
0,0,7,7,16,17,33,36,24,60,0.000333,0.100888,8,2421.309177,134.517177,302.663647,133.486868,2,0
0,0,7,7,15,16,31,33,25,58,0.000333,0.095781,7,2011.403702,111.74465,287.343386,122.603359,2,0
0,0,5,5,12,12,24,21,17,38,0.000333,0.058076,6,1045.37145,58.076192,174.228575,86.0391,2,0
0,0,8,8,16,17,33,41,26,67,0.000333,0.112658,8,2703.795248,150.210847,337.974406,133.486868,3,0
0,0,8,8,15,17,32,39,27,66,0.000333,0.11,7,2310,128.333333,330,128.090227,2,0
0,0,7,7,15,17,32,36,24,60,0.000333,0.1,7,2100,116.666667,300,128.090227,2,0
0,0,7,7,14,16,30,33,25,58,0.000333,0.094867,7,1992.197582,110.677643,284.599655,117.302969,2,0
0,0,3,3,11,10,21,15,12,27,0.000333,0.039531,5,592.962852,32.942381,118.59257,71.273029,2,0
0,0,6,6,16,15,31,35,24,59,0.000333,0.097433,8,2338.380659,129.910037,292.297582,122.603359,2,0
0,0,3,3,13,9,22,25,14,39,0.000333,0.057973,6,1043.506999,57.972611,173.917833,76.635041,1,0
0,0,5,5,14,15,29,30,22,52,0.000333,0.084205,7,1768.305082,98.239171,252.615012,111.906328,1,0
0,0,6,6,14,15,29,33,25,58,0.000333,0.093921,7,1972.340284,109.57446,281.762898,111.906328,1,0
0,0,5,5,14,15,29,30,22,52,0.000333,0.084205,7,1768.305082,98.239171,252.615012,111.906328,1,0
0,0,8,8,15,15,30,37,24,61,0.000333,0.099773,7,2095.242284,116.402349,299.320326,117.206718,2,0
0,0,7,7,13,15,28,33,23,56,0.000333,0.089737,6,1615.271254,89.737292,269.211876,106.709075,1,0
0,0,6,6,12,14,26,27,21,48,0.000333,0.075207,6,1353.726639,75.207035,225.621106,96.322519,1,0
0,0,7,7,13,15,28,32,22,54,0.000333,0.086532,6,1557.582995,86.532389,259.597166,106.709075,1,0
0,0,18,18,18,18,36,76,51,127,0.000333,0.21886,18,11818.44855,656.580475,656.580475,150.1173,3,0
0,0,16,16,16,21,37,66,47,113,0.000333,0.196223,16,9418.691685,523.260649,588.66823,156.238666,1,0
0,0,2,2,7,4,11,10,5,15,0.000333,0.017297,3,155.674423,8.648579,51.891474,27.651484,1,0
0,0,17,17,18,18,36,71,49,120,0.000333,0.206797,18,11167.038,620.391,620.391,150.1173,2,0
0,0,16,16,16,21,37,66,47,113,0.000333,0.196223,16,9418.691685,523.260649,588.66823,156.238666,1,0
0,0,14,14,15,21,36,64,44,108,0.000333,0.186117,14,7816.926602,434.2737,558.3519,150.842025,1,0
0,0,6,6,12,17,29,30,24,54,0.000333,0.087444,6,1573.985842,87.443658,262.330974,112.506418,1,0
0,0,9,9,16,18,34,44,28,72,0.000333,0.122099,8,2930.378597,162.798811,366.297325,139.05865,3,0
0,0,8,8,15,18,33,40,27,67,0.000333,0.112658,7,2365.820842,131.434491,337.974406,133.662009,2,0
0,0,8,8,15,18,33,39,26,65,0.000333,0.109295,7,2295.199324,127.511074,327.885618,133.662009,2,0
0,0,7,7,14,17,31,34,25,59,0.000333,0.097433,7,2046.083076,113.671282,292.297582,122.789837,2,0
0,0,3,3,11,10,21,15,12,27,0.000333,0.039531,5,592.962852,32.942381,118.59257,71.273029,2,0
0,0,7,7,16,14,30,34,22,56,0.000333,0.091595,8,2198.286987,122.127055,274.785873,117.302969,2,0
0,0,7,7,14,15,29,32,23,55,0.000333,0.089063,7,1870.322683,103.906816,267.188955,111.906328,1,0
0,0,6,6,14,14,28,29,20,49,0.000333,0.07852,7,1648.922738,91.606819,235.560391,106.605938,1,0
0,0,8,8,17,16,33,40,25,65,0.000333,0.109295,8,2623.084942,145.726941,327.885618,133.486868,3,0
0,0,8,8,16,16,32,38,26,64,0.000333,0.106667,8,2560,142.222222,320,128,2,0
0,0,7,7,16,16,32,35,23,58,0.000333,0.096667,8,2320,128.888889,290,128,2,0
0,0,6,6,15,15,30,29,21,50,0.000333,0.081782,7,1717.411708,95.411762,245.34453,117.206718,2,0
0,0,5,5,12,12,24,21,17,38,0.000333,0.058076,6,1045.37145,58.076192,174.228575,86.0391,2,0
0,0,8,8,16,16,32,40,25,65,0.000333,0.108333,8,2600,144.444444,325,128,3,0
0,0,8,8,15,16,31,38,26,64,0.000333,0.10569,7,2219.479947,123.304442,317.068564,122.603359,2,0
0,0,7,7,15,16,31,35,23,58,0.000333,0.095781,7,2011.403702,111.74465,287.343386,122.603359,2,0
0,0,6,6,14,15,29,29,21,50,0.000333,0.080966,7,1700.293348,94.460742,242.89905,111.906328,2,0
0,0,3,3,11,10,21,15,12,27,0.000333,0.039531,5,592.962852,32.942381,118.59257,71.273029,2,0
0,0,5,5,11,11,22,27,20,47,0.000333,0.069864,5,1047.96643,58.220357,209.593286,76.107496,2,0
0,0,2,2,8,8,16,12,10,22,0.000333,0.029333,4,352,19.555556,88,48,2,0
0,0,4,4,10,9,19,25,14,39,0.000333,0.055223,5,828.345865,46.019215,165.669173,61.748606,1,0
0,0,3,3,8,8,16,15,11,26,0.000333,0.034667,4,416,23.111111,104,48,1,0
0,0,6,6,11,17,28,47,33,80,0.000333,0.128196,5,1922.941969,106.830109,384.588394,107.540616,3,0
0,0,5,5,10,17,27,42,31,73,0.000333,0.115702,5,1735.533938,96.418552,347.106788,102.706149,2,0
0,0,6,6,11,17,28,47,33,80,0.000333,0.128196,5,1922.941969,106.830109,384.588394,107.540616,3,0
0,0,6,6,11,17,28,47,33,80,0.000333,0.128196,5,1922.941969,106.830109,384.588394,107.540616,3,0
0,0,5,5,10,17,27,42,31,73,0.000333,0.115702,5,1735.533938,96.418552,347.106788,102.706149,2,0
0,0,6,6,11,17,28,47,33,80,0.000333,0.128196,5,1922.941969,106.830109,384.588394,107.540616,3,0
0,0,4,4,13,11,24,36,20,56,0.000333,0.085586,6,1540.5474,85.585967,256.7579,86.159464,2,0
0,0,4,4,9,8,17,30,18,48,0.000333,0.065399,8,1569.585731,87.199207,196.198216,52.529325,1,0
0,0,3,3,9,7,16,21,13,34,0.000333,0.045333,4,544,30.222222,136,48.180809,1,0
0,0,4,4,13,11,24,36,20,56,0.000333,0.085586,6,1540.5474,85.585967,256.7579,86.159464,2,0
0,0,4,4,8,8,16,19,13,32,0.000333,0.042667,4,512,28.444444,128,48,1,0
0,0,2,2,7,6,13,18,10,28,0.000333,0.034537,3,310.836936,17.268719,103.612312,35.161259,1,0
0,0,4,4,10,9,19,25,14,39,0.000333,0.055223,5,828.345865,46.019215,165.669173,61.748606,1,0
0,0,2,2,8,5,13,13,8,21,0.000333,0.025903,4,310.836936,17.268719,77.709234,35.60964,2,0
0,0,4,4,13,11,24,36,20,56,0.000333,0.085586,6,1540.5474,85.585967,256.7579,86.159464,2,0
0,0,7,7,12,19,31,51,37,88,0.000333,0.145323,6,2615.815652,145.323092,435.969275,123.730173,5,0
0,0,5,5,10,17,27,42,31,73,0.000333,0.115702,5,1735.533938,96.418552,347.106788,102.706149,2,0
0,0,7,7,12,19,31,51,37,88,0.000333,0.145323,6,2615.815652,145.323092,435.969275,123.730173,5,0
0,0,3,3,8,5,13,14,8,22,0.000333,0.027137,4,325.638695,18.091039,81.409674,35.60964,1,0
0,0,8,8,8,12,20,25,22,47,0.000333,0.06771,4,812.522482,45.140138,203.13062,67.01955,1,0
0,0,8,8,8,13,21,25,30,55,0.000333,0.080526,8,1932.619666,107.367759,241.577458,72.105716,1,0
0,0,4,4,8,7,15,23,13,36,0.000333,0.046883,4,562.592246,31.255125,140.648061,43.651484,2,0
0,0,9,9,11,15,26,41,33,74,0.000333,0.115944,10,3478.325391,193.2403,347.832539,96.657107,6,0
0,0,10,10,12,16,28,61,43,104,0.000333,0.166655,12,5999.578943,333.309941,499.964912,107.01955,7,0
0,0,3,3,7,9,16,20,14,34,0.000333,0.045333,3,408,22.666667,136,48.180809,1,0
0,0,2,2,8,6,14,17,9,26,0.000333,0.032997,4,395.964912,21.998051,98.991228,39.509775,1,0
0,0,2,2,6,7,13,9,8,17,0.000333,0.020969,3,188.722426,10.484579,62.907475,35.161259,2,0
0,0,3,3,7,7,14,17,10,27,0.000333,0.034266,3,308.395749,17.133097,102.798583,39.302969,1,0
0,0,8,8,11,14,25,35,29,64,0.000333,0.099069,10,2972.067961,165.114887,297.206796,91.356717,6,0
0,0,2,2,7,6,13,15,9,24,0.000333,0.029604,3,266.43166,14.801759,88.810553,35.161259,3,0
0,0,4,4,10,12,22,22,18,40,0.000333,0.059459,5,891.886324,49.54924,178.377265,76.238831,1,0
0,0,7,7,12,19,31,51,37,88,0.000333,0.145323,6,2615.815652,145.323092,435.969275,123.730173,5,0
0,0,5,5,10,17,27,42,31,73,0.000333,0.115702,5,1735.533938,96.418552,347.106788,102.706149,2,0
0,0,7,7,12,19,31,51,37,88,0.000333,0.145323,6,2615.815652,145.323092,435.969275,123.730173,5,0
0,0,7,7,12,19,31,51,37,88,0.000333,0.145323,6,2615.815652,145.323092,435.969275,123.730173,5,0
0,0,5,5,10,17,27,42,31,73,0.000333,0.115702,5,1735.533938,96.418552,347.106788,102.706149,2,0
0,0,7,7,12,19,31,51,37,88,0.000333,0.145323,6,2615.815652,145.323092,435.969275,123.730173,5,0
0,0,2,2,6,4,10,7,5,12,0.000333,0.013288,3,119.589411,6.643856,39.863137,23.509775,1,0
0,0,8,8,11,15,26,31,37,68,0.000333,0.106543,10,3196.299008,177.572167,319.629901,96.657107,1,0
0,0,8,8,11,14,25,30,34,64,0.000333,0.099069,10,2972.067961,165.114887,297.206796,91.356717,1,0
0,0,2,2,6,4,10,7,5,12,0.000333,0.013288,3,119.589411,6.643856,39.863137,23.509775,1,0
0,0,5,5,11,11,22,19,22,41,0.000333,0.060946,10,1828.366964,101.575942,182.836696,76.107496,1,0
0,0,7,7,12,19,31,51,37,88,0.000333,0.145323,6,2615.815652,145.323092,435.969275,123.730173,5,0
0,0,5,5,10,17,27,42,31,73,0.000333,0.115702,5,1735.533938,96.418552,347.106788,102.706149,2,0
0,0,7,7,12,19,31,51,37,88,0.000333,0.145323,6,2615.815652,145.323092,435.969275,123.730173,5,0
0,0,7,7,12,19,31,51,37,88,0.000333,0.145323,6,2615.815652,145.323092,435.969275,123.730173,5,0
0,0,5,5,10,17,27,42,31,73,0.000333,0.115702,5,1735.533938,96.418552,347.106788,102.706149,2,0
0,0,7,7,12,19,31,51,37,88,0.000333,0.145323,6,2615.815652,145.323092,435.969275,123.730173,5,0
0,0,9,9,11,12,23,67,44,111,0.000333,0.167372,15,7531.730657,418.429481,502.115377,81.073298,7,0
0,0,4,4,14,14,28,44,20,64,0.000333,0.102557,7,2153.695005,119.649723,307.670715,106.605938,1,0
0,0,3,3,8,7,15,11,10,21,0.000333,0.027348,4,328.17881,18.232156,82.044703,43.651484,1,0
0,0,10,10,11,12,23,73,49,122,0.000333,0.183958,20,11037.49117,613.193954,551.874559,81.073298,8,0
0,0,5,5,10,17,27,42,31,73,0.000333,0.115702,5,1735.533938,96.418552,347.106788,102.706149,2,0
0,0,7,7,12,19,31,51,37,88,0.000333,0.145323,6,2615.815652,145.323092,435.969275,123.730173,5,0
0,0,2,2,6,4,10,7,5,12,0.000333,0.013288,3,119.589411,6.643856,39.863137,23.509775,1,0
0,0,3,3,8,6,14,12,9,21,0.000333,0.026651,4,319.817813,17.767656,79.954453,39.509775,1,0
0,0,2,2,6,4,10,8,6,14,0.000333,0.015502,3,139.52098,7.751166,46.506993,23.509775,1,0
0,0,3,3,8,6,14,13,10,23,0.000333,0.02919,4,350.276653,19.459814,87.569163,39.509775,1,0
0,0,3,3,8,6,14,13,10,23,0.000333,0.02919,4,350.276653,19.459814,87.569163,39.509775,1,0
0,0,2,2,6,4,10,8,6,14,0.000333,0.015502,3,139.52098,7.751166,46.506993,23.509775,1,0
0,0,3,3,8,6,14,13,10,23,0.000333,0.02919,4,350.276653,19.459814,87.569163,39.509775,1,0
0,0,4,4,8,7,15,15,12,27,0.000333,0.035162,4,421.944184,23.441344,105.486046,43.651484,1,0
0,0,4,4,8,7,15,15,12,27,0.000333,0.035162,4,421.944184,23.441344,105.486046,43.651484,1,0
0,0,2,2,6,4,10,8,6,14,0.000333,0.015502,3,139.52098,7.751166,46.506993,23.509775,1,0
0,0,4,4,8,7,15,15,12,27,0.000333,0.035162,4,421.944184,23.441344,105.486046,43.651484,1,0
0,0,4,4,10,9,19,19,14,33,0.000333,0.046727,5,700.90804,38.939336,140.181608,61.748606,1,0
0,0,4,4,10,9,19,19,14,33,0.000333,0.046727,5,700.90804,38.939336,140.181608,61.748606,1,0
0,0,2,2,6,4,10,8,6,14,0.000333,0.015502,3,139.52098,7.751166,46.506993,23.509775,1,0
0,0,4,4,10,9,19,19,14,33,0.000333,0.046727,5,700.90804,38.939336,140.181608,61.748606,1,0
0,0,4,4,9,8,17,16,13,29,0.000333,0.039512,4,474.14569,26.341427,118.536422,52.529325,1,0
0,0,4,4,9,8,17,16,13,29,0.000333,0.039512,4,474.14569,26.341427,118.536422,52.529325,1,0
0,0,2,2,6,4,10,8,6,14,0.000333,0.015502,3,139.52098,7.751166,46.506993,23.509775,1,0
0,0,4,4,9,8,17,16,13,29,0.000333,0.039512,4,474.14569,26.341427,118.536422,52.529325,1,0
0,0,5,5,9,9,18,19,16,35,0.000333,0.048649,4,583.7895,32.43275,145.947375,57.05865,1,0
0,0,5,5,9,9,18,19,16,35,0.000333,0.048649,4,583.7895,32.43275,145.947375,57.05865,1,0
0,0,5,5,9,9,18,19,16,35,0.000333,0.048649,4,583.7895,32.43275,145.947375,57.05865,1,0
0,0,2,2,6,4,10,8,6,14,0.000333,0.015502,3,139.52098,7.751166,46.506993,23.509775,1,0
0,0,3,3,8,8,16,15,11,26,0.000333,0.034667,4,416,23.111111,104,48,1,0
0,0,3,3,8,8,16,15,11,26,0.000333,0.034667,4,416,23.111111,104,48,1,0
0,0,2,2,6,4,10,8,6,14,0.000333,0.015502,3,139.52098,7.751166,46.506993,23.509775,1,0
0,0,3,3,8,8,16,15,11,26,0.000333,0.034667,4,416,23.111111,104,48,1,0
0,0,5,5,9,7,16,20,11,31,0.000333,0.041333,4,496,27.555556,124,48.180809,3,0
0,0,4,4,7,6,13,16,9,25,0.000333,0.030837,3,277.532979,15.418499,92.510993,35.161259,3,0
0,0,2,2,4,4,8,8,5,13,0.000333,0.013,2,78,4.333333,39,16,1,0
0,0,4,4,8,8,16,17,12,29,0.000333,0.038667,4,464,25.777778,116,48,1,0
0,0,16,16,20,21,41,68,55,123,0.000333,0.21966,20,13179.57793,732.198774,658.978897,178.677228,4,0
0,0,11,11,17,17,34,61,43,104,0.000333,0.176365,16,8465.538168,470.307676,529.096135,138.973737,4,0
0,0,12,12,18,16,34,64,45,109,0.000333,0.184844,18,9981.602095,554.53345,554.53345,139.05865,4,0
0,0,12,12,17,18,35,68,47,115,0.000333,0.196623,16,9437.880751,524.326708,589.867547,144.545518,4,0
0,0,13,13,17,22,39,61,53,114,0.000333,0.200845,16,9640.573647,535.587425,602.535853,167.594364,4,0
0,0,11,11,16,20,36,60,49,109,0.000333,0.187841,16,9016.349203,500.908289,563.521825,150.438562,4,0
0,0,13,13,16,21,37,65,63,128,0.000333,0.22227,24,16003.44074,889.080041,666.810031,156.238666,4,0
0,0,15,15,16,22,38,70,77,147,0.000333,0.257148,24,18514.68827,1028.593793,771.445344,162.107496,4,0
0,0,17,17,16,23,39,75,91,166,0.000333,0.292459,24,21057.04244,1169.835691,877.376768,168.041925,4,0
0,0,12,12,17,19,36,63,51,114,0.000333,0.196457,16,9429.943203,523.885733,589.37145,150.197491,4,0
0,0,12,12,17,21,38,65,52,117,0.000333,0.204669,16,9824.120305,545.784461,614.007519,161.725534,4,0
0,0,13,13,17,22,39,73,56,129,0.000333,0.227272,16,10909.07018,606.059454,681.816886,167.594364,4,0
0,0,12,12,16,21,37,67,53,120,0.000333,0.208378,16,10002.15046,555.675026,625.134404,156.238666,4,0
0,0,14,14,16,23,39,73,59,132,0.000333,0.232558,16,11162.76949,620.15386,697.673093,168.041925,4,0
0,0,18,18,20,24,44,73,76,149,0.000333,0.271152,30,24403.65934,1355.758852,813.455311,196.477662,4,0
0,0,13,13,16,22,38,60,59,119,0.000333,0.208168,16,9992.053986,555.11411,624.503374,162.107496,4,0
0,0,10,10,17,15,32,56,36,92,0.000333,0.153333,16,7360,408.888889,460,128.090227,5,0
0,0,13,13,20,15,35,64,36,100,0.000333,0.170976,20,10258.56603,569.920335,512.928302,145.041921,7,0
0,0,11,11,17,15,32,61,36,97,0.000333,0.161667,16,7760,431.111111,485,128.090227,7,0
0,0,12,12,20,16,36,65,38,103,0.000333,0.177501,20,10650.0455,591.669195,532.502275,150.438562,7,0
0,0,11,11,17,16,33,61,38,99,0.000333,0.166465,16,7990.320285,443.906683,499.395018,133.486868,7,0
0,0,14,14,22,17,39,72,42,114,0.000333,0.200845,22,13255.78877,736.432709,602.535853,167.594364,7,0
0,0,13,13,19,17,36,69,42,111,0.000333,0.191287,18,10329.51015,573.861675,573.861675,150.197491,7,0
0,0,14,14,21,17,38,70,42,112,0.000333,0.195923,20,11755.35763,653.075424,587.767882,161.725534,7,0
0,0,13,13,18,17,35,67,42,109,0.000333,0.186364,18,10063.65328,559.091849,559.091849,144.545518,7,0
0,0,13,13,22,17,39,69,41,110,0.000333,0.193798,22,12790.67337,710.592965,581.394244,167.594364,7,0
0,0,12,12,19,17,36,65,41,106,0.000333,0.182671,18,9864.216903,548.01205,548.01205,150.197491,7,0
0,0,13,13,21,17,38,68,41,109,0.000333,0.190675,20,11440.48198,635.582332,572.024099,161.725534,7,0
0,0,12,12,18,17,35,64,41,105,0.000333,0.179525,18,9694.344902,538.574717,538.574717,144.545518,7,0
0,0,17,17,22,17,39,71,42,113,0.000333,0.199083,22,13139.50992,729.972773,597.250451,167.594364,7,0
0,0,16,16,20,17,37,68,42,110,0.000333,0.191013,20,11460.7974,636.710967,573.03987,155.92543,7,0
0,0,14,14,21,17,38,70,42,112,0.000333,0.195923,20,11755.35763,653.075424,587.767882,161.725534,7,0
0,0,13,13,18,17,35,67,42,109,0.000333,0.186364,18,10063.65328,559.091849,559.091849,144.545518,7,0
0,0,14,14,20,17,37,68,42,110,0.000333,0.191013,20,11460.7974,636.710967,573.03987,155.92543,7,0
0,0,13,13,17,17,34,65,42,107,0.000333,0.181453,16,8709.736384,483.874244,544.358524,138.973737,7,0
0,0,16,16,21,17,38,68,42,110,0.000333,0.192424,20,11545.44053,641.413363,577.272026,161.725534,7,0
0,0,15,15,18,17,35,65,42,107,0.000333,0.182944,18,9878.999091,548.833283,548.833283,144.545518,7,0
0,0,13,13,21,17,38,68,41,109,0.000333,0.190675,20,11440.48198,635.582332,572.024099,161.725534,7,0
0,0,12,12,18,17,35,64,41,105,0.000333,0.179525,18,9694.344902,538.574717,538.574717,144.545518,7,0
0,0,13,13,20,17,37,67,41,108,0.000333,0.18754,20,11252.41927,625.134404,562.620963,155.92543,7,0
0,0,12,12,17,17,34,63,41,104,0.000333,0.176365,16,8465.538168,470.307676,529.096135,138.973737,7,0
0,0,18,18,22,18,40,75,38,113,0.000333,0.200459,22,13230.31324,735.017402,601.377875,173.166146,7,0
0,0,16,16,22,17,39,71,38,109,0.000333,0.192036,22,12674.39452,704.133029,576.108842,167.594364,7,0
0,0,13,13,19,15,34,65,36,101,0.000333,0.171278,18,9249.007445,513.833747,513.833747,139.313982,7,0
0,0,11,11,17,16,33,71,44,115,0.000333,0.193368,16,9281.68518,515.649177,580.105324,133.486868,7,0
0,0,13,13,19,17,36,61,38,99,0.000333,0.170608,18,9212.806353,511.822575,511.822575,150.197491,5,0
0,0,14,14,21,20,41,69,51,120,0.000333,0.214302,20,12858.12481,714.340267,642.906241,178.677228,6,0
0,0,13,13,18,20,38,66,51,117,0.000333,0.204669,18,11052.13534,614.007519,614.007519,161.497212,6,0
0,0,14,14,20,23,43,68,63,131,0.000333,0.236947,20,14216.81366,789.822981,710.840683,190.480487,6,0
0,0,13,13,17,23,40,65,63,128,0.000333,0.227069,16,10899.30874,605.517152,681.206796,173.528793,6,0
0,0,11,11,17,16,33,59,40,99,0.000333,0.166465,16,7990.320285,443.906683,499.395018,133.486868,5,0
0,0,14,14,18,17,35,72,48,120,0.000333,0.205171,18,11079.25132,615.513962,615.513962,144.545518,5,0
0,0,16,16,21,22,43,68,54,122,0.000333,0.220668,20,13240.086,735.560333,662.0043,190.346161,5,0
0,0,11,11,18,18,36,61,42,103,0.000333,0.177501,18,9585.040953,532.502275,532.502275,150.1173,5,0
0,0,12,12,19,17,36,64,44,108,0.000333,0.186117,18,10050.3342,558.3519,558.3519,150.197491,5,0
0,0,12,12,18,19,37,68,46,114,0.000333,0.197959,18,10689.79831,593.877684,593.877684,155.769273,5,0
0,0,13,13,18,23,41,61,52,113,0.000333,0.201801,18,10897.26078,605.403377,605.403377,179.100575,5,0
0,0,11,11,17,21,38,60,48,108,0.000333,0.188925,16,9068.418743,503.801041,566.776171,161.725534,5,0
0,0,13,13,17,22,39,65,62,127,0.000333,0.223749,16,10739.93731,596.663184,671.246082,167.594364,5,0
0,0,15,15,17,23,40,70,76,146,0.000333,0.259001,24,18648.03604,1036.002002,777.001502,173.528793,5,0
0,0,12,12,18,20,38,63,50,113,0.000333,0.197672,18,10674.28456,593.015809,593.015809,161.497212,5,0
0,0,12,12,18,22,40,65,51,116,0.000333,0.205781,18,11112.18586,617.343659,617.343659,173.166146,5,0
0,0,13,13,18,23,41,73,55,128,0.000333,0.228589,18,12343.79982,685.766657,685.766657,179.100575,5,0
0,0,12,12,17,22,39,67,52,119,0.000333,0.209654,16,10063.40583,559.078101,628.962864,167.594364,5,0
0,0,14,14,17,24,41,73,58,131,0.000333,0.233946,16,11229.429,623.857167,701.839313,179.525968,5,0
0,0,17,17,21,25,46,72,73,145,0.000333,0.266972,20,16018.32967,889.907204,800.916484,208.335071,5,0
0,0,13,13,17,23,40,60,58,118,0.000333,0.209329,16,10047.80024,558.211125,627.987515,173.528793,5,0
0,0,12,12,21,24,45,67,56,123,0.000333,0.225166,20,13509.95862,750.553256,675.497931,202.277766,5,0
0,0,13,13,21,24,45,68,56,124,0.000333,0.226997,20,13619.79568,756.655315,680.989784,202.277766,5,0
0,0,9,9,16,14,30,55,35,90,0.000333,0.147207,16,7065.922458,392.551248,441.620154,117.302969,4,0
0,0,12,12,19,14,33,64,37,101,0.000333,0.169828,18,9170.708509,509.483806,509.483806,134.013592,6,0
0,0,11,11,16,14,30,61,37,98,0.000333,0.160292,16,7694.004454,427.444692,480.875278,117.302969,6,0
0,0,14,14,22,16,38,72,43,115,0.000333,0.201171,22,13277.25661,737.625367,603.511664,162.107496,8,0
0,0,11,11,16,15,31,61,39,100,0.000333,0.16514,16,7926.714097,440.373005,495.419631,122.603359,6,0
0,0,16,16,23,17,40,78,47,125,0.000333,0.221747,22,14635.30226,813.072348,665.241012,173.528793,8,0
0,0,15,15,20,17,37,75,47,122,0.000333,0.211851,20,12711.06621,706.170345,635.553311,155.92543,8,0
0,0,16,16,22,17,39,76,47,123,0.000333,0.216701,22,14302.2984,794.572134,650.104473,167.594364,8,0
0,0,15,15,19,17,36,73,47,120,0.000333,0.206797,18,11167.038,620.391,620.391,150.197491,8,0
0,0,15,15,24,17,41,75,46,121,0.000333,0.216088,24,15558.33102,864.351723,648.263793,179.525968,8,0
0,0,14,14,20,17,37,71,46,117,0.000333,0.203169,20,12190.12088,677.228938,609.506044,155.92543,8,0
0,0,15,15,23,17,40,74,46,120,0.000333,0.212877,22,14049.89017,780.549454,638.631371,173.528793,8,0
0,0,14,14,19,17,36,70,46,116,0.000333,0.199904,18,10794.8034,599.7113,599.7113,150.197491,8,0
0,0,18,18,23,17,40,76,47,123,0.000333,0.218199,22,14401.13743,800.06319,654.597156,173.528793,8,0
0,0,17,17,20,17,37,73,47,120,0.000333,0.208378,20,12502.68808,694.593782,625.134404,155.92543,8,0
0,0,16,16,22,17,39,76,47,123,0.000333,0.216701,22,14302.2984,794.572134,650.104473,167.594364,8,0
0,0,15,15,19,17,36,73,47,120,0.000333,0.206797,18,11167.038,620.391,620.391,150.197491,8,0
0,0,16,16,21,17,38,74,47,121,0.000333,0.211666,20,12699.98458,705.554699,634.999229,161.725534,8,0
0,0,15,15,18,17,35,71,47,118,0.000333,0.201752,18,10894.59713,605.255396,605.255396,144.545518,8,0
0,0,19,19,22,17,39,75,47,122,0.000333,0.21494,22,14186.01956,788.112198,644.819071,167.594364,8,0
0,0,18,18,20,17,37,72,47,119,0.000333,0.206642,20,12398.49901,688.805501,619.924951,155.92543,8,0
0,0,15,15,23,17,40,74,46,120,0.000333,0.212877,22,14049.89017,780.549454,638.631371,173.528793,8,0
0,0,14,14,19,17,36,70,46,116,0.000333,0.199904,18,10794.8034,599.7113,599.7113,150.197491,8,0
0,0,15,15,22,17,39,73,46,119,0.000333,0.209654,22,13837.18301,768.732389,628.962864,167.594364,8,0
0,0,14,14,18,17,35,69,46,115,0.000333,0.196623,18,10617.61585,589.867547,589.867547,144.545518,8,0
0,0,20,20,22,18,40,81,43,124,0.000333,0.219973,22,14518.21984,806.567769,659.919084,173.166146,8,0
0,0,18,18,22,17,39,77,43,120,0.000333,0.211416,22,13953.46186,775.192325,634.248266,167.594364,8,0
0,0,15,15,19,15,34,71,41,112,0.000333,0.189932,18,10256.32509,569.795838,569.795838,139.313982,8,0
0,0,13,13,18,16,34,77,49,126,0.000333,0.213673,27,17307.54859,961.530477,641.020318,139.05865,8,0
0,0,15,15,20,17,37,67,43,110,0.000333,0.191013,20,11460.7974,636.710967,573.03987,155.92543,6,0
0,0,16,16,22,20,42,75,56,131,0.000333,0.235465,22,15540.65881,863.369934,706.393582,184.546058,7,0
0,0,15,15,19,20,39,72,56,128,0.000333,0.22551,18,12177.56671,676.531484,676.531484,167.149185,7,0
0,0,16,16,21,23,44,74,68,142,0.000333,0.258413,20,15504.7858,861.376989,775.23929,196.280591,7,0
0,0,15,15,18,23,41,71,68,139,0.000333,0.248233,18,13404.59512,744.699729,744.699729,179.100575,7,0
0,0,13,13,18,16,34,65,45,110,0.000333,0.18654,18,10073.17643,559.620913,559.620913,139.05865,6,0
0,0,16,16,19,17,36,78,53,131,0.000333,0.225753,27,18286.02473,1015.890263,677.260175,150.197491,6,0
0,0,19,19,22,22,44,75,61,136,0.000333,0.247494,22,16334.6194,907.478856,742.4827,196.214991,6,0
0,0,14,14,19,18,37,68,49,117,0.000333,0.203169,18,10971.10879,609.506044,609.506044,155.769273,6,0
0,0,15,15,20,17,37,71,51,122,0.000333,0.211851,30,19066.59932,1059.255518,635.553311,155.92543,6,0
0,0,15,15,19,19,38,75,53,128,0.000333,0.223912,18,12091.22499,671.734722,671.734722,161.421246,6,0
0,0,16,16,19,23,42,68,59,127,0.000333,0.228275,18,12326.83763,684.824313,684.824313,184.752548,6,0
0,0,14,14,18,21,39,67,55,122,0.000333,0.21494,18,11606.74327,644.819071,644.819071,167.297316,6,0
0,0,16,16,18,22,40,72,69,141,0.000333,0.250131,27,20260.58026,1125.587792,750.391861,173.166146,6,0
0,0,18,18,18,23,41,77,83,160,0.000333,0.285736,27,23144.62466,1285.812481,857.208321,179.100575,6,0
0,0,20,20,18,24,42,82,97,179,0.000333,0.321742,36,34748.09347,1930.449637,965.224819,185.09775,6,0
0,0,15,15,19,20,39,70,57,127,0.000333,0.223749,18,12082.42947,671.246082,671.246082,167.149185,6,0
0,0,15,15,19,22,41,72,58,130,0.000333,0.232161,18,12536.67169,696.481761,696.481761,178.818118,6,0
0,0,16,16,19,23,42,80,62,142,0.000333,0.255236,18,13782.76333,765.709074,765.709074,184.752548,6,0
0,0,15,15,18,22,40,74,59,133,0.000333,0.235939,18,12740.69586,707.816437,707.816437,173.166146,6,0
0,0,17,17,18,24,42,80,65,145,0.000333,0.260629,18,14073.94847,781.886026,781.886026,185.09775,6,0
0,0,20,20,22,25,47,79,80,159,0.000333,0.294393,33,29144.92771,1619.16265,883.179627,214.2039,6,0
0,0,16,16,18,25,43,67,66,133,0.000333,0.240564,18,12990.47782,721.693212,721.693212,191.155055,6,0
0,0,4,4,10,9,19,23,16,39,0.000333,0.055223,5,828.345865,46.019215,165.669173,61.748606,1,0
0,0,8,8,14,11,25,33,21,54,0.000333,0.083589,7,1755.37764,97.52098,250.768234,91.356717,2,0
0,0,7,7,11,10,21,30,21,51,0.000333,0.074669,10,2240.081886,124.448994,224.008189,71.273029,2,0
0,0,8,8,15,11,26,34,22,56,0.000333,0.087742,14,3685.144739,204.730263,263.224624,96.657107,2,0
0,0,7,7,11,11,22,30,22,52,0.000333,0.077297,10,2318.904442,128.828025,231.890444,76.107496,2,0
0,0,10,10,16,14,30,41,27,68,0.000333,0.111223,8,2669.348484,148.297138,333.668561,117.302969,2,0
0,0,9,9,13,14,27,38,27,65,0.000333,0.103023,6,1854.406126,103.022563,309.067688,101.408685,2,0
0,0,10,10,15,14,29,39,27,66,0.000333,0.106876,7,2244.38722,124.688179,320.626746,111.906328,2,0
0,0,9,9,12,14,26,36,27,63,0.000333,0.098709,6,1776.766213,98.709234,296.127702,96.322519,2,0
0,0,9,9,17,13,30,38,25,63,0.000333,0.103045,8,2473.07286,137.392937,309.134108,117.592585,2,0
0,0,8,8,13,13,26,34,25,59,0.000333,0.092442,6,1663.95566,92.441981,277.325943,96.211433,2,0
0,0,9,9,16,13,29,37,25,62,0.000333,0.100398,8,2409.558574,133.864365,301.194822,112.105716,2,0
0,0,8,8,12,13,25,33,25,58,0.000333,0.089781,6,1616.061954,89.78122,269.343659,91.125266,2,0
0,0,12,12,16,14,30,39,27,66,0.000333,0.107952,8,2590.838234,143.935457,323.854779,117.302969,2,0
0,0,11,11,13,14,27,36,27,63,0.000333,0.099853,6,1797.347476,99.852638,299.557913,101.408685,2,0
0,0,10,10,15,14,29,39,27,66,0.000333,0.106876,7,2244.38722,124.688179,320.626746,111.906328,2,0
0,0,9,9,12,14,26,36,27,63,0.000333,0.098709,6,1776.766213,98.709234,296.127702,96.322519,2,0
0,0,10,10,14,14,28,37,27,64,0.000333,0.102557,7,2153.695005,119.649723,307.670715,106.605938,2,0
0,0,9,9,11,14,25,34,27,61,0.000333,0.094425,5,1416.376138,78.687563,283.275228,91.356717,2,0
0,0,12,12,15,14,29,37,27,64,0.000333,0.103637,7,2176.375486,120.909749,310.910784,111.906328,2,0
0,0,11,11,12,14,26,34,27,61,0.000333,0.095576,6,1720.360937,95.575608,286.726823,96.322519,2,0
0,0,9,9,16,13,29,37,25,62,0.000333,0.100398,8,2409.558574,133.864365,301.194822,112.105716,2,0
0,0,8,8,12,13,25,33,25,58,0.000333,0.089781,6,1616.061954,89.78122,269.343659,91.125266,2,0
0,0,9,9,15,13,28,36,25,61,0.000333,0.09775,7,2052.740552,114.041142,293.24865,106.709075,2,0
0,0,8,8,11,13,24,32,25,57,0.000333,0.087114,5,1306.714313,72.59524,261.342863,86.159464,2,0
0,0,11,11,15,12,27,38,22,60,0.000333,0.095098,7,1997.052751,110.947375,285.29325,101.622909,2,0
0,0,11,11,15,11,26,38,22,60,0.000333,0.094009,14,3948.369363,219.353854,282.026383,96.657107,2,0
0,0,8,8,12,10,22,32,21,53,0.000333,0.078783,12,2836.198509,157.566584,236.349876,76.238831,2,0
0,0,7,7,13,12,25,35,25,60,0.000333,0.092877,12,3343.576457,185.754248,278.631371,91.125266,2,0
0,0,8,8,12,10,22,30,22,52,0.000333,0.077297,12,2782.68533,154.593629,231.890444,76.238831,1,0
0,0,12,12,16,15,31,46,39,85,0.000333,0.140369,16,6737.706982,374.317055,421.106686,122.603359,2,0
0,0,11,11,13,14,27,43,39,82,0.000333,0.129967,12,4678.809302,259.93385,389.900775,101.408685,2,0
0,0,12,12,15,18,33,45,51,96,0.000333,0.161421,14,6779.665696,376.648094,484.261835,133.662009,2,0
0,0,11,11,12,17,29,42,51,93,0.000333,0.150597,18,8132.260186,451.792233,451.792233,112.506418,2,0
0,0,8,8,10,11,21,33,26,59,0.000333,0.086382,10,2591.467279,143.970404,259.146728,71.273029,1,0
0,0,11,11,11,12,23,48,34,82,0.000333,0.123644,10,3709.320804,206.073378,370.93208,81.073298,1,0
0,0,13,13,14,17,31,43,40,83,0.000333,0.137066,14,5756.776113,319.820895,411.198294,122.789837,1,0
0,0,8,8,10,16,26,33,34,67,0.000333,0.104976,10,3149.294611,174.960812,314.929461,97.219281,1,0
0,0,9,9,12,12,24,38,30,68,0.000333,0.103926,12,3741.329401,207.851633,311.77745,86.0391,1,0
0,0,9,9,11,14,25,42,32,74,0.000333,0.114548,10,3436.45358,190.914088,343.645358,91.356717,1,0
0,0,10,10,11,18,29,34,38,72,0.000333,0.116592,10,3497.746316,194.31924,349.774632,113.112398,1,0
0,0,7,7,10,16,26,31,32,63,0.000333,0.098709,10,2961.277022,164.51539,296.127702,97.219281,1,0
0,0,10,10,10,17,27,39,48,87,0.000333,0.137892,10,4136.752127,229.819563,413.675213,102.706149,1,0
0,0,12,12,10,18,28,45,62,107,0.000333,0.171462,15,7715.80465,428.655814,514.386977,108.277931,1,0
0,0,14,14,10,19,29,51,76,127,0.000333,0.205655,20,12339.27173,685.515096,616.963586,113.929904,1,0
0,0,9,9,11,15,26,37,36,73,0.000333,0.114377,10,3431.320994,190.628944,343.132099,96.657107,1,0
0,0,9,9,11,17,28,39,37,76,0.000333,0.121786,10,3653.589741,202.977208,365.358974,107.540616,1,0
0,0,10,10,11,18,29,48,41,89,0.000333,0.14412,10,4323.603086,240.200171,432.360309,113.112398,1,0
0,0,9,9,10,17,27,41,38,79,0.000333,0.125212,10,3756.361127,208.686729,375.636113,102.706149,1,0
0,0,11,11,10,19,29,48,44,92,0.000333,0.148978,10,4469.342516,248.296806,446.934252,113.929904,1,0
0,0,14,14,14,20,34,46,59,105,0.000333,0.178061,14,7478.570377,415.476132,534.183598,139.741531,1,0
0,0,10,10,10,18,28,33,44,77,0.000333,0.123389,10,3701.66329,205.647961,370.166329,108.277931,1,0
0,0,6,6,10,11,21,37,24,61,0.000333,0.08931,10,2679.313628,148.850757,267.931363,71.273029,1,0
0,0,8,8,14,12,26,43,25,68,0.000333,0.106543,14,4474.818612,248.601034,319.629901,96.322519,2,0
0,0,7,7,11,11,22,40,25,65,0.000333,0.096621,10,2898.630552,161.035031,289.863055,76.107496,2,0
0,0,8,8,15,12,27,44,26,70,0.000333,0.110947,14,4659.789752,258.877208,332.842125,101.622909,2,0
0,0,7,7,11,12,23,40,26,66,0.000333,0.099518,10,2985.550891,165.863938,298.555089,81.073298,2,0
0,0,10,10,16,15,31,51,31,82,0.000333,0.135415,16,6499.905559,361.105864,406.244097,122.603359,2,0
0,0,9,9,13,15,28,48,31,79,0.000333,0.126594,12,4557.372466,253.187359,379.781039,106.709075,2,0
0,0,10,10,15,15,30,49,31,80,0.000333,0.13085,14,5495.717467,305.317637,392.551248,117.206718,2,0
0,0,9,9,12,15,27,46,31,77,0.000333,0.122042,12,4393.516052,244.084225,366.126338,101.622909,2,0
0,0,9,9,17,14,31,48,29,77,0.000333,0.127158,16,6103.569854,339.087214,381.473116,122.789837,2,0
0,0,8,8,13,14,27,44,29,73,0.000333,0.115702,12,4165.281452,231.404525,347.106788,101.408685,2,0
0,0,9,9,16,14,30,47,29,76,0.000333,0.124308,16,5966.778964,331.48772,372.923685,117.302969,2,0
0,0,8,8,12,14,26,43,29,72,0.000333,0.112811,12,4061.179916,225.621106,338.43166,96.322519,2,0
0,0,12,12,16,15,31,49,31,80,0.000333,0.132112,16,6341.371277,352.298404,396.335705,122.603359,2,0
0,0,11,11,13,15,28,46,31,77,0.000333,0.123389,12,4441.995948,246.777553,370.166329,106.709075,2,0
0,0,10,10,15,15,30,49,31,80,0.000333,0.13085,14,5495.717467,305.317637,392.551248,117.206718,2,0
0,0,9,9,12,15,27,46,31,77,0.000333,0.122042,12,4393.516052,244.084225,366.126338,101.622909,2,0
0,0,10,10,14,15,29,47,31,78,0.000333,0.126308,14,5304.915247,294.717514,378.922518,111.906328,2,0
0,0,9,9,11,15,26,44,31,75,0.000333,0.117511,10,3525.329789,195.851655,352.532979,96.657107,2,0
0,0,12,12,15,15,30,47,31,78,0.000333,0.127579,14,5358.32453,297.684696,382.737466,117.206718,2,0
0,0,11,11,12,15,27,44,31,75,0.000333,0.118872,12,4279.398752,237.744375,356.616563,101.622909,2,0
0,0,9,9,16,14,30,47,29,76,0.000333,0.124308,16,5966.778964,331.48772,372.923685,117.302969,2,0
0,0,8,8,12,14,26,43,29,72,0.000333,0.112811,12,4061.179916,225.621106,338.43166,96.322519,2,0
0,0,9,9,15,14,29,46,29,75,0.000333,0.12145,14,5100.880045,283.382225,364.348575,111.906328,2,0
0,0,8,8,11,14,25,42,29,71,0.000333,0.109905,10,3297.137895,183.174327,329.713789,91.356717,2,0
0,0,11,11,15,13,28,48,26,74,0.000333,0.118581,14,4980.419699,276.689983,355.744264,106.709075,2,0
0,0,11,11,15,12,27,48,26,74,0.000333,0.117287,14,4926.063452,273.670192,351.861675,101.622909,2,0
0,0,8,8,12,11,23,42,25,67,0.000333,0.101026,12,3636.943813,202.052434,303.078651,81.073298,2,0
0,0,7,7,13,13,26,45,29,74,0.000333,0.115944,12,4173.99047,231.888359,347.832539,96.211433,2,0
0,0,8,8,12,11,23,40,26,66,0.000333,0.099518,12,3582.661069,199.036726,298.555089,81.073298,1,0
0,0,12,12,16,16,32,56,43,99,0.000333,0.165,16,7920,440,495,128,2,0
0,0,11,11,13,15,28,53,43,96,0.000333,0.153835,12,5538.07287,307.670715,461.506073,106.709075,2,0
0,0,12,12,15,19,34,55,55,110,0.000333,0.18654,14,7834.692776,435.26071,559.620913,139.313982,2,0
0,0,11,11,12,18,30,52,55,107,0.000333,0.175012,18,9450.671287,525.037294,525.037294,118.0782,2,0
0,0,8,8,10,12,22,43,30,73,0.000333,0.108513,10,3255.385082,180.854727,325.538508,76.238831,1,0
0,0,11,11,11,13,24,58,38,96,0.000333,0.146719,10,4401.564001,244.531333,440.1564,86.159464,1,0
0,0,13,13,14,18,32,53,44,97,0.000333,0.161667,14,6790,377.222222,485,128.361619,1,0
0,0,8,8,10,17,27,43,38,81,0.000333,0.128382,10,3851.458877,213.969938,385.145888,102.706149,1,0
0,0,9,9,12,13,25,48,34,82,0.000333,0.126932,12,4569.554491,253.864138,380.796208,91.125266,1,0
0,0,9,9,11,15,26,52,36,88,0.000333,0.13788,10,4136.386952,229.799275,413.638695,96.657107,1,0
0,0,10,10,11,19,30,44,42,86,0.000333,0.140664,10,4219.925912,234.440328,421.992591,118.764371,1,0
0,0,8,8,10,17,27,43,38,81,0.000333,0.128382,10,3851.458877,213.969938,385.145888,102.706149,1,0
0,0,10,10,10,18,28,49,52,101,0.000333,0.161848,10,4855.428471,269.746026,485.542847,108.277931,1,0
0,0,12,12,10,19,29,55,66,121,0.000333,0.195939,15,8817.235506,489.846417,587.8157,113.929904,1,0
0,0,14,14,10,20,30,61,80,141,0.000333,0.230624,20,13837.43148,768.746193,691.871574,119.657843,1,0
0,0,9,9,11,16,27,47,40,87,0.000333,0.137892,10,4136.752127,229.819563,413.675213,102.053748,1,0
0,0,9,9,11,18,29,49,41,90,0.000333,0.145739,10,4372.182896,242.89905,437.21829,113.112398,1,0
0,0,10,10,11,19,30,58,45,103,0.000333,0.16847,10,5054.097313,280.783184,505.409731,118.764371,1,0
0,0,9,9,10,18,28,51,42,93,0.000333,0.149028,10,4470.840078,248.380004,447.084008,108.277931,1,0
0,0,11,11,10,20,30,58,48,106,0.000333,0.173377,10,5201.304031,288.961335,520.130403,119.657843,1,0
0,0,14,14,14,21,35,56,63,119,0.000333,0.203462,21,12818.07826,712.115459,610.384679,145.541635,1,0
0,0,10,10,10,19,29,43,48,91,0.000333,0.147359,10,4420.762706,245.597928,442.076271,113.929904,1,0
0,0,6,6,10,11,21,37,24,61,0.000333,0.08931,10,2679.313628,148.850757,267.931363,71.273029,1,0
0,0,8,8,14,12,26,43,25,68,0.000333,0.106543,14,4474.818612,248.601034,319.629901,96.322519,2,0
0,0,7,7,11,11,22,40,25,65,0.000333,0.096621,10,2898.630552,161.035031,289.863055,76.107496,2,0
0,0,8,8,15,12,27,44,26,70,0.000333,0.110947,14,4659.789752,258.877208,332.842125,101.622909,2,0
0,0,7,7,11,12,23,40,26,66,0.000333,0.099518,10,2985.550891,165.863938,298.555089,81.073298,2,0
0,0,10,10,16,15,31,51,31,82,0.000333,0.135415,16,6499.905559,361.105864,406.244097,122.603359,2,0
0,0,9,9,13,15,28,48,31,79,0.000333,0.126594,12,4557.372466,253.187359,379.781039,106.709075,2,0
0,0,10,10,15,15,30,49,31,80,0.000333,0.13085,14,5495.717467,305.317637,392.551248,117.206718,2,0
0,0,9,9,12,15,27,46,31,77,0.000333,0.122042,12,4393.516052,244.084225,366.126338,101.622909,2,0
0,0,9,9,17,14,31,48,29,77,0.000333,0.127158,16,6103.569854,339.087214,381.473116,122.789837,2,0
0,0,8,8,13,14,27,44,29,73,0.000333,0.115702,12,4165.281452,231.404525,347.106788,101.408685,2,0
0,0,9,9,16,14,30,47,29,76,0.000333,0.124308,16,5966.778964,331.48772,372.923685,117.302969,2,0
0,0,8,8,12,14,26,43,29,72,0.000333,0.112811,12,4061.179916,225.621106,338.43166,96.322519,2,0
0,0,12,12,16,15,31,49,31,80,0.000333,0.132112,16,6341.371277,352.298404,396.335705,122.603359,2,0
0,0,11,11,13,15,28,46,31,77,0.000333,0.123389,12,4441.995948,246.777553,370.166329,106.709075,2,0
0,0,10,10,15,15,30,49,31,80,0.000333,0.13085,14,5495.717467,305.317637,392.551248,117.206718,2,0
0,0,9,9,12,15,27,46,31,77,0.000333,0.122042,12,4393.516052,244.084225,366.126338,101.622909,2,0
0,0,10,10,14,15,29,47,31,78,0.000333,0.126308,14,5304.915247,294.717514,378.922518,111.906328,2,0
0,0,9,9,11,15,26,44,31,75,0.000333,0.117511,10,3525.329789,195.851655,352.532979,96.657107,2,0
0,0,12,12,15,15,30,47,31,78,0.000333,0.127579,14,5358.32453,297.684696,382.737466,117.206718,2,0
0,0,11,11,12,15,27,44,31,75,0.000333,0.118872,12,4279.398752,237.744375,356.616563,101.622909,2,0
0,0,9,9,16,14,30,47,29,76,0.000333,0.124308,16,5966.778964,331.48772,372.923685,117.302969,2,0
0,0,8,8,12,14,26,43,29,72,0.000333,0.112811,12,4061.179916,225.621106,338.43166,96.322519,2,0
0,0,9,9,15,14,29,46,29,75,0.000333,0.12145,14,5100.880045,283.382225,364.348575,111.906328,2,0
0,0,8,8,11,14,25,42,29,71,0.000333,0.109905,10,3297.137895,183.174327,329.713789,91.356717,2,0
0,0,11,11,15,13,28,48,26,74,0.000333,0.118581,14,4980.419699,276.689983,355.744264,106.709075,2,0
0,0,11,11,15,12,27,48,26,74,0.000333,0.117287,14,4926.063452,273.670192,351.861675,101.622909,2,0
0,0,8,8,12,11,23,42,25,67,0.000333,0.101026,12,3636.943813,202.052434,303.078651,81.073298,2,0
0,0,7,7,13,13,26,45,29,74,0.000333,0.115944,12,4173.99047,231.888359,347.832539,96.211433,2,0
0,0,8,8,12,11,23,40,26,66,0.000333,0.099518,12,3582.661069,199.036726,298.555089,81.073298,1,0
0,0,12,12,16,16,32,56,43,99,0.000333,0.165,16,7920,440,495,128,2,0
0,0,11,11,13,15,28,53,43,96,0.000333,0.153835,12,5538.07287,307.670715,461.506073,106.709075,2,0
0,0,12,12,15,19,34,55,55,110,0.000333,0.18654,14,7834.692776,435.26071,559.620913,139.313982,2,0
0,0,11,11,12,18,30,52,55,107,0.000333,0.175012,18,9450.671287,525.037294,525.037294,118.0782,2,0
0,0,8,8,10,12,22,43,30,73,0.000333,0.108513,10,3255.385082,180.854727,325.538508,76.238831,1,0
0,0,11,11,11,13,24,58,38,96,0.000333,0.146719,10,4401.564001,244.531333,440.1564,86.159464,1,0
0,0,13,13,14,18,32,53,44,97,0.000333,0.161667,14,6790,377.222222,485,128.361619,1,0
0,0,8,8,10,17,27,43,38,81,0.000333,0.128382,10,3851.458877,213.969938,385.145888,102.706149,1,0
0,0,9,9,12,13,25,48,34,82,0.000333,0.126932,12,4569.554491,253.864138,380.796208,91.125266,1,0
0,0,9,9,11,15,26,52,36,88,0.000333,0.13788,10,4136.386952,229.799275,413.638695,96.657107,1,0
0,0,10,10,11,19,30,44,42,86,0.000333,0.140664,10,4219.925912,234.440328,421.992591,118.764371,1,0
0,0,8,8,10,17,27,43,38,81,0.000333,0.128382,10,3851.458877,213.969938,385.145888,102.706149,1,0
0,0,10,10,10,18,28,49,52,101,0.000333,0.161848,10,4855.428471,269.746026,485.542847,108.277931,1,0
0,0,12,12,10,19,29,55,66,121,0.000333,0.195939,15,8817.235506,489.846417,587.8157,113.929904,1,0
0,0,14,14,10,20,30,61,80,141,0.000333,0.230624,20,13837.43148,768.746193,691.871574,119.657843,1,0
0,0,9,9,11,16,27,47,40,87,0.000333,0.137892,10,4136.752127,229.819563,413.675213,102.053748,1,0
0,0,9,9,11,18,29,49,41,90,0.000333,0.145739,10,4372.182896,242.89905,437.21829,113.112398,1,0
0,0,10,10,11,19,30,58,45,103,0.000333,0.16847,10,5054.097313,280.783184,505.409731,118.764371,1,0
0,0,9,9,10,19,29,51,41,92,0.000333,0.148978,10,4469.342516,248.296806,446.934252,113.929904,1,0
0,0,11,11,10,20,30,58,48,106,0.000333,0.173377,10,5201.304031,288.961335,520.130403,119.657843,1,0
0,0,14,14,14,21,35,56,63,119,0.000333,0.203462,21,12818.07826,712.115459,610.384679,145.541635,1,0
0,0,10,10,10,19,29,43,48,91,0.000333,0.147359,10,4420.762706,245.597928,442.076271,113.929904,1,0
0,0,6,6,10,11,21,31,23,54,0.000333,0.079062,10,2371.851408,131.769523,237.185141,71.273029,1,0
0,0,8,8,14,12,26,37,24,61,0.000333,0.095576,14,4014.175519,223.009751,286.726823,96.322519,2,0
0,0,7,7,11,11,22,34,24,58,0.000333,0.086216,10,2586.470339,143.692797,258.647034,76.107496,2,0
0,0,8,8,15,12,27,38,25,63,0.000333,0.099853,14,4193.810777,232.989488,299.557913,101.622909,2,0
0,0,7,7,11,12,23,34,25,59,0.000333,0.088963,10,2668.901554,148.272309,266.890155,81.073298,2,0
0,0,10,10,16,15,31,45,30,75,0.000333,0.123855,16,5945.035572,330.279754,371.564723,122.603359,2,0
0,0,9,9,13,15,28,42,30,72,0.000333,0.115377,12,4153.554653,230.753036,346.129554,106.709075,2,0
0,0,10,10,15,15,30,43,30,73,0.000333,0.119401,14,5014.842189,278.602344,358.203013,117.206718,2,0
0,0,9,9,12,15,27,40,30,70,0.000333,0.110947,12,3994.105502,221.89475,332.842125,101.622909,2,0
0,0,9,9,17,14,31,42,28,70,0.000333,0.115598,16,5548.699868,308.261104,346.793742,122.789837,2,0
0,0,8,8,13,14,27,38,28,66,0.000333,0.104608,12,3765.870902,209.21505,313.822575,101.408685,2,0
0,0,9,9,16,14,30,41,28,69,0.000333,0.112858,16,5417.207218,300.955957,338.575451,117.302969,2,0
0,0,8,8,12,14,26,37,28,65,0.000333,0.101843,12,3666.34298,203.685721,305.528582,96.322519,2,0
0,0,12,12,16,15,31,43,30,73,0.000333,0.120552,16,5786.501291,321.472294,361.656331,122.603359,2,0
0,0,11,11,13,15,28,40,30,70,0.000333,0.112172,12,4038.178135,224.34323,336.514845,106.709075,2,0
0,0,10,10,15,15,30,43,30,73,0.000333,0.119401,14,5014.842189,278.602344,358.203013,117.206718,2,0
0,0,9,9,12,15,27,40,30,70,0.000333,0.110947,12,3994.105502,221.89475,332.842125,101.622909,2,0
0,0,10,10,14,15,29,41,30,71,0.000333,0.114972,14,4828.833109,268.268506,344.916651,111.906328,2,0
0,0,9,9,11,15,26,38,30,68,0.000333,0.106543,10,3196.299008,177.572167,319.629901,96.657107,2,0
0,0,12,12,15,15,30,41,30,71,0.000333,0.11613,14,4877.449252,270.969403,348.389232,117.206718,2,0
0,0,11,11,12,15,27,38,30,68,0.000333,0.107777,12,3879.988202,215.5549,323.33235,101.622909,2,0
0,0,9,9,16,14,30,41,28,69,0.000333,0.112858,16,5417.207218,300.955957,338.575451,117.302969,2,0
0,0,8,8,12,14,26,37,28,65,0.000333,0.101843,12,3666.34298,203.685721,305.528582,96.322519,2,0
0,0,9,9,15,14,29,40,28,68,0.000333,0.110114,14,4624.797907,256.933217,330.342708,111.906328,2,0
0,0,8,8,11,14,25,36,28,64,0.000333,0.099069,10,2972.067961,165.114887,297.206796,91.356717,2,0
0,0,11,11,15,13,28,42,25,67,0.000333,0.107364,7,2254.649458,125.258303,322.09278,106.709075,2,0
0,0,11,11,15,12,27,42,25,67,0.000333,0.106192,14,4460.084477,247.782471,318.577463,101.622909,2,0
0,0,8,8,12,11,23,36,24,60,0.000333,0.090471,12,3256.964608,180.942478,271.413717,81.073298,2,0
0,0,7,7,13,13,26,39,28,67,0.000333,0.104976,12,3779.153533,209.952974,314.929461,96.211433,2,0
0,0,8,8,12,11,23,34,25,59,0.000333,0.088963,12,3202.681865,177.92677,266.890155,81.073298,1,0
0,0,12,12,16,16,32,50,42,92,0.000333,0.153333,16,7360,408.888889,460,128,2,0
0,0,11,11,13,15,28,47,42,89,0.000333,0.142618,12,5134.255057,285.236392,427.854588,106.709075,2,0
0,0,12,12,15,19,34,49,54,103,0.000333,0.17467,14,7336.121417,407.562301,524.008673,139.313982,2,0
0,0,11,11,12,18,30,46,54,100,0.000333,0.163563,18,8832.403072,490.68906,490.68906,118.0782,2,0
0,0,8,8,10,12,22,37,29,66,0.000333,0.098107,10,2943.224868,163.512493,294.322487,76.238831,1,0
0,0,11,11,11,13,24,52,37,89,0.000333,0.136021,10,4080.616626,226.700924,408.061663,86.159464,1,0
0,0,13,13,14,18,32,47,43,90,0.000333,0.15,14,6300,350,450,128.361619,1,0
0,0,8,8,10,17,27,37,37,74,0.000333,0.117287,10,3518.616752,195.478708,351.861675,102.706149,1,0
0,0,9,9,12,13,25,42,33,75,0.000333,0.116096,12,4179.470571,232.192809,348.289214,91.125266,1,0
0,0,9,9,11,15,26,46,35,81,0.000333,0.126912,10,3807.356172,211.519787,380.735617,96.657107,1,0
0,0,10,10,11,19,30,38,41,79,0.000333,0.129215,10,3876.443571,215.357976,387.644357,118.764371,1,0
0,0,8,8,10,17,27,37,37,74,0.000333,0.117287,10,3518.616752,195.478708,351.861675,102.706149,1,0
0,0,10,10,10,18,28,43,51,94,0.000333,0.15063,10,4518.913627,251.050757,451.891363,108.277931,1,0
0,0,12,12,10,19,29,49,65,114,0.000333,0.184603,15,8307.147502,461.508195,553.809833,113.929904,1,0
0,0,14,14,10,20,30,55,79,134,0.000333,0.219174,15,9862.850097,547.936117,657.52334,119.657843,1,0
0,0,9,9,11,16,27,41,39,80,0.000333,0.126797,10,3803.910002,211.328333,380.391,102.053748,1,0
0,0,9,9,11,18,29,43,40,83,0.000333,0.134404,10,4032.124226,224.006901,403.212423,113.112398,1,0
0,0,10,10,11,19,30,52,44,96,0.000333,0.15702,10,4710.614972,261.700832,471.061497,118.764371,1,0
0,0,9,9,10,18,28,45,41,86,0.000333,0.137811,10,4134.325233,229.684735,413.432523,108.277931,1,0
0,0,11,11,10,20,30,52,47,99,0.000333,0.161927,10,4857.82169,269.878983,485.782169,119.657843,1,0
0,0,14,14,14,21,35,50,62,112,0.000333,0.191493,14,8042.715771,446.817543,574.479698,145.541635,1,0
0,0,10,10,10,19,29,37,47,84,0.000333,0.136023,10,4080.704036,226.70578,408.070404,113.929904,1,0
0,0,9,9,14,20,34,44,45,89,0.000333,0.150928,14,6338.9787,352.165483,452.784193,139.741531,1,0
0,0,10,10,14,20,34,45,46,91,0.000333,0.15432,14,6481.42766,360.079314,462.959119,139.741531,1,0
0,0,6,6,10,10,20,27,20,47,0.000333,0.06771,10,2031.306205,112.850345,203.13062,66.438562,1,0
0,0,7,7,11,10,21,30,21,51,0.000333,0.074669,10,2240.081886,124.448994,224.008189,71.273029,2,0
0,0,8,8,14,11,25,33,21,54,0.000333,0.083589,7,1755.37764,97.52098,250.768234,91.356717,2,0
0,0,8,8,15,11,26,34,22,56,0.000333,0.087742,14,3685.144739,204.730263,263.224624,96.657107,2,0
0,0,7,7,11,11,22,30,22,52,0.000333,0.077297,10,2318.904442,128.828025,231.890444,76.107496,2,0
0,0,10,10,16,14,30,41,27,68,0.000333,0.111223,8,2669.348484,148.297138,333.668561,117.302969,2,0
0,0,9,9,13,14,27,38,27,65,0.000333,0.103023,6,1854.406126,103.022563,309.067688,101.408685,2,0
0,0,10,10,15,14,29,39,27,66,0.000333,0.106876,7,2244.38722,124.688179,320.626746,111.906328,2,0
0,0,9,9,12,14,26,36,27,63,0.000333,0.098709,6,1776.766213,98.709234,296.127702,96.322519,2,0
0,0,9,9,17,13,30,38,25,63,0.000333,0.103045,8,2473.07286,137.392937,309.134108,117.592585,2,0
0,0,8,8,13,13,26,34,25,59,0.000333,0.092442,6,1663.95566,92.441981,277.325943,96.211433,2,0
0,0,9,9,16,13,29,37,25,62,0.000333,0.100398,8,2409.558574,133.864365,301.194822,112.105716,2,0
0,0,8,8,12,13,25,33,25,58,0.000333,0.089781,6,1616.061954,89.78122,269.343659,91.125266,2,0
0,0,12,12,16,14,30,39,27,66,0.000333,0.107952,8,2590.838234,143.935457,323.854779,117.302969,2,0
0,0,11,11,13,14,27,36,27,63,0.000333,0.099853,6,1797.347476,99.852638,299.557913,101.408685,2,0
0,0,9,9,15,14,29,36,24,60,0.000333,0.09716,7,2040.352018,113.35289,291.47886,111.906328,2,0
0,0,8,8,12,14,26,33,24,57,0.000333,0.089308,6,1607.550384,89.308355,267.925064,96.322519,2,0
0,0,10,10,14,14,28,37,27,64,0.000333,0.102557,7,2153.695005,119.649723,307.670715,106.605938,2,0
0,0,9,9,11,14,25,34,27,61,0.000333,0.094425,5,1416.376138,78.687563,283.275228,91.356717,2,0
0,0,12,12,15,14,29,37,27,64,0.000333,0.103637,7,2176.375486,120.909749,310.910784,111.906328,2,0
0,0,11,11,12,14,26,34,27,61,0.000333,0.095576,6,1720.360937,95.575608,286.726823,96.322519,2,0
0,0,10,10,16,13,29,37,25,62,0.000333,0.100398,8,2409.558574,133.864365,301.194822,112.105716,2,0
0,0,8,8,12,13,25,33,25,58,0.000333,0.089781,6,1616.061954,89.78122,269.343659,91.125266,2,0
0,0,9,9,15,13,28,36,25,61,0.000333,0.09775,7,2052.740552,114.041142,293.24865,106.709075,2,0
0,0,8,8,11,13,24,32,25,57,0.000333,0.087114,5,1306.714313,72.59524,261.342863,86.159464,2,0
0,0,11,11,15,12,27,38,22,60,0.000333,0.095098,7,1997.052751,110.947375,285.29325,101.622909,2,0
0,0,11,11,15,11,26,38,22,60,0.000333,0.094009,14,3948.369363,219.353854,282.026383,96.657107,2,0
0,0,8,8,12,10,22,32,21,53,0.000333,0.078783,12,2836.198509,157.566584,236.349876,76.238831,2,0
0,0,7,7,13,12,25,35,25,60,0.000333,0.092877,12,3343.576457,185.754248,278.631371,91.125266,2,0
0,0,8,8,12,10,22,30,22,52,0.000333,0.077297,12,2782.68533,154.593629,231.890444,76.238831,1,0
0,0,12,12,16,15,31,46,39,85,0.000333,0.140369,16,6737.706982,374.317055,421.106686,122.603359,2,0
0,0,11,11,13,14,27,43,39,82,0.000333,0.129967,12,4678.809302,259.93385,389.900775,101.408685,2,0
0,0,12,12,15,18,33,45,51,96,0.000333,0.161421,14,6779.665696,376.648094,484.261835,133.662009,2,0
0,0,11,11,12,17,29,42,51,93,0.000333,0.150597,18,8132.260186,451.792233,451.792233,112.506418,2,0
0,0,8,8,10,11,21,33,26,59,0.000333,0.086382,10,2591.467279,143.970404,259.146728,71.273029,1,0
0,0,11,11,11,12,23,48,34,82,0.000333,0.123644,10,3709.320804,206.073378,370.93208,81.073298,1,0
0,0,13,13,14,17,31,43,40,83,0.000333,0.137066,14,5756.776113,319.820895,411.198294,122.789837,1,0
0,0,8,8,10,16,26,33,34,67,0.000333,0.104976,10,3149.294611,174.960812,314.929461,97.219281,1,0
0,0,9,9,12,12,24,38,30,68,0.000333,0.103926,12,3741.329401,207.851633,311.77745,86.0391,1,0
0,0,9,9,11,14,25,42,32,74,0.000333,0.114548,10,3436.45358,190.914088,343.645358,91.356717,1,0
0,0,10,10,11,18,29,34,38,72,0.000333,0.116592,10,3497.746316,194.31924,349.774632,113.112398,1,0
0,0,8,8,10,16,26,33,34,67,0.000333,0.104976,10,3149.294611,174.960812,314.929461,97.219281,1,0
0,0,10,10,10,17,27,39,48,87,0.000333,0.137892,10,4136.752127,229.819563,413.675213,102.706149,1,0
0,0,12,12,10,18,28,45,62,107,0.000333,0.171462,15,7715.80465,428.655814,514.386977,108.277931,1,0
0,0,14,14,10,19,29,51,76,127,0.000333,0.205655,20,12339.27173,685.515096,616.963586,113.929904,1,0
0,0,9,9,11,15,26,37,36,73,0.000333,0.114377,10,3431.320994,190.628944,343.132099,96.657107,1,0
0,0,9,9,11,17,28,39,37,76,0.000333,0.121786,10,3653.589741,202.977208,365.358974,107.540616,1,0
0,0,10,10,11,18,29,48,41,89,0.000333,0.14412,10,4323.603086,240.200171,432.360309,113.112398,1,0
0,0,9,9,10,17,27,41,38,79,0.000333,0.125212,10,3756.361127,208.686729,375.636113,102.706149,1,0
0,0,11,11,10,19,29,48,44,92,0.000333,0.148978,10,4469.342516,248.296806,446.934252,113.929904,1,0
0,0,14,14,14,20,34,46,59,105,0.000333,0.178061,14,7478.570377,415.476132,534.183598,139.741531,1,0
0,0,10,10,10,18,28,33,44,77,0.000333,0.123389,10,3701.66329,205.647961,370.166329,108.277931,1,0
0,0,9,9,14,19,33,40,42,82,0.000333,0.13788,14,5790.964449,321.720247,413.640318,134.013592,1,0
0,0,10,10,14,19,33,41,43,84,0.000333,0.141243,14,5932.207484,329.567082,423.729106,134.013592,1,0
0,0,6,6,10,11,21,31,23,54,0.000333,0.079062,10,2371.851408,131.769523,237.185141,71.273029,1,0
0,0,8,8,14,12,26,37,24,61,0.000333,0.095576,14,4014.175519,223.009751,286.726823,96.322519,2,0
0,0,7,7,11,11,22,34,24,58,0.000333,0.086216,10,2586.470339,143.692797,258.647034,76.107496,2,0
0,0,8,8,15,12,27,38,25,63,0.000333,0.099853,14,4193.810777,232.989488,299.557913,101.622909,2,0
0,0,7,7,11,12,23,34,25,59,0.000333,0.088963,10,2668.901554,148.272309,266.890155,81.073298,2,0
0,0,10,10,16,15,31,45,30,75,0.000333,0.123855,16,5945.035572,330.279754,371.564723,122.603359,2,0
0,0,9,9,13,15,28,42,30,72,0.000333,0.115377,12,4153.554653,230.753036,346.129554,106.709075,2,0
0,0,10,10,15,15,30,43,30,73,0.000333,0.119401,14,5014.842189,278.602344,358.203013,117.206718,2,0
0,0,9,9,12,15,27,40,30,70,0.000333,0.110947,12,3994.105502,221.89475,332.842125,101.622909,2,0
0,0,9,9,17,14,31,42,28,70,0.000333,0.115598,16,5548.699868,308.261104,346.793742,122.789837,2,0
0,0,8,8,13,14,27,38,28,66,0.000333,0.104608,12,3765.870902,209.21505,313.822575,101.408685,2,0
0,0,9,9,16,14,30,41,28,69,0.000333,0.112858,16,5417.207218,300.955957,338.575451,117.302969,2,0
0,0,8,8,12,14,26,37,28,65,0.000333,0.101843,12,3666.34298,203.685721,305.528582,96.322519,2,0
0,0,12,12,16,15,31,43,30,73,0.000333,0.120552,16,5786.501291,321.472294,361.656331,122.603359,2,0
0,0,11,11,13,15,28,40,30,70,0.000333,0.112172,12,4038.178135,224.34323,336.514845,106.709075,2,0
0,0,10,10,15,15,30,43,30,73,0.000333,0.119401,14,5014.842189,278.602344,358.203013,117.206718,2,0
0,0,9,9,12,15,27,40,30,70,0.000333,0.110947,12,3994.105502,221.89475,332.842125,101.622909,2,0
0,0,10,10,14,15,29,41,30,71,0.000333,0.114972,14,4828.833109,268.268506,344.916651,111.906328,2,0
0,0,9,9,11,15,26,38,30,68,0.000333,0.106543,10,3196.299008,177.572167,319.629901,96.657107,2,0
0,0,12,12,15,15,30,41,30,71,0.000333,0.11613,14,4877.449252,270.969403,348.389232,117.206718,2,0
0,0,11,11,12,15,27,38,30,68,0.000333,0.107777,12,3879.988202,215.5549,323.33235,101.622909,2,0
0,0,9,9,16,14,30,41,28,69,0.000333,0.112858,16,5417.207218,300.955957,338.575451,117.302969,2,0
0,0,8,8,12,14,26,37,28,65,0.000333,0.101843,12,3666.34298,203.685721,305.528582,96.322519,2,0
0,0,9,9,15,14,29,40,28,68,0.000333,0.110114,14,4624.797907,256.933217,330.342708,111.906328,2,0
0,0,8,8,11,14,25,36,28,64,0.000333,0.099069,10,2972.067961,165.114887,297.206796,91.356717,2,0
0,0,11,11,15,13,28,42,25,67,0.000333,0.107364,7,2254.649458,125.258303,322.09278,106.709075,2,0
0,0,11,11,15,12,27,42,25,67,0.000333,0.106192,14,4460.084477,247.782471,318.577463,101.622909,2,0
0,0,8,8,12,11,23,36,24,60,0.000333,0.090471,12,3256.964608,180.942478,271.413717,81.073298,2,0
0,0,7,7,13,13,26,39,28,67,0.000333,0.104976,12,3779.153533,209.952974,314.929461,96.211433,2,0
0,0,8,8,12,11,23,34,25,59,0.000333,0.088963,12,3202.681865,177.92677,266.890155,81.073298,1,0
0,0,12,12,16,16,32,50,42,92,0.000333,0.153333,16,7360,408.888889,460,128,2,0
0,0,11,11,13,15,28,47,42,89,0.000333,0.142618,12,5134.255057,285.236392,427.854588,106.709075,2,0
0,0,12,12,15,19,34,49,54,103,0.000333,0.17467,14,7336.121417,407.562301,524.008673,139.313982,2,0
0,0,11,11,12,18,30,46,54,100,0.000333,0.163563,18,8832.403072,490.68906,490.68906,118.0782,2,0
0,0,8,8,10,12,22,37,29,66,0.000333,0.098107,10,2943.224868,163.512493,294.322487,76.238831,1,0
0,0,11,11,11,13,24,52,37,89,0.000333,0.136021,10,4080.616626,226.700924,408.061663,86.159464,1,0
0,0,13,13,14,18,32,47,43,90,0.000333,0.15,14,6300,350,450,128.361619,1,0
0,0,8,8,10,17,27,37,37,74,0.000333,0.117287,10,3518.616752,195.478708,351.861675,102.706149,1,0
0,0,9,9,12,13,25,42,33,75,0.000333,0.116096,12,4179.470571,232.192809,348.289214,91.125266,1,0
0,0,9,9,11,15,26,46,35,81,0.000333,0.126912,10,3807.356172,211.519787,380.735617,96.657107,1,0
0,0,10,10,11,19,30,38,41,79,0.000333,0.129215,10,3876.443571,215.357976,387.644357,118.764371,1,0
0,0,8,8,10,17,27,37,37,74,0.000333,0.117287,10,3518.616752,195.478708,351.861675,102.706149,1,0
0,0,10,10,10,18,28,43,51,94,0.000333,0.15063,10,4518.913627,251.050757,451.891363,108.277931,1,0
0,0,12,12,10,19,29,49,65,114,0.000333,0.184603,15,8307.147502,461.508195,553.809833,113.929904,1,0
0,0,14,14,10,20,30,55,79,134,0.000333,0.219174,15,9862.850097,547.936117,657.52334,119.657843,1,0
0,0,9,9,11,16,27,41,39,80,0.000333,0.126797,10,3803.910002,211.328333,380.391,102.053748,1,0
0,0,9,9,11,18,29,43,40,83,0.000333,0.134404,10,4032.124226,224.006901,403.212423,113.112398,1,0
0,0,10,10,11,19,30,52,44,96,0.000333,0.15702,10,4710.614972,261.700832,471.061497,118.764371,1,0
0,0,9,9,10,18,28,45,41,86,0.000333,0.137811,10,4134.325233,229.684735,413.432523,108.277931,1,0
0,0,11,11,10,20,30,52,47,99,0.000333,0.161927,10,4857.82169,269.878983,485.782169,119.657843,1,0
0,0,14,14,14,21,35,50,62,112,0.000333,0.191493,14,8042.715771,446.817543,574.479698,145.541635,1,0
0,0,10,10,10,19,29,37,47,84,0.000333,0.136023,10,4080.704036,226.70578,408.070404,113.929904,1,0
0,0,9,9,14,20,34,44,45,89,0.000333,0.150928,14,6338.9787,352.165483,452.784193,139.741531,1,0
0,0,10,10,14,20,34,45,46,91,0.000333,0.15432,14,6481.42766,360.079314,462.959119,139.741531,1,0
0,0,8,8,10,10,20,38,25,63,0.000333,0.09076,10,2722.8147,151.267483,272.28147,66.438562,1,0
0,0,10,10,14,10,24,44,26,70,0.000333,0.106982,14,4493.263251,249.625736,320.947375,86.52225,2,0
0,0,9,9,11,10,21,41,26,67,0.000333,0.098095,10,2942.852673,163.491815,294.285267,71.273029,2,0
0,0,10,10,15,11,26,45,27,72,0.000333,0.112811,14,4738.043236,263.224624,338.43166,96.657107,2,0
0,0,9,9,11,11,22,41,27,68,0.000333,0.10108,10,3032.413501,168.467417,303.24135,76.107496,2,0
0,0,12,12,16,13,29,52,32,84,0.000333,0.136023,16,6529.126457,362.729248,408.070404,112.105716,2,0
0,0,11,11,13,13,26,49,32,81,0.000333,0.126912,12,4568.827406,253.823745,380.735617,96.211433,2,0
0,0,12,12,15,13,28,50,32,82,0.000333,0.131401,14,5518.843451,306.602414,394.203104,106.709075,2,0
0,0,11,11,12,13,25,47,32,79,0.000333,0.122288,12,4402.375668,244.576426,366.864639,91.125266,2,0
0,0,11,11,17,13,30,49,30,79,0.000333,0.129215,16,6202.309713,344.572762,387.644357,117.592585,2,0
0,0,10,10,13,13,26,45,30,75,0.000333,0.117511,12,4230.395746,235.021986,352.532979,96.211433,2,0
0,0,11,11,16,13,29,48,30,78,0.000333,0.126308,16,6062.760282,336.820016,378.922518,112.105716,2,0
0,0,10,10,12,13,25,44,30,74,0.000333,0.114548,12,4123.744297,229.096905,343.645358,91.125266,2,0
0,0,14,14,16,13,29,50,32,82,0.000333,0.132785,16,6373.671066,354.092837,398.354442,112.105716,2,0
0,0,13,13,13,13,26,47,32,79,0.000333,0.123778,12,4456.016853,247.556492,371.334738,96.211433,2,0
0,0,12,12,15,13,28,50,32,82,0.000333,0.131401,14,5518.843451,306.602414,394.203104,106.709075,2,0
0,0,11,11,12,13,25,47,32,79,0.000333,0.122288,12,4402.375668,244.576426,366.864639,91.125266,2,0
0,0,12,12,14,13,27,48,32,80,0.000333,0.126797,14,5325.474002,295.859667,380.391,101.408685,2,0
0,0,11,11,11,13,24,45,32,77,0.000333,0.117681,10,3530.421126,196.134507,353.042113,86.159464,2,0
0,0,14,14,15,13,28,48,32,80,0.000333,0.128196,14,5384.237513,299.124306,384.588394,106.709075,2,0
0,0,13,13,12,13,25,45,32,77,0.000333,0.119192,12,4290.923119,238.384618,357.576927,91.125266,2,0
0,0,11,11,16,13,29,48,30,78,0.000333,0.126308,16,6062.760282,336.820016,378.922518,112.105716,2,0
0,0,10,10,12,13,25,44,30,74,0.000333,0.114548,12,4123.744297,229.096905,343.645358,91.125266,2,0
0,0,11,11,15,13,28,47,30,77,0.000333,0.123389,14,5182.328606,287.907145,370.166329,106.709075,2,0
0,0,10,10,11,13,24,43,30,73,0.000333,0.111567,10,3347.022626,185.945701,334.702263,86.159464,2,0
0,0,13,13,15,12,27,49,27,76,0.000333,0.120457,14,5059.200302,281.066683,361.37145,101.622909,2,0
0,0,13,13,15,11,26,49,27,76,0.000333,0.119078,14,5001.26786,277.848214,357.233419,96.657107,2,0
0,0,10,10,12,10,22,43,26,69,0.000333,0.102567,12,3692.40938,205.133854,307.700782,76.238831,2,0
0,0,9,9,13,11,24,46,30,76,0.000333,0.116152,12,4181.485801,232.304767,348.45715,86.159464,2,0
0,0,10,10,12,10,22,41,27,68,0.000333,0.10108,12,3638.896201,202.1609,303.24135,76.238831,1,0
0,0,13,13,13,14,27,54,44,98,0.000333,0.155326,18,8387.621554,465.978975,465.978975,101.408685,2,0
0,0,14,14,16,14,30,57,44,101,0.000333,0.165199,24,11894.3028,660.7946,495.59595,117.302969,2,0
0,0,14,14,15,17,32,56,56,112,0.000333,0.186667,21,11760,653.333333,560,128.090227,2,0
0,0,13,13,12,17,29,53,56,109,0.000333,0.176507,18,9531.358712,529.519928,529.519928,112.506418,2,0
0,0,10,10,10,11,21,44,31,75,0.000333,0.109808,10,3294.238067,183.013226,329.423807,71.273029,1,0
0,0,13,13,11,12,23,59,39,98,0.000333,0.14777,15,6649.636075,369.424226,443.309072,81.073298,1,0
0,0,15,15,14,17,31,54,45,99,0.000333,0.163488,14,6866.516086,381.473116,490.465435,122.789837,1,0
0,0,10,10,10,16,26,44,39,83,0.000333,0.130045,10,3901.364966,216.742498,390.136497,97.219281,1,0
0,0,11,11,12,12,24,49,35,84,0.000333,0.128379,12,4621.642201,256.7579,385.13685,86.0391,1,0
0,0,11,11,11,14,25,53,37,90,0.000333,0.139316,10,4179.470571,232.192809,417.947057,91.356717,1,0
0,0,12,12,11,18,29,45,43,88,0.000333,0.142501,10,4275.023276,237.501293,427.502328,113.112398,1,0
0,0,10,10,10,16,26,44,39,83,0.000333,0.130045,10,3901.364966,216.742498,390.136497,97.219281,1,0
0,0,12,12,10,17,27,50,53,103,0.000333,0.163251,15,7346.301191,408.127844,489.753413,102.706149,1,0
0,0,14,14,10,18,28,56,67,123,0.000333,0.197102,15,8869.569831,492.75388,591.304655,108.277931,1,0
0,0,16,16,10,19,29,62,81,143,0.000333,0.231564,20,13893.82565,771.879203,694.691282,113.929904,1,0
0,0,7,7,9,13,22,27,25,52,0.000333,0.077297,4,927.561777,51.53121,231.890444,76.635041,1,0
0,0,11,11,11,17,28,50,42,92,0.000333,0.147426,10,4422.766528,245.709252,442.276653,107.540616,1,0
0,0,12,12,11,18,29,59,46,105,0.000333,0.170029,10,5100.880045,283.382225,510.088004,113.112398,1,0
0,0,11,11,10,17,27,52,43,95,0.000333,0.150571,10,4517.143127,250.952396,451.714313,102.706149,1,0
0,0,13,13,10,19,29,59,49,108,0.000333,0.174887,10,5246.619475,291.47886,524.661947,113.929904,1,0
0,0,16,16,14,20,34,57,64,121,0.000333,0.205194,21,12927.24308,718.180171,615.583004,139.741531,1,0
0,0,12,12,10,18,28,44,49,93,0.000333,0.149028,10,4470.840078,248.380004,447.084008,108.277931,1,0
0,0,11,11,14,19,33,51,47,98,0.000333,0.164784,14,6920.908732,384.49493,494.350624,134.013592,1,0
0,0,12,12,14,19,33,52,48,100,0.000333,0.168146,14,7062.151767,392.341765,504.439412,134.013592,1,0
0,0,8,8,10,10,20,39,26,65,0.000333,0.093642,10,2809.253262,156.069626,280.925326,66.438562,1,0
0,0,11,11,14,10,24,45,27,72,0.000333,0.110039,14,4621.642201,256.7579,330.1173,86.52225,2,0
0,0,9,9,11,10,21,42,27,69,0.000333,0.101023,10,3030.699022,168.372168,303.069902,71.273029,2,0
0,0,10,10,15,11,26,46,28,74,0.000333,0.115944,14,4869.655548,270.536419,347.832539,96.657107,2,0
0,0,9,9,11,11,22,42,28,70,0.000333,0.104053,10,3121.602133,173.422341,312.160213,76.107496,2,0
0,0,12,12,16,13,29,53,33,86,0.000333,0.139262,16,6684.581849,371.365658,417.786366,112.105716,2,0
0,0,11,11,13,13,26,50,33,83,0.000333,0.130045,12,4681.637959,260.090998,390.136497,96.211433,2,0
0,0,12,12,15,13,28,51,33,84,0.000333,0.134606,14,5653.449388,314.080522,403.817813,106.709075,2,0
0,0,11,11,12,13,25,48,33,81,0.000333,0.125384,12,4513.828216,250.768234,376.152351,91.125266,2,0
0,0,11,11,17,13,30,50,31,81,0.000333,0.132486,16,6359.330212,353.296123,397.458138,117.592585,2,0
0,0,10,10,13,13,26,46,31,77,0.000333,0.120645,12,4343.2063,241.289239,361.933858,96.211433,2,0
0,0,11,11,16,13,29,49,31,80,0.000333,0.129546,16,6218.215674,345.456426,388.63848,112.105716,2,0
0,0,10,10,12,13,25,45,31,76,0.000333,0.117644,12,4235.196845,235.288714,352.93307,91.125266,2,0
0,0,14,14,16,13,29,51,33,84,0.000333,0.136023,16,6529.126457,362.729248,408.070404,112.105716,2,0
0,0,13,13,13,13,26,48,33,81,0.000333,0.126912,12,4568.827406,253.823745,380.735617,96.211433,2,0
0,0,13,13,15,13,28,51,33,84,0.000333,0.134606,14,5653.449388,314.080522,403.817813,106.709075,2,0
0,0,11,11,12,13,25,48,33,81,0.000333,0.125384,12,4513.828216,250.768234,376.152351,91.125266,2,0
0,0,12,12,14,13,27,49,33,82,0.000333,0.129967,14,5458.610852,303.256158,389.900775,101.408685,2,0
0,0,11,11,11,13,24,46,33,79,0.000333,0.120737,10,3622.120376,201.22891,362.212038,86.159464,2,0
0,0,11,11,14,11,25,45,27,72,0.000333,0.111453,14,4681.007039,260.055947,334.357646,91.356717,2,0
0,0,9,9,11,11,22,42,27,69,0.000333,0.102567,10,3077.007817,170.944879,307.700782,76.107496,2,0
0,0,11,11,16,13,29,49,31,80,0.000333,0.129546,16,6218.215674,345.456426,388.63848,112.105716,2,0
0,0,10,10,12,13,25,45,31,76,0.000333,0.117644,12,4235.196845,235.288714,352.93307,91.125266,2,0
0,0,11,11,15,13,28,48,31,79,0.000333,0.126594,14,5316.934544,295.385252,379.781039,106.709075,2,0
0,0,10,10,11,13,24,44,31,75,0.000333,0.114624,10,3438.721876,191.040104,343.872188,86.159464,2,0
0,0,13,13,15,12,27,50,28,78,0.000333,0.123627,14,5192.337152,288.463175,370.881225,101.622909,2,0
0,0,13,13,15,11,26,50,28,78,0.000333,0.122211,14,5132.880172,285.16001,366.634298,96.657107,2,0
0,0,10,10,12,10,22,44,27,71,0.000333,0.10554,12,3799.435739,211.079763,316.619645,76.238831,2,0
0,0,9,9,13,11,24,47,31,78,0.000333,0.119209,12,4291.524901,238.41805,357.627075,86.159464,2,0
0,0,10,10,12,10,22,42,28,70,0.000333,0.104053,12,3745.92256,208.106809,312.160213,76.238831,1,0
0,0,14,14,16,14,30,58,45,103,0.000333,0.16847,24,12129.83355,673.879642,505.409731,117.302969,2,0
0,0,13,13,13,14,27,55,45,100,0.000333,0.158496,18,8558.797504,475.48875,475.48875,101.408685,2,0
0,0,14,14,15,17,32,57,57,114,0.000333,0.19,21,11970,665,570,128.090227,2,0
0,0,13,13,12,17,29,54,57,111,0.000333,0.179745,18,9706.246028,539.23589,539.23589,112.506418,2,0
0,0,10,10,10,11,21,45,32,77,0.000333,0.112736,10,3382.084416,187.893579,338.208442,71.273029,1,0
0,0,13,13,11,12,23,60,40,100,0.000333,0.150785,15,6785.342934,376.963496,452.356196,81.073298,1,0
0,0,15,15,14,17,31,55,46,101,0.000333,0.166791,14,7005.233583,389.179643,500.373827,122.789837,1,0
0,0,11,11,10,16,26,50,43,93,0.000333,0.145714,10,4371.408938,242.856052,437.140894,97.219281,1,0
0,0,11,11,12,12,24,50,36,86,0.000333,0.131436,18,7097.521951,394.306775,394.306775,86.0391,1,0
0,0,12,12,11,14,25,59,41,100,0.000333,0.154795,10,4643.85619,257.992011,464.385619,91.356717,1,0
0,0,13,13,11,18,29,51,47,98,0.000333,0.158694,10,4760.821375,264.490076,476.082138,113.112398,1,0
0,0,11,11,10,16,26,50,43,93,0.000333,0.145714,10,4371.408938,242.856052,437.140894,97.219281,1,0
0,0,13,13,10,17,27,56,57,113,0.000333,0.179101,15,8059.534316,447.751906,537.302288,102.706149,1,0
0,0,15,15,10,18,28,62,71,133,0.000333,0.213126,15,9590.67307,532.815171,639.378205,108.277931,1,0
0,0,17,17,10,19,29,68,85,153,0.000333,0.247757,20,14865.42185,825.856769,743.271092,113.929904,1,0
0,0,11,11,11,15,26,49,42,91,0.000333,0.14258,10,4277.400144,237.633341,427.740014,96.657107,1,0
0,0,12,12,11,17,28,56,46,102,0.000333,0.16345,10,4903.50202,272.416779,490.350202,107.540616,1,0
0,0,13,13,11,18,29,65,50,115,0.000333,0.186223,10,5586.678144,310.371008,558.667814,113.112398,1,0
0,0,12,12,10,17,27,58,47,105,0.000333,0.166421,10,4992.631877,277.368438,499.263188,102.706149,1,0
0,0,14,14,10,19,29,65,53,118,0.000333,0.191081,10,5732.417574,318.467643,573.241757,113.929904,1,0
0,0,17,17,14,20,34,63,68,131,0.000333,0.222153,21,13995.61028,777.533904,666.457632,139.741531,1,0
0,0,13,13,10,18,28,50,53,103,0.000333,0.165053,10,4951.57557,275.087532,495.157557,108.277931,1,0
0,0,12,12,14,19,33,57,51,108,0.000333,0.181598,14,7627.123908,423.729106,544.794565,134.013592,1,0
0,0,13,13,14,19,33,58,52,110,0.000333,0.184961,14,7768.366944,431.575941,554.883353,134.013592,1,0
0,0,13,13,12,16,28,41,34,75,0.000333,0.120184,12,4326.61943,240.367746,360.551619,107.01955,3,0
0,0,15,15,15,16,31,47,35,82,0.000333,0.135415,14,5687.417364,315.967631,406.244097,122.603359,4,0
0,0,14,14,13,16,29,44,35,79,0.000333,0.127927,12,4605.365983,255.853666,383.780499,112.105716,4,0
0,0,15,15,16,17,33,48,36,84,0.000333,0.141243,16,6779.665696,376.648094,423.729106,133.486868,4,0
0,0,14,14,13,17,30,44,36,80,0.000333,0.13085,12,4710.614972,261.700832,392.551248,117.592585,4,0
0,0,17,17,17,19,36,55,41,96,0.000333,0.165438,16,7941.004802,441.166933,496.3128,150.197491,4,0
0,0,16,16,15,19,34,52,41,93,0.000333,0.157711,14,6623.876619,367.993146,473.134044,139.313982,4,0
0,0,17,17,16,19,35,53,41,94,0.000333,0.160718,16,7714.441657,428.580092,482.152604,144.710623,4,0
0,0,16,16,14,19,33,50,41,91,0.000333,0.153013,14,6426.558108,357.031006,459.039865,134.013592,4,0
0,0,16,16,18,19,37,52,39,91,0.000333,0.15802,18,8533.084613,474.060256,474.060256,155.769273,4,0
0,0,15,15,15,19,34,48,39,87,0.000333,0.147536,14,6196.529741,344.251652,442.609267,139.313982,4,0
0,0,16,16,17,19,36,51,39,90,0.000333,0.155098,16,7444.692002,413.594,465.29325,150.197491,4,0
0,0,15,15,14,19,33,47,39,86,0.000333,0.144606,14,6073.45052,337.413918,433.817894,134.013592,4,0
0,0,19,19,17,19,36,53,41,94,0.000333,0.161991,16,7775.567202,431.975956,485.97295,150.197491,4,0
0,0,18,18,15,19,34,50,41,91,0.000333,0.15432,14,6481.42766,360.079314,462.959119,139.313982,4,0
0,0,17,17,16,19,35,53,41,94,0.000333,0.160718,16,7714.441657,428.580092,482.152604,144.710623,4,0
0,0,16,16,14,19,33,50,41,91,0.000333,0.153013,14,6426.558108,357.031006,459.039865,134.013592,4,0
0,0,17,17,15,19,34,51,41,92,0.000333,0.156016,14,6552.65214,364.03623,468.046581,139.313982,4,0
0,0,16,16,13,19,32,48,41,89,0.000333,0.148333,12,5340,296.666667,445,128.816339,4,0
0,0,19,19,16,19,35,51,41,92,0.000333,0.157298,16,7550.304601,419.461367,471.894038,144.710623,4,0
0,0,18,18,14,19,33,48,41,89,0.000333,0.14965,14,6285.315073,349.184171,448.951077,134.013592,4,0
0,0,16,16,17,19,36,51,39,90,0.000333,0.155098,16,7444.692002,413.594,465.29325,150.197491,4,0
0,0,15,15,14,19,33,47,39,86,0.000333,0.144606,14,6073.45052,337.413918,433.817894,134.013592,4,0
0,0,16,16,16,19,35,50,39,89,0.000333,0.152169,16,7304.099016,405.783279,456.506189,144.710623,4,0
0,0,15,15,13,19,32,46,39,85,0.000333,0.141667,12,5100,283.333333,425,128.816339,4,0
0,0,18,18,17,18,35,52,36,88,0.000333,0.150459,16,7222.030488,401.223916,451.376905,144.545518,4,0
0,0,18,18,17,17,34,52,36,88,0.000333,0.149232,16,7163.14768,397.952649,447.69673,138.973737,4,0
0,0,15,15,14,16,30,46,35,81,0.000333,0.132486,14,5564.413935,309.134108,397.458138,117.302969,4,0
0,0,14,14,15,17,32,49,39,88,0.000333,0.146667,14,6160,342.222222,440,128.090227,4,0
0,0,15,15,14,16,30,44,36,80,0.000333,0.13085,14,5495.717467,305.317637,392.551248,117.302969,3,0
0,0,19,19,17,20,37,60,53,113,0.000333,0.196223,16,9418.691685,523.260649,588.66823,155.92543,4,0
0,0,18,18,15,20,35,57,53,110,0.000333,0.188074,14,7899.095846,438.838658,564.221132,145.041921,4,0
0,0,19,19,16,23,39,59,65,124,0.000333,0.218463,16,10486.238,582.568778,655.389875,168.041925,4,0
0,0,18,18,14,23,37,56,65,121,0.000333,0.210115,14,8824.814001,490.267445,630.343857,157.344894,4,0
0,0,15,15,12,17,29,47,40,87,0.000333,0.140881,12,5071.732159,281.762898,422.644347,112.506418,3,0
0,0,18,18,13,18,31,62,48,110,0.000333,0.181654,12,6539.53913,363.307729,544.961594,123.164366,3,0
0,0,20,20,16,23,39,57,54,111,0.000333,0.19556,16,9386.874341,521.493019,586.679646,168.041925,3,0
0,0,15,15,12,22,34,47,48,95,0.000333,0.161103,12,5799.707639,322.20598,483.30897,141.127046,3,0
0,0,16,16,14,18,32,52,44,96,0.000333,0.16,14,6720,373.333333,480,128.361619,3,0
0,0,4,4,10,9,19,27,16,43,0.000333,0.060887,5,913.304415,50.739134,182.660883,61.748606,1,0
0,0,4,4,10,9,19,27,16,43,0.000333,0.060887,5,913.304415,50.739134,182.660883,61.748606,1,0
0,0,4,4,10,9,19,27,16,43,0.000333,0.060887,5,913.304415,50.739134,182.660883,61.748606,1,0
0,0,4,4,10,9,19,27,16,43,0.000333,0.060887,5,913.304415,50.739134,182.660883,61.748606,1,0
0,0,4,4,10,9,19,27,16,43,0.000333,0.060887,5,913.304415,50.739134,182.660883,61.748606,1,0
0,0,4,4,10,9,19,27,16,43,0.000333,0.060887,5,913.304415,50.739134,182.660883,61.748606,1,0
0,0,4,4,10,9,19,27,16,43,0.000333,0.060887,5,913.304415,50.739134,182.660883,61.748606,1,0
0,0,4,4,10,9,19,27,16,43,0.000333,0.060887,5,913.304415,50.739134,182.660883,61.748606,1,0
0,0,4,4,10,9,19,27,16,43,0.000333,0.060887,5,913.304415,50.739134,182.660883,61.748606,1,0
0,0,4,4,10,9,19,27,16,43,0.000333,0.060887,5,913.304415,50.739134,182.660883,61.748606,1,0
0,0,4,4,10,9,19,27,16,43,0.000333,0.060887,5,913.304415,50.739134,182.660883,61.748606,1,0
0,0,4,4,10,9,19,27,16,43,0.000333,0.060887,5,913.304415,50.739134,182.660883,61.748606,1,0
0,0,8,8,12,12,24,42,33,75,0.000333,0.114624,12,4126.466251,229.248125,343.872188,86.0391,1,0
0,0,8,8,12,12,24,42,33,75,0.000333,0.114624,12,4126.466251,229.248125,343.872188,86.0391,1,0
0,0,8,8,11,15,26,41,42,83,0.000333,0.130045,10,3901.364966,216.742498,390.136497,96.657107,1,0
0,0,8,8,11,15,26,41,42,83,0.000333,0.130045,10,3901.364966,216.742498,390.136497,96.657107,1,0
0,0,6,6,10,10,20,33,22,55,0.000333,0.079235,10,2377.060452,132.058914,237.706045,66.438562,1,0
0,0,9,9,11,11,22,48,30,78,0.000333,0.115945,10,3478.356663,193.242037,347.835666,76.107496,1,0
0,0,7,7,11,16,27,35,28,63,0.000333,0.099853,5,1497.789563,83.210531,299.557913,102.053748,1,0
0,0,6,6,10,15,25,33,30,63,0.000333,0.097521,10,2925.6294,162.534967,292.56294,91.82264,1,0
0,0,8,8,12,11,23,42,30,72,0.000333,0.108565,12,3908.35753,217.130974,325.696461,81.073298,1,0
0,0,7,7,11,13,24,42,28,70,0.000333,0.106982,10,3209.473751,178.304097,320.947375,86.159464,1,0
0,0,8,8,11,17,28,34,34,68,0.000333,0.108967,10,3269.001347,181.611186,326.900135,107.540616,1,0
0,0,6,6,10,15,25,33,30,63,0.000333,0.097521,10,2925.6294,162.534967,292.56294,91.82264,1,0
0,0,8,8,10,16,26,39,44,83,0.000333,0.130045,10,3901.364966,216.742498,390.136497,97.219281,1,0
0,0,10,10,10,17,27,45,58,103,0.000333,0.163251,15,7346.301191,408.127844,489.753413,102.706149,1,0
0,0,12,12,10,18,28,51,72,123,0.000333,0.197102,20,11826.09311,657.005173,591.304655,108.277931,1,0
0,0,8,8,11,14,25,41,39,80,0.000333,0.123836,10,3715.084952,206.393608,371.508495,91.356717,1,0
0,0,7,7,11,16,27,39,33,72,0.000333,0.114117,10,3423.519002,190.1955,342.3519,102.053748,1,0
0,0,8,8,11,17,28,48,37,85,0.000333,0.136208,10,4086.251684,227.013982,408.625168,107.540616,1,0
0,0,7,7,10,16,26,41,34,75,0.000333,0.117511,10,3525.329789,195.851655,352.532979,97.219281,1,0
0,0,9,9,10,18,28,48,40,88,0.000333,0.141016,10,4230.472331,235.026241,423.047233,108.277931,1,0
0,0,9,9,11,18,29,40,45,85,0.000333,0.137643,10,4129.283846,229.404658,412.928385,113.112398,1,0
0,0,8,8,10,17,27,33,40,73,0.000333,0.115702,10,3471.067877,192.837104,347.106788,102.706149,1,0
0,0,7,7,14,18,32,40,38,78,0.000333,0.13,14,5460,303.333333,390,128.361619,1,0
0,0,7,7,13,18,31,39,38,77,0.000333,0.127158,12,4577.677391,254.315411,381.473116,123.164366,1,0
0,0,4,4,10,9,19,27,16,43,0.000333,0.060887,5,913.304415,50.739134,182.660883,61.748606,1,0
0,0,4,4,10,9,19,27,16,43,0.000333,0.060887,5,913.304415,50.739134,182.660883,61.748606,1,0
0,0,4,4,10,9,19,27,16,43,0.000333,0.060887,5,913.304415,50.739134,182.660883,61.748606,1,0
0,0,4,4,10,9,19,27,16,43,0.000333,0.060887,5,913.304415,50.739134,182.660883,61.748606,1,0
0,0,4,4,10,9,19,27,16,43,0.000333,0.060887,5,913.304415,50.739134,182.660883,61.748606,1,0
0,0,4,4,10,9,19,27,16,43,0.000333,0.060887,5,913.304415,50.739134,182.660883,61.748606,1,0
0,0,4,4,10,9,19,27,16,43,0.000333,0.060887,5,913.304415,50.739134,182.660883,61.748606,1,0
0,0,4,4,10,9,19,27,16,43,0.000333,0.060887,5,913.304415,50.739134,182.660883,61.748606,1,0
0,0,4,4,10,9,19,27,16,43,0.000333,0.060887,5,913.304415,50.739134,182.660883,61.748606,1,0
0,0,4,4,10,9,19,27,16,43,0.000333,0.060887,5,913.304415,50.739134,182.660883,61.748606,1,0
0,0,4,4,10,9,19,27,16,43,0.000333,0.060887,5,913.304415,50.739134,182.660883,61.748606,1,0
0,0,4,4,10,9,19,27,16,43,0.000333,0.060887,5,913.304415,50.739134,182.660883,61.748606,1,0
0,0,4,4,10,9,19,27,16,43,0.000333,0.060887,5,913.304415,50.739134,182.660883,61.748606,1,0
0,0,4,4,10,9,19,27,16,43,0.000333,0.060887,5,913.304415,50.739134,182.660883,61.748606,1,0
0,0,4,4,10,9,19,27,16,43,0.000333,0.060887,5,913.304415,50.739134,182.660883,61.748606,1,0
0,0,4,4,10,9,19,27,16,43,0.000333,0.060887,5,913.304415,50.739134,182.660883,61.748606,1,0
0,0,4,4,10,9,19,27,16,43,0.000333,0.060887,5,913.304415,50.739134,182.660883,61.748606,1,0
0,0,4,4,10,9,19,27,16,43,0.000333,0.060887,5,913.304415,50.739134,182.660883,61.748606,1,0
0,0,4,4,10,9,19,27,16,43,0.000333,0.060887,5,913.304415,50.739134,182.660883,61.748606,1,0
0,0,4,4,10,9,19,27,16,43,0.000333,0.060887,5,913.304415,50.739134,182.660883,61.748606,1,0
0,0,4,4,10,9,19,27,16,43,0.000333,0.060887,5,913.304415,50.739134,182.660883,61.748606,1,0
0,0,4,4,10,9,19,27,16,43,0.000333,0.060887,5,913.304415,50.739134,182.660883,61.748606,1,0
0,0,4,4,10,9,19,27,16,43,0.000333,0.060887,5,913.304415,50.739134,182.660883,61.748606,1,0
0,0,4,4,10,9,19,27,16,43,0.000333,0.060887,5,913.304415,50.739134,182.660883,61.748606,1,0
0,0,4,4,10,9,19,27,16,43,0.000333,0.060887,5,913.304415,50.739134,182.660883,61.748606,1,0
0,0,4,4,10,9,19,27,16,43,0.000333,0.060887,5,913.304415,50.739134,182.660883,61.748606,1,0
0,0,4,4,10,9,19,27,16,43,0.000333,0.060887,5,913.304415,50.739134,182.660883,61.748606,1,0
0,0,4,4,10,9,19,27,16,43,0.000333,0.060887,5,913.304415,50.739134,182.660883,61.748606,1,0
0,0,4,4,10,9,19,27,16,43,0.000333,0.060887,5,913.304415,50.739134,182.660883,61.748606,1,0
0,0,4,4,10,9,19,27,16,43,0.000333,0.060887,5,913.304415,50.739134,182.660883,61.748606,1,0
0,0,4,4,10,9,19,27,16,43,0.000333,0.060887,5,913.304415,50.739134,182.660883,61.748606,1,0
0,0,8,8,12,12,24,42,33,75,0.000333,0.114624,12,4126.466251,229.248125,343.872188,86.0391,1,0
0,0,8,8,12,12,24,42,33,75,0.000333,0.114624,12,4126.466251,229.248125,343.872188,86.0391,1,0
0,0,8,8,11,15,26,41,42,83,0.000333,0.130045,10,3901.364966,216.742498,390.136497,96.657107,1,0
0,0,8,8,11,15,26,41,42,83,0.000333,0.130045,10,3901.364966,216.742498,390.136497,96.657107,1,0
0,0,6,6,10,10,20,33,22,55,0.000333,0.079235,10,2377.060452,132.058914,237.706045,66.438562,1,0
0,0,9,9,11,11,22,48,30,78,0.000333,0.115945,10,3478.356663,193.242037,347.835666,76.107496,1,0
0,0,7,7,11,16,27,35,28,63,0.000333,0.099853,5,1497.789563,83.210531,299.557913,102.053748,1,0
0,0,6,6,10,15,25,33,30,63,0.000333,0.097521,10,2925.6294,162.534967,292.56294,91.82264,1,0
0,0,8,8,12,11,23,42,30,72,0.000333,0.108565,12,3908.35753,217.130974,325.696461,81.073298,1,0
0,0,7,7,11,13,24,42,28,70,0.000333,0.106982,10,3209.473751,178.304097,320.947375,86.159464,1,0
0,0,8,8,11,17,28,34,34,68,0.000333,0.108967,10,3269.001347,181.611186,326.900135,107.540616,1,0
0,0,6,6,10,15,25,33,30,63,0.000333,0.097521,10,2925.6294,162.534967,292.56294,91.82264,1,0
0,0,8,8,10,16,26,39,44,83,0.000333,0.130045,10,3901.364966,216.742498,390.136497,97.219281,1,0
0,0,10,10,10,17,27,45,58,103,0.000333,0.163251,15,7346.301191,408.127844,489.753413,102.706149,1,0
0,0,12,12,10,18,28,51,72,123,0.000333,0.197102,20,11826.09311,657.005173,591.304655,108.277931,1,0
0,0,8,8,11,14,25,41,39,80,0.000333,0.123836,10,3715.084952,206.393608,371.508495,91.356717,1,0
0,0,7,7,11,16,27,39,33,72,0.000333,0.114117,10,3423.519002,190.1955,342.3519,102.053748,1,0
0,0,8,8,11,17,28,48,37,85,0.000333,0.136208,10,4086.251684,227.013982,408.625168,107.540616,1,0
0,0,7,7,10,16,26,41,34,75,0.000333,0.117511,10,3525.329789,195.851655,352.532979,97.219281,1,0
0,0,9,9,10,18,28,48,40,88,0.000333,0.141016,10,4230.472331,235.026241,423.047233,108.277931,1,0
0,0,9,9,11,18,29,40,45,85,0.000333,0.137643,10,4129.283846,229.404658,412.928385,113.112398,1,0
0,0,8,8,10,17,27,33,40,73,0.000333,0.115702,10,3471.067877,192.837104,347.106788,102.706149,1,0
0,0,7,7,14,18,32,40,38,78,0.000333,0.13,14,5460,303.333333,390,128.361619,1,0
0,0,7,7,13,18,31,39,38,77,0.000333,0.127158,12,4577.677391,254.315411,381.473116,123.164366,1,0
0,0,4,4,11,9,20,29,16,45,0.000333,0.064829,5,972.433821,54.024101,194.486764,66.583073,1,0
0,0,4,4,11,9,20,29,16,45,0.000333,0.064829,5,972.433821,54.024101,194.486764,66.583073,1,0
0,0,4,4,11,9,20,29,16,45,0.000333,0.064829,5,972.433821,54.024101,194.486764,66.583073,1,0
0,0,12,12,16,14,30,47,29,76,0.000333,0.124308,16,5966.778964,331.48772,372.923685,117.302969,2,0
0,0,11,11,13,14,27,44,29,73,0.000333,0.115702,12,4165.281452,231.404525,347.106788,101.408685,2,0
0,0,10,10,15,14,29,47,29,76,0.000333,0.123069,14,5168.891779,287.160654,369.206556,111.906328,2,0
0,0,9,9,12,14,26,44,29,73,0.000333,0.114377,12,4117.585193,228.754733,343.132099,96.322519,2,0
0,0,10,10,14,14,28,45,29,74,0.000333,0.118581,14,4980.419699,276.689983,355.744264,106.605938,2,0
0,0,9,9,11,14,25,42,29,71,0.000333,0.109905,10,3297.137895,183.174327,329.713789,91.356717,2,0
0,0,8,8,14,11,25,41,23,64,0.000333,0.099069,14,4160.895146,231.160841,297.206796,91.356717,2,0
0,0,7,7,11,11,22,38,23,61,0.000333,0.090675,10,2720.253287,151.125183,272.025329,76.107496,2,0
0,0,9,9,16,13,29,45,27,72,0.000333,0.116592,16,5596.394106,310.910784,349.774632,112.105716,2,0
0,0,8,8,12,13,25,41,27,68,0.000333,0.105261,12,3789.386651,210.521481,315.782221,91.125266,2,0
0,0,9,9,15,13,28,44,27,71,0.000333,0.113774,14,4778.510793,265.472822,341.322199,106.709075,2,0
0,0,8,8,11,13,24,40,27,67,0.000333,0.102397,10,3071.924875,170.662493,307.192488,86.159464,2,0
0,0,11,11,15,12,27,46,24,70,0.000333,0.110947,14,4659.789752,258.877208,332.842125,101.622909,2,0
0,0,11,11,15,11,26,46,24,70,0.000333,0.109677,14,4606.430924,255.912829,329.03078,96.657107,2,0
0,0,8,8,12,10,22,40,23,63,0.000333,0.093648,12,3371.330304,187.296128,280.944192,76.238831,2,0
0,0,7,7,13,12,25,43,27,70,0.000333,0.108357,12,3900.839199,216.713289,325.069933,91.125266,2,0
0,0,8,8,12,11,23,38,24,62,0.000333,0.093487,12,3365.530095,186.973894,280.460841,81.073298,1,0
0,0,12,12,16,15,31,54,41,95,0.000333,0.156883,16,7530.378392,418.354355,470.648649,122.603359,2,0
0,0,11,11,13,14,27,51,41,92,0.000333,0.145817,12,5249.395802,291.6331,437.44965,101.408685,2,0
0,0,12,12,15,18,33,53,53,106,0.000333,0.178235,14,7485.880873,415.882271,534.705777,133.662009,2,0
0,0,11,11,12,17,29,50,53,103,0.000333,0.166791,18,9006.696765,500.372042,500.372042,112.506418,2,0
0,0,8,8,10,11,21,41,28,69,0.000333,0.101023,10,3030.699022,168.372168,303.069902,71.273029,1,0
0,0,11,11,11,12,23,56,36,92,0.000333,0.138723,15,6242.515499,346.806417,416.1677,81.073298,1,0
0,0,13,13,14,17,31,51,42,93,0.000333,0.15358,14,6450.363596,358.353533,460.740257,122.789837,1,0
0,0,8,8,10,16,26,41,36,77,0.000333,0.120645,10,3619.338583,201.074366,361.933858,97.219281,1,0
0,0,9,9,12,12,24,46,32,78,0.000333,0.119209,12,4291.524901,238.41805,357.627075,86.0391,1,0
0,0,9,9,11,14,25,50,34,84,0.000333,0.130028,10,3900.839199,216.713289,390.08392,91.356717,1,0
0,0,10,10,11,18,29,42,40,82,0.000333,0.132785,10,3983.544416,221.308023,398.354442,113.112398,1,0
0,0,8,8,10,16,26,41,36,77,0.000333,0.120645,10,3619.338583,201.074366,361.933858,97.219281,1,0
0,0,10,10,10,17,27,47,50,97,0.000333,0.153741,10,4612.240877,256.235604,461.224088,102.706149,1,0
0,0,12,12,10,18,28,53,64,117,0.000333,0.187487,15,8436.907888,468.717105,562.460526,108.277931,1,0
0,0,12,12,10,19,29,53,64,117,0.000333,0.189461,15,8525.756646,473.653147,568.383776,113.929904,1,0
0,0,9,9,11,15,26,45,38,83,0.000333,0.130045,10,3901.364966,216.742498,390.136497,96.657107,1,0
0,0,9,9,11,17,28,47,39,86,0.000333,0.137811,10,4134.325233,229.684735,413.432523,107.540616,1,0
0,0,10,10,11,18,29,56,43,99,0.000333,0.160313,10,4809.401185,267.188955,480.940119,113.112398,1,0
0,0,9,9,10,17,27,49,40,89,0.000333,0.141062,10,4231.849877,235.102771,423.184988,102.706149,1,0
0,0,11,11,10,19,29,56,46,102,0.000333,0.165171,10,4955.140615,275.28559,495.514062,113.929904,1,0
0,0,14,14,14,20,34,54,61,115,0.000333,0.195019,21,12286.22276,682.567931,585.058227,139.741531,1,0
0,0,10,10,10,18,28,41,46,87,0.000333,0.139413,10,4182.398782,232.355488,418.239878,108.277931,1,0
0,0,9,9,14,19,33,48,44,92,0.000333,0.154695,14,6497.179626,360.954424,464.084259,134.013592,1,0
0,0,10,10,14,19,33,49,45,94,0.000333,0.158058,14,6638.422661,368.801259,474.173047,134.013592,1,0
0,0,11,11,12,16,28,38,31,69,0.000333,0.110569,6,1990.244938,110.569163,331.70749,107.01955,3,0
0,0,13,13,15,17,32,44,32,76,0.000333,0.126667,7,2660,147.777778,380,128.090227,4,0
0,0,12,12,13,16,29,41,32,73,0.000333,0.118211,12,4255.591352,236.421742,354.632613,112.105716,4,0
0,0,13,13,16,17,33,45,33,78,0.000333,0.131154,8,3147.70193,174.872329,393.462741,133.486868,4,0
0,0,12,12,13,17,30,41,33,74,0.000333,0.121037,6,2178.659424,121.036635,363.109904,117.592585,4,0
0,0,15,15,17,20,37,52,38,90,0.000333,0.156284,8,3750.806423,208.378135,468.850803,155.92543,4,0
0,0,14,14,15,20,35,49,38,87,0.000333,0.148749,7,3123.733357,173.540742,446.247622,145.041921,4,0
0,0,15,15,16,20,36,50,38,88,0.000333,0.151651,8,3639.627201,202.201511,454.9534,150.438562,4,0
0,0,14,14,14,20,34,47,38,85,0.000333,0.144145,7,3027.040391,168.168911,432.434342,139.741531,4,0
0,0,14,14,18,19,37,49,36,85,0.000333,0.147601,9,3985.231825,221.401768,442.803536,155.769273,4,0
0,0,13,13,15,19,34,45,36,81,0.000333,0.137361,7,2884.591431,160.255079,412.08449,139.313982,4,0
0,0,14,14,17,19,36,48,36,84,0.000333,0.144758,8,3474.189601,193.010533,434.2737,150.197491,4,0
0,0,13,13,14,19,33,44,36,80,0.000333,0.134517,7,2824.860707,156.936706,403.55153,134.013592,4,0
0,0,17,17,17,20,37,50,38,88,0.000333,0.152811,8,3667.455169,203.747509,458.431896,155.92543,4,0
0,0,16,16,15,20,35,47,38,85,0.000333,0.14533,7,3051.923395,169.5513,435.989056,145.041921,4,0
0,0,15,15,16,20,36,50,38,88,0.000333,0.151651,8,3639.627201,202.201511,454.9534,150.438562,4,0
0,0,14,14,14,20,34,47,38,85,0.000333,0.144145,7,3027.040391,168.168911,432.434342,139.741531,4,0
0,0,15,15,15,20,35,48,38,86,0.000333,0.147039,7,3087.828376,171.546021,441.118339,145.041921,4,0
0,0,14,14,13,20,33,45,38,83,0.000333,0.139562,6,2512.108271,139.561571,418.684712,134.544278,4,0
0,0,17,17,16,20,36,48,38,86,0.000333,0.148205,8,3556.908401,197.606022,444.61355,150.438562,4,0
0,0,16,16,14,20,34,45,38,83,0.000333,0.140753,7,2955.815911,164.211995,422.259416,139.741531,4,0
0,0,14,14,17,19,36,48,36,84,0.000333,0.144758,8,3474.189601,193.010533,434.2737,150.197491,4,0
0,0,13,13,14,19,33,44,36,80,0.000333,0.134517,7,2824.860707,156.936706,403.55153,134.013592,4,0
0,0,14,14,16,19,35,47,36,83,0.000333,0.14191,8,3405.843923,189.213551,425.73049,144.710623,4,0
0,0,13,13,13,19,32,43,36,79,0.000333,0.131667,6,2370,131.666667,395,128.816339,4,0
0,0,16,16,17,18,35,49,33,82,0.000333,0.1402,8,3364.809659,186.93387,420.601207,144.545518,4,0
0,0,16,16,17,17,34,49,33,82,0.000333,0.139057,8,3337.375624,185.409757,417.171953,138.973737,4,0
0,0,13,13,14,16,30,43,32,75,0.000333,0.122672,14,5152.235125,286.235285,368.016795,117.302969,4,0
0,0,12,12,15,18,33,46,36,82,0.000333,0.13788,14,5790.964449,321.720247,413.640318,133.662009,4,0
0,0,13,13,14,17,31,41,33,74,0.000333,0.122204,7,2566.273689,142.57076,366.610527,122.789837,3,0
0,0,17,17,17,21,38,57,50,107,0.000333,0.187176,16,8984.451903,499.136217,561.528244,161.725534,4,0
0,0,16,16,15,20,35,54,50,104,0.000333,0.177815,14,7468.236073,414.902004,533.445434,145.041921,4,0
0,0,17,17,16,24,40,56,62,118,0.000333,0.209329,16,10047.80024,558.211125,627.987515,174.0391,4,0
0,0,16,16,14,23,37,53,62,115,0.000333,0.199696,14,8387.219919,465.956662,599.087137,157.344894,4,0
0,0,13,13,12,17,29,44,37,81,0.000333,0.131165,12,4721.957527,262.330974,393.496461,112.506418,3,0
0,0,16,16,13,18,31,59,45,104,0.000333,0.171745,12,6182.836995,343.490944,515.236416,123.164366,3,0
0,0,18,18,16,23,39,54,51,105,0.000333,0.184989,16,8879.475728,493.304207,554.967233,168.041925,3,0
0,0,13,13,12,22,34,44,45,89,0.000333,0.150928,12,5433.410314,301.856129,452.784193,141.127046,3,0
0,0,14,14,14,18,32,49,41,90,0.000333,0.15,14,6300,350,450,128.361619,3,0
0,0,14,14,13,20,33,53,43,96,0.000333,0.161421,12,5811.142026,322.841224,484.261835,134.544278,3,0
0,0,15,15,13,24,37,45,49,94,0.000333,0.16323,12,5876.263396,326.459078,489.688616,158.144816,3,0
0,0,13,13,12,22,34,44,45,89,0.000333,0.150928,12,5433.410314,301.856129,452.784193,141.127046,3,0
0,0,15,15,12,23,35,50,59,109,0.000333,0.186364,12,6709.102186,372.727899,559.091849,147.061475,3,0
0,0,17,17,12,24,36,56,73,129,0.000333,0.222307,18,12004.56585,666.920325,666.920325,153.05865,3,0
0,0,19,19,12,25,37,62,87,149,0.000333,0.258736,18,13971.75393,776.208551,776.208551,159.115955,3,0
0,0,14,14,13,21,34,48,47,95,0.000333,0.161103,12,5799.707639,322.20598,483.30897,140.344382,3,0
0,0,14,14,13,23,36,50,48,98,0.000333,0.168884,12,6079.831802,337.768433,506.65265,152.147641,3,0
0,0,15,15,13,24,37,59,52,111,0.000333,0.19275,12,6938.991883,385.499549,578.249324,158.144816,3,0
0,0,14,14,12,23,35,52,49,101,0.000333,0.172686,12,6216.691017,345.371723,518.057585,147.061475,3,0
0,0,16,16,12,25,37,59,55,114,0.000333,0.197959,12,7126.532204,395.918456,593.877684,159.115955,3,0
0,0,19,19,16,26,42,57,70,127,0.000333,0.228275,16,10957.189,608.732722,684.824313,186.211433,3,0
0,0,15,15,12,24,36,44,55,99,0.000333,0.170608,12,6141.870902,341.21505,511.822575,153.05865,3,0
0,0,14,14,16,25,41,51,53,104,0.000333,0.185728,16,8914.966536,495.275919,557.185408,180.096405,3,0
0,0,15,15,16,25,41,52,54,106,0.000333,0.1893,16,9086.4082,504.800456,567.900512,180.096405,3,0
0,0,8,8,10,10,20,37,24,61,0.000333,0.087879,10,2636.376138,146.465341,263.637614,66.438562,1,0
0,0,10,10,14,10,24,43,25,68,0.000333,0.103926,14,4364.884301,242.493572,311.77745,86.52225,2,0
0,0,9,9,11,10,21,40,25,65,0.000333,0.095167,10,2855.006325,158.611462,285.500632,71.273029,2,0
0,0,10,10,15,11,26,44,26,70,0.000333,0.109677,14,4606.430924,255.912829,329.03078,96.657107,2,0
0,0,9,9,11,11,22,40,26,66,0.000333,0.098107,10,2943.224868,163.512493,294.322487,76.107496,2,0
0,0,12,12,16,13,29,51,31,82,0.000333,0.132785,16,6373.671066,354.092837,398.354442,112.105716,2,0
0,0,11,11,13,13,26,48,31,79,0.000333,0.123778,12,4456.016853,247.556492,371.334738,96.211433,2,0
0,0,12,12,15,13,28,49,31,80,0.000333,0.128196,14,5384.237513,299.124306,384.588394,106.709075,2,0
0,0,11,11,12,13,25,46,31,77,0.000333,0.119192,12,4290.923119,238.384618,357.576927,91.125266,2,0
0,0,11,11,17,13,30,48,29,77,0.000333,0.125944,16,6045.289214,335.849401,377.830576,117.592585,2,0
0,0,10,10,13,13,26,44,29,73,0.000333,0.114377,12,4117.585193,228.754733,343.132099,96.211433,2,0
0,0,11,11,16,13,29,47,29,76,0.000333,0.123069,16,5907.30489,328.183605,369.206556,112.105716,2,0
0,0,10,10,12,13,25,43,29,72,0.000333,0.111453,12,4012.291748,222.905097,334.357646,91.125266,2,0
0,0,14,14,16,13,29,49,31,80,0.000333,0.129546,16,6218.215674,345.456426,388.63848,112.105716,2,0
0,0,13,13,13,13,26,46,31,77,0.000333,0.120645,12,4343.2063,241.289239,361.933858,96.211433,2,0
0,0,12,12,15,13,28,49,31,80,0.000333,0.128196,14,5384.237513,299.124306,384.588394,106.709075,2,0
0,0,11,11,12,13,25,46,31,77,0.000333,0.119192,12,4290.923119,238.384618,357.576927,91.125266,2,0
0,0,12,12,14,13,27,47,31,78,0.000333,0.123627,14,5192.337152,288.463175,370.881225,101.408685,2,0
0,0,11,11,11,13,24,44,31,75,0.000333,0.114624,10,3438.721876,191.040104,343.872188,86.159464,2,0
0,0,14,14,15,13,28,47,31,78,0.000333,0.124991,14,5249.631575,291.646199,374.973684,106.709075,2,0
0,0,13,13,12,13,25,44,31,75,0.000333,0.116096,12,4179.470571,232.192809,348.289214,91.125266,2,0
0,0,11,11,16,13,29,47,29,76,0.000333,0.123069,16,5907.30489,328.183605,369.206556,112.105716,2,0
0,0,10,10,12,13,25,43,29,72,0.000333,0.111453,12,4012.291748,222.905097,334.357646,91.125266,2,0
0,0,11,11,15,13,28,46,29,75,0.000333,0.120184,14,5047.722668,280.429037,360.551619,106.709075,2,0
0,0,10,10,11,13,24,42,29,71,0.000333,0.108511,10,3255.323376,180.851299,325.532338,86.159464,2,0
0,0,13,13,15,12,27,48,26,74,0.000333,0.117287,14,4926.063452,273.670192,351.861675,101.622909,2,0
0,0,13,13,15,11,26,48,26,74,0.000333,0.115944,14,4869.655548,270.536419,347.832539,96.657107,2,0
0,0,10,10,12,10,22,42,25,67,0.000333,0.099594,12,3585.383021,199.187946,298.781918,76.238831,2,0
0,0,9,9,13,11,24,45,29,74,0.000333,0.113096,12,4071.446701,226.191483,339.287225,86.159464,2,0
0,0,10,10,12,10,22,40,26,66,0.000333,0.098107,12,3531.869842,196.214991,294.322487,76.238831,1,0
0,0,14,14,16,14,30,56,43,99,0.000333,0.161927,24,11658.77206,647.709559,485.782169,117.302969,2,0
0,0,13,13,13,14,27,53,43,96,0.000333,0.152156,18,8216.445604,456.4692,456.4692,101.408685,2,0
0,0,14,14,15,16,31,55,51,106,0.000333,0.175048,21,11028.04099,612.668944,525.144809,122.603359,2,0
0,0,13,13,12,16,28,52,51,103,0.000333,0.165053,18,8912.836025,495.157557,495.157557,107.01955,2,0
0,0,10,10,10,11,21,43,30,73,0.000333,0.10688,10,3206.391719,178.132873,320.639172,71.273029,1,0
0,0,13,13,11,12,23,58,38,96,0.000333,0.144754,15,6513.929217,361.884956,434.261948,81.073298,1,0
0,0,15,15,14,16,30,53,42,95,0.000333,0.155385,14,6526.164492,362.564694,466.154607,117.302969,1,0
0,0,10,10,10,15,25,43,36,79,0.000333,0.122288,10,3668.64639,203.813688,366.864639,91.82264,1,0
0,0,11,11,12,12,24,48,34,82,0.000333,0.125322,12,4511.603101,250.644617,375.966925,86.0391,1,0
0,0,11,11,11,14,25,52,36,88,0.000333,0.13622,10,4086.593447,227.032969,408.659345,91.356717,1,0
0,0,12,12,11,17,28,44,40,84,0.000333,0.134606,10,4038.178135,224.34323,403.817813,107.540616,1,0
0,0,10,10,10,15,25,43,36,79,0.000333,0.122288,10,3668.64639,203.813688,366.864639,91.82264,1,0
0,0,12,12,10,17,27,49,48,97,0.000333,0.153741,10,4612.240877,256.235604,461.224088,102.706149,1,0
0,0,14,14,10,17,27,55,60,115,0.000333,0.182271,15,8202.180941,455.676719,546.812063,102.706149,1,0
0,0,16,16,10,18,28,61,72,133,0.000333,0.213126,20,12787.56409,710.420227,639.378205,108.277931,1,0
0,0,11,11,11,14,25,47,38,85,0.000333,0.131576,10,3947.277761,219.293209,394.727776,91.356717,1,0
0,0,11,11,11,16,27,49,39,88,0.000333,0.139477,10,4184.301002,232.461167,418.4301,102.053748,1,0
0,0,12,12,11,17,28,58,43,101,0.000333,0.161848,10,4855.428471,269.746026,485.542847,107.540616,1,0
0,0,11,11,10,16,26,51,40,91,0.000333,0.14258,10,4277.400144,237.633341,427.740014,97.219281,1,0
0,0,13,13,10,18,28,58,46,104,0.000333,0.166655,10,4999.649119,277.758284,499.964912,108.277931,1,0
0,0,16,16,14,19,33,56,57,113,0.000333,0.190006,21,11970.34725,665.019291,570.016535,134.013592,1,0
0,0,12,12,10,17,27,43,44,87,0.000333,0.137892,10,4136.752127,229.819563,413.675213,102.706149,1,0
0,0,11,11,14,18,32,50,43,93,0.000333,0.155,14,6510,361.666667,465,128.361619,1,0
0,0,12,12,14,18,32,51,44,95,0.000333,0.158333,14,6650,369.444444,475,128.361619,1,0
0,0,8,8,10,10,20,37,24,61,0.000333,0.087879,10,2636.376138,146.465341,263.637614,66.438562,1,0
0,0,10,10,14,10,24,43,25,68,0.000333,0.103926,14,4364.884301,242.493572,311.77745,86.52225,2,0
0,0,9,9,11,10,21,40,25,65,0.000333,0.095167,10,2855.006325,158.611462,285.500632,71.273029,2,0
0,0,10,10,15,11,26,44,26,70,0.000333,0.109677,14,4606.430924,255.912829,329.03078,96.657107,2,0
0,0,9,9,11,11,22,40,26,66,0.000333,0.098107,10,2943.224868,163.512493,294.322487,76.107496,2,0
0,0,12,12,16,13,29,51,31,82,0.000333,0.132785,16,6373.671066,354.092837,398.354442,112.105716,2,0
0,0,11,11,13,13,26,48,31,79,0.000333,0.123778,12,4456.016853,247.556492,371.334738,96.211433,2,0
0,0,12,12,15,13,28,49,31,80,0.000333,0.128196,14,5384.237513,299.124306,384.588394,106.709075,2,0
0,0,11,11,12,13,25,46,31,77,0.000333,0.119192,12,4290.923119,238.384618,357.576927,91.125266,2,0
0,0,11,11,17,13,30,48,29,77,0.000333,0.125944,16,6045.289214,335.849401,377.830576,117.592585,2,0
0,0,10,10,13,13,26,44,29,73,0.000333,0.114377,12,4117.585193,228.754733,343.132099,96.211433,2,0
0,0,11,11,16,13,29,47,29,76,0.000333,0.123069,16,5907.30489,328.183605,369.206556,112.105716,2,0
0,0,10,10,12,13,25,43,29,72,0.000333,0.111453,12,4012.291748,222.905097,334.357646,91.125266,2,0
0,0,14,14,16,13,29,49,31,80,0.000333,0.129546,16,6218.215674,345.456426,388.63848,112.105716,2,0
0,0,13,13,13,13,26,46,31,77,0.000333,0.120645,12,4343.2063,241.289239,361.933858,96.211433,2,0
0,0,12,12,15,13,28,49,31,80,0.000333,0.128196,14,5384.237513,299.124306,384.588394,106.709075,2,0
0,0,11,11,12,13,25,46,31,77,0.000333,0.119192,12,4290.923119,238.384618,357.576927,91.125266,2,0
0,0,12,12,14,13,27,47,31,78,0.000333,0.123627,14,5192.337152,288.463175,370.881225,101.408685,2,0
0,0,11,11,11,13,24,44,31,75,0.000333,0.114624,10,3438.721876,191.040104,343.872188,86.159464,2,0
0,0,14,14,15,13,28,47,31,78,0.000333,0.124991,14,5249.631575,291.646199,374.973684,106.709075,2,0
0,0,13,13,12,13,25,44,31,75,0.000333,0.116096,12,4179.470571,232.192809,348.289214,91.125266,2,0
0,0,11,11,16,13,29,47,29,76,0.000333,0.123069,16,5907.30489,328.183605,369.206556,112.105716,2,0
0,0,10,10,12,13,25,43,29,72,0.000333,0.111453,12,4012.291748,222.905097,334.357646,91.125266,2,0
0,0,11,11,15,13,28,46,29,75,0.000333,0.120184,14,5047.722668,280.429037,360.551619,106.709075,2,0
0,0,10,10,11,13,24,42,29,71,0.000333,0.108511,10,3255.323376,180.851299,325.532338,86.159464,2,0
0,0,13,13,15,12,27,48,26,74,0.000333,0.117287,14,4926.063452,273.670192,351.861675,101.622909,2,0
0,0,13,13,15,11,26,48,26,74,0.000333,0.115944,14,4869.655548,270.536419,347.832539,96.657107,2,0
0,0,10,10,12,10,22,42,25,67,0.000333,0.099594,12,3585.383021,199.187946,298.781918,76.238831,2,0
0,0,9,9,13,11,24,45,29,74,0.000333,0.113096,12,4071.446701,226.191483,339.287225,86.159464,2,0
0,0,10,10,12,10,22,40,26,66,0.000333,0.098107,12,3531.869842,196.214991,294.322487,76.238831,1,0
0,0,14,14,16,14,30,56,43,99,0.000333,0.161927,24,11658.77206,647.709559,485.782169,117.302969,2,0
0,0,13,13,13,14,27,53,43,96,0.000333,0.152156,18,8216.445604,456.4692,456.4692,101.408685,2,0
0,0,14,14,15,16,31,55,51,106,0.000333,0.175048,21,11028.04099,612.668944,525.144809,122.603359,2,0
0,0,13,13,12,16,28,52,51,103,0.000333,0.165053,18,8912.836025,495.157557,495.157557,107.01955,2,0
0,0,10,10,10,11,21,43,30,73,0.000333,0.10688,10,3206.391719,178.132873,320.639172,71.273029,1,0
0,0,13,13,11,12,23,58,38,96,0.000333,0.144754,15,6513.929217,361.884956,434.261948,81.073298,1,0
0,0,15,15,14,16,30,53,42,95,0.000333,0.155385,14,6526.164492,362.564694,466.154607,117.302969,1,0
0,0,10,10,10,15,25,43,36,79,0.000333,0.122288,10,3668.64639,203.813688,366.864639,91.82264,1,0
0,0,11,11,12,12,24,48,34,82,0.000333,0.125322,12,4511.603101,250.644617,375.966925,86.0391,1,0
0,0,11,11,11,14,25,52,36,88,0.000333,0.13622,10,4086.593447,227.032969,408.659345,91.356717,1,0
0,0,12,12,11,17,28,44,40,84,0.000333,0.134606,10,4038.178135,224.34323,403.817813,107.540616,1,0
0,0,10,10,10,15,25,43,36,79,0.000333,0.122288,10,3668.64639,203.813688,366.864639,91.82264,1,0
0,0,12,12,10,16,26,49,48,97,0.000333,0.151981,15,6839.13979,379.952211,455.942653,97.219281,1,0
0,0,14,14,10,17,27,55,60,115,0.000333,0.182271,15,8202.180941,455.676719,546.812063,102.706149,1,0
0,0,16,16,10,18,28,61,72,133,0.000333,0.213126,20,12787.56409,710.420227,639.378205,108.277931,1,0
0,0,11,11,11,14,25,47,38,85,0.000333,0.131576,10,3947.277761,219.293209,394.727776,91.356717,1,0
0,0,11,11,11,16,27,49,39,88,0.000333,0.139477,10,4184.301002,232.461167,418.4301,102.053748,1,0
0,0,12,12,11,17,28,58,43,101,0.000333,0.161848,10,4855.428471,269.746026,485.542847,107.540616,1,0
0,0,11,11,10,16,26,51,40,91,0.000333,0.14258,10,4277.400144,237.633341,427.740014,97.219281,1,0
0,0,13,13,10,18,28,58,46,104,0.000333,0.166655,10,4999.649119,277.758284,499.964912,108.277931,1,0
0,0,16,16,14,19,33,56,57,113,0.000333,0.190006,21,11970.34725,665.019291,570.016535,134.013592,1,0
0,0,12,12,10,17,27,43,44,87,0.000333,0.137892,10,4136.752127,229.819563,413.675213,102.706149,1,0
0,0,11,11,14,18,32,50,43,93,0.000333,0.155,14,6510,361.666667,465,128.361619,1,0
0,0,12,12,14,18,32,51,44,95,0.000333,0.158333,14,6650,369.444444,475,128.361619,1,0
0,0,8,8,10,10,20,37,24,61,0.000333,0.087879,10,2636.376138,146.465341,263.637614,66.438562,1,0
0,0,10,10,14,10,24,43,25,68,0.000333,0.103926,14,4364.884301,242.493572,311.77745,86.52225,2,0
0,0,9,9,11,10,21,40,25,65,0.000333,0.095167,10,2855.006325,158.611462,285.500632,71.273029,2,0
0,0,10,10,15,11,26,44,26,70,0.000333,0.109677,14,4606.430924,255.912829,329.03078,96.657107,2,0
0,0,9,9,11,11,22,40,26,66,0.000333,0.098107,10,2943.224868,163.512493,294.322487,76.107496,2,0
0,0,12,12,16,13,29,51,31,82,0.000333,0.132785,16,6373.671066,354.092837,398.354442,112.105716,2,0
0,0,11,11,13,13,26,48,31,79,0.000333,0.123778,12,4456.016853,247.556492,371.334738,96.211433,2,0
0,0,12,12,15,13,28,49,31,80,0.000333,0.128196,14,5384.237513,299.124306,384.588394,106.709075,2,0
0,0,11,11,12,13,25,46,31,77,0.000333,0.119192,12,4290.923119,238.384618,357.576927,91.125266,2,0
0,0,11,11,17,13,30,48,29,77,0.000333,0.125944,16,6045.289214,335.849401,377.830576,117.592585,2,0
0,0,10,10,13,13,26,44,29,73,0.000333,0.114377,12,4117.585193,228.754733,343.132099,96.211433,2,0
0,0,11,11,16,13,29,47,29,76,0.000333,0.123069,16,5907.30489,328.183605,369.206556,112.105716,2,0
0,0,10,10,12,13,25,43,29,72,0.000333,0.111453,12,4012.291748,222.905097,334.357646,91.125266,2,0
0,0,14,14,16,13,29,49,31,80,0.000333,0.129546,16,6218.215674,345.456426,388.63848,112.105716,2,0
0,0,13,13,13,13,26,46,31,77,0.000333,0.120645,12,4343.2063,241.289239,361.933858,96.211433,2,0
0,0,12,12,15,13,28,49,31,80,0.000333,0.128196,14,5384.237513,299.124306,384.588394,106.709075,2,0
0,0,11,11,12,13,25,46,31,77,0.000333,0.119192,12,4290.923119,238.384618,357.576927,91.125266,2,0
0,0,12,12,14,13,27,47,31,78,0.000333,0.123627,14,5192.337152,288.463175,370.881225,101.408685,2,0
0,0,11,11,11,13,24,44,31,75,0.000333,0.114624,10,3438.721876,191.040104,343.872188,86.159464,2,0
0,0,14,14,15,13,28,47,31,78,0.000333,0.124991,14,5249.631575,291.646199,374.973684,106.709075,2,0
0,0,13,13,12,13,25,44,31,75,0.000333,0.116096,12,4179.470571,232.192809,348.289214,91.125266,2,0
0,0,11,11,16,13,29,47,29,76,0.000333,0.123069,16,5907.30489,328.183605,369.206556,112.105716,2,0
0,0,10,10,12,13,25,43,29,72,0.000333,0.111453,12,4012.291748,222.905097,334.357646,91.125266,2,0
0,0,11,11,15,13,28,46,29,75,0.000333,0.120184,14,5047.722668,280.429037,360.551619,106.709075,2,0
0,0,10,10,11,13,24,42,29,71,0.000333,0.108511,10,3255.323376,180.851299,325.532338,86.159464,2,0
0,0,13,13,15,12,27,48,26,74,0.000333,0.117287,14,4926.063452,273.670192,351.861675,101.622909,2,0
0,0,13,13,15,11,26,48,26,74,0.000333,0.115944,14,4869.655548,270.536419,347.832539,96.657107,2,0
0,0,10,10,12,10,22,42,25,67,0.000333,0.099594,12,3585.383021,199.187946,298.781918,76.238831,2,0
0,0,9,9,13,11,24,45,29,74,0.000333,0.113096,12,4071.446701,226.191483,339.287225,86.159464,2,0
0,0,10,10,12,10,22,40,26,66,0.000333,0.098107,12,3531.869842,196.214991,294.322487,76.238831,1,0
0,0,14,14,16,14,30,56,43,99,0.000333,0.161927,24,11658.77206,647.709559,485.782169,117.302969,2,0
0,0,13,13,13,14,27,53,43,96,0.000333,0.152156,18,8216.445604,456.4692,456.4692,101.408685,2,0
0,0,14,14,15,16,31,55,51,106,0.000333,0.175048,21,11028.04099,612.668944,525.144809,122.603359,2,0
0,0,13,13,12,16,28,52,51,103,0.000333,0.165053,18,8912.836025,495.157557,495.157557,107.01955,2,0
0,0,10,10,10,11,21,43,30,73,0.000333,0.10688,10,3206.391719,178.132873,320.639172,71.273029,1,0
0,0,13,13,11,12,23,58,38,96,0.000333,0.144754,15,6513.929217,361.884956,434.261948,81.073298,1,0
0,0,15,15,14,16,30,53,42,95,0.000333,0.155385,14,6526.164492,362.564694,466.154607,117.302969,1,0
0,0,10,10,10,15,25,43,36,79,0.000333,0.122288,10,3668.64639,203.813688,366.864639,91.82264,1,0
0,0,11,11,12,12,24,48,34,82,0.000333,0.125322,12,4511.603101,250.644617,375.966925,86.0391,1,0
0,0,11,11,11,14,25,52,36,88,0.000333,0.13622,10,4086.593447,227.032969,408.659345,91.356717,1,0
0,0,12,12,11,17,28,44,40,84,0.000333,0.134606,10,4038.178135,224.34323,403.817813,107.540616,1,0
0,0,10,10,10,15,25,43,36,79,0.000333,0.122288,10,3668.64639,203.813688,366.864639,91.82264,1,0
0,0,12,12,10,16,26,49,48,97,0.000333,0.151981,15,6839.13979,379.952211,455.942653,97.219281,1,0
0,0,14,14,10,17,27,55,60,115,0.000333,0.182271,15,8202.180941,455.676719,546.812063,102.706149,1,0
0,0,16,16,10,18,28,61,72,133,0.000333,0.213126,20,12787.56409,710.420227,639.378205,108.277931,1,0
0,0,11,11,11,14,25,47,38,85,0.000333,0.131576,10,3947.277761,219.293209,394.727776,91.356717,1,0
0,0,11,11,11,16,27,49,39,88,0.000333,0.139477,10,4184.301002,232.461167,418.4301,102.053748,1,0
0,0,12,12,11,17,28,58,43,101,0.000333,0.161848,10,4855.428471,269.746026,485.542847,107.540616,1,0
0,0,11,11,10,16,26,51,40,91,0.000333,0.14258,10,4277.400144,237.633341,427.740014,97.219281,1,0
0,0,13,13,10,18,28,58,46,104,0.000333,0.166655,10,4999.649119,277.758284,499.964912,108.277931,1,0
0,0,16,16,14,19,33,56,57,113,0.000333,0.190006,21,11970.34725,665.019291,570.016535,134.013592,1,0
0,0,12,12,10,17,27,43,44,87,0.000333,0.137892,10,4136.752127,229.819563,413.675213,102.706149,1,0
0,0,11,11,14,18,32,50,43,93,0.000333,0.155,14,6510,361.666667,465,128.361619,1,0
0,0,12,12,14,18,32,51,44,95,0.000333,0.158333,14,6650,369.444444,475,128.361619,1,0
0,0,6,6,10,9,19,32,20,52,0.000333,0.073631,10,2208.922307,122.717906,220.892231,61.748606,1,0
0,0,8,8,14,10,24,38,21,59,0.000333,0.090171,14,3787.179026,210.398835,270.512788,86.52225,2,0
0,0,7,7,11,9,20,35,21,56,0.000333,0.080676,10,2420.279733,134.459985,242.027973,66.583073,2,0
0,0,8,8,15,10,25,39,22,61,0.000333,0.094425,14,3965.853186,220.325177,283.275228,91.82264,2,0
0,0,7,7,11,10,21,35,22,57,0.000333,0.083454,10,2503.620931,139.090052,250.362093,71.273029,2,0
0,0,10,10,16,13,29,46,27,73,0.000333,0.118211,16,5674.121802,315.228989,354.632613,112.105716,2,0
0,0,9,9,13,13,26,43,27,70,0.000333,0.109677,12,3948.369363,219.353854,329.03078,96.211433,2,0
0,0,10,10,15,13,28,44,27,71,0.000333,0.113774,14,4778.510793,265.472822,341.322199,106.709075,2,0
0,0,9,9,12,13,25,41,27,68,0.000333,0.105261,12,3789.386651,210.521481,315.782221,91.125266,2,0
0,0,9,9,17,12,29,43,25,68,0.000333,0.110114,16,5285.483323,293.637962,330.342708,112.506418,2,0
0,0,8,8,13,12,25,39,25,64,0.000333,0.099069,12,3566.481554,198.137864,297.206796,91.125266,2,0
0,0,9,9,16,12,28,42,25,67,0.000333,0.107364,16,5153.484476,286.304693,322.09278,107.01955,2,0
0,0,8,8,12,12,24,38,25,63,0.000333,0.096284,12,3466.231651,192.568425,288.852638,86.0391,2,0
0,0,12,12,16,13,29,44,27,71,0.000333,0.114972,16,5518.66641,306.592578,344.916651,112.105716,2,0
0,0,11,11,13,13,26,41,27,68,0.000333,0.106543,12,3835.55881,213.086601,319.629901,96.211433,2,0
0,0,10,10,15,13,28,44,27,71,0.000333,0.113774,14,4778.510793,265.472822,341.322199,106.709075,2,0
0,0,9,9,12,13,25,41,27,68,0.000333,0.105261,12,3789.386651,210.521481,315.782221,91.125266,2,0
0,0,10,10,14,13,27,42,27,69,0.000333,0.109362,14,4593.221327,255.178963,328.087238,101.408685,2,0
0,0,9,9,11,13,24,39,27,66,0.000333,0.100869,10,3026.07525,168.115292,302.607525,86.159464,2,0
0,0,12,12,15,13,28,42,27,69,0.000333,0.110569,14,4643.904855,257.994714,331.70749,106.709075,2,0
0,0,11,11,12,13,25,39,27,66,0.000333,0.102165,12,3677.934102,204.329672,306.494509,91.125266,2,0
0,0,9,9,16,12,28,42,25,67,0.000333,0.107364,16,5153.484476,286.304693,322.09278,107.01955,2,0
0,0,8,8,12,12,24,38,25,63,0.000333,0.096284,12,3466.231651,192.568425,288.852638,86.0391,2,0
0,0,9,9,15,12,27,41,25,66,0.000333,0.104608,14,4393.516052,244.084225,313.822575,101.622909,2,0
0,0,8,8,11,12,23,37,25,62,0.000333,0.093487,10,2804.608413,155.811578,280.460841,81.073298,2,0
0,0,11,11,15,11,26,43,22,65,0.000333,0.101843,14,4277.400144,237.633341,305.528582,96.657107,2,0
0,0,11,11,15,10,25,43,22,65,0.000333,0.100617,14,4225.909133,234.77273,301.850652,91.82264,2,0
0,0,8,8,12,9,21,37,21,58,0.000333,0.084918,12,3057.052926,169.836274,254.754411,71.548875,2,0
0,0,7,7,13,11,24,40,25,65,0.000333,0.099341,12,3576.270751,198.681708,298.022563,86.159464,2,0
0,0,8,8,12,10,22,35,22,57,0.000333,0.084729,12,3050.251227,169.458402,254.187602,76.238831,1,0
0,0,12,12,16,14,30,51,39,90,0.000333,0.147207,16,7065.922458,392.551248,441.620154,117.302969,2,0
0,0,11,11,13,13,26,48,39,87,0.000333,0.136313,18,7360.888599,408.938255,408.938255,96.211433,2,0
0,0,12,12,15,16,31,50,47,97,0.000333,0.160186,14,6727.79859,373.766588,480.557042,122.603359,2,0
0,0,11,11,12,15,27,47,47,94,0.000333,0.148986,18,8045.269654,446.959425,446.959425,101.622909,2,0
0,0,8,8,10,10,20,38,26,64,0.000333,0.092201,10,2766.033981,153.668554,276.603398,66.438562,1,0
0,0,11,11,11,11,22,53,34,87,0.000333,0.129324,15,5819.558262,323.308792,387.970551,76.107496,1,0
0,0,13,13,14,15,29,48,38,86,0.000333,0.139262,14,5849.009118,324.944951,417.786366,111.906328,1,0
0,0,8,8,10,14,24,38,32,70,0.000333,0.106982,10,3209.473751,178.304097,320.947375,86.52225,1,0
0,0,9,9,12,11,23,43,30,73,0.000333,0.110073,12,3962.640274,220.146682,330.220023,81.073298,1,0
0,0,9,9,11,13,24,47,32,79,0.000333,0.120737,10,3622.120376,201.22891,362.212038,86.159464,1,0
0,0,10,10,11,16,27,39,36,75,0.000333,0.118872,10,3566.165627,198.120313,356.616563,102.053748,1,0
0,0,8,8,10,14,24,38,32,70,0.000333,0.106982,10,3209.473751,178.304097,320.947375,86.52225,1,0
0,0,10,10,10,15,25,44,44,88,0.000333,0.13622,10,4086.593447,227.032969,408.659345,91.82264,1,0
0,0,12,12,10,16,26,50,56,106,0.000333,0.166082,15,7473.699152,415.205508,498.24661,97.219281,1,0
0,0,14,14,10,17,27,56,68,124,0.000333,0.196535,20,11792.12101,655.117834,589.60605,102.706149,1,0
0,0,9,9,11,13,24,42,34,76,0.000333,0.116152,10,3484.571501,193.587306,348.45715,86.159464,1,0
0,0,9,9,11,15,26,44,35,79,0.000333,0.123778,10,3713.347377,206.297077,371.334738,96.657107,1,0
0,0,10,10,11,16,27,53,39,92,0.000333,0.145817,10,4374.496502,243.027583,437.44965,102.053748,1,0
0,0,9,9,10,15,25,46,36,82,0.000333,0.126932,10,3807.962076,211.553449,380.796208,91.82264,1,0
0,0,11,11,10,17,27,53,42,95,0.000333,0.150571,10,4517.143127,250.952396,451.714313,102.706149,1,0
0,0,14,14,14,18,32,51,53,104,0.000333,0.173333,14,7280,404.444444,520,128.361619,1,0
0,0,10,10,10,16,26,38,40,78,0.000333,0.122211,10,3666.34298,203.685721,366.634298,97.219281,1,0
0,0,9,9,14,17,31,45,39,84,0.000333,0.138717,14,5826.134861,323.674159,416.15249,122.789837,1,0
0,0,10,10,14,17,31,46,40,86,0.000333,0.14202,14,5964.852358,331.380687,426.060883,122.789837,1,0
0,0,6,6,10,9,19,32,20,52,0.000333,0.073631,10,2208.922307,122.717906,220.892231,61.748606,1,0
0,0,8,8,14,10,24,38,21,59,0.000333,0.090171,14,3787.179026,210.398835,270.512788,86.52225,2,0
0,0,7,7,11,9,20,35,21,56,0.000333,0.080676,10,2420.279733,134.459985,242.027973,66.583073,2,0
0,0,8,8,15,10,25,39,22,61,0.000333,0.094425,14,3965.853186,220.325177,283.275228,91.82264,2,0
0,0,7,7,11,10,21,35,22,57,0.000333,0.083454,10,2503.620931,139.090052,250.362093,71.273029,2,0
0,0,10,10,16,13,29,46,27,73,0.000333,0.118211,16,5674.121802,315.228989,354.632613,112.105716,2,0
0,0,9,9,13,13,26,43,27,70,0.000333,0.109677,12,3948.369363,219.353854,329.03078,96.211433,2,0
0,0,10,10,15,13,28,44,27,71,0.000333,0.113774,14,4778.510793,265.472822,341.322199,106.709075,2,0
0,0,9,9,12,13,25,41,27,68,0.000333,0.105261,12,3789.386651,210.521481,315.782221,91.125266,2,0
0,0,9,9,17,12,29,43,25,68,0.000333,0.110114,16,5285.483323,293.637962,330.342708,112.506418,2,0
0,0,8,8,13,12,25,39,25,64,0.000333,0.099069,12,3566.481554,198.137864,297.206796,91.125266,2,0
0,0,9,9,16,12,28,42,25,67,0.000333,0.107364,16,5153.484476,286.304693,322.09278,107.01955,2,0
0,0,8,8,12,12,24,38,25,63,0.000333,0.096284,12,3466.231651,192.568425,288.852638,86.0391,2,0
0,0,12,12,16,13,29,44,27,71,0.000333,0.114972,16,5518.66641,306.592578,344.916651,112.105716,2,0
0,0,11,11,13,13,26,41,27,68,0.000333,0.106543,12,3835.55881,213.086601,319.629901,96.211433,2,0
0,0,10,10,15,13,28,44,27,71,0.000333,0.113774,14,4778.510793,265.472822,341.322199,106.709075,2,0
0,0,9,9,12,13,25,41,27,68,0.000333,0.105261,12,3789.386651,210.521481,315.782221,91.125266,2,0
0,0,10,10,14,13,27,42,27,69,0.000333,0.109362,14,4593.221327,255.178963,328.087238,101.408685,2,0
0,0,9,9,11,13,24,39,27,66,0.000333,0.100869,10,3026.07525,168.115292,302.607525,86.159464,2,0
0,0,12,12,15,13,28,42,27,69,0.000333,0.110569,14,4643.904855,257.994714,331.70749,106.709075,2,0
0,0,11,11,12,13,25,39,27,66,0.000333,0.102165,12,3677.934102,204.329672,306.494509,91.125266,2,0
0,0,9,9,16,12,28,42,25,67,0.000333,0.107364,16,5153.484476,286.304693,322.09278,107.01955,2,0
0,0,8,8,12,12,24,38,25,63,0.000333,0.096284,12,3466.231651,192.568425,288.852638,86.0391,2,0
0,0,9,9,15,12,27,41,25,66,0.000333,0.104608,14,4393.516052,244.084225,313.822575,101.622909,2,0
0,0,8,8,11,12,23,37,25,62,0.000333,0.093487,10,2804.608413,155.811578,280.460841,81.073298,2,0
0,0,11,11,15,11,26,43,22,65,0.000333,0.101843,14,4277.400144,237.633341,305.528582,96.657107,2,0
0,0,11,11,15,10,25,43,22,65,0.000333,0.100617,14,4225.909133,234.77273,301.850652,91.82264,2,0
0,0,8,8,12,9,21,37,21,58,0.000333,0.084918,12,3057.052926,169.836274,254.754411,71.548875,2,0
0,0,7,7,13,11,24,40,25,65,0.000333,0.099341,12,3576.270751,198.681708,298.022563,86.159464,2,0
0,0,8,8,12,10,22,35,22,57,0.000333,0.084729,12,3050.251227,169.458402,254.187602,76.238831,1,0
0,0,12,12,16,14,30,51,39,90,0.000333,0.147207,16,7065.922458,392.551248,441.620154,117.302969,2,0
0,0,11,11,13,13,26,48,39,87,0.000333,0.136313,18,7360.888599,408.938255,408.938255,96.211433,2,0
0,0,12,12,15,16,31,50,47,97,0.000333,0.160186,14,6727.79859,373.766588,480.557042,122.603359,2,0
0,0,11,11,12,15,27,47,47,94,0.000333,0.148986,18,8045.269654,446.959425,446.959425,101.622909,2,0
0,0,8,8,10,10,20,38,26,64,0.000333,0.092201,10,2766.033981,153.668554,276.603398,66.438562,1,0
0,0,11,11,11,11,22,53,34,87,0.000333,0.129324,15,5819.558262,323.308792,387.970551,76.107496,1,0
0,0,13,13,14,15,29,48,38,86,0.000333,0.139262,14,5849.009118,324.944951,417.786366,111.906328,1,0
0,0,8,8,10,14,24,38,32,70,0.000333,0.106982,10,3209.473751,178.304097,320.947375,86.52225,1,0
0,0,9,9,12,11,23,43,30,73,0.000333,0.110073,12,3962.640274,220.146682,330.220023,81.073298,1,0
0,0,9,9,11,13,24,47,32,79,0.000333,0.120737,10,3622.120376,201.22891,362.212038,86.159464,1,0
0,0,10,10,11,16,27,39,36,75,0.000333,0.118872,10,3566.165627,198.120313,356.616563,102.053748,1,0
0,0,8,8,10,14,24,38,32,70,0.000333,0.106982,10,3209.473751,178.304097,320.947375,86.52225,1,0
0,0,10,10,10,15,25,44,44,88,0.000333,0.13622,10,4086.593447,227.032969,408.659345,91.82264,1,0
0,0,12,12,10,16,26,50,56,106,0.000333,0.166082,15,7473.699152,415.205508,498.24661,97.219281,1,0
0,0,14,14,10,17,27,56,68,124,0.000333,0.196535,20,11792.12101,655.117834,589.60605,102.706149,1,0
0,0,9,9,11,13,24,42,34,76,0.000333,0.116152,10,3484.571501,193.587306,348.45715,86.159464,1,0
0,0,9,9,11,15,26,44,35,79,0.000333,0.123778,10,3713.347377,206.297077,371.334738,96.657107,1,0
0,0,10,10,11,16,27,53,39,92,0.000333,0.145817,10,4374.496502,243.027583,437.44965,102.053748,1,0
0,0,9,9,10,15,25,46,36,82,0.000333,0.126932,10,3807.962076,211.553449,380.796208,91.82264,1,0
0,0,11,11,10,17,27,53,42,95,0.000333,0.150571,10,4517.143127,250.952396,451.714313,102.706149,1,0
0,0,14,14,14,18,32,51,53,104,0.000333,0.173333,14,7280,404.444444,520,128.361619,1,0
0,0,9,9,16,13,29,43,29,72,0.000333,0.116592,16,5596.394106,310.910784,349.774632,112.105716,5,0
0,0,12,12,17,13,30,52,31,83,0.000333,0.135757,16,6516.350711,362.019484,407.271919,117.592585,7,0
0,0,11,11,16,13,29,49,31,80,0.000333,0.129546,16,6218.215674,345.456426,388.63848,112.105716,7,0
0,0,12,12,18,14,32,53,33,86,0.000333,0.143333,18,7740,430,430,128.361619,7,0
0,0,11,11,16,14,30,49,33,82,0.000333,0.134122,16,6437.840461,357.657803,402.365029,117.302969,7,0
0,0,14,14,19,15,34,60,37,97,0.000333,0.164495,18,8882.710121,493.483896,493.483896,139.313982,7,0
0,0,13,13,18,15,33,57,37,94,0.000333,0.158058,18,8535.11485,474.173047,474.173047,133.662009,7,0
0,0,14,14,18,15,33,58,37,95,0.000333,0.159739,18,8625.913944,479.217441,479.217441,133.662009,7,0
0,0,13,13,17,15,32,55,37,92,0.000333,0.153333,16,7360,408.888889,460,128.090227,7,0
0,0,13,13,20,15,35,57,36,93,0.000333,0.159008,20,9540.466412,530.025912,477.023321,145.041921,7,0
0,0,12,12,18,15,33,53,36,89,0.000333,0.14965,18,8081.119379,448.951077,448.951077,133.662009,7,0
0,0,13,13,19,15,34,56,36,92,0.000333,0.156016,18,8424.838465,468.046581,468.046581,139.313982,7,0
0,0,12,12,17,15,32,52,36,88,0.000333,0.146667,16,7040,391.111111,440,128.090227,7,0
0,0,16,16,19,15,34,58,37,95,0.000333,0.161103,18,8699.561459,483.30897,483.30897,139.313982,7,0
0,0,15,15,18,15,33,55,37,92,0.000333,0.154695,18,8353.516662,464.084259,464.084259,133.662009,7,0
0,0,14,14,18,15,33,58,37,95,0.000333,0.159739,18,8625.913944,479.217441,479.217441,133.662009,7,0
0,0,13,13,17,15,32,55,37,92,0.000333,0.153333,16,7360,408.888889,460,128.090227,7,0
0,0,14,14,17,15,32,56,37,93,0.000333,0.155,16,7440,413.333333,465,128.090227,7,0
0,0,13,13,16,15,31,53,37,90,0.000333,0.148626,16,7134.042687,396.335705,445.877668,122.603359,7,0
0,0,16,16,18,15,33,56,37,93,0.000333,0.156376,18,8444.315756,469.128653,469.128653,133.662009,7,0
0,0,15,15,17,15,32,53,37,90,0.000333,0.15,16,7200,400,450,128.090227,7,0
0,0,13,13,19,15,34,56,36,92,0.000333,0.156016,18,8424.838465,468.046581,468.046581,139.313982,7,0
0,0,12,12,17,15,32,52,36,88,0.000333,0.146667,16,7040,391.111111,440,128.090227,7,0
0,0,13,13,18,15,33,55,36,91,0.000333,0.153013,18,8262.717568,459.039865,459.039865,133.662009,7,0
0,0,12,12,16,15,31,51,36,87,0.000333,0.143672,16,6896.241264,383.124515,431.015079,122.603359,7,0
0,0,18,18,20,16,36,63,33,96,0.000333,0.165438,20,9926.256003,551.458667,496.3128,150.438562,7,0
0,0,16,16,20,15,35,59,33,92,0.000333,0.157298,20,9437.880751,524.326708,471.894038,145.041921,7,0
0,0,13,13,17,13,30,53,31,84,0.000333,0.137393,16,6594.86096,366.381164,412.17881,117.592585,7,0
0,0,11,11,18,15,33,59,39,98,0.000333,0.164784,18,8898.311227,494.350624,494.350624,133.662009,7,0
0,0,13,13,18,15,33,49,33,82,0.000333,0.13788,18,7445.52572,413.640318,413.640318,133.662009,5,0
0,0,14,14,18,18,36,57,46,103,0.000333,0.177501,18,9585.040953,532.502275,532.502275,150.1173,6,0
0,0,13,13,17,18,35,54,46,100,0.000333,0.170976,16,8206.852827,455.936268,512.928302,144.545518,6,0
0,0,14,14,17,21,38,56,58,114,0.000333,0.199421,16,9572.219785,531.789988,598.263737,161.725534,6,0
0,0,13,13,16,21,37,53,58,111,0.000333,0.19275,16,9251.989177,513.999399,578.249324,156.238666,6,0
0,0,11,11,16,14,30,47,35,82,0.000333,0.134122,16,6437.840461,357.657803,402.365029,117.302969,5,0
0,0,14,14,18,15,33,60,43,103,0.000333,0.173191,18,9352.306697,519.572594,519.572594,133.662009,5,0
0,0,16,16,19,20,39,56,49,105,0.000333,0.184989,18,9989.410194,554.967233,554.967233,167.149185,5,0
0,0,11,11,17,16,33,49,37,86,0.000333,0.144606,16,6941.086308,385.615906,433.817894,133.486868,5,0
0,0,12,12,18,15,33,52,39,91,0.000333,0.153013,18,8262.717568,459.039865,459.039865,133.662009,5,0
0,0,12,12,18,17,35,56,41,97,0.000333,0.165847,18,8955.728148,497.540453,497.540453,144.545518,5,0
0,0,13,13,17,21,38,49,47,96,0.000333,0.167934,16,8060.816661,447.823148,503.801041,161.725534,5,0
0,0,11,11,16,19,35,48,43,91,0.000333,0.155588,16,7468.236073,414.902004,466.764755,144.710623,5,0
0,0,13,13,16,20,36,53,57,110,0.000333,0.189564,16,9099.068003,505.503778,568.69175,150.438562,5,0
0,0,15,15,16,21,37,58,71,129,0.000333,0.224006,24,16128.46762,896.025979,672.019484,156.238666,5,0
0,0,17,17,16,22,38,63,85,148,0.000333,0.258898,24,18640.63853,1035.591029,776.693272,162.107496,5,0
0,0,12,12,17,18,35,51,45,96,0.000333,0.164137,16,7878.578714,437.698817,492.41117,144.545518,5,0
0,0,12,12,18,20,38,53,46,99,0.000333,0.173182,18,9351.806829,519.544824,519.544824,161.497212,5,0
0,0,13,13,18,21,39,61,50,111,0.000333,0.19556,18,10560.23363,586.679646,586.679646,167.297316,5,0
0,0,12,12,17,20,37,55,47,102,0.000333,0.177121,16,8501.827893,472.323772,531.364243,155.92543,5,0
0,0,14,14,16,22,38,61,53,114,0.000333,0.199421,16,9572.219785,531.789988,598.263737,162.107496,5,0
0,0,17,17,19,23,42,60,68,128,0.000333,0.230072,18,12423.89934,690.21663,690.21663,184.752548,5,0
0,0,13,13,16,21,37,48,53,101,0.000333,0.175385,16,8418.476639,467.693147,526.15479,156.238666,5,0
0,0,12,12,20,22,42,55,51,106,0.000333,0.190529,20,11431.71294,635.095163,571.585647,184.546058,5,0
0,0,13,13,21,22,43,56,52,108,0.000333,0.195346,20,11720.73187,651.151771,586.036594,190.346161,5,0
0,0,8,8,10,9,19,43,28,71,0.000333,0.100534,15,4524.042802,251.335711,301.602853,61.748606,1,0
0,0,10,10,14,10,24,49,29,78,0.000333,0.119209,14,5006.779051,278.154392,357.627075,86.52225,2,0
0,0,9,9,11,9,20,46,29,75,0.000333,0.108048,15,4862.169107,270.120506,324.144607,66.583073,2,0
0,0,10,10,15,10,25,50,30,80,0.000333,0.123836,21,7801.678399,433.426578,371.508495,91.82264,2,0
0,0,9,9,11,10,21,46,30,76,0.000333,0.111272,15,5007.241862,278.180103,333.816124,71.273029,2,0
0,0,12,12,16,13,29,57,35,92,0.000333,0.148978,16,7150.948025,397.27489,446.934252,112.105716,2,0
0,0,11,11,13,13,26,54,35,89,0.000333,0.139446,12,5020.069619,278.892757,418.339135,96.211433,2,0
0,0,12,12,15,13,28,55,35,90,0.000333,0.144221,14,6057.267202,336.514845,432.661943,106.709075,2,0
0,0,11,11,12,13,25,52,35,87,0.000333,0.134672,12,4848.185862,269.343659,404.015489,91.125266,2,0
0,0,11,11,17,12,29,54,33,87,0.000333,0.140881,16,6762.309545,375.683864,422.644347,112.506418,2,0
0,0,10,10,13,12,25,50,33,83,0.000333,0.12848,12,4625.280765,256.960043,385.440064,91.125266,2,0
0,0,11,11,16,12,28,53,33,86,0.000333,0.137811,16,6614.920373,367.495576,413.432523,107.01955,2,0
0,0,10,10,12,12,24,49,33,82,0.000333,0.125322,12,4511.603101,250.644617,375.966925,86.0391,2,0
0,0,14,14,16,13,29,55,35,90,0.000333,0.145739,16,6995.492633,388.63848,437.21829,112.105716,2,0
0,0,13,13,13,13,26,52,35,87,0.000333,0.136313,12,4907.259066,272.625504,408.938255,96.211433,2,0
0,0,12,12,15,13,28,55,35,90,0.000333,0.144221,14,6057.267202,336.514845,432.661943,106.709075,2,0
0,0,11,11,12,13,25,52,35,87,0.000333,0.134672,12,4848.185862,269.343659,404.015489,91.125266,2,0
0,0,12,12,14,13,27,53,35,88,0.000333,0.139477,14,5858.021403,325.445633,418.4301,101.408685,2,0
0,0,11,11,11,13,24,50,35,85,0.000333,0.129907,10,3897.218126,216.512118,389.721813,86.159464,2,0
0,0,14,14,15,13,28,53,35,88,0.000333,0.141016,14,5922.661264,329.036737,423.047233,106.709075,2,0
0,0,13,13,12,13,25,50,35,85,0.000333,0.131576,12,4736.733314,263.151851,394.727776,91.125266,2,0
0,0,11,11,16,12,28,53,33,86,0.000333,0.137811,16,6614.920373,367.495576,413.432523,107.01955,2,0
0,0,10,10,12,12,24,49,33,82,0.000333,0.125322,12,4511.603101,250.644617,375.966925,86.0391,2,0
0,0,10,10,15,11,26,50,30,80,0.000333,0.125345,14,5264.492484,292.471805,376.035177,96.657107,2,0
0,0,9,9,11,11,22,46,30,76,0.000333,0.112972,10,3389.16803,188.287113,338.916803,76.107496,2,0
0,0,13,13,15,11,26,54,30,84,0.000333,0.131612,14,5527.717109,307.095395,394.836936,96.657107,2,0
0,0,13,13,15,10,25,54,30,84,0.000333,0.130028,21,8191.762319,455.097907,390.08392,91.82264,2,0
0,0,10,10,12,9,21,48,29,77,0.000333,0.112736,18,6087.751948,338.208442,338.208442,71.548875,2,0
0,0,9,9,13,11,24,51,33,84,0.000333,0.128379,18,6932.463301,385.13685,385.13685,86.159464,2,0
0,0,10,10,12,9,21,46,30,76,0.000333,0.111272,18,6008.690234,333.816124,333.816124,71.548875,1,0
0,0,10,10,10,10,20,49,34,83,0.000333,0.119573,15,5380.800478,298.93336,358.720032,66.438562,1,0
0,0,13,13,11,11,22,64,42,106,0.000333,0.157567,15,7090.496274,393.91646,472.699752,76.107496,1,0
0,0,15,15,14,15,29,59,46,105,0.000333,0.170029,21,10711.84809,595.102672,510.088004,111.906328,1,0
0,0,11,11,10,14,24,51,42,93,0.000333,0.142134,15,6396.022689,355.334594,426.401513,86.52225,1,0
0,0,12,12,11,13,24,60,42,102,0.000333,0.155889,15,7014.992626,389.721813,467.666175,86.159464,1,0
0,0,13,13,11,16,27,52,46,98,0.000333,0.155326,10,4659.789752,258.877208,465.978975,102.053748,1,0
0,0,11,11,10,14,24,51,42,93,0.000333,0.142134,15,6396.022689,355.334594,426.401513,86.52225,1,0
0,0,13,13,10,15,25,57,54,111,0.000333,0.171823,15,7732.020556,429.556698,515.468037,91.82264,1,0
0,0,15,15,10,16,26,63,66,129,0.000333,0.202119,20,12127.13447,673.729693,606.356724,97.219281,1,0
0,0,17,17,10,17,27,69,78,147,0.000333,0.232989,20,13979.36926,776.631625,698.968463,102.706149,1,0
0,0,12,12,11,15,26,57,45,102,0.000333,0.159815,15,7191.672769,399.537376,479.444851,96.657107,1,0
0,0,13,13,11,16,27,66,49,115,0.000333,0.182271,15,8202.180941,455.676719,546.812063,102.053748,1,0
0,0,12,12,10,15,25,59,46,105,0.000333,0.162535,15,7314.073499,406.337417,487.6049,91.82264,1,0
0,0,14,14,10,17,27,66,52,118,0.000333,0.187026,15,8416.150879,467.563938,561.076725,102.706149,1,0
0,0,17,17,14,18,32,64,63,127,0.000333,0.211667,21,13335,740.833333,635,128.361619,1,0
0,0,13,13,10,16,26,51,50,101,0.000333,0.158248,15,7121.166173,395.620343,474.744412,97.219281,1,0
0,0,12,12,14,17,31,58,49,107,0.000333,0.1767,14,7421.386073,412.299226,530.099005,122.789837,1,0
0,0,13,13,14,17,31,59,50,109,0.000333,0.180002,14,7560.10357,420.005754,540.007398,122.789837,1,0
0,0,8,8,10,9,19,45,30,75,0.000333,0.106198,15,4778.918453,265.49547,318.594564,61.748606,1,0
0,0,10,10,14,10,24,51,31,82,0.000333,0.125322,21,7895.305426,438.628079,375.966925,86.52225,2,0
0,0,9,9,11,9,20,48,31,79,0.000333,0.113811,15,5121.484792,284.526933,341.432319,66.583073,2,0
0,0,10,10,15,10,25,52,32,84,0.000333,0.130028,21,8191.762319,455.097907,390.08392,91.82264,2,0
0,0,9,9,11,10,21,48,32,80,0.000333,0.117128,15,5270.780907,292.821162,351.385394,71.273029,2,0
0,0,12,12,16,13,29,59,37,96,0.000333,0.155455,16,7461.858809,414.547712,466.366176,112.105716,2,0
0,0,11,11,13,13,26,56,37,93,0.000333,0.145714,12,5245.690725,291.427263,437.140894,96.211433,2,0
0,0,12,12,15,13,28,57,37,94,0.000333,0.15063,14,6326.479077,351.47106,451.891363,106.709075,2,0
0,0,11,11,12,13,25,54,37,91,0.000333,0.140864,12,5071.090959,281.727276,422.590913,91.125266,2,0
0,0,10,10,15,11,26,52,32,84,0.000333,0.131612,14,5527.717109,307.095395,394.836936,96.657107,2,0
0,0,9,9,11,11,22,48,32,80,0.000333,0.118918,10,3567.545295,198.196961,356.754529,76.107496,2,0
0,0,11,11,16,12,28,55,35,90,0.000333,0.144221,16,6922.591088,384.588394,432.661943,107.01955,2,0
0,0,10,10,12,12,24,51,35,86,0.000333,0.131436,12,4731.681301,262.871183,394.306775,86.0391,2,0
0,0,14,14,16,13,29,57,37,94,0.000333,0.152217,16,7306.403417,405.911301,456.650214,112.105716,2,0
0,0,13,13,13,13,26,54,37,91,0.000333,0.14258,12,5132.880172,285.16001,427.740014,96.211433,2,0
0,0,12,12,15,13,28,57,37,94,0.000333,0.15063,14,6326.479077,351.47106,451.891363,106.709075,2,0
0,0,11,11,12,13,25,54,37,91,0.000333,0.140864,12,5071.090959,281.727276,422.590913,91.125266,2,0
0,0,11,11,14,13,27,53,34,87,0.000333,0.137892,14,5791.452978,321.747388,413.675213,101.408685,2,0
0,0,10,10,11,13,24,50,34,84,0.000333,0.128379,10,3851.368501,213.964917,385.13685,86.159464,2,0
0,0,14,14,15,13,28,55,37,92,0.000333,0.147426,14,6191.87314,343.992952,442.276653,106.709075,2,0
0,0,13,13,12,13,25,52,37,89,0.000333,0.137768,12,4959.638411,275.535467,413.303201,91.125266,2,0
0,0,11,11,16,12,28,55,35,90,0.000333,0.144221,16,6922.591088,384.588394,432.661943,107.01955,2,0
0,0,10,10,12,12,24,51,35,86,0.000333,0.131436,12,4731.681301,262.871183,394.306775,86.0391,2,0
0,0,11,11,15,12,27,54,35,89,0.000333,0.141062,14,5924.589828,329.143879,423.184988,101.622909,2,0
0,0,10,10,11,12,23,50,35,85,0.000333,0.128168,10,3845.027663,213.612648,384.502766,81.073298,2,0
0,0,13,13,15,11,26,56,32,88,0.000333,0.13788,14,5790.941733,321.718985,413.638695,96.657107,2,0
0,0,13,13,15,10,25,56,32,88,0.000333,0.13622,21,8581.846239,476.769235,408.659345,91.82264,2,0
0,0,10,10,12,9,21,50,31,81,0.000333,0.118593,18,6403.998802,355.777711,355.777711,71.548875,2,0
0,0,9,9,13,11,24,53,35,88,0.000333,0.134492,18,7262.580601,403.4767,403.4767,86.159464,2,0
0,0,10,10,12,9,21,48,32,80,0.000333,0.117128,18,6324.937089,351.385394,351.385394,71.548875,1,0
0,0,10,10,10,10,20,51,36,87,0.000333,0.125336,15,5640.116164,313.339787,376.007744,66.438562,1,0
0,0,13,13,11,11,22,66,44,110,0.000333,0.163512,20,9810.749561,545.041642,490.537478,76.107496,1,0
0,0,15,15,14,15,29,61,48,109,0.000333,0.176507,21,11119.9185,617.77325,529.519928,111.906328,1,0
0,0,11,11,10,14,24,53,44,97,0.000333,0.148247,15,6671.120439,370.617802,444.741363,86.52225,1,0
0,0,12,12,11,13,24,62,44,106,0.000333,0.162002,15,7290.090376,405.005021,486.006025,86.159464,1,0
0,0,13,13,11,16,27,54,48,102,0.000333,0.161666,15,7274.977878,404.165438,484.998525,102.053748,1,0
0,0,11,11,10,14,24,53,44,97,0.000333,0.148247,15,6671.120439,370.617802,444.741363,86.52225,1,0
0,0,13,13,10,15,25,59,56,115,0.000333,0.178014,15,8010.651927,445.036218,534.043462,91.82264,1,0
0,0,15,15,10,16,26,65,68,133,0.000333,0.208386,20,12503.16965,694.620536,625.158483,97.219281,1,0
0,0,17,17,10,17,27,71,80,151,0.000333,0.239329,20,14359.76026,797.764459,717.988013,102.706149,1,0
0,0,12,12,11,15,26,59,47,106,0.000333,0.166082,15,7473.699152,415.205508,498.24661,96.657107,1,0
0,0,13,13,11,16,27,68,51,119,0.000333,0.188611,15,8487.474191,471.526344,565.831613,102.053748,1,0
0,0,12,12,10,15,25,61,48,109,0.000333,0.168727,15,7592.70487,421.816937,506.180325,91.82264,1,0
0,0,14,14,10,17,27,68,54,122,0.000333,0.193365,15,8701.444129,483.413563,580.096275,102.706149,1,0
0,0,17,17,14,18,32,66,65,131,0.000333,0.218333,21,13755,764.166667,655,128.361619,1,0
0,0,13,13,10,16,26,53,52,105,0.000333,0.164515,15,7403.192556,411.288475,493.54617,97.219281,1,0
0,0,12,12,14,17,31,60,51,111,0.000333,0.183305,21,11548.2316,641.568422,549.91579,122.789837,1,0
0,0,13,13,14,17,31,61,52,113,0.000333,0.186608,21,11756.30785,653.128214,559.824183,122.789837,1,0
0,0,8,8,8,8,16,34,25,59,0.000333,0.078667,12,2832,157.333333,236,48,1,0
0,0,10,10,12,9,21,40,26,66,0.000333,0.096631,12,3478.715399,193.261967,289.89295,71.548875,2,0
0,0,9,9,9,8,17,37,26,63,0.000333,0.085837,12,3090.121908,171.673439,257.510159,52.529325,2,0
0,0,10,10,13,9,22,41,27,68,0.000333,0.10108,18,5458.344301,303.24135,303.24135,76.635041,2,0
0,0,9,9,9,9,18,37,27,64,0.000333,0.088958,12,3202.502401,177.9168,266.8752,57.05865,2,0
0,0,12,12,14,12,26,48,32,80,0.000333,0.125345,14,5264.492484,292.471805,376.035177,96.322519,2,0
0,0,11,11,11,12,23,45,32,77,0.000333,0.116105,10,3483.142706,193.507928,348.314271,81.073298,2,0
0,0,12,12,13,12,25,46,32,78,0.000333,0.12074,12,4346.649394,241.480522,362.220783,91.125266,2,0
0,0,11,11,10,12,22,43,32,75,0.000333,0.111486,10,3344.573714,185.809651,334.457371,76.238831,2,0
0,0,11,11,15,11,26,45,30,75,0.000333,0.117511,14,4935.461704,274.192317,352.532979,96.657107,2,0
0,0,10,10,11,11,22,41,30,71,0.000333,0.10554,10,3166.196449,175.899803,316.619645,76.107496,2,0
0,0,11,11,14,11,25,44,30,74,0.000333,0.114548,14,4811.035013,267.279723,343.645358,91.356717,2,0
0,0,10,10,10,11,21,40,30,70,0.000333,0.102487,10,3074.622196,170.812344,307.46222,71.273029,2,0
0,0,14,14,14,12,26,46,32,78,0.000333,0.122211,14,5132.880172,285.16001,366.634298,96.322519,2,0
0,0,13,13,11,12,23,43,32,75,0.000333,0.113089,10,3392.671467,188.481748,339.267147,81.073298,2,0
0,0,12,12,13,12,25,46,32,78,0.000333,0.12074,12,4346.649394,241.480522,362.220783,91.125266,2,0
0,0,11,11,10,12,22,43,32,75,0.000333,0.111486,10,3344.573714,185.809651,334.457371,76.238831,2,0
0,0,12,12,12,12,24,44,32,76,0.000333,0.116152,12,4181.485801,232.304767,348.45715,86.0391,2,0
0,0,11,11,9,12,21,41,32,73,0.000333,0.10688,8,2565.113375,142.506299,320.639172,71.548875,2,0
0,0,14,14,13,12,25,44,32,76,0.000333,0.117644,12,4235.196845,235.288714,352.93307,91.125266,2,0
0,0,13,13,10,12,22,41,32,73,0.000333,0.108513,10,3255.385082,180.854727,325.538508,76.238831,2,0
0,0,11,11,14,11,25,44,30,74,0.000333,0.114548,14,4811.035013,267.279723,343.645358,91.356717,2,0
0,0,10,10,10,11,21,40,30,70,0.000333,0.102487,10,3074.622196,170.812344,307.46222,71.273029,2,0
0,0,11,11,13,11,24,43,30,73,0.000333,0.111567,12,4016.427151,223.134842,334.702263,86.159464,2,0
0,0,10,10,9,11,20,39,30,69,0.000333,0.099404,8,2385.704308,132.539128,298.213039,66.583073,2,0
0,0,13,13,13,10,23,45,27,72,0.000333,0.108565,12,3908.35753,217.130974,325.696461,81.324997,2,0
0,0,13,13,13,9,22,45,27,72,0.000333,0.107026,18,5779.423378,321.079077,321.079077,76.635041,2,0
0,0,10,10,10,8,18,39,26,65,0.000333,0.090348,15,4065.676876,225.870938,271.045125,57.219281,2,0
0,0,9,9,11,10,21,42,30,72,0.000333,0.105416,15,4743.702817,263.539045,316.246854,71.273029,2,0
0,0,10,10,10,8,18,37,27,64,0.000333,0.088958,15,4003.128001,222.396,266.8752,57.219281,1,0
0,0,10,10,9,9,18,40,31,71,0.000333,0.098688,12,3552.776101,197.37645,296.064675,57.05865,1,0
0,0,13,13,10,10,20,55,39,94,0.000333,0.13542,15,6093.918614,338.551034,406.261241,66.438562,1,0
0,0,15,15,13,14,27,50,43,93,0.000333,0.147402,18,7959.681679,442.204538,442.204538,101.408685,1,0
0,0,11,11,9,13,22,42,39,81,0.000333,0.120405,12,4334.567533,240.809307,361.213961,76.635041,1,0
0,0,12,12,10,12,22,51,39,90,0.000333,0.133783,15,6020.232685,334.457371,401.348846,76.238831,1,0
0,0,13,13,10,15,25,43,43,86,0.000333,0.133124,10,3993.716323,221.873129,399.371632,91.82264,1,0
0,0,11,11,9,13,22,42,39,81,0.000333,0.120405,12,4334.567533,240.809307,361.213961,76.635041,1,0
0,0,13,13,9,14,23,48,51,99,0.000333,0.149278,12,5373.991604,298.555089,447.832634,81.832294,1,0
0,0,15,15,9,15,24,54,63,117,0.000333,0.178814,16,8583.049801,476.8361,536.440613,87.132684,1,0
0,0,17,17,9,16,25,60,75,135,0.000333,0.208974,16,10030.72937,557.262743,626.920586,92.529325,1,0
0,0,12,12,10,14,24,48,42,90,0.000333,0.137549,15,6189.699376,343.872188,412.646625,86.52225,1,0
0,0,13,13,10,15,25,57,46,103,0.000333,0.159439,15,7174.757813,398.597656,478.317188,91.82264,1,0
0,0,12,12,9,14,23,50,43,93,0.000333,0.14023,12,5048.295143,280.460841,420.691262,81.832294,1,0
0,0,14,14,9,16,25,57,49,106,0.000333,0.164083,12,5906.985073,328.165837,492.248756,92.529325,1,0
0,0,17,17,13,17,30,55,60,115,0.000333,0.188097,18,10157.26353,564.292418,564.292418,117.592585,1,0
0,0,13,13,9,15,24,42,47,89,0.000333,0.136021,12,4896.739951,272.041108,408.061663,87.132684,1,0
0,0,12,12,13,16,29,49,46,95,0.000333,0.153836,12,5538.098334,307.67213,461.508195,112.105716,1,0
0,0,13,13,13,16,29,50,47,97,0.000333,0.157075,12,5654.689878,314.149438,471.224157,112.105716,1,0
0,0,8,8,8,8,16,36,27,63,0.000333,0.084,12,3024,168,252,48,1,0
0,0,10,10,12,9,21,42,28,70,0.000333,0.102487,18,5534.319953,307.46222,307.46222,71.548875,2,0
0,0,9,9,9,8,17,39,28,67,0.000333,0.091287,12,3286.320124,182.57334,273.86001,52.529325,2,0
0,0,10,10,13,9,22,43,29,72,0.000333,0.107026,18,5779.423378,321.079077,321.079077,76.635041,2,0
0,0,9,9,9,9,18,39,29,68,0.000333,0.094518,12,3402.658801,189.0366,283.5549,57.05865,2,0
0,0,12,12,14,12,26,50,34,84,0.000333,0.131612,14,5527.717109,307.095395,394.836936,96.322519,2,0
0,0,11,11,11,12,23,47,34,81,0.000333,0.122136,10,3664.085184,203.560288,366.408518,81.073298,2,0
0,0,12,12,13,12,25,48,34,82,0.000333,0.126932,12,4569.554491,253.864138,380.796208,91.125266,2,0
0,0,11,11,10,12,22,45,34,79,0.000333,0.117432,10,3522.950979,195.719499,352.295098,76.238831,2,0
0,0,11,11,15,11,26,47,32,79,0.000333,0.123778,14,5198.686328,288.815907,371.334738,96.657107,2,0
0,0,10,10,11,11,22,43,32,75,0.000333,0.111486,10,3344.573714,185.809651,334.457371,76.107496,2,0
0,0,11,11,14,11,25,46,32,78,0.000333,0.12074,14,5071.090959,281.727276,362.220783,91.356717,2,0
0,0,10,10,10,11,21,42,32,74,0.000333,0.108344,10,3250.314893,180.57305,325.031489,71.273029,2,0
0,0,14,14,14,12,26,48,34,82,0.000333,0.128479,14,5396.104796,299.7836,385.436057,96.322519,2,0
0,0,13,13,11,12,23,45,34,79,0.000333,0.11912,10,3573.613945,198.534108,357.361395,81.073298,2,0
0,0,12,12,13,12,25,48,34,82,0.000333,0.126932,12,4569.554491,253.864138,380.796208,91.125266,2,0
0,0,11,11,10,12,22,45,34,79,0.000333,0.117432,10,3522.950979,195.719499,352.295098,76.238831,2,0
0,0,12,12,12,12,24,46,34,80,0.000333,0.122266,12,4401.564001,244.531333,366.797,86.0391,2,0
0,0,11,11,9,12,21,43,34,77,0.000333,0.112736,8,2705.667532,150.314863,338.208442,71.548875,2,0
0,0,14,14,13,12,25,46,34,80,0.000333,0.123836,12,4458.101942,247.67233,371.508495,91.125266,2,0
0,0,13,13,10,12,22,43,34,77,0.000333,0.114459,10,3433.762346,190.764575,343.376235,76.238831,2,0
0,0,12,12,15,11,26,48,34,82,0.000333,0.128479,21,8094.157195,449.6754,385.436057,96.657107,2,0
0,0,11,11,11,11,22,44,34,78,0.000333,0.115945,15,5217.534994,289.863055,347.835666,76.107496,2,0
0,0,12,12,14,11,25,47,34,81,0.000333,0.125384,21,7899.199379,438.84441,376.152351,91.356717,2,0
0,0,11,11,10,11,21,43,34,77,0.000333,0.112736,15,5073.126623,281.840368,338.208442,71.273029,2,0
0,0,14,14,14,10,24,49,31,80,0.000333,0.122266,21,7702.737001,427.929833,366.797,86.52225,2,0
0,0,14,14,14,9,23,49,31,80,0.000333,0.120628,21,7599.584086,422.199116,361.884956,81.832294,2,0
0,0,11,11,11,8,19,43,30,73,0.000333,0.103366,15,4651.480627,258.41559,310.098708,62.053748,2,0
0,0,10,10,12,10,22,46,34,80,0.000333,0.118918,18,6421.581531,356.754529,356.754529,76.238831,2,0
0,0,11,11,11,8,19,41,31,72,0.000333,0.10195,15,4587.761715,254.875651,305.850781,62.053748,1,0
0,0,11,11,9,9,18,44,35,79,0.000333,0.109808,12,3953.088901,219.61605,329.424075,57.05865,1,0
0,0,14,14,10,10,20,59,43,102,0.000333,0.146946,20,8816.733314,489.818517,440.836666,66.438562,1,0
0,0,15,15,13,14,27,52,45,97,0.000333,0.153741,18,8302.033579,461.224088,461.224088,101.408685,1,0
0,0,11,11,9,13,22,44,41,85,0.000333,0.126351,12,4548.620251,252.701125,379.051688,76.635041,1,0
0,0,12,12,10,12,22,53,41,94,0.000333,0.139729,15,6287.798582,349.322143,419.186572,76.238831,1,0
0,0,13,13,10,15,25,45,45,90,0.000333,0.139316,15,6269.205856,348.289214,417.947057,91.82264,1,0
0,0,11,11,9,13,22,44,41,85,0.000333,0.126351,12,4548.620251,252.701125,379.051688,76.635041,1,0
0,0,13,13,9,14,23,50,53,103,0.000333,0.155309,12,5591.122578,310.617921,465.926881,81.832294,1,0
0,0,15,15,9,15,24,56,65,121,0.000333,0.184927,16,8876.487401,493.138189,554.780463,87.132684,1,0
0,0,17,17,9,16,25,62,77,139,0.000333,0.215165,16,10327.93617,573.774231,645.49601,92.529325,1,0
0,0,12,12,10,14,24,50,44,94,0.000333,0.143662,15,6464.797126,359.155396,430.986475,86.52225,1,0
0,0,13,13,10,15,25,59,48,107,0.000333,0.165631,15,7453.389185,414.077177,496.892612,91.82264,1,0
0,0,12,12,9,14,23,52,45,97,0.000333,0.146262,12,5265.426117,292.523673,438.78551,81.832294,1,0
0,0,14,14,9,16,25,59,51,110,0.000333,0.170275,12,6129.890171,340.549454,510.824181,92.529325,1,0
0,0,17,17,13,17,30,57,62,119,0.000333,0.19464,18,10510.55966,583.919981,583.919981,117.592585,1,0
0,0,13,13,9,15,24,44,49,93,0.000333,0.142134,12,5116.818151,284.267675,426.401513,87.132684,1,0
0,0,12,12,13,16,29,51,48,99,0.000333,0.160313,18,8656.922133,480.940119,480.940119,112.105716,1,0
0,0,13,13,13,16,29,52,49,101,0.000333,0.163552,18,8831.809449,490.656081,490.656081,112.105716,1,0
0,0,10,10,10,10,20,47,32,79,0.000333,0.113811,15,5121.484792,284.526933,341.432319,66.438562,1,0
0,0,12,12,14,11,25,53,33,86,0.000333,0.133124,21,8386.804279,465.933571,399.371632,91.356717,2,0
0,0,11,11,11,10,21,50,33,83,0.000333,0.121521,15,5468.435191,303.801955,364.562346,71.273029,2,0
0,0,12,12,15,11,26,54,34,88,0.000333,0.13788,21,8686.412599,482.578478,413.638695,96.657107,2,0
0,0,11,11,11,11,22,50,34,84,0.000333,0.124864,15,5618.883839,312.160213,374.592256,76.107496,2,0
0,0,14,14,16,14,30,61,39,100,0.000333,0.163563,16,7851.024953,436.168053,490.68906,117.302969,2,0
0,0,13,13,13,14,27,58,39,97,0.000333,0.153741,12,5534.689053,307.482725,461.224088,101.408685,2,0
0,0,14,14,15,14,29,59,39,98,0.000333,0.158694,14,6665.149925,370.286107,476.082138,111.906328,2,0
0,0,13,13,12,14,26,56,39,95,0.000333,0.148847,12,5358.501279,297.694515,446.541773,96.322519,2,0
0,0,13,13,17,13,30,58,37,95,0.000333,0.155385,16,7458.473705,414.35965,466.154607,117.592585,2,0
0,0,12,12,13,13,26,54,37,91,0.000333,0.14258,12,5132.880172,285.16001,427.740014,96.211433,2,0
0,0,13,13,16,13,29,57,37,94,0.000333,0.152217,16,7306.403417,405.911301,456.650214,112.105716,2,0
0,0,12,12,12,13,25,53,37,90,0.000333,0.139316,12,5015.364685,278.631371,417.947057,91.125266,2,0
0,0,16,16,16,14,30,59,39,98,0.000333,0.160292,16,7694.004454,427.444692,480.875278,117.302969,2,0
0,0,15,15,13,14,27,56,39,95,0.000333,0.150571,12,5420.571752,301.142875,451.714313,101.408685,2,0
0,0,14,14,15,14,29,59,39,98,0.000333,0.158694,14,6665.149925,370.286107,476.082138,111.906328,2,0
0,0,13,13,12,14,26,56,39,95,0.000333,0.148847,12,5358.501279,297.694515,446.541773,96.322519,2,0
0,0,14,14,14,14,28,57,39,96,0.000333,0.153835,14,6461.085015,358.949168,461.506073,106.605938,2,0
0,0,13,13,11,14,25,54,39,93,0.000333,0.14396,10,4318.786256,239.93257,431.878626,91.356717,2,0
0,0,16,16,15,14,29,57,39,96,0.000333,0.155455,14,6529.126457,362.729248,466.366176,111.906328,2,0
0,0,15,15,12,14,26,54,39,93,0.000333,0.145714,12,5245.690725,291.427263,437.140894,96.322519,2,0
0,0,13,13,16,13,29,57,37,94,0.000333,0.152217,16,7306.403417,405.911301,456.650214,112.105716,2,0
0,0,12,12,12,13,25,53,37,90,0.000333,0.139316,12,5015.364685,278.631371,417.947057,91.125266,2,0
0,0,13,13,15,13,28,56,37,93,0.000333,0.149028,14,6259.176109,347.732006,447.084008,106.709075,2,0
0,0,12,12,11,13,24,52,37,89,0.000333,0.136021,10,4080.616626,226.700924,408.061663,86.159464,2,0
0,0,15,15,15,12,27,58,34,92,0.000333,0.145817,14,6124.295103,340.238617,437.44965,101.622909,2,0
0,0,15,15,15,11,26,58,34,92,0.000333,0.144147,21,9081.249535,504.513863,432.440454,96.657107,2,0
0,0,12,12,12,10,22,52,33,85,0.000333,0.126351,18,6822.930377,379.051688,379.051688,76.238831,2,0
0,0,11,11,13,12,25,55,37,92,0.000333,0.142412,18,7690.22585,427.234769,427.234769,91.125266,2,0
0,0,12,12,12,10,22,50,34,84,0.000333,0.124864,18,6742.660607,374.592256,374.592256,76.238831,1,0
0,0,16,16,16,15,31,66,51,117,0.000333,0.193214,24,13911.38324,772.854624,579.640968,122.603359,2,0
0,0,15,15,13,14,27,63,51,114,0.000333,0.180686,18,9757.029154,542.057175,542.057175,101.408685,2,0
0,0,16,16,15,17,32,65,59,124,0.000333,0.206667,21,13020,723.333333,620,128.090227,2,0
0,0,15,15,12,16,28,62,59,121,0.000333,0.193897,18,10470.41902,581.689946,581.689946,107.01955,2,0
0,0,12,12,10,11,21,53,38,91,0.000333,0.133234,15,5995.513282,333.084071,399.700885,71.273029,1,0
0,0,15,15,11,12,23,68,46,114,0.000333,0.171895,15,7735.290945,429.738386,515.686063,81.073298,1,0
0,0,17,17,14,16,30,63,50,113,0.000333,0.184826,21,11644.05138,646.891744,554.478637,117.302969,1,0
0,0,12,12,10,15,25,53,44,97,0.000333,0.150151,10,4504.540504,250.25225,450.45405,91.82264,1,0
0,0,13,13,12,12,24,58,42,100,0.000333,0.152832,18,8252.932501,458.49625,458.49625,86.0391,1,0
0,0,13,13,11,14,25,62,44,106,0.000333,0.164083,15,7383.731342,410.207297,492.248756,91.356717,1,0
0,0,14,14,11,17,28,54,48,102,0.000333,0.16345,10,4903.50202,272.416779,490.350202,107.540616,1,0
0,0,12,12,10,15,25,53,44,97,0.000333,0.150151,10,4504.540504,250.25225,450.45405,91.82264,1,0
0,0,14,14,10,16,26,59,56,115,0.000333,0.180184,15,8108.258514,450.458806,540.550568,97.219281,1,0
0,0,16,16,10,17,27,65,68,133,0.000333,0.2108,20,12648.00076,702.666709,632.400038,102.706149,1,0
0,0,18,18,10,18,28,71,80,151,0.000333,0.24197,20,14518.21187,806.567326,725.910593,108.277931,1,0
0,0,13,13,11,14,25,57,46,103,0.000333,0.159439,15,7174.757813,398.597656,478.317188,91.356717,1,0
0,0,13,13,11,16,27,59,47,106,0.000333,0.168006,10,5040.180752,280.010042,504.018075,102.053748,1,0
0,0,14,14,11,17,28,68,51,119,0.000333,0.190692,15,8581.128536,476.729363,572.075236,107.540616,1,0
0,0,13,13,10,16,26,61,48,109,0.000333,0.170783,15,7685.218939,426.956608,512.347929,97.219281,1,0
0,0,15,15,10,18,28,68,54,122,0.000333,0.195499,15,8797.459507,488.74775,586.4973,108.277931,1,0
0,0,18,18,14,19,33,66,65,131,0.000333,0.220272,21,13877.12822,770.951568,660.81563,134.013592,1,0
0,0,14,14,10,17,27,53,52,105,0.000333,0.166421,15,7488.947816,416.052656,499.263188,102.706149,1,0
0,0,13,13,14,18,32,60,51,111,0.000333,0.185,14,7770,431.666667,555,128.361619,1,0
0,0,14,14,14,18,32,61,52,113,0.000333,0.188333,14,7910,439.444444,565,128.361619,1,0
0,0,10,10,10,10,20,49,34,83,0.000333,0.119573,15,5380.800478,298.93336,358.720032,66.438562,1,0
0,0,12,12,14,11,25,55,35,90,0.000333,0.139316,21,8776.888199,487.6049,417.947057,91.356717,2,0
0,0,11,11,11,10,21,52,35,87,0.000333,0.127377,15,5731.974237,318.443013,382.131616,71.273029,2,0
0,0,12,12,15,11,26,56,36,92,0.000333,0.144147,21,9081.249535,504.513863,432.440454,96.657107,2,0
0,0,11,11,11,11,22,52,36,88,0.000333,0.13081,15,5886.449737,327.024985,392.429982,76.107496,2,0
0,0,14,14,16,14,30,63,41,104,0.000333,0.170106,16,8165.065951,453.614775,510.316622,117.302969,2,0
0,0,13,13,13,14,27,60,41,101,0.000333,0.160081,12,5762.923653,320.162425,480.243638,101.408685,2,0
0,0,14,14,15,14,29,61,41,102,0.000333,0.165171,14,6937.196861,385.399826,495.514062,111.906328,2,0
0,0,13,13,12,14,26,58,41,99,0.000333,0.155115,12,5584.122385,310.229021,465.343532,96.322519,2,0
0,0,13,13,17,13,30,60,39,99,0.000333,0.161927,24,11658.77206,647.709559,485.782169,117.592585,2,0
0,0,12,12,13,13,26,56,39,95,0.000333,0.148847,18,8037.751918,446.541773,446.541773,96.211433,2,0
0,0,13,13,16,13,29,59,39,98,0.000333,0.158694,24,11425.9713,634.776183,476.082138,112.105716,2,0
0,0,12,12,12,13,25,55,39,94,0.000333,0.145507,18,7857.404673,436.522482,436.522482,91.125266,2,0
0,0,16,16,16,14,30,61,41,102,0.000333,0.166834,16,8008.045452,444.891414,500.502841,117.302969,2,0
0,0,15,15,13,14,27,58,41,99,0.000333,0.156911,12,5648.806353,313.822575,470.733863,101.408685,2,0
0,0,14,14,15,14,29,61,41,102,0.000333,0.165171,14,6937.196861,385.399826,495.514062,111.906328,2,0
0,0,13,13,12,14,26,58,41,99,0.000333,0.155115,12,5584.122385,310.229021,465.343532,96.322519,2,0
0,0,14,14,14,14,28,59,41,100,0.000333,0.160245,14,6730.296891,373.905383,480.735492,106.605938,2,0
0,0,13,13,11,14,25,56,41,97,0.000333,0.150151,10,4504.540504,250.25225,450.45405,91.356717,2,0
0,0,16,16,15,14,29,59,41,100,0.000333,0.161933,14,6801.173393,377.842966,485.7981,111.906328,2,0
0,0,15,15,12,14,26,56,41,97,0.000333,0.151981,12,5471.311832,303.961768,455.942653,96.322519,2,0
0,0,13,13,16,13,29,59,39,98,0.000333,0.158694,24,11425.9713,634.776183,476.082138,112.105716,2,0
0,0,12,12,12,13,25,55,39,94,0.000333,0.145507,18,7857.404673,436.522482,436.522482,91.125266,2,0
0,0,13,13,15,13,28,58,39,97,0.000333,0.155438,21,9792.581976,544.032332,466.313427,106.709075,2,0
0,0,12,12,11,13,24,54,39,93,0.000333,0.142134,15,6396.022689,355.334594,426.401513,86.159464,2,0
0,0,15,15,15,12,27,60,36,96,0.000333,0.152156,21,9585.853204,532.5474,456.4692,101.622909,2,0
0,0,15,15,15,11,26,60,36,96,0.000333,0.150414,21,9476.086472,526.449248,451.242213,96.657107,2,0
0,0,12,12,12,10,22,54,35,89,0.000333,0.132296,18,7144.009453,396.889414,396.889414,76.238831,2,0
0,0,11,11,13,12,25,57,39,96,0.000333,0.148603,18,8024.583496,445.810194,445.810194,91.125266,2,0
0,0,12,12,12,10,22,52,36,88,0.000333,0.13081,18,7063.739684,392.429982,392.429982,76.238831,1,0
0,0,16,16,16,15,31,68,53,121,0.000333,0.199819,24,14386.98609,799.277005,599.457754,122.603359,2,0
0,0,15,15,13,14,27,65,53,118,0.000333,0.187026,18,10099.38106,561.076725,561.076725,101.408685,2,0
0,0,16,16,15,17,32,67,61,128,0.000333,0.213333,21,13440,746.666667,640,128.090227,2,0
0,0,15,15,12,16,28,64,61,125,0.000333,0.200306,18,10816.54858,600.919365,600.919365,107.01955,2,0
0,0,12,12,10,11,21,55,40,95,0.000333,0.13909,15,6259.052327,347.725129,417.270155,71.273029,1,0
0,0,15,15,11,12,23,70,48,118,0.000333,0.177927,20,10675.60622,593.089234,533.780311,81.073298,1,0
0,0,17,17,14,16,30,65,52,117,0.000333,0.191369,21,12056.23019,669.790566,574.1062,117.302969,1,0
0,0,12,12,10,15,25,55,46,101,0.000333,0.156343,15,7035.442128,390.857896,469.029475,91.82264,1,0
0,0,13,13,12,12,24,60,44,104,0.000333,0.158945,18,8583.049801,476.8361,476.8361,86.0391,1,0
0,0,13,13,11,14,25,64,46,110,0.000333,0.170275,15,7662.362713,425.686817,510.824181,91.356717,1,0
0,0,14,14,11,17,28,56,50,106,0.000333,0.16986,10,5095.796217,283.09979,509.579622,107.540616,1,0
0,0,12,12,10,15,25,55,46,101,0.000333,0.156343,15,7035.442128,390.857896,469.029475,91.82264,1,0
0,0,14,14,10,16,26,61,58,119,0.000333,0.186451,15,8390.284897,466.126939,559.352326,97.219281,1,0
0,0,16,16,10,17,27,67,70,137,0.000333,0.21714,20,13028.39176,723.799542,651.419588,102.706149,1,0
0,0,18,18,10,18,28,73,82,155,0.000333,0.24838,20,14902.80026,827.933348,745.140013,108.277931,1,0
0,0,13,13,11,14,25,59,48,107,0.000333,0.165631,15,7453.389185,414.077177,496.892612,91.356717,1,0
0,0,13,13,11,16,27,61,49,110,0.000333,0.174346,15,7845.564379,435.864688,523.037625,102.053748,1,0
0,0,14,14,11,17,28,70,53,123,0.000333,0.197102,15,8869.569831,492.75388,591.304655,107.540616,1,0
0,0,13,13,10,16,26,63,50,113,0.000333,0.17705,15,7967.245322,442.62474,531.149688,97.219281,1,0
0,0,15,15,10,18,28,70,56,126,0.000333,0.201909,15,9085.900803,504.772267,605.72672,108.277931,1,0
0,0,18,18,14,19,33,68,67,135,0.000333,0.226998,21,14300.85733,794.492074,680.993206,134.013592,1,0
0,0,14,14,10,17,27,55,54,109,0.000333,0.172761,15,7774.241066,431.902281,518.282738,102.706149,1,0
0,0,13,13,14,18,32,62,53,115,0.000333,0.191667,14,8050,447.222222,575,128.361619,1,0
0,0,14,14,14,18,32,63,54,117,0.000333,0.195,21,12285,682.5,585,128.361619,1,0
0,0,10,10,10,10,20,47,32,79,0.000333,0.113811,15,5121.484792,284.526933,341.432319,66.438562,1,0
0,0,12,12,14,11,25,53,33,86,0.000333,0.133124,21,8386.804279,465.933571,399.371632,91.356717,2,0
0,0,11,11,11,10,21,50,33,83,0.000333,0.121521,15,5468.435191,303.801955,364.562346,71.273029,2,0
0,0,12,12,15,11,26,54,34,88,0.000333,0.13788,21,8686.412599,482.578478,413.638695,96.657107,2,0
0,0,11,11,11,11,22,50,34,84,0.000333,0.124864,15,5618.883839,312.160213,374.592256,76.107496,2,0
0,0,14,14,16,14,30,61,39,100,0.000333,0.163563,16,7851.024953,436.168053,490.68906,117.302969,2,0
0,0,13,13,13,14,27,58,39,97,0.000333,0.153741,12,5534.689053,307.482725,461.224088,101.408685,2,0
0,0,14,14,15,14,29,59,39,98,0.000333,0.158694,14,6665.149925,370.286107,476.082138,111.906328,2,0
0,0,13,13,12,14,26,56,39,95,0.000333,0.148847,12,5358.501279,297.694515,446.541773,96.322519,2,0
0,0,13,13,17,13,30,58,37,95,0.000333,0.155385,16,7458.473705,414.35965,466.154607,117.592585,2,0
0,0,12,12,13,13,26,54,37,91,0.000333,0.14258,12,5132.880172,285.16001,427.740014,96.211433,2,0
0,0,13,13,16,13,29,57,37,94,0.000333,0.152217,16,7306.403417,405.911301,456.650214,112.105716,2,0
0,0,12,12,12,13,25,53,37,90,0.000333,0.139316,12,5015.364685,278.631371,417.947057,91.125266,2,0
0,0,16,16,16,14,30,59,39,98,0.000333,0.160292,16,7694.004454,427.444692,480.875278,117.302969,2,0
0,0,15,15,13,14,27,56,39,95,0.000333,0.150571,12,5420.571752,301.142875,451.714313,101.408685,2,0
0,0,14,14,15,14,29,59,39,98,0.000333,0.158694,14,6665.149925,370.286107,476.082138,111.906328,2,0
0,0,13,13,12,14,26,56,39,95,0.000333,0.148847,12,5358.501279,297.694515,446.541773,96.322519,2,0
0,0,14,14,14,14,28,57,39,96,0.000333,0.153835,14,6461.085015,358.949168,461.506073,106.605938,2,0
0,0,13,13,11,14,25,54,39,93,0.000333,0.14396,10,4318.786256,239.93257,431.878626,91.356717,2,0
0,0,16,16,15,14,29,57,39,96,0.000333,0.155455,14,6529.126457,362.729248,466.366176,111.906328,2,0
0,0,15,15,12,14,26,54,39,93,0.000333,0.145714,12,5245.690725,291.427263,437.140894,96.322519,2,0
0,0,13,13,16,13,29,57,37,94,0.000333,0.152217,16,7306.403417,405.911301,456.650214,112.105716,2,0
0,0,12,12,12,13,25,53,37,90,0.000333,0.139316,12,5015.364685,278.631371,417.947057,91.125266,2,0
0,0,13,13,15,13,28,56,37,93,0.000333,0.149028,14,6259.176109,347.732006,447.084008,106.709075,2,0
0,0,12,12,11,13,24,52,37,89,0.000333,0.136021,10,4080.616626,226.700924,408.061663,86.159464,2,0
0,0,15,15,15,12,27,58,34,92,0.000333,0.145817,14,6124.295103,340.238617,437.44965,101.622909,2,0
0,0,15,15,15,11,26,58,34,92,0.000333,0.144147,21,9081.249535,504.513863,432.440454,96.657107,2,0
0,0,12,12,12,10,22,52,33,85,0.000333,0.126351,18,6822.930377,379.051688,379.051688,76.238831,2,0
0,0,11,11,13,12,25,55,37,92,0.000333,0.142412,18,7690.22585,427.234769,427.234769,91.125266,2,0
0,0,12,12,12,10,22,50,34,84,0.000333,0.124864,18,6742.660607,374.592256,374.592256,76.238831,1,0
0,0,16,16,16,15,31,66,51,117,0.000333,0.193214,24,13911.38324,772.854624,579.640968,122.603359,2,0
0,0,15,15,13,14,27,63,51,114,0.000333,0.180686,18,9757.029154,542.057175,542.057175,101.408685,2,0
0,0,16,16,15,17,32,65,59,124,0.000333,0.206667,21,13020,723.333333,620,128.090227,2,0
0,0,15,15,12,16,28,62,59,121,0.000333,0.193897,18,10470.41902,581.689946,581.689946,107.01955,2,0
0,0,12,12,10,11,21,53,38,91,0.000333,0.133234,15,5995.513282,333.084071,399.700885,71.273029,1,0
0,0,15,15,11,12,23,68,46,114,0.000333,0.171895,15,7735.290945,429.738386,515.686063,81.073298,1,0
0,0,17,17,14,16,30,63,50,113,0.000333,0.184826,21,11644.05138,646.891744,554.478637,117.302969,1,0
0,0,12,12,10,15,25,53,44,97,0.000333,0.150151,10,4504.540504,250.25225,450.45405,91.82264,1,0
0,0,13,13,12,12,24,58,42,100,0.000333,0.152832,18,8252.932501,458.49625,458.49625,86.0391,1,0
0,0,13,13,11,14,25,62,44,106,0.000333,0.164083,15,7383.731342,410.207297,492.248756,91.356717,1,0
0,0,14,14,11,17,28,54,48,102,0.000333,0.16345,10,4903.50202,272.416779,490.350202,107.540616,1,0
0,0,12,12,10,15,25,53,44,97,0.000333,0.150151,10,4504.540504,250.25225,450.45405,91.82264,1,0
0,0,14,14,10,16,26,59,56,115,0.000333,0.180184,15,8108.258514,450.458806,540.550568,97.219281,1,0
0,0,16,16,10,17,27,65,68,133,0.000333,0.2108,20,12648.00076,702.666709,632.400038,102.706149,1,0
0,0,18,18,10,18,28,71,80,151,0.000333,0.24197,20,14518.21187,806.567326,725.910593,108.277931,1,0
0,0,13,13,11,14,25,57,46,103,0.000333,0.159439,15,7174.757813,398.597656,478.317188,91.356717,1,0
0,0,13,13,11,16,27,59,47,106,0.000333,0.168006,10,5040.180752,280.010042,504.018075,102.053748,1,0
0,0,14,14,11,17,28,68,51,119,0.000333,0.190692,15,8581.128536,476.729363,572.075236,107.540616,1,0
0,0,13,13,10,16,26,61,48,109,0.000333,0.170783,15,7685.218939,426.956608,512.347929,97.219281,1,0
0,0,15,15,10,18,28,68,54,122,0.000333,0.195499,15,8797.459507,488.74775,586.4973,108.277931,1,0
0,0,18,18,14,19,33,66,65,131,0.000333,0.220272,21,13877.12822,770.951568,660.81563,134.013592,1,0
0,0,14,14,10,17,27,53,52,105,0.000333,0.166421,15,7488.947816,416.052656,499.263188,102.706149,1,0
0,0,13,13,14,18,32,60,51,111,0.000333,0.185,14,7770,431.666667,555,128.361619,1,0
0,0,14,14,14,18,32,61,52,113,0.000333,0.188333,14,7910,439.444444,565,128.361619,1,0
0,0,10,10,10,10,20,49,34,83,0.000333,0.119573,15,5380.800478,298.93336,358.720032,66.438562,1,0
0,0,12,12,14,11,25,55,35,90,0.000333,0.139316,21,8776.888199,487.6049,417.947057,91.356717,2,0
0,0,11,11,11,10,21,52,35,87,0.000333,0.127377,15,5731.974237,318.443013,382.131616,71.273029,2,0
0,0,12,12,15,11,26,56,36,92,0.000333,0.144147,21,9081.249535,504.513863,432.440454,96.657107,2,0
0,0,11,11,11,11,22,52,36,88,0.000333,0.13081,15,5886.449737,327.024985,392.429982,76.107496,2,0
0,0,14,14,16,14,30,63,41,104,0.000333,0.170106,16,8165.065951,453.614775,510.316622,117.302969,2,0
0,0,13,13,13,14,27,60,41,101,0.000333,0.160081,12,5762.923653,320.162425,480.243638,101.408685,2,0
0,0,14,14,15,14,29,61,41,102,0.000333,0.165171,14,6937.196861,385.399826,495.514062,111.906328,2,0
0,0,13,13,12,14,26,58,41,99,0.000333,0.155115,12,5584.122385,310.229021,465.343532,96.322519,2,0
0,0,13,13,17,13,30,60,39,99,0.000333,0.161927,24,11658.77206,647.709559,485.782169,117.592585,2,0
0,0,12,12,13,13,26,56,39,95,0.000333,0.148847,18,8037.751918,446.541773,446.541773,96.211433,2,0
0,0,13,13,16,13,29,59,39,98,0.000333,0.158694,24,11425.9713,634.776183,476.082138,112.105716,2,0
0,0,12,12,12,13,25,55,39,94,0.000333,0.145507,18,7857.404673,436.522482,436.522482,91.125266,2,0
0,0,16,16,16,14,30,61,41,102,0.000333,0.166834,16,8008.045452,444.891414,500.502841,117.302969,2,0
0,0,15,15,13,14,27,58,41,99,0.000333,0.156911,12,5648.806353,313.822575,470.733863,101.408685,2,0
0,0,14,14,15,14,29,61,41,102,0.000333,0.165171,14,6937.196861,385.399826,495.514062,111.906328,2,0
0,0,13,13,12,14,26,58,41,99,0.000333,0.155115,12,5584.122385,310.229021,465.343532,96.322519,2,0
0,0,14,14,14,14,28,59,41,100,0.000333,0.160245,14,6730.296891,373.905383,480.735492,106.605938,2,0
0,0,13,13,11,14,25,56,41,97,0.000333,0.150151,10,4504.540504,250.25225,450.45405,91.356717,2,0
0,0,16,16,15,14,29,59,41,100,0.000333,0.161933,14,6801.173393,377.842966,485.7981,111.906328,2,0
0,0,15,15,12,14,26,56,41,97,0.000333,0.151981,12,5471.311832,303.961768,455.942653,96.322519,2,0
0,0,13,13,16,13,29,59,39,98,0.000333,0.158694,24,11425.9713,634.776183,476.082138,112.105716,2,0
0,0,12,12,12,13,25,55,39,94,0.000333,0.145507,18,7857.404673,436.522482,436.522482,91.125266,2,0
0,0,13,13,15,13,28,58,39,97,0.000333,0.155438,21,9792.581976,544.032332,466.313427,106.709075,2,0
0,0,12,12,11,13,24,54,39,93,0.000333,0.142134,15,6396.022689,355.334594,426.401513,86.159464,2,0
0,0,15,15,15,12,27,60,36,96,0.000333,0.152156,21,9585.853204,532.5474,456.4692,101.622909,2,0
0,0,15,15,15,11,26,60,36,96,0.000333,0.150414,21,9476.086472,526.449248,451.242213,96.657107,2,0
0,0,12,12,12,10,22,54,35,89,0.000333,0.132296,18,7144.009453,396.889414,396.889414,76.238831,2,0
0,0,11,11,13,12,25,57,39,96,0.000333,0.148603,18,8024.583496,445.810194,445.810194,91.125266,2,0
0,0,12,12,12,10,22,52,36,88,0.000333,0.13081,18,7063.739684,392.429982,392.429982,76.238831,1,0
0,0,16,16,16,15,31,68,53,121,0.000333,0.199819,24,14386.98609,799.277005,599.457754,122.603359,2,0
0,0,15,15,13,14,27,65,53,118,0.000333,0.187026,18,10099.38106,561.076725,561.076725,101.408685,2,0
0,0,16,16,15,17,32,67,61,128,0.000333,0.213333,21,13440,746.666667,640,128.090227,2,0
0,0,15,15,12,16,28,64,61,125,0.000333,0.200306,18,10816.54858,600.919365,600.919365,107.01955,2,0
0,0,12,12,10,11,21,55,40,95,0.000333,0.13909,15,6259.052327,347.725129,417.270155,71.273029,1,0
0,0,15,15,11,12,23,70,48,118,0.000333,0.177927,20,10675.60622,593.089234,533.780311,81.073298,1,0
0,0,17,17,14,16,30,65,52,117,0.000333,0.191369,21,12056.23019,669.790566,574.1062,117.302969,1,0
0,0,12,12,10,15,25,55,46,101,0.000333,0.156343,15,7035.442128,390.857896,469.029475,91.82264,1,0
0,0,13,13,12,12,24,60,44,104,0.000333,0.158945,18,8583.049801,476.8361,476.8361,86.0391,1,0
0,0,13,13,11,14,25,64,46,110,0.000333,0.170275,15,7662.362713,425.686817,510.824181,91.356717,1,0
0,0,14,14,11,17,28,56,50,106,0.000333,0.16986,10,5095.796217,283.09979,509.579622,107.540616,1,0
0,0,12,12,10,15,25,55,46,101,0.000333,0.156343,15,7035.442128,390.857896,469.029475,91.82264,1,0
0,0,14,14,10,16,26,61,58,119,0.000333,0.186451,15,8390.284897,466.126939,559.352326,97.219281,1,0
0,0,16,16,10,17,27,67,70,137,0.000333,0.21714,20,13028.39176,723.799542,651.419588,102.706149,1,0
0,0,18,18,10,18,28,73,82,155,0.000333,0.24838,20,14902.80026,827.933348,745.140013,108.277931,1,0
0,0,13,13,11,14,25,59,48,107,0.000333,0.165631,15,7453.389185,414.077177,496.892612,91.356717,1,0
0,0,13,13,11,16,27,61,49,110,0.000333,0.174346,15,7845.564379,435.864688,523.037625,102.053748,1,0
0,0,14,14,11,17,28,70,53,123,0.000333,0.197102,15,8869.569831,492.75388,591.304655,107.540616,1,0
0,0,13,13,10,16,26,63,50,113,0.000333,0.17705,15,7967.245322,442.62474,531.149688,97.219281,1,0
0,0,15,15,10,18,28,70,56,126,0.000333,0.201909,15,9085.900803,504.772267,605.72672,108.277931,1,0
0,0,18,18,14,19,33,68,67,135,0.000333,0.226998,21,14300.85733,794.492074,680.993206,134.013592,1,0
0,0,14,14,10,17,27,55,54,109,0.000333,0.172761,15,7774.241066,431.902281,518.282738,102.706149,1,0
0,0,13,13,14,18,32,62,53,115,0.000333,0.191667,14,8050,447.222222,575,128.361619,1,0
0,0,14,14,14,18,32,63,54,117,0.000333,0.195,21,12285,682.5,585,128.361619,1,0
0,0,13,13,14,17,31,54,49,103,0.000333,0.170094,14,7143.95108,396.886171,510.28222,122.789837,1,0
0,0,14,14,13,17,30,55,50,105,0.000333,0.171741,12,6182.68215,343.482342,515.223513,117.592585,1,0
0,0,13,13,14,17,31,56,51,107,0.000333,0.1767,21,11132.07911,618.448839,530.099005,122.789837,1,0
0,0,14,14,13,17,30,57,52,109,0.000333,0.178284,18,9627.319349,534.851075,534.851075,117.592585,1,0
0,0,13,13,14,17,31,54,49,103,0.000333,0.170094,14,7143.95108,396.886171,510.28222,122.789837,1,0
0,0,14,14,13,17,30,55,50,105,0.000333,0.171741,12,6182.68215,343.482342,515.223513,117.592585,1,0
0,0,13,13,14,17,31,56,51,107,0.000333,0.1767,21,11132.07911,618.448839,530.099005,122.789837,1,0
0,0,14,14,13,17,30,57,52,109,0.000333,0.178284,18,9627.319349,534.851075,534.851075,117.592585,1,0
0,0,9,9,10,9,19,45,30,75,0.000333,0.106198,15,4778.918453,265.49547,318.594564,61.748606,1,0
0,0,11,11,14,10,24,51,31,82,0.000333,0.125322,21,7895.305426,438.628079,375.966925,86.52225,2,0
0,0,10,10,11,9,20,48,31,79,0.000333,0.113811,15,5121.484792,284.526933,341.432319,66.583073,2,0
0,0,11,11,15,10,25,52,32,84,0.000333,0.130028,21,8191.762319,455.097907,390.08392,91.82264,2,0
0,0,10,10,11,10,21,48,32,80,0.000333,0.117128,15,5270.780907,292.821162,351.385394,71.273029,2,0
0,0,13,13,16,13,29,59,37,96,0.000333,0.155455,16,7461.858809,414.547712,466.366176,112.105716,2,0
0,0,12,12,13,13,26,56,37,93,0.000333,0.145714,12,5245.690725,291.427263,437.140894,96.211433,2,0
0,0,13,13,15,13,28,57,37,94,0.000333,0.15063,14,6326.479077,351.47106,451.891363,106.709075,2,0
0,0,12,12,12,13,25,54,37,91,0.000333,0.140864,12,5071.090959,281.727276,422.590913,91.125266,2,0
0,0,12,12,17,12,29,56,35,91,0.000333,0.147359,16,7073.220329,392.956685,442.076271,112.506418,2,0
0,0,11,11,13,12,25,52,35,87,0.000333,0.134672,12,4848.185862,269.343659,404.015489,91.125266,2,0
0,0,12,12,16,12,28,55,35,90,0.000333,0.144221,16,6922.591088,384.588394,432.661943,107.01955,2,0
0,0,11,11,12,12,24,51,35,86,0.000333,0.131436,12,4731.681301,262.871183,394.306775,86.0391,2,0
0,0,15,15,16,13,29,57,37,94,0.000333,0.152217,16,7306.403417,405.911301,456.650214,112.105716,2,0
0,0,14,14,13,13,26,54,37,91,0.000333,0.14258,12,5132.880172,285.16001,427.740014,96.211433,2,0
0,0,13,13,15,13,28,57,37,94,0.000333,0.15063,14,6326.479077,351.47106,451.891363,106.709075,2,0
0,0,12,12,12,13,25,54,37,91,0.000333,0.140864,12,5071.090959,281.727276,422.590913,91.125266,2,0
0,0,13,13,14,13,27,55,37,92,0.000333,0.145817,14,6124.295103,340.238617,437.44965,101.408685,2,0
0,0,12,12,11,13,24,52,37,89,0.000333,0.136021,10,4080.616626,226.700924,408.061663,86.159464,2,0
0,0,15,15,15,13,28,55,37,92,0.000333,0.147426,14,6191.87314,343.992952,442.276653,106.709075,2,0
0,0,14,14,12,13,25,52,37,89,0.000333,0.137768,12,4959.638411,275.535467,413.303201,91.125266,2,0
0,0,12,12,16,12,28,55,35,90,0.000333,0.144221,16,6922.591088,384.588394,432.661943,107.01955,2,0
0,0,11,11,12,12,24,51,35,86,0.000333,0.131436,12,4731.681301,262.871183,394.306775,86.0391,2,0
0,0,12,12,15,12,27,54,35,89,0.000333,0.141062,14,5924.589828,329.143879,423.184988,101.622909,2,0
0,0,11,11,11,12,23,50,35,85,0.000333,0.128168,10,3845.027663,213.612648,384.502766,81.073298,2,0
0,0,14,14,15,11,26,56,32,88,0.000333,0.13788,14,5790.941733,321.718985,413.638695,96.657107,2,0
0,0,14,14,15,10,25,56,32,88,0.000333,0.13622,21,8581.846239,476.769235,408.659345,91.82264,2,0
0,0,11,11,12,9,21,50,31,81,0.000333,0.118593,18,6403.998802,355.777711,355.777711,71.548875,2,0
0,0,10,10,13,11,24,53,35,88,0.000333,0.134492,18,7262.580601,403.4767,403.4767,86.159464,2,0
0,0,11,11,12,9,21,48,32,80,0.000333,0.117128,18,6324.937089,351.385394,351.385394,71.548875,1,0
0,0,11,11,10,10,20,51,36,87,0.000333,0.125336,15,5640.116164,313.339787,376.007744,66.438562,1,0
0,0,14,14,11,11,22,66,44,110,0.000333,0.163512,20,9810.749561,545.041642,490.537478,76.107496,1,0
0,0,16,16,14,15,29,61,48,109,0.000333,0.176507,21,11119.9185,617.77325,529.519928,111.906328,1,0
0,0,11,11,10,14,24,51,42,93,0.000333,0.142134,15,6396.022689,355.334594,426.401513,86.52225,1,0
0,0,12,12,11,13,24,60,42,102,0.000333,0.155889,15,7014.992626,389.721813,467.666175,86.159464,1,0
0,0,13,13,11,16,27,52,46,98,0.000333,0.155326,10,4659.789752,258.877208,465.978975,102.053748,1,0
0,0,11,11,10,14,24,51,42,93,0.000333,0.142134,15,6396.022689,355.334594,426.401513,86.52225,1,0
0,0,13,13,10,15,25,57,54,111,0.000333,0.171823,15,7732.020556,429.556698,515.468037,91.82264,1,0
0,0,15,15,10,16,26,63,66,129,0.000333,0.202119,20,12127.13447,673.729693,606.356724,97.219281,1,0
0,0,17,17,10,17,27,69,78,147,0.000333,0.232989,20,13979.36926,776.631625,698.968463,102.706149,1,0
0,0,12,12,11,15,26,57,45,102,0.000333,0.159815,15,7191.672769,399.537376,479.444851,96.657107,1,0
0,0,13,13,11,16,27,66,49,115,0.000333,0.182271,15,8202.180941,455.676719,546.812063,102.053748,1,0
0,0,12,12,10,15,25,59,46,105,0.000333,0.162535,15,7314.073499,406.337417,487.6049,91.82264,1,0
0,0,14,14,10,17,27,66,52,118,0.000333,0.187026,15,8416.150879,467.563938,561.076725,102.706149,1,0
0,0,17,17,14,18,32,64,63,127,0.000333,0.211667,21,13335,740.833333,635,128.361619,1,0
0,0,13,13,10,16,26,51,50,101,0.000333,0.158248,15,7121.166173,395.620343,474.744412,97.219281,1,0
0,0,12,12,14,17,31,58,49,107,0.000333,0.1767,14,7421.386073,412.299226,530.099005,122.789837,1,0
0,0,13,13,14,17,31,59,50,109,0.000333,0.180002,14,7560.10357,420.005754,540.007398,122.789837,1,0
0,0,9,9,10,9,19,47,32,79,0.000333,0.111862,15,5033.794103,279.655228,335.586274,61.748606,1,0
0,0,11,11,14,10,24,53,33,86,0.000333,0.131436,21,8280.442276,460.024571,394.306775,86.52225,2,0
0,0,10,10,11,9,20,50,33,83,0.000333,0.119573,15,5380.800478,298.93336,358.720032,66.583073,2,0
0,0,11,11,15,10,25,54,34,88,0.000333,0.13622,21,8581.846239,476.769235,408.659345,91.82264,2,0
0,0,10,10,11,10,21,50,34,84,0.000333,0.122985,15,5534.319953,307.46222,368.954664,71.273029,2,0
0,0,13,13,16,13,29,61,39,100,0.000333,0.161933,24,11659.15439,647.730799,485.7981,112.105716,2,0
0,0,12,12,13,13,26,58,39,97,0.000333,0.151981,18,8206.967748,455.942653,455.942653,96.211433,2,0
0,0,13,13,15,13,28,59,39,98,0.000333,0.15704,21,9893.53643,549.640913,471.120782,106.709075,2,0
0,0,12,12,12,13,25,56,39,95,0.000333,0.147055,18,7940.994085,441.166338,441.166338,91.125266,2,0
0,0,12,12,17,12,29,58,37,95,0.000333,0.153836,24,11076.19667,615.344259,461.508195,112.506418,2,0
0,0,11,11,13,12,25,54,37,91,0.000333,0.140864,18,7606.636439,422.590913,422.590913,91.125266,2,0
0,0,12,12,16,12,28,57,37,94,0.000333,0.15063,24,10845.3927,602.521817,451.891363,107.01955,2,0
0,0,11,11,12,12,24,53,37,90,0.000333,0.137549,18,7427.639251,412.646625,412.646625,86.0391,2,0
0,0,15,15,16,13,29,59,39,98,0.000333,0.158694,24,11425.9713,634.776183,476.082138,112.105716,2,0
0,0,14,14,13,13,26,56,39,95,0.000333,0.148847,18,8037.751918,446.541773,446.541773,96.211433,2,0
0,0,13,13,15,13,28,59,39,98,0.000333,0.15704,21,9893.53643,549.640913,471.120782,106.709075,2,0
0,0,12,12,12,13,25,56,39,95,0.000333,0.147055,18,7940.994085,441.166338,441.166338,91.125266,2,0
0,0,13,13,14,13,27,57,39,96,0.000333,0.152156,21,9585.853204,532.5474,456.4692,101.408685,2,0
0,0,12,12,11,13,24,54,39,93,0.000333,0.142134,15,6396.022689,355.334594,426.401513,86.159464,2,0
0,0,15,15,15,13,28,57,39,96,0.000333,0.153835,21,9691.627523,538.423751,461.506073,106.709075,2,0
0,0,14,14,12,13,25,54,39,93,0.000333,0.14396,18,7773.815262,431.878626,431.878626,91.125266,2,0
0,0,12,12,16,12,28,57,37,94,0.000333,0.15063,24,10845.3927,602.521817,451.891363,107.01955,2,0
0,0,11,11,12,12,24,53,37,90,0.000333,0.137549,18,7427.639251,412.646625,412.646625,86.0391,2,0
0,0,12,12,15,12,27,56,37,93,0.000333,0.147402,21,9286.295292,515.905294,442.204538,101.622909,2,0
0,0,11,11,11,12,23,52,37,89,0.000333,0.134199,15,6038.955211,335.497512,402.597014,81.073298,2,0
0,0,14,14,15,11,26,58,34,92,0.000333,0.144147,21,9081.249535,504.513863,432.440454,96.657107,2,0
0,0,14,14,15,10,25,58,34,92,0.000333,0.142412,21,8971.930159,498.440564,427.234769,91.82264,2,0
0,0,11,11,12,9,21,52,33,85,0.000333,0.124449,18,6720.245657,373.346981,373.346981,71.548875,2,0
0,0,10,10,13,11,24,55,37,92,0.000333,0.140606,18,7592.697901,421.81655,421.81655,86.159464,2,0
0,0,11,11,12,9,21,50,34,84,0.000333,0.122985,18,6641.183943,368.954664,368.954664,71.548875,1,0
0,0,11,11,10,10,20,53,38,91,0.000333,0.131098,15,5899.43185,327.746214,393.295457,66.438562,1,0
0,0,14,14,11,11,22,68,46,114,0.000333,0.169458,20,10167.50409,564.861338,508.375205,76.107496,1,0
0,0,16,16,14,15,29,63,50,113,0.000333,0.182984,21,11527.9889,640.443828,548.951852,111.906328,1,0
0,0,11,11,10,14,24,53,44,97,0.000333,0.148247,15,6671.120439,370.617802,444.741363,86.52225,1,0
0,0,12,12,11,13,24,62,44,106,0.000333,0.162002,15,7290.090376,405.005021,486.006025,86.159464,1,0
0,0,13,13,11,16,27,54,48,102,0.000333,0.161666,15,7274.977878,404.165438,484.998525,102.053748,1,0
0,0,11,11,10,14,24,53,44,97,0.000333,0.148247,15,6671.120439,370.617802,444.741363,86.52225,1,0
0,0,13,13,10,15,25,59,56,115,0.000333,0.178014,15,8010.651927,445.036218,534.043462,91.82264,1,0
0,0,15,15,10,16,26,65,68,133,0.000333,0.208386,20,12503.16965,694.620536,625.158483,97.219281,1,0
0,0,17,17,10,17,27,71,80,151,0.000333,0.239329,20,14359.76026,797.764459,717.988013,102.706149,1,0
0,0,12,12,11,15,26,59,47,106,0.000333,0.166082,15,7473.699152,415.205508,498.24661,96.657107,1,0
0,0,13,13,11,16,27,68,51,119,0.000333,0.188611,15,8487.474191,471.526344,565.831613,102.053748,1,0
0,0,12,12,10,15,25,61,48,109,0.000333,0.168727,15,7592.70487,421.816937,506.180325,91.82264,1,0
0,0,14,14,10,17,27,68,54,122,0.000333,0.193365,15,8701.444129,483.413563,580.096275,102.706149,1,0
0,0,17,17,14,18,32,66,65,131,0.000333,0.218333,21,13755,764.166667,655,128.361619,1,0
0,0,13,13,10,16,26,53,52,105,0.000333,0.164515,15,7403.192556,411.288475,493.54617,97.219281,1,0
0,0,13,13,10,16,26,53,52,105,0.000333,0.164515,15,7403.192556,411.288475,493.54617,97.219281,1,0
0,0,13,13,14,17,31,61,52,113,0.000333,0.186608,21,11756.30785,653.128214,559.824183,122.789837,1,0
0,0,9,9,9,8,17,36,27,63,0.000333,0.085837,12,3090.121908,171.673439,257.510159,52.529325,1,0
0,0,11,11,13,9,22,42,28,70,0.000333,0.104053,18,5618.883839,312.160213,312.160213,76.635041,2,0
0,0,10,10,10,8,18,39,28,67,0.000333,0.093128,15,4190.774626,232.820813,279.384975,57.219281,2,0
0,0,11,11,14,9,23,43,29,72,0.000333,0.108565,21,6839.625678,379.979204,325.696461,81.832294,2,0
0,0,10,10,10,9,19,39,29,68,0.000333,0.096286,15,4332.886064,240.715892,288.859071,61.748606,2,0
0,0,13,13,15,12,27,50,34,84,0.000333,0.133137,14,5591.747703,310.65265,399.41055,101.622909,2,0
0,0,12,12,12,12,24,47,34,81,0.000333,0.123794,12,4456.583551,247.587975,371.381963,86.0391,2,0
0,0,13,13,14,12,26,48,34,82,0.000333,0.128479,14,5396.104796,299.7836,385.436057,96.322519,2,0
0,0,12,12,11,12,23,45,34,79,0.000333,0.11912,10,3573.613945,198.534108,357.361395,81.073298,2,0
0,0,12,12,16,11,27,47,32,79,0.000333,0.125212,16,6010.177803,333.898767,375.636113,102.053748,2,0
0,0,11,11,12,11,23,43,32,75,0.000333,0.113089,12,4071.20576,226.178098,339.267147,81.073298,2,0
0,0,12,12,15,11,26,46,32,78,0.000333,0.122211,14,5132.880172,285.16001,366.634298,96.657107,2,0
0,0,11,11,11,11,22,42,32,74,0.000333,0.109999,10,3299.979398,183.332189,329.99794,76.107496,2,0
0,0,15,15,15,12,27,48,34,82,0.000333,0.129967,14,5458.610852,303.256158,389.900775,101.622909,2,0
0,0,14,14,12,12,24,45,34,79,0.000333,0.120737,12,4346.544451,241.474692,362.212038,86.0391,2,0
0,0,13,13,14,12,26,48,34,82,0.000333,0.128479,14,5396.104796,299.7836,385.436057,96.322519,2,0
0,0,12,12,11,12,23,45,34,79,0.000333,0.11912,10,3573.613945,198.534108,357.361395,81.073298,2,0
0,0,13,13,13,12,25,46,34,80,0.000333,0.123836,12,4458.101942,247.67233,371.508495,91.125266,2,0
0,0,12,12,10,12,22,43,34,77,0.000333,0.114459,10,3433.762346,190.764575,343.376235,76.238831,2,0
0,0,15,15,14,12,26,46,34,80,0.000333,0.125345,14,5264.492484,292.471805,376.035177,96.322519,2,0
0,0,14,14,11,12,23,43,34,77,0.000333,0.116105,10,3483.142706,193.507928,348.314271,81.073298,2,0
0,0,12,12,15,11,26,46,32,78,0.000333,0.122211,14,5132.880172,285.16001,366.634298,96.657107,2,0
0,0,11,11,11,11,22,42,32,74,0.000333,0.109999,10,3299.979398,183.332189,329.99794,76.107496,2,0
0,0,12,12,14,11,25,45,32,77,0.000333,0.119192,14,5006.076973,278.115387,357.576927,91.356717,2,0
0,0,11,11,10,11,21,41,32,73,0.000333,0.10688,10,3206.391719,178.132873,320.639172,71.273029,2,0
0,0,14,14,14,10,24,47,29,76,0.000333,0.116152,14,4878.400101,271.022228,348.45715,86.52225,2,0
0,0,14,14,14,9,23,47,29,76,0.000333,0.114597,21,7219.604882,401.08916,343.790709,81.832294,2,0
0,0,11,11,11,8,19,41,28,69,0.000333,0.097702,15,4396.604976,244.255832,293.106998,62.053748,2,0
0,0,10,10,12,10,22,44,32,76,0.000333,0.112972,18,6100.502454,338.916803,338.916803,76.238831,2,0
0,0,11,11,11,8,19,39,29,68,0.000333,0.096286,15,4332.886064,240.715892,288.859071,62.053748,1,0
0,0,11,11,9,9,18,42,33,75,0.000333,0.104248,12,3752.932501,208.49625,312.744375,57.05865,1,0
0,0,14,14,10,10,20,57,41,98,0.000333,0.141183,20,8470.979066,470.609948,423.548953,66.438562,1,0
0,0,16,16,13,14,27,52,45,97,0.000333,0.153741,18,8302.033579,461.224088,461.224088,101.408685,1,0
0,0,11,11,9,13,22,42,39,81,0.000333,0.120405,12,4334.567533,240.809307,361.213961,76.635041,1,0
0,0,12,12,10,12,22,51,39,90,0.000333,0.133783,15,6020.232685,334.457371,401.348846,76.238831,1,0
0,0,13,13,10,15,25,43,43,86,0.000333,0.133124,10,3993.716323,221.873129,399.371632,91.82264,1,0
0,0,11,11,9,13,22,42,39,81,0.000333,0.120405,12,4334.567533,240.809307,361.213961,76.635041,1,0
0,0,13,13,9,14,23,48,51,99,0.000333,0.149278,12,5373.991604,298.555089,447.832634,81.832294,1,0
0,0,15,15,9,15,24,54,63,117,0.000333,0.178814,16,8583.049801,476.8361,536.440613,87.132684,1,0
0,0,17,17,9,16,25,60,75,135,0.000333,0.208974,16,10030.72937,557.262743,626.920586,92.529325,1,0
0,0,12,12,10,14,24,48,42,90,0.000333,0.137549,15,6189.699376,343.872188,412.646625,86.52225,1,0
0,0,13,13,10,15,25,57,46,103,0.000333,0.159439,15,7174.757813,398.597656,478.317188,91.82264,1,0
0,0,12,12,9,14,23,50,43,93,0.000333,0.14023,12,5048.295143,280.460841,420.691262,81.832294,1,0
0,0,14,14,9,16,25,57,49,106,0.000333,0.164083,12,5906.985073,328.165837,492.248756,92.529325,1,0
0,0,17,17,13,17,30,55,60,115,0.000333,0.188097,18,10157.26353,564.292418,564.292418,117.592585,1,0
0,0,13,13,9,15,24,42,47,89,0.000333,0.136021,12,4896.739951,272.041108,408.061663,87.132684,1,0
0,0,12,12,13,16,29,49,46,95,0.000333,0.153836,12,5538.098334,307.67213,461.508195,112.105716,1,0
0,0,13,13,13,16,29,50,47,97,0.000333,0.157075,12,5654.689878,314.149438,471.224157,112.105716,1,0
0,0,9,9,9,8,17,38,29,67,0.000333,0.091287,12,3286.320124,182.57334,273.86001,52.529325,1,0
0,0,11,11,13,9,22,44,30,74,0.000333,0.109999,18,5939.962916,329.99794,329.99794,76.635041,2,0
0,0,10,10,10,8,18,41,30,71,0.000333,0.098688,15,4440.970127,246.720563,296.064675,57.219281,2,0
0,0,11,11,14,9,23,45,31,76,0.000333,0.114597,21,7219.604882,401.08916,343.790709,81.832294,2,0
0,0,10,10,10,9,19,41,31,72,0.000333,0.10195,15,4587.761715,254.875651,305.850781,61.748606,2,0
0,0,13,13,15,12,27,52,36,88,0.000333,0.139477,21,8787.032104,488.16845,418.4301,101.622909,2,0
0,0,12,12,12,12,24,49,36,85,0.000333,0.129907,18,7014.992626,389.721813,389.721813,86.0391,2,0
0,0,13,13,14,12,26,50,36,86,0.000333,0.134746,21,8488.994131,471.610785,404.237816,96.322519,2,0
0,0,12,12,11,12,23,47,36,83,0.000333,0.125152,15,5631.834635,312.879702,375.455642,81.073298,2,0
0,0,12,12,16,11,27,49,34,83,0.000333,0.131552,24,9471.735904,526.20755,394.655663,102.053748,2,0
0,0,11,11,12,11,23,45,34,79,0.000333,0.11912,18,6432.505102,357.361395,357.361395,81.073298,2,0
0,0,12,12,15,11,26,48,34,82,0.000333,0.128479,21,8094.157195,449.6754,385.436057,96.657107,2,0
0,0,11,11,11,11,22,44,34,78,0.000333,0.115945,15,5217.534994,289.863055,347.835666,76.107496,2,0
0,0,15,15,15,12,27,50,36,86,0.000333,0.136307,21,8587.326829,477.073713,408.920325,101.622909,2,0
0,0,14,14,12,12,24,47,36,83,0.000333,0.126851,18,6849.933976,380.551888,380.551888,86.0391,2,0
0,0,13,13,14,12,26,50,36,86,0.000333,0.134746,21,8488.994131,471.610785,404.237816,96.322519,2,0
0,0,12,12,11,12,23,47,36,83,0.000333,0.125152,15,5631.834635,312.879702,375.455642,81.073298,2,0
0,0,13,13,13,12,25,48,36,84,0.000333,0.130028,18,7021.510559,390.08392,390.08392,91.125266,2,0
0,0,12,12,10,12,22,45,36,81,0.000333,0.120405,15,5418.209417,301.011634,361.213961,76.238831,2,0
0,0,15,15,14,12,26,48,36,84,0.000333,0.131612,21,8291.575663,460.643092,394.836936,96.322519,2,0
0,0,14,14,11,12,23,45,36,81,0.000333,0.122136,15,5496.127777,305.340432,366.408518,81.073298,2,0
0,0,12,12,15,11,26,48,34,82,0.000333,0.128479,21,8094.157195,449.6754,385.436057,96.657107,2,0
0,0,11,11,11,11,22,44,34,78,0.000333,0.115945,15,5217.534994,289.863055,347.835666,76.107496,2,0
0,0,12,12,14,11,25,47,34,81,0.000333,0.125384,21,7899.199379,438.84441,376.152351,91.356717,2,0
0,0,11,11,10,11,21,43,34,77,0.000333,0.112736,15,5073.126623,281.840368,338.208442,71.273029,2,0
0,0,14,14,14,10,24,49,31,80,0.000333,0.122266,21,7702.737001,427.929833,366.797,86.52225,2,0
0,0,14,14,14,9,23,49,31,80,0.000333,0.120628,21,7599.584086,422.199116,361.884956,81.832294,2,0
0,0,11,11,11,8,19,43,30,73,0.000333,0.103366,15,4651.480627,258.41559,310.098708,62.053748,2,0
0,0,10,10,12,10,22,46,34,80,0.000333,0.118918,18,6421.581531,356.754529,356.754529,76.238831,2,0
0,0,11,11,11,8,19,41,31,72,0.000333,0.10195,15,4587.761715,254.875651,305.850781,62.053748,1,0
0,0,11,11,9,9,18,44,35,79,0.000333,0.109808,12,3953.088901,219.61605,329.424075,57.05865,1,0
0,0,14,14,10,10,20,59,43,102,0.000333,0.146946,20,8816.733314,489.818517,440.836666,66.438562,1,0
0,0,16,16,13,14,27,54,47,101,0.000333,0.160081,18,8644.385479,480.243638,480.243638,101.408685,1,0
0,0,11,11,9,13,22,44,41,85,0.000333,0.126351,12,4548.620251,252.701125,379.051688,76.635041,1,0
0,0,12,12,10,12,22,53,41,94,0.000333,0.139729,15,6287.798582,349.322143,419.186572,76.238831,1,0
0,0,13,13,10,15,25,45,45,90,0.000333,0.139316,15,6269.205856,348.289214,417.947057,91.82264,1,0
0,0,11,11,9,13,22,44,41,85,0.000333,0.126351,12,4548.620251,252.701125,379.051688,76.635041,1,0
0,0,13,13,9,14,23,50,53,103,0.000333,0.155309,12,5591.122578,310.617921,465.926881,81.832294,1,0
0,0,15,15,9,15,24,56,65,121,0.000333,0.184927,16,8876.487401,493.138189,554.780463,87.132684,1,0
0,0,17,17,9,16,25,62,77,139,0.000333,0.215165,16,10327.93617,573.774231,645.49601,92.529325,1,0
0,0,12,12,10,14,24,50,44,94,0.000333,0.143662,15,6464.797126,359.155396,430.986475,86.52225,1,0
0,0,13,13,10,15,25,59,48,107,0.000333,0.165631,15,7453.389185,414.077177,496.892612,91.82264,1,0
0,0,12,12,9,14,23,52,45,97,0.000333,0.146262,12,5265.426117,292.523673,438.78551,81.832294,1,0
0,0,14,14,9,16,25,59,51,110,0.000333,0.170275,12,6129.890171,340.549454,510.824181,92.529325,1,0
0,0,17,17,13,17,30,57,62,119,0.000333,0.19464,18,10510.55966,583.919981,583.919981,117.592585,1,0
0,0,13,13,9,15,24,44,49,93,0.000333,0.142134,12,5116.818151,284.267675,426.401513,87.132684,1,0
0,0,12,12,13,16,29,51,48,99,0.000333,0.160313,18,8656.922133,480.940119,480.940119,112.105716,1,0
0,0,13,13,13,16,29,52,49,101,0.000333,0.163552,18,8831.809449,490.656081,490.656081,112.105716,1,0
0,0,10,10,16,14,30,45,31,76,0.000333,0.124308,16,5966.778964,331.48772,372.923685,117.302969,5,0
0,0,13,13,17,14,31,54,33,87,0.000333,0.143672,16,6896.241264,383.124515,431.015079,122.789837,7,0
0,0,12,12,16,14,30,51,33,84,0.000333,0.137393,16,6594.86096,366.381164,412.17881,117.302969,7,0
0,0,13,13,18,15,33,55,35,90,0.000333,0.151332,18,8171.918473,453.995471,453.995471,133.662009,7,0
0,0,12,12,16,15,31,51,35,86,0.000333,0.14202,16,6816.974123,378.720785,426.060883,122.603359,7,0
0,0,15,15,19,16,35,62,39,101,0.000333,0.172686,18,9325.036525,518.057585,518.057585,144.710623,7,0
0,0,14,14,18,16,34,59,39,98,0.000333,0.16619,18,8974.284452,498.571358,498.571358,139.05865,7,0
0,0,15,15,18,16,34,60,39,99,0.000333,0.167886,18,9065.858783,503.658821,503.658821,139.05865,7,0
0,0,14,14,17,16,33,57,39,96,0.000333,0.161421,16,7748.189367,430.454965,484.261835,133.486868,7,0
0,0,14,14,20,16,36,59,38,97,0.000333,0.167161,20,10029.6545,557.203028,501.482725,150.438562,7,0
0,0,13,13,18,16,34,55,38,93,0.000333,0.157711,18,8516.412796,473.134044,473.134044,139.05865,7,0
0,0,14,14,19,16,35,58,38,96,0.000333,0.164137,18,8863.401053,492.41117,492.41117,144.710623,7,0
0,0,13,13,17,16,33,54,38,92,0.000333,0.154695,16,7425.348144,412.519341,464.084259,133.486868,7,0
0,0,17,17,19,16,35,60,39,99,0.000333,0.169266,18,9140.382336,507.799019,507.799019,144.710623,7,0
0,0,16,16,18,16,34,57,39,96,0.000333,0.162799,18,8791.13579,488.396433,488.396433,139.05865,7,0
0,0,14,14,17,16,33,57,39,96,0.000333,0.161421,16,7748.189367,430.454965,484.261835,133.486868,7,0
0,0,15,15,18,16,34,60,39,99,0.000333,0.167886,18,9065.858783,503.658821,503.658821,139.05865,7,0
0,0,15,15,17,16,33,58,39,97,0.000333,0.163102,16,7828.899673,434.938871,489.30623,133.486868,7,0
0,0,14,14,16,16,32,55,39,94,0.000333,0.156667,16,7520,417.777778,470,128,7,0
0,0,17,17,18,16,34,58,39,97,0.000333,0.164495,18,8882.710121,493.483896,493.483896,139.05865,7,0
0,0,16,16,17,16,33,55,39,94,0.000333,0.158058,16,7586.768756,421.487153,474.173047,133.486868,7,0
0,0,14,14,19,16,35,58,38,96,0.000333,0.164137,18,8863.401053,492.41117,492.41117,144.710623,7,0
0,0,13,13,17,16,33,54,38,92,0.000333,0.154695,16,7425.348144,412.519341,464.084259,133.486868,7,0
0,0,14,14,18,16,34,57,38,95,0.000333,0.161103,18,8699.561459,483.30897,483.30897,139.05865,7,0
0,0,13,13,16,16,32,53,38,91,0.000333,0.151667,16,7280,404.444444,455,128,7,0
0,0,19,19,20,17,37,65,35,100,0.000333,0.173648,20,10418.90673,578.828152,520.945337,155.92543,7,0
0,0,20,20,20,16,36,67,35,102,0.000333,0.175777,20,10546.647,585.924833,527.33235,150.438562,7,0
0,0,14,14,17,14,31,55,33,88,0.000333,0.145323,16,6975.508405,387.528245,435.969275,122.789837,7,0
0,0,12,12,18,16,34,61,41,102,0.000333,0.172974,18,9340.581777,518.92121,518.92121,139.05865,7,0
0,0,14,14,18,16,34,51,35,86,0.000333,0.145841,18,7875.392478,437.521804,437.521804,139.05865,5,0
0,0,15,15,18,19,37,59,48,107,0.000333,0.185804,18,10033.40718,557.41151,557.41151,155.769273,6,0
0,0,14,14,17,19,36,56,48,104,0.000333,0.179224,16,8602.755202,477.930845,537.6722,150.197491,6,0
0,0,15,15,17,22,39,58,60,118,0.000333,0.207892,16,9978.839389,554.379966,623.677462,167.594364,6,0
0,0,14,14,16,22,38,55,60,115,0.000333,0.201171,16,9656.186625,536.454812,603.511664,162.107496,6,0
0,0,12,12,16,15,31,49,37,86,0.000333,0.14202,16,6816.974123,378.720785,426.060883,122.603359,5,0
0,0,15,15,18,16,34,62,45,107,0.000333,0.181453,18,9798.453432,544.358524,544.358524,139.05865,5,0
0,0,17,17,19,21,40,58,51,109,0.000333,0.193363,18,10441.62292,580.090162,580.090162,172.949289,5,0
0,0,12,12,17,17,34,51,39,90,0.000333,0.152624,16,7325.946491,406.997027,457.871656,138.973737,5,0
0,0,12,12,17,16,33,52,40,92,0.000333,0.154695,16,7425.348144,412.519341,464.084259,133.486868,5,0
0,0,13,13,18,18,36,58,43,101,0.000333,0.174054,18,9398.923653,522.162425,522.162425,150.1173,5,0
0,0,14,14,17,22,39,51,49,100,0.000333,0.17618,16,8456.64355,469.813531,528.540222,167.594364,5,0
0,0,12,12,16,20,36,50,45,95,0.000333,0.163714,16,7858.286002,436.571445,491.142875,150.438562,5,0
0,0,14,14,16,21,37,55,59,114,0.000333,0.197959,16,9502.042939,527.891274,593.877684,156.238666,5,0
0,0,16,16,16,22,38,60,73,133,0.000333,0.232658,24,16751.38462,930.632479,697.974359,162.107496,5,0
0,0,18,18,16,23,39,65,87,152,0.000333,0.267794,24,19281.14729,1071.17485,803.381137,168.041925,5,0
0,0,12,12,16,19,35,51,46,97,0.000333,0.165847,16,7960.647242,442.25818,497.540453,144.710623,5,0
0,0,13,13,18,21,39,55,48,103,0.000333,0.181465,18,9799.135714,544.396429,544.396429,167.297316,5,0
0,0,14,14,18,22,40,63,52,115,0.000333,0.204007,18,11016.39116,612.021731,612.021731,173.166146,5,0
0,0,13,13,17,21,38,57,49,106,0.000333,0.185427,16,8900.485063,494.471392,556.280316,161.725534,5,0
0,0,15,15,16,23,39,63,55,118,0.000333,0.207892,16,9978.839389,554.379966,623.677462,168.041925,5,0
0,0,18,18,19,24,43,62,70,132,0.000333,0.238756,18,12892.80506,716.266948,716.266948,190.749723,5,0
0,0,14,14,16,22,38,50,55,105,0.000333,0.183677,16,8816.518223,489.806568,551.032389,162.107496,5,0
0,0,13,13,20,23,43,57,53,110,0.000333,0.198963,20,11937.78246,663.210137,596.889123,190.480487,5,0
0,0,14,14,21,23,44,58,54,112,0.000333,0.203819,20,12229.12683,679.395935,611.456341,196.280591,5,0
0,0,10,10,15,12,27,47,27,74,0.000333,0.117287,14,4926.063452,273.670192,351.861675,101.622909,5,0
0,0,9,9,14,12,26,45,27,72,0.000333,0.112811,14,4738.043236,263.224624,338.43166,96.322519,5,0
0,0,10,10,16,13,29,47,29,76,0.000333,0.123069,16,5907.30489,328.183605,369.206556,112.105716,5,0
0,0,9,9,14,13,27,43,29,72,0.000333,0.114117,14,4792.926602,266.2737,342.3519,101.408685,5,0
0,0,12,12,17,14,31,54,33,87,0.000333,0.143672,16,6896.241264,383.124515,431.015079,122.789837,5,0
0,0,11,11,16,14,30,51,33,84,0.000333,0.137393,16,6594.86096,366.381164,412.17881,117.302969,5,0
0,0,12,12,16,14,30,52,33,85,0.000333,0.139029,16,6673.37121,370.742845,417.085701,117.302969,5,0
0,0,11,11,15,14,29,49,33,82,0.000333,0.132785,14,5576.962182,309.831232,398.354442,111.906328,5,0
0,0,11,11,18,14,32,51,32,83,0.000333,0.138333,18,7470,415,415,128.361619,5,0
0,0,10,10,16,14,30,47,32,79,0.000333,0.129215,16,6202.309713,344.572762,387.644357,117.302969,5,0
0,0,11,11,17,14,31,50,32,82,0.000333,0.135415,16,6499.905559,361.105864,406.244097,122.789837,5,0
0,0,10,10,15,14,29,46,32,78,0.000333,0.126308,14,5304.915247,294.717514,378.922518,111.906328,5,0
0,0,14,14,17,14,31,52,33,85,0.000333,0.140369,16,6737.706982,374.317055,421.106686,122.789837,5,0
0,0,13,13,16,14,30,49,33,82,0.000333,0.134122,16,6437.840461,357.657803,402.365029,117.302969,5,0
0,0,12,12,16,14,30,52,33,85,0.000333,0.139029,16,6673.37121,370.742845,417.085701,117.302969,5,0
0,0,11,11,15,14,29,49,33,82,0.000333,0.132785,14,5576.962182,309.831232,398.354442,111.906328,5,0
0,0,12,12,15,14,29,50,33,83,0.000333,0.134404,14,5644.973916,313.609662,403.212423,111.906328,5,0
0,0,11,11,14,14,28,47,33,80,0.000333,0.128196,14,5384.237513,299.124306,384.588394,106.605938,5,0
0,0,15,15,16,14,30,51,33,84,0.000333,0.137393,16,6594.86096,366.381164,412.17881,117.302969,5,0
0,0,14,14,15,14,29,48,33,81,0.000333,0.131165,14,5508.950448,306.052803,393.496461,111.906328,5,0
0,0,11,11,17,14,31,50,32,82,0.000333,0.135415,16,6499.905559,361.105864,406.244097,122.789837,5,0
0,0,10,10,15,14,29,46,32,78,0.000333,0.126308,14,5304.915247,294.717514,378.922518,111.906328,5,0
0,0,11,11,16,14,30,49,32,81,0.000333,0.132486,16,6359.330212,353.296123,397.458138,117.302969,5,0
0,0,10,10,14,14,28,45,32,77,0.000333,0.123389,14,5182.328606,287.907145,370.166329,106.605938,5,0
0,0,17,17,19,15,34,59,29,88,0.000333,0.149232,9,4029.27057,223.848365,447.69673,139.313982,5,0
0,0,17,17,19,14,33,59,29,88,0.000333,0.147969,18,7990.320285,443.906683,443.906683,134.013592,5,0
0,0,11,11,16,12,28,47,27,74,0.000333,0.118581,16,5691.908228,316.217124,355.744264,107.01955,5,0
0,0,9,9,16,14,30,53,35,88,0.000333,0.143935,16,6908.901959,383.827887,431.806372,117.302969,5,0
0,0,11,11,16,14,30,43,29,72,0.000333,0.117765,16,5652.737966,314.040998,353.296123,117.302969,3,0
0,0,13,13,16,17,33,54,47,101,0.000333,0.169828,16,8151.740897,452.874494,509.483806,133.486868,4,0
0,0,12,12,15,17,32,51,47,98,0.000333,0.163333,14,6860,381.111111,490,128.090227,4,0
0,0,12,12,15,20,35,50,54,104,0.000333,0.177815,14,7468.236073,414.902004,533.445434,145.041921,4,0
0,0,11,11,14,20,34,47,54,101,0.000333,0.171278,14,7193.672458,399.64847,513.833747,139.741531,4,0
0,0,9,9,14,13,27,41,31,72,0.000333,0.114117,14,4792.926602,266.2737,342.3519,101.408685,3,0
0,0,12,12,16,14,30,54,39,93,0.000333,0.152114,16,7301.453206,405.636289,456.340825,117.302969,3,0
0,0,14,14,17,19,36,50,45,95,0.000333,0.163714,16,7858.286002,436.571445,491.142875,150.197491,3,0
0,0,9,9,15,15,30,43,33,76,0.000333,0.124308,14,5220.931594,290.051755,372.923685,117.206718,3,0
0,0,10,10,16,14,30,46,35,81,0.000333,0.132486,16,6359.330212,353.296123,397.458138,117.302969,3,0
0,0,10,10,16,16,32,50,37,87,0.000333,0.145,16,6960,386.666667,435,128,3,0
0,0,11,11,15,20,35,43,43,86,0.000333,0.147039,14,6175.656752,343.092042,441.118339,145.041921,3,0
0,0,9,9,14,18,32,42,39,81,0.000333,0.135,14,5670,315,405,128.361619,3,0
0,0,11,11,14,19,33,47,53,100,0.000333,0.168146,14,7062.151767,392.341765,504.439412,134.013592,3,0
0,0,13,13,14,20,34,52,67,119,0.000333,0.201803,21,12713.56964,706.309424,605.408078,139.741531,3,0
0,0,15,15,14,21,35,57,81,138,0.000333,0.235947,21,14864.66218,825.814566,707.841056,145.541635,3,0
0,0,10,10,15,17,32,45,41,86,0.000333,0.143333,14,6020,334.444444,430,128.090227,3,0
0,0,10,10,16,19,35,47,42,89,0.000333,0.152169,16,7304.099016,405.783279,456.506189,144.710623,3,0
0,0,11,11,16,20,36,55,46,101,0.000333,0.174054,16,8354.598802,464.144378,522.162425,150.438562,3,0
0,0,10,10,15,19,34,49,43,92,0.000333,0.156016,14,6552.65214,364.03623,468.046581,139.313982,3,0
0,0,12,12,14,21,35,55,49,104,0.000333,0.177815,14,7468.236073,414.902004,533.445434,145.541635,3,0
0,0,15,15,17,22,39,54,64,118,0.000333,0.207892,16,9978.839389,554.379966,623.677462,167.594364,3,0
0,0,11,11,14,20,34,42,49,91,0.000333,0.15432,14,6481.42766,360.079314,462.959119,139.741531,3,0
0,0,10,10,18,21,39,49,47,96,0.000333,0.169133,18,9133.175034,507.398613,507.398613,167.297316,3,0
0,0,11,11,19,21,40,50,48,98,0.000333,0.17385,18,9387.881159,521.548953,521.548953,172.949289,3,0
0,0,7,7,15,13,28,37,24,61,0.000333,0.09775,7,2052.740552,114.041142,293.24865,106.709075,4,0
0,0,9,9,15,13,28,45,26,71,0.000333,0.113774,14,4778.510793,265.472822,341.322199,106.709075,6,0
0,0,9,9,13,13,26,41,24,65,0.000333,0.101843,6,1833.17149,101.842861,305.528582,96.211433,5,0
0,0,10,10,16,14,30,49,28,77,0.000333,0.125944,16,6045.289214,335.849401,377.830576,117.302969,6,0
0,0,9,9,15,14,29,45,28,73,0.000333,0.118211,14,4964.856577,275.825365,354.632613,111.906328,6,0
0,0,11,11,17,15,32,51,32,83,0.000333,0.138333,16,6640,368.888889,415,128.090227,6,0
0,0,11,11,17,15,32,51,32,83,0.000333,0.138333,16,6640,368.888889,415,128.090227,6,0
0,0,12,12,17,15,32,52,32,84,0.000333,0.14,16,6720,373.333333,420,128.090227,6,0
0,0,11,11,16,15,31,50,32,82,0.000333,0.135415,16,6499.905559,361.105864,406.244097,122.603359,6,0
0,0,11,11,18,15,33,51,31,82,0.000333,0.13788,18,7445.52572,413.640318,413.640318,133.662009,6,0
0,0,10,10,17,15,32,47,31,78,0.000333,0.13,16,6240,346.666667,390,128.090227,6,0
0,0,11,11,17,15,32,50,31,81,0.000333,0.135,16,6480,360,405,128.090227,6,0
0,0,10,10,16,15,31,46,31,77,0.000333,0.127158,16,6103.569854,339.087214,381.473116,122.603359,6,0
0,0,14,14,18,15,33,52,32,84,0.000333,0.141243,18,7627.123908,423.729106,423.729106,133.662009,6,0
0,0,13,13,17,15,32,49,32,81,0.000333,0.135,16,6480,360,405,128.090227,6,0
0,0,12,12,17,15,32,52,32,84,0.000333,0.14,16,6720,373.333333,420,128.090227,6,0
0,0,11,11,16,15,31,49,32,81,0.000333,0.133763,16,6420.638418,356.702134,401.289901,122.603359,6,0
0,0,12,12,16,15,31,50,32,82,0.000333,0.135415,16,6499.905559,361.105864,406.244097,122.603359,6,0
0,0,11,11,15,15,30,47,32,79,0.000333,0.129215,14,5427.020999,301.501167,387.644357,117.206718,6,0
0,0,14,14,17,15,32,50,32,82,0.000333,0.136667,16,6560,364.444444,410,128.090227,6,0
0,0,14,14,17,15,32,50,32,82,0.000333,0.136667,16,6560,364.444444,410,128.090227,6,0
0,0,11,11,17,15,32,50,31,81,0.000333,0.135,16,6480,360,405,128.090227,6,0
0,0,10,10,16,15,31,46,31,77,0.000333,0.127158,16,6103.569854,339.087214,381.473116,122.603359,6,0
0,0,11,11,16,15,31,49,31,80,0.000333,0.132112,16,6341.371277,352.298404,396.335705,122.603359,6,0
0,0,10,10,15,15,30,45,31,76,0.000333,0.124308,14,5220.931594,290.051755,372.923685,117.206718,6,0
0,0,17,17,20,17,37,58,30,88,0.000333,0.152811,10,4584.318962,254.684387,458.431896,155.92543,6,0
0,0,17,17,20,16,36,58,30,88,0.000333,0.151651,10,4549.534001,252.751889,454.9534,150.438562,6,0
0,0,12,12,17,14,31,48,28,76,0.000333,0.125506,16,6024.302713,334.683484,376.51892,122.789837,6,0
0,0,9,9,17,15,32,53,34,87,0.000333,0.145,16,6960,386.666667,435,128.090227,6,0
0,0,11,11,17,15,32,43,28,71,0.000333,0.118333,8,2840,157.777778,355,128.090227,4,0
0,0,11,11,16,18,34,48,41,89,0.000333,0.150928,16,7244.547086,402.474838,452.784193,139.05865,5,0
0,0,12,12,17,18,35,52,41,93,0.000333,0.159008,16,7632.373129,424.020729,477.023321,144.545518,5,0
0,0,12,12,16,21,37,50,53,103,0.000333,0.178858,16,8585.179147,476.954397,536.573697,156.238666,5,0
0,0,11,11,15,21,36,47,53,100,0.000333,0.172331,14,7237.895002,402.105278,516.9925,150.842025,5,0
0,0,9,9,15,14,29,41,30,71,0.000333,0.114972,14,4828.833109,268.268506,344.916651,111.906328,4,0
0,0,12,12,17,15,32,54,38,92,0.000333,0.153333,16,7360,408.888889,460,128.090227,4,0
0,0,14,14,18,20,38,50,44,94,0.000333,0.164435,18,8879.493353,493.305186,493.305186,161.497212,4,0
0,0,9,9,16,16,32,43,32,75,0.000333,0.125,16,6000,333.333333,375,128,4,0
0,0,10,10,17,15,32,46,34,80,0.000333,0.133333,16,6400,355.555556,400,128.090227,4,0
0,0,10,10,17,17,34,50,36,86,0.000333,0.145841,16,7000.34887,388.908271,437.521804,138.973737,4,0
0,0,11,11,16,21,37,43,42,85,0.000333,0.147601,16,7084.856577,393.603143,442.803536,156.238666,4,0
0,0,9,9,15,19,34,42,38,80,0.000333,0.135666,14,5697.958382,316.553243,406.997027,139.313982,4,0
0,0,11,11,15,20,35,47,52,99,0.000333,0.169266,14,7109.186261,394.954792,507.799019,145.041921,4,0
0,0,13,13,15,21,36,52,65,117,0.000333,0.201627,21,12702.50573,705.694763,604.881225,150.842025,4,0
0,0,15,15,15,22,37,57,80,137,0.000333,0.237898,21,14987.59733,832.644296,713.695111,156.710855,4,0
0,0,10,10,16,18,34,45,40,85,0.000333,0.144145,16,6918.949464,384.386081,432.434342,139.05865,4,0
0,0,10,10,17,20,37,47,41,88,0.000333,0.152811,16,7334.910339,407.495019,458.431896,155.92543,4,0
0,0,10,10,16,20,36,49,42,91,0.000333,0.156821,16,7527.410802,418.189489,470.463175,150.438562,4,0
0,0,12,12,15,22,37,55,48,103,0.000333,0.178858,14,7512.031753,417.335097,536.573697,156.710855,4,0
0,0,15,15,18,23,41,54,63,117,0.000333,0.208945,18,11283.00452,626.833585,626.833585,179.100575,4,0
0,0,7,7,14,12,26,37,25,62,0.000333,0.097142,14,4079.981675,226.665649,291.427263,96.322519,3,0
0,0,10,10,15,12,27,46,27,73,0.000333,0.115702,14,4859.495027,269.971946,347.106788,101.622909,5,0
0,0,9,9,14,12,26,43,27,70,0.000333,0.109677,14,4606.430924,255.912829,329.03078,96.322519,5,0
0,0,10,10,16,13,29,47,29,76,0.000333,0.123069,16,5907.30489,328.183605,369.206556,112.105716,5,0
0,0,9,9,14,13,27,43,29,72,0.000333,0.114117,14,4792.926602,266.2737,342.3519,101.408685,5,0
0,0,12,12,17,14,31,54,33,87,0.000333,0.143672,16,6896.241264,383.124515,431.015079,122.789837,5,0
0,0,11,11,16,14,30,51,33,84,0.000333,0.137393,16,6594.86096,366.381164,412.17881,117.302969,5,0
0,0,12,12,16,14,30,52,33,85,0.000333,0.139029,16,6673.37121,370.742845,417.085701,117.302969,5,0
0,0,11,11,15,14,29,49,33,82,0.000333,0.132785,14,5576.962182,309.831232,398.354442,111.906328,5,0
0,0,11,11,18,14,32,51,32,83,0.000333,0.138333,18,7470,415,415,128.361619,5,0
0,0,10,10,16,14,30,47,32,79,0.000333,0.129215,16,6202.309713,344.572762,387.644357,117.302969,5,0
0,0,13,13,19,15,34,56,36,92,0.000333,0.156016,18,8424.838465,468.046581,468.046581,139.313982,7,0
0,0,10,10,15,14,29,46,32,78,0.000333,0.126308,14,5304.915247,294.717514,378.922518,111.906328,5,0
0,0,14,14,17,14,31,52,33,85,0.000333,0.140369,16,6737.706982,374.317055,421.106686,122.789837,5,0
0,0,13,13,16,14,30,49,33,82,0.000333,0.134122,16,6437.840461,357.657803,402.365029,117.302969,5,0
0,0,12,12,16,14,30,52,33,85,0.000333,0.139029,16,6673.37121,370.742845,417.085701,117.302969,5,0
0,0,11,11,15,14,29,49,33,82,0.000333,0.132785,14,5576.962182,309.831232,398.354442,111.906328,5,0
0,0,12,12,15,14,29,50,33,83,0.000333,0.134404,14,5644.973916,313.609662,403.212423,111.906328,5,0
0,0,11,11,14,14,28,47,33,80,0.000333,0.128196,14,5384.237513,299.124306,384.588394,106.605938,5,0
0,0,15,15,16,14,30,51,33,84,0.000333,0.137393,16,6594.86096,366.381164,412.17881,117.302969,5,0
0,0,13,13,15,14,29,47,33,80,0.000333,0.129546,14,5440.938715,302.274373,388.63848,111.906328,5,0
0,0,11,11,17,14,31,50,32,82,0.000333,0.135415,16,6499.905559,361.105864,406.244097,122.789837,5,0
0,0,10,10,15,14,29,46,32,78,0.000333,0.126308,14,5304.915247,294.717514,378.922518,111.906328,5,0
0,0,11,11,16,14,30,49,32,81,0.000333,0.132486,16,6359.330212,353.296123,397.458138,117.302969,5,0
0,0,10,10,14,14,28,45,32,77,0.000333,0.123389,14,5182.328606,287.907145,370.166329,106.605938,5,0
0,0,17,17,19,15,34,59,29,88,0.000333,0.149232,9,4029.27057,223.848365,447.69673,139.313982,5,0
0,0,17,17,19,14,33,59,29,88,0.000333,0.147969,18,7990.320285,443.906683,443.906683,134.013592,5,0
0,0,11,11,16,12,28,47,27,74,0.000333,0.118581,16,5691.908228,316.217124,355.744264,107.01955,5,0
0,0,9,9,16,14,30,53,35,88,0.000333,0.143935,16,6908.901959,383.827887,431.806372,117.302969,5,0
0,0,11,11,16,14,30,43,29,72,0.000333,0.117765,16,5652.737966,314.040998,353.296123,117.302969,3,0
0,0,12,12,16,17,33,51,42,93,0.000333,0.156376,16,7506.05845,417.003247,469.128653,133.486868,4,0
0,0,11,11,15,17,32,48,42,90,0.000333,0.15,14,6300,350,450,128.090227,4,0
0,0,12,12,15,20,35,50,54,104,0.000333,0.177815,14,7468.236073,414.902004,533.445434,145.041921,4,0
0,0,11,11,14,20,34,47,54,101,0.000333,0.171278,14,7193.672458,399.64847,513.833747,139.741531,4,0
0,0,9,9,14,13,27,41,31,72,0.000333,0.114117,14,4792.926602,266.2737,342.3519,101.408685,3,0
0,0,12,12,16,14,30,54,39,93,0.000333,0.152114,16,7301.453206,405.636289,456.340825,117.302969,3,0
0,0,14,14,17,19,36,50,45,95,0.000333,0.163714,16,7858.286002,436.571445,491.142875,150.197491,3,0
0,0,9,9,15,15,30,43,33,76,0.000333,0.124308,14,5220.931594,290.051755,372.923685,117.206718,3,0
0,0,10,10,16,14,30,46,35,81,0.000333,0.132486,16,6359.330212,353.296123,397.458138,117.302969,3,0
0,0,10,10,16,16,32,50,37,87,0.000333,0.145,16,6960,386.666667,435,128,3,0
0,0,11,11,15,20,35,43,43,86,0.000333,0.147039,14,6175.656752,343.092042,441.118339,145.041921,3,0
0,0,9,9,14,18,32,42,39,81,0.000333,0.135,14,5670,315,405,128.361619,3,0
0,0,11,11,14,19,33,47,53,100,0.000333,0.168146,14,7062.151767,392.341765,504.439412,134.013592,3,0
0,0,13,13,14,20,34,52,67,119,0.000333,0.201803,21,12713.56964,706.309424,605.408078,139.741531,3,0
0,0,13,13,14,20,34,49,76,125,0.000333,0.211978,21,13354.58996,741.921664,635.932855,139.741531,3,0
0,0,10,10,15,17,32,45,41,86,0.000333,0.143333,14,6020,334.444444,430,128.090227,3,0
0,0,10,10,16,19,35,47,42,89,0.000333,0.152169,16,7304.099016,405.783279,456.506189,144.710623,3,0
0,0,11,11,16,20,36,55,46,101,0.000333,0.174054,16,8354.598802,464.144378,522.162425,150.438562,3,0
0,0,10,10,15,19,34,49,43,92,0.000333,0.156016,14,6552.65214,364.03623,468.046581,139.313982,3,0
0,0,12,12,14,21,35,55,49,104,0.000333,0.177815,14,7468.236073,414.902004,533.445434,145.541635,3,0
0,0,15,15,17,22,39,54,64,118,0.000333,0.207892,16,9978.839389,554.379966,623.677462,167.594364,3,0
0,0,11,11,14,20,34,42,49,91,0.000333,0.15432,14,6481.42766,360.079314,462.959119,139.741531,3,0
0,0,10,10,18,21,39,49,47,96,0.000333,0.169133,18,9133.175034,507.398613,507.398613,167.297316,3,0
0,0,11,11,19,21,40,50,48,98,0.000333,0.17385,18,9387.881159,521.548953,521.548953,172.949289,3,0
0,0,5,5,7,12,19,30,22,52,0.000333,0.073631,3,662.676692,36.815372,220.892231,62.671034,1,0
0,0,5,5,8,12,20,37,23,60,0.000333,0.086439,4,1037.262743,57.625708,259.315686,67.01955,1,0
0,0,8,8,8,13,21,38,26,64,0.000333,0.093703,8,2248.86652,124.937029,281.108315,72.105716,3,0
0,0,9,9,11,14,25,42,26,68,0.000333,0.105261,5,1578.911105,87.717284,315.782221,91.356717,3,0
0,0,8,8,9,13,22,45,27,72,0.000333,0.107026,8,2568.632612,142.701812,321.079077,76.635041,3,0
0,0,9,9,12,14,26,49,27,76,0.000333,0.119078,6,2143.400511,119.077806,357.233419,96.322519,3,0
0,0,8,8,8,14,22,38,28,66,0.000333,0.098107,8,2354.579895,130.809994,294.322487,77.302969,3,0
0,0,9,9,12,14,26,43,28,71,0.000333,0.111244,12,4004.77464,222.48748,333.73122,96.322519,3,0
0,0,9,9,13,14,27,50,29,79,0.000333,0.125212,12,4507.633352,250.424075,375.636113,101.408685,3,0
0,0,8,8,9,14,23,45,29,74,0.000333,0.111581,8,2677.948678,148.774927,334.743585,81.832294,3,0
0,0,10,10,10,17,27,46,32,78,0.000333,0.123627,5,1854.406126,103.022563,370.881225,102.706149,3,0
0,0,11,11,14,17,31,57,33,90,0.000333,0.148626,7,3121.143676,173.396871,445.877668,122.789837,3,0
0,0,11,11,13,17,30,55,33,88,0.000333,0.143935,6,2590.838234,143.935457,431.806372,117.592585,3,0
0,0,11,11,13,17,30,50,32,82,0.000333,0.134122,6,2414.190173,134.121676,402.365029,117.592585,3,0
0,0,11,11,9,18,27,44,34,78,0.000333,0.123627,4,1483.524901,82.41805,370.881225,103.587975,3,0
0,0,12,12,13,18,31,55,35,90,0.000333,0.148626,6,2675.266008,148.625889,445.877668,123.164366,3,0
0,0,11,11,10,18,28,51,35,86,0.000333,0.137811,5,2067.162616,114.842368,413.432523,108.277931,3,0
0,0,12,12,12,18,30,48,34,82,0.000333,0.134122,6,2414.190173,134.121676,402.365029,118.0782,3,0
0,0,11,11,15,17,32,54,34,88,0.000333,0.146667,14,6160,342.222222,440,128.090227,3,0
0,0,10,10,12,17,29,50,34,84,0.000333,0.136023,12,4896.844843,272.046936,408.070404,112.506418,3,0
0,0,8,8,9,17,26,36,29,65,0.000333,0.101843,4,1222.114327,67.89524,305.528582,98.016193,1,0
0,0,8,8,9,17,26,36,29,65,0.000333,0.101843,4,1222.114327,67.89524,305.528582,98.016193,1,0
0,0,11,11,14,17,31,53,34,87,0.000333,0.143672,14,6034.211106,335.23395,431.015079,122.789837,3,0
0,0,11,11,13,17,30,52,34,86,0.000333,0.140664,12,5063.911095,281.328394,421.992591,117.592585,3,0
0,0,11,11,13,17,30,46,33,79,0.000333,0.129215,6,2325.866142,129.214786,387.644357,117.592585,3,0
0,0,10,10,9,17,26,41,33,74,0.000333,0.115944,4,1391.330157,77.29612,347.832539,98.016193,3,0
0,0,14,14,14,18,32,54,35,89,0.000333,0.148333,7,3115,173.055556,445,128.361619,3,0
0,0,14,14,13,18,31,47,34,81,0.000333,0.133763,6,2407.739407,133.7633,401.289901,123.164366,3,0
0,0,14,14,13,18,31,47,34,81,0.000333,0.133763,6,2407.739407,133.7633,401.289901,123.164366,3,0
0,0,13,13,10,18,28,44,34,78,0.000333,0.124991,5,1874.86842,104.159357,374.973684,108.277931,3,0
0,0,12,12,13,18,31,54,35,89,0.000333,0.146974,6,2645.54083,146.974491,440.923472,123.164366,3,0
0,0,11,11,10,18,28,51,35,86,0.000333,0.137811,5,2067.162616,114.842368,413.432523,108.277931,3,0
0,0,12,12,12,18,30,47,34,81,0.000333,0.132486,6,2384.748829,132.486046,397.458138,118.0782,3,0
0,0,11,11,9,18,27,44,34,78,0.000333,0.123627,4,1483.524901,82.41805,370.881225,103.587975,3,0
0,0,11,11,9,18,27,49,35,84,0.000333,0.133137,4,1597.642201,88.7579,399.41055,103.587975,3,0
0,0,12,12,12,18,30,52,35,87,0.000333,0.1423,6,2561.396891,142.299827,426.899482,118.0782,3,0
0,0,11,11,8,18,26,42,34,76,0.000333,0.119078,4,1428.933674,79.385204,357.233419,99.05865,3,0
0,0,12,12,11,18,29,45,34,79,0.000333,0.127927,5,1918.902493,106.605694,383.780499,113.112398,3,0
0,0,14,14,13,18,31,52,35,87,0.000333,0.143672,6,2586.090474,143.671693,431.015079,123.164366,3,0
0,0,13,13,10,18,28,49,35,84,0.000333,0.134606,5,2019.089067,112.171615,403.817813,108.277931,3,0
0,0,13,13,9,18,27,42,34,76,0.000333,0.120457,4,1445.485801,80.304767,361.37145,103.587975,3,0
0,0,14,14,12,18,30,45,34,79,0.000333,0.129215,6,2325.866142,129.214786,387.644357,118.0782,3,0
0,0,11,11,14,17,31,52,34,86,0.000333,0.14202,14,5964.852358,331.380687,426.060883,122.789837,3,0
0,0,10,10,10,17,27,48,34,82,0.000333,0.129967,10,3899.007752,216.611542,389.900775,102.706149,3,0
0,0,10,10,9,17,26,41,33,74,0.000333,0.115944,4,1391.330157,77.29612,347.832539,98.016193,3,0
0,0,11,11,13,17,30,45,33,78,0.000333,0.127579,6,2296.424799,127.579155,382.737466,117.592585,3,0
0,0,11,11,13,17,30,51,34,85,0.000333,0.139029,12,5005.028408,278.057134,417.085701,117.592585,3,0
0,0,10,10,9,17,26,47,34,81,0.000333,0.126912,8,3045.884937,169.21583,380.735617,98.016193,3,0
0,0,10,10,8,17,25,40,33,73,0.000333,0.113001,4,1356.006007,75.333667,339.001502,93.486868,3,0
0,0,11,11,12,17,29,44,33,77,0.000333,0.124688,6,2244.38722,124.688179,374.064537,112.506418,3,0
0,0,14,14,12,16,28,48,30,78,0.000333,0.124991,6,2249.842104,124.991228,374.973684,107.01955,3,0
0,0,14,14,12,17,29,48,30,78,0.000333,0.126308,6,2273.535106,126.307506,378.922518,112.506418,3,0
0,0,16,16,13,17,30,59,31,90,0.000333,0.147207,6,2649.720922,147.206718,441.620154,117.592585,3,0
0,0,14,14,13,16,29,55,31,86,0.000333,0.139262,6,2506.718193,139.262122,417.786366,112.105716,3,0
0,0,10,10,10,14,24,47,29,76,0.000333,0.116152,10,3484.571501,193.587306,348.45715,86.52225,3,0
0,0,10,10,9,14,23,40,28,68,0.000333,0.102534,8,2460.817704,136.712095,307.602213,81.832294,3,0
0,0,9,9,11,17,28,55,37,92,0.000333,0.147426,10,4422.766528,245.709252,442.276653,107.540616,3,0
0,0,9,9,10,17,27,48,36,84,0.000333,0.133137,10,3994.105502,221.89475,399.41055,102.706149,3,0
0,0,9,9,10,14,24,45,27,72,0.000333,0.110039,5,1650.5865,91.69925,330.1173,86.52225,1,0
0,0,9,9,9,14,23,38,26,64,0.000333,0.096503,4,1158.031861,64.335103,289.507965,81.832294,1,0
0,0,13,13,13,20,33,57,49,106,0.000333,0.178235,12,6416.46932,356.470518,534.705777,134.544278,2,0
0,0,12,12,10,20,30,54,49,103,0.000333,0.16847,10,5054.097313,280.783184,505.409731,119.657843,2,0
0,0,12,12,9,19,28,47,43,90,0.000333,0.144221,8,3461.295544,192.294197,432.661943,109.239948,2,0
0,0,12,12,12,22,34,53,56,109,0.000333,0.184844,12,6654.401396,369.688966,554.53345,141.127046,2,0
0,0,11,11,9,21,30,50,56,106,0.000333,0.173377,8,4161.043225,231.169068,520.130403,120.767991,2,0
0,0,11,11,8,20,28,43,51,94,0.000333,0.15063,8,3615.130901,200.840606,451.891363,110.438562,2,0
0,0,9,9,7,15,22,38,32,70,0.000333,0.104053,6,1872.96128,104.053404,312.160213,78.254843,1,0
0,0,9,9,8,15,23,45,33,78,0.000333,0.117613,8,2822.702661,156.816814,352.837833,82.603359,1,0
0,0,10,10,8,14,22,53,36,89,0.000333,0.132296,8,3175.115312,176.395295,396.889414,77.302969,1,0
0,0,10,10,9,14,23,60,37,97,0.000333,0.146262,8,3510.284078,195.015782,438.78551,81.832294,1,0
0,0,12,12,11,19,30,48,42,90,0.000333,0.147207,10,4416.201536,245.34453,441.620154,118.764371,1,0
0,0,12,12,12,19,31,55,43,98,0.000333,0.161837,12,5826.134861,323.674159,485.511238,123.730173,1,0
0,0,9,9,8,16,24,39,34,73,0.000333,0.111567,8,2677.6181,148.756561,334.702263,88,1,0
0,0,9,9,9,16,25,46,35,81,0.000333,0.125384,8,3009.218811,167.178823,376.152351,92.529325,1,0
0,0,8,8,9,14,23,43,32,75,0.000333,0.113089,8,2714.137174,150.785399,339.267147,81.832294,1,0
0,0,8,8,10,14,24,50,33,83,0.000333,0.126851,10,3805.518876,211.417715,380.551888,86.52225,1,0
0,0,10,10,8,17,25,47,38,85,0.000333,0.131576,8,3157.822209,175.434567,394.727776,93.486868,1,0
0,0,10,10,9,17,26,54,39,93,0.000333,0.145714,8,3497.12715,194.284842,437.140894,98.016193,1,0
0,0,11,11,8,21,29,39,44,83,0.000333,0.134404,8,3225.699381,179.205521,403.212423,116.238666,1,0
0,0,11,11,9,21,30,46,45,91,0.000333,0.148842,8,3572.216354,198.456464,446.527044,120.767991,1,0
0,0,9,9,7,19,26,38,40,78,0.000333,0.122211,6,2199.805788,122.211433,366.634298,100.362107,1,0
0,0,9,9,8,19,27,45,41,86,0.000333,0.136307,8,3271.362601,181.742367,408.920325,104.710623,1,0
0,0,11,11,7,20,27,44,54,98,0.000333,0.155326,6,2795.873851,155.326325,465.978975,106.090046,1,0
0,0,11,11,8,20,28,51,55,106,0.000333,0.16986,8,4076.636974,226.479832,509.579622,110.438562,1,0
0,0,13,13,7,21,28,50,68,118,0.000333,0.189089,9,5105.410927,283.63394,567.267881,111.89015,1,0
0,0,13,13,8,21,29,57,69,126,0.000333,0.204035,12,7345.267265,408.070404,612.105605,116.238666,1,0
0,0,15,15,7,22,29,56,82,138,0.000333,0.223467,9,6033.612396,335.200689,670.401377,117.75898,1,0
0,0,15,15,8,22,30,63,83,146,0.000333,0.238802,12,8596.872324,477.604018,716.406027,122.107496,1,0
0,0,10,10,8,19,27,42,42,84,0.000333,0.133137,8,3195.284401,177.5158,399.41055,104.710623,1,0
0,0,10,10,9,19,28,49,43,92,0.000333,0.147426,8,3538.213223,196.567401,442.276653,109.239948,1,0
0,0,10,10,8,20,28,44,43,87,0.000333,0.139413,8,3345.919026,185.88439,418.239878,110.438562,1,0
0,0,10,10,9,20,29,51,44,95,0.000333,0.153836,8,3692.065556,205.114753,461.508195,114.967887,1,0
0,0,11,11,8,21,29,53,47,100,0.000333,0.161933,8,3886.384796,215.910266,485.7981,116.238666,1,0
0,0,11,11,9,21,30,60,48,108,0.000333,0.176648,8,4239.553475,235.530749,529.944184,120.767991,1,0
0,0,10,10,7,20,27,46,44,90,0.000333,0.142647,6,2567.639251,142.646625,427.939875,106.090046,1,0
0,0,10,10,8,20,28,53,45,98,0.000333,0.15704,8,3768.966259,209.387014,471.120782,110.438562,1,0
0,0,10,10,9,20,29,53,46,99,0.000333,0.160313,8,3847.520948,213.751164,480.940119,114.967887,1,0
0,0,10,10,10,20,30,60,47,107,0.000333,0.175012,10,5250.372937,291.687385,525.037294,119.657843,1,0
0,0,15,15,11,23,34,51,65,116,0.000333,0.196715,10,5901.456896,327.858716,590.14569,142.095673,1,0
0,0,15,15,12,23,35,58,66,124,0.000333,0.21201,12,7632.373129,424.020729,636.031094,147.061475,1,0
0,0,11,11,7,21,28,38,50,88,0.000333,0.141016,6,2538.283399,141.015744,423.047233,111.89015,1,0
0,0,11,11,8,21,29,45,51,96,0.000333,0.155455,8,3730.929404,207.273856,466.366176,116.238666,1,0
0,0,10,10,11,22,33,45,48,93,0.000333,0.156376,10,4691.286531,260.62703,469.128653,136.161243,1,0
0,0,10,10,12,22,34,52,49,101,0.000333,0.171278,12,6166.004964,342.555831,513.833747,141.127046,1,0
0,0,7,7,10,12,22,44,27,71,0.000333,0.10554,10,3166.196449,175.899803,316.619645,76.238831,1,0
0,0,9,9,14,12,26,50,28,78,0.000333,0.122211,14,5132.880172,285.16001,366.634298,96.322519,2,0
0,0,8,8,11,12,23,47,28,75,0.000333,0.113089,10,3392.671467,188.481748,339.267147,81.073298,2,0
0,0,10,10,15,13,28,53,31,84,0.000333,0.134606,14,5653.449388,314.080522,403.817813,106.709075,2,0
0,0,9,9,11,13,24,49,31,80,0.000333,0.122266,10,3667.970001,203.776111,366.797,86.159464,2,0
0,0,12,12,16,15,31,60,36,96,0.000333,0.158534,16,7609.645533,422.758085,475.602846,122.603359,2,0
0,0,11,11,13,15,28,57,36,93,0.000333,0.149028,12,5365.008093,298.056005,447.084008,106.709075,2,0
0,0,12,12,15,15,30,58,36,94,0.000333,0.153749,14,6457.468024,358.748224,461.247716,117.206718,2,0
0,0,11,11,12,15,27,55,36,91,0.000333,0.144232,12,5192.337152,288.463175,432.694763,101.622909,2,0
0,0,11,11,17,15,32,57,34,91,0.000333,0.151667,16,7280,404.444444,455,128.090227,2,0
0,0,10,10,13,15,28,53,34,87,0.000333,0.139413,12,5018.878539,278.826585,418.239878,106.709075,2,0
0,0,11,11,16,15,31,56,34,90,0.000333,0.148626,16,7134.042687,396.335705,445.877668,122.603359,2,0
0,0,10,10,12,15,27,52,34,86,0.000333,0.136307,12,4907.043902,272.61355,408.920325,101.622909,2,0
0,0,14,14,16,15,31,58,36,94,0.000333,0.155231,16,7451.111251,413.950625,465.694453,122.603359,2,0
0,0,13,13,13,15,28,55,36,91,0.000333,0.145823,12,5249.631575,291.646199,437.469298,106.709075,2,0
0,0,12,12,15,15,30,58,36,94,0.000333,0.153749,14,6457.468024,358.748224,461.247716,117.206718,2,0
0,0,11,11,12,15,27,55,36,91,0.000333,0.144232,12,5192.337152,288.463175,432.694763,101.622909,2,0
0,0,12,12,14,15,29,56,36,92,0.000333,0.148978,14,6257.079522,347.615529,446.934252,111.906328,2,0
0,0,11,11,11,15,26,53,36,89,0.000333,0.139446,10,4183.391349,232.410631,418.339135,96.657107,2,0
0,0,14,14,15,15,30,56,36,92,0.000333,0.150478,14,6320.075087,351.115283,451.433935,117.206718,2,0
0,0,13,13,12,15,27,53,36,89,0.000333,0.141062,12,5078.219852,282.123325,423.184988,101.622909,2,0
0,0,11,11,16,15,31,56,34,90,0.000333,0.148626,16,7134.042687,396.335705,445.877668,122.603359,2,0
0,0,10,10,12,15,27,52,34,86,0.000333,0.136307,12,4907.043902,272.61355,408.920325,101.622909,2,0
0,0,11,11,15,15,30,55,34,89,0.000333,0.145571,14,6113.985682,339.665871,436.713263,117.206718,2,0
0,0,10,10,11,15,26,51,34,85,0.000333,0.133179,10,3995.37376,221.965209,399.537376,96.657107,2,0
0,0,12,12,15,14,29,57,31,88,0.000333,0.142501,14,5985.032586,332.50181,427.502328,111.906328,2,0
0,0,12,12,15,13,28,57,31,88,0.000333,0.141016,14,5922.661264,329.036737,423.047233,106.709075,2,0
0,0,10,10,12,12,24,51,30,81,0.000333,0.123794,12,4456.583551,247.587975,371.381963,86.0391,2,0
0,0,9,9,13,13,26,54,34,88,0.000333,0.13788,12,4963.664342,275.75913,413.638695,96.211433,2,0
0,0,10,10,12,12,24,49,31,80,0.000333,0.122266,12,4401.564001,244.531333,366.797,86.0391,1,0
0,0,9,9,10,13,23,50,33,83,0.000333,0.125152,10,3754.556424,208.586468,375.455642,81.324997,1,0
0,0,11,11,11,14,25,60,38,98,0.000333,0.151699,10,4550.979066,252.83217,455.097907,91.356717,1,0
0,0,14,14,14,19,33,60,47,107,0.000333,0.179917,14,7556.502391,419.805688,539.750171,134.013592,1,0
0,0,7,7,9,14,23,23,27,50,0.000333,0.075393,4,904.712391,50.2618,226.178098,81.832294,1,0
0,0,10,10,11,16,27,59,39,98,0.000333,0.155326,10,4659.789752,258.877208,465.978975,102.053748,1,0
0,0,12,12,11,20,31,53,47,100,0.000333,0.16514,10,4954.19631,275.233128,495.419631,124.49231,1,0
0,0,10,10,10,18,28,52,43,95,0.000333,0.152233,10,4566.987176,253.72151,456.698718,108.277931,1,0
0,0,12,12,10,19,29,58,57,115,0.000333,0.186223,15,8380.017217,465.556512,558.667814,113.929904,1,0
0,0,14,14,10,20,30,64,71,135,0.000333,0.22081,15,9936.453456,552.025192,662.43023,119.657843,1,0
0,0,16,16,10,21,31,70,85,155,0.000333,0.255967,20,15358.00856,853.222698,767.900428,125.457947,1,0
0,0,11,11,11,19,30,58,46,104,0.000333,0.170106,10,5103.166219,283.509234,510.316622,118.764371,1,0
0,0,12,12,11,20,31,67,50,117,0.000333,0.193214,10,5796.409683,322.02276,579.640968,124.49231,1,0
0,0,11,11,10,19,29,60,47,107,0.000333,0.173268,10,5198.039665,288.779981,519.803966,113.929904,1,0
0,0,13,13,10,21,31,67,53,120,0.000333,0.198168,10,5945.035572,330.279754,594.503557,125.457947,1,0
0,0,16,16,14,22,36,65,68,133,0.000333,0.2292,21,14439.60053,802.200029,687.600025,151.410465,1,0
0,0,12,12,10,20,30,52,53,105,0.000333,0.171741,10,5152.235125,286.235285,515.223513,119.657843,1,0
0,0,11,11,14,21,35,59,51,110,0.000333,0.188074,14,7899.095846,438.838658,564.221132,145.541635,1,0
0,0,12,12,14,21,35,60,52,112,0.000333,0.191493,14,8042.715771,446.817543,574.479698,145.541635,1,0
0,0,8,8,10,13,23,56,33,89,0.000333,0.134199,10,4025.970141,223.665008,402.597014,81.324997,1,0
0,0,10,10,14,13,27,62,34,96,0.000333,0.152156,14,6390.568803,355.0316,456.4692,101.408685,2,0
0,0,9,9,11,13,24,59,34,93,0.000333,0.142134,10,4264.015126,236.889729,426.401513,86.159464,2,0
0,0,10,10,15,14,29,63,35,98,0.000333,0.158694,14,6665.149925,370.286107,476.082138,111.906328,2,0
0,0,9,9,11,14,25,59,35,94,0.000333,0.145507,10,4365.224818,242.51249,436.522482,91.356717,2,0
0,0,12,12,16,16,32,70,40,110,0.000333,0.183333,16,8800,488.888889,550,128,2,0
0,0,11,11,13,16,29,67,40,107,0.000333,0.173268,12,6237.647598,346.535978,519.803966,112.105716,2,0
0,0,12,12,15,16,31,68,40,108,0.000333,0.178351,14,7490.744821,416.15249,535.053202,122.603359,2,0
0,0,11,11,12,16,28,65,40,105,0.000333,0.168257,12,6057.267202,336.514845,504.772267,107.01955,2,0
0,0,11,11,17,16,33,67,38,105,0.000333,0.176554,16,8474.582121,470.810118,529.661383,133.486868,2,0
0,0,10,10,13,16,29,63,38,101,0.000333,0.163552,12,5887.872966,327.104054,490.656081,112.105716,2,0
0,0,11,11,16,16,32,66,38,104,0.000333,0.173333,16,8320,462.222222,520,128,2,0
0,0,10,10,12,16,28,62,38,100,0.000333,0.160245,12,5768.825906,320.490328,480.735492,107.01955,2,0
0,0,14,14,16,16,32,68,40,108,0.000333,0.18,16,8640,480,540,128,2,0
0,0,13,13,13,16,29,65,40,105,0.000333,0.170029,12,6121.056054,340.05867,510.088004,112.105716,2,0
0,0,12,12,15,16,31,68,40,108,0.000333,0.178351,14,7490.744821,416.15249,535.053202,122.603359,2,0
0,0,11,11,12,16,28,65,40,105,0.000333,0.168257,12,6057.267202,336.514845,504.772267,107.01955,2,0
0,0,12,12,14,16,30,66,40,106,0.000333,0.173377,14,7281.825644,404.545869,520.130403,117.302969,2,0
0,0,11,11,11,16,27,63,40,103,0.000333,0.163251,10,4897.534127,272.085229,489.753413,102.053748,2,0
0,0,14,14,15,16,31,66,40,106,0.000333,0.175048,14,7352.027325,408.445962,525.144809,122.603359,2,0
0,0,14,14,13,16,29,64,40,104,0.000333,0.16841,12,6062.760282,336.820016,505.230023,112.105716,2,0
0,0,11,11,16,16,32,66,38,104,0.000333,0.173333,16,8320,462.222222,520,128,2,0
0,0,10,10,12,16,28,62,38,100,0.000333,0.160245,12,5768.825906,320.490328,480.735492,107.01955,2,0
0,0,11,11,15,16,31,65,38,103,0.000333,0.170094,14,7143.95108,396.886171,510.28222,122.603359,2,0
0,0,10,10,11,16,27,61,38,99,0.000333,0.156911,10,4707.338627,261.518813,470.733863,102.053748,2,0
0,0,12,12,15,15,30,67,35,102,0.000333,0.166834,14,7007.039771,389.279987,500.502841,117.206718,2,0
0,0,12,12,15,14,29,67,35,102,0.000333,0.165171,14,6937.196861,385.399826,495.514062,111.906328,2,0
0,0,10,10,12,13,25,61,34,95,0.000333,0.147055,12,5293.996056,294.110892,441.166338,91.125266,2,0
0,0,9,9,13,14,27,64,38,102,0.000333,0.161666,12,5819.982303,323.33235,484.998525,101.408685,2,0
0,0,10,10,12,13,25,59,35,94,0.000333,0.145507,12,5238.269782,291.014988,436.522482,91.125266,1,0
0,0,10,10,10,14,24,62,39,101,0.000333,0.15436,10,4630.812126,257.26734,463.081213,86.52225,1,0
0,0,13,13,11,15,26,77,47,124,0.000333,0.194285,15,8742.817876,485.712104,582.854525,96.657107,1,0
0,0,15,15,14,20,34,72,53,125,0.000333,0.211978,14,8903.059972,494.614443,635.932855,139.741531,1,0
0,0,10,10,10,19,29,62,47,109,0.000333,0.176507,10,5295.199285,294.177738,529.519928,113.929904,1,0
0,0,11,11,11,17,28,71,45,116,0.000333,0.185884,10,5576.53171,309.807317,557.653171,107.540616,1,0
0,0,12,12,11,21,32,63,51,114,0.000333,0.19,10,5700,316.666667,570,130.292414,1,0
0,0,10,10,10,19,29,62,47,109,0.000333,0.176507,10,5295.199285,294.177738,529.519928,113.929904,1,0
0,0,12,12,10,20,30,68,61,129,0.000333,0.210996,15,9494.833303,527.490739,632.988887,119.657843,1,0
0,0,14,14,10,21,31,74,75,149,0.000333,0.246058,15,11072.62875,615.146042,738.17525,125.457947,1,0
0,0,11,11,11,20,31,68,50,118,0.000333,0.194865,10,5845.951646,324.775091,584.595165,124.49231,1,0
0,0,12,12,11,21,32,77,54,131,0.000333,0.218333,10,6550,363.888889,655,130.292414,1,0
0,0,11,11,10,20,30,70,51,121,0.000333,0.197911,10,5937.337621,329.85209,593.733762,119.657843,1,0
0,0,13,13,10,22,32,77,57,134,0.000333,0.223333,10,6700,372.222222,670,131.326777,1,0
0,0,16,16,14,23,37,75,72,147,0.000333,0.255263,21,16081.58254,893.421252,765.789645,157.344894,1,0
0,0,12,12,10,21,31,62,57,119,0.000333,0.196516,10,5895.493609,327.527423,589.549361,125.457947,1,0
0,0,8,8,10,13,23,56,33,89,0.000333,0.134199,10,4025.970141,223.665008,402.597014,81.324997,1,0
0,0,10,10,14,13,27,62,34,96,0.000333,0.152156,14,6390.568803,355.0316,456.4692,101.408685,2,0
0,0,9,9,11,13,24,59,34,93,0.000333,0.142134,10,4264.015126,236.889729,426.401513,86.159464,2,0
0,0,10,10,15,14,29,63,35,98,0.000333,0.158694,14,6665.149925,370.286107,476.082138,111.906328,2,0
0,0,9,9,11,14,25,59,35,94,0.000333,0.145507,10,4365.224818,242.51249,436.522482,91.356717,2,0
0,0,12,12,16,16,32,70,40,110,0.000333,0.183333,16,8800,488.888889,550,128,2,0
0,0,11,11,13,16,29,67,40,107,0.000333,0.173268,12,6237.647598,346.535978,519.803966,112.105716,2,0
0,0,12,12,15,16,31,68,40,108,0.000333,0.178351,14,7490.744821,416.15249,535.053202,122.603359,2,0
0,0,11,11,12,16,28,65,40,105,0.000333,0.168257,12,6057.267202,336.514845,504.772267,107.01955,2,0
0,0,11,11,17,16,33,67,38,105,0.000333,0.176554,16,8474.582121,470.810118,529.661383,133.486868,2,0
0,0,10,10,13,16,29,63,38,101,0.000333,0.163552,12,5887.872966,327.104054,490.656081,112.105716,2,0
0,0,11,11,16,16,32,66,38,104,0.000333,0.173333,16,8320,462.222222,520,128,2,0
0,0,10,10,12,16,28,62,38,100,0.000333,0.160245,12,5768.825906,320.490328,480.735492,107.01955,2,0
0,0,14,14,16,16,32,68,40,108,0.000333,0.18,16,8640,480,540,128,2,0
0,0,13,13,13,16,29,65,40,105,0.000333,0.170029,12,6121.056054,340.05867,510.088004,112.105716,2,0
0,0,12,12,15,16,31,68,40,108,0.000333,0.178351,14,7490.744821,416.15249,535.053202,122.603359,2,0
0,0,11,11,12,16,28,65,40,105,0.000333,0.168257,12,6057.267202,336.514845,504.772267,107.01955,2,0
0,0,12,12,14,16,30,66,40,106,0.000333,0.173377,14,7281.825644,404.545869,520.130403,117.302969,2,0
0,0,11,11,11,16,27,63,40,103,0.000333,0.163251,10,4897.534127,272.085229,489.753413,102.053748,2,0
0,0,14,14,15,16,31,66,40,106,0.000333,0.175048,14,7352.027325,408.445962,525.144809,122.603359,2,0
0,0,13,13,12,16,28,63,40,103,0.000333,0.165053,12,5941.890684,330.105038,495.157557,107.01955,2,0
0,0,11,11,16,16,32,66,38,104,0.000333,0.173333,16,8320,462.222222,520,128,2,0
0,0,10,10,12,16,28,62,38,100,0.000333,0.160245,12,5768.825906,320.490328,480.735492,107.01955,2,0
0,0,11,11,15,16,31,65,38,103,0.000333,0.170094,14,7143.95108,396.886171,510.28222,122.603359,2,0
0,0,10,10,11,16,27,61,38,99,0.000333,0.156911,10,4707.338627,261.518813,470.733863,102.053748,2,0
0,0,12,12,15,15,30,67,35,102,0.000333,0.166834,14,7007.039771,389.279987,500.502841,117.206718,2,0
0,0,12,12,15,14,29,67,35,102,0.000333,0.165171,14,6937.196861,385.399826,495.514062,111.906328,2,0
0,0,10,10,12,13,25,61,34,95,0.000333,0.147055,12,5293.996056,294.110892,441.166338,91.125266,2,0
0,0,9,9,13,14,27,64,38,102,0.000333,0.161666,12,5819.982303,323.33235,484.998525,101.408685,2,0
0,0,10,10,12,13,25,59,35,94,0.000333,0.145507,12,5238.269782,291.014988,436.522482,91.125266,1,0
0,0,10,10,10,14,24,62,39,101,0.000333,0.15436,10,4630.812126,257.26734,463.081213,86.52225,1,0
0,0,13,13,11,15,26,77,47,124,0.000333,0.194285,15,8742.817876,485.712104,582.854525,96.657107,1,0
0,0,15,15,14,20,34,72,53,125,0.000333,0.211978,14,8903.059972,494.614443,635.932855,139.741531,1,0
0,0,10,10,10,19,29,62,47,109,0.000333,0.176507,10,5295.199285,294.177738,529.519928,113.929904,1,0
0,0,11,11,11,17,28,71,45,116,0.000333,0.185884,10,5576.53171,309.807317,557.653171,107.540616,1,0
0,0,12,12,11,21,32,63,51,114,0.000333,0.19,10,5700,316.666667,570,130.292414,1,0
0,0,10,10,10,19,29,62,47,109,0.000333,0.176507,10,5295.199285,294.177738,529.519928,113.929904,1,0
0,0,12,12,10,20,30,68,61,129,0.000333,0.210996,15,9494.833303,527.490739,632.988887,119.657843,1,0
0,0,14,14,10,21,31,74,75,149,0.000333,0.246058,15,11072.62875,615.146042,738.17525,125.457947,1,0
0,0,11,11,11,20,31,68,50,118,0.000333,0.194865,10,5845.951646,324.775091,584.595165,124.49231,1,0
0,0,12,12,11,21,32,77,54,131,0.000333,0.218333,10,6550,363.888889,655,130.292414,1,0
0,0,11,11,10,20,30,70,51,121,0.000333,0.197911,10,5937.337621,329.85209,593.733762,119.657843,1,0
0,0,13,13,10,22,32,77,57,134,0.000333,0.223333,10,6700,372.222222,670,131.326777,1,0
0,0,16,16,14,23,37,75,72,147,0.000333,0.255263,21,16081.58254,893.421252,765.789645,157.344894,1,0
0,0,12,12,10,21,31,62,57,119,0.000333,0.196516,10,5895.493609,327.527423,589.549361,125.457947,1,0
0,0,11,11,14,22,36,69,55,124,0.000333,0.21369,14,8974.989803,498.610545,641.0707,151.410465,1,0
0,0,12,12,14,22,36,70,56,126,0.000333,0.217137,14,9119.747703,506.65265,651.41055,151.410465,1,0
0,0,8,8,10,13,23,50,32,82,0.000333,0.123644,10,3709.320804,206.073378,370.93208,81.324997,1,0
0,0,10,10,14,13,27,56,33,89,0.000333,0.141062,14,5924.589828,329.143879,423.184988,101.408685,2,0
0,0,9,9,11,13,24,53,33,86,0.000333,0.131436,10,3943.067751,219.059319,394.306775,86.159464,2,0
0,0,10,10,15,14,29,57,34,91,0.000333,0.147359,14,6189.067788,343.837099,442.076271,111.906328,2,0
0,0,9,9,11,14,25,53,34,87,0.000333,0.134672,10,4040.154885,224.453049,404.015489,91.356717,2,0
0,0,10,10,14,14,28,56,33,89,0.000333,0.142618,14,5989.964233,332.775791,427.854588,106.605938,2,0
0,0,9,9,11,14,25,53,33,86,0.000333,0.133124,10,3993.716323,221.873129,399.371632,91.356717,2,0
0,0,12,12,15,16,31,62,39,101,0.000333,0.166791,14,7005.233583,389.179643,500.373827,122.603359,2,0
0,0,11,11,12,16,28,59,39,98,0.000333,0.15704,12,5653.449388,314.080522,471.120782,107.01955,2,0
0,0,11,11,17,16,33,61,37,98,0.000333,0.164784,16,7909.609979,439.422777,494.350624,133.486868,2,0
0,0,10,10,13,16,29,57,37,94,0.000333,0.152217,12,5479.802563,304.433476,456.650214,112.105716,2,0
0,0,11,11,16,16,32,60,37,97,0.000333,0.161667,16,7760,431.111111,485,128,2,0
0,0,10,10,12,16,28,56,37,93,0.000333,0.149028,12,5365.008093,298.056005,447.084008,107.01955,2,0
0,0,14,14,16,16,32,62,39,101,0.000333,0.168333,16,8080,448.888889,505,128,2,0
0,0,13,13,13,16,29,59,39,98,0.000333,0.158694,12,5712.98565,317.388092,476.082138,112.105716,2,0
0,0,10,10,14,14,28,56,33,89,0.000333,0.142618,14,5989.964233,332.775791,427.854588,106.605938,2,0
0,0,9,9,11,14,25,53,33,86,0.000333,0.133124,10,3993.716323,221.873129,399.371632,91.356717,2,0
0,0,10,10,14,14,28,56,33,89,0.000333,0.142618,14,5989.964233,332.775791,427.854588,106.605938,2,0
0,0,9,9,11,14,25,53,33,86,0.000333,0.133124,10,3993.716323,221.873129,399.371632,91.356717,2,0
0,0,10,10,14,14,28,56,33,89,0.000333,0.142618,14,5989.964233,332.775791,427.854588,106.605938,2,0
0,0,9,9,11,14,25,53,33,86,0.000333,0.133124,10,3993.716323,221.873129,399.371632,91.356717,2,0
0,0,12,12,12,14,26,60,37,97,0.000333,0.151981,12,5471.311832,303.961768,455.942653,96.322519,2,0
0,0,10,10,15,15,30,57,34,91,0.000333,0.148842,14,6251.378619,347.298812,446.527044,117.206718,2,0
0,0,9,9,11,15,26,53,34,87,0.000333,0.136313,10,4089.382555,227.18792,408.938255,96.657107,2,0
0,0,10,10,15,15,30,57,34,91,0.000333,0.148842,14,6251.378619,347.298812,446.527044,117.206718,2,0
0,0,9,9,11,15,26,53,34,87,0.000333,0.136313,10,4089.382555,227.18792,408.938255,96.657107,2,0
0,0,12,12,15,15,30,61,34,95,0.000333,0.155385,14,6526.164492,362.564694,466.154607,117.206718,2,0
0,0,12,12,15,14,29,61,34,95,0.000333,0.153836,14,6461.114724,358.950818,461.508195,111.906328,2,0
0,0,10,10,12,13,25,55,33,88,0.000333,0.13622,12,4903.912136,272.439563,408.659345,91.125266,2,0
0,0,9,9,13,14,27,58,37,95,0.000333,0.150571,12,5420.571752,301.142875,451.714313,101.408685,2,0
0,0,10,10,12,13,25,53,34,87,0.000333,0.134672,12,4848.185862,269.343659,404.015489,91.125266,1,0
0,0,10,10,10,14,24,56,38,94,0.000333,0.143662,10,4309.864751,239.436931,430.986475,86.52225,1,0
0,0,13,13,11,15,26,71,46,117,0.000333,0.183317,15,8249.271705,458.292873,549.951447,96.657107,1,0
0,0,15,15,14,20,34,66,52,118,0.000333,0.200107,14,8404.488614,466.916034,600.320615,139.741531,1,0
0,0,10,10,10,19,29,56,46,102,0.000333,0.165171,10,4955.140615,275.28559,495.514062,113.929904,1,0
0,0,11,11,11,17,28,65,44,109,0.000333,0.174667,10,5240.016865,291.112048,524.001687,107.540616,1,0
0,0,12,12,11,21,32,57,50,107,0.000333,0.178333,10,5350,297.222222,535,130.292414,1,0
0,0,10,10,10,19,29,56,46,102,0.000333,0.165171,10,4955.140615,275.28559,495.514062,113.929904,1,0
0,0,12,12,10,22,32,62,58,120,0.000333,0.2,10,6000,333.333333,600,131.326777,1,0
0,0,14,14,10,21,31,68,74,142,0.000333,0.234499,15,10552.43814,586.246563,703.495876,125.457947,1,0
0,0,16,16,10,22,32,74,88,162,0.000333,0.27,20,16200,900,810,131.326777,1,0
0,0,11,11,11,20,31,62,49,111,0.000333,0.183305,10,5499.157905,305.508772,549.91579,124.49231,1,0
0,0,12,12,11,21,32,71,53,124,0.000333,0.206667,10,6200,344.444444,620,130.292414,1,0
0,0,11,11,10,20,30,64,50,114,0.000333,0.186462,10,5593.855279,310.769738,559.385528,119.657843,1,0
0,0,13,13,10,22,32,71,56,127,0.000333,0.211667,10,6350,352.777778,635,131.326777,1,0
0,0,16,16,14,23,37,69,71,140,0.000333,0.243108,21,15315.7929,850.877383,729.323471,157.344894,1,0
0,0,12,12,10,21,31,56,56,112,0.000333,0.184957,10,5548.699868,308.261104,554.869987,125.457947,1,0
0,0,11,11,14,22,36,63,54,117,0.000333,0.201627,14,8468.337152,470.463175,604.881225,151.410465,1,0
0,0,12,12,14,22,36,64,55,119,0.000333,0.205074,14,8613.095052,478.505281,615.221075,151.410465,1,0
0,0,8,8,9,11,20,24,23,47,0.000333,0.06771,8,1625.044964,90.280276,203.13062,66.583073,1,0
0,0,10,10,13,11,24,30,24,54,0.000333,0.082529,12,2971.0557,165.05865,247.587975,86.159464,2,0
0,0,9,9,10,11,21,27,24,51,0.000333,0.074669,10,2240.081886,124.448994,224.008189,71.273029,2,0
0,0,10,10,14,12,26,31,25,56,0.000333,0.087742,14,3685.144739,204.730263,263.224624,96.322519,2,0
0,0,9,9,10,12,22,27,25,52,0.000333,0.077297,10,2318.904442,128.828025,231.890444,76.238831,2,0
0,0,12,12,15,14,29,38,30,68,0.000333,0.110114,14,4624.797907,256.933217,330.342708,111.906328,2,0
0,0,11,11,12,14,26,35,30,65,0.000333,0.101843,12,3666.34298,203.685721,305.528582,96.322519,2,0
0,0,12,12,14,14,28,36,30,66,0.000333,0.105762,14,4441.995948,246.777553,317.285425,106.605938,2,0
0,0,11,11,11,14,25,33,30,63,0.000333,0.097521,10,2925.6294,162.534967,292.56294,91.356717,2,0
0,0,10,10,14,13,27,31,25,56,0.000333,0.088758,7,1863.915901,103.550883,266.2737,101.408685,2,0
0,0,9,9,10,13,23,27,25,52,0.000333,0.078408,5,1176.126109,65.340339,235.225222,81.324997,2,0
0,0,11,11,15,14,29,34,28,62,0.000333,0.100398,14,4216.727504,234.262639,301.194822,111.906328,2,0
0,0,10,10,11,14,25,30,28,58,0.000333,0.089781,10,2693.43659,149.635366,269.343659,91.356717,2,0
0,0,14,14,15,14,29,36,30,66,0.000333,0.106876,14,4488.774439,249.376358,320.626746,111.906328,2,0
0,0,13,13,12,14,26,33,30,63,0.000333,0.098709,12,3553.532427,197.418468,296.127702,96.322519,2,0
0,0,10,10,13,12,25,30,24,54,0.000333,0.083589,12,3009.218811,167.178823,250.768234,91.125266,2,0
0,0,9,9,10,12,22,27,24,51,0.000333,0.07581,10,2274.310126,126.350563,227.431013,76.238831,2,0
0,0,12,12,13,14,27,34,30,64,0.000333,0.101438,12,3651.753602,202.8752,304.3128,101.408685,2,0
0,0,11,11,10,14,24,31,30,61,0.000333,0.093228,10,2796.827125,155.379285,279.682713,86.52225,2,0
0,0,15,15,14,14,28,35,30,65,0.000333,0.104159,14,4374.692979,243.038499,312.47807,106.605938,2,0
0,0,14,14,12,14,26,32,30,62,0.000333,0.097142,12,3497.12715,194.284842,291.427263,96.322519,2,0
0,0,10,10,14,13,27,31,25,56,0.000333,0.088758,7,1863.915901,103.550883,266.2737,101.408685,2,0
0,0,9,9,10,13,23,27,25,52,0.000333,0.078408,5,1176.126109,65.340339,235.225222,81.324997,2,0
0,0,11,11,14,14,28,33,28,61,0.000333,0.09775,14,4105.481103,228.082284,293.24865,106.605938,2,0
0,0,10,10,10,14,24,29,28,57,0.000333,0.087114,10,2613.428625,145.190479,261.342863,86.52225,2,0
0,0,12,12,14,13,27,35,25,60,0.000333,0.095098,7,1997.052751,110.947375,285.29325,101.408685,2,0
0,0,12,12,14,12,26,35,25,60,0.000333,0.094009,14,3948.369363,219.353854,282.026383,96.322519,2,0
0,0,10,10,11,11,22,29,24,53,0.000333,0.078783,10,2363.498758,131.305487,236.349876,76.107496,2,0
0,0,9,9,12,12,24,32,28,60,0.000333,0.091699,12,3301.173001,183.3985,275.09775,86.0391,2,0
0,0,10,10,11,11,22,27,25,52,0.000333,0.077297,10,2318.904442,128.828025,231.890444,76.107496,1,0
0,0,10,10,9,12,21,30,29,59,0.000333,0.086382,8,2073.173824,115.176324,259.146728,71.548875,1,0
0,0,13,13,10,13,23,45,37,82,0.000333,0.123644,10,3709.320804,206.073378,370.93208,81.324997,1,0
0,0,15,15,13,18,31,40,43,83,0.000333,0.137066,12,4934.379525,274.132196,411.198294,123.164366,1,0
0,0,10,10,9,17,26,30,37,67,0.000333,0.104976,8,2519.435689,139.968649,314.929461,98.016193,1,0
0,0,11,11,10,15,25,39,35,74,0.000333,0.114548,10,3436.45358,190.914088,343.645358,91.82264,1,0
0,0,12,12,10,19,29,31,41,72,0.000333,0.116592,10,3497.746316,194.31924,349.774632,113.929904,1,0
0,0,10,10,9,17,26,30,37,67,0.000333,0.104976,8,2519.435689,139.968649,314.929461,98.016193,1,0
0,0,12,12,9,18,27,36,51,87,0.000333,0.137892,8,3309.401702,183.85565,413.675213,103.587975,1,0
0,0,14,14,9,19,28,42,65,107,0.000333,0.171462,12,6172.64372,342.924651,514.386977,109.239948,1,0
0,0,16,16,9,20,29,48,79,127,0.000333,0.205655,12,7403.563037,411.309058,616.963586,114.967887,1,0
0,0,11,11,10,18,28,36,40,76,0.000333,0.121786,10,3653.589741,202.977208,365.358974,108.277931,1,0
0,0,12,12,10,19,29,45,44,89,0.000333,0.14412,10,4323.603086,240.200171,432.360309,113.929904,1,0
0,0,11,11,9,18,27,38,41,79,0.000333,0.125212,8,3005.088901,166.949383,375.636113,103.587975,1,0
0,0,13,13,9,20,29,45,47,92,0.000333,0.148978,8,3575.474012,198.637445,446.934252,114.967887,1,0
0,0,16,16,13,21,34,43,62,105,0.000333,0.178061,12,6410.20318,356.122399,534.183598,140.344382,1,0
0,0,12,12,9,19,28,30,47,77,0.000333,0.123389,8,2961.330632,164.518368,370.166329,109.239948,1,0
0,0,11,11,13,20,33,37,45,82,0.000333,0.13788,12,4963.683813,275.760212,413.640318,134.544278,1,0
0,0,8,8,10,12,22,34,27,61,0.000333,0.090675,10,2720.253287,151.125183,272.025329,76.238831,1,0
0,0,10,10,14,12,26,40,28,68,0.000333,0.106543,14,4474.818612,248.601034,319.629901,96.322519,2,0
0,0,9,9,11,12,23,37,28,65,0.000333,0.098011,10,2940.315271,163.350848,294.031527,81.073298,2,0
0,0,10,10,15,13,28,41,29,70,0.000333,0.112172,14,4711.207824,261.733768,336.514845,106.709075,2,0
0,0,9,9,11,13,24,37,29,66,0.000333,0.100869,10,3026.07525,168.115292,302.607525,86.159464,2,0
0,0,12,12,16,15,31,48,34,82,0.000333,0.135415,16,6499.905559,361.105864,406.244097,122.603359,2,0
0,0,11,11,13,15,28,45,34,79,0.000333,0.126594,12,4557.372466,253.187359,379.781039,106.709075,2,0
0,0,12,12,15,15,30,46,34,80,0.000333,0.13085,14,5495.717467,305.317637,392.551248,117.206718,2,0
0,0,11,11,12,15,27,43,34,77,0.000333,0.122042,12,4393.516052,244.084225,366.126338,101.622909,2,0
0,0,11,11,16,16,32,44,32,76,0.000333,0.126667,16,6080,337.777778,380,128,2,0
0,0,10,10,12,16,28,40,32,72,0.000333,0.115377,12,4153.554653,230.753036,346.129554,107.01955,2,0
0,0,11,11,16,15,31,44,32,76,0.000333,0.125506,16,6024.302713,334.683484,376.51892,122.603359,2,0
0,0,10,10,12,15,27,40,32,72,0.000333,0.114117,12,4108.222802,228.2346,342.3519,101.622909,2,0
0,0,14,14,16,15,31,46,34,80,0.000333,0.132112,16,6341.371277,352.298404,396.335705,122.603359,2,0
0,0,13,13,13,15,28,43,34,77,0.000333,0.123389,12,4441.995948,246.777553,370.166329,106.709075,2,0
0,0,10,10,14,13,27,40,28,68,0.000333,0.107777,14,4526.652902,251.480717,323.33235,101.408685,2,0
0,0,9,9,11,13,24,37,28,65,0.000333,0.099341,10,2980.225625,165.56809,298.022563,86.159464,2,0
0,0,10,10,14,13,27,40,28,68,0.000333,0.107777,14,4526.652902,251.480717,323.33235,101.408685,2,0
0,0,9,9,11,13,24,37,28,65,0.000333,0.099341,10,2980.225625,165.56809,298.022563,86.159464,2,0
0,0,10,10,14,13,27,40,28,68,0.000333,0.107777,14,4526.652902,251.480717,323.33235,101.408685,2,0
0,0,9,9,11,13,24,37,28,65,0.000333,0.099341,10,2980.225625,165.56809,298.022563,86.159464,2,0
0,0,12,12,12,13,25,44,32,76,0.000333,0.117644,12,4235.196845,235.288714,352.93307,91.125266,2,0
0,0,11,11,16,15,31,44,32,76,0.000333,0.125506,16,6024.302713,334.683484,376.51892,122.603359,2,0
0,0,10,10,12,15,27,40,32,72,0.000333,0.114117,12,4108.222802,228.2346,342.3519,101.622909,2,0
0,0,10,10,15,14,29,41,29,70,0.000333,0.113353,14,4760.821375,264.490076,340.05867,111.906328,2,0
0,0,9,9,11,14,25,37,29,66,0.000333,0.102165,10,3064.945085,170.274727,306.494509,91.356717,2,0
0,0,12,12,15,14,29,45,29,74,0.000333,0.11983,14,5032.868311,279.603795,359.490594,111.906328,2,0
0,0,12,12,15,13,28,45,29,74,0.000333,0.118581,14,4980.419699,276.689983,355.744264,106.709075,2,0
0,0,10,10,12,12,24,39,28,67,0.000333,0.102397,12,3686.309851,204.794992,307.192488,86.0391,2,0
0,0,9,9,13,13,26,42,32,74,0.000333,0.115944,12,4173.99047,231.888359,347.832539,96.211433,2,0
0,0,10,10,12,12,24,37,29,66,0.000333,0.100869,12,3631.290301,201.73835,302.607525,86.0391,1,0
0,0,10,10,10,13,23,40,33,73,0.000333,0.110073,10,3302.200228,183.455568,330.220023,81.324997,1,0
0,0,13,13,11,14,25,55,41,96,0.000333,0.148603,10,4458.101942,247.67233,445.810194,91.356717,1,0
0,0,15,15,14,19,33,50,47,97,0.000333,0.163102,14,6850.287214,380.571512,489.30623,134.013592,1,0
0,0,10,10,10,18,28,40,41,81,0.000333,0.129799,10,3893.957487,216.330971,389.395749,108.277931,1,0
0,0,11,11,11,16,27,49,39,88,0.000333,0.139477,10,4184.301002,232.461167,418.4301,102.053748,1,0
0,0,12,12,11,20,31,41,45,86,0.000333,0.14202,10,4260.608827,236.70049,426.060883,124.49231,1,0
0,0,10,10,10,18,28,40,41,81,0.000333,0.129799,10,3893.957487,216.330971,389.395749,108.277931,1,0
0,0,12,12,10,19,29,46,55,101,0.000333,0.163552,10,4906.560805,272.586711,490.656081,113.929904,1,0
0,0,14,14,10,20,30,52,69,121,0.000333,0.197911,15,8906.006431,494.778135,593.733762,119.657843,1,0
0,0,16,16,10,21,31,58,83,141,0.000333,0.232847,15,10478.1252,582.118066,698.54168,125.457947,1,0
0,0,11,11,11,19,30,46,44,90,0.000333,0.147207,10,4416.201536,245.34453,441.620154,118.764371,1,0
0,0,12,12,11,20,31,55,48,103,0.000333,0.170094,10,5102.8222,283.490122,510.28222,124.49231,1,0
0,0,11,11,10,19,29,48,45,93,0.000333,0.150597,10,4517.922325,250.995685,451.792233,113.929904,1,0
0,0,13,13,10,21,31,55,51,106,0.000333,0.175048,10,5251.448089,291.747116,525.144809,125.457947,1,0
0,0,16,16,14,22,36,53,66,119,0.000333,0.205074,21,12919.64258,717.757921,615.221075,151.410465,1,0
0,0,12,12,10,20,30,40,51,91,0.000333,0.148842,10,4465.270442,248.07058,446.527044,119.657843,1,0
0,0,11,11,14,21,35,47,49,96,0.000333,0.164137,14,6893.756375,382.986465,492.41117,145.541635,1,0
0,0,12,12,14,21,35,48,50,98,0.000333,0.167557,14,7037.376299,390.96535,502.669736,145.541635,1,0
0,0,8,8,10,12,22,34,27,61,0.000333,0.090675,10,2720.253287,151.125183,272.025329,76.238831,1,0
0,0,10,10,14,12,26,40,28,68,0.000333,0.106543,14,4474.818612,248.601034,319.629901,96.322519,2,0
0,0,9,9,11,12,23,37,28,65,0.000333,0.098011,10,2940.315271,163.350848,294.031527,81.073298,2,0
0,0,10,10,15,13,28,41,29,70,0.000333,0.112172,14,4711.207824,261.733768,336.514845,106.709075,2,0
0,0,9,9,11,13,24,37,29,66,0.000333,0.100869,10,3026.07525,168.115292,302.607525,86.159464,2,0
0,0,12,12,16,15,31,48,34,82,0.000333,0.135415,16,6499.905559,361.105864,406.244097,122.603359,2,0
0,0,9,9,11,13,24,37,28,65,0.000333,0.099341,10,2980.225625,165.56809,298.022563,86.159464,2,0
0,0,12,12,15,15,30,46,34,80,0.000333,0.13085,14,5495.717467,305.317637,392.551248,117.206718,2,0
0,0,11,11,12,15,27,43,34,77,0.000333,0.122042,12,4393.516052,244.084225,366.126338,101.622909,2,0
0,0,11,11,17,15,32,45,32,77,0.000333,0.128333,16,6160,342.222222,385,128.090227,2,0
0,0,10,10,13,15,28,41,32,73,0.000333,0.116979,12,4211.242912,233.95794,350.936909,106.709075,2,0
0,0,11,11,16,15,31,44,32,76,0.000333,0.125506,16,6024.302713,334.683484,376.51892,122.603359,2,0
0,0,10,10,12,15,27,40,32,72,0.000333,0.114117,12,4108.222802,228.2346,342.3519,101.622909,2,0
0,0,14,14,16,15,31,46,34,80,0.000333,0.132112,16,6341.371277,352.298404,396.335705,122.603359,2,0
0,0,13,13,13,15,28,43,34,77,0.000333,0.123389,12,4441.995948,246.777553,370.166329,106.709075,2,0
0,0,12,12,15,15,30,46,34,80,0.000333,0.13085,14,5495.717467,305.317637,392.551248,117.206718,2,0
0,0,11,11,12,15,27,43,34,77,0.000333,0.122042,12,4393.516052,244.084225,366.126338,101.622909,2,0
0,0,12,12,14,15,29,44,34,78,0.000333,0.126308,14,5304.915247,294.717514,378.922518,111.906328,2,0
0,0,11,11,11,15,26,41,34,75,0.000333,0.117511,10,3525.329789,195.851655,352.532979,96.657107,2,0
0,0,14,14,15,15,30,44,34,78,0.000333,0.127579,14,5358.32453,297.684696,382.737466,117.206718,2,0
0,0,13,13,12,15,27,41,34,75,0.000333,0.118872,12,4279.398752,237.744375,356.616563,101.622909,2,0
0,0,11,11,16,15,31,44,32,76,0.000333,0.125506,16,6024.302713,334.683484,376.51892,122.603359,2,0
0,0,10,10,12,15,27,40,32,72,0.000333,0.114117,12,4108.222802,228.2346,342.3519,101.622909,2,0
0,0,11,11,15,15,30,43,32,75,0.000333,0.122672,14,5152.235125,286.235285,368.016795,117.206718,2,0
0,0,10,10,11,15,26,39,32,71,0.000333,0.111244,10,3337.3122,185.406233,333.73122,96.657107,2,0
0,0,12,12,15,14,29,45,29,74,0.000333,0.11983,14,5032.868311,279.603795,359.490594,111.906328,2,0
0,0,12,12,15,13,28,45,29,74,0.000333,0.118581,14,4980.419699,276.689983,355.744264,106.709075,2,0
0,0,10,10,12,12,24,39,28,67,0.000333,0.102397,12,3686.309851,204.794992,307.192488,86.0391,2,0
0,0,9,9,13,13,26,42,32,74,0.000333,0.115944,12,4173.99047,231.888359,347.832539,96.211433,2,0
0,0,10,10,12,12,24,37,29,66,0.000333,0.100869,12,3631.290301,201.73835,302.607525,86.0391,1,0
0,0,10,10,10,13,23,40,33,73,0.000333,0.110073,10,3302.200228,183.455568,330.220023,81.324997,1,0
0,0,13,13,11,14,25,55,41,96,0.000333,0.148603,10,4458.101942,247.67233,445.810194,91.356717,1,0
0,0,15,15,14,19,33,50,47,97,0.000333,0.163102,14,6850.287214,380.571512,489.30623,134.013592,1,0
0,0,10,10,10,18,28,40,41,81,0.000333,0.129799,10,3893.957487,216.330971,389.395749,108.277931,1,0
0,0,11,11,11,16,27,49,39,88,0.000333,0.139477,10,4184.301002,232.461167,418.4301,102.053748,1,0
0,0,12,12,11,20,31,41,45,86,0.000333,0.14202,10,4260.608827,236.70049,426.060883,124.49231,1,0
0,0,10,10,10,18,28,40,41,81,0.000333,0.129799,10,3893.957487,216.330971,389.395749,108.277931,1,0
0,0,12,12,10,19,29,46,55,101,0.000333,0.163552,10,4906.560805,272.586711,490.656081,113.929904,1,0
0,0,14,14,10,20,30,52,69,121,0.000333,0.197911,15,8906.006431,494.778135,593.733762,119.657843,1,0
0,0,16,16,10,21,31,58,83,141,0.000333,0.232847,15,10478.1252,582.118066,698.54168,125.457947,1,0
0,0,11,11,11,19,30,46,44,90,0.000333,0.147207,10,4416.201536,245.34453,441.620154,118.764371,1,0
0,0,12,12,11,20,31,55,48,103,0.000333,0.170094,10,5102.8222,283.490122,510.28222,124.49231,1,0
0,0,11,11,10,19,29,48,45,93,0.000333,0.150597,10,4517.922325,250.995685,451.792233,113.929904,1,0
0,0,13,13,10,21,31,55,51,106,0.000333,0.175048,10,5251.448089,291.747116,525.144809,125.457947,1,0
0,0,16,16,14,22,36,53,66,119,0.000333,0.205074,21,12919.64258,717.757921,615.221075,151.410465,1,0
0,0,12,12,10,20,30,40,51,91,0.000333,0.148842,10,4465.270442,248.07058,446.527044,119.657843,1,0
0,0,8,8,9,12,21,28,26,54,0.000333,0.079062,8,1897.481127,105.415618,237.185141,71.548875,1,0
0,0,10,10,13,12,25,34,27,61,0.000333,0.094425,12,3399.302731,188.850152,283.275228,91.125266,2,0
0,0,9,9,10,12,22,31,27,58,0.000333,0.086216,10,2586.470339,143.692797,258.647034,76.238831,2,0
0,0,10,10,14,13,27,35,28,63,0.000333,0.099853,14,4193.810777,232.989488,299.557913,101.408685,2,0
0,0,9,9,10,13,23,31,28,59,0.000333,0.088963,10,2668.901554,148.272309,266.890155,81.324997,2,0
0,0,13,13,15,15,30,42,33,75,0.000333,0.122672,14,5152.235125,286.235285,368.016795,117.206718,2,0
0,0,11,11,12,15,27,39,33,72,0.000333,0.114117,12,4108.222802,228.2346,342.3519,101.622909,2,0
0,0,12,12,14,15,29,40,33,73,0.000333,0.118211,14,4964.856577,275.825365,354.632613,111.906328,2,0
0,0,11,11,11,15,26,37,33,70,0.000333,0.109677,10,3290.307803,182.794878,329.03078,96.657107,2,0
0,0,12,12,17,13,30,59,38,97,0.000333,0.158656,16,7615.494204,423.083011,475.968388,117.592585,2,0
0,0,11,11,13,13,26,55,38,93,0.000333,0.145714,12,5245.690725,291.427263,437.140894,96.211433,2,0
0,0,12,12,16,13,29,58,38,96,0.000333,0.155455,16,7461.858809,414.547712,466.366176,112.105716,2,0
0,0,11,11,12,13,25,54,38,92,0.000333,0.142412,12,5126.817234,284.82318,427.234769,91.125266,2,0
0,0,15,15,16,14,30,60,40,100,0.000333,0.163563,16,7851.024953,436.168053,490.68906,117.302969,2,0
0,0,14,14,13,14,27,57,40,97,0.000333,0.153741,12,5534.689053,307.482725,461.224088,101.408685,2,0
0,0,13,13,15,14,29,60,40,100,0.000333,0.161933,14,6801.173393,377.842966,485.7981,111.906328,2,0
0,0,12,12,12,14,26,57,40,97,0.000333,0.151981,12,5471.311832,303.961768,455.942653,96.322519,2,0
0,0,13,13,14,14,28,58,40,98,0.000333,0.15704,14,6595.690953,366.427275,471.120782,106.605938,2,0
0,0,12,12,11,14,25,55,40,95,0.000333,0.147055,10,4411.66338,245.09241,441.166338,91.356717,2,0
0,0,15,15,16,14,30,60,40,100,0.000333,0.163563,16,7851.024953,436.168053,490.68906,117.302969,2,0
0,0,14,14,13,14,27,57,40,97,0.000333,0.153741,12,5534.689053,307.482725,461.224088,101.408685,2,0
0,0,12,12,16,13,29,58,38,96,0.000333,0.155455,16,7461.858809,414.547712,466.366176,112.105716,2,0
0,0,11,11,12,13,25,54,38,92,0.000333,0.142412,12,5126.817234,284.82318,427.234769,91.125266,2,0
0,0,12,12,15,13,28,57,38,95,0.000333,0.152233,14,6393.782046,355.210114,456.698718,106.709075,2,0
0,0,11,11,11,13,24,53,38,91,0.000333,0.139077,10,4172.315876,231.795326,417.231588,86.159464,2,0
0,0,14,14,15,12,27,59,35,94,0.000333,0.148986,14,6257.431953,347.635108,446.959425,101.622909,2,0
0,0,14,14,15,11,26,59,35,94,0.000333,0.14728,21,9278.668004,515.481556,441.841334,96.657107,2,0
0,0,11,11,12,10,22,53,34,87,0.000333,0.129324,18,6983.469915,387.970551,387.970551,76.238831,2,0
0,0,10,10,13,12,25,56,38,94,0.000333,0.145507,18,7857.404673,436.522482,436.522482,91.125266,2,0
0,0,11,11,12,11,23,51,35,86,0.000333,0.129675,18,7002.473908,389.026328,389.026328,81.073298,1,0
0,0,11,11,10,11,21,54,39,93,0.000333,0.136162,15,6127.282805,340.4046,408.48552,71.273029,1,0
0,0,14,14,11,12,23,69,47,116,0.000333,0.174911,15,7870.997804,437.277656,524.733187,81.073298,1,0
0,0,16,16,14,16,30,64,51,115,0.000333,0.188097,21,11850.14079,658.341155,564.292418,117.302969,1,0
0,0,11,11,10,15,25,54,45,99,0.000333,0.153247,15,6896.126442,383.118136,459.741763,91.82264,1,0
0,0,12,12,11,14,25,63,45,108,0.000333,0.167179,15,7523.047027,417.947057,501.536468,91.356717,1,0
0,0,13,13,11,17,28,55,49,104,0.000333,0.166655,10,4999.649119,277.758284,499.964912,107.540616,1,0
0,0,11,11,10,15,25,54,45,99,0.000333,0.153247,15,6896.126442,383.118136,459.741763,91.82264,1,0
0,0,13,13,10,16,26,60,57,117,0.000333,0.183317,15,8249.271705,458.292873,549.951447,97.219281,1,0
0,0,15,15,10,17,27,66,69,135,0.000333,0.21397,20,12838.19626,713.233125,641.909813,102.706149,1,0
0,0,17,17,10,18,28,72,81,153,0.000333,0.245175,20,14710.50606,817.250337,735.525303,108.277931,1,0
0,0,12,12,11,16,27,60,48,108,0.000333,0.171176,15,7702.917754,427.939875,513.52785,102.053748,1,0
0,0,13,13,11,17,28,69,52,121,0.000333,0.193897,15,8725.349184,484.741621,581.689946,107.540616,1,0
0,0,12,12,10,16,26,62,49,111,0.000333,0.173916,15,7826.232131,434.790674,521.748809,97.219281,1,0
0,0,14,14,10,17,27,69,55,124,0.000333,0.196535,15,8844.090754,491.338375,589.60605,102.706149,1,0
0,0,17,17,14,19,33,67,66,133,0.000333,0.223635,21,14088.99278,782.721821,670.904418,134.013592,1,0
0,0,13,13,10,17,27,54,53,107,0.000333,0.169591,15,7631.594441,423.977469,508.772963,102.706149,1,0
0,0,12,12,14,18,32,61,52,113,0.000333,0.188333,14,7910,439.444444,565,128.361619,1,0
0,0,13,13,14,18,32,62,53,115,0.000333,0.191667,14,8050,447.222222,575,128.361619,1,0
0,0,9,9,10,10,20,48,32,80,0.000333,0.115251,15,5186.313714,288.12854,345.754248,66.438562,1,0
0,0,11,11,14,11,25,54,33,87,0.000333,0.134672,21,8484.325259,471.351403,404.015489,91.356717,2,0
0,0,10,10,11,10,21,51,33,84,0.000333,0.122985,15,5534.319953,307.46222,368.954664,71.273029,2,0
0,0,11,11,15,11,26,55,34,89,0.000333,0.139446,21,8785.121833,488.062324,418.339135,96.657107,2,0
0,0,10,10,11,11,22,51,34,85,0.000333,0.126351,15,5685.775314,315.876406,379.051688,76.107496,2,0
0,0,13,13,16,14,30,62,39,101,0.000333,0.165199,16,7929.535203,440.529733,495.59595,117.302969,2,0
0,0,12,12,13,14,27,59,39,98,0.000333,0.155326,12,5591.747703,310.65265,465.978975,101.408685,2,0
0,0,13,13,15,14,29,60,39,99,0.000333,0.160313,14,6733.161659,374.064537,480.940119,111.906328,2,0
0,0,12,12,12,14,26,57,39,96,0.000333,0.150414,12,5414.906555,300.828142,451.242213,96.322519,2,0
0,0,12,12,17,13,30,59,37,96,0.000333,0.15702,16,7536.983955,418.721331,471.061497,117.592585,2,0
0,0,11,11,13,13,26,55,37,92,0.000333,0.144147,12,5189.285449,288.293636,432.440454,96.211433,2,0
0,0,12,12,16,13,29,58,37,95,0.000333,0.153836,16,7384.131113,410.229506,461.508195,112.105716,2,0
0,0,11,11,12,13,25,54,37,91,0.000333,0.140864,12,5071.090959,281.727276,422.590913,91.125266,2,0
0,0,15,15,16,14,30,60,39,99,0.000333,0.161927,16,7772.514703,431.806372,485.782169,117.302969,2,0
0,0,14,14,13,14,27,57,39,96,0.000333,0.152156,12,5477.630402,304.3128,456.4692,101.408685,2,0
0,0,13,13,15,14,29,60,39,99,0.000333,0.160313,14,6733.161659,374.064537,480.940119,111.906328,2,0
0,0,12,12,12,14,26,57,39,96,0.000333,0.150414,12,5414.906555,300.828142,451.242213,96.322519,2,0
0,0,13,13,14,14,28,58,39,97,0.000333,0.155438,14,6528.387984,362.688221,466.313427,106.605938,2,0
0,0,12,12,11,14,25,55,39,94,0.000333,0.145507,10,4365.224818,242.51249,436.522482,91.356717,2,0
0,0,15,15,15,14,29,58,39,97,0.000333,0.157075,14,6597.138191,366.507677,471.224157,111.906328,2,0
0,0,14,14,12,14,26,55,39,94,0.000333,0.14728,12,5302.096002,294.560889,441.841334,96.322519,2,0
0,0,12,12,16,13,29,58,37,95,0.000333,0.153836,16,7384.131113,410.229506,461.508195,112.105716,2,0
0,0,11,11,12,13,25,54,37,91,0.000333,0.140864,12,5071.090959,281.727276,422.590913,91.125266,2,0
0,0,12,12,15,13,28,57,37,94,0.000333,0.15063,14,6326.479077,351.47106,451.891363,106.709075,2,0
0,0,11,11,11,13,24,53,37,90,0.000333,0.137549,10,4126.466251,229.248125,412.646625,86.159464,2,0
0,0,14,14,15,12,27,59,34,93,0.000333,0.147402,14,6190.863528,343.936863,442.204538,101.622909,2,0
0,0,14,14,15,11,26,59,34,93,0.000333,0.145714,21,9179.95877,509.997709,437.140894,96.657107,2,0
0,0,11,11,12,10,22,53,33,86,0.000333,0.127837,18,6903.200146,383.511119,383.511119,76.238831,2,0
0,0,10,10,13,12,25,56,37,93,0.000333,0.14396,18,7773.815262,431.878626,431.878626,91.125266,2,0
0,0,11,11,12,11,23,51,34,85,0.000333,0.128168,18,6921.049793,384.502766,384.502766,81.073298,1,0
0,0,11,11,10,11,21,54,38,92,0.000333,0.134698,15,6061.398043,336.744336,404.093203,71.273029,1,0
0,0,14,14,11,12,23,69,46,115,0.000333,0.173403,15,7803.144374,433.508021,520.209625,81.073298,1,0
0,0,16,16,14,16,30,64,50,114,0.000333,0.186462,21,11747.09609,652.616449,559.385528,117.302969,1,0
0,0,12,12,10,15,25,59,47,106,0.000333,0.164083,15,7383.731342,410.207297,492.248756,91.82264,1,0
0,0,13,13,11,14,25,68,47,115,0.000333,0.178014,15,8010.651927,445.036218,534.043462,91.356717,1,0
0,0,14,14,11,17,28,60,51,111,0.000333,0.177872,15,8004.245945,444.68033,533.616396,107.540616,1,0
0,0,12,12,10,15,25,59,47,106,0.000333,0.164083,15,7383.731342,410.207297,492.248756,91.82264,1,0
0,0,14,14,10,16,26,65,59,124,0.000333,0.194285,15,8742.817876,485.712104,582.854525,97.219281,1,0
0,0,16,16,10,17,27,71,71,142,0.000333,0.225065,20,13503.88051,750.215584,675.194025,102.706149,1,0
0,0,18,18,10,18,28,77,83,160,0.000333,0.256392,20,15383.53575,854.640875,769.176788,108.277931,1,0
0,0,13,13,11,16,27,65,50,115,0.000333,0.182271,15,8202.180941,455.676719,546.812063,102.053748,1,0
0,0,14,14,11,17,28,74,54,128,0.000333,0.205114,15,9230.12145,512.784525,615.34143,107.540616,1,0
0,0,13,13,10,16,26,67,51,118,0.000333,0.184884,15,8319.778301,462.209906,554.651887,97.219281,1,0
0,0,15,15,10,18,28,74,57,131,0.000333,0.209921,15,9446.452422,524.802912,629.763495,108.277931,1,0
0,0,18,18,14,19,33,72,68,140,0.000333,0.235405,21,14830.51871,823.917706,706.215177,134.013592,1,0
0,0,14,14,10,17,27,59,55,114,0.000333,0.180686,15,8130.857629,451.714313,542.057175,102.706149,1,0
0,0,13,13,14,18,32,66,54,120,0.000333,0.2,21,12600,700,600,128.361619,1,0
0,0,14,14,14,18,32,67,55,122,0.000333,0.203333,21,12810,711.666667,610,128.361619,1,0
0,0,9,9,9,9,18,39,30,69,0.000333,0.095908,12,3452.697901,191.81655,287.724825,57.05865,1,0
0,0,11,11,13,10,23,45,31,76,0.000333,0.114597,18,6188.232756,343.790709,343.790709,81.324997,2,0
0,0,10,10,10,9,19,42,31,73,0.000333,0.103366,15,4651.480627,258.41559,310.098708,61.748606,2,0
0,0,11,11,14,10,24,46,32,78,0.000333,0.119209,21,7510.168576,417.231588,357.627075,86.52225,2,0
0,0,10,10,10,10,20,42,32,74,0.000333,0.106608,15,4797.340185,266.518899,319.822679,66.438562,2,0
0,0,13,13,15,13,28,53,37,90,0.000333,0.144221,14,6057.267202,336.514845,432.661943,106.709075,2,0
0,0,12,12,12,13,25,50,37,87,0.000333,0.134672,12,4848.185862,269.343659,404.015489,91.125266,2,0
0,0,13,13,14,13,27,51,37,88,0.000333,0.139477,14,5858.021403,325.445633,418.4301,101.408685,2,0
0,0,12,12,11,13,24,48,37,85,0.000333,0.129907,10,3897.218126,216.512118,389.721813,86.159464,2,0
0,0,12,12,16,12,28,50,35,85,0.000333,0.136208,16,6538.002694,363.222372,408.625168,107.01955,2,0
0,0,11,11,12,12,24,46,35,81,0.000333,0.123794,12,4456.583551,247.587975,371.381963,86.0391,2,0
0,0,12,12,15,12,27,49,35,84,0.000333,0.133137,14,5591.747703,310.65265,399.41055,101.622909,2,0
0,0,11,11,11,12,23,45,35,80,0.000333,0.120628,10,3618.849565,201.047198,361.884956,81.073298,2,0
0,0,15,15,15,13,28,51,37,88,0.000333,0.141016,14,5922.661264,329.036737,423.047233,106.709075,2,0
0,0,14,14,12,13,25,48,37,85,0.000333,0.131576,12,4736.733314,263.151851,394.727776,91.125266,2,0
0,0,13,13,14,13,27,51,37,88,0.000333,0.139477,14,5858.021403,325.445633,418.4301,101.408685,2,0
0,0,12,12,11,13,24,48,37,85,0.000333,0.129907,10,3897.218126,216.512118,389.721813,86.159464,2,0
0,0,13,13,13,13,26,49,37,86,0.000333,0.134746,12,4850.853789,269.491877,404.237816,96.211433,2,0
0,0,12,12,10,13,23,46,37,83,0.000333,0.125152,10,3754.556424,208.586468,375.455642,81.324997,2,0
0,0,15,15,14,13,27,49,37,86,0.000333,0.136307,14,5724.884553,318.049142,408.920325,101.408685,2,0
0,0,14,14,11,13,24,46,37,83,0.000333,0.126851,10,3805.518876,211.417715,380.551888,86.159464,2,0
0,0,12,12,15,12,27,49,35,84,0.000333,0.133137,14,5591.747703,310.65265,399.41055,101.622909,2,0
0,0,11,11,11,12,23,45,35,80,0.000333,0.120628,10,3618.849565,201.047198,361.884956,81.073298,2,0
0,0,12,12,14,12,26,48,35,83,0.000333,0.130045,14,5461.910952,303.439497,390.136497,96.322519,2,0
0,0,11,11,10,12,22,44,35,79,0.000333,0.117432,10,3522.950979,195.719499,352.295098,76.238831,2,0
0,0,14,14,14,11,25,50,32,82,0.000333,0.126932,14,5331.146906,296.174828,380.796208,91.356717,2,0
0,0,14,14,14,10,24,50,32,82,0.000333,0.125322,21,7895.305426,438.628079,375.966925,86.52225,2,0
0,0,11,11,11,9,20,44,31,75,0.000333,0.108048,15,4862.169107,270.120506,324.144607,66.583073,2,0
0,0,10,10,12,11,23,47,35,82,0.000333,0.123644,18,6676.777447,370.93208,370.93208,81.073298,2,0
0,0,11,11,11,10,21,42,32,74,0.000333,0.108344,15,4875.472339,270.859574,325.031489,71.273029,1,0
0,0,11,11,9,10,19,45,36,81,0.000333,0.114694,12,4128.985543,229.388086,344.082129,61.748606,1,0
0,0,14,14,10,11,21,60,44,104,0.000333,0.152267,20,9136.020239,507.55668,456.801012,71.273029,1,0
0,0,16,16,13,15,28,55,48,103,0.000333,0.165053,18,8912.836025,495.157557,495.157557,106.709075,1,0
0,0,11,11,9,14,23,45,42,87,0.000333,0.131183,12,4722.598682,262.366593,393.54989,81.832294,1,0
0,0,12,12,10,13,23,54,42,96,0.000333,0.144754,15,6513.929217,361.884956,434.261948,81.324997,1,0
0,0,13,13,10,16,26,46,46,92,0.000333,0.144147,10,4324.404541,240.244697,432.440454,97.219281,1,0
0,0,11,11,9,14,23,45,42,87,0.000333,0.131183,12,4722.598682,262.366593,393.54989,81.832294,1,0
0,0,13,13,9,15,24,51,54,105,0.000333,0.160474,12,5777.052751,320.947375,481.421063,87.132684,1,0
0,0,15,15,9,16,25,57,66,123,0.000333,0.190398,16,9139.108981,507.728277,571.194311,92.529325,1,0
0,0,17,17,9,17,26,63,78,141,0.000333,0.220921,16,10604.192,589.121778,662.762,98.016193,1,0
0,0,12,12,10,15,25,51,45,96,0.000333,0.148603,15,6687.152913,371.508495,445.810194,91.82264,1,0
0,0,13,13,10,16,26,60,49,109,0.000333,0.170783,15,7685.218939,426.956608,512.347929,97.219281,1,0
0,0,12,12,9,15,24,53,46,99,0.000333,0.151304,12,5446.935451,302.607525,453.911288,87.132684,1,0
0,0,14,14,9,16,25,60,52,112,0.000333,0.173371,12,6241.342719,346.741262,520.111893,92.529325,1,0
0,0,17,17,13,18,31,58,63,121,0.000333,0.199819,18,10790.23956,599.457754,599.457754,123.164366,1,0
0,0,13,13,9,16,25,45,50,95,0.000333,0.147055,12,5293.996056,294.110892,441.166338,92.529325,1,0
0,0,12,12,13,17,30,52,49,101,0.000333,0.165199,12,5947.151402,330.3973,495.59595,117.592585,1,0
0,0,13,13,13,17,30,53,50,103,0.000333,0.16847,12,6064.916776,336.939821,505.409731,117.592585,1,0
0,0,9,9,9,9,18,39,29,68,0.000333,0.094518,12,3402.658801,189.0366,283.5549,57.05865,1,0
0,0,11,11,13,10,23,45,30,75,0.000333,0.113089,18,6106.808641,339.267147,339.267147,81.324997,2,0
0,0,10,10,10,9,19,42,30,72,0.000333,0.10195,15,4587.761715,254.875651,305.850781,61.748606,2,0
0,0,11,11,14,10,24,46,31,77,0.000333,0.117681,21,7413.884364,411.882465,353.042113,86.52225,2,0
0,0,10,10,10,10,20,42,31,73,0.000333,0.105167,15,4732.511264,262.917292,315.500751,66.438562,2,0
0,0,13,13,15,13,28,53,36,89,0.000333,0.142618,14,5989.964233,332.775791,427.854588,106.709075,2,0
0,0,12,12,12,13,25,50,36,86,0.000333,0.133124,12,4792.459588,266.247755,399.371632,91.125266,2,0
0,0,13,13,14,13,27,51,36,87,0.000333,0.137892,14,5791.452978,321.747388,413.675213,101.408685,2,0
0,0,12,12,11,13,24,48,36,84,0.000333,0.128379,10,3851.368501,213.964917,385.13685,86.159464,2,0
0,0,12,12,16,12,28,50,34,84,0.000333,0.134606,16,6461.085015,358.949168,403.817813,107.01955,2,0
0,0,11,11,12,12,24,46,34,80,0.000333,0.122266,12,4401.564001,244.531333,366.797,86.0391,2,0
0,0,12,12,15,12,27,49,34,83,0.000333,0.131552,14,5525.179278,306.954404,394.655663,101.622909,2,0
0,0,11,11,11,12,23,45,34,79,0.000333,0.11912,10,3573.613945,198.534108,357.361395,81.073298,2,0
0,0,15,15,15,13,28,51,36,87,0.000333,0.139413,14,5855.358295,325.297683,418.239878,106.709075,2,0
0,0,14,14,12,13,25,48,36,84,0.000333,0.130028,12,4681.007039,260.055947,390.08392,91.125266,2,0
0,0,13,13,14,13,27,51,36,87,0.000333,0.137892,14,5791.452978,321.747388,413.675213,101.408685,2,0
0,0,12,12,11,13,24,48,36,84,0.000333,0.128379,10,3851.368501,213.964917,385.13685,86.159464,2,0
0,0,13,13,13,13,26,49,36,85,0.000333,0.133179,12,4794.448513,266.358251,399.537376,96.211433,2,0
0,0,12,12,10,13,23,46,36,82,0.000333,0.123644,10,3709.320804,206.073378,370.93208,81.324997,2,0
0,0,15,15,14,13,27,49,36,85,0.000333,0.134722,14,5658.316128,314.350896,404.165438,101.408685,2,0
0,0,14,14,11,13,24,46,36,82,0.000333,0.125322,10,3759.669251,208.870514,375.966925,86.159464,2,0
0,0,12,12,15,12,27,49,34,83,0.000333,0.131552,14,5525.179278,306.954404,394.655663,101.622909,2,0
0,0,11,11,11,12,23,45,34,79,0.000333,0.11912,10,3573.613945,198.534108,357.361395,81.073298,2,0
0,0,12,12,14,12,26,48,34,82,0.000333,0.128479,14,5396.104796,299.7836,385.436057,96.322519,2,0
0,0,11,11,10,12,22,44,34,78,0.000333,0.115945,10,3478.356663,193.242037,347.835666,76.238831,2,0
0,0,14,14,14,11,25,50,31,81,0.000333,0.125384,14,5266.132919,292.56294,376.152351,91.356717,2,0
0,0,14,14,14,10,24,50,31,81,0.000333,0.123794,21,7799.021214,433.278956,371.381963,86.52225,2,0
0,0,11,11,11,9,20,44,30,74,0.000333,0.106608,15,4797.340185,266.518899,319.822679,66.583073,2,0
0,0,10,10,12,11,23,47,34,81,0.000333,0.122136,18,6595.353332,366.408518,366.408518,81.073298,2,0
0,0,11,11,11,10,21,42,31,73,0.000333,0.10688,15,4809.587578,267.19931,320.639172,71.273029,1,0
0,0,11,11,9,10,19,45,35,80,0.000333,0.113278,12,4078.010413,226.556134,339.834201,61.748606,1,0
0,0,14,14,10,11,21,60,43,103,0.000333,0.150803,15,6786.130418,377.007245,452.408695,71.273029,1,0
0,0,16,16,13,15,28,55,47,102,0.000333,0.16345,18,8826.303637,490.350202,490.350202,106.709075,1,0
0,0,12,12,9,14,23,50,44,94,0.000333,0.141738,12,5102.577886,283.476549,425.214824,81.832294,1,0
0,0,13,13,10,13,23,59,44,103,0.000333,0.155309,15,6988.903222,388.272401,465.926881,81.324997,1,0
0,0,14,14,10,16,26,51,48,99,0.000333,0.155115,15,6980.152981,387.786277,465.343532,97.219281,1,0
0,0,12,12,9,14,23,50,44,94,0.000333,0.141738,12,5102.577886,283.476549,425.214824,81.832294,1,0
0,0,14,14,9,15,24,56,56,112,0.000333,0.171172,12,6162.189601,342.343867,513.5158,87.132684,1,0
0,0,16,16,9,16,25,62,68,130,0.000333,0.201234,16,9659.220875,536.623382,603.701305,92.529325,1,0
0,0,18,18,9,17,26,68,80,148,0.000333,0.231888,16,11130.64125,618.368958,695.665078,98.016193,1,0
0,0,13,13,10,15,25,56,47,103,0.000333,0.159439,15,7174.757813,398.597656,478.317188,91.82264,1,0
0,0,14,14,10,16,26,65,51,116,0.000333,0.18175,15,8178.76511,454.375839,545.251007,97.219281,1,0
0,0,13,13,9,15,24,58,48,106,0.000333,0.162002,12,5832.072301,324.004017,486.006025,87.132684,1,0
0,0,15,15,9,17,26,65,54,119,0.000333,0.186451,12,6712.227918,372.901551,559.352326,98.016193,1,0
0,0,18,18,13,18,31,63,65,128,0.000333,0.211379,18,11414.4683,634.137128,634.137128,123.164366,1,0
0,0,14,14,9,16,25,50,52,102,0.000333,0.157891,12,5684.079976,315.782221,473.673331,92.529325,1,0
0,0,13,13,13,17,30,57,51,108,0.000333,0.176648,18,9538.995318,529.944184,529.944184,117.592585,1,0
0,0,14,14,13,17,30,58,52,110,0.000333,0.179919,18,9715.643379,539.757966,539.757966,117.592585,1,0
0,0,10,10,10,11,21,50,35,85,0.000333,0.124449,15,5600.204714,311.122484,373.346981,71.273029,1,0
0,0,12,12,14,12,26,56,36,92,0.000333,0.144147,21,9081.249535,504.513863,432.440454,96.322519,2,0
0,0,11,11,11,11,22,53,36,89,0.000333,0.132296,15,5953.341211,330.741178,396.889414,76.107496,2,0
0,0,12,12,15,12,27,57,37,94,0.000333,0.148986,21,9386.147929,521.452663,446.959425,101.622909,2,0
0,0,11,11,11,12,23,53,37,90,0.000333,0.135707,15,6106.808641,339.267147,407.120576,81.073298,2,0
0,0,14,14,16,15,31,64,42,106,0.000333,0.175048,16,8402.316942,466.795386,525.144809,122.603359,2,0
0,0,13,13,13,15,28,61,42,103,0.000333,0.165053,12,5941.890684,330.105038,495.157557,106.709075,2,0
0,0,14,14,15,15,30,62,42,104,0.000333,0.170106,14,7144.432707,396.912928,510.316622,117.206718,2,0
0,0,13,13,12,15,27,59,42,101,0.000333,0.160081,12,5762.923653,320.162425,480.243638,101.622909,2,0
0,0,13,13,17,14,31,61,40,101,0.000333,0.166791,16,8005.981238,444.776735,500.373827,122.789837,2,0
0,0,12,12,13,14,27,57,40,97,0.000333,0.153741,12,5534.689053,307.482725,461.224088,101.408685,2,0
0,0,13,13,16,14,30,60,40,100,0.000333,0.163563,16,7851.024953,436.168053,490.68906,117.302969,2,0
0,0,12,12,12,14,26,56,40,96,0.000333,0.150414,12,5414.906555,300.828142,451.242213,96.322519,2,0
0,0,16,16,16,15,31,62,42,104,0.000333,0.171745,16,8243.78266,457.987926,515.236416,122.603359,2,0
0,0,15,15,13,15,28,59,42,101,0.000333,0.161848,12,5826.514166,323.695231,485.542847,106.709075,2,0
0,0,14,14,15,15,30,62,42,104,0.000333,0.170106,14,7144.432707,396.912928,510.316622,117.206718,2,0
0,0,13,13,12,15,27,59,42,101,0.000333,0.160081,12,5762.923653,320.162425,480.243638,101.622909,2,0
0,0,14,14,14,15,29,60,42,102,0.000333,0.165171,14,6937.196861,385.399826,495.514062,111.906328,2,0
0,0,13,13,11,15,26,57,42,99,0.000333,0.155115,10,4653.435321,258.524184,465.343532,96.657107,2,0
0,0,12,12,14,12,26,56,36,92,0.000333,0.144147,21,9081.249535,504.513863,432.440454,96.322519,2,0
0,0,11,11,11,12,23,53,36,89,0.000333,0.134199,15,6038.955211,335.497512,402.597014,81.073298,2,0
0,0,13,13,16,14,30,60,40,100,0.000333,0.163563,16,7851.024953,436.168053,490.68906,117.302969,2,0
0,0,12,12,12,14,26,56,40,96,0.000333,0.150414,12,5414.906555,300.828142,451.242213,96.322519,2,0
0,0,13,13,15,14,29,59,40,99,0.000333,0.160313,14,6733.161659,374.064537,480.940119,111.906328,2,0
0,0,12,12,11,14,25,55,40,95,0.000333,0.147055,10,4411.66338,245.09241,441.166338,91.356717,2,0
0,0,15,15,15,13,28,61,37,98,0.000333,0.15704,14,6595.690953,366.427275,471.120782,106.709075,2,0
0,0,15,15,15,12,27,61,37,98,0.000333,0.155326,21,9785.558479,543.642138,465.978975,101.622909,2,0
0,0,12,12,12,11,23,55,36,91,0.000333,0.137215,18,7409.594484,411.644138,411.644138,81.073298,2,0
0,0,11,11,13,13,26,58,40,98,0.000333,0.153548,18,8291.575663,460.643092,460.643092,96.211433,2,0
0,0,12,12,12,12,24,53,37,90,0.000333,0.137549,18,7427.639251,412.646625,412.646625,86.0391,1,0
0,0,16,16,16,16,32,69,54,123,0.000333,0.205,24,14760,820,615,128,2,0
0,0,15,15,13,15,28,66,54,120,0.000333,0.192294,18,10383.88663,576.882591,576.882591,106.709075,2,0
0,0,16,16,15,18,33,68,62,130,0.000333,0.21859,21,13771.19595,765.066441,655.771236,133.662009,2,0
0,0,15,15,12,17,29,65,62,127,0.000333,0.205655,18,11105.34456,616.963586,616.963586,112.506418,2,0
0,0,12,12,10,12,22,56,41,97,0.000333,0.144188,15,6488.473005,360.470723,432.564867,76.238831,1,0
0,0,15,15,11,13,24,71,49,120,0.000333,0.183399,15,8252.932501,458.49625,550.1955,86.159464,1,0
0,0,17,17,14,17,31,66,53,119,0.000333,0.196516,21,12380.53658,687.807588,589.549361,122.789837,1,0
0,0,12,12,10,16,26,56,47,103,0.000333,0.161382,10,4841.45291,268.969606,484.145291,97.219281,1,0
0,0,13,13,12,13,25,61,45,106,0.000333,0.164083,18,8860.47761,492.248756,492.248756,91.125266,1,0
0,0,13,13,11,15,26,65,47,112,0.000333,0.175483,15,7896.738726,438.707707,526.449248,96.657107,1,0
0,0,14,14,11,18,29,57,51,108,0.000333,0.174887,10,5246.619475,291.47886,524.661947,113.112398,1,0
0,0,12,12,10,16,26,56,47,103,0.000333,0.161382,10,4841.45291,268.969606,484.145291,97.219281,1,0
0,0,14,14,10,17,27,62,59,121,0.000333,0.19178,15,8630.120816,479.451156,575.341388,102.706149,1,0
0,0,16,16,10,18,28,68,71,139,0.000333,0.222741,15,10023.33501,556.851945,668.222334,108.277931,1,0
0,0,18,18,10,19,29,74,83,157,0.000333,0.254234,20,15254.06033,847.447796,762.703016,113.929904,1,0
0,0,13,13,11,15,26,60,49,109,0.000333,0.170783,15,7685.218939,426.956608,512.347929,96.657107,1,0
0,0,13,13,11,17,28,62,50,112,0.000333,0.179475,10,5384.237513,299.124306,538.423751,107.540616,1,0
0,0,14,14,11,18,29,71,54,125,0.000333,0.202416,15,9108.714366,506.039687,607.247624,113.112398,1,0
0,0,13,13,10,17,27,64,51,115,0.000333,0.182271,15,8202.180941,455.676719,546.812063,102.706149,1,0
0,0,15,15,10,18,28,71,57,128,0.000333,0.205114,15,9230.12145,512.784525,615.34143,108.277931,1,0
0,0,18,18,14,20,34,69,68,137,0.000333,0.232327,21,14636.63059,813.146144,696.982409,139.741531,1,0
0,0,14,14,10,18,28,56,55,111,0.000333,0.177872,15,8004.245945,444.68033,533.616396,108.277931,1,0
0,0,13,13,14,19,33,63,54,117,0.000333,0.196731,14,8262.717568,459.039865,590.194112,134.013592,1,0
0,0,14,14,14,19,33,64,55,119,0.000333,0.200094,14,8403.960603,466.8867,600.2829,134.013592,1,0
0,0,10,10,10,11,21,50,34,84,0.000333,0.122985,15,5534.319953,307.46222,368.954664,71.273029,1,0
0,0,12,12,14,12,26,56,35,91,0.000333,0.14258,14,5988.360201,332.686678,427.740014,96.322519,2,0
0,0,11,11,11,11,22,53,35,88,0.000333,0.13081,15,5886.449737,327.024985,392.429982,76.107496,2,0
0,0,12,12,15,12,27,57,36,93,0.000333,0.147402,21,9286.295292,515.905294,442.204538,101.622909,2,0
0,0,11,11,11,12,23,53,36,89,0.000333,0.134199,15,6038.955211,335.497512,402.597014,81.073298,2,0
0,0,14,14,16,15,31,64,41,105,0.000333,0.173397,16,8323.049801,462.391656,520.190613,122.603359,2,0
0,0,13,13,13,15,28,61,41,102,0.000333,0.16345,12,5884.202425,326.900135,490.350202,106.709075,2,0
0,0,14,14,15,15,30,62,41,103,0.000333,0.16847,14,7075.736239,393.096458,505.409731,117.206718,2,0
0,0,13,13,12,15,27,59,41,100,0.000333,0.158496,12,5705.865003,316.9925,475.48875,101.622909,2,0
0,0,13,13,17,14,31,61,39,100,0.000333,0.16514,16,7926.714097,440.373005,495.419631,122.789837,2,0
0,0,12,12,13,14,27,57,39,96,0.000333,0.152156,12,5477.630402,304.3128,456.4692,101.408685,2,0
0,0,13,13,16,14,30,60,39,99,0.000333,0.161927,16,7772.514703,431.806372,485.782169,117.302969,2,0
0,0,12,12,12,14,26,56,39,95,0.000333,0.148847,12,5358.501279,297.694515,446.541773,96.322519,2,0
0,0,16,16,16,15,31,62,41,103,0.000333,0.170094,16,8164.51552,453.584196,510.28222,122.603359,2,0
0,0,15,15,13,15,28,59,41,100,0.000333,0.160245,12,5768.825906,320.490328,480.735492,106.709075,2,0
0,0,14,14,15,15,30,62,41,103,0.000333,0.16847,14,7075.736239,393.096458,505.409731,117.206718,2,0
0,0,13,13,12,15,27,59,41,100,0.000333,0.158496,12,5705.865003,316.9925,475.48875,101.622909,2,0
0,0,14,14,14,15,29,60,41,101,0.000333,0.163552,14,6869.185127,381.621396,490.656081,111.906328,2,0
0,0,13,13,11,15,26,57,41,98,0.000333,0.153548,10,4606.430924,255.912829,460.643092,96.657107,2,0
0,0,16,16,15,15,30,60,41,101,0.000333,0.165199,14,6938.343302,385.463517,495.59595,117.206718,2,0
0,0,15,15,12,15,27,57,41,98,0.000333,0.155326,12,5591.747703,310.65265,465.978975,101.622909,2,0
0,0,13,13,16,14,30,60,39,99,0.000333,0.161927,16,7772.514703,431.806372,485.782169,117.302969,2,0
0,0,12,12,12,14,26,56,39,95,0.000333,0.148847,12,5358.501279,297.694515,446.541773,96.322519,2,0
0,0,13,13,15,14,29,59,39,98,0.000333,0.158694,14,6665.149925,370.286107,476.082138,111.906328,2,0
0,0,12,12,11,14,25,55,39,94,0.000333,0.145507,10,4365.224818,242.51249,436.522482,91.356717,2,0
0,0,15,15,15,13,28,61,36,97,0.000333,0.155438,14,6528.387984,362.688221,466.313427,106.709075,2,0
0,0,15,15,15,12,27,61,36,97,0.000333,0.153741,21,9685.705842,538.094769,461.224088,101.622909,2,0
0,0,12,12,12,11,23,55,35,90,0.000333,0.135707,18,7328.170369,407.120576,407.120576,81.073298,2,0
0,0,11,11,13,13,26,58,39,97,0.000333,0.151981,18,8206.967748,455.942653,455.942653,96.211433,2,0
0,0,12,12,12,12,24,53,36,89,0.000333,0.136021,18,7345.109926,408.061663,408.061663,86.0391,1,0
0,0,16,16,16,16,32,69,53,122,0.000333,0.203333,24,14640,813.333333,610,128,2,0
0,0,15,15,13,15,28,66,53,119,0.000333,0.190692,18,10297.35424,572.075236,572.075236,106.709075,2,0
0,0,16,16,15,18,33,68,61,129,0.000333,0.216909,21,13665.26367,759.181315,650.726841,133.662009,2,0
0,0,15,15,12,17,29,65,61,126,0.000333,0.204035,18,11017.9009,612.105605,612.105605,112.506418,2,0
0,0,12,12,10,12,22,56,40,96,0.000333,0.142702,15,6421.581531,356.754529,428.105435,76.238831,1,0
0,0,15,15,11,13,24,71,48,119,0.000333,0.18187,15,8184.158064,454.675448,545.610538,86.159464,1,0
0,0,17,17,14,17,31,66,52,118,0.000333,0.194865,21,12276.49846,682.027692,584.595165,122.789837,1,0
0,0,13,13,10,16,26,61,49,110,0.000333,0.172349,15,7755.725535,430.873641,517.048369,97.219281,1,0
0,0,13,13,12,13,25,61,44,105,0.000333,0.162535,18,8776.888199,487.6049,487.6049,91.125266,1,0
0,0,14,14,11,15,26,70,49,119,0.000333,0.186451,15,8390.284897,466.126939,559.352326,96.657107,1,0
0,0,15,15,11,18,29,62,53,115,0.000333,0.186223,10,5586.678144,310.371008,558.667814,113.112398,1,0
0,0,13,13,10,16,26,61,49,110,0.000333,0.172349,15,7755.725535,430.873641,517.048369,97.219281,1,0
0,0,15,15,10,17,27,67,61,128,0.000333,0.202875,15,9129.384004,507.188,608.6256,102.706149,1,0
0,0,17,17,10,18,28,73,73,146,0.000333,0.233958,20,14037.47637,779.859798,701.873819,108.277931,1,0
0,0,19,19,10,19,29,79,85,164,0.000333,0.26557,20,15934.17766,885.232092,796.708883,113.929904,1,0
0,0,13,13,11,15,26,60,48,108,0.000333,0.169216,15,7614.712343,423.039575,507.64749,96.657107,1,0
0,0,14,14,11,17,28,67,52,119,0.000333,0.190692,15,8581.128536,476.729363,572.075236,107.540616,1,0
0,0,15,15,11,18,29,76,56,132,0.000333,0.213751,15,9618.80237,534.377909,641.253491,113.112398,1,0
0,0,14,14,10,17,27,69,53,122,0.000333,0.193365,15,8701.444129,483.413563,580.096275,102.706149,1,0
0,0,16,16,10,19,29,76,59,135,0.000333,0.218609,15,9837.411515,546.522862,655.827434,113.929904,1,0
0,0,19,19,14,20,34,74,70,144,0.000333,0.244198,21,15384.48763,854.693757,732.594649,139.741531,1,0
0,0,15,15,10,18,28,61,57,118,0.000333,0.189089,15,8509.018212,472.723234,567.267881,108.277931,1,0
0,0,14,14,14,19,33,68,56,124,0.000333,0.208502,14,8757.068191,486.503788,625.504871,134.013592,1,0
0,0,15,15,14,19,33,69,57,126,0.000333,0.211865,21,13347.46684,741.525936,635.593659,134.013592,1,0
0,0,10,10,10,11,21,50,35,85,0.000333,0.124449,15,5600.204714,311.122484,373.346981,71.273029,1,0
0,0,12,12,14,12,26,56,36,92,0.000333,0.144147,21,9081.249535,504.513863,432.440454,96.322519,2,0
0,0,11,11,11,11,22,53,36,89,0.000333,0.132296,15,5953.341211,330.741178,396.889414,76.107496,2,0
0,0,12,12,15,12,27,57,37,94,0.000333,0.148986,21,9386.147929,521.452663,446.959425,101.622909,2,0
0,0,11,11,11,12,23,53,37,90,0.000333,0.135707,15,6106.808641,339.267147,407.120576,81.073298,2,0
0,0,14,14,16,15,31,64,42,106,0.000333,0.175048,16,8402.316942,466.795386,525.144809,122.603359,2,0
0,0,13,13,13,15,28,61,42,103,0.000333,0.165053,12,5941.890684,330.105038,495.157557,106.709075,2,0
0,0,14,14,15,15,30,62,42,104,0.000333,0.170106,14,7144.432707,396.912928,510.316622,117.206718,2,0
0,0,13,13,12,15,27,59,42,101,0.000333,0.160081,12,5762.923653,320.162425,480.243638,101.622909,2,0
0,0,13,13,17,14,31,61,40,101,0.000333,0.166791,16,8005.981238,444.776735,500.373827,122.789837,2,0
0,0,12,12,13,14,27,57,40,97,0.000333,0.153741,12,5534.689053,307.482725,461.224088,101.408685,2,0
0,0,13,13,16,14,30,60,40,100,0.000333,0.163563,16,7851.024953,436.168053,490.68906,117.302969,2,0
0,0,12,12,12,14,26,56,40,96,0.000333,0.150414,12,5414.906555,300.828142,451.242213,96.322519,2,0
0,0,16,16,16,15,31,62,42,104,0.000333,0.171745,16,8243.78266,457.987926,515.236416,122.603359,2,0
0,0,15,15,13,15,28,59,42,101,0.000333,0.161848,12,5826.514166,323.695231,485.542847,106.709075,2,0
0,0,14,14,15,15,30,62,42,104,0.000333,0.170106,14,7144.432707,396.912928,510.316622,117.206718,2,0
0,0,13,13,12,15,27,59,42,101,0.000333,0.160081,12,5762.923653,320.162425,480.243638,101.622909,2,0
0,0,14,14,14,15,29,60,42,102,0.000333,0.165171,14,6937.196861,385.399826,495.514062,111.906328,2,0
0,0,13,13,11,15,26,57,42,99,0.000333,0.155115,10,4653.435321,258.524184,465.343532,96.657107,2,0
0,0,16,16,15,15,30,60,42,102,0.000333,0.166834,14,7007.039771,389.279987,500.502841,117.206718,2,0
0,0,15,15,12,15,27,57,42,99,0.000333,0.156911,12,5648.806353,313.822575,470.733863,101.622909,2,0
0,0,13,13,16,14,30,60,40,100,0.000333,0.163563,16,7851.024953,436.168053,490.68906,117.302969,2,0
0,0,12,12,12,14,26,56,40,96,0.000333,0.150414,12,5414.906555,300.828142,451.242213,96.322519,2,0
0,0,13,13,15,14,29,59,40,99,0.000333,0.160313,14,6733.161659,374.064537,480.940119,111.906328,2,0
0,0,12,12,11,14,25,55,40,95,0.000333,0.147055,10,4411.66338,245.09241,441.166338,91.356717,2,0
0,0,15,15,15,13,28,61,37,98,0.000333,0.15704,14,6595.690953,366.427275,471.120782,106.709075,2,0
0,0,15,15,15,12,27,61,37,98,0.000333,0.155326,21,9785.558479,543.642138,465.978975,101.622909,2,0
0,0,12,12,12,11,23,55,36,91,0.000333,0.137215,18,7409.594484,411.644138,411.644138,81.073298,2,0
0,0,11,11,13,13,26,58,40,98,0.000333,0.153548,18,8291.575663,460.643092,460.643092,96.211433,2,0
0,0,12,12,12,12,24,53,37,90,0.000333,0.137549,18,7427.639251,412.646625,412.646625,86.0391,1,0
0,0,16,16,16,16,32,69,54,123,0.000333,0.205,24,14760,820,615,128,2,0
0,0,15,15,13,15,28,66,54,120,0.000333,0.192294,18,10383.88663,576.882591,576.882591,106.709075,2,0
0,0,16,16,15,18,33,68,62,130,0.000333,0.21859,21,13771.19595,765.066441,655.771236,133.662009,2,0
0,0,15,15,12,17,29,65,62,127,0.000333,0.205655,18,11105.34456,616.963586,616.963586,112.506418,2,0
0,0,12,12,10,12,22,56,41,97,0.000333,0.144188,15,6488.473005,360.470723,432.564867,76.238831,1,0
0,0,15,15,11,13,24,71,49,120,0.000333,0.183399,15,8252.932501,458.49625,550.1955,86.159464,1,0
0,0,17,17,14,17,31,66,53,119,0.000333,0.196516,21,12380.53658,687.807588,589.549361,122.789837,1,0
0,0,12,12,10,16,26,56,47,103,0.000333,0.161382,10,4841.45291,268.969606,484.145291,97.219281,1,0
0,0,13,13,12,13,25,61,45,106,0.000333,0.164083,18,8860.47761,492.248756,492.248756,91.125266,1,0
0,0,13,13,11,15,26,65,47,112,0.000333,0.175483,15,7896.738726,438.707707,526.449248,96.657107,1,0
0,0,14,14,11,18,29,57,51,108,0.000333,0.174887,10,5246.619475,291.47886,524.661947,113.112398,1,0
0,0,12,12,10,16,26,56,47,103,0.000333,0.161382,10,4841.45291,268.969606,484.145291,97.219281,1,0
0,0,14,14,10,17,27,62,59,121,0.000333,0.19178,15,8630.120816,479.451156,575.341388,102.706149,1,0
0,0,16,16,10,18,28,68,71,139,0.000333,0.222741,15,10023.33501,556.851945,668.222334,108.277931,1,0
0,0,18,18,10,19,29,74,83,157,0.000333,0.254234,20,15254.06033,847.447796,762.703016,113.929904,1,0
0,0,13,13,11,15,26,60,49,109,0.000333,0.170783,15,7685.218939,426.956608,512.347929,96.657107,1,0
0,0,13,13,11,17,28,62,50,112,0.000333,0.179475,10,5384.237513,299.124306,538.423751,107.540616,1,0
0,0,14,14,11,18,29,71,54,125,0.000333,0.202416,15,9108.714366,506.039687,607.247624,113.112398,1,0
0,0,13,13,10,17,27,64,51,115,0.000333,0.182271,15,8202.180941,455.676719,546.812063,102.706149,1,0
0,0,15,15,10,18,28,71,57,128,0.000333,0.205114,15,9230.12145,512.784525,615.34143,108.277931,1,0
0,0,18,18,14,20,34,69,68,137,0.000333,0.232327,21,14636.63059,813.146144,696.982409,139.741531,1,0
0,0,14,14,10,18,28,56,55,111,0.000333,0.177872,15,8004.245945,444.68033,533.616396,108.277931,1,0
0,0,13,13,14,19,33,63,54,117,0.000333,0.196731,14,8262.717568,459.039865,590.194112,134.013592,1,0
0,0,14,14,14,19,33,64,55,119,0.000333,0.200094,14,8403.960603,466.8867,600.2829,134.013592,1,0
0,0,10,10,10,11,21,50,34,84,0.000333,0.122985,15,5534.319953,307.46222,368.954664,71.273029,1,0
0,0,12,12,14,12,26,56,35,91,0.000333,0.14258,14,5988.360201,332.686678,427.740014,96.322519,2,0
0,0,11,11,11,11,22,53,35,88,0.000333,0.13081,15,5886.449737,327.024985,392.429982,76.107496,2,0
0,0,12,12,15,12,27,57,36,93,0.000333,0.147402,21,9286.295292,515.905294,442.204538,101.622909,2,0
0,0,11,11,11,12,23,53,36,89,0.000333,0.134199,15,6038.955211,335.497512,402.597014,81.073298,2,0
0,0,14,14,16,15,31,64,41,105,0.000333,0.173397,16,8323.049801,462.391656,520.190613,122.603359,2,0
0,0,13,13,13,15,28,61,41,102,0.000333,0.16345,12,5884.202425,326.900135,490.350202,106.709075,2,0
0,0,14,14,15,15,30,62,41,103,0.000333,0.16847,14,7075.736239,393.096458,505.409731,117.206718,2,0
0,0,13,13,12,15,27,59,41,100,0.000333,0.158496,12,5705.865003,316.9925,475.48875,101.622909,2,0
0,0,13,13,17,14,31,61,39,100,0.000333,0.16514,16,7926.714097,440.373005,495.419631,122.789837,2,0
0,0,12,12,13,14,27,57,39,96,0.000333,0.152156,12,5477.630402,304.3128,456.4692,101.408685,2,0
0,0,13,13,16,14,30,60,39,99,0.000333,0.161927,16,7772.514703,431.806372,485.782169,117.302969,2,0
0,0,12,12,12,14,26,56,39,95,0.000333,0.148847,12,5358.501279,297.694515,446.541773,96.322519,2,0
0,0,16,16,16,15,31,62,41,103,0.000333,0.170094,16,8164.51552,453.584196,510.28222,122.603359,2,0
0,0,15,15,13,15,28,59,41,100,0.000333,0.160245,12,5768.825906,320.490328,480.735492,106.709075,2,0
0,0,14,14,15,15,30,62,41,103,0.000333,0.16847,14,7075.736239,393.096458,505.409731,117.206718,2,0
0,0,13,13,12,15,27,59,41,100,0.000333,0.158496,12,5705.865003,316.9925,475.48875,101.622909,2,0
0,0,14,14,14,15,29,60,41,101,0.000333,0.163552,14,6869.185127,381.621396,490.656081,111.906328,2,0
0,0,13,13,11,15,26,57,41,98,0.000333,0.153548,10,4606.430924,255.912829,460.643092,96.657107,2,0
0,0,16,16,15,15,30,60,41,101,0.000333,0.165199,14,6938.343302,385.463517,495.59595,117.206718,2,0
0,0,15,15,12,15,27,57,41,98,0.000333,0.155326,12,5591.747703,310.65265,465.978975,101.622909,2,0
0,0,13,13,16,14,30,60,39,99,0.000333,0.161927,16,7772.514703,431.806372,485.782169,117.302969,2,0
0,0,12,12,12,14,26,56,39,95,0.000333,0.148847,12,5358.501279,297.694515,446.541773,96.322519,2,0
0,0,13,13,15,14,29,59,39,98,0.000333,0.158694,14,6665.149925,370.286107,476.082138,111.906328,2,0
0,0,12,12,11,14,25,55,39,94,0.000333,0.145507,10,4365.224818,242.51249,436.522482,91.356717,2,0
0,0,15,15,15,13,28,61,36,97,0.000333,0.155438,14,6528.387984,362.688221,466.313427,106.709075,2,0
0,0,15,15,15,12,27,61,36,97,0.000333,0.153741,21,9685.705842,538.094769,461.224088,101.622909,2,0
0,0,12,12,12,11,23,55,35,90,0.000333,0.135707,18,7328.170369,407.120576,407.120576,81.073298,2,0
0,0,11,11,13,13,26,58,39,97,0.000333,0.151981,18,8206.967748,455.942653,455.942653,96.211433,2,0
0,0,12,12,12,12,24,53,36,89,0.000333,0.136021,18,7345.109926,408.061663,408.061663,86.0391,1,0
0,0,16,16,16,16,32,69,53,122,0.000333,0.203333,24,14640,813.333333,610,128,2,0
0,0,15,15,13,15,28,66,53,119,0.000333,0.190692,18,10297.35424,572.075236,572.075236,106.709075,2,0
0,0,16,16,15,18,33,68,61,129,0.000333,0.216909,21,13665.26367,759.181315,650.726841,133.662009,2,0
0,0,15,15,12,17,29,65,61,126,0.000333,0.204035,18,11017.9009,612.105605,612.105605,112.506418,2,0
0,0,12,12,10,12,22,56,40,96,0.000333,0.142702,15,6421.581531,356.754529,428.105435,76.238831,1,0
0,0,15,15,11,13,24,71,48,119,0.000333,0.18187,15,8184.158064,454.675448,545.610538,86.159464,1,0
0,0,17,17,14,17,31,66,52,118,0.000333,0.194865,21,12276.49846,682.027692,584.595165,122.789837,1,0
0,0,13,13,10,16,26,61,49,110,0.000333,0.172349,15,7755.725535,430.873641,517.048369,97.219281,1,0
0,0,13,13,12,13,25,61,44,105,0.000333,0.162535,18,8776.888199,487.6049,487.6049,91.125266,1,0
0,0,14,14,11,15,26,70,49,119,0.000333,0.186451,15,8390.284897,466.126939,559.352326,96.657107,1,0
0,0,15,15,11,18,29,62,53,115,0.000333,0.186223,10,5586.678144,310.371008,558.667814,113.112398,1,0
0,0,13,13,10,16,26,61,49,110,0.000333,0.172349,15,7755.725535,430.873641,517.048369,97.219281,1,0
0,0,15,15,10,17,27,67,61,128,0.000333,0.202875,15,9129.384004,507.188,608.6256,102.706149,1,0
0,0,17,17,10,18,28,73,73,146,0.000333,0.233958,20,14037.47637,779.859798,701.873819,108.277931,1,0
0,0,19,19,10,19,29,79,85,164,0.000333,0.26557,20,15934.17766,885.232092,796.708883,113.929904,1,0
0,0,13,13,11,15,26,60,48,108,0.000333,0.169216,15,7614.712343,423.039575,507.64749,96.657107,1,0
0,0,14,14,11,17,28,67,52,119,0.000333,0.190692,15,8581.128536,476.729363,572.075236,107.540616,1,0
0,0,15,15,11,18,29,76,56,132,0.000333,0.213751,15,9618.80237,534.377909,641.253491,113.112398,1,0
0,0,14,14,10,17,27,69,53,122,0.000333,0.193365,15,8701.444129,483.413563,580.096275,102.706149,1,0
0,0,16,16,10,19,29,76,59,135,0.000333,0.218609,15,9837.411515,546.522862,655.827434,113.929904,1,0
0,0,16,16,11,19,30,68,62,130,0.000333,0.212632,15,9568.436661,531.579815,637.895777,118.764371,1,0
0,0,15,15,10,18,28,61,57,118,0.000333,0.189089,15,8509.018212,472.723234,567.267881,108.277931,1,0
0,0,14,14,14,19,33,68,56,124,0.000333,0.208502,14,8757.068191,486.503788,625.504871,134.013592,1,0
0,0,15,15,14,19,33,69,57,126,0.000333,0.211865,21,13347.46684,741.525936,635.593659,134.013592,1,0
0,0,13,13,14,18,32,57,52,109,0.000333,0.181667,14,7630,423.888889,545,128.361619,1,0
0,0,14,14,13,18,31,58,53,111,0.000333,0.183305,12,6598.989485,366.610527,549.91579,123.164366,1,0
0,0,14,14,14,18,32,62,54,116,0.000333,0.193333,21,12180,676.666667,580,128.361619,1,0
0,0,15,15,13,18,31,63,55,118,0.000333,0.194865,18,10522.71296,584.595165,584.595165,123.164366,1,0
0,0,13,13,14,18,32,57,52,109,0.000333,0.181667,14,7630,423.888889,545,128.361619,1,0
0,0,14,14,13,18,31,58,53,111,0.000333,0.183305,12,6598.989485,366.610527,549.91579,123.164366,1,0
0,0,14,14,14,18,32,62,54,116,0.000333,0.193333,21,12180,676.666667,580,128.361619,1,0
0,0,15,15,13,18,31,63,55,118,0.000333,0.194865,18,10522.71296,584.595165,584.595165,123.164366,1,0
0,0,9,9,10,10,20,48,33,81,0.000333,0.116692,15,5251.142635,291.730146,350.076176,66.438562,1,0
0,0,11,11,14,11,25,54,34,88,0.000333,0.13622,21,8581.846239,476.769235,408.659345,91.356717,2,0
0,0,10,10,11,10,21,51,34,85,0.000333,0.124449,15,5600.204714,311.122484,373.346981,71.273029,2,0
0,0,11,11,15,11,26,55,35,90,0.000333,0.141013,21,8883.831067,493.54617,423.039575,96.657107,2,0
0,0,10,10,11,11,22,51,35,86,0.000333,0.127837,15,5752.666788,319.592599,383.511119,76.107496,2,0
0,0,13,13,16,14,30,62,40,102,0.000333,0.166834,16,8008.045452,444.891414,500.502841,117.302969,2,0
0,0,12,12,13,14,27,59,40,99,0.000333,0.156911,12,5648.806353,313.822575,470.733863,101.408685,2,0
0,0,13,13,15,14,29,60,40,100,0.000333,0.161933,14,6801.173393,377.842966,485.7981,111.906328,2,0
0,0,12,12,12,14,26,57,40,97,0.000333,0.151981,12,5471.311832,303.961768,455.942653,96.322519,2,0
0,0,12,12,17,13,30,59,38,97,0.000333,0.158656,16,7615.494204,423.083011,475.968388,117.592585,2,0
0,0,11,11,13,13,26,55,38,93,0.000333,0.145714,12,5245.690725,291.427263,437.140894,96.211433,2,0
0,0,12,12,16,13,29,58,38,96,0.000333,0.155455,16,7461.858809,414.547712,466.366176,112.105716,2,0
0,0,11,11,12,13,25,54,38,92,0.000333,0.142412,12,5126.817234,284.82318,427.234769,91.125266,2,0
0,0,15,15,16,14,30,60,40,100,0.000333,0.163563,16,7851.024953,436.168053,490.68906,117.302969,2,0
0,0,14,14,13,14,27,57,40,97,0.000333,0.153741,12,5534.689053,307.482725,461.224088,101.408685,2,0
0,0,13,13,15,14,29,60,40,100,0.000333,0.161933,14,6801.173393,377.842966,485.7981,111.906328,2,0
0,0,12,12,12,14,26,57,40,97,0.000333,0.151981,12,5471.311832,303.961768,455.942653,96.322519,2,0
0,0,11,11,14,11,25,54,34,88,0.000333,0.13622,21,8581.846239,476.769235,408.659345,91.356717,2,0
0,0,10,10,11,11,22,51,34,85,0.000333,0.126351,15,5685.775314,315.876406,379.051688,76.107496,2,0
0,0,15,15,15,14,29,58,40,98,0.000333,0.158694,14,6665.149925,370.286107,476.082138,111.906328,2,0
0,0,14,14,12,14,26,55,40,95,0.000333,0.148847,12,5358.501279,297.694515,446.541773,96.322519,2,0
0,0,12,12,16,13,29,58,38,96,0.000333,0.155455,16,7461.858809,414.547712,466.366176,112.105716,2,0
0,0,11,11,12,13,25,54,38,92,0.000333,0.142412,12,5126.817234,284.82318,427.234769,91.125266,2,0
0,0,12,12,15,13,28,57,38,95,0.000333,0.152233,14,6393.782046,355.210114,456.698718,106.709075,2,0
0,0,11,11,11,13,24,53,38,91,0.000333,0.139077,10,4172.315876,231.795326,417.231588,86.159464,2,0
0,0,14,14,15,12,27,59,35,94,0.000333,0.148986,14,6257.431953,347.635108,446.959425,101.622909,2,0
0,0,14,14,15,11,26,59,35,94,0.000333,0.14728,21,9278.668004,515.481556,441.841334,96.657107,2,0
0,0,11,11,12,10,22,53,34,87,0.000333,0.129324,18,6983.469915,387.970551,387.970551,76.238831,2,0
0,0,10,10,13,12,25,56,38,94,0.000333,0.145507,18,7857.404673,436.522482,436.522482,91.125266,2,0
0,0,11,11,12,11,23,51,35,86,0.000333,0.129675,18,7002.473908,389.026328,389.026328,81.073298,1,0
0,0,11,11,10,11,21,54,39,93,0.000333,0.136162,15,6127.282805,340.4046,408.48552,71.273029,1,0
0,0,14,14,11,12,23,69,47,116,0.000333,0.174911,15,7870.997804,437.277656,524.733187,81.073298,1,0
0,0,16,16,14,16,30,64,51,115,0.000333,0.188097,21,11850.14079,658.341155,564.292418,117.302969,1,0
0,0,11,11,10,15,25,54,45,99,0.000333,0.153247,15,6896.126442,383.118136,459.741763,91.82264,1,0
0,0,12,12,11,14,25,63,45,108,0.000333,0.167179,15,7523.047027,417.947057,501.536468,91.356717,1,0
0,0,13,13,11,17,28,55,49,104,0.000333,0.166655,10,4999.649119,277.758284,499.964912,107.540616,1,0
0,0,11,11,10,15,25,54,45,99,0.000333,0.153247,15,6896.126442,383.118136,459.741763,91.82264,1,0
0,0,13,13,10,16,26,60,57,117,0.000333,0.183317,15,8249.271705,458.292873,549.951447,97.219281,1,0
0,0,15,15,10,17,27,66,69,135,0.000333,0.21397,20,12838.19626,713.233125,641.909813,102.706149,1,0
0,0,17,17,10,18,28,72,81,153,0.000333,0.245175,20,14710.50606,817.250337,735.525303,108.277931,1,0
0,0,12,12,11,16,27,60,48,108,0.000333,0.171176,15,7702.917754,427.939875,513.52785,102.053748,1,0
0,0,13,13,11,17,28,69,52,121,0.000333,0.193897,15,8725.349184,484.741621,581.689946,107.540616,1,0
0,0,12,12,10,16,26,62,49,111,0.000333,0.173916,15,7826.232131,434.790674,521.748809,97.219281,1,0
0,0,14,14,10,17,27,69,55,124,0.000333,0.196535,15,8844.090754,491.338375,589.60605,102.706149,1,0
0,0,14,14,11,18,29,61,58,119,0.000333,0.1927,15,8671.496076,481.749782,578.099738,113.112398,1,0
0,0,13,13,10,17,27,54,53,107,0.000333,0.169591,15,7631.594441,423.977469,508.772963,102.706149,1,0
0,0,12,12,14,18,32,61,52,113,0.000333,0.188333,14,7910,439.444444,565,128.361619,1,0
0,0,13,13,14,18,32,62,53,115,0.000333,0.191667,14,8050,447.222222,575,128.361619,1,0
0,0,9,9,10,10,20,48,32,80,0.000333,0.115251,15,5186.313714,288.12854,345.754248,66.438562,1,0
0,0,11,11,14,11,25,54,33,87,0.000333,0.134672,21,8484.325259,471.351403,404.015489,91.356717,2,0
0,0,10,10,11,10,21,51,33,84,0.000333,0.122985,15,5534.319953,307.46222,368.954664,71.273029,2,0
0,0,11,11,15,11,26,55,34,89,0.000333,0.139446,21,8785.121833,488.062324,418.339135,96.657107,2,0
0,0,10,10,11,11,22,51,34,85,0.000333,0.126351,15,5685.775314,315.876406,379.051688,76.107496,2,0
0,0,13,13,16,14,30,62,39,101,0.000333,0.165199,16,7929.535203,440.529733,495.59595,117.302969,2,0
0,0,12,12,13,14,27,59,39,98,0.000333,0.155326,12,5591.747703,310.65265,465.978975,101.408685,2,0
0,0,13,13,15,14,29,60,39,99,0.000333,0.160313,14,6733.161659,374.064537,480.940119,111.906328,2,0
0,0,12,12,12,14,26,57,39,96,0.000333,0.150414,12,5414.906555,300.828142,451.242213,96.322519,2,0
0,0,12,12,17,13,30,59,37,96,0.000333,0.15702,16,7536.983955,418.721331,471.061497,117.592585,2,0
0,0,11,11,13,13,26,55,37,92,0.000333,0.144147,12,5189.285449,288.293636,432.440454,96.211433,2,0
0,0,12,12,16,13,29,58,37,95,0.000333,0.153836,16,7384.131113,410.229506,461.508195,112.105716,2,0
0,0,11,11,12,13,25,54,37,91,0.000333,0.140864,12,5071.090959,281.727276,422.590913,91.125266,2,0
0,0,15,15,16,14,30,60,39,99,0.000333,0.161927,16,7772.514703,431.806372,485.782169,117.302969,2,0
0,0,14,14,13,14,27,57,39,96,0.000333,0.152156,12,5477.630402,304.3128,456.4692,101.408685,2,0
0,0,13,13,15,14,29,60,39,99,0.000333,0.160313,14,6733.161659,374.064537,480.940119,111.906328,2,0
0,0,12,12,12,14,26,57,39,96,0.000333,0.150414,12,5414.906555,300.828142,451.242213,96.322519,2,0
0,0,13,13,14,14,28,58,39,97,0.000333,0.155438,14,6528.387984,362.688221,466.313427,106.605938,2,0
0,0,12,12,11,14,25,55,39,94,0.000333,0.145507,10,4365.224818,242.51249,436.522482,91.356717,2,0
0,0,15,15,15,14,29,58,39,97,0.000333,0.157075,14,6597.138191,366.507677,471.224157,111.906328,2,0
0,0,14,14,12,14,26,55,39,94,0.000333,0.14728,12,5302.096002,294.560889,441.841334,96.322519,2,0
0,0,12,12,16,13,29,58,37,95,0.000333,0.153836,16,7384.131113,410.229506,461.508195,112.105716,2,0
0,0,11,11,12,13,25,54,37,91,0.000333,0.140864,12,5071.090959,281.727276,422.590913,91.125266,2,0
0,0,12,12,15,13,28,57,37,94,0.000333,0.15063,14,6326.479077,351.47106,451.891363,106.709075,2,0
0,0,11,11,11,13,24,53,37,90,0.000333,0.137549,10,4126.466251,229.248125,412.646625,86.159464,2,0
0,0,14,14,15,12,27,59,34,93,0.000333,0.147402,14,6190.863528,343.936863,442.204538,101.622909,2,0
0,0,14,14,15,11,26,59,34,93,0.000333,0.145714,21,9179.95877,509.997709,437.140894,96.657107,2,0
0,0,11,11,12,10,22,53,33,86,0.000333,0.127837,18,6903.200146,383.511119,383.511119,76.238831,2,0
0,0,10,10,13,12,25,56,37,93,0.000333,0.14396,18,7773.815262,431.878626,431.878626,91.125266,2,0
0,0,11,11,12,11,23,51,34,85,0.000333,0.128168,18,6921.049793,384.502766,384.502766,81.073298,1,0
0,0,11,11,10,11,21,54,38,92,0.000333,0.134698,15,6061.398043,336.744336,404.093203,71.273029,1,0
0,0,14,14,11,12,23,69,46,115,0.000333,0.173403,15,7803.144374,433.508021,520.209625,81.073298,1,0
0,0,16,16,14,16,30,64,50,114,0.000333,0.186462,21,11747.09609,652.616449,559.385528,117.302969,1,0
0,0,12,12,10,15,25,59,47,106,0.000333,0.164083,15,7383.731342,410.207297,492.248756,91.82264,1,0
0,0,13,13,11,14,25,68,47,115,0.000333,0.178014,15,8010.651927,445.036218,534.043462,91.356717,1,0
0,0,14,14,11,17,28,60,51,111,0.000333,0.177872,15,8004.245945,444.68033,533.616396,107.540616,1,0
0,0,12,12,10,15,25,59,47,106,0.000333,0.164083,15,7383.731342,410.207297,492.248756,91.82264,1,0
0,0,14,14,10,16,26,65,59,124,0.000333,0.194285,15,8742.817876,485.712104,582.854525,97.219281,1,0
0,0,16,16,10,17,27,71,71,142,0.000333,0.225065,20,13503.88051,750.215584,675.194025,102.706149,1,0
0,0,18,18,10,18,28,77,83,160,0.000333,0.256392,20,15383.53575,854.640875,769.176788,108.277931,1,0
0,0,13,13,11,16,27,65,50,115,0.000333,0.182271,15,8202.180941,455.676719,546.812063,102.053748,1,0
0,0,14,14,11,17,28,74,54,128,0.000333,0.205114,15,9230.12145,512.784525,615.34143,107.540616,1,0
0,0,13,13,10,16,26,67,51,118,0.000333,0.184884,15,8319.778301,462.209906,554.651887,97.219281,1,0
0,0,15,15,10,18,28,74,57,131,0.000333,0.209921,15,9446.452422,524.802912,629.763495,108.277931,1,0
0,0,18,18,14,19,33,72,68,140,0.000333,0.235405,21,14830.51871,823.917706,706.215177,134.013592,1,0
0,0,14,14,10,17,27,59,55,114,0.000333,0.180686,15,8130.857629,451.714313,542.057175,102.706149,1,0
0,0,13,13,14,18,32,66,54,120,0.000333,0.2,21,12600,700,600,128.361619,1,0
0,0,14,14,14,18,32,67,55,122,0.000333,0.203333,21,12810,711.666667,610,128.361619,1,0
0,0,9,9,9,9,18,39,30,69,0.000333,0.095908,12,3452.697901,191.81655,287.724825,57.05865,1,0
0,0,11,11,13,10,23,45,31,76,0.000333,0.114597,18,6188.232756,343.790709,343.790709,81.324997,2,0
0,0,10,10,10,9,19,42,31,73,0.000333,0.103366,15,4651.480627,258.41559,310.098708,61.748606,2,0
0,0,11,11,14,10,24,46,32,78,0.000333,0.119209,21,7510.168576,417.231588,357.627075,86.52225,2,0
0,0,10,10,10,10,20,42,32,74,0.000333,0.106608,15,4797.340185,266.518899,319.822679,66.438562,2,0
0,0,13,13,15,13,28,53,37,90,0.000333,0.144221,14,6057.267202,336.514845,432.661943,106.709075,2,0
0,0,12,12,12,13,25,50,37,87,0.000333,0.134672,12,4848.185862,269.343659,404.015489,91.125266,2,0
0,0,13,13,14,13,27,51,37,88,0.000333,0.139477,14,5858.021403,325.445633,418.4301,101.408685,2,0
0,0,12,12,11,13,24,48,37,85,0.000333,0.129907,10,3897.218126,216.512118,389.721813,86.159464,2,0
0,0,12,12,16,12,28,50,35,85,0.000333,0.136208,16,6538.002694,363.222372,408.625168,107.01955,2,0
0,0,11,11,12,12,24,46,35,81,0.000333,0.123794,12,4456.583551,247.587975,371.381963,86.0391,2,0
0,0,12,12,15,12,27,49,35,84,0.000333,0.133137,14,5591.747703,310.65265,399.41055,101.622909,2,0
0,0,11,11,11,12,23,45,35,80,0.000333,0.120628,10,3618.849565,201.047198,361.884956,81.073298,2,0
0,0,15,15,15,13,28,51,37,88,0.000333,0.141016,14,5922.661264,329.036737,423.047233,106.709075,2,0
0,0,14,14,12,13,25,48,37,85,0.000333,0.131576,12,4736.733314,263.151851,394.727776,91.125266,2,0
0,0,13,13,14,13,27,51,37,88,0.000333,0.139477,14,5858.021403,325.445633,418.4301,101.408685,2,0
0,0,12,12,11,13,24,48,37,85,0.000333,0.129907,10,3897.218126,216.512118,389.721813,86.159464,2,0
0,0,13,13,13,13,26,49,37,86,0.000333,0.134746,12,4850.853789,269.491877,404.237816,96.211433,2,0
0,0,12,12,10,13,23,46,37,83,0.000333,0.125152,10,3754.556424,208.586468,375.455642,81.324997,2,0
0,0,15,15,14,13,27,49,37,86,0.000333,0.136307,14,5724.884553,318.049142,408.920325,101.408685,2,0
0,0,14,14,11,13,24,46,37,83,0.000333,0.126851,10,3805.518876,211.417715,380.551888,86.159464,2,0
0,0,12,12,15,12,27,49,35,84,0.000333,0.133137,14,5591.747703,310.65265,399.41055,101.622909,2,0
0,0,11,11,11,12,23,45,35,80,0.000333,0.120628,10,3618.849565,201.047198,361.884956,81.073298,2,0
0,0,12,12,14,12,26,48,35,83,0.000333,0.130045,14,5461.910952,303.439497,390.136497,96.322519,2,0
0,0,11,11,10,12,22,44,35,79,0.000333,0.117432,10,3522.950979,195.719499,352.295098,76.238831,2,0
0,0,14,14,14,11,25,50,32,82,0.000333,0.126932,14,5331.146906,296.174828,380.796208,91.356717,2,0
0,0,14,14,14,10,24,50,32,82,0.000333,0.125322,21,7895.305426,438.628079,375.966925,86.52225,2,0
0,0,11,11,11,9,20,44,31,75,0.000333,0.108048,15,4862.169107,270.120506,324.144607,66.583073,2,0
0,0,10,10,12,11,23,47,35,82,0.000333,0.123644,18,6676.777447,370.93208,370.93208,81.073298,2,0
0,0,11,11,11,10,21,42,32,74,0.000333,0.108344,15,4875.472339,270.859574,325.031489,71.273029,1,0
0,0,11,11,9,10,19,45,36,81,0.000333,0.114694,12,4128.985543,229.388086,344.082129,61.748606,1,0
0,0,14,14,10,11,21,60,44,104,0.000333,0.152267,20,9136.020239,507.55668,456.801012,71.273029,1,0
0,0,16,16,13,15,28,55,48,103,0.000333,0.165053,18,8912.836025,495.157557,495.157557,106.709075,1,0
0,0,11,11,9,14,23,45,42,87,0.000333,0.131183,12,4722.598682,262.366593,393.54989,81.832294,1,0
0,0,12,12,10,13,23,54,42,96,0.000333,0.144754,15,6513.929217,361.884956,434.261948,81.324997,1,0
0,0,13,13,10,16,26,46,46,92,0.000333,0.144147,10,4324.404541,240.244697,432.440454,97.219281,1,0
0,0,11,11,9,14,23,45,42,87,0.000333,0.131183,12,4722.598682,262.366593,393.54989,81.832294,1,0
0,0,13,13,9,15,24,51,54,105,0.000333,0.160474,12,5777.052751,320.947375,481.421063,87.132684,1,0
0,0,15,15,9,16,25,57,66,123,0.000333,0.190398,16,9139.108981,507.728277,571.194311,92.529325,1,0
0,0,17,17,9,17,26,63,78,141,0.000333,0.220921,16,10604.192,589.121778,662.762,98.016193,1,0
0,0,12,12,10,15,25,51,45,96,0.000333,0.148603,15,6687.152913,371.508495,445.810194,91.82264,1,0
0,0,13,13,10,16,26,60,49,109,0.000333,0.170783,15,7685.218939,426.956608,512.347929,97.219281,1,0
0,0,12,12,9,15,24,53,46,99,0.000333,0.151304,12,5446.935451,302.607525,453.911288,87.132684,1,0
0,0,14,14,9,16,25,60,52,112,0.000333,0.173371,12,6241.342719,346.741262,520.111893,92.529325,1,0
0,0,14,14,10,17,27,52,55,107,0.000333,0.169591,15,7631.594441,423.977469,508.772963,102.706149,1,0
0,0,13,13,9,16,25,45,50,95,0.000333,0.147055,12,5293.996056,294.110892,441.166338,92.529325,1,0
0,0,12,12,13,17,30,52,49,101,0.000333,0.165199,12,5947.151402,330.3973,495.59595,117.592585,1,0
0,0,13,13,13,17,30,53,50,103,0.000333,0.16847,12,6064.916776,336.939821,505.409731,117.592585,1,0
0,0,9,9,9,9,18,39,29,68,0.000333,0.094518,12,3402.658801,189.0366,283.5549,57.05865,1,0
0,0,11,11,13,10,23,45,30,75,0.000333,0.113089,18,6106.808641,339.267147,339.267147,81.324997,2,0
0,0,10,10,10,9,19,42,30,72,0.000333,0.10195,15,4587.761715,254.875651,305.850781,61.748606,2,0
0,0,11,11,14,10,24,46,31,77,0.000333,0.117681,21,7413.884364,411.882465,353.042113,86.52225,2,0
0,0,10,10,10,10,20,42,31,73,0.000333,0.105167,15,4732.511264,262.917292,315.500751,66.438562,2,0
0,0,13,13,15,13,28,53,36,89,0.000333,0.142618,14,5989.964233,332.775791,427.854588,106.709075,2,0
0,0,12,12,12,13,25,50,36,86,0.000333,0.133124,12,4792.459588,266.247755,399.371632,91.125266,2,0
0,0,13,13,14,13,27,51,36,87,0.000333,0.137892,14,5791.452978,321.747388,413.675213,101.408685,2,0
0,0,12,12,11,13,24,48,36,84,0.000333,0.128379,10,3851.368501,213.964917,385.13685,86.159464,2,0
0,0,12,12,16,12,28,50,34,84,0.000333,0.134606,16,6461.085015,358.949168,403.817813,107.01955,2,0
0,0,11,11,12,12,24,46,34,80,0.000333,0.122266,12,4401.564001,244.531333,366.797,86.0391,2,0
0,0,12,12,15,12,27,49,34,83,0.000333,0.131552,14,5525.179278,306.954404,394.655663,101.622909,2,0
0,0,11,11,11,12,23,45,34,79,0.000333,0.11912,10,3573.613945,198.534108,357.361395,81.073298,2,0
0,0,15,15,15,13,28,51,36,87,0.000333,0.139413,14,5855.358295,325.297683,418.239878,106.709075,2,0
0,0,14,14,12,13,25,48,36,84,0.000333,0.130028,12,4681.007039,260.055947,390.08392,91.125266,2,0
0,0,13,13,14,13,27,51,36,87,0.000333,0.137892,14,5791.452978,321.747388,413.675213,101.408685,2,0
0,0,12,12,11,13,24,48,36,84,0.000333,0.128379,10,3851.368501,213.964917,385.13685,86.159464,2,0
0,0,13,13,13,13,26,49,36,85,0.000333,0.133179,12,4794.448513,266.358251,399.537376,96.211433,2,0
0,0,12,12,10,13,23,46,36,82,0.000333,0.123644,10,3709.320804,206.073378,370.93208,81.324997,2,0
0,0,15,15,14,13,27,49,36,85,0.000333,0.134722,14,5658.316128,314.350896,404.165438,101.408685,2,0
0,0,14,14,11,13,24,46,36,82,0.000333,0.125322,10,3759.669251,208.870514,375.966925,86.159464,2,0
0,0,12,12,15,12,27,49,34,83,0.000333,0.131552,14,5525.179278,306.954404,394.655663,101.622909,2,0
0,0,11,11,11,12,23,45,34,79,0.000333,0.11912,10,3573.613945,198.534108,357.361395,81.073298,2,0
0,0,12,12,14,12,26,48,34,82,0.000333,0.128479,14,5396.104796,299.7836,385.436057,96.322519,2,0
0,0,11,11,10,12,22,44,34,78,0.000333,0.115945,10,3478.356663,193.242037,347.835666,76.238831,2,0
0,0,14,14,14,11,25,50,31,81,0.000333,0.125384,14,5266.132919,292.56294,376.152351,91.356717,2,0
0,0,14,14,14,10,24,50,31,81,0.000333,0.123794,21,7799.021214,433.278956,371.381963,86.52225,2,0
0,0,11,11,11,9,20,44,30,74,0.000333,0.106608,15,4797.340185,266.518899,319.822679,66.583073,2,0
0,0,10,10,12,11,23,47,34,81,0.000333,0.122136,18,6595.353332,366.408518,366.408518,81.073298,2,0
0,0,11,11,11,10,21,42,31,73,0.000333,0.10688,15,4809.587578,267.19931,320.639172,71.273029,1,0
0,0,11,11,9,10,19,45,35,80,0.000333,0.113278,12,4078.010413,226.556134,339.834201,61.748606,1,0
0,0,14,14,10,11,21,60,43,103,0.000333,0.150803,15,6786.130418,377.007245,452.408695,71.273029,1,0
0,0,16,16,13,15,28,55,47,102,0.000333,0.16345,18,8826.303637,490.350202,490.350202,106.709075,1,0
0,0,12,12,9,14,23,50,44,94,0.000333,0.141738,12,5102.577886,283.476549,425.214824,81.832294,1,0
0,0,13,13,10,13,23,59,44,103,0.000333,0.155309,15,6988.903222,388.272401,465.926881,81.324997,1,0
0,0,14,14,10,16,26,51,48,99,0.000333,0.155115,15,6980.152981,387.786277,465.343532,97.219281,1,0
0,0,12,12,9,14,23,50,44,94,0.000333,0.141738,12,5102.577886,283.476549,425.214824,81.832294,1,0
0,0,14,14,9,15,24,56,56,112,0.000333,0.171172,12,6162.189601,342.343867,513.5158,87.132684,1,0
0,0,16,16,9,16,25,62,68,130,0.000333,0.201234,16,9659.220875,536.623382,603.701305,92.529325,1,0
0,0,18,18,9,17,26,68,80,148,0.000333,0.231888,16,11130.64125,618.368958,695.665078,98.016193,1,0
0,0,13,13,10,15,25,56,47,103,0.000333,0.159439,15,7174.757813,398.597656,478.317188,91.82264,1,0
0,0,14,14,10,16,26,65,51,116,0.000333,0.18175,15,8178.76511,454.375839,545.251007,97.219281,1,0
0,0,13,13,9,15,24,58,48,106,0.000333,0.162002,12,5832.072301,324.004017,486.006025,87.132684,1,0
0,0,15,15,9,17,26,65,54,119,0.000333,0.186451,12,6712.227918,372.901551,559.352326,98.016193,1,0
0,0,18,18,13,18,31,63,65,128,0.000333,0.211379,18,11414.4683,634.137128,634.137128,123.164366,1,0
0,0,14,14,9,16,25,50,52,102,0.000333,0.157891,12,5684.079976,315.782221,473.673331,92.529325,1,0
0,0,13,13,13,17,30,57,51,108,0.000333,0.176648,18,9538.995318,529.944184,529.944184,117.592585,1,0
0,0,14,14,13,17,30,58,52,110,0.000333,0.179919,18,9715.643379,539.757966,539.757966,117.592585,1,0
0,0,5,5,8,7,15,16,12,28,0.000333,0.036464,4,437.571747,24.309541,109.392937,43.651484,2,0
0,0,14,14,16,15,31,72,39,111,0.000333,0.183305,16,8798.652647,488.814036,549.91579,122.603359,6,0
0,0,17,17,19,15,34,81,41,122,0.000333,0.20689,18,11172.0684,620.670467,620.670467,139.313982,8,0
0,0,16,16,16,15,31,78,41,119,0.000333,0.196516,16,9432.789775,524.043876,589.549361,122.603359,8,0
0,0,8,8,12,9,21,25,14,39,0.000333,0.0571,6,1027.802277,57.100126,171.300379,71.548875,4,0
0,0,7,7,9,8,17,22,14,36,0.000333,0.04905,4,588.594649,32.699703,147.148662,52.529325,4,0
0,0,17,17,20,16,36,82,43,125,0.000333,0.215414,20,12924.8125,718.045139,646.240625,150.438562,8,0
0,0,16,16,16,16,32,78,43,121,0.000333,0.201667,16,9680,537.777778,605,128,8,0
0,0,8,8,13,8,21,26,16,42,0.000333,0.061492,12,2213.727981,122.984888,184.477332,72.105716,4,0
0,0,7,7,9,8,17,22,16,38,0.000333,0.051775,8,1242.588704,69.032706,155.323588,52.529325,4,0
0,0,19,19,21,18,39,89,47,136,0.000333,0.239605,20,14376.29404,798.683002,718.814702,167.297316,8,0
0,0,18,18,18,18,36,86,47,133,0.000333,0.2292,18,12376.80045,687.600025,687.600025,150.1173,8,0
0,0,10,10,14,12,26,33,20,53,0.000333,0.083041,7,1743.863135,96.881285,249.123305,96.322519,4,0
0,0,9,9,11,12,23,30,20,50,0.000333,0.075393,5,1130.890489,62.827249,226.178098,81.073298,4,0
0,0,19,19,20,18,38,87,47,134,0.000333,0.234407,20,14064.44574,781.358096,703.222287,161.497212,8,0
0,0,18,18,17,18,35,84,47,131,0.000333,0.223979,16,10750.9772,597.276511,671.936075,144.545518,8,0
0,0,10,10,13,12,25,31,20,51,0.000333,0.078946,6,1421.019994,78.945555,236.836666,91.125266,4,0
0,0,9,9,10,12,22,28,20,48,0.000333,0.071351,5,1070.263588,59.459088,214.052718,76.238831,4,0
0,0,18,18,22,18,40,86,46,132,0.000333,0.234165,22,15454.87919,858.604399,702.494509,173.166146,8,0
0,0,17,17,18,18,36,82,46,128,0.000333,0.220583,18,11911.5072,661.7504,661.7504,150.1173,8,0
0,0,9,9,15,10,25,30,19,49,0.000333,0.07585,7,1592.842673,88.49126,227.548953,91.82264,4,0
0,0,8,8,11,10,21,26,19,45,0.000333,0.065885,5,988.27142,54.903968,197.654284,71.273029,4,0
0,0,18,18,21,18,39,85,46,131,0.000333,0.230796,20,13847.75381,769.319656,692.387691,167.297316,8,0
0,0,17,17,17,18,35,81,46,127,0.000333,0.21714,16,10422.70309,579.039061,651.418943,144.545518,8,0
0,0,9,9,14,10,24,29,19,48,0.000333,0.073359,7,1540.5474,85.585967,220.0782,86.52225,4,0
0,0,8,8,10,10,20,25,19,44,0.000333,0.063388,5,950.824181,52.823566,190.164836,66.438562,4,0
0,0,21,21,21,18,39,87,47,134,0.000333,0.236081,20,14164.87795,786.937664,708.243897,167.297316,8,0
0,0,20,20,18,18,36,84,47,131,0.000333,0.225753,18,12190.68315,677.260175,677.260175,150.1173,8,0
0,0,12,12,14,12,26,31,20,51,0.000333,0.079907,7,1678.056979,93.225388,239.722426,96.322519,4,0
0,0,11,11,11,12,23,28,20,48,0.000333,0.072377,5,1085.654869,60.314159,217.130974,81.073298,4,0
0,0,19,19,20,18,38,87,47,134,0.000333,0.234407,20,14064.44574,781.358096,703.222287,161.497212,8,0
0,0,18,18,17,18,35,84,47,131,0.000333,0.223979,16,10750.9772,597.276511,671.936075,144.545518,8,0
0,0,10,10,13,12,25,31,20,51,0.000333,0.078946,6,1421.019994,78.945555,236.836666,91.125266,4,0
0,0,9,9,10,12,22,28,20,48,0.000333,0.071351,5,1070.263588,59.459088,214.052718,76.238831,4,0
0,0,19,19,19,18,37,85,47,132,0.000333,0.229216,18,12377.6612,687.647844,687.647844,155.769273,8,0
0,0,18,18,16,18,34,82,47,129,0.000333,0.218761,16,10500.5233,583.362406,656.282707,139.05865,8,0
0,0,10,10,12,12,24,29,20,49,0.000333,0.074888,6,1347.978975,74.887721,224.663163,86.0391,4,0
0,0,9,9,9,12,21,26,20,46,0.000333,0.067349,4,808.186406,44.899245,202.046601,71.548875,4,0
0,0,21,21,20,18,38,85,47,132,0.000333,0.230909,20,13854.52864,769.696035,692.726432,161.497212,8,0
0,0,20,20,17,18,35,82,47,129,0.000333,0.220559,16,10586.84015,588.157786,661.677509,144.545518,8,0
0,0,12,12,13,12,25,29,20,49,0.000333,0.07585,6,1365.29372,75.849651,227.548953,91.125266,4,0
0,0,11,11,10,12,22,26,20,46,0.000333,0.068378,5,1025.669272,56.981626,205.133854,76.238831,4,0
0,0,7,7,11,12,23,29,23,52,0.000333,0.078408,5,1176.126109,65.340339,235.225222,81.073298,2,0
0,0,7,7,10,12,22,28,23,51,0.000333,0.07581,5,1137.155063,63.175281,227.431013,76.238831,2,0
0,0,7,7,10,12,22,28,23,51,0.000333,0.07581,5,1137.155063,63.175281,227.431013,76.238831,2,0
0,0,7,7,11,12,23,29,23,52,0.000333,0.078408,5,1176.126109,65.340339,235.225222,81.073298,2,0
0,0,7,7,10,11,21,28,22,50,0.000333,0.073205,10,2196.158711,122.008817,219.615871,71.273029,2,0
0,0,7,7,10,11,21,28,22,50,0.000333,0.073205,10,2196.158711,122.008817,219.615871,71.273029,2,0
0,0,8,8,11,11,22,29,22,51,0.000333,0.07581,10,2274.310126,126.350563,227.431013,76.107496,2,0
0,0,7,7,10,11,21,28,22,50,0.000333,0.073205,10,2196.158711,122.008817,219.615871,71.273029,2,0
0,0,8,8,11,11,22,29,22,51,0.000333,0.07581,10,2274.310126,126.350563,227.431013,76.107496,2,0
0,0,7,7,10,11,21,28,22,50,0.000333,0.073205,10,2196.158711,122.008817,219.615871,71.273029,2,0
0,0,8,8,11,11,22,29,22,51,0.000333,0.07581,10,2274.310126,126.350563,227.431013,76.107496,2,0
0,0,7,7,10,11,21,28,22,50,0.000333,0.073205,10,2196.158711,122.008817,219.615871,71.273029,2,0
0,0,10,10,11,11,22,35,26,61,0.000333,0.090675,10,2720.253287,151.125183,272.025329,76.107496,2,0
0,0,8,8,12,12,24,30,23,53,0.000333,0.081001,6,1458.018075,81.001004,243.003013,86.0391,2,0
0,0,7,7,10,12,22,28,23,51,0.000333,0.07581,5,1137.155063,63.175281,227.431013,76.238831,2,0
0,0,8,8,12,12,24,30,23,53,0.000333,0.081001,6,1458.018075,81.001004,243.003013,86.0391,2,0
0,0,7,7,10,12,22,28,23,51,0.000333,0.07581,5,1137.155063,63.175281,227.431013,76.238831,2,0
0,0,8,8,12,11,23,30,23,53,0.000333,0.079916,12,2876.985404,159.832522,239.748784,81.073298,2,0
0,0,8,8,12,11,23,30,22,52,0.000333,0.078408,12,2822.702661,156.816814,235.225222,81.073298,2,0
0,0,7,7,10,10,20,28,22,50,0.000333,0.072032,10,2160.964047,120.053558,216.096405,66.438562,2,0
0,0,7,7,12,11,23,33,26,59,0.000333,0.088963,12,3202.681865,177.92677,266.890155,81.073298,2,0
0,0,8,8,11,10,21,28,23,51,0.000333,0.074669,10,2240.081886,124.448994,224.008189,71.273029,1,0
0,0,8,8,9,11,20,31,27,58,0.000333,0.083557,8,2005.374636,111.409702,250.67183,66.583073,1,0
0,0,11,11,10,12,22,46,35,81,0.000333,0.120405,10,3612.139611,200.674423,361.213961,76.238831,1,0
0,0,9,9,10,17,27,33,33,66,0.000333,0.104608,5,1569.112876,87.172938,313.822575,102.706149,1,0
0,0,8,8,9,16,25,31,35,66,0.000333,0.102165,8,2451.956068,136.219782,306.494509,92.529325,1,0
0,0,8,8,10,14,24,37,31,68,0.000333,0.103926,10,3117.7745,173.209694,311.77745,86.52225,1,0
0,0,10,10,10,18,28,32,39,71,0.000333,0.113774,10,3413.221995,189.623444,341.322199,108.277931,1,0
0,0,8,8,9,16,25,31,35,66,0.000333,0.102165,8,2451.956068,136.219782,306.494509,92.529325,1,0
0,0,10,10,9,17,26,37,49,86,0.000333,0.134746,8,3233.902526,179.661251,404.237816,98.016193,1,0
0,0,12,12,9,18,27,43,63,106,0.000333,0.168006,12,6048.216903,336.01205,504.018075,103.587975,1,0
0,0,14,14,9,19,28,49,77,126,0.000333,0.201909,16,9691.627523,538.423751,605.72672,109.239948,1,0
0,0,9,9,10,17,27,37,38,75,0.000333,0.118872,10,3566.165627,198.120313,356.616563,102.706149,1,0
0,0,10,10,10,18,28,46,42,88,0.000333,0.141016,10,4230.472331,235.026241,423.047233,108.277931,1,0
0,0,10,10,9,18,27,42,41,83,0.000333,0.131552,8,3157.245301,175.402517,394.655663,103.587975,1,0
0,0,11,11,9,19,28,46,45,91,0.000333,0.145823,8,3499.754383,194.430799,437.469298,109.239948,1,0
0,0,11,11,10,19,29,38,50,88,0.000333,0.142501,10,4275.023276,237.501293,427.502328,113.929904,1,0
0,0,10,10,9,18,27,31,45,76,0.000333,0.120457,8,2890.971601,160.609533,361.37145,103.587975,1,0
0,0,8,8,12,19,31,34,40,74,0.000333,0.122204,12,4399.326324,244.407018,366.610527,123.730173,1,0
0,0,8,8,11,19,30,33,40,73,0.000333,0.119401,10,3582.030135,199.001674,358.203013,118.764371,1,0
0,0,6,6,10,10,20,32,21,53,0.000333,0.076354,10,2290.62189,127.256772,229.062189,66.438562,1,0
0,0,7,7,11,10,21,35,22,57,0.000333,0.083454,10,2503.620931,139.090052,250.362093,71.273029,2,0
0,0,8,8,13,11,24,37,23,60,0.000333,0.091699,12,3301.173001,183.3985,275.09775,86.159464,2,0
0,0,8,8,12,11,23,36,22,58,0.000333,0.087456,12,3148.399121,174.911062,262.366593,81.073298,2,0
0,0,6,6,10,10,20,32,21,53,0.000333,0.076354,10,2290.62189,127.256772,229.062189,66.438562,1,0
0,0,8,8,12,11,23,36,22,58,0.000333,0.087456,12,3148.399121,174.911062,262.366593,81.073298,2,0
0,0,7,7,11,12,23,35,23,58,0.000333,0.087456,5,1311.832967,72.879609,262.366593,81.073298,2,0
0,0,7,7,11,11,22,35,22,57,0.000333,0.084729,10,2541.876023,141.215335,254.187602,76.107496,2,0
0,0,8,8,12,11,23,36,22,58,0.000333,0.087456,12,3148.399121,174.911062,262.366593,81.073298,2,0
0,0,8,8,12,11,23,36,22,58,0.000333,0.087456,12,3148.399121,174.911062,262.366593,81.073298,2,0
0,0,8,8,12,11,23,36,22,58,0.000333,0.087456,12,3148.399121,174.911062,262.366593,81.073298,2,0
0,0,7,7,11,11,22,35,22,57,0.000333,0.084729,10,2541.876023,141.215335,254.187602,76.107496,2,0
0,0,8,8,13,12,25,37,23,60,0.000333,0.092877,6,1671.788228,92.877124,278.631371,91.125266,2,0
0,0,8,8,13,12,25,37,23,60,0.000333,0.092877,6,1671.788228,92.877124,278.631371,91.125266,2,0
0,0,8,8,13,11,24,37,23,60,0.000333,0.091699,12,3301.173001,183.3985,275.09775,86.159464,2,0
0,0,7,7,11,10,21,35,22,57,0.000333,0.083454,10,2503.620931,139.090052,250.362093,71.273029,2,0
0,0,7,7,13,11,24,40,26,66,0.000333,0.100869,12,3631.290301,201.73835,302.607525,86.159464,2,0
0,0,8,8,12,10,22,35,23,58,0.000333,0.086216,12,3103.764407,172.431356,258.647034,76.238831,1,0
0,0,8,8,10,11,21,38,27,65,0.000333,0.095167,10,2855.006325,158.611462,285.500632,71.273029,1,0
0,0,11,11,11,12,23,53,35,88,0.000333,0.132691,10,3980.734521,221.151918,398.073452,81.073298,1,0
0,0,9,9,11,17,28,40,33,73,0.000333,0.116979,5,1754.684547,97.482475,350.936909,107.540616,1,0
0,0,8,8,10,16,26,38,35,73,0.000333,0.114377,10,3431.320994,190.628944,343.132099,97.219281,1,0
0,0,8,8,11,14,25,44,31,75,0.000333,0.116096,10,3482.892142,193.494008,348.289214,91.356717,1,0
0,0,10,10,11,18,29,39,39,78,0.000333,0.126308,10,3789.225176,210.51251,378.922518,113.112398,1,0
0,0,8,8,10,16,26,38,35,73,0.000333,0.114377,10,3431.320994,190.628944,343.132099,97.219281,1,0
0,0,10,10,10,17,27,44,49,93,0.000333,0.147402,10,4422.045377,245.669188,442.204538,102.706149,1,0
0,0,12,12,10,18,28,50,63,113,0.000333,0.181077,15,8148.466593,452.692588,543.231106,108.277931,1,0
0,0,14,14,10,19,29,55,77,132,0.000333,0.213751,20,12825.06983,712.503879,641.253491,113.929904,1,0
0,0,8,8,11,17,28,40,35,75,0.000333,0.120184,10,3605.516192,200.306455,360.551619,107.540616,1,0
0,0,10,10,11,18,29,53,42,95,0.000333,0.153836,10,4615.081945,256.393441,461.508195,113.112398,1,0
0,0,8,8,10,17,27,43,37,80,0.000333,0.126797,10,3803.910002,211.328333,380.391,102.706149,1,0
0,0,11,11,10,19,29,53,45,98,0.000333,0.158694,10,4760.821375,264.490076,476.082138,113.929904,1,0
0,0,11,11,11,19,30,45,50,95,0.000333,0.155385,10,4661.546066,258.974781,466.154607,118.764371,1,0
0,0,10,10,10,18,28,38,45,83,0.000333,0.133003,10,3990.104585,221.672477,399.010459,108.277931,1,0
0,0,8,8,13,19,32,41,40,81,0.000333,0.135,12,4860,270,405,128.816339,1,0
0,0,8,8,12,19,31,40,40,80,0.000333,0.132112,12,4756.028458,264.223803,396.335705,123.730173,1,0
0,0,6,6,10,12,22,35,23,58,0.000333,0.086216,5,1293.235169,71.846398,258.647034,76.238831,1,0
0,0,7,7,11,11,22,39,25,64,0.000333,0.095135,10,2854.036236,158.557569,285.403624,76.107496,2,0
0,0,7,7,11,12,23,39,26,65,0.000333,0.098011,10,2940.315271,163.350848,294.031527,81.073298,2,0
0,0,8,8,12,12,24,40,25,65,0.000333,0.099341,12,3576.270751,198.681708,298.022563,86.0391,2,0
0,0,8,8,12,12,24,40,25,65,0.000333,0.099341,12,3576.270751,198.681708,298.022563,86.0391,2,0
0,0,7,7,11,13,24,39,26,65,0.000333,0.099341,10,2980.225625,165.56809,298.022563,86.159464,2,0
0,0,8,8,13,13,26,41,26,67,0.000333,0.104976,12,3779.153533,209.952974,314.929461,96.211433,2,0
0,0,8,8,12,12,24,40,25,65,0.000333,0.099341,12,3576.270751,198.681708,298.022563,86.0391,2,0
0,0,7,7,11,12,23,39,25,64,0.000333,0.096503,10,2895.079652,160.837758,289.507965,81.073298,2,0
0,0,7,7,11,12,23,39,25,64,0.000333,0.096503,10,2895.079652,160.837758,289.507965,81.073298,2,0
0,0,7,7,11,12,23,39,25,64,0.000333,0.096503,10,2895.079652,160.837758,289.507965,81.073298,2,0
0,0,7,7,11,12,23,39,25,64,0.000333,0.096503,10,2895.079652,160.837758,289.507965,81.073298,2,0
0,0,7,7,11,13,24,39,26,65,0.000333,0.099341,10,2980.225625,165.56809,298.022563,86.159464,2,0
0,0,7,7,11,13,24,39,26,65,0.000333,0.099341,10,2980.225625,165.56809,298.022563,86.159464,2,0
0,0,8,8,13,12,25,41,25,66,0.000333,0.102165,12,3677.934102,204.329672,306.494509,91.125266,2,0
0,0,7,7,11,11,22,39,25,64,0.000333,0.095135,10,2854.036236,158.557569,285.403624,76.107496,2,0
0,0,7,7,13,12,25,44,29,73,0.000333,0.113001,12,4068.018022,226.001001,339.001502,91.125266,2,0
0,0,8,8,12,11,23,39,26,65,0.000333,0.098011,12,3528.378326,196.021018,294.031527,81.073298,1,0
0,0,8,8,10,12,22,42,30,72,0.000333,0.107026,10,3210.790765,178.377265,321.079077,76.238831,1,0
0,0,11,11,11,13,24,57,38,95,0.000333,0.14519,10,4355.714376,241.984132,435.571438,86.159464,1,0
0,0,9,9,11,18,29,44,36,80,0.000333,0.129546,10,3886.384796,215.910266,388.63848,113.112398,1,0
0,0,8,8,10,17,27,42,38,80,0.000333,0.126797,10,3803.910002,211.328333,380.391,102.706149,1,0
0,0,8,8,11,15,26,48,34,82,0.000333,0.128479,10,3854.360569,214.131143,385.436057,96.657107,1,0
0,0,10,10,11,19,30,43,42,85,0.000333,0.139029,10,4170.857006,231.714278,417.085701,118.764371,1,0
0,0,8,8,10,17,27,42,38,80,0.000333,0.126797,10,3803.910002,211.328333,380.391,102.706149,1,0
0,0,10,10,10,18,28,48,52,100,0.000333,0.160245,10,4807.354922,267.075273,480.735492,108.277931,1,0
0,0,12,12,10,19,29,54,66,120,0.000333,0.194319,15,8744.365791,485.7981,582.957719,113.929904,1,0
0,0,14,14,10,20,30,60,80,140,0.000333,0.228988,20,13739.29367,763.294093,686.964683,119.657843,1,0
0,0,9,9,11,18,29,48,41,89,0.000333,0.14412,10,4323.603086,240.200171,432.360309,113.112398,1,0
0,0,10,10,11,19,30,57,45,102,0.000333,0.166834,10,5005.028408,278.057134,500.502841,118.764371,1,0
0,0,8,8,10,18,28,47,40,87,0.000333,0.139413,10,4182.398782,232.355488,418.239878,108.277931,1,0
0,0,11,11,10,20,30,57,48,105,0.000333,0.171741,10,5152.235125,286.235285,515.223513,119.657843,1,0
0,0,11,11,11,20,31,49,53,102,0.000333,0.168443,10,5053.280237,280.737791,505.328024,124.49231,1,0
0,0,10,10,10,19,29,42,48,90,0.000333,0.145739,10,4372.182896,242.89905,437.21829,113.929904,1,0
0,0,8,8,13,20,33,45,43,88,0.000333,0.147969,12,5326.88019,295.937788,443.906683,134.544278,1,0
0,0,8,8,13,20,33,45,43,88,0.000333,0.147969,12,5326.88019,295.937788,443.906683,134.544278,1,0
0,0,6,6,9,9,18,21,18,39,0.000333,0.054209,8,1301.0166,72.2787,162.627075,57.05865,1,0
0,0,8,8,11,9,20,25,19,44,0.000333,0.063388,10,1901.648362,105.647131,190.164836,66.583073,2,0
0,0,8,8,12,10,22,26,20,46,0.000333,0.068378,12,2461.606253,136.755903,205.133854,76.238831,2,0
0,0,8,8,11,10,21,25,19,44,0.000333,0.064421,5,966.309833,53.68388,193.261967,71.273029,2,0
0,0,8,8,11,10,21,25,19,44,0.000333,0.064421,5,966.309833,53.68388,193.261967,71.273029,2,0
0,0,8,8,12,11,23,26,20,46,0.000333,0.069361,6,1248.5031,69.361283,208.08385,81.073298,2,0
0,0,8,8,12,11,23,26,20,46,0.000333,0.069361,6,1248.5031,69.361283,208.08385,81.073298,2,0
0,0,8,8,11,10,21,25,19,44,0.000333,0.064421,5,966.309833,53.68388,193.261967,71.273029,2,0
0,0,8,8,11,10,21,25,19,44,0.000333,0.064421,5,966.309833,53.68388,193.261967,71.273029,2,0
0,0,7,7,10,10,20,24,19,43,0.000333,0.061948,5,929.21454,51.62303,185.842908,66.438562,2,0
0,0,7,7,10,10,20,24,19,43,0.000333,0.061948,5,929.21454,51.62303,185.842908,66.438562,2,0
0,0,7,7,10,10,20,24,19,43,0.000333,0.061948,5,929.21454,51.62303,185.842908,66.438562,2,0
0,0,7,7,10,11,21,24,20,44,0.000333,0.064421,5,966.309833,53.68388,193.261967,71.273029,2,0
0,0,7,7,10,11,21,24,20,44,0.000333,0.064421,5,966.309833,53.68388,193.261967,71.273029,2,0
0,0,8,8,12,10,22,26,20,46,0.000333,0.068378,12,2461.606253,136.755903,205.133854,76.238831,2,0
0,0,7,7,10,9,19,24,19,43,0.000333,0.060887,10,1826.608831,101.478268,182.660883,61.748606,2,0
0,0,7,7,12,10,22,29,23,52,0.000333,0.077297,12,2782.68533,154.593629,231.890444,76.238831,2,0
0,0,8,8,11,9,20,24,20,44,0.000333,0.063388,10,1901.648362,105.647131,190.164836,66.583073,1,0
0,0,8,8,9,10,19,27,24,51,0.000333,0.072215,8,1733.154425,96.286357,216.644303,61.748606,1,0
0,0,11,11,10,11,21,42,32,74,0.000333,0.108344,10,3250.314893,180.57305,325.031489,71.273029,1,0
0,0,9,9,10,16,26,29,30,59,0.000333,0.092442,5,1386.629717,77.034984,277.325943,97.219281,1,0
0,0,8,8,9,15,24,27,32,59,0.000333,0.090171,8,2164.1023,120.227906,270.512788,87.132684,1,0
0,0,8,8,10,13,23,33,28,61,0.000333,0.091979,10,2759.372793,153.298489,275.937279,81.324997,1,0
0,0,10,10,10,17,27,28,36,64,0.000333,0.101438,10,3043.128001,169.062667,304.3128,102.706149,1,0
0,0,8,8,9,15,24,27,32,59,0.000333,0.090171,8,2164.1023,120.227906,270.512788,87.132684,1,0
0,0,8,8,9,15,24,27,32,59,0.000333,0.090171,8,2164.1023,120.227906,270.512788,87.132684,1,0
0,0,12,12,9,17,26,39,60,99,0.000333,0.155115,12,5584.122385,310.229021,465.343532,98.016193,1,0
0,0,14,14,9,18,27,45,74,119,0.000333,0.188611,16,9053.305804,502.961434,565.831613,103.587975,1,0
0,0,9,9,10,17,27,33,35,68,0.000333,0.107777,10,3233.323501,179.629083,323.33235,102.706149,1,0
0,0,10,10,10,18,28,43,39,82,0.000333,0.131401,10,3942.031036,219.001724,394.203104,108.277931,1,0
0,0,7,7,9,16,25,28,30,58,0.000333,0.089781,4,1077.374636,59.854146,269.343659,92.529325,1,0
0,0,11,11,9,18,27,42,42,84,0.000333,0.133137,8,3195.284401,177.5158,399.41055,103.587975,1,0
0,0,11,11,10,18,28,34,47,81,0.000333,0.129799,10,3893.957487,216.330971,389.395749,108.277931,1,0
0,0,10,10,9,17,26,27,42,69,0.000333,0.10811,8,2594.642724,144.146818,324.330341,98.016193,1,0
0,0,8,8,12,18,30,30,37,67,0.000333,0.109587,12,3945.140039,219.174447,328.76167,118.0782,1,0
0,0,8,8,11,18,29,29,37,66,0.000333,0.106876,10,3206.267457,178.12597,320.626746,113.112398,1,0
0,0,6,6,9,10,19,25,21,46,0.000333,0.065135,8,1563.237325,86.846518,195.404666,61.748606,1,0
0,0,7,7,10,10,20,28,22,50,0.000333,0.072032,10,2160.964047,120.053558,216.096405,66.438562,2,0
0,0,8,8,12,11,23,30,23,53,0.000333,0.079916,12,2876.985404,159.832522,239.748784,81.073298,2,0
0,0,8,8,11,11,22,29,22,51,0.000333,0.07581,10,2274.310126,126.350563,227.431013,76.107496,2,0
0,0,8,8,11,11,22,29,22,51,0.000333,0.07581,10,2274.310126,126.350563,227.431013,76.107496,2,0
0,0,7,7,10,12,22,28,23,51,0.000333,0.07581,5,1137.155063,63.175281,227.431013,76.238831,2,0
0,0,8,8,12,12,24,30,23,53,0.000333,0.081001,6,1458.018075,81.001004,243.003013,86.0391,2,0
0,0,8,8,11,11,22,29,22,51,0.000333,0.07581,10,2274.310126,126.350563,227.431013,76.107496,2,0
0,0,7,7,10,11,21,28,22,50,0.000333,0.073205,10,2196.158711,122.008817,219.615871,71.273029,2,0
0,0,7,7,10,11,21,28,22,50,0.000333,0.073205,10,2196.158711,122.008817,219.615871,71.273029,2,0
0,0,8,8,11,11,22,29,22,51,0.000333,0.07581,10,2274.310126,126.350563,227.431013,76.107496,2,0
0,0,7,7,10,11,21,28,22,50,0.000333,0.073205,10,2196.158711,122.008817,219.615871,71.273029,2,0
0,0,7,7,10,12,22,28,23,51,0.000333,0.07581,5,1137.155063,63.175281,227.431013,76.238831,2,0
0,0,8,8,12,12,24,30,23,53,0.000333,0.081001,6,1458.018075,81.001004,243.003013,86.0391,2,0
0,0,8,8,12,11,23,30,23,53,0.000333,0.079916,12,2876.985404,159.832522,239.748784,81.073298,2,0
0,0,7,7,10,10,20,28,22,50,0.000333,0.072032,10,2160.964047,120.053558,216.096405,66.438562,2,0
0,0,7,7,12,11,23,33,26,59,0.000333,0.088963,12,3202.681865,177.92677,266.890155,81.073298,2,0
0,0,8,8,11,10,21,28,23,51,0.000333,0.074669,10,2240.081886,124.448994,224.008189,71.273029,1,0
0,0,8,8,9,11,20,31,27,58,0.000333,0.083557,8,2005.374636,111.409702,250.67183,66.583073,1,0
0,0,11,11,10,12,22,46,35,81,0.000333,0.120405,10,3612.139611,200.674423,361.213961,76.238831,1,0
0,0,8,8,10,17,27,31,31,62,0.000333,0.098268,5,1474.015126,81.889729,294.803025,102.706149,1,0
0,0,8,8,9,16,25,31,35,66,0.000333,0.102165,8,2451.956068,136.219782,306.494509,92.529325,1,0
0,0,8,8,10,14,24,37,31,68,0.000333,0.103926,10,3117.7745,173.209694,311.77745,86.52225,1,0
0,0,10,10,10,18,28,32,39,71,0.000333,0.113774,10,3413.221995,189.623444,341.322199,108.277931,1,0
0,0,8,8,9,16,25,31,35,66,0.000333,0.102165,8,2451.956068,136.219782,306.494509,92.529325,1,0
0,0,10,10,9,17,26,37,49,86,0.000333,0.134746,8,3233.902526,179.661251,404.237816,98.016193,1,0
0,0,12,12,9,18,27,43,63,106,0.000333,0.168006,12,6048.216903,336.01205,504.018075,103.587975,1,0
0,0,14,14,9,19,28,49,77,126,0.000333,0.201909,16,9691.627523,538.423751,605.72672,109.239948,1,0
0,0,9,9,10,17,27,37,38,75,0.000333,0.118872,10,3566.165627,198.120313,356.616563,102.706149,1,0
0,0,10,10,10,18,28,47,42,89,0.000333,0.142618,10,4278.545881,237.696993,427.854588,108.277931,1,0
0,0,8,8,9,17,26,36,37,73,0.000333,0.114377,8,2745.056795,152.503155,343.132099,98.016193,1,0
0,0,11,11,9,19,28,46,45,91,0.000333,0.145823,8,3499.754383,194.430799,437.469298,109.239948,1,0
0,0,11,11,10,19,29,38,50,88,0.000333,0.142501,10,4275.023276,237.501293,427.502328,113.929904,1,0
0,0,10,10,9,18,27,31,45,76,0.000333,0.120457,8,2890.971601,160.609533,361.37145,103.587975,1,0
0,0,8,8,12,19,31,34,40,74,0.000333,0.122204,12,4399.326324,244.407018,366.610527,123.730173,1,0
0,0,8,8,11,19,30,33,40,73,0.000333,0.119401,10,3582.030135,199.001674,358.203013,118.764371,1,0
0,0,8,8,10,10,20,39,26,65,0.000333,0.093642,10,2809.253262,156.069626,280.925326,66.438562,1,0
0,0,10,10,12,10,22,43,27,70,0.000333,0.104053,12,3745.92256,208.106809,312.160213,76.238831,2,0
0,0,9,9,11,11,22,42,28,70,0.000333,0.104053,10,3121.602133,173.422341,312.160213,76.107496,2,0
0,0,10,10,12,11,23,43,27,70,0.000333,0.10555,12,3799.792043,211.099558,316.649337,81.073298,2,0
0,0,10,10,12,11,23,43,27,70,0.000333,0.10555,12,3799.792043,211.099558,316.649337,81.073298,2,0
0,0,10,10,13,12,25,44,28,72,0.000333,0.111453,12,4012.291748,222.905097,334.357646,91.125266,2,0
0,0,9,9,11,12,23,42,28,70,0.000333,0.10555,10,3166.493369,175.916298,316.649337,81.073298,2,0
0,0,10,10,12,11,23,43,27,70,0.000333,0.10555,12,3799.792043,211.099558,316.649337,81.073298,2,0
0,0,9,9,11,11,22,42,27,69,0.000333,0.102567,10,3077.007817,170.944879,307.700782,76.107496,2,0
0,0,9,9,11,11,22,42,27,69,0.000333,0.102567,10,3077.007817,170.944879,307.700782,76.107496,2,0
0,0,10,10,12,11,23,43,27,70,0.000333,0.10555,12,3799.792043,211.099558,316.649337,81.073298,2,0
0,0,9,9,11,11,22,42,27,69,0.000333,0.102567,10,3077.007817,170.944879,307.700782,76.107496,2,0
0,0,9,9,11,12,23,42,28,70,0.000333,0.10555,10,3166.493369,175.916298,316.649337,81.073298,2,0
0,0,10,10,13,12,25,44,28,72,0.000333,0.111453,12,4012.291748,222.905097,334.357646,91.125266,2,0
0,0,10,10,13,11,24,44,27,71,0.000333,0.108511,12,3906.388051,217.021558,325.532338,86.159464,2,0
0,0,9,9,11,10,21,42,27,69,0.000333,0.101023,10,3030.699022,168.372168,303.069902,71.273029,2,0
0,0,9,9,13,11,24,47,31,78,0.000333,0.119209,12,4291.524901,238.41805,357.627075,86.159464,2,0
0,0,10,10,12,10,22,42,28,70,0.000333,0.104053,12,3745.92256,208.106809,312.160213,76.238831,1,0
0,0,10,10,10,11,21,45,32,77,0.000333,0.112736,10,3382.084416,187.893579,338.208442,71.273029,1,0
0,0,13,13,11,12,23,60,40,100,0.000333,0.150785,15,6785.342934,376.963496,452.356196,81.073298,1,0
0,0,11,11,11,17,28,47,38,85,0.000333,0.136208,10,4086.251684,227.013982,408.625168,107.540616,1,0
0,0,10,10,10,16,26,45,40,85,0.000333,0.133179,10,3995.37376,221.965209,399.537376,97.219281,1,0
0,0,10,10,11,14,25,51,36,87,0.000333,0.134672,10,4040.154885,224.453049,404.015489,91.356717,1,0
0,0,12,12,11,18,29,46,44,90,0.000333,0.145739,10,4372.182896,242.89905,437.21829,113.112398,1,0
0,0,10,10,10,16,26,45,40,85,0.000333,0.133179,10,3995.37376,221.965209,399.537376,97.219281,1,0
0,0,12,12,10,17,27,51,54,105,0.000333,0.166421,15,7488.947816,416.052656,499.263188,102.706149,1,0
0,0,14,14,10,18,28,57,68,125,0.000333,0.200306,15,9013.790479,500.766138,600.919365,108.277931,1,0
0,0,16,16,10,19,29,63,82,145,0.000333,0.234802,20,14088.14489,782.674716,704.407244,113.929904,1,0
0,0,11,11,11,17,28,51,43,94,0.000333,0.15063,10,4518.913627,251.050757,451.891363,107.540616,1,0
0,0,12,12,11,18,29,60,47,107,0.000333,0.173268,10,5198.039665,288.779981,519.803966,113.112398,1,0
0,0,10,10,10,17,27,50,42,92,0.000333,0.145817,10,4374.496502,243.027583,437.44965,102.706149,1,0
0,0,13,13,10,19,29,60,50,110,0.000333,0.178126,10,5343.779095,296.876616,534.377909,113.929904,1,0
0,0,13,13,11,19,30,52,55,107,0.000333,0.175012,10,5250.372937,291.687385,525.037294,118.764371,1,0
0,0,12,12,10,18,28,45,50,95,0.000333,0.152233,10,4566.987176,253.72151,456.698718,108.277931,1,0
0,0,10,10,13,19,32,48,45,93,0.000333,0.155,12,5580,310,465,128.816339,1,0
0,0,10,10,12,19,31,47,45,92,0.000333,0.151929,12,5469.432727,303.857374,455.786061,123.730173,1,0
0,0,8,8,10,10,20,40,27,67,0.000333,0.096523,10,2895.691824,160.871768,289.569182,66.438562,1,0
0,0,9,9,11,10,21,43,28,71,0.000333,0.103952,10,3118.54537,173.252521,311.854537,71.273029,2,0
0,0,10,10,13,11,24,45,29,74,0.000333,0.113096,12,4071.446701,226.191483,339.287225,86.159464,2,0
0,0,9,9,11,11,22,43,28,71,0.000333,0.10554,10,3166.196449,175.899803,316.619645,76.107496,2,0
0,0,10,10,12,11,23,44,28,72,0.000333,0.108565,12,3908.35753,217.130974,325.696461,81.073298,2,0
0,0,10,10,13,12,25,45,29,74,0.000333,0.114548,12,4123.744297,229.096905,343.645358,91.125266,2,0
0,0,10,10,13,12,25,45,29,74,0.000333,0.114548,12,4123.744297,229.096905,343.645358,91.125266,2,0
0,0,9,9,11,11,22,43,28,71,0.000333,0.10554,10,3166.196449,175.899803,316.619645,76.107496,2,0
0,0,10,10,12,11,23,44,28,72,0.000333,0.108565,12,3908.35753,217.130974,325.696461,81.073298,2,0
0,0,9,9,11,11,22,43,28,71,0.000333,0.10554,10,3166.196449,175.899803,316.619645,76.107496,2,0
0,0,9,9,11,11,22,43,28,71,0.000333,0.10554,10,3166.196449,175.899803,316.619645,76.107496,2,0
0,0,9,9,11,11,22,43,28,71,0.000333,0.10554,10,3166.196449,175.899803,316.619645,76.107496,2,0
0,0,10,10,13,12,25,45,29,74,0.000333,0.114548,12,4123.744297,229.096905,343.645358,91.125266,2,0
0,0,10,10,13,12,25,45,29,74,0.000333,0.114548,12,4123.744297,229.096905,343.645358,91.125266,2,0
0,0,10,10,13,11,24,45,28,73,0.000333,0.111567,12,4016.427151,223.134842,334.702263,86.159464,2,0
0,0,9,9,11,10,21,43,28,71,0.000333,0.103952,10,3118.54537,173.252521,311.854537,71.273029,2,0
0,0,9,9,13,11,24,48,32,80,0.000333,0.122266,12,4401.564001,244.531333,366.797,86.159464,2,0
0,0,10,10,12,10,22,43,29,72,0.000333,0.107026,12,3852.948919,214.052718,321.079077,76.238831,1,0
0,0,10,10,10,11,21,46,33,79,0.000333,0.115664,15,5204.896146,289.160897,346.993076,71.273029,1,0
0,0,13,13,11,12,23,61,41,102,0.000333,0.153801,15,6921.049793,384.502766,461.40332,81.073298,1,0
0,0,11,11,11,17,28,48,39,87,0.000333,0.139413,10,4182.398782,232.355488,418.239878,107.540616,1,0
0,0,10,10,10,16,26,46,41,87,0.000333,0.136313,10,4089.382555,227.18792,408.938255,97.219281,1,0
0,0,11,11,11,14,25,57,40,97,0.000333,0.150151,10,4504.540504,250.25225,450.45405,91.356717,1,0
0,0,12,12,11,18,29,47,45,92,0.000333,0.148978,10,4469.342516,248.296806,446.934252,113.112398,1,0
0,0,10,10,10,16,26,46,41,87,0.000333,0.136313,10,4089.382555,227.18792,408.938255,97.219281,1,0
0,0,12,12,10,17,27,52,55,107,0.000333,0.169591,15,7631.594441,423.977469,508.772963,102.706149,1,0
0,0,14,14,10,18,28,58,69,127,0.000333,0.203511,15,9158.011127,508.778396,610.534075,108.277931,1,0
0,0,16,16,10,19,29,64,83,147,0.000333,0.238041,20,14282.46413,793.470229,714.123206,113.929904,1,0
0,0,11,11,11,17,28,52,44,96,0.000333,0.153835,10,4615.060725,256.392263,461.506073,107.540616,1,0
0,0,12,12,11,18,29,61,48,109,0.000333,0.176507,10,5295.199285,294.177738,529.519928,113.112398,1,0
0,0,10,10,10,17,27,51,43,94,0.000333,0.148986,10,4469.594252,248.310792,446.959425,102.706149,1,0
0,0,13,13,10,19,29,61,51,112,0.000333,0.181365,10,5440.938715,302.274373,544.093871,113.929904,1,0
0,0,13,13,11,19,30,53,56,109,0.000333,0.178284,10,5348.510749,297.139486,534.851075,118.764371,1,0
0,0,12,12,10,18,28,46,51,97,0.000333,0.155438,10,4663.134274,259.063015,466.313427,108.277931,1,0
0,0,10,10,13,19,32,49,46,95,0.000333,0.158333,12,5700,316.666667,475,128.816339,1,0
0,0,10,10,12,19,31,48,46,94,0.000333,0.155231,12,5588.333438,310.462969,465.694453,123.730173,1,0
0,0,8,8,11,10,21,41,26,67,0.000333,0.098095,10,2942.852673,163.491815,294.285267,71.273029,1,0
0,0,9,9,12,10,22,44,27,71,0.000333,0.10554,12,3799.435739,211.079763,316.619645,76.238831,2,0
0,0,10,10,14,11,25,46,28,74,0.000333,0.114548,14,4811.035013,267.279723,343.645358,91.356717,2,0
0,0,9,9,12,11,23,44,27,71,0.000333,0.107058,12,3854.074787,214.115266,321.172899,81.073298,2,0
0,0,10,10,13,11,24,45,27,72,0.000333,0.110039,12,3961.407601,220.0782,330.1173,86.159464,2,0
0,0,10,10,14,12,26,46,28,74,0.000333,0.115944,14,4869.655548,270.536419,347.832539,96.322519,2,0
0,0,10,10,14,12,26,46,28,74,0.000333,0.115944,14,4869.655548,270.536419,347.832539,96.322519,2,0
0,0,9,9,12,11,23,44,27,71,0.000333,0.107058,12,3854.074787,214.115266,321.172899,81.073298,2,0
0,0,10,10,13,11,24,45,27,72,0.000333,0.110039,12,3961.407601,220.0782,330.1173,86.159464,2,0
0,0,9,9,12,11,23,44,27,71,0.000333,0.107058,12,3854.074787,214.115266,321.172899,81.073298,2,0
0,0,10,10,13,11,24,45,27,72,0.000333,0.110039,12,3961.407601,220.0782,330.1173,86.159464,2,0
0,0,9,9,12,11,23,44,27,71,0.000333,0.107058,12,3854.074787,214.115266,321.172899,81.073298,2,0
0,0,9,9,12,12,24,44,28,72,0.000333,0.110039,12,3961.407601,220.0782,330.1173,86.0391,2,0
0,0,10,10,14,12,26,46,28,74,0.000333,0.115944,14,4869.655548,270.536419,347.832539,96.322519,2,0
0,0,10,10,14,11,25,46,27,73,0.000333,0.113001,14,4746.021026,263.667835,339.001502,91.356717,2,0
0,0,9,9,12,10,22,44,27,71,0.000333,0.10554,12,3799.435739,211.079763,316.619645,76.238831,2,0
0,0,9,9,14,11,25,49,31,80,0.000333,0.123836,14,5201.118933,288.951052,371.508495,91.356717,2,0
0,0,10,10,13,10,23,44,28,72,0.000333,0.108565,12,3908.35753,217.130974,325.696461,81.324997,1,0
0,0,10,10,11,11,22,47,32,79,0.000333,0.117432,10,3522.950979,195.719499,352.295098,76.107496,1,0
0,0,13,13,12,12,24,62,40,102,0.000333,0.155889,18,8417.991151,467.666175,467.666175,86.0391,1,0
0,0,11,11,12,17,29,49,38,87,0.000333,0.140881,12,5071.732159,281.762898,422.644347,112.506418,1,0
0,0,10,10,11,16,27,47,40,87,0.000333,0.137892,10,4136.752127,229.819563,413.675213,102.053748,1,0
0,0,10,10,12,14,26,53,36,89,0.000333,0.139446,12,5020.069619,278.892757,418.339135,96.322519,1,0
0,0,12,12,12,18,30,48,44,92,0.000333,0.150478,12,5417.207218,300.955957,451.433935,118.0782,1,0
0,0,10,10,11,16,27,47,40,87,0.000333,0.137892,10,4136.752127,229.819563,413.675213,102.053748,1,0
0,0,12,12,11,17,28,53,54,107,0.000333,0.171462,15,7715.80465,428.655814,514.386977,107.540616,1,0
0,0,14,14,11,18,29,59,68,127,0.000333,0.205655,15,9254.453796,514.136322,616.963586,113.112398,1,0
0,0,16,16,11,19,30,65,82,147,0.000333,0.240438,20,14426.25835,801.458797,721.312918,118.764371,1,0
0,0,11,11,12,17,29,53,43,96,0.000333,0.155455,12,5596.394106,310.910784,466.366176,112.506418,1,0
0,0,12,12,12,18,30,62,47,109,0.000333,0.178284,12,6418.212899,356.567383,534.851075,118.0782,1,0
0,0,10,10,11,17,28,52,42,94,0.000333,0.15063,10,4518.913627,251.050757,451.891363,107.540616,1,0
0,0,13,13,11,19,30,62,50,112,0.000333,0.183191,10,5495.717467,305.317637,549.571747,118.764371,1,0
0,0,12,12,12,19,31,52,53,105,0.000333,0.173397,12,6242.287351,346.793742,520.190613,123.730173,1,0
0,0,12,12,11,18,29,47,50,97,0.000333,0.157075,10,4712.241565,261.791198,471.224157,113.112398,1,0
0,0,10,10,14,19,33,50,45,95,0.000333,0.159739,14,6709.044179,372.724677,479.217441,134.013592,1,0
0,0,10,10,13,19,32,49,45,94,0.000333,0.156667,12,5640,313.333333,470,128.816339,1,0
0,0,8,8,9,9,18,30,23,53,0.000333,0.073669,8,1768.048201,98.2249,221.006025,57.05865,1,0
0,0,10,10,11,9,20,34,24,58,0.000333,0.083557,10,2506.718295,139.262128,250.67183,66.583073,2,0
0,0,9,9,10,10,20,33,25,58,0.000333,0.083557,10,2506.718295,139.262128,250.67183,66.438562,2,0
0,0,9,9,10,10,20,33,24,57,0.000333,0.082117,10,2463.499014,136.861056,246.349901,66.438562,2,0
0,0,9,9,10,10,20,33,24,57,0.000333,0.082117,10,2463.499014,136.861056,246.349901,66.438562,2,0
0,0,10,10,12,11,23,35,25,60,0.000333,0.090471,12,3256.964608,180.942478,271.413717,81.073298,2,0
0,0,10,10,12,11,23,35,25,60,0.000333,0.090471,12,3256.964608,180.942478,271.413717,81.073298,2,0
0,0,10,10,11,10,21,34,24,58,0.000333,0.084918,10,2547.544105,141.530228,254.754411,71.273029,2,0
0,0,9,9,10,10,20,33,24,57,0.000333,0.082117,10,2463.499014,136.861056,246.349901,66.438562,2,0
0,0,10,10,11,10,21,34,24,58,0.000333,0.084918,10,2547.544105,141.530228,254.754411,71.273029,2,0
0,0,10,10,11,10,21,34,24,58,0.000333,0.084918,10,2547.544105,141.530228,254.754411,71.273029,2,0
0,0,9,9,10,10,20,33,24,57,0.000333,0.082117,10,2463.499014,136.861056,246.349901,66.438562,2,0
0,0,9,9,10,11,21,33,25,58,0.000333,0.084918,10,2547.544105,141.530228,254.754411,71.273029,2,0
0,0,10,10,12,11,23,35,25,60,0.000333,0.090471,12,3256.964608,180.942478,271.413717,81.073298,2,0
0,0,10,10,12,10,22,35,24,59,0.000333,0.087702,12,3157.277586,175.40431,263.106465,76.238831,2,0
0,0,9,9,10,9,19,33,24,57,0.000333,0.080711,10,2421.318683,134.517705,242.131868,61.748606,2,0
0,0,9,9,12,10,22,38,28,66,0.000333,0.098107,12,3531.869842,196.214991,294.322487,76.238831,2,0
0,0,10,10,11,9,20,33,25,58,0.000333,0.083557,10,2506.718295,139.262128,250.67183,66.583073,1,0
0,0,10,10,9,10,19,36,29,65,0.000333,0.092038,8,2208.922307,122.717906,276.115288,61.748606,1,0
0,0,13,13,10,11,21,51,37,88,0.000333,0.128841,15,5797.858998,322.103278,386.523933,71.273029,1,0
0,0,10,10,10,16,26,36,33,69,0.000333,0.10811,10,3243.303406,180.183523,324.330341,97.219281,1,0
0,0,10,10,9,15,24,36,37,73,0.000333,0.111567,8,2677.6181,148.756561,334.702263,87.132684,1,0
0,0,10,10,10,13,23,42,33,75,0.000333,0.113089,10,3392.671467,188.481748,339.267147,81.324997,1,0
0,0,12,12,10,17,27,37,41,78,0.000333,0.123627,10,3708.812252,206.045125,370.881225,102.706149,1,0
0,0,10,10,9,15,24,36,37,73,0.000333,0.111567,8,2677.6181,148.756561,334.702263,87.132684,1,0
0,0,12,12,9,16,25,42,51,93,0.000333,0.14396,12,5182.543508,287.919084,431.878626,92.529325,1,0
0,0,14,14,9,17,26,48,65,113,0.000333,0.17705,12,6373.796258,354.099792,531.149688,98.016193,1,0
0,0,16,16,9,18,27,54,79,133,0.000333,0.2108,16,10118.40061,562.133367,632.400038,103.587975,1,0
0,0,11,11,10,16,26,42,40,82,0.000333,0.128479,10,3854.360569,214.131143,385.436057,97.219281,1,0
0,0,12,12,10,17,27,51,44,95,0.000333,0.150571,10,4517.143127,250.952396,451.714313,102.706149,1,0
0,0,7,7,9,14,23,32,32,64,0.000333,0.096503,8,2316.063722,128.670207,289.507965,81.832294,1,0
0,0,13,13,9,18,27,51,47,98,0.000333,0.155326,8,3727.831802,207.101767,465.978975,103.587975,1,0
0,0,13,13,10,18,28,43,52,95,0.000333,0.152233,10,4566.987176,253.72151,456.698718,108.277931,1,0
0,0,12,12,9,17,26,36,47,83,0.000333,0.130045,8,3121.091973,173.393998,390.136497,98.016193,1,0
0,0,10,10,12,18,30,39,42,81,0.000333,0.132486,12,4769.497659,264.972092,397.458138,118.0782,1,0
0,0,10,10,11,18,29,38,42,80,0.000333,0.129546,10,3886.384796,215.910266,388.63848,113.112398,1,0
0,0,8,8,9,9,18,31,24,55,0.000333,0.076449,8,1834.767001,101.9315,229.345875,57.05865,1,0
0,0,10,10,11,9,20,35,25,60,0.000333,0.086439,10,2593.156857,144.06427,259.315686,66.583073,2,0
0,0,9,9,10,10,20,34,26,60,0.000333,0.086439,10,2593.156857,144.06427,259.315686,66.438562,2,0
0,0,9,9,10,10,20,34,25,59,0.000333,0.084998,10,2549.937576,141.663199,254.993758,66.438562,2,0
0,0,9,9,10,10,20,34,25,59,0.000333,0.084998,10,2549.937576,141.663199,254.993758,66.438562,2,0
0,0,10,10,12,11,23,36,26,62,0.000333,0.093487,12,3365.530095,186.973894,280.460841,81.073298,2,0
0,0,10,10,12,11,23,36,26,62,0.000333,0.093487,12,3365.530095,186.973894,280.460841,81.073298,2,0
0,0,10,10,11,10,21,35,25,60,0.000333,0.087846,10,2635.390454,146.410581,263.539045,71.273029,2,0
0,0,9,9,10,10,20,34,25,59,0.000333,0.084998,10,2549.937576,141.663199,254.993758,66.438562,2,0
0,0,10,10,11,10,21,35,25,60,0.000333,0.087846,10,2635.390454,146.410581,263.539045,71.273029,2,0
0,0,9,9,10,10,20,34,25,59,0.000333,0.084998,10,2549.937576,141.663199,254.993758,66.438562,2,0
0,0,9,9,10,10,20,34,25,59,0.000333,0.084998,10,2549.937576,141.663199,254.993758,66.438562,2,0
0,0,10,10,12,11,23,36,26,62,0.000333,0.093487,12,3365.530095,186.973894,280.460841,81.073298,2,0
0,0,9,9,10,11,21,34,26,60,0.000333,0.087846,10,2635.390454,146.410581,263.539045,71.273029,2,0
0,0,10,10,12,10,22,36,26,62,0.000333,0.092162,12,3317.817124,184.323174,276.48476,76.238831,2,0
0,0,9,9,10,9,19,34,25,59,0.000333,0.083543,10,2506.277233,139.237624,250.627723,61.748606,2,0
0,0,9,9,12,10,22,39,29,68,0.000333,0.10108,12,3638.896201,202.1609,303.24135,76.238831,2,0
0,0,10,10,11,9,20,34,26,60,0.000333,0.086439,10,2593.156857,144.06427,259.315686,66.583073,1,0
0,0,10,10,9,10,19,37,30,67,0.000333,0.09487,12,3415.333721,189.740762,284.611143,61.748606,1,0
0,0,13,13,10,11,21,52,38,90,0.000333,0.13177,15,5929.628521,329.423807,395.308568,71.273029,1,0
0,0,11,11,10,16,26,39,36,75,0.000333,0.117511,10,3525.329789,195.851655,352.532979,97.219281,1,0
0,0,10,10,9,15,24,37,38,75,0.000333,0.114624,8,2750.9775,152.832083,343.872188,87.132684,1,0
0,0,10,10,10,13,23,43,34,77,0.000333,0.116105,10,3483.142706,193.507928,348.314271,81.324997,1,0
0,0,12,12,10,17,27,38,42,80,0.000333,0.126797,10,3803.910002,211.328333,380.391,102.706149,1,0
0,0,10,10,9,15,24,37,38,75,0.000333,0.114624,8,2750.9775,152.832083,343.872188,87.132684,1,0
0,0,12,12,9,16,25,43,52,95,0.000333,0.147055,12,5293.996056,294.110892,441.166338,92.529325,1,0
0,0,14,14,9,17,26,49,66,115,0.000333,0.180184,12,6486.606811,360.367045,540.550568,98.016193,1,0
0,0,16,16,9,18,27,55,80,135,0.000333,0.21397,16,10270.55701,570.5865,641.909813,103.587975,1,0
0,0,11,11,10,16,26,43,41,84,0.000333,0.131612,10,3948.369363,219.353854,394.836936,97.219281,1,0
0,0,12,12,10,17,27,52,45,97,0.000333,0.153741,10,4612.240877,256.235604,461.224088,102.706149,1,0
0,0,10,10,9,16,25,42,40,82,0.000333,0.126932,8,3046.36966,169.242759,380.796208,92.529325,1,0
0,0,13,13,9,18,27,52,48,100,0.000333,0.158496,8,3803.910002,211.328333,475.48875,103.587975,1,0
0,0,13,13,10,18,28,44,53,97,0.000333,0.155438,10,4663.134274,259.063015,466.313427,108.277931,1,0
0,0,12,12,9,17,26,37,48,85,0.000333,0.133179,8,3196.299008,177.572167,399.537376,98.016193,1,0
0,0,10,10,12,18,30,40,43,83,0.000333,0.135757,12,4887.263033,271.514613,407.271919,118.0782,1,0
0,0,10,10,11,18,29,39,43,82,0.000333,0.132785,10,3983.544416,221.308023,398.354442,113.112398,1,0
0,0,8,8,10,9,19,32,23,55,0.000333,0.077879,10,2336.360132,129.797785,233.636013,61.748606,1,0
0,0,9,9,11,9,20,35,24,59,0.000333,0.084998,10,2549.937576,141.663199,254.993758,66.583073,2,0
0,0,10,10,13,10,23,37,25,62,0.000333,0.093487,12,3365.530095,186.973894,280.460841,81.324997,2,0
0,0,9,9,11,10,21,35,24,59,0.000333,0.086382,10,2591.467279,143.970404,259.146728,71.273029,2,0
0,0,10,10,12,10,22,36,24,60,0.000333,0.089189,12,3210.790765,178.377265,267.565897,76.238831,2,0
0,0,10,10,13,11,24,37,25,62,0.000333,0.094756,12,3411.212101,189.511783,284.267675,86.159464,2,0
0,0,9,9,11,11,22,35,25,60,0.000333,0.089189,10,2675.658971,148.647721,267.565897,76.107496,2,0
0,0,10,10,12,10,22,36,24,60,0.000333,0.089189,12,3210.790765,178.377265,267.565897,76.238831,2,0
0,0,9,9,11,10,21,35,24,59,0.000333,0.086382,10,2591.467279,143.970404,259.146728,71.273029,2,0
0,0,10,10,12,10,22,36,24,60,0.000333,0.089189,12,3210.790765,178.377265,267.565897,76.238831,2,0
0,0,9,9,11,10,21,35,24,59,0.000333,0.086382,10,2591.467279,143.970404,259.146728,71.273029,2,0
0,0,9,9,11,10,21,35,24,59,0.000333,0.086382,10,2591.467279,143.970404,259.146728,71.273029,2,0
0,0,9,9,11,11,22,35,25,60,0.000333,0.089189,10,2675.658971,148.647721,267.565897,76.107496,2,0
0,0,10,10,13,11,24,37,25,62,0.000333,0.094756,12,3411.212101,189.511783,284.267675,86.159464,2,0
0,0,10,10,13,10,23,37,24,61,0.000333,0.091979,12,3311.247352,183.958186,275.937279,81.324997,2,0
0,0,9,9,11,9,20,35,24,59,0.000333,0.084998,10,2549.937576,141.663199,254.993758,66.583073,2,0
0,0,9,9,13,10,23,40,28,68,0.000333,0.102534,12,3691.226556,205.068142,307.602213,81.324997,2,0
0,0,10,10,12,9,21,35,25,60,0.000333,0.087846,12,3162.468544,175.692697,263.539045,71.548875,1,0
0,0,10,10,10,10,20,38,29,67,0.000333,0.096523,10,2895.691824,160.871768,289.569182,66.438562,1,0
0,0,13,13,11,11,22,53,37,90,0.000333,0.133783,15,6020.232685,334.457371,401.348846,76.107496,1,0
0,0,11,11,11,16,27,40,35,75,0.000333,0.118872,10,3566.165627,198.120313,356.616563,102.053748,1,0
0,0,10,10,10,15,25,38,37,75,0.000333,0.116096,10,3482.892142,193.494008,348.289214,91.82264,1,0
0,0,10,10,11,13,24,44,33,77,0.000333,0.117681,10,3530.421126,196.134507,353.042113,86.159464,1,0
0,0,12,12,11,17,28,39,41,80,0.000333,0.128196,10,3845.883938,213.660219,384.588394,107.540616,1,0
0,0,10,10,10,15,25,38,37,75,0.000333,0.116096,10,3482.892142,193.494008,348.289214,91.82264,1,0
0,0,12,12,10,16,26,44,51,95,0.000333,0.148847,15,6698.126598,372.118144,446.541773,97.219281,1,0
0,0,14,14,10,17,27,50,65,115,0.000333,0.182271,15,8202.180941,455.676719,546.812063,102.706149,1,0
0,0,16,16,10,18,28,56,79,135,0.000333,0.216331,20,12979.85829,721.103238,648.992914,108.277931,1,0
0,0,11,11,11,16,27,44,40,84,0.000333,0.133137,10,3994.105502,221.89475,399.41055,102.053748,1,0
0,0,12,12,11,17,28,53,44,97,0.000333,0.155438,10,4663.134274,259.063015,466.313427,107.540616,1,0
0,0,10,10,10,16,26,43,39,82,0.000333,0.128479,10,3854.360569,214.131143,385.436057,97.219281,1,0
0,0,13,13,10,18,28,53,47,100,0.000333,0.160245,10,4807.354922,267.075273,480.735492,108.277931,1,0
0,0,13,13,11,18,29,45,52,97,0.000333,0.157075,10,4712.241565,261.791198,471.224157,113.112398,1,0
0,0,12,12,10,17,27,38,47,85,0.000333,0.134722,10,4041.654377,224.536354,404.165438,102.706149,1,0
0,0,10,10,13,18,31,41,42,83,0.000333,0.137066,12,4934.379525,274.132196,411.198294,123.164366,1,0
0,0,10,10,12,18,30,40,42,82,0.000333,0.134122,12,4828.380346,268.243353,402.365029,118.0782,1,0
0,0,8,8,10,10,20,39,26,65,0.000333,0.093642,10,2809.253262,156.069626,280.925326,66.438562,1,0
0,0,10,10,12,10,22,43,27,70,0.000333,0.104053,12,3745.92256,208.106809,312.160213,76.238831,2,0
0,0,9,9,11,11,22,42,28,70,0.000333,0.104053,10,3121.602133,173.422341,312.160213,76.107496,2,0
0,0,10,10,12,11,23,43,27,70,0.000333,0.10555,12,3799.792043,211.099558,316.649337,81.073298,2,0
0,0,9,9,11,11,22,42,27,69,0.000333,0.102567,10,3077.007817,170.944879,307.700782,76.107496,2,0
0,0,10,10,13,12,25,44,28,72,0.000333,0.111453,12,4012.291748,222.905097,334.357646,91.125266,2,0
0,0,10,10,13,12,25,44,28,72,0.000333,0.111453,12,4012.291748,222.905097,334.357646,91.125266,2,0
0,0,9,9,11,11,22,42,27,69,0.000333,0.102567,10,3077.007817,170.944879,307.700782,76.107496,2,0
0,0,10,10,12,11,23,43,27,70,0.000333,0.10555,12,3799.792043,211.099558,316.649337,81.073298,2,0
0,0,9,9,11,11,22,42,27,69,0.000333,0.102567,10,3077.007817,170.944879,307.700782,76.107496,2,0
0,0,10,10,12,11,23,43,27,70,0.000333,0.10555,12,3799.792043,211.099558,316.649337,81.073298,2,0
0,0,9,9,11,11,22,42,27,69,0.000333,0.102567,10,3077.007817,170.944879,307.700782,76.107496,2,0
0,0,10,10,13,12,25,44,28,72,0.000333,0.111453,12,4012.291748,222.905097,334.357646,91.125266,2,0
0,0,9,9,11,12,23,42,28,70,0.000333,0.10555,10,3166.493369,175.916298,316.649337,81.073298,2,0
0,0,10,10,13,11,24,44,27,71,0.000333,0.108511,12,3906.388051,217.021558,325.532338,86.159464,2,0
0,0,9,9,11,10,21,42,27,69,0.000333,0.101023,10,3030.699022,168.372168,303.069902,71.273029,2,0
0,0,9,9,13,11,24,47,31,78,0.000333,0.119209,12,4291.524901,238.41805,357.627075,86.159464,2,0
0,0,10,10,12,10,22,42,28,70,0.000333,0.104053,12,3745.92256,208.106809,312.160213,76.238831,1,0
0,0,10,10,10,11,21,45,32,77,0.000333,0.112736,10,3382.084416,187.893579,338.208442,71.273029,1,0
0,0,13,13,11,12,23,60,40,100,0.000333,0.150785,15,6785.342934,376.963496,452.356196,81.073298,1,0
0,0,11,11,11,17,28,47,38,85,0.000333,0.136208,10,4086.251684,227.013982,408.625168,107.540616,1,0
0,0,10,10,10,16,26,45,40,85,0.000333,0.133179,10,3995.37376,221.965209,399.537376,97.219281,1,0
0,0,10,10,11,14,25,51,36,87,0.000333,0.134672,10,4040.154885,224.453049,404.015489,91.356717,1,0
0,0,12,12,11,18,29,46,44,90,0.000333,0.145739,10,4372.182896,242.89905,437.21829,113.112398,1,0
0,0,10,10,10,16,26,45,40,85,0.000333,0.133179,10,3995.37376,221.965209,399.537376,97.219281,1,0
0,0,12,12,10,17,27,51,54,105,0.000333,0.166421,15,7488.947816,416.052656,499.263188,102.706149,1,0
0,0,14,14,10,18,28,57,68,125,0.000333,0.200306,15,9013.790479,500.766138,600.919365,108.277931,1,0
0,0,16,16,10,19,29,63,82,145,0.000333,0.234802,20,14088.14489,782.674716,704.407244,113.929904,1,0
0,0,11,11,11,17,28,51,43,94,0.000333,0.15063,10,4518.913627,251.050757,451.891363,107.540616,1,0
0,0,12,12,11,18,29,60,47,107,0.000333,0.173268,10,5198.039665,288.779981,519.803966,113.112398,1,0
0,0,10,10,10,17,27,50,42,92,0.000333,0.145817,10,4374.496502,243.027583,437.44965,102.706149,1,0
0,0,13,13,10,19,29,60,50,110,0.000333,0.178126,10,5343.779095,296.876616,534.377909,113.929904,1,0
0,0,13,13,11,19,30,52,55,107,0.000333,0.175012,10,5250.372937,291.687385,525.037294,118.764371,1,0
0,0,12,12,10,18,28,45,50,95,0.000333,0.152233,10,4566.987176,253.72151,456.698718,108.277931,1,0
0,0,10,10,13,19,32,48,45,93,0.000333,0.155,12,5580,310,465,128.816339,1,0
0,0,10,10,12,19,31,47,45,92,0.000333,0.151929,12,5469.432727,303.857374,455.786061,123.730173,1,0
0,0,8,8,10,10,20,40,27,67,0.000333,0.096523,10,2895.691824,160.871768,289.569182,66.438562,1,0
0,0,10,10,12,10,22,44,28,72,0.000333,0.107026,12,3852.948919,214.052718,321.079077,76.238831,2,0
0,0,9,9,11,11,22,43,29,72,0.000333,0.107026,10,3210.790765,178.377265,321.079077,76.107496,2,0
0,0,9,9,11,11,22,43,28,71,0.000333,0.10554,10,3166.196449,175.899803,316.619645,76.107496,2,0
0,0,10,10,12,11,23,44,28,72,0.000333,0.108565,12,3908.35753,217.130974,325.696461,81.073298,2,0
0,0,10,10,13,12,25,45,29,74,0.000333,0.114548,12,4123.744297,229.096905,343.645358,91.125266,2,0
0,0,9,9,11,12,23,43,29,72,0.000333,0.108565,10,3256.964608,180.942478,325.696461,81.073298,2,0
0,0,10,10,12,11,23,44,28,72,0.000333,0.108565,12,3908.35753,217.130974,325.696461,81.073298,2,0
0,0,10,10,12,11,23,44,28,72,0.000333,0.108565,12,3908.35753,217.130974,325.696461,81.073298,2,0
0,0,9,9,11,11,22,43,28,71,0.000333,0.10554,10,3166.196449,175.899803,316.619645,76.107496,2,0
0,0,10,10,12,11,23,44,28,72,0.000333,0.108565,12,3908.35753,217.130974,325.696461,81.073298,2,0
0,0,9,9,11,11,22,43,28,71,0.000333,0.10554,10,3166.196449,175.899803,316.619645,76.107496,2,0
0,0,10,10,13,12,25,45,29,74,0.000333,0.114548,12,4123.744297,229.096905,343.645358,91.125266,2,0
0,0,9,9,11,12,23,43,29,72,0.000333,0.108565,10,3256.964608,180.942478,325.696461,81.073298,2,0
0,0,10,10,13,11,24,45,28,73,0.000333,0.111567,12,4016.427151,223.134842,334.702263,86.159464,2,0
0,0,9,9,11,10,21,43,28,71,0.000333,0.103952,10,3118.54537,173.252521,311.854537,71.273029,2,0
0,0,6,6,10,9,19,31,20,51,0.000333,0.072215,10,2166.443032,120.357946,216.644303,61.748606,1,0
0,0,6,6,10,10,20,31,20,51,0.000333,0.073473,10,2204.183328,122.454629,220.418333,66.438562,1,0
0,0,6,6,10,9,19,31,20,51,0.000333,0.072215,10,2166.443032,120.357946,216.644303,61.748606,1,0
0,0,8,8,10,10,20,37,26,63,0.000333,0.09076,10,2722.8147,151.267483,272.28147,66.438562,1,0
0,0,6,6,11,10,21,34,22,56,0.000333,0.08199,10,2459.697757,136.649875,245.969776,71.273029,1,0
0,0,7,7,11,15,26,32,27,59,0.000333,0.092442,5,1386.629717,77.034984,277.325943,96.657107,1,0
0,0,9,9,10,15,25,43,39,82,0.000333,0.126932,10,3807.962076,211.553449,380.796208,91.82264,1,0
0,0,9,9,11,13,24,46,32,78,0.000333,0.119209,10,3576.270751,198.681708,357.627075,86.159464,1,0
0,0,9,9,10,16,26,37,35,72,0.000333,0.112811,10,3384.316597,188.017589,338.43166,97.219281,1,0
0,0,9,9,10,15,25,43,39,82,0.000333,0.126932,10,3807.962076,211.553449,380.796208,91.82264,1,0
0,0,8,8,10,15,25,36,40,76,0.000333,0.117644,10,3529.330704,196.073928,352.93307,91.82264,1,0
0,0,8,8,10,15,25,36,40,76,0.000333,0.117644,10,3529.330704,196.073928,352.93307,91.82264,1,0
0,0,8,8,10,15,25,36,40,76,0.000333,0.117644,10,3529.330704,196.073928,352.93307,91.82264,1,0
0,0,10,10,11,16,27,49,42,91,0.000333,0.144232,10,4326.947627,240.385979,432.694763,102.053748,1,0
0,0,11,11,11,17,28,58,46,104,0.000333,0.166655,10,4999.649119,277.758284,499.964912,107.540616,1,0
0,0,6,6,10,14,24,30,26,56,0.000333,0.085586,5,1283.7895,71.321639,256.7579,86.52225,1,0
0,0,11,11,10,17,27,54,46,100,0.000333,0.158496,10,4754.887502,264.160417,475.48875,102.706149,1,0
0,0,12,12,11,18,29,50,54,104,0.000333,0.16841,15,7578.450352,421.02502,505.230023,113.112398,1,0
0,0,9,9,10,16,26,37,38,75,0.000333,0.117511,10,3525.329789,195.851655,352.532979,97.219281,1,0
0,0,6,6,11,9,20,32,19,51,0.000333,0.073473,10,2204.183328,122.454629,220.418333,66.583073,1,0
0,0,7,7,11,9,20,34,21,55,0.000333,0.079235,10,2377.060452,132.058914,237.706045,66.583073,1,0
0,0,6,6,11,9,20,32,19,51,0.000333,0.073473,10,2204.183328,122.454629,220.418333,66.583073,1,0
0,0,6,6,11,9,20,32,19,51,0.000333,0.073473,10,2204.183328,122.454629,220.418333,66.583073,1,0
0,0,6,6,11,9,20,32,19,51,0.000333,0.073473,10,2204.183328,122.454629,220.418333,66.583073,1,0
0,0,6,6,11,9,20,32,19,51,0.000333,0.073473,10,2204.183328,122.454629,220.418333,66.583073,1,0
0,0,6,6,11,9,20,32,19,51,0.000333,0.073473,10,2204.183328,122.454629,220.418333,66.583073,1,0
0,0,6,6,11,9,20,32,19,51,0.000333,0.073473,10,2204.183328,122.454629,220.418333,66.583073,1,0
0,0,6,6,11,9,20,32,19,51,0.000333,0.073473,10,2204.183328,122.454629,220.418333,66.583073,1,0
0,0,6,6,11,9,20,32,19,51,0.000333,0.073473,10,2204.183328,122.454629,220.418333,66.583073,1,0
0,0,6,6,11,9,20,32,19,51,0.000333,0.073473,10,2204.183328,122.454629,220.418333,66.583073,1,0
0,0,6,6,11,9,20,32,19,51,0.000333,0.073473,10,2204.183328,122.454629,220.418333,66.583073,1,0
0,0,4,4,10,7,17,18,11,29,0.000333,0.039512,5,592.682112,32.926784,118.536422,52.870765,1,0
0,0,6,6,11,9,20,32,19,51,0.000333,0.073473,10,2204.183328,122.454629,220.418333,66.583073,1,0
0,0,6,6,11,9,20,32,19,51,0.000333,0.073473,10,2204.183328,122.454629,220.418333,66.583073,1,0
0,0,6,6,11,9,20,32,19,51,0.000333,0.073473,10,2204.183328,122.454629,220.418333,66.583073,1,0
0,0,6,6,11,9,20,32,19,51,0.000333,0.073473,10,2204.183328,122.454629,220.418333,66.583073,1,0
0,0,8,8,11,10,21,38,25,63,0.000333,0.092239,10,2767.159976,153.73111,276.715998,71.273029,1,0
0,0,6,6,12,9,21,35,21,56,0.000333,0.08199,12,2951.637308,163.97985,245.969776,71.548875,1,0
0,0,7,7,12,15,27,35,26,61,0.000333,0.096683,6,1740.288826,96.682713,290.048138,101.622909,1,0
0,0,10,10,11,15,26,49,39,88,0.000333,0.13788,10,4136.386952,229.799275,413.638695,96.657107,1,0
0,0,9,9,12,13,25,47,29,76,0.000333,0.117644,12,4235.196845,235.288714,352.93307,91.125266,1,0
0,0,8,8,10,14,24,28,34,62,0.000333,0.094756,10,2842.67675,157.926486,284.267675,86.52225,1,0
0,0,9,9,11,15,26,45,37,82,0.000333,0.128479,10,3854.360569,214.131143,385.436057,96.657107,1,0
0,0,9,9,11,16,27,41,41,82,0.000333,0.129967,10,3899.007752,216.611542,389.900775,102.053748,1,0
0,0,9,9,11,16,27,41,41,82,0.000333,0.129967,10,3899.007752,216.611542,389.900775,102.053748,1,0
0,0,9,9,11,16,27,41,41,82,0.000333,0.129967,10,3899.007752,216.611542,389.900775,102.053748,1,0
0,0,10,10,12,16,28,51,40,91,0.000333,0.145823,12,5249.631575,291.646199,437.469298,107.01955,1,0
0,0,11,11,12,17,29,60,44,104,0.000333,0.16841,12,6062.760282,336.820016,505.230023,112.506418,1,0
0,0,9,9,11,17,28,46,34,80,0.000333,0.128196,10,3845.883938,213.660219,384.588394,107.540616,1,0
0,0,14,14,11,18,29,67,56,123,0.000333,0.199177,15,8962.974936,497.943052,597.531662,113.112398,1,0
0,0,12,12,12,18,30,52,52,104,0.000333,0.170106,12,6123.799463,340.211081,510.316622,118.0782,1,0
0,0,12,12,11,17,28,52,47,99,0.000333,0.158643,10,4759.281373,264.404521,475.928137,107.540616,1,0
0,0,7,7,13,16,29,37,28,65,0.000333,0.105256,6,1894.612588,105.256255,315.768765,112.105716,1,0
0,0,9,9,14,18,32,44,39,83,0.000333,0.138333,14,5810,322.777778,415,128.361619,1,0
0,0,7,7,10,9,19,34,21,55,0.000333,0.077879,10,2336.360132,129.797785,233.636013,61.748606,1,0
0,0,8,8,10,9,19,36,23,59,0.000333,0.083543,10,2506.277233,139.237624,250.627723,61.748606,1,0
0,0,7,7,11,10,21,33,21,54,0.000333,0.079062,10,2371.851408,131.769523,237.185141,71.273029,2,0
0,0,8,8,11,10,21,35,22,57,0.000333,0.083454,10,2503.620931,139.090052,250.362093,71.273029,2,0
0,0,9,9,11,10,21,39,24,63,0.000333,0.092239,10,2767.159976,153.73111,276.715998,71.273029,2,0
0,0,7,7,11,11,22,33,21,54,0.000333,0.08027,5,1204.046537,66.891474,240.809307,76.107496,2,0
0,0,7,7,11,11,22,33,21,54,0.000333,0.08027,5,1204.046537,66.891474,240.809307,76.107496,2,0
0,0,7,7,11,10,21,33,20,53,0.000333,0.077598,10,2327.928234,129.329346,232.792823,71.273029,2,0
0,0,7,7,11,10,21,33,20,53,0.000333,0.077598,10,2327.928234,129.329346,232.792823,71.273029,2,0
0,0,7,7,11,10,21,33,20,53,0.000333,0.077598,10,2327.928234,129.329346,232.792823,71.273029,2,0
0,0,7,7,11,10,21,33,20,53,0.000333,0.077598,10,2327.928234,129.329346,232.792823,71.273029,2,0
0,0,7,7,11,10,21,33,20,53,0.000333,0.077598,10,2327.928234,129.329346,232.792823,71.273029,2,0
0,0,6,6,10,9,19,30,19,49,0.000333,0.069383,10,2081.484482,115.638027,208.148448,61.748606,1,0
0,0,6,6,10,9,19,30,19,49,0.000333,0.069383,10,2081.484482,115.638027,208.148448,61.748606,1,0
0,0,6,6,10,9,19,30,19,49,0.000333,0.069383,10,2081.484482,115.638027,208.148448,61.748606,1,0
0,0,6,6,10,9,19,30,19,49,0.000333,0.069383,10,2081.484482,115.638027,208.148448,61.748606,1,0
0,0,6,6,10,9,19,30,19,49,0.000333,0.069383,10,2081.484482,115.638027,208.148448,61.748606,1,0
0,0,6,6,10,9,19,30,19,49,0.000333,0.069383,10,2081.484482,115.638027,208.148448,61.748606,1,0
0,0,6,6,10,10,20,30,19,49,0.000333,0.070591,5,1058.872383,58.826244,211.774477,66.438562,1,0
0,0,8,8,10,10,20,36,25,61,0.000333,0.087879,10,2636.376138,146.465341,263.637614,66.438562,1,0
0,0,6,6,11,9,20,33,21,54,0.000333,0.077795,10,2333.841171,129.657843,233.384117,66.583073,1,0
0,0,6,6,11,14,25,29,24,53,0.000333,0.082041,5,1230.62189,68.367883,246.124378,91.356717,1,0
0,0,8,8,10,15,25,39,35,74,0.000333,0.114548,10,3436.45358,190.914088,343.645358,91.82264,1,0
0,0,9,9,11,13,24,45,31,76,0.000333,0.116152,10,3484.571501,193.587306,348.45715,86.159464,1,0
0,0,9,9,10,16,26,36,34,70,0.000333,0.109677,10,3290.307803,182.794878,329.03078,97.219281,1,0
0,0,8,8,10,15,25,36,33,69,0.000333,0.106809,10,3204.260771,178.014487,320.426077,91.82264,1,0
0,0,8,8,10,15,25,36,33,69,0.000333,0.106809,10,3204.260771,178.014487,320.426077,91.82264,1,0
0,0,8,8,10,15,25,36,33,69,0.000333,0.106809,10,3204.260771,178.014487,320.426077,91.82264,1,0
0,0,8,8,10,15,25,36,33,69,0.000333,0.106809,10,3204.260771,178.014487,320.426077,91.82264,1,0
0,0,10,10,11,16,27,47,40,87,0.000333,0.137892,10,4136.752127,229.819563,413.675213,102.053748,1,0
0,0,11,11,11,17,28,56,44,100,0.000333,0.160245,10,4807.354922,267.075273,480.735492,107.540616,1,0
0,0,9,9,9,15,24,35,34,69,0.000333,0.105454,8,2530.8993,140.605517,316.362413,87.132684,1,0
0,0,11,11,10,17,27,52,44,96,0.000333,0.152156,10,4564.692002,253.594,456.4692,102.706149,1,0
0,0,12,12,11,18,29,48,52,100,0.000333,0.161933,10,4857.980995,269.887833,485.7981,113.112398,1,0
0,0,9,9,10,16,26,36,37,73,0.000333,0.114377,10,3431.320994,190.628944,343.132099,97.219281,1,0
0,0,9,9,13,17,30,34,38,72,0.000333,0.117765,12,4239.553475,235.530749,353.296123,117.592585,1,0
0,0,9,9,12,17,29,33,38,71,0.000333,0.114972,12,4138.999808,229.944434,344.916651,112.506418,1,0
0,0,6,6,10,9,19,31,20,51,0.000333,0.072215,10,2166.443032,120.357946,216.644303,61.748606,1,0
0,0,7,7,10,9,19,33,22,55,0.000333,0.077879,10,2336.360132,129.797785,233.636013,61.748606,1,0
0,0,6,6,10,9,19,31,20,51,0.000333,0.072215,10,2166.443032,120.357946,216.644303,61.748606,1,0
0,0,6,6,10,9,19,31,20,51,0.000333,0.072215,10,2166.443032,120.357946,216.644303,61.748606,1,0
0,0,6,6,10,9,19,31,20,51,0.000333,0.072215,10,2166.443032,120.357946,216.644303,61.748606,1,0
0,0,6,6,10,9,19,31,20,51,0.000333,0.072215,10,2166.443032,120.357946,216.644303,61.748606,1,0
0,0,6,6,10,10,20,31,20,51,0.000333,0.073473,10,2204.183328,122.454629,220.418333,66.438562,1,0
0,0,6,6,10,9,19,31,20,51,0.000333,0.072215,10,2166.443032,120.357946,216.644303,61.748606,1,0
0,0,6,6,10,9,19,31,20,51,0.000333,0.072215,10,2166.443032,120.357946,216.644303,61.748606,1,0
0,0,6,6,10,9,19,31,20,51,0.000333,0.072215,10,2166.443032,120.357946,216.644303,61.748606,1,0
0,0,6,6,10,9,19,31,20,51,0.000333,0.072215,10,2166.443032,120.357946,216.644303,61.748606,1,0
0,0,6,6,10,9,19,31,20,51,0.000333,0.072215,10,2166.443032,120.357946,216.644303,61.748606,1,0
0,0,6,6,10,9,19,31,20,51,0.000333,0.072215,10,2166.443032,120.357946,216.644303,61.748606,1,0
0,0,6,6,10,9,19,31,20,51,0.000333,0.072215,10,2166.443032,120.357946,216.644303,61.748606,1,0
0,0,6,6,10,9,19,31,20,51,0.000333,0.072215,10,2166.443032,120.357946,216.644303,61.748606,1,0
0,0,6,6,10,9,19,31,20,51,0.000333,0.072215,10,2166.443032,120.357946,216.644303,61.748606,1,0
0,0,6,6,10,9,19,31,20,51,0.000333,0.072215,10,2166.443032,120.357946,216.644303,61.748606,1,0
0,0,6,6,10,9,19,31,20,51,0.000333,0.072215,10,2166.443032,120.357946,216.644303,61.748606,1,0
0,0,8,8,10,10,20,37,26,63,0.000333,0.09076,10,2722.8147,151.267483,272.28147,66.438562,1,0
0,0,6,6,11,9,20,34,22,56,0.000333,0.080676,10,2420.279733,134.459985,242.027973,66.583073,1,0
0,0,7,7,11,14,25,32,27,59,0.000333,0.091329,5,1369.937576,76.107643,273.987515,91.356717,1,0
0,0,11,11,9,14,23,41,44,85,0.000333,0.128168,12,4614.033195,256.335178,384.502766,81.832294,1,0
0,0,9,9,11,13,24,46,32,78,0.000333,0.119209,10,3576.270751,198.681708,357.627075,86.159464,1,0
0,0,8,8,10,16,26,35,33,68,0.000333,0.106543,10,3196.299008,177.572167,319.629901,97.219281,1,0
0,0,9,9,9,14,23,34,36,70,0.000333,0.10555,8,2533.194695,140.733039,316.649337,81.832294,1,0
0,0,7,7,10,14,24,33,32,65,0.000333,0.099341,10,2980.225625,165.56809,298.022563,86.52225,1,0
0,0,7,7,10,14,24,33,32,65,0.000333,0.099341,10,2980.225625,165.56809,298.022563,86.52225,1,0
0,0,7,7,10,14,24,33,32,65,0.000333,0.099341,10,2980.225625,165.56809,298.022563,86.52225,1,0
0,0,10,10,11,16,27,49,42,91,0.000333,0.144232,10,4326.947627,240.385979,432.694763,102.053748,1,0
0,0,11,11,11,17,28,58,46,104,0.000333,0.166655,10,4999.649119,277.758284,499.964912,107.540616,1,0
0,0,9,9,10,17,27,45,35,80,0.000333,0.126797,10,3803.910002,211.328333,380.391,102.706149,1,0
0,0,11,11,10,17,27,54,46,100,0.000333,0.158496,10,4754.887502,264.160417,475.48875,102.706149,1,0
0,0,12,12,11,18,29,50,54,104,0.000333,0.16841,15,7578.450352,421.02502,505.230023,113.112398,1,0
0,0,8,8,10,16,26,35,36,71,0.000333,0.111244,10,3337.3122,185.406233,333.73122,97.219281,1,0
0,0,9,9,13,19,32,36,40,76,0.000333,0.126667,12,4560,253.333333,380,128.816339,1,0
0,0,8,8,13,19,32,41,40,81,0.000333,0.135,12,4860,270,405,128.816339,1,0
0,0,6,6,11,9,20,32,19,51,0.000333,0.073473,10,2204.183328,122.454629,220.418333,66.583073,1,0
0,0,6,6,11,9,20,32,19,51,0.000333,0.073473,10,2204.183328,122.454629,220.418333,66.583073,1,0
0,0,6,6,11,9,20,32,19,51,0.000333,0.073473,10,2204.183328,122.454629,220.418333,66.583073,1,0
0,0,6,6,11,9,20,32,19,51,0.000333,0.073473,10,2204.183328,122.454629,220.418333,66.583073,1,0
0,0,6,6,11,9,20,32,19,51,0.000333,0.073473,10,2204.183328,122.454629,220.418333,66.583073,1,0
0,0,6,6,11,9,20,32,19,51,0.000333,0.073473,10,2204.183328,122.454629,220.418333,66.583073,1,0
0,0,6,6,11,9,20,32,19,51,0.000333,0.073473,10,2204.183328,122.454629,220.418333,66.583073,1,0
0,0,6,6,11,9,20,32,19,51,0.000333,0.073473,10,2204.183328,122.454629,220.418333,66.583073,1,0
0,0,6,6,11,9,20,32,19,51,0.000333,0.073473,10,2204.183328,122.454629,220.418333,66.583073,1,0
0,0,6,6,11,9,20,32,19,51,0.000333,0.073473,10,2204.183328,122.454629,220.418333,66.583073,1,0
0,0,6,6,11,9,20,32,19,51,0.000333,0.073473,10,2204.183328,122.454629,220.418333,66.583073,1,0
0,0,6,6,11,9,20,32,19,51,0.000333,0.073473,10,2204.183328,122.454629,220.418333,66.583073,1,0
0,0,6,6,11,9,20,32,19,51,0.000333,0.073473,10,2204.183328,122.454629,220.418333,66.583073,1,0
0,0,6,6,11,9,20,32,19,51,0.000333,0.073473,10,2204.183328,122.454629,220.418333,66.583073,1,0
0,0,6,6,11,9,20,32,19,51,0.000333,0.073473,10,2204.183328,122.454629,220.418333,66.583073,1,0
0,0,6,6,11,9,20,32,19,51,0.000333,0.073473,10,2204.183328,122.454629,220.418333,66.583073,1,0
0,0,6,6,11,9,20,32,19,51,0.000333,0.073473,10,2204.183328,122.454629,220.418333,66.583073,1,0
0,0,6,6,11,9,20,32,19,51,0.000333,0.073473,10,2204.183328,122.454629,220.418333,66.583073,1,0
0,0,8,8,11,10,21,38,25,63,0.000333,0.092239,10,2767.159976,153.73111,276.715998,71.273029,1,0
0,0,7,7,12,9,21,37,23,60,0.000333,0.087846,12,3162.468544,175.692697,263.539045,71.548875,1,0
0,0,7,7,12,14,26,33,26,59,0.000333,0.092442,6,1663.95566,92.441981,277.325943,96.322519,1,0
0,0,9,9,11,15,26,45,37,82,0.000333,0.128479,10,3854.360569,214.131143,385.436057,96.657107,1,0
0,0,9,9,12,13,25,47,31,78,0.000333,0.12074,12,4346.649394,241.480522,362.220783,91.125266,1,0
0,0,9,9,11,16,27,38,34,72,0.000333,0.114117,10,3423.519002,190.1955,342.3519,102.053748,1,0
0,0,8,8,10,13,23,32,32,64,0.000333,0.096503,10,2895.079652,160.837758,289.507965,81.324997,1,0
0,0,7,7,11,14,25,34,31,65,0.000333,0.100617,10,3018.506523,167.694807,301.850652,91.356717,1,0
0,0,8,8,11,15,26,38,33,71,0.000333,0.111244,10,3337.3122,185.406233,333.73122,96.657107,1,0
0,0,8,8,11,15,26,38,33,71,0.000333,0.111244,10,3337.3122,185.406233,333.73122,96.657107,1,0
0,0,10,10,12,16,28,51,40,91,0.000333,0.145823,12,5249.631575,291.646199,437.469298,107.01955,1,0
0,0,11,11,12,17,29,60,44,104,0.000333,0.16841,12,6062.760282,336.820016,505.230023,112.506418,1,0
0,0,9,9,10,15,25,37,34,71,0.000333,0.109905,10,3297.137895,183.174327,329.713789,91.82264,1,0
0,0,11,11,11,17,28,56,44,100,0.000333,0.160245,10,4807.354922,267.075273,480.735492,107.540616,1,0
0,0,12,12,12,18,30,52,52,104,0.000333,0.170106,12,6123.799463,340.211081,510.316622,118.0782,1,0
0,0,9,9,11,16,27,38,37,75,0.000333,0.118872,10,3566.165627,198.120313,356.616563,102.053748,1,0
0,0,5,5,10,10,20,34,20,54,0.000333,0.077795,10,2333.841171,129.657843,233.384117,66.438562,1,0
0,0,5,5,10,10,20,34,20,54,0.000333,0.077795,10,2333.841171,129.657843,233.384117,66.438562,1,0
0,0,5,5,10,10,20,34,20,54,0.000333,0.077795,10,2333.841171,129.657843,233.384117,66.438562,1,0
0,0,5,5,10,10,20,34,20,54,0.000333,0.077795,10,2333.841171,129.657843,233.384117,66.438562,1,0
0,0,5,5,10,10,20,34,20,54,0.000333,0.077795,10,2333.841171,129.657843,233.384117,66.438562,1,0
0,0,5,5,10,10,20,34,20,54,0.000333,0.077795,10,2333.841171,129.657843,233.384117,66.438562,1,0
0,0,5,5,10,10,20,34,20,54,0.000333,0.077795,10,2333.841171,129.657843,233.384117,66.438562,1,0
0,0,5,5,10,10,20,34,20,54,0.000333,0.077795,10,2333.841171,129.657843,233.384117,66.438562,1,0
0,0,5,5,10,10,20,34,20,54,0.000333,0.077795,10,2333.841171,129.657843,233.384117,66.438562,1,0
0,0,5,5,10,10,20,34,20,54,0.000333,0.077795,10,2333.841171,129.657843,233.384117,66.438562,1,0
0,0,5,5,10,10,20,34,20,54,0.000333,0.077795,10,2333.841171,129.657843,233.384117,66.438562,1,0
0,0,5,5,10,11,21,34,20,54,0.000333,0.079062,5,1185.925704,65.884761,237.185141,71.273029,1,0
0,0,5,5,10,10,20,34,20,54,0.000333,0.077795,10,2333.841171,129.657843,233.384117,66.438562,1,0
0,0,5,5,10,10,20,34,20,54,0.000333,0.077795,10,2333.841171,129.657843,233.384117,66.438562,1,0
0,0,5,5,10,10,20,34,20,54,0.000333,0.077795,10,2333.841171,129.657843,233.384117,66.438562,1,0
0,0,5,5,10,10,20,34,20,54,0.000333,0.077795,10,2333.841171,129.657843,233.384117,66.438562,1,0
0,0,5,5,10,10,20,34,20,54,0.000333,0.077795,10,2333.841171,129.657843,233.384117,66.438562,1,0
0,0,5,5,10,10,20,34,20,54,0.000333,0.077795,10,2333.841171,129.657843,233.384117,66.438562,1,0
0,0,8,8,12,13,25,45,34,79,0.000333,0.122288,12,4402.375668,244.576426,366.864639,91.125266,1,0
0,0,7,7,9,17,26,37,34,71,0.000333,0.111244,8,2669.84976,148.324987,333.73122,98.016193,1,0
0,0,7,7,8,14,22,39,40,79,0.000333,0.117432,8,2818.360783,156.575599,352.295098,77.302969,1,0
0,0,6,6,10,11,21,35,22,57,0.000333,0.083454,10,2503.620931,139.090052,250.362093,71.273029,1,0
0,0,7,7,11,11,22,43,26,69,0.000333,0.102567,10,3077.007817,170.944879,307.700782,76.107496,1,0
0,0,7,7,11,17,28,38,29,67,0.000333,0.107364,5,1610.463899,89.470217,322.09278,107.540616,1,0
0,0,7,7,10,16,26,40,34,74,0.000333,0.115944,10,3478.325391,193.2403,347.832539,97.219281,1,0
0,0,8,8,11,12,23,44,29,73,0.000333,0.110073,10,3302.200228,183.455568,330.220023,81.073298,1,0
0,0,7,7,11,14,25,45,29,74,0.000333,0.114548,10,3436.45358,190.914088,343.645358,91.356717,1,0
0,0,7,7,10,17,27,36,32,68,0.000333,0.107777,5,1616.661751,89.814542,323.33235,102.706149,1,0
0,0,7,7,10,16,26,40,34,74,0.000333,0.115944,10,3478.325391,193.2403,347.832539,97.219281,1,0
0,0,6,6,10,15,25,37,26,63,0.000333,0.097521,5,1462.8147,81.267483,292.56294,91.82264,1,0
0,0,7,7,10,16,26,40,34,74,0.000333,0.115944,10,3478.325391,193.2403,347.832539,97.219281,1,0
0,0,7,7,10,16,26,40,34,74,0.000333,0.115944,10,3478.325391,193.2403,347.832539,97.219281,1,0
0,0,7,7,11,15,26,40,32,72,0.000333,0.112811,10,3384.316597,188.017589,338.43166,96.657107,1,0
0,0,8,8,11,17,28,46,37,83,0.000333,0.133003,10,3990.104585,221.672477,399.010459,107.540616,1,0
0,0,9,9,11,18,29,55,41,96,0.000333,0.155455,10,4663.661755,259.09232,466.366176,113.112398,1,0
0,0,8,8,10,17,27,48,38,86,0.000333,0.136307,10,4089.203252,227.177958,408.920325,102.706149,1,0
0,0,10,10,10,19,29,55,44,99,0.000333,0.160313,10,4809.401185,267.188955,480.940119,113.929904,1,0
0,0,10,10,11,19,30,47,49,96,0.000333,0.15702,10,4710.614972,261.700832,471.061497,118.764371,1,0
0,0,8,8,10,17,27,40,38,78,0.000333,0.123627,10,3708.812252,206.045125,370.881225,102.706149,1,0
0,0,8,8,14,19,33,47,42,89,0.000333,0.14965,14,6285.315073,349.184171,448.951077,134.013592,1,0
0,0,8,8,13,19,32,46,42,88,0.000333,0.146667,12,5280,293.333333,440,128.816339,1,0
0,0,6,6,10,11,21,40,24,64,0.000333,0.093703,10,2811.083151,156.171286,281.108315,71.273029,1,0
0,0,6,6,10,11,21,40,24,64,0.000333,0.093703,10,2811.083151,156.171286,281.108315,71.273029,1,0
0,0,6,6,10,11,21,40,24,64,0.000333,0.093703,10,2811.083151,156.171286,281.108315,71.273029,1,0
0,0,6,6,10,11,21,40,24,64,0.000333,0.093703,10,2811.083151,156.171286,281.108315,71.273029,1,0
0,0,6,6,10,11,21,40,24,64,0.000333,0.093703,10,2811.083151,156.171286,281.108315,71.273029,1,0
0,0,6,6,10,11,21,40,24,64,0.000333,0.093703,10,2811.083151,156.171286,281.108315,71.273029,1,0
0,0,6,6,10,11,21,40,24,64,0.000333,0.093703,10,2811.083151,156.171286,281.108315,71.273029,1,0
0,0,6,6,10,11,21,40,24,64,0.000333,0.093703,10,2811.083151,156.171286,281.108315,71.273029,1,0
0,0,6,6,10,11,21,40,24,64,0.000333,0.093703,10,2811.083151,156.171286,281.108315,71.273029,1,0
0,0,6,6,10,11,21,40,24,64,0.000333,0.093703,10,2811.083151,156.171286,281.108315,71.273029,1,0
0,0,6,6,10,11,21,40,24,64,0.000333,0.093703,10,2811.083151,156.171286,281.108315,71.273029,1,0
0,0,6,6,10,11,21,40,24,64,0.000333,0.093703,10,2811.083151,156.171286,281.108315,71.273029,1,0
0,0,6,6,10,11,21,40,24,64,0.000333,0.093703,10,2811.083151,156.171286,281.108315,71.273029,1,0
0,0,6,6,10,11,21,40,24,64,0.000333,0.093703,10,2811.083151,156.171286,281.108315,71.273029,1,0
0,0,6,6,10,11,21,40,24,64,0.000333,0.093703,10,2811.083151,156.171286,281.108315,71.273029,1,0
0,0,6,6,10,11,21,40,24,64,0.000333,0.093703,10,2811.083151,156.171286,281.108315,71.273029,1,0
0,0,6,6,10,11,21,40,24,64,0.000333,0.093703,10,2811.083151,156.171286,281.108315,71.273029,1,0
0,0,6,6,10,11,21,40,24,64,0.000333,0.093703,10,2811.083151,156.171286,281.108315,71.273029,1,0
0,0,8,8,12,13,25,45,32,77,0.000333,0.119192,12,4290.923119,238.384618,357.576927,91.125266,1,0
0,0,6,6,9,17,26,35,32,67,0.000333,0.104976,4,1259.717844,69.984325,314.929461,98.016193,1,0
0,0,8,8,11,16,27,44,38,82,0.000333,0.129967,10,3899.007752,216.611542,389.900775,102.053748,1,0
0,0,8,8,10,12,22,46,30,76,0.000333,0.112972,10,3389.16803,188.287113,338.916803,76.238831,1,0
0,0,11,11,11,13,24,61,38,99,0.000333,0.151304,10,4539.112876,252.172938,453.911288,86.159464,1,0
0,0,9,9,11,18,29,48,36,84,0.000333,0.136023,10,4080.704036,226.70578,408.070404,113.112398,1,0
0,0,8,8,10,17,27,46,38,84,0.000333,0.133137,10,3994.105502,221.89475,399.41055,102.706149,1,0
0,0,10,10,11,14,25,54,35,89,0.000333,0.137768,10,4133.032009,229.612889,413.303201,91.356717,1,0
0,0,9,9,11,15,26,55,36,91,0.000333,0.14258,10,4277.400144,237.633341,427.740014,96.657107,1,0
0,0,9,9,10,18,28,46,39,85,0.000333,0.136208,10,4086.251684,227.013982,408.625168,108.277931,1,0
0,0,8,8,10,17,27,46,38,84,0.000333,0.133137,10,3994.105502,221.89475,399.41055,102.706149,1,0
0,0,8,8,10,18,28,46,38,84,0.000333,0.134606,10,4038.178135,224.34323,403.817813,108.277931,1,0
0,0,8,8,10,18,28,46,38,84,0.000333,0.134606,10,4038.178135,224.34323,403.817813,108.277931,1,0
0,0,8,8,10,18,28,46,38,84,0.000333,0.134606,10,4038.178135,224.34323,403.817813,108.277931,1,0
0,0,8,8,11,15,26,45,36,81,0.000333,0.126912,10,3807.356172,211.519787,380.735617,96.657107,1,0
0,0,9,9,11,18,29,52,41,93,0.000333,0.150597,10,4517.922325,250.995685,451.792233,113.112398,1,0
0,0,10,10,11,19,30,61,45,106,0.000333,0.173377,10,5201.304031,288.961335,520.130403,118.764371,1,0
0,0,9,9,10,18,28,54,42,96,0.000333,0.153835,10,4615.060725,256.392263,461.506073,108.277931,1,0
0,0,11,11,10,20,30,61,48,109,0.000333,0.178284,10,5348.510749,297.139486,534.851075,119.657843,1,0
0,0,11,11,11,20,31,53,53,106,0.000333,0.175048,10,5251.448089,291.747116,525.144809,124.49231,1,0
0,0,10,10,10,19,29,47,48,95,0.000333,0.153836,10,4615.081945,256.393441,461.508195,113.929904,1,0
0,0,9,9,14,20,34,53,46,99,0.000333,0.167886,14,7051.223498,391.734639,503.658821,139.741531,1,0
0,0,9,9,13,20,33,52,46,98,0.000333,0.164784,12,5932.207484,329.567082,494.350624,134.544278,1,0
0,0,6,6,10,11,21,36,23,59,0.000333,0.086382,10,2591.467279,143.970404,259.146728,71.273029,1,0
0,0,6,6,10,11,21,36,23,59,0.000333,0.086382,10,2591.467279,143.970404,259.146728,71.273029,1,0
0,0,6,6,10,11,21,36,23,59,0.000333,0.086382,10,2591.467279,143.970404,259.146728,71.273029,1,0
0,0,6,6,10,11,21,36,23,59,0.000333,0.086382,10,2591.467279,143.970404,259.146728,71.273029,1,0
0,0,6,6,10,11,21,36,23,59,0.000333,0.086382,10,2591.467279,143.970404,259.146728,71.273029,1,0
0,0,6,6,10,11,21,36,23,59,0.000333,0.086382,10,2591.467279,143.970404,259.146728,71.273029,1,0
0,0,6,6,10,11,21,36,23,59,0.000333,0.086382,10,2591.467279,143.970404,259.146728,71.273029,1,0
0,0,6,6,10,11,21,36,23,59,0.000333,0.086382,10,2591.467279,143.970404,259.146728,71.273029,1,0
0,0,6,6,10,11,21,36,23,59,0.000333,0.086382,10,2591.467279,143.970404,259.146728,71.273029,1,0
0,0,6,6,10,11,21,36,23,59,0.000333,0.086382,10,2591.467279,143.970404,259.146728,71.273029,1,0
0,0,6,6,10,11,21,36,23,59,0.000333,0.086382,10,2591.467279,143.970404,259.146728,71.273029,1,0
0,0,6,6,10,11,21,36,23,59,0.000333,0.086382,10,2591.467279,143.970404,259.146728,71.273029,1,0
0,0,6,6,10,11,21,36,23,59,0.000333,0.086382,10,2591.467279,143.970404,259.146728,71.273029,1,0
0,0,5,5,10,10,20,30,19,49,0.000333,0.070591,5,1058.872383,58.826244,211.774477,66.438562,1,0
0,0,6,6,10,11,21,36,23,59,0.000333,0.086382,10,2591.467279,143.970404,259.146728,71.273029,1,0
0,0,6,6,10,11,21,36,23,59,0.000333,0.086382,10,2591.467279,143.970404,259.146728,71.273029,1,0
0,0,6,6,10,11,21,36,23,59,0.000333,0.086382,10,2591.467279,143.970404,259.146728,71.273029,1,0
0,0,6,6,10,11,21,36,23,59,0.000333,0.086382,10,2591.467279,143.970404,259.146728,71.273029,1,0
0,0,11,11,12,16,28,53,44,97,0.000333,0.155438,12,5595.761129,310.875618,466.313427,107.01955,1,0
0,0,11,11,11,20,31,52,56,108,0.000333,0.178351,10,5350.532015,297.251779,535.053202,124.49231,1,0
0,0,8,8,10,12,22,42,29,71,0.000333,0.10554,10,3166.196449,175.899803,316.619645,76.238831,1,0
0,0,8,8,11,12,23,45,29,74,0.000333,0.111581,10,3347.435847,185.968658,334.743585,81.073298,1,0
0,0,9,9,11,18,29,44,35,79,0.000333,0.127927,5,1918.902493,106.605694,383.780499,113.112398,1,0
0,0,8,8,10,17,27,42,37,79,0.000333,0.125212,10,3756.361127,208.686729,375.636113,102.706149,1,0
0,0,8,8,11,13,24,45,32,77,0.000333,0.117681,10,3530.421126,196.134507,353.042113,86.159464,1,0
0,0,9,9,11,15,26,51,35,86,0.000333,0.134746,10,4042.378158,224.576564,404.237816,96.657107,1,0
0,0,10,10,11,19,30,44,41,85,0.000333,0.139029,10,4170.857006,231.714278,417.085701,118.764371,1,0
0,0,8,8,10,17,27,42,37,79,0.000333,0.125212,10,3756.361127,208.686729,375.636113,102.706149,1,0
0,0,8,8,10,18,28,42,37,79,0.000333,0.126594,10,3797.810388,210.989466,379.781039,108.277931,1,0
0,0,8,8,10,18,28,42,37,79,0.000333,0.126594,10,3797.810388,210.989466,379.781039,108.277931,1,0
0,0,8,8,10,18,28,42,37,79,0.000333,0.126594,10,3797.810388,210.989466,379.781039,108.277931,1,0
0,0,7,7,10,16,26,40,30,70,0.000333,0.109677,5,1645.153901,91.397439,329.03078,97.219281,1,0
0,0,8,8,11,18,29,44,37,81,0.000333,0.131165,10,3934.964606,218.609145,393.496461,113.112398,1,0
0,0,9,9,11,19,30,53,41,94,0.000333,0.153749,10,4612.47716,256.248731,461.247716,118.764371,1,0
0,0,9,9,10,18,28,50,41,91,0.000333,0.145823,10,4374.692979,243.038499,437.469298,108.277931,1,0
0,0,10,10,10,20,30,53,44,97,0.000333,0.158656,10,4759.683878,264.426882,475.968388,119.657843,1,0
0,0,11,11,11,20,31,49,52,101,0.000333,0.166791,10,5003.738273,277.98546,500.373827,124.49231,1,0
0,0,10,10,10,19,29,43,47,90,0.000333,0.145739,10,4372.182896,242.89905,437.21829,113.929904,1,0
0,0,9,9,14,20,34,49,45,94,0.000333,0.159407,14,6695.101099,371.950061,478.221507,139.741531,1,0
0,0,9,9,13,20,33,48,45,93,0.000333,0.156376,12,5629.543837,312.752435,469.128653,134.544278,1,0
0,0,6,6,10,11,21,36,23,59,0.000333,0.086382,10,2591.467279,143.970404,259.146728,71.273029,1,0
0,0,6,6,10,11,21,36,23,59,0.000333,0.086382,10,2591.467279,143.970404,259.146728,71.273029,1,0
0,0,6,6,10,11,21,36,23,59,0.000333,0.086382,10,2591.467279,143.970404,259.146728,71.273029,1,0
0,0,6,6,10,11,21,36,23,59,0.000333,0.086382,10,2591.467279,143.970404,259.146728,71.273029,1,0
0,0,6,6,10,11,21,36,23,59,0.000333,0.086382,10,2591.467279,143.970404,259.146728,71.273029,1,0
0,0,6,6,10,11,21,36,23,59,0.000333,0.086382,10,2591.467279,143.970404,259.146728,71.273029,1,0
0,0,6,6,10,11,21,36,23,59,0.000333,0.086382,10,2591.467279,143.970404,259.146728,71.273029,1,0
0,0,6,6,10,11,21,36,23,59,0.000333,0.086382,10,2591.467279,143.970404,259.146728,71.273029,1,0
0,0,6,6,10,11,21,36,23,59,0.000333,0.086382,10,2591.467279,143.970404,259.146728,71.273029,1,0
0,0,6,6,10,11,21,36,23,59,0.000333,0.086382,10,2591.467279,143.970404,259.146728,71.273029,1,0
0,0,6,6,10,11,21,36,23,59,0.000333,0.086382,10,2591.467279,143.970404,259.146728,71.273029,1,0
0,0,6,6,10,11,21,36,23,59,0.000333,0.086382,10,2591.467279,143.970404,259.146728,71.273029,1,0
0,0,6,6,10,11,21,36,23,59,0.000333,0.086382,10,2591.467279,143.970404,259.146728,71.273029,1,0
0,0,6,6,10,11,21,36,23,59,0.000333,0.086382,10,2591.467279,143.970404,259.146728,71.273029,1,0
0,0,6,6,10,11,21,36,23,59,0.000333,0.086382,10,2591.467279,143.970404,259.146728,71.273029,1,0
0,0,6,6,10,11,21,36,23,59,0.000333,0.086382,10,2591.467279,143.970404,259.146728,71.273029,1,0
0,0,6,6,10,11,21,36,23,59,0.000333,0.086382,10,2591.467279,143.970404,259.146728,71.273029,1,0
0,0,6,6,10,11,21,36,23,59,0.000333,0.086382,10,2591.467279,143.970404,259.146728,71.273029,1,0
0,0,9,9,12,15,27,43,35,78,0.000333,0.123627,12,4450.574702,247.25415,370.881225,101.622909,1,0
0,0,8,8,10,19,29,42,38,80,0.000333,0.129546,10,3886.384796,215.910266,388.63848,113.929904,1,0
0,0,8,8,10,12,22,42,29,71,0.000333,0.10554,10,3166.196449,175.899803,316.619645,76.238831,1,0
0,0,8,8,11,12,23,45,29,74,0.000333,0.111581,10,3347.435847,185.968658,334.743585,81.073298,1,0
0,0,9,9,11,18,29,44,35,79,0.000333,0.127927,5,1918.902493,106.605694,383.780499,113.112398,1,0
0,0,8,8,10,17,27,42,37,79,0.000333,0.125212,10,3756.361127,208.686729,375.636113,102.706149,1,0
0,0,8,8,11,13,24,42,28,70,0.000333,0.106982,10,3209.473751,178.304097,320.947375,86.159464,1,0
0,0,9,9,11,15,26,51,35,86,0.000333,0.134746,10,4042.378158,224.576564,404.237816,96.657107,1,0
0,0,10,10,11,19,30,44,41,85,0.000333,0.139029,10,4170.857006,231.714278,417.085701,118.764371,1,0
0,0,8,8,10,17,27,42,37,79,0.000333,0.125212,10,3756.361127,208.686729,375.636113,102.706149,1,0
0,0,8,8,10,18,28,42,37,79,0.000333,0.126594,10,3797.810388,210.989466,379.781039,108.277931,1,0
0,0,8,8,10,18,28,42,37,79,0.000333,0.126594,10,3797.810388,210.989466,379.781039,108.277931,1,0
0,0,8,8,10,18,28,42,37,79,0.000333,0.126594,10,3797.810388,210.989466,379.781039,108.277931,1,0
0,0,8,8,10,16,26,44,38,82,0.000333,0.128479,10,3854.360569,214.131143,385.436057,97.219281,1,0
0,0,8,8,11,18,29,44,37,81,0.000333,0.131165,10,3934.964606,218.609145,393.496461,113.112398,1,0
0,0,9,9,11,19,30,53,41,94,0.000333,0.153749,10,4612.47716,256.248731,461.247716,118.764371,1,0
0,0,9,9,10,18,28,50,41,91,0.000333,0.145823,10,4374.692979,243.038499,437.469298,108.277931,1,0
0,0,10,10,10,20,30,53,44,97,0.000333,0.158656,10,4759.683878,264.426882,475.968388,119.657843,1,0
0,0,10,10,11,20,31,45,49,94,0.000333,0.155231,10,4656.944532,258.719141,465.694453,124.49231,1,0
0,0,10,10,10,19,29,43,47,90,0.000333,0.145739,10,4372.182896,242.89905,437.21829,113.929904,1,0
0,0,9,9,12,22,34,44,43,87,0.000333,0.147536,6,2655.655603,147.536422,442.609267,141.127046,1,0
0,0,9,9,13,20,33,48,45,93,0.000333,0.156376,12,5629.543837,312.752435,469.128653,134.544278,1,0
0,0,6,6,11,11,22,38,23,61,0.000333,0.090675,10,2720.253287,151.125183,272.025329,76.107496,1,0
0,0,6,6,11,11,22,38,23,61,0.000333,0.090675,10,2720.253287,151.125183,272.025329,76.107496,1,0
0,0,6,6,11,11,22,38,23,61,0.000333,0.090675,10,2720.253287,151.125183,272.025329,76.107496,1,0
0,0,6,6,11,11,22,38,23,61,0.000333,0.090675,10,2720.253287,151.125183,272.025329,76.107496,1,0
0,0,6,6,11,11,22,38,23,61,0.000333,0.090675,10,2720.253287,151.125183,272.025329,76.107496,1,0
0,0,6,6,11,11,22,38,23,61,0.000333,0.090675,10,2720.253287,151.125183,272.025329,76.107496,1,0
0,0,6,6,11,11,22,38,23,61,0.000333,0.090675,10,2720.253287,151.125183,272.025329,76.107496,1,0
0,0,6,6,11,11,22,38,23,61,0.000333,0.090675,10,2720.253287,151.125183,272.025329,76.107496,1,0
0,0,6,6,11,11,22,38,23,61,0.000333,0.090675,10,2720.253287,151.125183,272.025329,76.107496,1,0
0,0,6,6,11,11,22,38,23,61,0.000333,0.090675,10,2720.253287,151.125183,272.025329,76.107496,1,0
0,0,6,6,11,11,22,38,23,61,0.000333,0.090675,10,2720.253287,151.125183,272.025329,76.107496,1,0
0,0,6,6,11,11,22,38,23,61,0.000333,0.090675,10,2720.253287,151.125183,272.025329,76.107496,1,0
0,0,6,6,11,11,22,38,23,61,0.000333,0.090675,10,2720.253287,151.125183,272.025329,76.107496,1,0
0,0,6,6,11,11,22,38,23,61,0.000333,0.090675,10,2720.253287,151.125183,272.025329,76.107496,1,0
0,0,6,6,11,11,22,38,23,61,0.000333,0.090675,10,2720.253287,151.125183,272.025329,76.107496,1,0
0,0,6,6,11,11,22,38,23,61,0.000333,0.090675,10,2720.253287,151.125183,272.025329,76.107496,1,0
0,0,6,6,11,11,22,38,23,61,0.000333,0.090675,10,2720.253287,151.125183,272.025329,76.107496,1,0
0,0,6,6,11,11,22,38,23,61,0.000333,0.090675,10,2720.253287,151.125183,272.025329,76.107496,1,0
0,0,11,11,13,16,29,55,44,99,0.000333,0.160313,12,5771.281422,320.626746,480.940119,112.105716,1,0
0,0,12,12,12,19,31,56,58,114,0.000333,0.188259,18,10166.01083,564.778379,564.778379,123.730173,1,0
0,0,8,8,11,12,23,44,29,73,0.000333,0.110073,10,3302.200228,183.455568,330.220023,81.073298,1,0
0,0,8,8,12,12,24,47,29,76,0.000333,0.116152,12,4181.485801,232.304767,348.45715,86.0391,1,0
0,0,9,9,12,18,30,46,35,81,0.000333,0.132486,6,2384.748829,132.486046,397.458138,118.0782,1,0
0,0,8,8,11,17,28,44,37,81,0.000333,0.129799,10,3893.957487,216.330971,389.395749,107.540616,1,0
0,0,10,10,13,13,26,53,37,90,0.000333,0.141013,12,5076.474896,282.026383,423.039575,96.211433,1,0
0,0,9,9,12,15,27,53,35,88,0.000333,0.139477,12,5021.161202,278.9534,418.4301,101.622909,1,0
0,0,10,10,12,19,31,45,41,86,0.000333,0.14202,12,5112.730592,284.040588,426.060883,123.730173,1,0
0,0,8,8,11,17,28,44,37,81,0.000333,0.129799,10,3893.957487,216.330971,389.395749,107.540616,1,0
0,0,8,8,11,18,29,44,37,81,0.000333,0.131165,10,3934.964606,218.609145,393.496461,113.112398,1,0
0,0,8,8,11,18,29,44,37,81,0.000333,0.131165,10,3934.964606,218.609145,393.496461,113.112398,1,0
0,0,8,8,11,18,29,44,37,81,0.000333,0.131165,10,3934.964606,218.609145,393.496461,113.112398,1,0
0,0,8,8,11,16,27,46,38,84,0.000333,0.133137,10,3994.105502,221.89475,399.41055,102.053748,1,0
0,0,9,9,12,18,30,50,40,90,0.000333,0.147207,12,5299.441843,294.413436,441.620154,118.0782,1,0
0,0,10,10,12,19,31,59,44,103,0.000333,0.170094,12,6123.38664,340.188147,510.28222,123.730173,1,0
0,0,9,9,11,18,29,52,41,93,0.000333,0.150597,10,4517.922325,250.995685,451.792233,113.112398,1,0
0,0,11,11,11,20,31,59,47,106,0.000333,0.175048,10,5251.448089,291.747116,525.144809,124.49231,1,0
0,0,11,11,12,20,32,51,52,103,0.000333,0.171667,12,6180,343.333333,515,129.458112,1,0
0,0,10,10,11,18,29,45,46,91,0.000333,0.147359,10,4420.762706,245.597928,442.076271,113.112398,1,0
0,0,9,9,15,20,35,51,45,96,0.000333,0.164137,14,6893.756375,382.986465,492.41117,145.041921,1,0
0,0,9,9,14,20,34,50,45,95,0.000333,0.161103,14,6766.325579,375.906977,483.30897,139.741531,1,0
0,0,6,6,10,10,20,31,21,52,0.000333,0.074913,10,2247.402609,124.855701,224.740261,66.438562,1,0
0,0,5,5,10,9,19,25,17,42,0.000333,0.059471,5,892.064778,49.559154,178.412956,61.748606,1,0
0,0,5,5,8,12,20,29,19,48,0.000333,0.069151,4,829.810194,46.100566,207.452549,67.01955,1,0
0,0,5,5,8,12,20,29,19,48,0.000333,0.069151,4,829.810194,46.100566,207.452549,67.01955,1,0
0,0,4,4,8,9,17,28,16,44,0.000333,0.059949,4,719.39346,39.966303,179.848365,52.529325,1,0
0,0,5,5,8,12,20,29,19,48,0.000333,0.069151,4,829.810194,46.100566,207.452549,67.01955,1,0
0,0,5,5,8,12,20,29,19,48,0.000333,0.069151,4,829.810194,46.100566,207.452549,67.01955,1,0
0,0,5,5,8,12,20,29,19,48,0.000333,0.069151,4,829.810194,46.100566,207.452549,67.01955,1,0
0,0,5,5,8,12,20,29,19,48,0.000333,0.069151,4,829.810194,46.100566,207.452549,67.01955,1,0
0,0,5,5,8,12,20,29,19,48,0.000333,0.069151,4,829.810194,46.100566,207.452549,67.01955,1,0
0,0,5,5,8,12,20,29,19,48,0.000333,0.069151,4,829.810194,46.100566,207.452549,67.01955,1,0
0,0,5,5,8,12,20,29,19,48,0.000333,0.069151,4,829.810194,46.100566,207.452549,67.01955,1,0
0,0,5,5,8,12,20,29,19,48,0.000333,0.069151,4,829.810194,46.100566,207.452549,67.01955,1,0
0,0,5,5,8,12,20,29,19,48,0.000333,0.069151,4,829.810194,46.100566,207.452549,67.01955,1,0
0,0,5,5,8,12,20,29,19,48,0.000333,0.069151,4,829.810194,46.100566,207.452549,67.01955,1,0
0,0,5,5,8,12,20,29,19,48,0.000333,0.069151,4,829.810194,46.100566,207.452549,67.01955,1,0
0,0,5,5,8,12,20,29,19,48,0.000333,0.069151,4,829.810194,46.100566,207.452549,67.01955,1,0
0,0,5,5,8,12,20,29,19,48,0.000333,0.069151,4,829.810194,46.100566,207.452549,67.01955,1,0
0,0,5,5,8,12,20,29,19,48,0.000333,0.069151,4,829.810194,46.100566,207.452549,67.01955,1,0
0,0,5,5,8,12,20,29,19,48,0.000333,0.069151,4,829.810194,46.100566,207.452549,67.01955,1,0
0,0,5,5,8,12,20,29,19,48,0.000333,0.069151,4,829.810194,46.100566,207.452549,67.01955,1,0
0,0,5,5,8,12,20,29,19,48,0.000333,0.069151,4,829.810194,46.100566,207.452549,67.01955,1,0
0,0,5,5,8,12,20,29,19,48,0.000333,0.069151,4,829.810194,46.100566,207.452549,67.01955,1,0
0,0,5,5,8,12,20,29,19,48,0.000333,0.069151,4,829.810194,46.100566,207.452549,67.01955,1,0
0,0,5,5,8,12,20,29,19,48,0.000333,0.069151,4,829.810194,46.100566,207.452549,67.01955,1,0
0,0,4,4,8,11,19,28,18,46,0.000333,0.065135,4,781.618662,43.423259,195.404666,62.053748,1,0
0,0,5,5,8,12,20,29,19,48,0.000333,0.069151,4,829.810194,46.100566,207.452549,67.01955,1,0
0,0,5,5,8,12,20,29,19,48,0.000333,0.069151,4,829.810194,46.100566,207.452549,67.01955,1,0
0,0,5,5,8,12,20,29,19,48,0.000333,0.069151,4,829.810194,46.100566,207.452549,67.01955,1,0
0,0,5,5,8,12,20,29,19,48,0.000333,0.069151,4,829.810194,46.100566,207.452549,67.01955,1,0
0,0,5,5,8,12,20,29,19,48,0.000333,0.069151,4,829.810194,46.100566,207.452549,67.01955,1,0
0,0,5,5,8,12,20,29,19,48,0.000333,0.069151,4,829.810194,46.100566,207.452549,67.01955,1,0
0,0,5,5,8,12,20,29,19,48,0.000333,0.069151,4,829.810194,46.100566,207.452549,67.01955,1,0
0,0,5,5,8,12,20,29,19,48,0.000333,0.069151,4,829.810194,46.100566,207.452549,67.01955,1,0
0,0,5,5,8,12,20,29,19,48,0.000333,0.069151,4,829.810194,46.100566,207.452549,67.01955,1,0
0,0,5,5,8,12,20,29,19,48,0.000333,0.069151,4,829.810194,46.100566,207.452549,67.01955,1,0
0,0,5,5,8,12,20,29,19,48,0.000333,0.069151,4,829.810194,46.100566,207.452549,67.01955,1,0
0,0,5,5,8,12,20,29,19,48,0.000333,0.069151,4,829.810194,46.100566,207.452549,67.01955,1,0
0,0,5,5,8,12,20,29,19,48,0.000333,0.069151,4,829.810194,46.100566,207.452549,67.01955,1,0
0,0,5,5,8,12,20,29,19,48,0.000333,0.069151,4,829.810194,46.100566,207.452549,67.01955,1,0
0,0,5,5,8,12,20,29,19,48,0.000333,0.069151,4,829.810194,46.100566,207.452549,67.01955,1,0
0,0,5,5,8,12,20,29,19,48,0.000333,0.069151,4,829.810194,46.100566,207.452549,67.01955,1,0
0,0,5,5,8,12,20,29,19,48,0.000333,0.069151,4,829.810194,46.100566,207.452549,67.01955,1,0
0,0,5,5,8,12,20,29,19,48,0.000333,0.069151,4,829.810194,46.100566,207.452549,67.01955,1,0
0,0,5,5,8,12,20,29,19,48,0.000333,0.069151,4,829.810194,46.100566,207.452549,67.01955,1,0
0,0,5,5,8,12,20,29,19,48,0.000333,0.069151,4,829.810194,46.100566,207.452549,67.01955,1,0
0,0,5,5,8,12,20,29,19,48,0.000333,0.069151,4,829.810194,46.100566,207.452549,67.01955,1,0
0,0,5,5,8,12,20,29,19,48,0.000333,0.069151,4,829.810194,46.100566,207.452549,67.01955,1,0
0,0,5,5,8,12,20,29,19,48,0.000333,0.069151,4,829.810194,46.100566,207.452549,67.01955,1,0
0,0,5,5,8,12,20,29,19,48,0.000333,0.069151,4,829.810194,46.100566,207.452549,67.01955,1,0
0,0,5,5,8,12,20,29,19,48,0.000333,0.069151,4,829.810194,46.100566,207.452549,67.01955,1,0
0,0,5,5,8,12,20,29,19,48,0.000333,0.069151,4,829.810194,46.100566,207.452549,67.01955,1,0
0,0,5,5,8,12,20,29,19,48,0.000333,0.069151,4,829.810194,46.100566,207.452549,67.01955,1,0
0,0,5,5,8,12,20,29,19,48,0.000333,0.069151,4,829.810194,46.100566,207.452549,67.01955,1,0
0,0,5,5,8,12,20,29,19,48,0.000333,0.069151,4,829.810194,46.100566,207.452549,67.01955,1,0
0,0,5,5,8,12,20,29,19,48,0.000333,0.069151,4,829.810194,46.100566,207.452549,67.01955,1,0
0,0,4,4,8,11,19,28,18,46,0.000333,0.065135,4,781.618662,43.423259,195.404666,62.053748,1,0
0,0,5,5,8,12,20,29,19,48,0.000333,0.069151,4,829.810194,46.100566,207.452549,67.01955,1,0
0,0,5,5,8,12,20,29,19,48,0.000333,0.069151,4,829.810194,46.100566,207.452549,67.01955,1,0
0,0,5,5,8,12,20,29,19,48,0.000333,0.069151,4,829.810194,46.100566,207.452549,67.01955,1,0
0,0,5,5,8,12,20,29,19,48,0.000333,0.069151,4,829.810194,46.100566,207.452549,67.01955,1,0
0,0,5,5,8,12,20,29,19,48,0.000333,0.069151,4,829.810194,46.100566,207.452549,67.01955,1,0
0,0,5,5,8,12,20,29,19,48,0.000333,0.069151,4,829.810194,46.100566,207.452549,67.01955,1,0
0,0,5,5,8,12,20,29,19,48,0.000333,0.069151,4,829.810194,46.100566,207.452549,67.01955,1,0
0,0,5,5,8,12,20,29,19,48,0.000333,0.069151,4,829.810194,46.100566,207.452549,67.01955,1,0
0,0,5,5,8,12,20,29,19,48,0.000333,0.069151,4,829.810194,46.100566,207.452549,67.01955,1,0
0,0,5,5,8,12,20,29,19,48,0.000333,0.069151,4,829.810194,46.100566,207.452549,67.01955,1,0
0,0,5,5,8,12,20,29,19,48,0.000333,0.069151,4,829.810194,46.100566,207.452549,67.01955,1,0
0,0,7,7,13,12,25,37,28,65,0.000333,0.100617,12,3622.207828,201.233768,301.850652,91.125266,1,0
0,0,8,8,12,13,25,44,32,76,0.000333,0.117644,12,4235.196845,235.288714,352.93307,91.125266,1,0
0,0,9,9,12,13,25,36,32,68,0.000333,0.105261,12,3789.386651,210.521481,315.782221,91.125266,1,0
0,0,7,7,11,12,23,35,28,63,0.000333,0.094995,10,2849.844032,158.324668,284.984403,81.073298,1,0
0,0,9,9,11,13,24,41,36,77,0.000333,0.117681,10,3530.421126,196.134507,353.042113,86.159464,1,0
0,0,11,11,11,14,25,47,44,91,0.000333,0.140864,15,6338.863699,352.159094,422.590913,91.356717,1,0
0,0,13,13,11,15,26,53,52,105,0.000333,0.164515,15,7403.192556,411.288475,493.54617,96.657107,1,0
0,0,8,8,12,11,23,39,30,69,0.000333,0.104042,12,3745.5093,208.08385,312.125775,81.073298,1,0
0,0,7,7,12,12,24,36,28,64,0.000333,0.097813,12,3521.251201,195.625067,293.4376,86.0391,1,0
0,0,8,8,12,13,25,41,31,72,0.000333,0.111453,12,4012.291748,222.905097,334.357646,91.125266,1,0
0,0,9,9,12,14,26,50,35,85,0.000333,0.133179,12,4794.448513,266.358251,399.537376,96.322519,1,0
0,0,8,8,11,13,24,43,32,75,0.000333,0.114624,10,3438.721876,191.040104,343.872188,86.159464,1,0
0,0,10,10,11,15,26,50,38,88,0.000333,0.13788,10,4136.386952,229.799275,413.638695,96.657107,1,0
0,0,10,10,12,15,27,42,37,79,0.000333,0.125212,12,4507.633352,250.424075,375.636113,101.622909,1,0
0,0,9,9,11,17,28,35,38,73,0.000333,0.116979,10,3509.369093,194.96495,350.936909,107.540616,1,0
0,0,12,12,14,17,31,67,54,121,0.000333,0.199819,21,12588.61283,699.367379,599.457754,122.789837,1,0
0,0,12,12,14,16,30,57,45,102,0.000333,0.166834,14,7007.039771,389.279987,500.502841,117.302969,1,0
0,0,12,12,13,17,30,60,47,107,0.000333,0.175012,12,6300.447525,350.024862,525.037294,117.592585,1,0
0,0,5,5,10,9,19,23,19,42,0.000333,0.059471,10,1784.129556,99.118309,178.412956,61.748606,1,0
0,0,6,6,11,9,20,26,20,46,0.000333,0.06627,10,1988.086924,110.449274,198.808692,66.583073,2,0
0,0,7,7,12,10,22,27,20,47,0.000333,0.069864,12,2515.119433,139.728857,209.593286,76.238831,2,0
0,0,6,6,11,10,21,26,21,47,0.000333,0.068813,10,2064.389189,114.688288,206.438919,71.273029,2,0
0,0,7,7,13,10,23,28,21,49,0.000333,0.073885,12,2659.85443,147.769691,221.654536,81.324997,2,0
0,0,7,7,12,10,22,27,20,47,0.000333,0.069864,12,2515.119433,139.728857,209.593286,76.238831,2,0
0,0,6,6,11,10,21,26,20,46,0.000333,0.067349,10,2020.466014,112.248112,202.046601,71.273029,2,0
0,0,7,7,12,10,22,27,20,47,0.000333,0.069864,12,2515.119433,139.728857,209.593286,76.238831,2,0
0,0,6,6,11,10,21,26,20,46,0.000333,0.067349,10,2020.466014,112.248112,202.046601,71.273029,2,0
0,0,7,7,13,11,24,28,21,49,0.000333,0.074888,6,1347.978975,74.887721,224.663163,86.159464,2,0
0,0,6,6,11,11,22,26,21,47,0.000333,0.069864,5,1047.96643,58.220357,209.593286,76.107496,2,0
0,0,7,7,13,11,24,28,21,49,0.000333,0.074888,6,1347.978975,74.887721,224.663163,86.159464,2,0
0,0,6,6,11,11,22,26,21,47,0.000333,0.069864,5,1047.96643,58.220357,209.593286,76.107496,2,0
0,0,7,7,12,10,22,27,20,47,0.000333,0.069864,12,2515.119433,139.728857,209.593286,76.238831,2,0
0,0,6,6,11,10,21,26,20,46,0.000333,0.067349,10,2020.466014,112.248112,202.046601,71.273029,2,0
0,0,6,6,11,10,21,26,20,46,0.000333,0.067349,10,2020.466014,112.248112,202.046601,71.273029,2,0
0,0,7,7,12,10,22,27,20,47,0.000333,0.069864,12,2515.119433,139.728857,209.593286,76.238831,2,0
0,0,6,6,11,10,21,26,20,46,0.000333,0.067349,10,2020.466014,112.248112,202.046601,71.273029,2,0
0,0,7,7,12,10,22,27,20,47,0.000333,0.069864,12,2515.119433,139.728857,209.593286,76.238831,2,0
0,0,6,6,11,10,21,26,20,46,0.000333,0.067349,10,2020.466014,112.248112,202.046601,71.273029,2,0
0,0,7,7,12,10,22,27,20,47,0.000333,0.069864,12,2515.119433,139.728857,209.593286,76.238831,2,0
0,0,8,8,12,10,22,33,24,57,0.000333,0.084729,12,3050.251227,169.458402,254.187602,76.238831,2,0
0,0,6,6,11,11,22,26,21,47,0.000333,0.069864,5,1047.96643,58.220357,209.593286,76.107496,2,0
0,0,7,7,13,11,24,28,21,49,0.000333,0.074888,6,1347.978975,74.887721,224.663163,86.159464,2,0
0,0,6,6,11,11,22,26,21,47,0.000333,0.069864,5,1047.96643,58.220357,209.593286,76.107496,2,0
0,0,7,7,13,11,24,28,21,49,0.000333,0.074888,6,1347.978975,74.887721,224.663163,86.159464,2,0
0,0,7,7,13,10,23,28,20,48,0.000333,0.072377,12,2605.571687,144.753983,217.130974,81.324997,2,0
0,0,7,7,13,10,23,28,21,49,0.000333,0.073885,12,2659.85443,147.769691,221.654536,81.324997,2,0
0,0,6,6,11,9,20,26,20,46,0.000333,0.06627,10,1988.086924,110.449274,198.808692,66.583073,2,0
0,0,6,6,13,11,24,31,24,55,0.000333,0.084058,12,3026.07525,168.115292,252.172938,86.159464,2,0
0,0,7,7,12,9,21,26,21,47,0.000333,0.068813,12,2477.267026,137.625946,206.438919,71.548875,1,0
0,0,11,11,14,13,27,39,37,76,0.000333,0.120457,14,5059.200302,281.066683,361.37145,101.408685,2,0
0,0,10,10,13,13,26,39,38,77,0.000333,0.120645,12,4343.2063,241.289239,361.933858,96.211433,2,0
0,0,10,10,12,13,25,38,38,76,0.000333,0.117644,12,4235.196845,235.288714,352.93307,91.125266,2,0
0,0,11,11,13,14,27,39,38,77,0.000333,0.122042,12,4393.516052,244.084225,366.126338,101.408685,2,0
0,0,7,7,10,10,20,29,25,54,0.000333,0.077795,10,2333.841171,129.657843,233.384117,66.438562,1,0
0,0,10,10,11,11,22,44,33,77,0.000333,0.114459,15,5150.64352,286.146862,343.376235,76.107496,1,0
0,0,7,7,11,10,21,30,25,55,0.000333,0.080526,10,2415.774583,134.209699,241.577458,71.273029,1,0
0,0,8,8,11,13,24,31,28,59,0.000333,0.090171,10,2705.127875,150.284882,270.512788,86.159464,1,0
0,0,7,7,10,12,22,29,27,56,0.000333,0.083243,10,2497.281706,138.737873,249.728171,76.238831,1,0
0,0,8,8,12,11,23,34,29,63,0.000333,0.094995,12,3419.812839,189.989602,284.984403,81.073298,1,0
0,0,7,7,12,12,24,31,27,58,0.000333,0.088643,12,3191.133901,177.285217,265.927825,86.0391,1,0
0,0,8,8,11,13,24,38,31,69,0.000333,0.105454,10,3163.624125,175.756896,316.362413,86.159464,1,0
0,0,9,9,11,13,24,30,31,61,0.000333,0.093228,10,2796.827125,155.379285,279.682713,86.159464,1,0
0,0,7,7,10,12,22,29,27,56,0.000333,0.083243,10,2497.281706,138.737873,249.728171,76.238831,1,0
0,0,9,9,10,13,23,35,35,70,0.000333,0.10555,10,3166.493369,175.916298,316.649337,81.324997,1,0
0,0,11,11,10,14,24,41,43,84,0.000333,0.128379,15,5777.052751,320.947375,385.13685,86.52225,1,0
0,0,13,13,10,15,25,47,51,98,0.000333,0.151699,15,6826.468599,379.248255,455.097907,91.82264,1,0
0,0,8,8,11,11,22,33,29,62,0.000333,0.092162,10,2764.847604,153.602645,276.48476,76.107496,1,0
0,0,7,7,11,12,23,30,27,57,0.000333,0.085948,10,2578.430315,143.246129,257.843031,81.073298,1,0
0,0,8,8,11,13,24,35,30,65,0.000333,0.099341,10,2980.225625,165.56809,298.022563,86.159464,1,0
0,0,9,9,11,14,25,44,34,78,0.000333,0.12074,10,3622.207828,201.233768,362.220783,91.356717,1,0
0,0,8,8,10,13,23,37,31,68,0.000333,0.102534,10,3076.02213,170.890118,307.602213,81.324997,1,0
0,0,10,10,10,15,25,44,37,81,0.000333,0.125384,10,3761.523514,208.973529,376.152351,91.82264,1,0
0,0,10,10,11,15,26,36,36,72,0.000333,0.112811,10,3384.316597,188.017589,338.43166,96.657107,1,0
0,0,9,9,10,17,27,28,37,65,0.000333,0.103023,10,3090.676876,171.704271,309.067688,102.706149,1,0
0,0,12,12,13,17,30,61,53,114,0.000333,0.186462,18,10068.9395,559.385528,559.385528,117.592585,1,0
0,0,12,12,13,16,29,51,44,95,0.000333,0.153836,12,5538.098334,307.67213,461.508195,112.105716,1,0
0,0,12,12,12,17,29,54,46,100,0.000333,0.161933,12,5829.577194,323.8654,485.7981,112.506418,1,0
0,0,10,10,13,9,22,46,31,77,0.000333,0.114459,18,6180.772223,343.376235,343.376235,76.635041,2,0
0,0,12,12,15,9,24,50,32,82,0.000333,0.125322,21,7895.305426,438.628079,375.966925,87.132684,3,0
0,0,11,11,14,9,23,49,32,81,0.000333,0.122136,21,7694.578887,427.476605,366.408518,81.832294,3,0
0,0,12,12,16,10,26,51,33,84,0.000333,0.131612,24,9476.086472,526.449248,394.836936,97.219281,3,0
0,0,11,11,14,10,24,50,33,83,0.000333,0.126851,21,7991.589639,443.977202,380.551888,86.52225,3,0
0,0,12,12,15,10,25,50,32,82,0.000333,0.126932,21,7996.720359,444.262242,380.796208,91.82264,3,0
0,0,11,11,14,10,24,49,32,81,0.000333,0.123794,21,7799.021214,433.278956,371.381963,86.52225,3,0
0,0,12,12,15,10,25,50,32,82,0.000333,0.126932,21,7996.720359,444.262242,380.796208,91.82264,3,0
0,0,11,11,14,10,24,49,32,81,0.000333,0.123794,21,7799.021214,433.278956,371.381963,86.52225,3,0
0,0,12,12,16,11,27,51,33,84,0.000333,0.133137,24,9585.853204,532.5474,399.41055,102.053748,3,0
0,0,11,11,14,11,25,49,33,82,0.000333,0.126932,21,7996.720359,444.262242,380.796208,91.356717,3,0
0,0,12,12,16,11,27,51,33,84,0.000333,0.133137,24,9585.853204,532.5474,399.41055,102.053748,3,0
0,0,11,11,14,11,25,50,33,83,0.000333,0.12848,21,8094.241339,449.680074,385.440064,91.356717,3,0
0,0,12,12,15,10,25,50,32,82,0.000333,0.126932,21,7996.720359,444.262242,380.796208,91.82264,3,0
0,0,11,11,14,10,24,49,32,81,0.000333,0.123794,21,7799.021214,433.278956,371.381963,86.52225,3,0
0,0,12,12,15,10,25,50,32,82,0.000333,0.126932,21,7996.720359,444.262242,380.796208,91.82264,3,0
0,0,11,11,14,10,24,49,32,81,0.000333,0.123794,21,7799.021214,433.278956,371.381963,86.52225,3,0
0,0,12,12,15,10,25,50,32,82,0.000333,0.126932,21,7996.720359,444.262242,380.796208,91.82264,3,0
0,0,11,11,14,10,24,49,32,81,0.000333,0.123794,21,7799.021214,433.278956,371.381963,86.52225,3,0
0,0,12,12,15,10,25,50,32,82,0.000333,0.126932,21,7996.720359,444.262242,380.796208,91.82264,3,0
0,0,11,11,14,10,24,49,32,81,0.000333,0.123794,21,7799.021214,433.278956,371.381963,86.52225,3,0
0,0,14,14,15,10,25,59,37,96,0.000333,0.148603,21,9362.014079,520.111893,445.810194,91.82264,3,0
0,0,12,12,16,11,27,51,33,84,0.000333,0.133137,24,9585.853204,532.5474,399.41055,102.053748,3,0
0,0,11,11,14,11,25,49,33,82,0.000333,0.126932,21,7996.720359,444.262242,380.796208,91.356717,3,0
0,0,12,12,16,11,27,51,33,84,0.000333,0.133137,24,9585.853204,532.5474,399.41055,102.053748,3,0
0,0,11,11,14,11,25,50,33,83,0.000333,0.12848,21,8094.241339,449.680074,385.440064,91.356717,3,0
0,0,12,12,16,10,26,51,32,83,0.000333,0.130045,24,9363.275919,520.181995,390.136497,97.219281,3,0
0,0,12,12,16,10,26,51,33,84,0.000333,0.131612,24,9476.086472,526.449248,394.836936,97.219281,3,0
0,0,11,11,14,9,23,49,32,81,0.000333,0.122136,21,7694.578887,427.476605,366.408518,81.832294,3,0
0,0,11,11,13,10,23,54,36,90,0.000333,0.135707,18,7328.170369,407.120576,407.120576,81.324997,3,0
0,0,12,12,15,9,24,49,33,82,0.000333,0.125322,21,7895.305426,438.628079,375.966925,87.132684,2,0
0,0,15,15,16,13,29,62,50,112,0.000333,0.181365,24,13058.25292,725.458495,544.093871,112.105716,3,0
0,0,16,16,17,13,30,63,50,113,0.000333,0.184826,24,13307.4873,739.30485,554.478637,117.592585,3,0
0,0,16,16,16,13,29,62,50,112,0.000333,0.181365,24,13058.25292,725.458495,544.093871,112.105716,3,0
0,0,15,15,15,13,28,61,50,111,0.000333,0.177872,21,11205.94432,622.552462,533.616396,106.709075,3,0
0,0,12,12,13,10,23,52,37,89,0.000333,0.134199,18,7246.746254,402.597014,402.597014,81.324997,2,0
0,0,15,15,14,11,25,67,45,112,0.000333,0.173371,28,14563.13301,809.062945,520.111893,91.356717,2,0
0,0,12,12,14,10,24,53,37,90,0.000333,0.137549,21,8665.579126,481.421063,412.646625,86.52225,2,0
0,0,13,13,14,13,27,54,40,94,0.000333,0.148986,21,9386.147929,521.452663,446.959425,101.408685,2,0
0,0,12,12,13,12,25,52,39,91,0.000333,0.140864,18,7606.636439,422.590913,422.590913,91.125266,2,0
0,0,13,13,15,11,26,57,41,98,0.000333,0.153548,21,9673.50494,537.416941,460.643092,96.657107,2,0
0,0,12,12,15,12,27,54,39,93,0.000333,0.147402,21,9286.295292,515.905294,442.204538,101.622909,2,0
0,0,13,13,14,13,27,61,43,104,0.000333,0.164836,21,10384.67431,576.92635,494.5083,101.408685,2,0
0,0,14,14,14,13,27,53,43,96,0.000333,0.152156,21,9585.853204,532.5474,456.4692,101.408685,2,0
0,0,12,12,13,12,25,52,39,91,0.000333,0.140864,18,7606.636439,422.590913,422.590913,91.125266,2,0
0,0,14,14,13,13,26,58,47,105,0.000333,0.164515,18,8883.831067,493.54617,493.54617,96.211433,2,0
0,0,16,16,13,14,27,64,55,119,0.000333,0.188611,18,10184.96903,565.831613,565.831613,101.408685,2,0
0,0,18,18,13,15,28,70,63,133,0.000333,0.213126,24,15345.07691,852.504273,639.378205,106.709075,2,0
0,0,13,13,14,11,25,55,41,96,0.000333,0.148603,21,9362.014079,520.111893,445.810194,91.356717,2,0
0,0,12,12,14,12,26,53,39,92,0.000333,0.144147,21,9081.249535,504.513863,432.440454,96.322519,2,0
0,0,13,13,14,13,27,58,42,100,0.000333,0.158496,21,9985.263755,554.736875,475.48875,101.408685,2,0
0,0,14,14,14,14,28,67,46,113,0.000333,0.181077,21,11407.85323,633.769624,543.231106,106.605938,2,0
0,0,13,13,13,13,26,60,43,103,0.000333,0.161382,18,8714.615237,484.145291,484.145291,96.211433,2,0
0,0,15,15,13,15,28,67,49,116,0.000333,0.185884,18,10037.75708,557.653171,557.653171,106.709075,2,0
0,0,15,15,14,15,29,59,48,107,0.000333,0.173268,21,10915.8833,606.437961,519.803966,111.906328,2,0
0,0,14,14,13,17,30,52,49,101,0.000333,0.165199,12,5947.151402,330.3973,495.59595,117.592585,2,0
0,0,17,17,15,17,32,84,65,149,0.000333,0.248333,21,15645,869.166667,745,128.090227,2,0
0,0,17,17,15,16,31,74,56,130,0.000333,0.214682,21,13524.95593,751.38644,644.04552,122.603359,2,0
0,0,17,17,14,16,30,77,58,135,0.000333,0.22081,21,13911.03484,772.835269,662.43023,117.302969,2,0
0,0,8,8,11,9,20,36,24,60,0.000333,0.086439,10,2593.156857,144.06427,259.315686,66.583073,1,0
0,0,10,10,13,9,22,40,25,65,0.000333,0.096621,12,3478.356663,193.242037,289.863055,76.635041,2,0
0,0,9,9,12,9,21,39,25,64,0.000333,0.093703,12,3373.299781,187.405543,281.108315,71.548875,2,0
0,0,10,10,14,10,24,41,26,67,0.000333,0.102397,14,4300.694826,238.92749,307.192488,86.52225,2,0
0,0,9,9,12,10,22,40,26,66,0.000333,0.098107,12,3531.869842,196.214991,294.322487,76.238831,2,0
0,0,9,9,12,10,22,39,25,64,0.000333,0.095135,12,3424.843483,190.269082,285.403624,76.238831,2,0
0,0,10,10,13,10,23,40,25,65,0.000333,0.098011,12,3528.378326,196.021018,294.031527,81.324997,2,0
0,0,9,9,12,10,22,39,25,64,0.000333,0.095135,12,3424.843483,190.269082,285.403624,76.238831,2,0
0,0,10,10,13,10,23,40,25,65,0.000333,0.098011,12,3528.378326,196.021018,294.031527,81.324997,2,0
0,0,10,10,14,11,25,41,26,67,0.000333,0.103713,14,4355.937106,241.996506,311.138365,91.356717,2,0
0,0,9,9,12,11,23,39,26,65,0.000333,0.098011,12,3528.378326,196.021018,294.031527,81.073298,2,0
0,0,10,10,14,11,25,41,26,67,0.000333,0.103713,14,4355.937106,241.996506,311.138365,91.356717,2,0
0,0,9,9,12,11,23,39,26,65,0.000333,0.098011,12,3528.378326,196.021018,294.031527,81.073298,2,0
0,0,10,10,13,10,23,40,25,65,0.000333,0.098011,12,3528.378326,196.021018,294.031527,81.324997,2,0
0,0,9,9,12,10,22,39,25,64,0.000333,0.095135,12,3424.843483,190.269082,285.403624,76.238831,2,0
0,0,10,10,13,10,23,40,25,65,0.000333,0.098011,12,3528.378326,196.021018,294.031527,81.324997,2,0
0,0,9,9,12,10,22,39,25,64,0.000333,0.095135,12,3424.843483,190.269082,285.403624,76.238831,2,0
0,0,10,10,13,10,23,40,25,65,0.000333,0.098011,12,3528.378326,196.021018,294.031527,81.324997,2,0
0,0,9,9,12,10,22,39,25,64,0.000333,0.095135,12,3424.843483,190.269082,285.403624,76.238831,2,0
0,0,10,10,13,10,23,40,25,65,0.000333,0.098011,12,3528.378326,196.021018,294.031527,81.324997,2,0
0,0,9,9,12,10,22,39,25,64,0.000333,0.095135,12,3424.843483,190.269082,285.403624,76.238831,2,0
0,0,12,12,13,10,23,49,30,79,0.000333,0.11912,18,6432.505102,357.361395,357.361395,81.324997,2,0
0,0,10,10,14,11,25,41,26,67,0.000333,0.103713,14,4355.937106,241.996506,311.138365,91.356717,2,0
0,0,9,9,12,11,23,39,26,65,0.000333,0.098011,12,3528.378326,196.021018,294.031527,81.073298,2,0
0,0,10,10,14,11,25,41,26,67,0.000333,0.103713,14,4355.937106,241.996506,311.138365,91.356717,2,0
0,0,9,9,12,11,23,39,26,65,0.000333,0.098011,12,3528.378326,196.021018,294.031527,81.073298,2,0
0,0,10,10,14,10,24,41,26,67,0.000333,0.102397,14,4300.694826,238.92749,307.192488,86.52225,2,0
0,0,10,10,14,10,24,41,25,66,0.000333,0.100869,14,4236.505351,235.361408,302.607525,86.52225,2,0
0,0,9,9,12,9,21,39,25,64,0.000333,0.093703,12,3373.299781,187.405543,281.108315,71.548875,2,0
0,0,9,9,14,10,24,44,29,73,0.000333,0.111567,14,4685.831676,260.323982,334.702263,86.52225,2,0
0,0,10,10,13,9,22,39,26,65,0.000333,0.096621,12,3478.356663,193.242037,289.863055,76.635041,1,0
0,0,13,13,14,13,27,52,43,95,0.000333,0.150571,21,9486.000567,527.000031,451.714313,101.408685,2,0
0,0,14,14,15,13,28,53,43,96,0.000333,0.153835,21,9691.627523,538.423751,461.506073,106.709075,2,0
0,0,14,14,14,13,27,52,43,95,0.000333,0.150571,21,9486.000567,527.000031,451.714313,101.408685,2,0
0,0,13,13,13,13,26,51,43,94,0.000333,0.14728,18,7953.144003,441.841334,441.841334,96.211433,2,0
0,0,10,10,11,10,21,42,30,72,0.000333,0.105416,15,4743.702817,263.539045,316.246854,71.273029,1,0
0,0,13,13,12,11,23,57,38,95,0.000333,0.143246,18,7735.290945,429.738386,429.738386,81.073298,1,0
0,0,10,10,12,10,22,43,30,73,0.000333,0.108513,18,5859.693147,325.538508,325.538508,76.238831,1,0
0,0,11,11,12,13,25,44,33,77,0.000333,0.119192,12,4290.923119,238.384618,357.576927,91.125266,1,0
0,0,10,10,11,12,23,42,32,74,0.000333,0.111581,10,3347.435847,185.968658,334.743585,81.073298,1,0
0,0,11,11,13,11,24,47,34,81,0.000333,0.123794,18,6684.875326,371.381963,371.381963,86.159464,1,0
0,0,10,10,13,12,25,44,32,76,0.000333,0.117644,12,4235.196845,235.288714,352.93307,91.125266,1,0
0,0,11,11,12,13,25,51,36,87,0.000333,0.134672,12,4848.185862,269.343659,404.015489,91.125266,1,0
0,0,12,12,12,13,25,43,36,79,0.000333,0.122288,12,4402.375668,244.576426,366.864639,91.125266,1,0
0,0,10,10,11,12,23,42,32,74,0.000333,0.111581,10,3347.435847,185.968658,334.743585,81.073298,1,0
0,0,12,12,11,13,24,48,40,88,0.000333,0.134492,15,6052.150501,336.230583,403.4767,86.159464,1,0
0,0,14,14,11,14,25,54,48,102,0.000333,0.157891,15,7105.09997,394.727776,473.673331,91.356717,1,0
0,0,16,16,11,15,26,60,56,116,0.000333,0.18175,15,8178.76511,454.375839,545.251007,96.657107,1,0
0,0,11,11,12,11,23,46,34,80,0.000333,0.120628,18,6513.929217,361.884956,361.884956,81.073298,1,0
0,0,10,10,12,12,24,43,32,75,0.000333,0.114624,12,4126.466251,229.248125,343.872188,86.0391,1,0
0,0,11,11,12,13,25,48,35,83,0.000333,0.12848,12,4625.280765,256.960043,385.440064,91.125266,1,0
0,0,12,12,12,14,26,57,39,96,0.000333,0.150414,12,5414.906555,300.828142,451.242213,96.322519,1,0
0,0,11,11,11,13,24,50,36,86,0.000333,0.131436,10,3943.067751,219.059319,394.306775,86.159464,1,0
0,0,13,13,11,15,26,57,42,99,0.000333,0.155115,10,4653.435321,258.524184,465.343532,96.657107,1,0
0,0,13,13,12,15,27,49,41,90,0.000333,0.142647,12,5135.278502,285.29325,427.939875,101.622909,1,0
0,0,12,12,11,17,28,42,42,84,0.000333,0.134606,10,4038.178135,224.34323,403.817813,107.540616,1,0
0,0,15,15,14,17,31,74,58,132,0.000333,0.217985,21,13733.03217,762.946232,653.953913,122.789837,1,0
0,0,15,15,14,16,30,64,49,113,0.000333,0.184826,21,11644.05138,646.891744,554.478637,117.302969,1,0
0,0,15,15,13,16,29,67,51,118,0.000333,0.191081,18,10318.35163,573.241757,573.241757,112.105716,1,0
0,0,8,8,11,9,20,36,24,60,0.000333,0.086439,10,2593.156857,144.06427,259.315686,66.583073,1,0
0,0,9,9,12,9,21,39,25,64,0.000333,0.093703,12,3373.299781,187.405543,281.108315,71.548875,2,0
0,0,10,10,13,9,22,40,25,65,0.000333,0.096621,12,3478.356663,193.242037,289.863055,76.635041,2,0
0,0,9,9,12,10,22,39,26,65,0.000333,0.096621,12,3478.356663,193.242037,289.863055,76.238831,2,0
0,0,10,10,14,10,24,41,26,67,0.000333,0.102397,14,4300.694826,238.92749,307.192488,86.52225,2,0
0,0,9,9,12,10,22,39,25,64,0.000333,0.095135,12,3424.843483,190.269082,285.403624,76.238831,2,0
0,0,10,10,13,10,23,40,25,65,0.000333,0.098011,12,3528.378326,196.021018,294.031527,81.324997,2,0
0,0,9,9,12,10,22,39,25,64,0.000333,0.095135,12,3424.843483,190.269082,285.403624,76.238831,2,0
0,0,10,10,13,10,23,40,25,65,0.000333,0.098011,12,3528.378326,196.021018,294.031527,81.324997,2,0
0,0,9,9,12,11,23,39,26,65,0.000333,0.098011,12,3528.378326,196.021018,294.031527,81.073298,2,0
0,0,9,9,13,11,24,40,26,66,0.000333,0.100869,12,3631.290301,201.73835,302.607525,86.159464,2,0
0,0,9,9,12,11,23,39,26,65,0.000333,0.098011,12,3528.378326,196.021018,294.031527,81.073298,2,0
0,0,10,10,14,11,25,41,26,67,0.000333,0.103713,14,4355.937106,241.996506,311.138365,91.356717,2,0
0,0,10,10,13,10,23,40,25,65,0.000333,0.098011,12,3528.378326,196.021018,294.031527,81.324997,2,0
0,0,9,9,12,10,22,39,25,64,0.000333,0.095135,12,3424.843483,190.269082,285.403624,76.238831,2,0
0,0,9,9,12,10,22,39,25,64,0.000333,0.095135,12,3424.843483,190.269082,285.403624,76.238831,2,0
0,0,9,9,12,10,22,39,25,64,0.000333,0.095135,12,3424.843483,190.269082,285.403624,76.238831,2,0
0,0,9,9,12,10,22,39,25,64,0.000333,0.095135,12,3424.843483,190.269082,285.403624,76.238831,2,0
0,0,10,10,13,10,23,40,25,65,0.000333,0.098011,12,3528.378326,196.021018,294.031527,81.324997,2,0
0,0,9,9,12,10,22,39,25,64,0.000333,0.095135,12,3424.843483,190.269082,285.403624,76.238831,2,0
0,0,10,10,13,10,23,40,25,65,0.000333,0.098011,12,3528.378326,196.021018,294.031527,81.324997,2,0
0,0,12,12,13,10,23,49,30,79,0.000333,0.11912,18,6432.505102,357.361395,357.361395,81.324997,2,0
0,0,9,9,12,11,23,39,26,65,0.000333,0.098011,12,3528.378326,196.021018,294.031527,81.073298,2,0
0,0,10,10,14,11,25,41,26,67,0.000333,0.103713,14,4355.937106,241.996506,311.138365,91.356717,2,0
0,0,9,9,12,11,23,39,26,65,0.000333,0.098011,12,3528.378326,196.021018,294.031527,81.073298,2,0
0,0,10,10,14,11,25,41,26,67,0.000333,0.103713,14,4355.937106,241.996506,311.138365,91.356717,2,0
0,0,10,10,14,10,24,41,25,66,0.000333,0.100869,14,4236.505351,235.361408,302.607525,86.52225,2,0
0,0,10,10,14,10,24,41,26,67,0.000333,0.102397,14,4300.694826,238.92749,307.192488,86.52225,2,0
0,0,9,9,12,9,21,39,25,64,0.000333,0.093703,12,3373.299781,187.405543,281.108315,71.548875,2,0
0,0,9,9,14,10,24,44,29,73,0.000333,0.111567,14,4685.831676,260.323982,334.702263,86.52225,2,0
0,0,10,10,13,9,22,39,26,65,0.000333,0.096621,12,3478.356663,193.242037,289.863055,76.635041,1,0
0,0,13,13,14,13,27,52,43,95,0.000333,0.150571,21,9486.000567,527.000031,451.714313,101.408685,2,0
0,0,14,14,15,13,28,53,43,96,0.000333,0.153835,21,9691.627523,538.423751,461.506073,106.709075,2,0
0,0,14,14,14,13,27,52,43,95,0.000333,0.150571,21,9486.000567,527.000031,451.714313,101.408685,2,0
0,0,13,13,13,13,26,51,43,94,0.000333,0.14728,18,7953.144003,441.841334,441.841334,96.211433,2,0
0,0,10,10,11,10,21,42,30,72,0.000333,0.105416,15,4743.702817,263.539045,316.246854,71.273029,1,0
0,0,13,13,12,11,23,57,38,95,0.000333,0.143246,18,7735.290945,429.738386,429.738386,81.073298,1,0
0,0,10,10,12,10,22,43,30,73,0.000333,0.108513,18,5859.693147,325.538508,325.538508,76.238831,1,0
0,0,11,11,12,13,25,44,33,77,0.000333,0.119192,12,4290.923119,238.384618,357.576927,91.125266,1,0
0,0,10,10,11,12,23,42,32,74,0.000333,0.111581,10,3347.435847,185.968658,334.743585,81.073298,1,0
0,0,11,11,13,11,24,47,34,81,0.000333,0.123794,18,6684.875326,371.381963,371.381963,86.159464,1,0
0,0,10,10,13,12,25,45,33,78,0.000333,0.12074,12,4346.649394,241.480522,362.220783,91.125266,1,0
0,0,11,11,12,13,25,51,36,87,0.000333,0.134672,12,4848.185862,269.343659,404.015489,91.125266,1,0
0,0,12,12,12,13,25,43,36,79,0.000333,0.122288,12,4402.375668,244.576426,366.864639,91.125266,1,0
0,0,10,10,11,12,23,42,32,74,0.000333,0.111581,10,3347.435847,185.968658,334.743585,81.073298,1,0
0,0,12,12,11,13,24,48,40,88,0.000333,0.134492,15,6052.150501,336.230583,403.4767,86.159464,1,0
0,0,14,14,11,14,25,54,48,102,0.000333,0.157891,15,7105.09997,394.727776,473.673331,91.356717,1,0
0,0,16,16,11,15,26,60,56,116,0.000333,0.18175,15,8178.76511,454.375839,545.251007,96.657107,1,0
0,0,11,11,12,11,23,46,34,80,0.000333,0.120628,18,6513.929217,361.884956,361.884956,81.073298,1,0
0,0,10,10,12,12,24,43,32,75,0.000333,0.114624,12,4126.466251,229.248125,343.872188,86.0391,1,0
0,0,11,11,12,13,25,48,35,83,0.000333,0.12848,12,4625.280765,256.960043,385.440064,91.125266,1,0
0,0,12,12,12,14,26,57,39,96,0.000333,0.150414,12,5414.906555,300.828142,451.242213,96.322519,1,0
0,0,11,11,11,13,24,50,36,86,0.000333,0.131436,10,3943.067751,219.059319,394.306775,86.159464,1,0
0,0,13,13,11,15,26,57,42,99,0.000333,0.155115,10,4653.435321,258.524184,465.343532,96.657107,1,0
0,0,13,13,12,15,27,49,41,90,0.000333,0.142647,12,5135.278502,285.29325,427.939875,101.622909,1,0
0,0,12,12,11,17,28,42,42,84,0.000333,0.134606,10,4038.178135,224.34323,403.817813,107.540616,1,0
0,0,15,15,14,17,31,74,58,132,0.000333,0.217985,21,13733.03217,762.946232,653.953913,122.789837,1,0
0,0,15,15,14,16,30,64,49,113,0.000333,0.184826,21,11644.05138,646.891744,554.478637,117.302969,1,0
0,0,15,15,13,16,29,67,51,118,0.000333,0.191081,18,10318.35163,573.241757,573.241757,112.105716,1,0
0,0,8,8,10,9,19,32,23,55,0.000333,0.077879,10,2336.360132,129.797785,233.636013,61.748606,1,0
0,0,9,9,11,9,20,35,24,59,0.000333,0.084998,10,2549.937576,141.663199,254.993758,66.583073,2,0
0,0,10,10,12,9,21,36,24,60,0.000333,0.087846,12,3162.468544,175.692697,263.539045,71.548875,2,0
0,0,9,9,11,10,21,35,25,60,0.000333,0.087846,10,2635.390454,146.410581,263.539045,71.273029,2,0
0,0,10,10,13,10,23,37,25,62,0.000333,0.093487,12,3365.530095,186.973894,280.460841,81.324997,2,0
0,0,10,10,12,10,22,36,24,60,0.000333,0.089189,12,3210.790765,178.377265,267.565897,76.238831,2,0
0,0,9,9,11,10,21,35,24,59,0.000333,0.086382,10,2591.467279,143.970404,259.146728,71.273029,2,0
0,0,10,10,12,10,22,36,24,60,0.000333,0.089189,12,3210.790765,178.377265,267.565897,76.238831,2,0
0,0,9,9,11,10,21,35,24,59,0.000333,0.086382,10,2591.467279,143.970404,259.146728,71.273029,2,0
0,0,9,9,11,11,22,35,25,60,0.000333,0.089189,10,2675.658971,148.647721,267.565897,76.107496,2,0
0,0,10,10,13,11,24,37,25,62,0.000333,0.094756,12,3411.212101,189.511783,284.267675,86.159464,2,0
0,0,9,9,11,11,22,35,25,60,0.000333,0.089189,10,2675.658971,148.647721,267.565897,76.107496,2,0
0,0,10,10,13,11,24,37,25,62,0.000333,0.094756,12,3411.212101,189.511783,284.267675,86.159464,2,0
0,0,9,9,11,10,21,35,24,59,0.000333,0.086382,10,2591.467279,143.970404,259.146728,71.273029,2,0
0,0,10,10,12,10,22,36,24,60,0.000333,0.089189,12,3210.790765,178.377265,267.565897,76.238831,2,0
0,0,9,9,11,10,21,35,24,59,0.000333,0.086382,10,2591.467279,143.970404,259.146728,71.273029,2,0
0,0,10,10,12,10,22,36,24,60,0.000333,0.089189,12,3210.790765,178.377265,267.565897,76.238831,2,0
0,0,9,9,11,10,21,35,24,59,0.000333,0.086382,10,2591.467279,143.970404,259.146728,71.273029,2,0
0,0,10,10,12,10,22,36,24,60,0.000333,0.089189,12,3210.790765,178.377265,267.565897,76.238831,2,0
0,0,9,9,11,10,21,35,24,59,0.000333,0.086382,10,2591.467279,143.970404,259.146728,71.273029,2,0
0,0,10,10,12,10,22,36,24,60,0.000333,0.089189,12,3210.790765,178.377265,267.565897,76.238831,2,0
0,0,12,12,12,10,22,45,29,74,0.000333,0.109999,12,3959.975277,219.998627,329.99794,76.238831,2,0
0,0,9,9,11,11,22,35,25,60,0.000333,0.089189,10,2675.658971,148.647721,267.565897,76.107496,2,0
0,0,10,10,13,11,24,37,25,62,0.000333,0.094756,12,3411.212101,189.511783,284.267675,86.159464,2,0
0,0,9,9,11,11,22,35,25,60,0.000333,0.089189,10,2675.658971,148.647721,267.565897,76.107496,2,0
0,0,10,10,13,11,24,37,25,62,0.000333,0.094756,12,3411.212101,189.511783,284.267675,86.159464,2,0
0,0,10,10,13,10,23,37,25,62,0.000333,0.093487,12,3365.530095,186.973894,280.460841,81.324997,2,0
0,0,10,10,13,10,23,37,24,61,0.000333,0.091979,12,3311.247352,183.958186,275.937279,81.324997,2,0
0,0,9,9,11,9,20,35,24,59,0.000333,0.084998,10,2549.937576,141.663199,254.993758,66.583073,2,0
0,0,9,9,13,10,23,40,28,68,0.000333,0.102534,12,3691.226556,205.068142,307.602213,81.324997,2,0
0,0,10,10,12,9,21,35,25,60,0.000333,0.087846,12,3162.468544,175.692697,263.539045,71.548875,1,0
0,0,14,14,14,13,27,49,42,91,0.000333,0.144232,21,9086.590017,504.810556,432.694763,101.408685,2,0
0,0,13,13,13,13,26,48,42,90,0.000333,0.141013,18,7614.712343,423.039575,423.039575,96.211433,2,0
0,0,14,14,13,13,26,48,42,90,0.000333,0.141013,18,7614.712343,423.039575,423.039575,96.211433,2,0
0,0,13,13,12,13,25,47,42,89,0.000333,0.137768,18,7439.457616,413.303201,413.303201,91.125266,2,0
0,0,10,10,10,10,20,38,29,67,0.000333,0.096523,10,2895.691824,160.871768,289.569182,66.438562,1,0
0,0,13,13,11,11,22,53,37,90,0.000333,0.133783,15,6020.232685,334.457371,401.348846,76.107496,1,0
0,0,10,10,11,10,21,39,29,68,0.000333,0.099559,10,2986.775847,165.931992,298.677585,71.273029,1,0
0,0,11,11,11,13,24,40,32,72,0.000333,0.110039,10,3301.173001,183.3985,330.1173,86.159464,1,0
0,0,10,10,10,12,22,37,31,68,0.000333,0.10108,10,3032.413501,168.467417,303.24135,76.238831,1,0
0,0,11,11,12,11,23,42,33,75,0.000333,0.113089,18,6106.808641,339.267147,339.267147,81.073298,1,0
0,0,10,10,11,12,23,38,31,69,0.000333,0.104042,10,3121.25775,173.403208,312.125775,81.073298,1,0
0,0,11,11,11,13,24,47,35,82,0.000333,0.125322,10,3759.669251,208.870514,375.966925,86.159464,1,0
0,0,12,12,11,13,24,39,35,74,0.000333,0.113096,10,3392.872251,188.492903,339.287225,86.159464,1,0
0,0,10,10,10,12,22,38,31,69,0.000333,0.102567,10,3077.007817,170.944879,307.700782,76.238831,1,0
0,0,12,12,10,13,23,44,39,83,0.000333,0.125152,15,5631.834635,312.879702,375.455642,81.324997,1,0
0,0,14,14,10,14,24,50,47,97,0.000333,0.148247,15,6671.120439,370.617802,444.741363,86.52225,1,0
0,0,16,16,10,15,25,56,55,111,0.000333,0.171823,15,7732.020556,429.556698,515.468037,91.82264,1,0
0,0,11,11,11,11,22,42,33,75,0.000333,0.111486,15,5016.860571,278.714476,334.457371,76.107496,1,0
0,0,10,10,11,12,23,39,31,70,0.000333,0.10555,10,3166.493369,175.916298,316.649337,81.073298,1,0
0,0,11,11,11,13,24,44,34,78,0.000333,0.119209,10,3576.270751,198.681708,357.627075,86.159464,1,0
0,0,12,12,11,14,25,53,38,91,0.000333,0.140864,10,4225.909133,234.77273,422.590913,91.356717,1,0
0,0,11,11,10,13,23,46,35,81,0.000333,0.122136,10,3664.085184,203.560288,366.408518,81.324997,1,0
0,0,13,13,10,15,25,53,41,94,0.000333,0.145507,10,4365.224818,242.51249,436.522482,91.82264,1,0
0,0,13,13,11,15,26,45,40,85,0.000333,0.133179,10,3995.37376,221.965209,399.537376,96.657107,1,0
0,0,12,12,10,17,27,38,41,79,0.000333,0.125212,10,3756.361127,208.686729,375.636113,102.706149,1,0
0,0,15,15,13,17,30,70,57,127,0.000333,0.207725,18,11217.1519,623.175106,623.175106,117.592585,1,0
0,0,15,15,13,16,29,60,48,108,0.000333,0.174887,18,9443.915055,524.661947,524.661947,112.105716,1,0
0,0,15,15,12,16,28,63,50,113,0.000333,0.181077,18,9778.159911,543.231106,543.231106,107.01955,1,0
0,0,8,8,10,9,19,33,24,57,0.000333,0.080711,10,2421.318683,134.517705,242.131868,61.748606,1,0
0,0,10,10,12,9,21,37,25,62,0.000333,0.090775,12,3267.884163,181.54912,272.32368,71.548875,2,0
0,0,9,9,11,9,20,36,25,61,0.000333,0.087879,10,2636.376138,146.465341,263.637614,66.583073,2,0
0,0,10,10,13,10,23,38,26,64,0.000333,0.096503,12,3474.095582,193.00531,289.507965,81.324997,2,0
0,0,9,9,11,10,21,37,26,63,0.000333,0.092239,10,2767.159976,153.73111,276.715998,71.273029,2,0
0,0,9,9,11,10,21,36,25,61,0.000333,0.08931,10,2679.313628,148.850757,267.931363,71.273029,2,0
0,0,10,10,12,10,22,37,25,62,0.000333,0.092162,12,3317.817124,184.323174,276.48476,76.238831,2,0
0,0,9,9,11,10,21,36,25,61,0.000333,0.08931,10,2679.313628,148.850757,267.931363,71.273029,2,0
0,0,10,10,12,10,22,37,25,62,0.000333,0.092162,12,3317.817124,184.323174,276.48476,76.238831,2,0
0,0,10,10,13,11,24,38,26,64,0.000333,0.097813,12,3521.251201,195.625067,293.4376,86.159464,2,0
0,0,9,9,11,11,22,36,26,62,0.000333,0.092162,10,2764.847604,153.602645,276.48476,76.107496,2,0
0,0,10,10,13,11,24,38,26,64,0.000333,0.097813,12,3521.251201,195.625067,293.4376,86.159464,2,0
0,0,9,9,11,11,22,37,26,63,0.000333,0.093648,10,2809.44192,156.080107,280.944192,76.107496,2,0
0,0,9,9,11,10,21,36,25,61,0.000333,0.08931,10,2679.313628,148.850757,267.931363,71.273029,2,0
0,0,10,10,12,10,22,37,25,62,0.000333,0.092162,12,3317.817124,184.323174,276.48476,76.238831,2,0
0,0,10,10,12,10,22,37,25,62,0.000333,0.092162,12,3317.817124,184.323174,276.48476,76.238831,2,0
0,0,9,9,11,10,21,36,25,61,0.000333,0.08931,10,2679.313628,148.850757,267.931363,71.273029,2,0
0,0,10,10,12,10,22,37,25,62,0.000333,0.092162,12,3317.817124,184.323174,276.48476,76.238831,2,0
0,0,9,9,11,10,21,36,25,61,0.000333,0.08931,10,2679.313628,148.850757,267.931363,71.273029,2,0
0,0,10,10,12,10,22,37,25,62,0.000333,0.092162,12,3317.817124,184.323174,276.48476,76.238831,2,0
0,0,9,9,11,10,21,36,25,61,0.000333,0.08931,10,2679.313628,148.850757,267.931363,71.273029,2,0
0,0,12,12,12,10,22,46,30,76,0.000333,0.112972,18,6100.502454,338.916803,338.916803,76.238831,2,0
0,0,10,10,13,11,24,38,26,64,0.000333,0.097813,12,3521.251201,195.625067,293.4376,86.159464,2,0
0,0,9,9,11,11,22,36,26,62,0.000333,0.092162,10,2764.847604,153.602645,276.48476,76.107496,2,0
0,0,10,10,13,11,24,38,26,64,0.000333,0.097813,12,3521.251201,195.625067,293.4376,86.159464,2,0
0,0,9,9,11,11,22,36,26,62,0.000333,0.092162,10,2764.847604,153.602645,276.48476,76.107496,2,0
0,0,10,10,13,10,23,38,25,63,0.000333,0.094995,12,3419.812839,189.989602,284.984403,81.324997,2,0
0,0,10,10,13,10,23,38,26,64,0.000333,0.096503,12,3474.095582,193.00531,289.507965,81.324997,2,0
0,0,9,9,11,9,20,36,25,61,0.000333,0.087879,10,2636.376138,146.465341,263.637614,66.583073,2,0
0,0,9,9,13,10,23,41,29,70,0.000333,0.10555,12,3799.792043,211.099558,316.649337,81.324997,2,0
0,0,10,10,12,9,21,36,26,62,0.000333,0.090775,12,3267.884163,181.54912,272.32368,71.548875,1,0
0,0,14,14,14,13,27,50,43,93,0.000333,0.147402,21,9286.295292,515.905294,442.204538,101.408685,2,0
0,0,13,13,13,13,26,49,43,92,0.000333,0.144147,18,7783.928173,432.440454,432.440454,96.211433,2,0
0,0,14,14,13,13,26,49,43,92,0.000333,0.144147,18,7783.928173,432.440454,432.440454,96.211433,2,0
0,0,13,13,12,13,25,48,43,91,0.000333,0.140864,18,7606.636439,422.590913,422.590913,91.125266,2,0
0,0,10,10,10,10,20,39,30,69,0.000333,0.099404,15,4473.195578,248.510865,298.213039,66.438562,1,0
0,0,13,13,11,11,22,54,38,92,0.000333,0.136756,15,6154.015634,341.889757,410.267709,76.107496,1,0
0,0,10,10,11,10,21,40,30,70,0.000333,0.102487,15,4611.933294,256.218516,307.46222,71.273029,1,0
0,0,11,11,11,13,24,41,33,74,0.000333,0.113096,10,3392.872251,188.492903,339.287225,86.159464,1,0
0,0,10,10,10,12,22,39,32,71,0.000333,0.10554,10,3166.196449,175.899803,316.619645,76.238831,1,0
0,0,11,11,12,11,23,44,34,78,0.000333,0.117613,18,6351.080986,352.837833,352.837833,81.073298,1,0
0,0,10,10,12,12,24,41,32,73,0.000333,0.111567,12,4016.427151,223.134842,334.702263,86.0391,1,0
0,0,11,11,11,13,24,48,36,84,0.000333,0.128379,10,3851.368501,213.964917,385.13685,86.159464,1,0
0,0,12,12,11,13,24,40,36,76,0.000333,0.116152,10,3484.571501,193.587306,348.45715,86.159464,1,0
0,0,10,10,10,12,22,39,32,71,0.000333,0.10554,10,3166.196449,175.899803,316.619645,76.238831,1,0
0,0,12,12,10,13,23,45,40,85,0.000333,0.128168,15,5767.541494,320.418972,384.502766,81.324997,1,0
0,0,14,14,10,14,24,51,48,99,0.000333,0.151304,15,6808.669314,378.259406,453.911288,86.52225,1,0
0,0,16,16,10,15,25,57,56,113,0.000333,0.174919,15,7871.336242,437.296458,524.755749,91.82264,1,0
0,0,11,11,11,11,22,43,34,77,0.000333,0.114459,15,5150.64352,286.146862,343.376235,76.107496,1,0
0,0,10,10,11,12,23,40,32,72,0.000333,0.108565,10,3256.964608,180.942478,325.696461,81.073298,1,0
0,0,11,11,11,13,24,45,35,80,0.000333,0.122266,10,3667.970001,203.776111,366.797,86.159464,1,0
0,0,12,12,11,14,25,54,39,93,0.000333,0.14396,10,4318.786256,239.93257,431.878626,91.356717,1,0
0,0,11,11,10,13,23,47,36,83,0.000333,0.125152,10,3754.556424,208.586468,375.455642,81.324997,1,0
0,0,13,13,10,15,25,54,42,96,0.000333,0.148603,10,4458.101942,247.67233,445.810194,91.82264,1,0
0,0,13,13,11,15,26,46,41,87,0.000333,0.136313,10,4089.382555,227.18792,408.938255,96.657107,1,0
0,0,12,12,10,17,27,39,42,81,0.000333,0.128382,10,3851.458877,213.969938,385.145888,102.706149,1,0
0,0,15,15,13,17,30,71,58,129,0.000333,0.210996,18,11393.79996,632.988887,632.988887,117.592585,1,0
0,0,15,15,13,16,29,61,49,110,0.000333,0.178126,18,9618.80237,534.377909,534.377909,112.105716,1,0
0,0,15,15,12,16,28,64,51,115,0.000333,0.184282,18,9951.224689,552.845816,552.845816,107.01955,1,0
0,0,8,8,11,9,20,34,23,57,0.000333,0.082117,10,2463.499014,136.861056,246.349901,66.583073,1,0
0,0,10,10,13,9,22,38,24,62,0.000333,0.092162,12,3317.817124,184.323174,276.48476,76.635041,2,0
0,0,9,9,12,9,21,37,24,61,0.000333,0.08931,12,3215.176353,178.620909,267.931363,71.548875,2,0
0,0,10,10,14,10,24,39,25,64,0.000333,0.097813,14,4108.126401,228.229244,293.4376,86.52225,2,0
0,0,9,9,12,10,22,37,25,62,0.000333,0.092162,12,3317.817124,184.323174,276.48476,76.238831,2,0
0,0,10,10,13,10,23,38,24,62,0.000333,0.093487,12,3365.530095,186.973894,280.460841,81.324997,2,0
0,0,9,9,12,10,22,37,24,61,0.000333,0.090675,12,3264.303945,181.350219,272.025329,76.238831,2,0
0,0,10,10,13,10,23,38,24,62,0.000333,0.093487,12,3365.530095,186.973894,280.460841,81.324997,2,0
0,0,9,9,12,10,22,37,24,61,0.000333,0.090675,12,3264.303945,181.350219,272.025329,76.238831,2,0
0,0,10,10,14,11,25,39,25,64,0.000333,0.099069,14,4160.895146,231.160841,297.206796,91.356717,2,0
0,0,9,9,12,11,23,37,25,62,0.000333,0.093487,12,3365.530095,186.973894,280.460841,81.073298,2,0
0,0,10,10,14,11,25,39,25,64,0.000333,0.099069,14,4160.895146,231.160841,297.206796,91.356717,2,0
0,0,9,9,12,11,23,37,25,62,0.000333,0.093487,12,3365.530095,186.973894,280.460841,81.073298,2,0
0,0,10,10,13,10,23,38,24,62,0.000333,0.093487,12,3365.530095,186.973894,280.460841,81.324997,2,0
0,0,9,9,12,10,22,37,24,61,0.000333,0.090675,12,3264.303945,181.350219,272.025329,76.238831,2,0
0,0,10,10,13,10,23,38,24,62,0.000333,0.093487,12,3365.530095,186.973894,280.460841,81.324997,2,0
0,0,9,9,12,10,22,37,24,61,0.000333,0.090675,12,3264.303945,181.350219,272.025329,76.238831,2,0
0,0,10,10,13,10,23,38,24,62,0.000333,0.093487,12,3365.530095,186.973894,280.460841,81.324997,2,0
0,0,9,9,12,10,22,37,24,61,0.000333,0.090675,12,3264.303945,181.350219,272.025329,76.238831,2,0
0,0,10,10,13,10,23,38,24,62,0.000333,0.093487,12,3365.530095,186.973894,280.460841,81.324997,2,0
0,0,9,9,12,10,22,37,24,61,0.000333,0.090675,12,3264.303945,181.350219,272.025329,76.238831,2,0
0,0,12,12,13,10,23,47,29,76,0.000333,0.114597,12,4125.488504,229.193806,343.790709,81.324997,2,0
0,0,10,10,14,11,25,39,25,64,0.000333,0.099069,14,4160.895146,231.160841,297.206796,91.356717,2,0
0,0,9,9,12,11,23,37,25,62,0.000333,0.093487,12,3365.530095,186.973894,280.460841,81.073298,2,0
0,0,10,10,14,11,25,39,25,64,0.000333,0.099069,14,4160.895146,231.160841,297.206796,91.356717,2,0
0,0,9,9,12,11,23,37,25,62,0.000333,0.093487,12,3365.530095,186.973894,280.460841,81.073298,2,0
0,0,10,10,14,10,24,39,24,63,0.000333,0.096284,14,4043.936926,224.663163,288.852638,86.52225,2,0
0,0,10,10,14,10,24,39,25,64,0.000333,0.097813,14,4108.126401,228.229244,293.4376,86.52225,2,0
0,0,9,9,12,9,21,37,24,61,0.000333,0.08931,12,3215.176353,178.620909,267.931363,71.548875,2,0
0,0,9,9,14,10,24,42,28,70,0.000333,0.106982,14,4493.263251,249.625736,320.947375,86.52225,2,0
0,0,10,10,13,9,22,37,25,62,0.000333,0.092162,12,3317.817124,184.323174,276.48476,76.635041,1,0
0,0,14,14,15,13,28,51,42,93,0.000333,0.149028,21,9388.764163,521.598009,447.084008,106.709075,2,0
0,0,13,13,14,13,27,50,42,92,0.000333,0.145817,21,9186.442654,510.357925,437.44965,101.408685,2,0
0,0,14,14,14,13,27,50,42,92,0.000333,0.145817,21,9186.442654,510.357925,437.44965,101.408685,2,0
0,0,13,13,13,13,26,49,42,91,0.000333,0.14258,18,7699.320258,427.740014,427.740014,96.211433,2,0
0,0,10,10,11,10,21,40,29,69,0.000333,0.101023,10,3030.699022,168.372168,303.069902,71.273029,1,0
0,0,13,13,12,11,23,55,37,92,0.000333,0.138723,18,7491.018599,416.1677,416.1677,81.073298,1,0
0,0,10,10,12,10,22,41,29,70,0.000333,0.104053,12,3745.92256,208.106809,312.160213,76.238831,1,0
0,0,11,11,12,13,25,42,32,74,0.000333,0.114548,12,4123.744297,229.096905,343.645358,91.125266,1,0
0,0,10,10,11,12,23,40,31,71,0.000333,0.107058,10,3211.728989,178.429388,321.172899,81.073298,1,0
0,0,11,11,13,11,24,45,33,78,0.000333,0.119209,18,6437.287351,357.627075,357.627075,86.159464,1,0
0,0,10,10,13,12,25,42,31,73,0.000333,0.113001,12,4068.018022,226.001001,339.001502,91.125266,1,0
0,0,11,11,12,13,25,49,35,84,0.000333,0.130028,12,4681.007039,260.055947,390.08392,91.125266,1,0
0,0,12,12,12,13,25,41,35,76,0.000333,0.117644,12,4235.196845,235.288714,352.93307,91.125266,1,0
0,0,10,10,11,12,23,40,31,71,0.000333,0.107058,10,3211.728989,178.429388,321.172899,81.073298,1,0
0,0,12,12,11,13,24,46,39,85,0.000333,0.129907,15,5845.827188,324.768177,389.721813,86.159464,1,0
0,0,14,14,11,14,25,52,47,99,0.000333,0.153247,15,6896.126442,383.118136,459.741763,91.356717,1,0
0,0,16,16,11,15,26,58,55,113,0.000333,0.17705,15,7967.245322,442.62474,531.149688,96.657107,1,0
0,0,11,11,12,11,23,44,33,77,0.000333,0.116105,18,6269.656871,348.314271,348.314271,81.073298,1,0
0,0,10,10,12,12,24,41,31,72,0.000333,0.110039,12,3961.407601,220.0782,330.1173,86.0391,1,0
0,0,11,11,12,13,25,46,34,80,0.000333,0.123836,12,4458.101942,247.67233,371.508495,91.125266,1,0
0,0,12,12,12,14,26,55,38,93,0.000333,0.145714,12,5245.690725,291.427263,437.140894,96.322519,1,0
0,0,11,11,11,13,24,48,35,83,0.000333,0.126851,10,3805.518876,211.417715,380.551888,86.159464,1,0
0,0,13,13,11,15,26,55,41,96,0.000333,0.150414,10,4512.422129,250.690118,451.242213,96.657107,1,0
0,0,13,13,12,15,27,47,40,87,0.000333,0.137892,12,4964.102552,275.783475,413.675213,101.622909,1,0
0,0,11,11,11,16,27,40,38,78,0.000333,0.123627,10,3708.812252,206.045125,370.881225,102.053748,1,0
0,0,15,15,14,17,31,72,57,129,0.000333,0.21303,21,13420.91781,745.606545,639.091324,122.789837,1,0
0,0,15,15,14,16,30,62,48,110,0.000333,0.179919,21,11334.91728,629.717626,539.757966,117.302969,1,0
0,0,15,15,13,16,29,65,50,115,0.000333,0.186223,18,10056.02066,558.667814,558.667814,112.105716,1,0
0,0,8,8,14,10,24,39,28,67,0.000333,0.102397,14,4300.694826,238.92749,307.192488,86.52225,2,0
0,0,10,10,16,10,26,43,29,72,0.000333,0.112811,16,5414.906555,300.828142,338.43166,97.219281,3,0
0,0,9,9,15,11,26,42,29,71,0.000333,0.111244,14,4672.23708,259.568727,333.73122,96.657107,3,0
0,0,10,10,17,11,28,44,30,74,0.000333,0.118581,16,5691.908228,316.217124,355.744264,107.540616,3,0
0,0,9,9,15,11,26,42,30,72,0.000333,0.112811,14,4738.043236,263.224624,338.43166,96.657107,3,0
0,0,5,5,10,9,19,25,17,42,0.000333,0.059471,5,892.064778,49.559154,178.412956,61.748606,1,0
0,0,5,5,10,9,19,25,17,42,0.000333,0.059471,5,892.064778,49.559154,178.412956,61.748606,1,0
0,0,5,5,10,9,19,25,17,42,0.000333,0.059471,5,892.064778,49.559154,178.412956,61.748606,1,0
0,0,5,5,10,9,19,25,17,42,0.000333,0.059471,5,892.064778,49.559154,178.412956,61.748606,1,0
0,0,5,5,10,9,19,25,17,42,0.000333,0.059471,5,892.064778,49.559154,178.412956,61.748606,1,0
0,0,5,5,10,9,19,25,17,42,0.000333,0.059471,5,892.064778,49.559154,178.412956,61.748606,1,0
0,0,5,5,10,9,19,25,17,42,0.000333,0.059471,5,892.064778,49.559154,178.412956,61.748606,1,0
0,0,5,5,10,9,19,25,17,42,0.000333,0.059471,5,892.064778,49.559154,178.412956,61.748606,1,0
0,0,5,5,10,9,19,25,17,42,0.000333,0.059471,5,892.064778,49.559154,178.412956,61.748606,1,0
0,0,5,5,10,9,19,25,17,42,0.000333,0.059471,5,892.064778,49.559154,178.412956,61.748606,1,0
0,0,5,5,10,9,19,25,17,42,0.000333,0.059471,5,892.064778,49.559154,178.412956,61.748606,1,0
0,0,5,5,10,9,19,25,17,42,0.000333,0.059471,5,892.064778,49.559154,178.412956,61.748606,1,0
0,0,5,5,10,9,19,25,17,42,0.000333,0.059471,5,892.064778,49.559154,178.412956,61.748606,1,0
0,0,5,5,10,9,19,25,17,42,0.000333,0.059471,5,892.064778,49.559154,178.412956,61.748606,1,0
0,0,5,5,10,9,19,25,17,42,0.000333,0.059471,5,892.064778,49.559154,178.412956,61.748606,1,0
0,0,5,5,10,9,19,25,17,42,0.000333,0.059471,5,892.064778,49.559154,178.412956,61.748606,1,0
0,0,5,5,10,9,19,25,17,42,0.000333,0.059471,5,892.064778,49.559154,178.412956,61.748606,1,0
0,0,5,5,10,9,19,25,17,42,0.000333,0.059471,5,892.064778,49.559154,178.412956,61.748606,1,0
0,0,5,5,10,9,19,25,17,42,0.000333,0.059471,5,892.064778,49.559154,178.412956,61.748606,1,0
0,0,5,5,10,9,19,25,17,42,0.000333,0.059471,5,892.064778,49.559154,178.412956,61.748606,1,0
0,0,5,5,10,9,19,25,17,42,0.000333,0.059471,5,892.064778,49.559154,178.412956,61.748606,1,0
0,0,5,5,10,9,19,25,17,42,0.000333,0.059471,5,892.064778,49.559154,178.412956,61.748606,1,0
0,0,5,5,10,9,19,25,17,42,0.000333,0.059471,5,892.064778,49.559154,178.412956,61.748606,1,0
0,0,5,5,10,9,19,25,17,42,0.000333,0.059471,5,892.064778,49.559154,178.412956,61.748606,1,0
0,0,5,5,10,9,19,25,17,42,0.000333,0.059471,5,892.064778,49.559154,178.412956,61.748606,1,0
0,0,5,5,10,9,19,25,17,42,0.000333,0.059471,5,892.064778,49.559154,178.412956,61.748606,1,0
0,0,5,5,10,9,19,25,17,42,0.000333,0.059471,5,892.064778,49.559154,178.412956,61.748606,1,0
0,0,5,5,10,9,19,25,17,42,0.000333,0.059471,5,892.064778,49.559154,178.412956,61.748606,1,0
0,0,5,5,10,9,19,25,17,42,0.000333,0.059471,5,892.064778,49.559154,178.412956,61.748606,1,0
0,0,5,5,10,9,19,25,17,42,0.000333,0.059471,5,892.064778,49.559154,178.412956,61.748606,1,0
0,0,9,9,12,12,24,40,34,74,0.000333,0.113096,12,4071.446701,226.191483,339.287225,86.0391,1,0
0,0,9,9,12,12,24,40,34,74,0.000333,0.113096,12,4071.446701,226.191483,339.287225,86.0391,1,0
0,0,9,9,11,15,26,39,43,82,0.000333,0.128479,10,3854.360569,214.131143,385.436057,96.657107,1,0
0,0,9,9,11,15,26,39,43,82,0.000333,0.128479,10,3854.360569,214.131143,385.436057,96.657107,1,0
0,0,7,7,10,10,20,31,23,54,0.000333,0.077795,10,2333.841171,129.657843,233.384117,66.438562,1,0
0,0,10,10,11,11,22,46,31,77,0.000333,0.114459,10,3433.762346,190.764575,343.376235,76.107496,1,0
0,0,7,7,11,15,26,30,26,56,0.000333,0.087742,5,1316.123121,73.117951,263.224624,96.657107,1,0
0,0,7,7,10,15,25,31,31,62,0.000333,0.095973,10,2879.190838,159.955047,287.919084,91.82264,1,0
0,0,9,9,12,11,23,40,31,71,0.000333,0.107058,12,3854.074787,214.115266,321.172899,81.073298,1,0
0,0,8,8,11,13,24,40,29,69,0.000333,0.105454,10,3163.624125,175.756896,316.362413,86.159464,1,0
0,0,9,9,11,17,28,32,35,67,0.000333,0.107364,10,3220.927798,178.940433,322.09278,107.540616,1,0
0,0,7,7,10,15,25,31,31,62,0.000333,0.095973,10,2879.190838,159.955047,287.919084,91.82264,1,0
0,0,9,9,10,16,26,37,45,82,0.000333,0.128479,10,3854.360569,214.131143,385.436057,97.219281,1,0
0,0,11,11,10,17,27,43,59,102,0.000333,0.161666,15,7274.977878,404.165438,484.998525,102.706149,1,0
0,0,13,13,10,18,28,49,73,122,0.000333,0.195499,20,11729.94601,651.663667,586.4973,108.277931,1,0
0,0,9,9,11,14,25,39,40,79,0.000333,0.122288,10,3668.64639,203.813688,366.864639,91.356717,1,0
0,0,8,8,11,16,27,37,34,71,0.000333,0.112532,10,3375.970127,187.553896,337.597013,102.053748,1,0
0,0,9,9,11,17,28,46,38,84,0.000333,0.134606,10,4038.178135,224.34323,403.817813,107.540616,1,0
0,0,8,8,10,16,26,39,35,74,0.000333,0.115944,10,3478.325391,193.2403,347.832539,97.219281,1,0
0,0,10,10,10,18,28,46,41,87,0.000333,0.139413,10,4182.398782,232.355488,418.239878,108.277931,1,0
0,0,10,10,11,18,29,38,46,84,0.000333,0.136023,10,4080.704036,226.70578,408.070404,113.112398,1,0
0,0,9,9,10,17,27,31,41,72,0.000333,0.114117,10,3423.519002,190.1955,342.3519,102.706149,1,0
0,0,8,8,14,18,32,38,39,77,0.000333,0.128333,14,5390,299.444444,385,128.361619,1,0
0,0,8,8,13,18,31,37,39,76,0.000333,0.125506,12,4518.227035,251.012613,376.51892,123.164366,1,0
0,0,5,5,10,9,19,25,17,42,0.000333,0.059471,5,892.064778,49.559154,178.412956,61.748606,1,0
0,0,5,5,10,9,19,25,17,42,0.000333,0.059471,5,892.064778,49.559154,178.412956,61.748606,1,0
0,0,5,5,10,9,19,25,17,42,0.000333,0.059471,5,892.064778,49.559154,178.412956,61.748606,1,0
0,0,5,5,10,9,19,25,17,42,0.000333,0.059471,5,892.064778,49.559154,178.412956,61.748606,1,0
0,0,5,5,10,9,19,25,17,42,0.000333,0.059471,5,892.064778,49.559154,178.412956,61.748606,1,0
0,0,5,5,10,9,19,25,17,42,0.000333,0.059471,5,892.064778,49.559154,178.412956,61.748606,1,0
0,0,5,5,10,9,19,25,17,42,0.000333,0.059471,5,892.064778,49.559154,178.412956,61.748606,1,0
0,0,5,5,10,9,19,25,17,42,0.000333,0.059471,5,892.064778,49.559154,178.412956,61.748606,1,0
0,0,5,5,10,9,19,25,17,42,0.000333,0.059471,5,892.064778,49.559154,178.412956,61.748606,1,0
0,0,5,5,10,9,19,25,17,42,0.000333,0.059471,5,892.064778,49.559154,178.412956,61.748606,1,0
0,0,5,5,10,9,19,25,17,42,0.000333,0.059471,5,892.064778,49.559154,178.412956,61.748606,1,0
0,0,5,5,10,9,19,25,17,42,0.000333,0.059471,5,892.064778,49.559154,178.412956,61.748606,1,0
0,0,5,5,10,9,19,25,17,42,0.000333,0.059471,5,892.064778,49.559154,178.412956,61.748606,1,0
0,0,5,5,10,9,19,25,17,42,0.000333,0.059471,5,892.064778,49.559154,178.412956,61.748606,1,0
0,0,5,5,10,9,19,25,17,42,0.000333,0.059471,5,892.064778,49.559154,178.412956,61.748606,1,0
0,0,5,5,10,9,19,25,17,42,0.000333,0.059471,5,892.064778,49.559154,178.412956,61.748606,1,0
0,0,5,5,10,9,19,25,17,42,0.000333,0.059471,5,892.064778,49.559154,178.412956,61.748606,1,0
0,0,5,5,10,9,19,25,17,42,0.000333,0.059471,5,892.064778,49.559154,178.412956,61.748606,1,0
0,0,5,5,10,9,19,25,17,42,0.000333,0.059471,5,892.064778,49.559154,178.412956,61.748606,1,0
0,0,5,5,10,9,19,25,17,42,0.000333,0.059471,5,892.064778,49.559154,178.412956,61.748606,1,0
0,0,5,5,10,9,19,25,17,42,0.000333,0.059471,5,892.064778,49.559154,178.412956,61.748606,1,0
0,0,5,5,10,9,19,25,17,42,0.000333,0.059471,5,892.064778,49.559154,178.412956,61.748606,1,0
0,0,5,5,10,9,19,25,17,42,0.000333,0.059471,5,892.064778,49.559154,178.412956,61.748606,1,0
0,0,5,5,10,9,19,25,17,42,0.000333,0.059471,5,892.064778,49.559154,178.412956,61.748606,1,0
0,0,5,5,10,9,19,25,17,42,0.000333,0.059471,5,892.064778,49.559154,178.412956,61.748606,1,0
0,0,5,5,10,9,19,25,17,42,0.000333,0.059471,5,892.064778,49.559154,178.412956,61.748606,1,0
0,0,5,5,10,9,19,25,17,42,0.000333,0.059471,5,892.064778,49.559154,178.412956,61.748606,1,0
0,0,5,5,10,9,19,25,17,42,0.000333,0.059471,5,892.064778,49.559154,178.412956,61.748606,1,0
0,0,5,5,10,9,19,25,17,42,0.000333,0.059471,5,892.064778,49.559154,178.412956,61.748606,1,0
0,0,5,5,10,9,19,25,17,42,0.000333,0.059471,5,892.064778,49.559154,178.412956,61.748606,1,0
0,0,5,5,10,9,19,25,17,42,0.000333,0.059471,5,892.064778,49.559154,178.412956,61.748606,1,0
0,0,9,9,12,12,24,40,34,74,0.000333,0.113096,12,4071.446701,226.191483,339.287225,86.0391,1,0
0,0,9,9,12,12,24,40,34,74,0.000333,0.113096,12,4071.446701,226.191483,339.287225,86.0391,1,0
0,0,9,9,11,15,26,39,43,82,0.000333,0.128479,10,3854.360569,214.131143,385.436057,96.657107,1,0
0,0,9,9,11,15,26,39,43,82,0.000333,0.128479,10,3854.360569,214.131143,385.436057,96.657107,1,0
0,0,7,7,10,10,20,31,23,54,0.000333,0.077795,10,2333.841171,129.657843,233.384117,66.438562,1,0
0,0,10,10,11,11,22,46,31,77,0.000333,0.114459,10,3433.762346,190.764575,343.376235,76.107496,1,0
0,0,7,7,11,15,26,30,26,56,0.000333,0.087742,5,1316.123121,73.117951,263.224624,96.657107,1,0
0,0,7,7,10,15,25,31,31,62,0.000333,0.095973,10,2879.190838,159.955047,287.919084,91.82264,1,0
0,0,9,9,12,11,23,40,31,71,0.000333,0.107058,12,3854.074787,214.115266,321.172899,81.073298,1,0
0,0,8,8,11,13,24,40,29,69,0.000333,0.105454,10,3163.624125,175.756896,316.362413,86.159464,1,0
0,0,9,9,11,17,28,32,35,67,0.000333,0.107364,10,3220.927798,178.940433,322.09278,107.540616,1,0
0,0,7,7,10,15,25,31,31,62,0.000333,0.095973,10,2879.190838,159.955047,287.919084,91.82264,1,0
0,0,9,9,10,16,26,37,45,82,0.000333,0.128479,10,3854.360569,214.131143,385.436057,97.219281,1,0
0,0,11,11,10,17,27,43,59,102,0.000333,0.161666,15,7274.977878,404.165438,484.998525,102.706149,1,0
0,0,13,13,10,18,28,49,73,122,0.000333,0.195499,20,11729.94601,651.663667,586.4973,108.277931,1,0
0,0,9,9,11,14,25,39,40,79,0.000333,0.122288,10,3668.64639,203.813688,366.864639,91.356717,1,0
0,0,8,8,11,16,27,37,34,71,0.000333,0.112532,10,3375.970127,187.553896,337.597013,102.053748,1,0
0,0,9,9,11,17,28,46,38,84,0.000333,0.134606,10,4038.178135,224.34323,403.817813,107.540616,1,0
0,0,8,8,10,16,26,39,35,74,0.000333,0.115944,10,3478.325391,193.2403,347.832539,97.219281,1,0
0,0,9,9,10,17,27,42,38,80,0.000333,0.126797,10,3803.910002,211.328333,380.391,102.706149,1,0
0,0,10,10,11,18,29,38,46,84,0.000333,0.136023,10,4080.704036,226.70578,408.070404,113.112398,1,0
0,0,9,9,10,17,27,31,41,72,0.000333,0.114117,10,3423.519002,190.1955,342.3519,102.706149,1,0
0,0,8,8,14,18,32,38,39,77,0.000333,0.128333,14,5390,299.444444,385,128.361619,1,0
0,0,8,8,13,18,31,37,39,76,0.000333,0.125506,12,4518.227035,251.012613,376.51892,123.164366,1,0
0,0,5,5,8,9,17,21,16,37,0.000333,0.050412,4,604.944501,33.608028,151.236125,52.529325,1,0
0,0,5,5,8,9,17,21,16,37,0.000333,0.050412,4,604.944501,33.608028,151.236125,52.529325,1,0
0,0,5,5,8,9,17,21,16,37,0.000333,0.050412,4,604.944501,33.608028,151.236125,52.529325,1,0
0,0,5,5,8,9,17,21,16,37,0.000333,0.050412,4,604.944501,33.608028,151.236125,52.529325,1,0
0,0,5,5,8,9,17,21,16,37,0.000333,0.050412,4,604.944501,33.608028,151.236125,52.529325,1,0
0,0,5,5,8,9,17,21,16,37,0.000333,0.050412,4,604.944501,33.608028,151.236125,52.529325,1,0
0,0,5,5,8,9,17,21,16,37,0.000333,0.050412,4,604.944501,33.608028,151.236125,52.529325,1,0
0,0,5,5,8,9,17,21,16,37,0.000333,0.050412,4,604.944501,33.608028,151.236125,52.529325,1,0
0,0,5,5,8,9,17,21,16,37,0.000333,0.050412,4,604.944501,33.608028,151.236125,52.529325,1,0
0,0,5,5,8,9,17,21,16,37,0.000333,0.050412,4,604.944501,33.608028,151.236125,52.529325,1,0
0,0,5,5,8,9,17,21,16,37,0.000333,0.050412,4,604.944501,33.608028,151.236125,52.529325,1,0
0,0,5,5,8,9,17,21,16,37,0.000333,0.050412,4,604.944501,33.608028,151.236125,52.529325,1,0
0,0,5,5,8,9,17,21,16,37,0.000333,0.050412,4,604.944501,33.608028,151.236125,52.529325,1,0
0,0,5,5,8,9,17,21,16,37,0.000333,0.050412,4,604.944501,33.608028,151.236125,52.529325,1,0
0,0,5,5,8,9,17,21,16,37,0.000333,0.050412,4,604.944501,33.608028,151.236125,52.529325,1,0
0,0,5,5,8,9,17,21,16,37,0.000333,0.050412,4,604.944501,33.608028,151.236125,52.529325,1,0
0,0,5,5,8,9,17,21,16,37,0.000333,0.050412,4,604.944501,33.608028,151.236125,52.529325,1,0
0,0,5,5,8,9,17,21,16,37,0.000333,0.050412,4,604.944501,33.608028,151.236125,52.529325,1,0
0,0,5,5,8,9,17,21,16,37,0.000333,0.050412,4,604.944501,33.608028,151.236125,52.529325,1,0
0,0,5,5,8,9,17,21,16,37,0.000333,0.050412,4,604.944501,33.608028,151.236125,52.529325,1,0
0,0,5,5,8,9,17,21,16,37,0.000333,0.050412,4,604.944501,33.608028,151.236125,52.529325,1,0
0,0,5,5,8,9,17,21,16,37,0.000333,0.050412,4,604.944501,33.608028,151.236125,52.529325,1,0
0,0,5,5,8,9,17,21,16,37,0.000333,0.050412,4,604.944501,33.608028,151.236125,52.529325,1,0
0,0,5,5,8,9,17,21,16,37,0.000333,0.050412,4,604.944501,33.608028,151.236125,52.529325,1,0
0,0,5,5,8,9,17,21,16,37,0.000333,0.050412,4,604.944501,33.608028,151.236125,52.529325,1,0
0,0,5,5,8,9,17,21,16,37,0.000333,0.050412,4,604.944501,33.608028,151.236125,52.529325,1,0
0,0,5,5,8,9,17,21,16,37,0.000333,0.050412,4,604.944501,33.608028,151.236125,52.529325,1,0
0,0,5,5,8,9,17,21,16,37,0.000333,0.050412,4,604.944501,33.608028,151.236125,52.529325,1,0
0,0,5,5,8,9,17,21,16,37,0.000333,0.050412,4,604.944501,33.608028,151.236125,52.529325,1,0
0,0,5,5,8,9,17,21,16,37,0.000333,0.050412,4,604.944501,33.608028,151.236125,52.529325,1,0
0,0,5,5,8,9,17,21,16,37,0.000333,0.050412,4,604.944501,33.608028,151.236125,52.529325,1,0
0,0,9,9,11,12,23,36,33,69,0.000333,0.104042,10,3121.25775,173.403208,312.125775,81.073298,1,0
0,0,9,9,11,12,23,36,33,69,0.000333,0.104042,10,3121.25775,173.403208,312.125775,81.073298,1,0
0,0,9,9,10,15,25,35,42,77,0.000333,0.119192,10,3575.769266,198.653848,357.576927,91.82264,1,0
0,0,9,9,10,15,25,35,42,77,0.000333,0.119192,10,3575.769266,198.653848,357.576927,91.82264,1,0
0,0,7,7,9,10,19,27,22,49,0.000333,0.069383,8,1665.187585,92.510421,208.148448,61.748606,1,0
0,0,10,10,10,11,21,42,30,72,0.000333,0.105416,10,3162.468544,175.692697,316.246854,71.273029,1,0
0,0,8,8,10,16,26,29,28,57,0.000333,0.089308,5,1339.62532,74.423629,267.925064,97.219281,1,0
0,0,7,7,9,15,24,27,30,57,0.000333,0.087114,8,2090.7429,116.152383,261.342863,87.132684,1,0
0,0,8,8,11,11,22,32,26,58,0.000333,0.086216,10,2586.470339,143.692797,258.647034,76.107496,1,0
0,0,8,8,10,13,23,36,28,64,0.000333,0.096503,10,2895.079652,160.837758,289.507965,81.324997,1,0
0,0,9,9,10,17,27,28,34,62,0.000333,0.098268,10,2948.030251,163.779458,294.803025,102.706149,1,0
0,0,7,7,9,15,24,27,30,57,0.000333,0.087114,8,2090.7429,116.152383,261.342863,87.132684,1,0
0,0,9,9,9,16,25,33,44,77,0.000333,0.119192,8,2860.615413,158.923078,357.576927,92.529325,1,0
0,0,11,11,9,17,26,39,58,97,0.000333,0.151981,12,5471.311832,303.961768,455.942653,98.016193,1,0
0,0,13,13,9,18,27,45,72,117,0.000333,0.185441,16,8901.149404,494.5083,556.321838,103.587975,1,0
0,0,9,9,10,14,24,35,39,74,0.000333,0.113096,10,3392.872251,188.492903,339.287225,86.52225,1,0
0,0,8,8,10,16,26,33,33,66,0.000333,0.10341,10,3102.290214,172.349456,310.229021,97.219281,1,0
0,0,9,9,10,17,27,42,37,79,0.000333,0.125212,10,3756.361127,208.686729,375.636113,102.706149,1,0
0,0,8,8,9,16,25,35,34,69,0.000333,0.106809,8,2563.408617,142.41159,320.426077,92.529325,1,0
0,0,10,10,9,18,27,42,40,82,0.000333,0.129967,8,3119.206201,173.289233,389.900775,103.587975,1,0
0,0,10,10,10,18,28,34,45,79,0.000333,0.126594,10,3797.810388,210.989466,379.781039,108.277931,1,0
0,0,9,9,9,17,26,27,40,67,0.000333,0.104976,8,2519.435689,139.968649,314.929461,98.016193,1,0
0,0,8,8,13,18,31,34,38,72,0.000333,0.118901,12,4280.425612,237.801423,356.702134,123.164366,1,0
0,0,8,8,12,18,30,33,38,71,0.000333,0.11613,12,4180.670787,232.259488,348.389232,118.0782,1,0
0,0,5,5,8,9,17,21,16,37,0.000333,0.050412,4,604.944501,33.608028,151.236125,52.529325,1,0
0,0,5,5,8,9,17,21,16,37,0.000333,0.050412,4,604.944501,33.608028,151.236125,52.529325,1,0
0,0,5,5,8,9,17,21,16,37,0.000333,0.050412,4,604.944501,33.608028,151.236125,52.529325,1,0
0,0,5,5,8,9,17,21,16,37,0.000333,0.050412,4,604.944501,33.608028,151.236125,52.529325,1,0
0,0,5,5,8,9,17,21,16,37,0.000333,0.050412,4,604.944501,33.608028,151.236125,52.529325,1,0
0,0,5,5,8,9,17,21,16,37,0.000333,0.050412,4,604.944501,33.608028,151.236125,52.529325,1,0
0,0,5,5,8,9,17,21,16,37,0.000333,0.050412,4,604.944501,33.608028,151.236125,52.529325,1,0
0,0,5,5,8,9,17,21,16,37,0.000333,0.050412,4,604.944501,33.608028,151.236125,52.529325,1,0
0,0,5,5,8,9,17,21,16,37,0.000333,0.050412,4,604.944501,33.608028,151.236125,52.529325,1,0
0,0,5,5,8,9,17,21,16,37,0.000333,0.050412,4,604.944501,33.608028,151.236125,52.529325,1,0
0,0,5,5,8,9,17,21,16,37,0.000333,0.050412,4,604.944501,33.608028,151.236125,52.529325,1,0
0,0,5,5,8,9,17,21,16,37,0.000333,0.050412,4,604.944501,33.608028,151.236125,52.529325,1,0
0,0,5,5,8,9,17,21,16,37,0.000333,0.050412,4,604.944501,33.608028,151.236125,52.529325,1,0
0,0,5,5,8,9,17,21,16,37,0.000333,0.050412,4,604.944501,33.608028,151.236125,52.529325,1,0
0,0,5,5,8,9,17,21,16,37,0.000333,0.050412,4,604.944501,33.608028,151.236125,52.529325,1,0
0,0,5,5,8,9,17,21,16,37,0.000333,0.050412,4,604.944501,33.608028,151.236125,52.529325,1,0
0,0,5,5,8,9,17,21,16,37,0.000333,0.050412,4,604.944501,33.608028,151.236125,52.529325,1,0
0,0,5,5,8,9,17,21,16,37,0.000333,0.050412,4,604.944501,33.608028,151.236125,52.529325,1,0
0,0,5,5,8,9,17,21,16,37,0.000333,0.050412,4,604.944501,33.608028,151.236125,52.529325,1,0
0,0,5,5,8,9,17,21,16,37,0.000333,0.050412,4,604.944501,33.608028,151.236125,52.529325,1,0
0,0,5,5,8,9,17,21,16,37,0.000333,0.050412,4,604.944501,33.608028,151.236125,52.529325,1,0
0,0,5,5,8,9,17,21,16,37,0.000333,0.050412,4,604.944501,33.608028,151.236125,52.529325,1,0
0,0,5,5,8,9,17,21,16,37,0.000333,0.050412,4,604.944501,33.608028,151.236125,52.529325,1,0
0,0,5,5,8,9,17,21,16,37,0.000333,0.050412,4,604.944501,33.608028,151.236125,52.529325,1,0
0,0,5,5,8,9,17,21,16,37,0.000333,0.050412,4,604.944501,33.608028,151.236125,52.529325,1,0
0,0,5,5,8,9,17,21,16,37,0.000333,0.050412,4,604.944501,33.608028,151.236125,52.529325,1,0
0,0,5,5,8,9,17,21,16,37,0.000333,0.050412,4,604.944501,33.608028,151.236125,52.529325,1,0
0,0,5,5,8,9,17,21,16,37,0.000333,0.050412,4,604.944501,33.608028,151.236125,52.529325,1,0
0,0,5,5,8,9,17,21,16,37,0.000333,0.050412,4,604.944501,33.608028,151.236125,52.529325,1,0
0,0,5,5,8,9,17,21,16,37,0.000333,0.050412,4,604.944501,33.608028,151.236125,52.529325,1,0
0,0,5,5,8,9,17,21,16,37,0.000333,0.050412,4,604.944501,33.608028,151.236125,52.529325,1,0
0,0,9,9,11,12,23,36,33,69,0.000333,0.104042,10,3121.25775,173.403208,312.125775,81.073298,1,0
0,0,9,9,11,12,23,36,33,69,0.000333,0.104042,10,3121.25775,173.403208,312.125775,81.073298,1,0
0,0,9,9,10,15,25,35,42,77,0.000333,0.119192,10,3575.769266,198.653848,357.576927,91.82264,1,0
0,0,9,9,10,15,25,35,42,77,0.000333,0.119192,10,3575.769266,198.653848,357.576927,91.82264,1,0
0,0,7,7,9,10,19,27,22,49,0.000333,0.069383,8,1665.187585,92.510421,208.148448,61.748606,1,0
0,0,10,10,10,11,21,42,30,72,0.000333,0.105416,10,3162.468544,175.692697,316.246854,71.273029,1,0
0,0,8,8,10,16,26,29,28,57,0.000333,0.089308,5,1339.62532,74.423629,267.925064,97.219281,1,0
0,0,7,7,9,15,24,27,30,57,0.000333,0.087114,8,2090.7429,116.152383,261.342863,87.132684,1,0
0,0,9,9,11,11,22,36,30,66,0.000333,0.098107,10,2943.224868,163.512493,294.322487,76.107496,1,0
0,0,8,8,10,13,23,36,28,64,0.000333,0.096503,10,2895.079652,160.837758,289.507965,81.324997,1,0
0,0,9,9,10,17,27,28,34,62,0.000333,0.098268,10,2948.030251,163.779458,294.803025,102.706149,1,0
0,0,7,7,9,15,24,27,30,57,0.000333,0.087114,8,2090.7429,116.152383,261.342863,87.132684,1,0
0,0,9,9,9,16,25,33,44,77,0.000333,0.119192,8,2860.615413,158.923078,357.576927,92.529325,1,0
0,0,11,11,9,17,26,39,58,97,0.000333,0.151981,12,5471.311832,303.961768,455.942653,98.016193,1,0
0,0,13,13,9,18,27,45,72,117,0.000333,0.185441,16,8901.149404,494.5083,556.321838,103.587975,1,0
0,0,9,9,10,14,24,35,39,74,0.000333,0.113096,10,3392.872251,188.492903,339.287225,86.52225,1,0
0,0,8,8,10,16,26,33,33,66,0.000333,0.10341,10,3102.290214,172.349456,310.229021,97.219281,1,0
0,0,9,9,10,17,27,42,37,79,0.000333,0.125212,10,3756.361127,208.686729,375.636113,102.706149,1,0
0,0,8,8,9,16,25,35,34,69,0.000333,0.106809,8,2563.408617,142.41159,320.426077,92.529325,1,0
0,0,10,10,9,18,27,42,40,82,0.000333,0.129967,8,3119.206201,173.289233,389.900775,103.587975,1,0
0,0,10,10,10,18,28,34,45,79,0.000333,0.126594,10,3797.810388,210.989466,379.781039,108.277931,1,0
0,0,9,9,9,17,26,27,40,67,0.000333,0.104976,8,2519.435689,139.968649,314.929461,98.016193,1,0
0,0,8,8,13,18,31,34,38,72,0.000333,0.118901,12,4280.425612,237.801423,356.702134,123.164366,1,0
0,0,8,8,12,18,30,33,38,71,0.000333,0.11613,12,4180.670787,232.259488,348.389232,118.0782,1,0
0,0,5,5,9,9,18,23,16,39,0.000333,0.054209,4,650.5083,36.13935,162.627075,57.05865,1,0
0,0,5,5,9,9,18,23,16,39,0.000333,0.054209,4,650.5083,36.13935,162.627075,57.05865,1,0
0,0,5,5,9,9,18,23,16,39,0.000333,0.054209,4,650.5083,36.13935,162.627075,57.05865,1,0
0,0,5,5,9,9,18,23,16,39,0.000333,0.054209,4,650.5083,36.13935,162.627075,57.05865,1,0
0,0,5,5,9,9,18,23,16,39,0.000333,0.054209,4,650.5083,36.13935,162.627075,57.05865,1,0
0,0,5,5,9,9,18,23,16,39,0.000333,0.054209,4,650.5083,36.13935,162.627075,57.05865,1,0
0,0,5,5,9,9,18,23,16,39,0.000333,0.054209,4,650.5083,36.13935,162.627075,57.05865,1,0
0,0,5,5,9,9,18,23,16,39,0.000333,0.054209,4,650.5083,36.13935,162.627075,57.05865,1,0
0,0,5,5,9,9,18,23,16,39,0.000333,0.054209,4,650.5083,36.13935,162.627075,57.05865,1,0
0,0,5,5,9,9,18,23,16,39,0.000333,0.054209,4,650.5083,36.13935,162.627075,57.05865,1,0
0,0,5,5,9,9,18,23,16,39,0.000333,0.054209,4,650.5083,36.13935,162.627075,57.05865,1,0
0,0,5,5,9,9,18,23,16,39,0.000333,0.054209,4,650.5083,36.13935,162.627075,57.05865,1,0
0,0,5,5,9,9,18,23,16,39,0.000333,0.054209,4,650.5083,36.13935,162.627075,57.05865,1,0
0,0,5,5,9,9,18,23,16,39,0.000333,0.054209,4,650.5083,36.13935,162.627075,57.05865,1,0
0,0,5,5,9,9,18,23,16,39,0.000333,0.054209,4,650.5083,36.13935,162.627075,57.05865,1,0
0,0,5,5,9,9,18,23,16,39,0.000333,0.054209,4,650.5083,36.13935,162.627075,57.05865,1,0
0,0,5,5,9,9,18,23,16,39,0.000333,0.054209,4,650.5083,36.13935,162.627075,57.05865,1,0
0,0,5,5,9,9,18,23,16,39,0.000333,0.054209,4,650.5083,36.13935,162.627075,57.05865,1,0
0,0,5,5,9,9,18,23,16,39,0.000333,0.054209,4,650.5083,36.13935,162.627075,57.05865,1,0
0,0,5,5,9,9,18,23,16,39,0.000333,0.054209,4,650.5083,36.13935,162.627075,57.05865,1,0
0,0,5,5,9,9,18,23,16,39,0.000333,0.054209,4,650.5083,36.13935,162.627075,57.05865,1,0
0,0,5,5,9,9,18,23,16,39,0.000333,0.054209,4,650.5083,36.13935,162.627075,57.05865,1,0
0,0,5,5,9,9,18,23,16,39,0.000333,0.054209,4,650.5083,36.13935,162.627075,57.05865,1,0
0,0,5,5,9,9,18,23,16,39,0.000333,0.054209,4,650.5083,36.13935,162.627075,57.05865,1,0
0,0,5,5,9,9,18,23,16,39,0.000333,0.054209,4,650.5083,36.13935,162.627075,57.05865,1,0
0,0,5,5,9,9,18,23,16,39,0.000333,0.054209,4,650.5083,36.13935,162.627075,57.05865,1,0
0,0,5,5,9,9,18,23,16,39,0.000333,0.054209,4,650.5083,36.13935,162.627075,57.05865,1,0
0,0,5,5,9,9,18,23,16,39,0.000333,0.054209,4,650.5083,36.13935,162.627075,57.05865,1,0
0,0,5,5,9,9,18,23,16,39,0.000333,0.054209,4,650.5083,36.13935,162.627075,57.05865,1,0
0,0,5,5,9,9,18,23,16,39,0.000333,0.054209,4,650.5083,36.13935,162.627075,57.05865,1,0
0,0,5,5,9,9,18,23,16,39,0.000333,0.054209,4,650.5083,36.13935,162.627075,57.05865,1,0
0,0,9,9,12,12,24,38,33,71,0.000333,0.108511,12,3906.388051,217.021558,325.532338,86.0391,1,0
0,0,9,9,12,12,24,38,33,71,0.000333,0.108511,12,3906.388051,217.021558,325.532338,86.0391,1,0
0,0,9,9,11,15,26,37,42,79,0.000333,0.123778,10,3713.347377,206.297077,371.334738,96.657107,1,0
0,0,9,9,11,15,26,37,42,79,0.000333,0.123778,10,3713.347377,206.297077,371.334738,96.657107,1,0
0,0,7,7,10,10,20,29,22,51,0.000333,0.073473,10,2204.183328,122.454629,220.418333,66.438562,1,0
0,0,10,10,11,11,22,44,30,74,0.000333,0.109999,10,3299.979398,183.332189,329.99794,76.107496,1,0
0,0,8,8,11,16,27,31,28,59,0.000333,0.093513,5,1402.691813,77.927323,280.538363,102.053748,1,0
0,0,7,7,10,15,25,29,30,59,0.000333,0.091329,10,2739.875152,152.215286,273.987515,91.82264,1,0
0,0,9,9,12,11,23,38,30,68,0.000333,0.102534,12,3691.226556,205.068142,307.602213,81.073298,1,0
0,0,8,8,11,13,24,38,28,66,0.000333,0.100869,10,3026.07525,168.115292,302.607525,86.159464,1,0
0,0,9,9,11,17,28,30,34,64,0.000333,0.102557,10,3076.70715,170.928175,307.670715,107.540616,1,0
0,0,7,7,10,15,25,29,30,59,0.000333,0.091329,10,2739.875152,152.215286,273.987515,91.82264,1,0
0,0,9,9,10,16,26,35,44,79,0.000333,0.123778,10,3713.347377,206.297077,371.334738,97.219281,1,0
0,0,11,11,10,17,27,41,58,99,0.000333,0.156911,15,7061.007941,392.278219,470.733863,102.706149,1,0
0,0,13,13,10,18,28,47,72,119,0.000333,0.190692,20,11441.50471,635.639151,572.075236,108.277931,1,0
0,0,9,9,11,14,25,37,39,76,0.000333,0.117644,10,3529.330704,196.073928,352.93307,91.356717,1,0
0,0,8,8,11,16,27,35,33,68,0.000333,0.107777,10,3233.323501,179.629083,323.33235,102.053748,1,0
0,0,9,9,11,17,28,44,37,81,0.000333,0.129799,10,3893.957487,216.330971,389.395749,107.540616,1,0
0,0,8,8,10,16,26,37,34,71,0.000333,0.111244,10,3337.3122,185.406233,333.73122,97.219281,1,0
0,0,10,10,10,18,28,44,40,84,0.000333,0.134606,10,4038.178135,224.34323,403.817813,108.277931,1,0
0,0,10,10,11,18,29,36,45,81,0.000333,0.131165,10,3934.964606,218.609145,393.496461,113.112398,1,0
0,0,9,9,10,17,27,29,40,69,0.000333,0.109362,10,3280.872376,182.270688,328.087238,102.706149,1,0
0,0,8,8,14,18,32,36,38,74,0.000333,0.123333,14,5180,287.777778,370,128.361619,1,0
0,0,8,8,13,18,31,35,38,73,0.000333,0.120552,12,4339.875968,241.10422,361.656331,123.164366,1,0
0,0,5,5,10,10,20,30,19,49,0.000333,0.070591,5,1058.872383,58.826244,211.774477,66.438562,1,0
0,0,5,5,10,10,20,30,19,49,0.000333,0.070591,5,1058.872383,58.826244,211.774477,66.438562,1,0
0,0,5,5,10,10,20,30,19,49,0.000333,0.070591,5,1058.872383,58.826244,211.774477,66.438562,1,0
0,0,5,5,10,10,20,30,19,49,0.000333,0.070591,5,1058.872383,58.826244,211.774477,66.438562,1,0
0,0,5,5,10,10,20,30,19,49,0.000333,0.070591,5,1058.872383,58.826244,211.774477,66.438562,1,0
0,0,5,5,10,10,20,30,19,49,0.000333,0.070591,5,1058.872383,58.826244,211.774477,66.438562,1,0
0,0,5,5,10,10,20,30,19,49,0.000333,0.070591,5,1058.872383,58.826244,211.774477,66.438562,1,0
0,0,5,5,10,10,20,30,19,49,0.000333,0.070591,5,1058.872383,58.826244,211.774477,66.438562,1,0
0,0,5,5,10,10,20,30,19,49,0.000333,0.070591,5,1058.872383,58.826244,211.774477,66.438562,1,0
0,0,5,5,10,10,20,30,19,49,0.000333,0.070591,5,1058.872383,58.826244,211.774477,66.438562,1,0
0,0,5,5,10,10,20,30,19,49,0.000333,0.070591,5,1058.872383,58.826244,211.774477,66.438562,1,0
0,0,5,5,10,10,20,30,19,49,0.000333,0.070591,5,1058.872383,58.826244,211.774477,66.438562,1,0
0,0,5,5,10,10,20,30,19,49,0.000333,0.070591,5,1058.872383,58.826244,211.774477,66.438562,1,0
0,0,5,5,10,10,20,30,19,49,0.000333,0.070591,5,1058.872383,58.826244,211.774477,66.438562,1,0
0,0,5,5,10,10,20,30,19,49,0.000333,0.070591,5,1058.872383,58.826244,211.774477,66.438562,1,0
0,0,5,5,10,10,20,30,19,49,0.000333,0.070591,5,1058.872383,58.826244,211.774477,66.438562,1,0
0,0,5,5,10,10,20,30,19,49,0.000333,0.070591,5,1058.872383,58.826244,211.774477,66.438562,1,0
0,0,5,5,10,10,20,30,19,49,0.000333,0.070591,5,1058.872383,58.826244,211.774477,66.438562,1,0
0,0,5,5,10,10,20,30,19,49,0.000333,0.070591,5,1058.872383,58.826244,211.774477,66.438562,1,0
0,0,5,5,10,10,20,30,19,49,0.000333,0.070591,5,1058.872383,58.826244,211.774477,66.438562,1,0
0,0,5,5,10,10,20,30,19,49,0.000333,0.070591,5,1058.872383,58.826244,211.774477,66.438562,1,0
0,0,5,5,10,10,20,30,19,49,0.000333,0.070591,5,1058.872383,58.826244,211.774477,66.438562,1,0
0,0,5,5,10,10,20,30,19,49,0.000333,0.070591,5,1058.872383,58.826244,211.774477,66.438562,1,0
0,0,5,5,10,10,20,30,19,49,0.000333,0.070591,5,1058.872383,58.826244,211.774477,66.438562,1,0
0,0,5,5,10,10,20,30,19,49,0.000333,0.070591,5,1058.872383,58.826244,211.774477,66.438562,1,0
0,0,5,5,10,10,20,30,19,49,0.000333,0.070591,5,1058.872383,58.826244,211.774477,66.438562,1,0
0,0,5,5,10,10,20,30,19,49,0.000333,0.070591,5,1058.872383,58.826244,211.774477,66.438562,1,0
0,0,5,5,10,10,20,30,19,49,0.000333,0.070591,5,1058.872383,58.826244,211.774477,66.438562,1,0
0,0,5,5,10,10,20,30,19,49,0.000333,0.070591,5,1058.872383,58.826244,211.774477,66.438562,1,0
0,0,5,5,10,10,20,30,19,49,0.000333,0.070591,5,1058.872383,58.826244,211.774477,66.438562,1,0
0,0,5,5,10,10,20,30,19,49,0.000333,0.070591,5,1058.872383,58.826244,211.774477,66.438562,1,0
0,0,9,9,12,13,25,45,36,81,0.000333,0.125384,12,4513.828216,250.768234,376.152351,91.125266,1,0
0,0,9,9,12,13,25,45,36,81,0.000333,0.125384,12,4513.828216,250.768234,376.152351,91.125266,1,0
0,0,9,9,11,16,27,44,45,89,0.000333,0.141062,10,4231.849877,235.102771,423.184988,102.053748,1,0
0,0,9,9,11,16,27,44,45,89,0.000333,0.141062,10,4231.849877,235.102771,423.184988,102.053748,1,0
0,0,7,7,10,11,21,36,25,61,0.000333,0.08931,10,2679.313628,148.850757,267.931363,71.273029,1,0
0,0,10,10,11,12,23,51,33,84,0.000333,0.12666,10,3799.792043,211.099558,379.979204,81.073298,1,0
0,0,8,8,11,17,28,38,31,69,0.000333,0.110569,5,1658.537448,92.140969,331.70749,107.540616,1,0
0,0,7,7,10,16,26,36,33,69,0.000333,0.10811,10,3243.303406,180.183523,324.330341,97.219281,1,0
0,0,9,9,12,12,24,45,33,78,0.000333,0.119209,12,4291.524901,238.41805,357.627075,86.0391,1,0
0,0,8,8,11,14,25,45,31,76,0.000333,0.117644,10,3529.330704,196.073928,352.93307,91.356717,1,0
0,0,9,9,11,18,29,37,37,74,0.000333,0.11983,10,3594.905936,199.716996,359.490594,113.112398,1,0
0,0,7,7,10,16,26,36,33,69,0.000333,0.10811,10,3243.303406,180.183523,324.330341,97.219281,1,0
0,0,9,9,10,17,27,42,47,89,0.000333,0.141062,10,4231.849877,235.102771,423.184988,102.706149,1,0
0,0,11,11,10,18,28,48,61,109,0.000333,0.174667,15,7860.025298,436.668072,524.001687,108.277931,1,0
0,0,13,13,10,19,29,54,75,129,0.000333,0.208893,15,9400.193226,522.232957,626.679548,113.929904,1,0
0,0,9,9,11,15,26,44,42,86,0.000333,0.134746,10,4042.378158,224.576564,404.237816,96.657107,1,0
0,0,8,8,11,17,28,42,36,78,0.000333,0.124991,10,3749.736839,208.318713,374.973684,107.540616,1,0
0,0,9,9,11,18,29,51,40,91,0.000333,0.147359,10,4420.762706,245.597928,442.076271,113.112398,1,0
0,0,8,8,10,17,27,44,37,81,0.000333,0.128382,10,3851.458877,213.969938,385.145888,102.706149,1,0
0,0,10,10,10,19,29,51,43,94,0.000333,0.152217,10,4566.502135,253.694563,456.650214,113.929904,1,0
0,0,10,10,11,19,30,43,48,91,0.000333,0.148842,10,4465.270442,248.07058,446.527044,118.764371,1,0
0,0,9,9,10,18,28,36,43,79,0.000333,0.126594,10,3797.810388,210.989466,379.781039,108.277931,1,0
0,0,8,8,14,19,33,43,41,84,0.000333,0.141243,14,5932.207484,329.567082,423.729106,134.013592,1,0
0,0,8,8,13,19,32,42,41,83,0.000333,0.138333,12,4980,276.666667,415,128.816339,1,0
0,0,5,5,10,10,20,30,19,49,0.000333,0.070591,5,1058.872383,58.826244,211.774477,66.438562,1,0
0,0,5,5,10,10,20,30,19,49,0.000333,0.070591,5,1058.872383,58.826244,211.774477,66.438562,1,0
0,0,5,5,10,10,20,30,19,49,0.000333,0.070591,5,1058.872383,58.826244,211.774477,66.438562,1,0
0,0,5,5,10,10,20,30,19,49,0.000333,0.070591,5,1058.872383,58.826244,211.774477,66.438562,1,0
0,0,5,5,10,10,20,30,19,49,0.000333,0.070591,5,1058.872383,58.826244,211.774477,66.438562,1,0
0,0,5,5,10,10,20,30,19,49,0.000333,0.070591,5,1058.872383,58.826244,211.774477,66.438562,1,0
0,0,5,5,10,10,20,30,19,49,0.000333,0.070591,5,1058.872383,58.826244,211.774477,66.438562,1,0
0,0,5,5,10,10,20,30,19,49,0.000333,0.070591,5,1058.872383,58.826244,211.774477,66.438562,1,0
0,0,5,5,10,10,20,30,19,49,0.000333,0.070591,5,1058.872383,58.826244,211.774477,66.438562,1,0
0,0,5,5,10,10,20,30,19,49,0.000333,0.070591,5,1058.872383,58.826244,211.774477,66.438562,1,0
0,0,5,5,10,10,20,30,19,49,0.000333,0.070591,5,1058.872383,58.826244,211.774477,66.438562,1,0
0,0,5,5,10,10,20,30,19,49,0.000333,0.070591,5,1058.872383,58.826244,211.774477,66.438562,1,0
0,0,5,5,10,10,20,30,19,49,0.000333,0.070591,5,1058.872383,58.826244,211.774477,66.438562,1,0
0,0,5,5,10,10,20,30,19,49,0.000333,0.070591,5,1058.872383,58.826244,211.774477,66.438562,1,0
0,0,5,5,10,10,20,30,19,49,0.000333,0.070591,5,1058.872383,58.826244,211.774477,66.438562,1,0
0,0,5,5,10,10,20,30,19,49,0.000333,0.070591,5,1058.872383,58.826244,211.774477,66.438562,1,0
0,0,5,5,10,10,20,30,19,49,0.000333,0.070591,5,1058.872383,58.826244,211.774477,66.438562,1,0
0,0,5,5,10,10,20,30,19,49,0.000333,0.070591,5,1058.872383,58.826244,211.774477,66.438562,1,0
0,0,5,5,10,10,20,30,19,49,0.000333,0.070591,5,1058.872383,58.826244,211.774477,66.438562,1,0
0,0,5,5,10,10,20,30,19,49,0.000333,0.070591,5,1058.872383,58.826244,211.774477,66.438562,1,0
0,0,5,5,10,10,20,30,19,49,0.000333,0.070591,5,1058.872383,58.826244,211.774477,66.438562,1,0
0,0,5,5,10,10,20,30,19,49,0.000333,0.070591,5,1058.872383,58.826244,211.774477,66.438562,1,0
0,0,5,5,10,10,20,30,19,49,0.000333,0.070591,5,1058.872383,58.826244,211.774477,66.438562,1,0
0,0,5,5,10,10,20,30,19,49,0.000333,0.070591,5,1058.872383,58.826244,211.774477,66.438562,1,0
0,0,5,5,10,10,20,30,19,49,0.000333,0.070591,5,1058.872383,58.826244,211.774477,66.438562,1,0
0,0,5,5,10,10,20,30,19,49,0.000333,0.070591,5,1058.872383,58.826244,211.774477,66.438562,1,0
0,0,5,5,10,10,20,30,19,49,0.000333,0.070591,5,1058.872383,58.826244,211.774477,66.438562,1,0
0,0,5,5,10,10,20,30,19,49,0.000333,0.070591,5,1058.872383,58.826244,211.774477,66.438562,1,0
0,0,5,5,10,10,20,30,19,49,0.000333,0.070591,5,1058.872383,58.826244,211.774477,66.438562,1,0
0,0,5,5,10,10,20,30,19,49,0.000333,0.070591,5,1058.872383,58.826244,211.774477,66.438562,1,0
0,0,5,5,10,10,20,30,19,49,0.000333,0.070591,5,1058.872383,58.826244,211.774477,66.438562,1,0
0,0,9,9,12,13,25,45,36,81,0.000333,0.125384,12,4513.828216,250.768234,376.152351,91.125266,1,0
0,0,9,9,12,13,25,45,36,81,0.000333,0.125384,12,4513.828216,250.768234,376.152351,91.125266,1,0
0,0,9,9,11,16,27,44,45,89,0.000333,0.141062,10,4231.849877,235.102771,423.184988,102.053748,1,0
0,0,9,9,11,16,27,44,45,89,0.000333,0.141062,10,4231.849877,235.102771,423.184988,102.053748,1,0
0,0,7,7,10,11,21,36,25,61,0.000333,0.08931,10,2679.313628,148.850757,267.931363,71.273029,1,0
0,0,10,10,11,12,23,51,33,84,0.000333,0.12666,10,3799.792043,211.099558,379.979204,81.073298,1,0
0,0,8,8,11,17,28,38,31,69,0.000333,0.110569,5,1658.537448,92.140969,331.70749,107.540616,1,0
0,0,7,7,10,16,26,36,33,69,0.000333,0.10811,10,3243.303406,180.183523,324.330341,97.219281,1,0
0,0,9,9,12,12,24,45,33,78,0.000333,0.119209,12,4291.524901,238.41805,357.627075,86.0391,1,0
0,0,8,8,11,14,25,45,31,76,0.000333,0.117644,10,3529.330704,196.073928,352.93307,91.356717,1,0
0,0,9,9,11,18,29,37,37,74,0.000333,0.11983,10,3594.905936,199.716996,359.490594,113.112398,1,0
0,0,7,7,10,16,26,36,33,69,0.000333,0.10811,10,3243.303406,180.183523,324.330341,97.219281,1,0
0,0,9,9,10,17,27,42,47,89,0.000333,0.141062,10,4231.849877,235.102771,423.184988,102.706149,1,0
0,0,11,11,10,18,28,48,61,109,0.000333,0.174667,15,7860.025298,436.668072,524.001687,108.277931,1,0
0,0,13,13,10,19,29,54,75,129,0.000333,0.208893,15,9400.193226,522.232957,626.679548,113.929904,1,0
0,0,9,9,11,15,26,44,42,86,0.000333,0.134746,10,4042.378158,224.576564,404.237816,96.657107,1,0
0,0,8,8,11,17,28,42,36,78,0.000333,0.124991,10,3749.736839,208.318713,374.973684,107.540616,1,0
0,0,9,9,11,18,29,51,40,91,0.000333,0.147359,10,4420.762706,245.597928,442.076271,113.112398,1,0
0,0,8,8,10,17,27,44,37,81,0.000333,0.128382,10,3851.458877,213.969938,385.145888,102.706149,1,0
0,0,10,10,10,19,29,51,43,94,0.000333,0.152217,10,4566.502135,253.694563,456.650214,113.929904,1,0
0,0,10,10,11,19,30,43,48,91,0.000333,0.148842,10,4465.270442,248.07058,446.527044,118.764371,1,0
0,0,9,9,10,18,28,36,43,79,0.000333,0.126594,10,3797.810388,210.989466,379.781039,108.277931,1,0
0,0,8,8,14,19,33,43,41,84,0.000333,0.141243,14,5932.207484,329.567082,423.729106,134.013592,1,0
0,0,8,8,13,19,32,42,41,83,0.000333,0.138333,12,4980,276.666667,415,128.816339,1,0
0,0,5,5,11,10,21,32,19,51,0.000333,0.074669,5,1120.040943,62.224497,224.008189,71.273029,1,0
0,0,5,5,11,10,21,32,19,51,0.000333,0.074669,5,1120.040943,62.224497,224.008189,71.273029,1,0
0,0,5,5,11,10,21,32,19,51,0.000333,0.074669,5,1120.040943,62.224497,224.008189,71.273029,1,0
0,0,5,5,11,10,21,32,19,51,0.000333,0.074669,5,1120.040943,62.224497,224.008189,71.273029,1,0
0,0,5,5,11,10,21,32,19,51,0.000333,0.074669,5,1120.040943,62.224497,224.008189,71.273029,1,0
0,0,5,5,11,10,21,32,19,51,0.000333,0.074669,5,1120.040943,62.224497,224.008189,71.273029,1,0
0,0,5,5,11,10,21,32,19,51,0.000333,0.074669,5,1120.040943,62.224497,224.008189,71.273029,1,0
0,0,5,5,11,10,21,32,19,51,0.000333,0.074669,5,1120.040943,62.224497,224.008189,71.273029,1,0
0,0,5,5,11,10,21,32,19,51,0.000333,0.074669,5,1120.040943,62.224497,224.008189,71.273029,1,0
0,0,5,5,11,10,21,32,19,51,0.000333,0.074669,5,1120.040943,62.224497,224.008189,71.273029,1,0
0,0,5,5,11,10,21,32,19,51,0.000333,0.074669,5,1120.040943,62.224497,224.008189,71.273029,1,0
0,0,5,5,11,10,21,32,19,51,0.000333,0.074669,5,1120.040943,62.224497,224.008189,71.273029,1,0
0,0,5,5,11,10,21,32,19,51,0.000333,0.074669,5,1120.040943,62.224497,224.008189,71.273029,1,0
0,0,5,5,11,10,21,32,19,51,0.000333,0.074669,5,1120.040943,62.224497,224.008189,71.273029,1,0
0,0,5,5,11,10,21,32,19,51,0.000333,0.074669,5,1120.040943,62.224497,224.008189,71.273029,1,0
0,0,5,5,11,10,21,32,19,51,0.000333,0.074669,5,1120.040943,62.224497,224.008189,71.273029,1,0
0,0,5,5,11,10,21,32,19,51,0.000333,0.074669,5,1120.040943,62.224497,224.008189,71.273029,1,0
0,0,5,5,11,10,21,32,19,51,0.000333,0.074669,5,1120.040943,62.224497,224.008189,71.273029,1,0
0,0,5,5,11,10,21,32,19,51,0.000333,0.074669,5,1120.040943,62.224497,224.008189,71.273029,1,0
0,0,5,5,11,10,21,32,19,51,0.000333,0.074669,5,1120.040943,62.224497,224.008189,71.273029,1,0
0,0,5,5,11,10,21,32,19,51,0.000333,0.074669,5,1120.040943,62.224497,224.008189,71.273029,1,0
0,0,5,5,11,10,21,32,19,51,0.000333,0.074669,5,1120.040943,62.224497,224.008189,71.273029,1,0
0,0,5,5,11,10,21,32,19,51,0.000333,0.074669,5,1120.040943,62.224497,224.008189,71.273029,1,0
0,0,5,5,11,10,21,32,19,51,0.000333,0.074669,5,1120.040943,62.224497,224.008189,71.273029,1,0
0,0,5,5,11,10,21,32,19,51,0.000333,0.074669,5,1120.040943,62.224497,224.008189,71.273029,1,0
0,0,5,5,11,10,21,32,19,51,0.000333,0.074669,5,1120.040943,62.224497,224.008189,71.273029,1,0
0,0,5,5,11,10,21,32,19,51,0.000333,0.074669,5,1120.040943,62.224497,224.008189,71.273029,1,0
0,0,5,5,11,10,21,32,19,51,0.000333,0.074669,5,1120.040943,62.224497,224.008189,71.273029,1,0
0,0,5,5,11,10,21,32,19,51,0.000333,0.074669,5,1120.040943,62.224497,224.008189,71.273029,1,0
0,0,5,5,11,10,21,32,19,51,0.000333,0.074669,5,1120.040943,62.224497,224.008189,71.273029,1,0
0,0,5,5,11,10,21,32,19,51,0.000333,0.074669,5,1120.040943,62.224497,224.008189,71.273029,1,0
0,0,9,9,13,13,26,47,36,83,0.000333,0.130045,12,4681.637959,260.090998,390.136497,96.211433,1,0
0,0,9,9,13,13,26,47,36,83,0.000333,0.130045,12,4681.637959,260.090998,390.136497,96.211433,1,0
0,0,9,9,12,16,28,46,45,91,0.000333,0.145823,12,5249.631575,291.646199,437.469298,107.01955,1,0
0,0,9,9,12,16,28,46,45,91,0.000333,0.145823,12,5249.631575,291.646199,437.469298,107.01955,1,0
0,0,7,7,11,11,22,38,25,63,0.000333,0.093648,10,2809.44192,156.080107,280.944192,76.107496,1,0
0,0,10,10,12,12,24,53,33,86,0.000333,0.131436,12,4731.681301,262.871183,394.306775,86.0391,1,0
0,0,8,8,12,17,29,40,31,71,0.000333,0.114972,6,2069.499904,114.972217,344.916651,112.506418,1,0
0,0,7,7,11,16,27,38,33,71,0.000333,0.112532,10,3375.970127,187.553896,337.597013,102.053748,1,0
0,0,9,9,13,12,25,47,33,80,0.000333,0.123836,12,4458.101942,247.67233,371.508495,91.125266,1,0
0,0,8,8,12,14,26,47,31,78,0.000333,0.122211,12,4399.611576,244.422865,366.634298,96.322519,1,0
0,0,9,9,12,18,30,39,37,76,0.000333,0.124308,12,4475.084223,248.61579,372.923685,118.0782,1,0
0,0,7,7,11,16,27,38,33,71,0.000333,0.112532,10,3375.970127,187.553896,337.597013,102.053748,1,0
0,0,9,9,11,17,28,44,47,91,0.000333,0.145823,10,4374.692979,243.038499,437.469298,107.540616,1,0
0,0,11,11,11,18,29,50,61,111,0.000333,0.179745,15,8088.538357,449.363242,539.23589,113.112398,1,0
0,0,13,13,11,19,30,56,75,131,0.000333,0.214268,15,9642.04002,535.66889,642.802668,118.764371,1,0
0,0,9,9,12,15,27,46,42,88,0.000333,0.139477,12,5021.161202,278.9534,418.4301,101.622909,1,0
0,0,8,8,12,17,29,44,36,80,0.000333,0.129546,12,4663.661755,259.09232,388.63848,112.506418,1,0
0,0,9,9,12,18,30,53,40,93,0.000333,0.152114,12,5476.089905,304.227217,456.340825,118.0782,1,0
0,0,8,8,11,17,28,46,37,83,0.000333,0.133003,10,3990.104585,221.672477,399.010459,107.540616,1,0
0,0,10,10,11,19,30,53,43,96,0.000333,0.15702,10,4710.614972,261.700832,471.061497,118.764371,1,0
0,0,10,10,12,19,31,45,48,93,0.000333,0.15358,12,5528.883082,307.160171,460.740257,123.730173,1,0
0,0,9,9,11,18,29,38,43,81,0.000333,0.131165,10,3934.964606,218.609145,393.496461,113.112398,1,0
0,0,8,8,15,19,34,45,41,86,0.000333,0.145841,14,6125.305261,340.294737,437.521804,139.313982,1,0
0,0,8,8,14,19,33,44,41,85,0.000333,0.142925,14,6002.829002,333.4905,428.7735,134.013592,1,0
0,0,5,5,8,9,17,21,16,37,0.000333,0.050412,4,604.944501,33.608028,151.236125,52.529325,1,0
0,0,5,5,8,9,17,21,16,37,0.000333,0.050412,4,604.944501,33.608028,151.236125,52.529325,1,0
0,0,5,5,8,9,17,21,16,37,0.000333,0.050412,4,604.944501,33.608028,151.236125,52.529325,1,0
0,0,5,5,8,9,17,21,16,37,0.000333,0.050412,4,604.944501,33.608028,151.236125,52.529325,1,0
0,0,5,5,8,9,17,21,16,37,0.000333,0.050412,4,604.944501,33.608028,151.236125,52.529325,1,0
0,0,5,5,8,9,17,21,16,37,0.000333,0.050412,4,604.944501,33.608028,151.236125,52.529325,1,0
0,0,5,5,8,9,17,21,16,37,0.000333,0.050412,4,604.944501,33.608028,151.236125,52.529325,1,0
0,0,5,5,8,9,17,21,16,37,0.000333,0.050412,4,604.944501,33.608028,151.236125,52.529325,1,0
0,0,5,5,8,9,17,21,16,37,0.000333,0.050412,4,604.944501,33.608028,151.236125,52.529325,1,0
0,0,5,5,8,9,17,21,16,37,0.000333,0.050412,4,604.944501,33.608028,151.236125,52.529325,1,0
0,0,5,5,8,9,17,21,16,37,0.000333,0.050412,4,604.944501,33.608028,151.236125,52.529325,1,0
0,0,5,5,8,9,17,21,16,37,0.000333,0.050412,4,604.944501,33.608028,151.236125,52.529325,1,0
0,0,5,5,8,9,17,21,16,37,0.000333,0.050412,4,604.944501,33.608028,151.236125,52.529325,1,0
0,0,5,5,8,9,17,21,16,37,0.000333,0.050412,4,604.944501,33.608028,151.236125,52.529325,1,0
0,0,5,5,8,9,17,21,16,37,0.000333,0.050412,4,604.944501,33.608028,151.236125,52.529325,1,0
0,0,5,5,8,9,17,21,16,37,0.000333,0.050412,4,604.944501,33.608028,151.236125,52.529325,1,0
0,0,5,5,8,9,17,21,16,37,0.000333,0.050412,4,604.944501,33.608028,151.236125,52.529325,1,0
0,0,5,5,8,9,17,21,16,37,0.000333,0.050412,4,604.944501,33.608028,151.236125,52.529325,1,0
0,0,5,5,8,9,17,21,16,37,0.000333,0.050412,4,604.944501,33.608028,151.236125,52.529325,1,0
0,0,5,5,8,9,17,21,16,37,0.000333,0.050412,4,604.944501,33.608028,151.236125,52.529325,1,0
0,0,5,5,8,9,17,21,16,37,0.000333,0.050412,4,604.944501,33.608028,151.236125,52.529325,1,0
0,0,5,5,8,9,17,21,16,37,0.000333,0.050412,4,604.944501,33.608028,151.236125,52.529325,1,0
0,0,5,5,8,9,17,21,16,37,0.000333,0.050412,4,604.944501,33.608028,151.236125,52.529325,1,0
0,0,5,5,8,9,17,21,16,37,0.000333,0.050412,4,604.944501,33.608028,151.236125,52.529325,1,0
0,0,5,5,8,9,17,21,16,37,0.000333,0.050412,4,604.944501,33.608028,151.236125,52.529325,1,0
0,0,5,5,8,9,17,21,16,37,0.000333,0.050412,4,604.944501,33.608028,151.236125,52.529325,1,0
0,0,5,5,8,9,17,21,16,37,0.000333,0.050412,4,604.944501,33.608028,151.236125,52.529325,1,0
0,0,5,5,8,9,17,21,16,37,0.000333,0.050412,4,604.944501,33.608028,151.236125,52.529325,1,0
0,0,5,5,8,9,17,21,16,37,0.000333,0.050412,4,604.944501,33.608028,151.236125,52.529325,1,0
0,0,5,5,8,9,17,21,16,37,0.000333,0.050412,4,604.944501,33.608028,151.236125,52.529325,1,0
0,0,5,5,8,9,17,21,16,37,0.000333,0.050412,4,604.944501,33.608028,151.236125,52.529325,1,0
0,0,9,9,11,12,23,36,33,69,0.000333,0.104042,10,3121.25775,173.403208,312.125775,81.073298,1,0
0,0,9,9,11,12,23,36,33,69,0.000333,0.104042,10,3121.25775,173.403208,312.125775,81.073298,1,0
0,0,9,9,10,15,25,35,42,77,0.000333,0.119192,10,3575.769266,198.653848,357.576927,91.82264,1,0
0,0,9,9,10,15,25,35,42,77,0.000333,0.119192,10,3575.769266,198.653848,357.576927,91.82264,1,0
0,0,7,7,9,10,19,27,22,49,0.000333,0.069383,8,1665.187585,92.510421,208.148448,61.748606,1,0
0,0,10,10,10,11,21,42,30,72,0.000333,0.105416,10,3162.468544,175.692697,316.246854,71.273029,1,0
0,0,8,8,10,16,26,29,28,57,0.000333,0.089308,5,1339.62532,74.423629,267.925064,97.219281,1,0
0,0,7,7,9,15,24,27,30,57,0.000333,0.087114,8,2090.7429,116.152383,261.342863,87.132684,1,0
0,0,9,9,11,11,22,36,30,66,0.000333,0.098107,10,2943.224868,163.512493,294.322487,76.107496,1,0
0,0,8,8,10,13,23,36,28,64,0.000333,0.096503,10,2895.079652,160.837758,289.507965,81.324997,1,0
0,0,9,9,10,17,27,28,34,62,0.000333,0.098268,10,2948.030251,163.779458,294.803025,102.706149,1,0
0,0,7,7,9,15,24,27,30,57,0.000333,0.087114,8,2090.7429,116.152383,261.342863,87.132684,1,0
0,0,9,9,9,16,25,33,44,77,0.000333,0.119192,8,2860.615413,158.923078,357.576927,92.529325,1,0
0,0,11,11,9,17,26,39,58,97,0.000333,0.151981,12,5471.311832,303.961768,455.942653,98.016193,1,0
0,0,13,13,9,18,27,45,72,117,0.000333,0.185441,16,8901.149404,494.5083,556.321838,103.587975,1,0
0,0,9,9,10,14,24,35,39,74,0.000333,0.113096,10,3392.872251,188.492903,339.287225,86.52225,1,0
0,0,8,8,10,16,26,33,33,66,0.000333,0.10341,10,3102.290214,172.349456,310.229021,97.219281,1,0
0,0,8,8,9,15,24,35,32,67,0.000333,0.102397,8,2457.5399,136.529994,307.192488,87.132684,1,0
0,0,8,8,9,16,25,35,34,69,0.000333,0.106809,8,2563.408617,142.41159,320.426077,92.529325,1,0
0,0,10,10,9,18,27,42,40,82,0.000333,0.129967,8,3119.206201,173.289233,389.900775,103.587975,1,0
0,0,10,10,10,18,28,34,45,79,0.000333,0.126594,10,3797.810388,210.989466,379.781039,108.277931,1,0
0,0,9,9,9,17,26,27,40,67,0.000333,0.104976,8,2519.435689,139.968649,314.929461,98.016193,1,0
0,0,8,8,13,18,31,34,38,72,0.000333,0.118901,12,4280.425612,237.801423,356.702134,123.164366,1,0
0,0,8,8,12,18,30,33,38,71,0.000333,0.11613,12,4180.670787,232.259488,348.389232,118.0782,1,0
0,0,5,5,8,9,17,21,16,37,0.000333,0.050412,4,604.944501,33.608028,151.236125,52.529325,1,0
0,0,5,5,8,9,17,21,16,37,0.000333,0.050412,4,604.944501,33.608028,151.236125,52.529325,1,0
0,0,5,5,8,9,17,21,16,37,0.000333,0.050412,4,604.944501,33.608028,151.236125,52.529325,1,0
0,0,5,5,8,9,17,21,16,37,0.000333,0.050412,4,604.944501,33.608028,151.236125,52.529325,1,0
0,0,5,5,8,9,17,21,16,37,0.000333,0.050412,4,604.944501,33.608028,151.236125,52.529325,1,0
0,0,5,5,8,9,17,21,16,37,0.000333,0.050412,4,604.944501,33.608028,151.236125,52.529325,1,0
0,0,5,5,8,9,17,21,16,37,0.000333,0.050412,4,604.944501,33.608028,151.236125,52.529325,1,0
0,0,5,5,8,9,17,21,16,37,0.000333,0.050412,4,604.944501,33.608028,151.236125,52.529325,1,0
0,0,5,5,8,9,17,21,16,37,0.000333,0.050412,4,604.944501,33.608028,151.236125,52.529325,1,0
0,0,5,5,8,9,17,21,16,37,0.000333,0.050412,4,604.944501,33.608028,151.236125,52.529325,1,0
0,0,5,5,8,9,17,21,16,37,0.000333,0.050412,4,604.944501,33.608028,151.236125,52.529325,1,0
0,0,5,5,8,9,17,21,16,37,0.000333,0.050412,4,604.944501,33.608028,151.236125,52.529325,1,0
0,0,5,5,8,9,17,21,16,37,0.000333,0.050412,4,604.944501,33.608028,151.236125,52.529325,1,0
0,0,5,5,8,9,17,21,16,37,0.000333,0.050412,4,604.944501,33.608028,151.236125,52.529325,1,0
0,0,5,5,8,9,17,21,16,37,0.000333,0.050412,4,604.944501,33.608028,151.236125,52.529325,1,0
0,0,5,5,8,9,17,21,16,37,0.000333,0.050412,4,604.944501,33.608028,151.236125,52.529325,1,0
0,0,5,5,8,9,17,21,16,37,0.000333,0.050412,4,604.944501,33.608028,151.236125,52.529325,1,0
0,0,5,5,8,9,17,21,16,37,0.000333,0.050412,4,604.944501,33.608028,151.236125,52.529325,1,0
0,0,5,5,8,9,17,21,16,37,0.000333,0.050412,4,604.944501,33.608028,151.236125,52.529325,1,0
0,0,5,5,8,9,17,21,16,37,0.000333,0.050412,4,604.944501,33.608028,151.236125,52.529325,1,0
0,0,5,5,8,9,17,21,16,37,0.000333,0.050412,4,604.944501,33.608028,151.236125,52.529325,1,0
0,0,5,5,8,9,17,21,16,37,0.000333,0.050412,4,604.944501,33.608028,151.236125,52.529325,1,0
0,0,5,5,8,9,17,21,16,37,0.000333,0.050412,4,604.944501,33.608028,151.236125,52.529325,1,0
0,0,5,5,8,9,17,21,16,37,0.000333,0.050412,4,604.944501,33.608028,151.236125,52.529325,1,0
0,0,5,5,8,9,17,21,16,37,0.000333,0.050412,4,604.944501,33.608028,151.236125,52.529325,1,0
0,0,5,5,8,9,17,21,16,37,0.000333,0.050412,4,604.944501,33.608028,151.236125,52.529325,1,0
0,0,5,5,8,9,17,21,16,37,0.000333,0.050412,4,604.944501,33.608028,151.236125,52.529325,1,0
0,0,5,5,8,9,17,21,16,37,0.000333,0.050412,4,604.944501,33.608028,151.236125,52.529325,1,0
0,0,5,5,8,9,17,21,16,37,0.000333,0.050412,4,604.944501,33.608028,151.236125,52.529325,1,0
0,0,5,5,8,9,17,21,16,37,0.000333,0.050412,4,604.944501,33.608028,151.236125,52.529325,1,0
0,0,5,5,8,9,17,21,16,37,0.000333,0.050412,4,604.944501,33.608028,151.236125,52.529325,1,0
0,0,9,9,11,12,23,36,33,69,0.000333,0.104042,10,3121.25775,173.403208,312.125775,81.073298,1,0
0,0,9,9,11,12,23,36,33,69,0.000333,0.104042,10,3121.25775,173.403208,312.125775,81.073298,1,0
0,0,9,9,10,15,25,35,42,77,0.000333,0.119192,10,3575.769266,198.653848,357.576927,91.82264,1,0
0,0,9,9,10,15,25,35,42,77,0.000333,0.119192,10,3575.769266,198.653848,357.576927,91.82264,1,0
0,0,7,7,9,10,19,27,22,49,0.000333,0.069383,8,1665.187585,92.510421,208.148448,61.748606,1,0
0,0,10,10,10,11,21,42,30,72,0.000333,0.105416,10,3162.468544,175.692697,316.246854,71.273029,1,0
0,0,8,8,10,16,26,29,28,57,0.000333,0.089308,5,1339.62532,74.423629,267.925064,97.219281,1,0
0,0,7,7,9,15,24,27,30,57,0.000333,0.087114,8,2090.7429,116.152383,261.342863,87.132684,1,0
0,0,9,9,11,11,22,36,30,66,0.000333,0.098107,10,2943.224868,163.512493,294.322487,76.107496,1,0
0,0,8,8,10,13,23,36,28,64,0.000333,0.096503,10,2895.079652,160.837758,289.507965,81.324997,1,0
0,0,9,9,10,17,27,28,34,62,0.000333,0.098268,10,2948.030251,163.779458,294.803025,102.706149,1,0
0,0,7,7,9,15,24,27,30,57,0.000333,0.087114,8,2090.7429,116.152383,261.342863,87.132684,1,0
0,0,9,9,9,16,25,33,44,77,0.000333,0.119192,8,2860.615413,158.923078,357.576927,92.529325,1,0
0,0,11,11,9,17,26,39,58,97,0.000333,0.151981,12,5471.311832,303.961768,455.942653,98.016193,1,0
0,0,13,13,9,18,27,45,72,117,0.000333,0.185441,16,8901.149404,494.5083,556.321838,103.587975,1,0
0,0,9,9,10,14,24,35,39,74,0.000333,0.113096,10,3392.872251,188.492903,339.287225,86.52225,1,0
0,0,8,8,10,16,26,33,33,66,0.000333,0.10341,10,3102.290214,172.349456,310.229021,97.219281,1,0
0,0,9,9,10,17,27,42,37,79,0.000333,0.125212,10,3756.361127,208.686729,375.636113,102.706149,1,0
0,0,8,8,9,16,25,35,34,69,0.000333,0.106809,8,2563.408617,142.41159,320.426077,92.529325,1,0
0,0,10,10,9,18,27,42,40,82,0.000333,0.129967,8,3119.206201,173.289233,389.900775,103.587975,1,0
0,0,10,10,10,18,28,34,45,79,0.000333,0.126594,10,3797.810388,210.989466,379.781039,108.277931,1,0
0,0,9,9,9,17,26,27,40,67,0.000333,0.104976,8,2519.435689,139.968649,314.929461,98.016193,1,0
0,0,8,8,13,18,31,34,38,72,0.000333,0.118901,12,4280.425612,237.801423,356.702134,123.164366,1,0
0,0,8,8,12,18,30,33,38,71,0.000333,0.11613,12,4180.670787,232.259488,348.389232,118.0782,1,0
0,0,5,5,9,9,18,23,16,39,0.000333,0.054209,4,650.5083,36.13935,162.627075,57.05865,1,0
0,0,5,5,9,9,18,23,16,39,0.000333,0.054209,4,650.5083,36.13935,162.627075,57.05865,1,0
0,0,5,5,9,9,18,23,16,39,0.000333,0.054209,4,650.5083,36.13935,162.627075,57.05865,1,0
0,0,8,8,12,13,25,44,28,72,0.000333,0.111453,12,4012.291748,222.905097,334.357646,91.125266,1,0
0,0,8,8,12,16,28,34,32,66,0.000333,0.105762,12,3807.425098,211.523617,317.285425,107.01955,1,0
0,0,6,6,11,14,25,33,28,61,0.000333,0.094425,10,2832.752276,157.375126,283.275228,91.356717,1,0
0,0,8,8,11,15,26,39,42,81,0.000333,0.126912,10,3807.356172,211.519787,380.735617,96.657107,1,0
0,0,10,10,11,16,27,45,56,101,0.000333,0.160081,15,7203.654566,400.203031,480.243638,102.053748,1,0
0,0,12,12,11,17,28,51,70,121,0.000333,0.193897,20,11633.79891,646.322162,581.689946,107.540616,1,0
0,0,8,8,12,13,25,41,37,78,0.000333,0.12074,12,4346.649394,241.480522,362.220783,91.125266,1,0
0,0,7,7,12,15,27,39,31,70,0.000333,0.110947,12,3994.105502,221.89475,332.842125,101.622909,1,0
0,0,8,8,12,16,28,48,35,83,0.000333,0.133003,12,4788.125502,266.006972,399.010459,107.01955,1,0
0,0,8,8,11,16,27,43,34,77,0.000333,0.122042,10,3661.263377,203.403521,366.126338,102.053748,1,0
0,0,10,10,11,18,29,50,40,90,0.000333,0.145739,10,4372.182896,242.89905,437.21829,113.112398,1,0
0,0,9,9,12,17,29,40,43,83,0.000333,0.134404,12,4838.549071,268.808282,403.212423,112.506418,1,0
0,0,8,8,11,16,27,33,38,71,0.000333,0.112532,10,3375.970127,187.553896,337.597013,102.053748,1,0
0,0,7,7,15,17,32,40,36,76,0.000333,0.126667,14,5320,295.555556,380,128.090227,1,0
0,0,7,7,14,17,31,39,36,75,0.000333,0.123855,14,5201.906126,288.994785,371.564723,122.789837,1,0
0,0,5,5,10,8,18,28,17,45,0.000333,0.062549,10,1876.466251,104.248125,187.646625,57.219281,1,0
0,0,5,5,10,8,18,28,17,45,0.000333,0.062549,10,1876.466251,104.248125,187.646625,57.219281,1,0
0,0,5,5,10,8,18,28,17,45,0.000333,0.062549,10,1876.466251,104.248125,187.646625,57.219281,1,0
0,0,5,5,10,8,18,28,17,45,0.000333,0.062549,10,1876.466251,104.248125,187.646625,57.219281,1,0
0,0,5,5,10,8,18,28,17,45,0.000333,0.062549,10,1876.466251,104.248125,187.646625,57.219281,1,0
0,0,5,5,10,8,18,28,17,45,0.000333,0.062549,10,1876.466251,104.248125,187.646625,57.219281,1,0
0,0,5,5,10,8,18,28,17,45,0.000333,0.062549,10,1876.466251,104.248125,187.646625,57.219281,1,0
0,0,5,5,10,8,18,28,17,45,0.000333,0.062549,10,1876.466251,104.248125,187.646625,57.219281,1,0
0,0,5,5,10,8,18,28,17,45,0.000333,0.062549,10,1876.466251,104.248125,187.646625,57.219281,1,0
0,0,5,5,10,8,18,28,17,45,0.000333,0.062549,10,1876.466251,104.248125,187.646625,57.219281,1,0
0,0,5,5,10,8,18,28,17,45,0.000333,0.062549,10,1876.466251,104.248125,187.646625,57.219281,1,0
0,0,5,5,10,8,18,28,17,45,0.000333,0.062549,10,1876.466251,104.248125,187.646625,57.219281,1,0
0,0,5,5,10,8,18,28,17,45,0.000333,0.062549,10,1876.466251,104.248125,187.646625,57.219281,1,0
0,0,5,5,10,8,18,28,17,45,0.000333,0.062549,10,1876.466251,104.248125,187.646625,57.219281,1,0
0,0,5,5,10,8,18,28,17,45,0.000333,0.062549,10,1876.466251,104.248125,187.646625,57.219281,1,0
0,0,5,5,10,8,18,28,17,45,0.000333,0.062549,10,1876.466251,104.248125,187.646625,57.219281,1,0
0,0,5,5,10,8,18,28,17,45,0.000333,0.062549,10,1876.466251,104.248125,187.646625,57.219281,1,0
0,0,5,5,10,8,18,28,17,45,0.000333,0.062549,10,1876.466251,104.248125,187.646625,57.219281,1,0
0,0,5,5,10,8,18,28,17,45,0.000333,0.062549,10,1876.466251,104.248125,187.646625,57.219281,1,0
0,0,5,5,10,8,18,28,17,45,0.000333,0.062549,10,1876.466251,104.248125,187.646625,57.219281,1,0
0,0,5,5,10,8,18,28,17,45,0.000333,0.062549,10,1876.466251,104.248125,187.646625,57.219281,1,0
0,0,5,5,10,8,18,28,17,45,0.000333,0.062549,10,1876.466251,104.248125,187.646625,57.219281,1,0
0,0,5,5,10,8,18,28,17,45,0.000333,0.062549,10,1876.466251,104.248125,187.646625,57.219281,1,0
0,0,5,5,10,8,18,28,17,45,0.000333,0.062549,10,1876.466251,104.248125,187.646625,57.219281,1,0
0,0,5,5,10,8,18,28,17,45,0.000333,0.062549,10,1876.466251,104.248125,187.646625,57.219281,1,0
0,0,5,5,10,8,18,28,17,45,0.000333,0.062549,10,1876.466251,104.248125,187.646625,57.219281,1,0
0,0,5,5,10,8,18,28,17,45,0.000333,0.062549,10,1876.466251,104.248125,187.646625,57.219281,1,0
0,0,5,5,10,8,18,28,17,45,0.000333,0.062549,10,1876.466251,104.248125,187.646625,57.219281,1,0
0,0,5,5,10,8,18,28,17,45,0.000333,0.062549,10,1876.466251,104.248125,187.646625,57.219281,1,0
0,0,5,5,10,8,18,28,17,45,0.000333,0.062549,10,1876.466251,104.248125,187.646625,57.219281,1,0
0,0,5,5,10,8,18,28,17,45,0.000333,0.062549,10,1876.466251,104.248125,187.646625,57.219281,1,0
0,0,10,10,12,12,24,45,36,81,0.000333,0.123794,18,6684.875326,371.381963,371.381963,86.0391,1,0
0,0,10,10,12,12,24,45,36,81,0.000333,0.123794,18,6684.875326,371.381963,371.381963,86.0391,1,0
0,0,10,10,11,15,26,44,45,89,0.000333,0.139446,15,6275.087024,348.615946,418.339135,96.657107,1,0
0,0,10,10,11,15,26,44,45,89,0.000333,0.139446,15,6275.087024,348.615946,418.339135,96.657107,1,0
0,0,7,7,10,9,19,34,23,57,0.000333,0.080711,10,2421.318683,134.517705,242.131868,61.748606,1,0
0,0,10,10,11,11,22,48,30,78,0.000333,0.115945,10,3478.356663,193.242037,347.835666,76.107496,1,0
0,0,8,8,11,15,26,36,29,65,0.000333,0.101843,5,1527.642908,84.86905,305.528582,96.657107,1,0
0,0,7,7,10,14,24,34,31,65,0.000333,0.099341,10,2980.225625,165.56809,298.022563,86.52225,1,0
0,0,10,10,12,11,23,45,33,78,0.000333,0.117613,18,6351.080986,352.837833,352.837833,81.073298,1,0
0,0,9,9,11,13,24,45,31,76,0.000333,0.116152,10,3484.571501,193.587306,348.45715,86.159464,1,0
0,0,9,9,11,16,27,35,35,70,0.000333,0.110947,10,3328.421252,184.912292,332.842125,102.053748,1,0
0,0,7,7,10,14,24,34,31,65,0.000333,0.099341,10,2980.225625,165.56809,298.022563,86.52225,1,0
0,0,9,9,10,15,25,40,45,85,0.000333,0.131576,15,5920.916642,328.939813,394.727776,91.82264,1,0
0,0,11,11,10,16,26,46,59,105,0.000333,0.164515,15,7403.192556,411.288475,493.54617,97.219281,1,0
0,0,13,13,10,17,27,52,73,125,0.000333,0.19812,20,11887.21876,660.401042,594.360938,102.706149,1,0
0,0,10,10,11,14,25,44,42,86,0.000333,0.133124,15,5990.574485,332.809694,399.371632,91.356717,1,0
0,0,8,8,11,15,26,40,34,74,0.000333,0.115944,10,3478.325391,193.2403,347.832539,96.657107,1,0
0,0,9,9,11,16,27,49,38,87,0.000333,0.137892,10,4136.752127,229.819563,413.675213,102.053748,1,0
0,0,8,8,10,15,25,42,35,77,0.000333,0.119192,10,3575.769266,198.653848,357.576927,91.82264,1,0
0,0,10,10,10,17,27,49,41,90,0.000333,0.142647,10,4279.398752,237.744375,427.939875,102.706149,1,0
0,0,10,10,11,17,28,41,46,87,0.000333,0.139413,10,4182.398782,232.355488,418.239878,107.540616,1,0
0,0,9,9,10,16,26,34,41,75,0.000333,0.117511,10,3525.329789,195.851655,352.532979,97.219281,1,0
0,0,8,8,14,17,31,41,39,80,0.000333,0.132112,14,5548.699868,308.261104,396.335705,122.789837,1,0
0,0,8,8,13,17,30,40,39,79,0.000333,0.129215,12,4651.732285,258.429571,387.644357,117.592585,1,0
0,0,5,5,10,8,18,29,18,47,0.000333,0.065329,10,1959.864751,108.881375,195.986475,57.219281,1,0
0,0,5,5,10,8,18,29,18,47,0.000333,0.065329,10,1959.864751,108.881375,195.986475,57.219281,1,0
0,0,5,5,10,8,18,29,18,47,0.000333,0.065329,10,1959.864751,108.881375,195.986475,57.219281,1,0
0,0,5,5,10,8,18,29,18,47,0.000333,0.065329,10,1959.864751,108.881375,195.986475,57.219281,1,0
0,0,5,5,10,8,18,29,18,47,0.000333,0.065329,10,1959.864751,108.881375,195.986475,57.219281,1,0
0,0,5,5,10,8,18,29,18,47,0.000333,0.065329,10,1959.864751,108.881375,195.986475,57.219281,1,0
0,0,5,5,10,8,18,29,18,47,0.000333,0.065329,10,1959.864751,108.881375,195.986475,57.219281,1,0
0,0,5,5,10,8,18,29,18,47,0.000333,0.065329,10,1959.864751,108.881375,195.986475,57.219281,1,0
0,0,5,5,10,8,18,29,18,47,0.000333,0.065329,10,1959.864751,108.881375,195.986475,57.219281,1,0
0,0,5,5,10,8,18,29,18,47,0.000333,0.065329,10,1959.864751,108.881375,195.986475,57.219281,1,0
0,0,5,5,10,8,18,29,18,47,0.000333,0.065329,10,1959.864751,108.881375,195.986475,57.219281,1,0
0,0,5,5,10,8,18,29,18,47,0.000333,0.065329,10,1959.864751,108.881375,195.986475,57.219281,1,0
0,0,5,5,10,8,18,29,18,47,0.000333,0.065329,10,1959.864751,108.881375,195.986475,57.219281,1,0
0,0,5,5,10,8,18,29,18,47,0.000333,0.065329,10,1959.864751,108.881375,195.986475,57.219281,1,0
0,0,5,5,10,8,18,29,18,47,0.000333,0.065329,10,1959.864751,108.881375,195.986475,57.219281,1,0
0,0,5,5,10,8,18,29,18,47,0.000333,0.065329,10,1959.864751,108.881375,195.986475,57.219281,1,0
0,0,5,5,10,8,18,29,18,47,0.000333,0.065329,10,1959.864751,108.881375,195.986475,57.219281,1,0
0,0,5,5,10,8,18,29,18,47,0.000333,0.065329,10,1959.864751,108.881375,195.986475,57.219281,1,0
0,0,5,5,10,8,18,29,18,47,0.000333,0.065329,10,1959.864751,108.881375,195.986475,57.219281,1,0
0,0,5,5,10,8,18,29,18,47,0.000333,0.065329,10,1959.864751,108.881375,195.986475,57.219281,1,0
0,0,5,5,10,8,18,29,18,47,0.000333,0.065329,10,1959.864751,108.881375,195.986475,57.219281,1,0
0,0,5,5,10,8,18,29,18,47,0.000333,0.065329,10,1959.864751,108.881375,195.986475,57.219281,1,0
0,0,5,5,10,8,18,29,18,47,0.000333,0.065329,10,1959.864751,108.881375,195.986475,57.219281,1,0
0,0,5,5,10,8,18,29,18,47,0.000333,0.065329,10,1959.864751,108.881375,195.986475,57.219281,1,0
0,0,5,5,10,8,18,29,18,47,0.000333,0.065329,10,1959.864751,108.881375,195.986475,57.219281,1,0
0,0,5,5,10,8,18,29,18,47,0.000333,0.065329,10,1959.864751,108.881375,195.986475,57.219281,1,0
0,0,5,5,10,8,18,29,18,47,0.000333,0.065329,10,1959.864751,108.881375,195.986475,57.219281,1,0
0,0,5,5,10,8,18,29,18,47,0.000333,0.065329,10,1959.864751,108.881375,195.986475,57.219281,1,0
0,0,5,5,10,8,18,29,18,47,0.000333,0.065329,10,1959.864751,108.881375,195.986475,57.219281,1,0
0,0,5,5,10,8,18,29,18,47,0.000333,0.065329,10,1959.864751,108.881375,195.986475,57.219281,1,0
0,0,5,5,10,8,18,29,18,47,0.000333,0.065329,10,1959.864751,108.881375,195.986475,57.219281,1,0
0,0,10,10,12,12,24,46,37,83,0.000333,0.126851,18,6849.933976,380.551888,380.551888,86.0391,1,0
0,0,10,10,12,12,24,46,37,83,0.000333,0.126851,18,6849.933976,380.551888,380.551888,86.0391,1,0
0,0,10,10,11,15,26,45,46,91,0.000333,0.14258,15,6416.100215,356.450012,427.740014,96.657107,1,0
0,0,10,10,11,15,26,45,46,91,0.000333,0.14258,15,6416.100215,356.450012,427.740014,96.657107,1,0
0,0,7,7,10,9,19,35,24,59,0.000333,0.083543,10,2506.277233,139.237624,250.627723,61.748606,1,0
0,0,11,11,11,11,22,52,34,86,0.000333,0.127837,15,5752.666788,319.592599,383.511119,76.107496,1,0
0,0,8,8,11,15,26,37,30,67,0.000333,0.104976,10,3149.294611,174.960812,314.929461,96.657107,1,0
0,0,7,7,10,14,24,35,32,67,0.000333,0.102397,10,3071.924875,170.662493,307.192488,86.52225,1,0
0,0,10,10,12,11,23,46,34,80,0.000333,0.120628,18,6513.929217,361.884956,361.884956,81.073298,1,0
0,0,9,9,11,13,24,46,32,78,0.000333,0.119209,10,3576.270751,198.681708,357.627075,86.159464,1,0
0,0,9,9,11,16,27,36,36,72,0.000333,0.114117,10,3423.519002,190.1955,342.3519,102.053748,1,0
0,0,7,7,10,14,24,35,32,67,0.000333,0.102397,10,3071.924875,170.662493,307.192488,86.52225,1,0
0,0,9,9,10,15,25,41,46,87,0.000333,0.134672,15,6060.232328,336.679574,404.015489,91.82264,1,0
0,0,11,11,10,16,26,47,60,107,0.000333,0.167649,15,7544.205748,419.122542,502.94705,97.219281,1,0
0,0,13,13,10,17,27,53,74,127,0.000333,0.20129,20,12077.41426,670.967459,603.870713,102.706149,1,0
0,0,9,9,11,13,24,43,41,84,0.000333,0.128379,15,5777.052751,320.947375,385.13685,86.159464,1,0
0,0,8,8,11,15,26,41,35,76,0.000333,0.119078,10,3572.334186,198.46301,357.233419,96.657107,1,0
0,0,9,9,11,16,27,50,39,89,0.000333,0.141062,10,4231.849877,235.102771,423.184988,102.053748,1,0
0,0,9,9,10,16,26,45,38,83,0.000333,0.130045,10,3901.364966,216.742498,390.136497,97.219281,1,0
0,0,11,11,10,18,28,52,44,96,0.000333,0.153835,10,4615.060725,256.392263,461.506073,108.277931,1,0
0,0,10,10,11,17,28,50,49,99,0.000333,0.158643,10,4759.281373,264.404521,475.928137,107.540616,1,0
0,0,9,9,10,16,26,35,42,77,0.000333,0.120645,10,3619.338583,201.074366,361.933858,97.219281,1,0
0,0,8,8,14,17,31,42,40,82,0.000333,0.135415,14,5687.417364,315.967631,406.244097,122.789837,1,0
0,0,8,8,13,17,30,41,40,81,0.000333,0.132486,12,4769.497659,264.972092,397.458138,117.592585,1,0
0,0,5,5,11,8,19,30,17,47,0.000333,0.066551,10,1996.525931,110.918107,199.652593,62.053748,1,0
0,0,5,5,11,8,19,30,17,47,0.000333,0.066551,10,1996.525931,110.918107,199.652593,62.053748,1,0
0,0,5,5,11,8,19,30,17,47,0.000333,0.066551,10,1996.525931,110.918107,199.652593,62.053748,1,0
0,0,5,5,11,8,19,30,17,47,0.000333,0.066551,10,1996.525931,110.918107,199.652593,62.053748,1,0
0,0,5,5,11,8,19,30,17,47,0.000333,0.066551,10,1996.525931,110.918107,199.652593,62.053748,1,0
0,0,5,5,11,8,19,30,17,47,0.000333,0.066551,10,1996.525931,110.918107,199.652593,62.053748,1,0
0,0,5,5,11,8,19,30,17,47,0.000333,0.066551,10,1996.525931,110.918107,199.652593,62.053748,1,0
0,0,5,5,11,8,19,30,17,47,0.000333,0.066551,10,1996.525931,110.918107,199.652593,62.053748,1,0
0,0,5,5,11,8,19,30,17,47,0.000333,0.066551,10,1996.525931,110.918107,199.652593,62.053748,1,0
0,0,5,5,11,8,19,30,17,47,0.000333,0.066551,10,1996.525931,110.918107,199.652593,62.053748,1,0
0,0,5,5,11,8,19,30,17,47,0.000333,0.066551,10,1996.525931,110.918107,199.652593,62.053748,1,0
0,0,5,5,11,8,19,30,17,47,0.000333,0.066551,10,1996.525931,110.918107,199.652593,62.053748,1,0
0,0,5,5,11,8,19,30,17,47,0.000333,0.066551,10,1996.525931,110.918107,199.652593,62.053748,1,0
0,0,5,5,11,8,19,30,17,47,0.000333,0.066551,10,1996.525931,110.918107,199.652593,62.053748,1,0
0,0,5,5,11,8,19,30,17,47,0.000333,0.066551,10,1996.525931,110.918107,199.652593,62.053748,1,0
0,0,5,5,11,8,19,30,17,47,0.000333,0.066551,10,1996.525931,110.918107,199.652593,62.053748,1,0
0,0,5,5,11,8,19,30,17,47,0.000333,0.066551,10,1996.525931,110.918107,199.652593,62.053748,1,0
0,0,5,5,11,8,19,30,17,47,0.000333,0.066551,10,1996.525931,110.918107,199.652593,62.053748,1,0
0,0,5,5,11,8,19,30,17,47,0.000333,0.066551,10,1996.525931,110.918107,199.652593,62.053748,1,0
0,0,5,5,11,8,19,30,17,47,0.000333,0.066551,10,1996.525931,110.918107,199.652593,62.053748,1,0
0,0,5,5,11,8,19,30,17,47,0.000333,0.066551,10,1996.525931,110.918107,199.652593,62.053748,1,0
0,0,5,5,11,8,19,30,17,47,0.000333,0.066551,10,1996.525931,110.918107,199.652593,62.053748,1,0
0,0,5,5,11,8,19,30,17,47,0.000333,0.066551,10,1996.525931,110.918107,199.652593,62.053748,1,0
0,0,5,5,11,8,19,30,17,47,0.000333,0.066551,10,1996.525931,110.918107,199.652593,62.053748,1,0
0,0,5,5,11,8,19,30,17,47,0.000333,0.066551,10,1996.525931,110.918107,199.652593,62.053748,1,0
0,0,5,5,11,8,19,30,17,47,0.000333,0.066551,10,1996.525931,110.918107,199.652593,62.053748,1,0
0,0,5,5,11,8,19,30,17,47,0.000333,0.066551,10,1996.525931,110.918107,199.652593,62.053748,1,0
0,0,5,5,11,8,19,30,17,47,0.000333,0.066551,10,1996.525931,110.918107,199.652593,62.053748,1,0
0,0,5,5,11,8,19,30,17,47,0.000333,0.066551,10,1996.525931,110.918107,199.652593,62.053748,1,0
0,0,5,5,11,8,19,30,17,47,0.000333,0.066551,10,1996.525931,110.918107,199.652593,62.053748,1,0
0,0,5,5,11,8,19,30,17,47,0.000333,0.066551,10,1996.525931,110.918107,199.652593,62.053748,1,0
0,0,10,10,13,12,25,47,36,83,0.000333,0.12848,18,6937.921148,385.440064,385.440064,91.125266,1,0
0,0,10,10,13,12,25,47,36,83,0.000333,0.12848,18,6937.921148,385.440064,385.440064,91.125266,1,0
0,0,10,10,12,15,27,46,45,91,0.000333,0.144232,18,7788.505729,432.694763,432.694763,101.622909,1,0
0,0,10,10,12,15,27,46,45,91,0.000333,0.144232,18,7788.505729,432.694763,432.694763,101.622909,1,0
0,0,7,7,11,9,20,36,23,59,0.000333,0.084998,10,2549.937576,141.663199,254.993758,66.583073,1,0
0,0,11,11,12,11,23,53,33,86,0.000333,0.129675,18,7002.473908,389.026328,389.026328,81.073298,1,0
0,0,8,8,12,15,27,38,29,67,0.000333,0.106192,6,1911.464776,106.192488,318.577463,101.622909,1,0
0,0,7,7,11,14,25,36,31,67,0.000333,0.103713,10,3111.383647,172.854647,311.138365,91.356717,1,0
0,0,10,10,13,11,24,47,33,80,0.000333,0.122266,18,6602.346001,366.797,366.797,86.159464,1,0
0,0,9,9,12,13,25,47,31,78,0.000333,0.12074,12,4346.649394,241.480522,362.220783,91.125266,1,0
0,0,9,9,12,16,28,37,35,72,0.000333,0.115377,12,4153.554653,230.753036,346.129554,107.01955,1,0
0,0,7,7,11,14,25,36,31,67,0.000333,0.103713,10,3111.383647,172.854647,311.138365,91.356717,1,0
0,0,9,9,11,15,26,42,45,87,0.000333,0.136313,15,6134.073832,340.78188,408.938255,96.657107,1,0
0,0,11,11,11,16,27,48,59,107,0.000333,0.169591,15,7631.594441,423.977469,508.772963,102.053748,1,0
0,0,13,13,11,17,28,54,73,127,0.000333,0.203511,20,12210.6815,678.371195,610.534075,107.540616,1,0
0,0,9,9,12,13,25,44,40,84,0.000333,0.130028,18,7021.510559,390.08392,390.08392,91.125266,1,0
0,0,8,8,12,15,27,42,34,76,0.000333,0.120457,12,4336.457402,240.9143,361.37145,101.622909,1,0
0,0,9,9,12,16,28,51,38,89,0.000333,0.142618,12,5134.255057,285.236392,427.854588,107.01955,1,0
0,0,9,9,11,16,27,46,37,83,0.000333,0.131552,10,3946.556627,219.253146,394.655663,102.053748,1,0
0,0,11,11,11,18,29,53,43,96,0.000333,0.155455,10,4663.661755,259.09232,466.366176,113.112398,1,0
0,0,10,10,12,17,29,43,46,89,0.000333,0.14412,12,5188.323703,288.240206,432.360309,112.506418,1,0
0,0,9,9,11,16,27,36,41,77,0.000333,0.122042,10,3661.263377,203.403521,366.126338,102.053748,1,0
0,0,8,8,15,17,32,43,39,82,0.000333,0.136667,14,5740,318.888889,410,128.090227,1,0
0,0,8,8,14,17,31,42,39,81,0.000333,0.133763,14,5618.058616,312.114368,401.289901,122.789837,1,0
0,0,4,4,10,9,19,31,17,48,0.000333,0.067967,5,1019.502603,56.639034,203.900521,61.748606,1,0
0,0,4,4,10,9,19,31,17,48,0.000333,0.067967,5,1019.502603,56.639034,203.900521,61.748606,1,0
0,0,4,4,10,9,19,31,17,48,0.000333,0.067967,5,1019.502603,56.639034,203.900521,61.748606,1,0
0,0,4,4,10,9,19,31,17,48,0.000333,0.067967,5,1019.502603,56.639034,203.900521,61.748606,1,0
0,0,4,4,10,9,19,31,17,48,0.000333,0.067967,5,1019.502603,56.639034,203.900521,61.748606,1,0
0,0,4,4,10,9,19,31,17,48,0.000333,0.067967,5,1019.502603,56.639034,203.900521,61.748606,1,0
0,0,4,4,10,9,19,31,17,48,0.000333,0.067967,5,1019.502603,56.639034,203.900521,61.748606,1,0
0,0,4,4,10,9,19,31,17,48,0.000333,0.067967,5,1019.502603,56.639034,203.900521,61.748606,1,0
0,0,4,4,10,9,19,31,17,48,0.000333,0.067967,5,1019.502603,56.639034,203.900521,61.748606,1,0
0,0,4,4,10,9,19,31,17,48,0.000333,0.067967,5,1019.502603,56.639034,203.900521,61.748606,1,0
0,0,4,4,10,9,19,31,17,48,0.000333,0.067967,5,1019.502603,56.639034,203.900521,61.748606,1,0
0,0,4,4,10,9,19,31,17,48,0.000333,0.067967,5,1019.502603,56.639034,203.900521,61.748606,1,0
0,0,4,4,10,9,19,31,17,48,0.000333,0.067967,5,1019.502603,56.639034,203.900521,61.748606,1,0
0,0,4,4,10,9,19,31,17,48,0.000333,0.067967,5,1019.502603,56.639034,203.900521,61.748606,1,0
0,0,4,4,10,9,19,31,17,48,0.000333,0.067967,5,1019.502603,56.639034,203.900521,61.748606,1,0
0,0,4,4,10,9,19,31,17,48,0.000333,0.067967,5,1019.502603,56.639034,203.900521,61.748606,1,0
0,0,4,4,10,9,19,31,17,48,0.000333,0.067967,5,1019.502603,56.639034,203.900521,61.748606,1,0
0,0,4,4,10,9,19,31,17,48,0.000333,0.067967,5,1019.502603,56.639034,203.900521,61.748606,1,0
0,0,4,4,10,9,19,31,17,48,0.000333,0.067967,5,1019.502603,56.639034,203.900521,61.748606,1,0
0,0,4,4,10,9,19,31,17,48,0.000333,0.067967,5,1019.502603,56.639034,203.900521,61.748606,1,0
0,0,4,4,10,9,19,31,17,48,0.000333,0.067967,5,1019.502603,56.639034,203.900521,61.748606,1,0
0,0,4,4,10,9,19,31,17,48,0.000333,0.067967,5,1019.502603,56.639034,203.900521,61.748606,1,0
0,0,4,4,10,9,19,31,17,48,0.000333,0.067967,5,1019.502603,56.639034,203.900521,61.748606,1,0
0,0,4,4,10,9,19,31,17,48,0.000333,0.067967,5,1019.502603,56.639034,203.900521,61.748606,1,0
0,0,4,4,10,9,19,31,17,48,0.000333,0.067967,5,1019.502603,56.639034,203.900521,61.748606,1,0
0,0,4,4,10,9,19,31,17,48,0.000333,0.067967,5,1019.502603,56.639034,203.900521,61.748606,1,0
0,0,4,4,10,9,19,31,17,48,0.000333,0.067967,5,1019.502603,56.639034,203.900521,61.748606,1,0
0,0,4,4,10,9,19,31,17,48,0.000333,0.067967,5,1019.502603,56.639034,203.900521,61.748606,1,0
0,0,4,4,10,9,19,31,17,48,0.000333,0.067967,5,1019.502603,56.639034,203.900521,61.748606,1,0
0,0,4,4,10,9,19,31,17,48,0.000333,0.067967,5,1019.502603,56.639034,203.900521,61.748606,1,0
0,0,4,4,10,9,19,31,17,48,0.000333,0.067967,5,1019.502603,56.639034,203.900521,61.748606,1,0
0,0,8,8,12,12,24,46,34,80,0.000333,0.122266,12,4401.564001,244.531333,366.797,86.0391,1,0
0,0,8,8,12,12,24,46,34,80,0.000333,0.122266,12,4401.564001,244.531333,366.797,86.0391,1,0
0,0,8,8,11,15,26,45,43,88,0.000333,0.13788,10,4136.386952,229.799275,413.638695,96.657107,1,0
0,0,8,8,11,15,26,45,43,88,0.000333,0.13788,10,4136.386952,229.799275,413.638695,96.657107,1,0
0,0,6,6,10,10,20,37,23,60,0.000333,0.086439,10,2593.156857,144.06427,259.315686,66.438562,1,0
0,0,9,9,11,11,22,52,31,83,0.000333,0.123378,10,3701.328243,205.629347,370.132824,76.107496,1,0
0,0,7,7,11,16,27,39,29,68,0.000333,0.107777,5,1616.661751,89.814542,323.33235,102.053748,1,0
0,0,6,6,10,15,25,37,31,68,0.000333,0.105261,10,3157.822209,175.434567,315.782221,91.82264,1,0
0,0,8,8,12,11,23,46,31,77,0.000333,0.116105,12,4179.771247,232.209514,348.314271,81.073298,1,0
0,0,7,7,11,13,24,46,29,75,0.000333,0.114624,10,3438.721876,191.040104,343.872188,86.159464,1,0
0,0,8,8,11,17,28,38,35,73,0.000333,0.116979,10,3509.369093,194.96495,350.936909,107.540616,1,0
0,0,6,6,10,15,25,37,31,68,0.000333,0.105261,10,3157.822209,175.434567,315.782221,91.82264,1,0
0,0,8,8,10,16,26,43,45,88,0.000333,0.13788,10,4136.386952,229.799275,413.638695,97.219281,1,0
0,0,10,10,10,17,27,49,59,108,0.000333,0.171176,15,7702.917754,427.939875,513.52785,102.706149,1,0
0,0,12,12,10,18,28,55,73,128,0.000333,0.205114,20,12306.8286,683.7127,615.34143,108.277931,1,0
0,0,8,8,11,14,25,45,40,85,0.000333,0.131576,10,3947.277761,219.293209,394.727776,91.356717,1,0
0,0,7,7,11,16,27,43,34,77,0.000333,0.122042,10,3661.263377,203.403521,366.126338,102.053748,1,0
0,0,8,8,11,17,28,52,38,90,0.000333,0.144221,10,4326.61943,240.367746,432.661943,107.540616,1,0
0,0,7,7,10,16,26,45,35,80,0.000333,0.125345,10,3760.351775,208.908432,376.035177,97.219281,1,0
0,0,9,9,10,18,28,52,41,93,0.000333,0.149028,10,4470.840078,248.380004,447.084008,108.277931,1,0
0,0,9,9,11,18,29,44,46,90,0.000333,0.145739,10,4372.182896,242.89905,437.21829,113.112398,1,0
0,0,8,8,10,17,27,37,41,78,0.000333,0.123627,10,3708.812252,206.045125,370.881225,102.706149,1,0
0,0,7,7,14,18,32,44,39,83,0.000333,0.138333,14,5810,322.777778,415,128.361619,1,0
0,0,7,7,13,18,31,43,39,82,0.000333,0.135415,12,4874.929169,270.829398,406.244097,123.164366,1,0
0,0,4,4,10,9,19,31,17,48,0.000333,0.067967,5,1019.502603,56.639034,203.900521,61.748606,1,0
0,0,4,4,10,9,19,31,17,48,0.000333,0.067967,5,1019.502603,56.639034,203.900521,61.748606,1,0
0,0,4,4,10,9,19,31,17,48,0.000333,0.067967,5,1019.502603,56.639034,203.900521,61.748606,1,0
0,0,4,4,10,9,19,31,17,48,0.000333,0.067967,5,1019.502603,56.639034,203.900521,61.748606,1,0
0,0,4,4,10,9,19,31,17,48,0.000333,0.067967,5,1019.502603,56.639034,203.900521,61.748606,1,0
0,0,4,4,10,9,19,31,17,48,0.000333,0.067967,5,1019.502603,56.639034,203.900521,61.748606,1,0
0,0,4,4,10,9,19,31,17,48,0.000333,0.067967,5,1019.502603,56.639034,203.900521,61.748606,1,0
0,0,4,4,10,9,19,31,17,48,0.000333,0.067967,5,1019.502603,56.639034,203.900521,61.748606,1,0
0,0,4,4,10,9,19,31,17,48,0.000333,0.067967,5,1019.502603,56.639034,203.900521,61.748606,1,0
0,0,4,4,10,9,19,31,17,48,0.000333,0.067967,5,1019.502603,56.639034,203.900521,61.748606,1,0
0,0,4,4,10,9,19,31,17,48,0.000333,0.067967,5,1019.502603,56.639034,203.900521,61.748606,1,0
0,0,4,4,10,9,19,31,17,48,0.000333,0.067967,5,1019.502603,56.639034,203.900521,61.748606,1,0
0,0,4,4,10,9,19,31,17,48,0.000333,0.067967,5,1019.502603,56.639034,203.900521,61.748606,1,0
0,0,4,4,10,9,19,31,17,48,0.000333,0.067967,5,1019.502603,56.639034,203.900521,61.748606,1,0
0,0,4,4,10,9,19,31,17,48,0.000333,0.067967,5,1019.502603,56.639034,203.900521,61.748606,1,0
0,0,4,4,10,9,19,31,17,48,0.000333,0.067967,5,1019.502603,56.639034,203.900521,61.748606,1,0
0,0,4,4,10,9,19,31,17,48,0.000333,0.067967,5,1019.502603,56.639034,203.900521,61.748606,1,0
0,0,4,4,10,9,19,31,17,48,0.000333,0.067967,5,1019.502603,56.639034,203.900521,61.748606,1,0
0,0,4,4,10,9,19,31,17,48,0.000333,0.067967,5,1019.502603,56.639034,203.900521,61.748606,1,0
0,0,4,4,10,9,19,31,17,48,0.000333,0.067967,5,1019.502603,56.639034,203.900521,61.748606,1,0
0,0,4,4,10,9,19,31,17,48,0.000333,0.067967,5,1019.502603,56.639034,203.900521,61.748606,1,0
0,0,4,4,10,9,19,31,17,48,0.000333,0.067967,5,1019.502603,56.639034,203.900521,61.748606,1,0
0,0,4,4,10,9,19,31,17,48,0.000333,0.067967,5,1019.502603,56.639034,203.900521,61.748606,1,0
0,0,4,4,10,9,19,31,17,48,0.000333,0.067967,5,1019.502603,56.639034,203.900521,61.748606,1,0
0,0,4,4,10,9,19,31,17,48,0.000333,0.067967,5,1019.502603,56.639034,203.900521,61.748606,1,0
0,0,4,4,10,9,19,31,17,48,0.000333,0.067967,5,1019.502603,56.639034,203.900521,61.748606,1,0
0,0,4,4,10,9,19,31,17,48,0.000333,0.067967,5,1019.502603,56.639034,203.900521,61.748606,1,0
0,0,4,4,10,9,19,31,17,48,0.000333,0.067967,5,1019.502603,56.639034,203.900521,61.748606,1,0
0,0,4,4,10,9,19,31,17,48,0.000333,0.067967,5,1019.502603,56.639034,203.900521,61.748606,1,0
0,0,4,4,10,9,19,31,17,48,0.000333,0.067967,5,1019.502603,56.639034,203.900521,61.748606,1,0
0,0,4,4,10,9,19,31,17,48,0.000333,0.067967,5,1019.502603,56.639034,203.900521,61.748606,1,0
0,0,8,8,12,12,24,46,34,80,0.000333,0.122266,12,4401.564001,244.531333,366.797,86.0391,1,0
0,0,8,8,12,12,24,46,34,80,0.000333,0.122266,12,4401.564001,244.531333,366.797,86.0391,1,0
0,0,8,8,11,15,26,45,43,88,0.000333,0.13788,10,4136.386952,229.799275,413.638695,96.657107,1,0
0,0,8,8,11,15,26,45,43,88,0.000333,0.13788,10,4136.386952,229.799275,413.638695,96.657107,1,0
0,0,6,6,10,10,20,37,23,60,0.000333,0.086439,10,2593.156857,144.06427,259.315686,66.438562,1,0
0,0,9,9,11,11,22,52,31,83,0.000333,0.123378,10,3701.328243,205.629347,370.132824,76.107496,1,0
0,0,7,7,11,16,27,39,29,68,0.000333,0.107777,5,1616.661751,89.814542,323.33235,102.053748,1,0
0,0,6,6,10,15,25,37,31,68,0.000333,0.105261,10,3157.822209,175.434567,315.782221,91.82264,1,0
0,0,8,8,12,11,23,46,31,77,0.000333,0.116105,12,4179.771247,232.209514,348.314271,81.073298,1,0
0,0,7,7,11,13,24,46,29,75,0.000333,0.114624,10,3438.721876,191.040104,343.872188,86.159464,1,0
0,0,8,8,11,17,28,38,35,73,0.000333,0.116979,10,3509.369093,194.96495,350.936909,107.540616,1,0
0,0,6,6,10,15,25,37,31,68,0.000333,0.105261,10,3157.822209,175.434567,315.782221,91.82264,1,0
0,0,8,8,10,16,26,43,45,88,0.000333,0.13788,10,4136.386952,229.799275,413.638695,97.219281,1,0
0,0,10,10,10,17,27,49,59,108,0.000333,0.171176,15,7702.917754,427.939875,513.52785,102.706149,1,0
0,0,12,12,10,18,28,55,73,128,0.000333,0.205114,20,12306.8286,683.7127,615.34143,108.277931,1,0
0,0,8,8,11,14,25,45,40,85,0.000333,0.131576,10,3947.277761,219.293209,394.727776,91.356717,1,0
0,0,7,7,11,16,27,43,34,77,0.000333,0.122042,10,3661.263377,203.403521,366.126338,102.053748,1,0
0,0,8,8,11,17,28,52,38,90,0.000333,0.144221,10,4326.61943,240.367746,432.661943,107.540616,1,0
0,0,7,7,10,16,26,45,35,80,0.000333,0.125345,10,3760.351775,208.908432,376.035177,97.219281,1,0
0,0,8,8,10,17,27,48,38,86,0.000333,0.136307,10,4089.203252,227.177958,408.920325,102.706149,1,0
0,0,9,9,11,18,29,44,46,90,0.000333,0.145739,10,4372.182896,242.89905,437.21829,113.112398,1,0
0,0,8,8,10,17,27,37,41,78,0.000333,0.123627,10,3708.812252,206.045125,370.881225,102.706149,1,0
0,0,7,7,14,18,32,44,39,83,0.000333,0.138333,14,5810,322.777778,415,128.361619,1,0
0,0,7,7,13,18,31,43,39,82,0.000333,0.135415,12,4874.929169,270.829398,406.244097,123.164366,1,0
0,0,4,4,10,9,19,27,16,43,0.000333,0.060887,5,913.304415,50.739134,182.660883,61.748606,1,0
0,0,4,4,10,9,19,27,16,43,0.000333,0.060887,5,913.304415,50.739134,182.660883,61.748606,1,0
0,0,4,4,10,9,19,27,16,43,0.000333,0.060887,5,913.304415,50.739134,182.660883,61.748606,1,0
0,0,4,4,10,9,19,27,16,43,0.000333,0.060887,5,913.304415,50.739134,182.660883,61.748606,1,0
0,0,4,4,10,9,19,27,16,43,0.000333,0.060887,5,913.304415,50.739134,182.660883,61.748606,1,0
0,0,4,4,10,9,19,27,16,43,0.000333,0.060887,5,913.304415,50.739134,182.660883,61.748606,1,0
0,0,4,4,10,9,19,27,16,43,0.000333,0.060887,5,913.304415,50.739134,182.660883,61.748606,1,0
0,0,4,4,10,9,19,27,16,43,0.000333,0.060887,5,913.304415,50.739134,182.660883,61.748606,1,0
0,0,4,4,10,9,19,27,16,43,0.000333,0.060887,5,913.304415,50.739134,182.660883,61.748606,1,0
0,0,4,4,10,9,19,27,16,43,0.000333,0.060887,5,913.304415,50.739134,182.660883,61.748606,1,0
0,0,4,4,10,9,19,27,16,43,0.000333,0.060887,5,913.304415,50.739134,182.660883,61.748606,1,0
0,0,4,4,10,9,19,27,16,43,0.000333,0.060887,5,913.304415,50.739134,182.660883,61.748606,1,0
0,0,4,4,10,9,19,27,16,43,0.000333,0.060887,5,913.304415,50.739134,182.660883,61.748606,1,0
0,0,4,4,10,9,19,27,16,43,0.000333,0.060887,5,913.304415,50.739134,182.660883,61.748606,1,0
0,0,4,4,10,9,19,27,16,43,0.000333,0.060887,5,913.304415,50.739134,182.660883,61.748606,1,0
0,0,4,4,10,9,19,27,16,43,0.000333,0.060887,5,913.304415,50.739134,182.660883,61.748606,1,0
0,0,4,4,10,9,19,27,16,43,0.000333,0.060887,5,913.304415,50.739134,182.660883,61.748606,1,0
0,0,4,4,10,9,19,27,16,43,0.000333,0.060887,5,913.304415,50.739134,182.660883,61.748606,1,0
0,0,4,4,10,9,19,27,16,43,0.000333,0.060887,5,913.304415,50.739134,182.660883,61.748606,1,0
0,0,5,5,9,9,18,23,16,39,0.000333,0.054209,4,650.5083,36.13935,162.627075,57.05865,1,0
0,0,5,5,9,9,18,23,16,39,0.000333,0.054209,4,650.5083,36.13935,162.627075,57.05865,1,0
0,0,5,5,9,9,18,23,16,39,0.000333,0.054209,4,650.5083,36.13935,162.627075,57.05865,1,0
0,0,5,5,9,9,18,23,16,39,0.000333,0.054209,4,650.5083,36.13935,162.627075,57.05865,1,0
0,0,5,5,9,9,18,23,16,39,0.000333,0.054209,4,650.5083,36.13935,162.627075,57.05865,1,0
0,0,5,5,9,9,18,23,16,39,0.000333,0.054209,4,650.5083,36.13935,162.627075,57.05865,1,0
0,0,5,5,9,9,18,23,16,39,0.000333,0.054209,4,650.5083,36.13935,162.627075,57.05865,1,0
0,0,5,5,9,9,18,23,16,39,0.000333,0.054209,4,650.5083,36.13935,162.627075,57.05865,1,0
0,0,5,5,9,9,18,23,16,39,0.000333,0.054209,4,650.5083,36.13935,162.627075,57.05865,1,0
0,0,5,5,9,9,18,23,16,39,0.000333,0.054209,4,650.5083,36.13935,162.627075,57.05865,1,0
0,0,5,5,9,9,18,23,16,39,0.000333,0.054209,4,650.5083,36.13935,162.627075,57.05865,1,0
0,0,5,5,9,9,18,23,16,39,0.000333,0.054209,4,650.5083,36.13935,162.627075,57.05865,1,0
0,0,5,5,9,9,18,23,16,39,0.000333,0.054209,4,650.5083,36.13935,162.627075,57.05865,1,0
0,0,5,5,9,9,18,23,16,39,0.000333,0.054209,4,650.5083,36.13935,162.627075,57.05865,1,0
0,0,5,5,9,9,18,23,16,39,0.000333,0.054209,4,650.5083,36.13935,162.627075,57.05865,1,0
0,0,5,5,9,9,18,23,16,39,0.000333,0.054209,4,650.5083,36.13935,162.627075,57.05865,1,0
0,0,5,5,9,9,18,23,16,39,0.000333,0.054209,4,650.5083,36.13935,162.627075,57.05865,1,0
0,0,5,5,9,9,18,23,16,39,0.000333,0.054209,4,650.5083,36.13935,162.627075,57.05865,1,0
0,0,5,5,9,9,18,23,16,39,0.000333,0.054209,4,650.5083,36.13935,162.627075,57.05865,1,0
0,0,5,5,9,9,18,23,16,39,0.000333,0.054209,4,650.5083,36.13935,162.627075,57.05865,1,0
0,0,4,4,9,7,16,23,14,37,0.000333,0.049333,8,1184,65.777778,148,48.180809,1,0
0,0,5,5,9,9,18,23,16,39,0.000333,0.054209,4,650.5083,36.13935,162.627075,57.05865,1,0
0,0,5,5,9,9,18,23,16,39,0.000333,0.054209,4,650.5083,36.13935,162.627075,57.05865,1,0
0,0,5,5,9,9,18,23,16,39,0.000333,0.054209,4,650.5083,36.13935,162.627075,57.05865,1,0
0,0,5,5,9,9,18,23,16,39,0.000333,0.054209,4,650.5083,36.13935,162.627075,57.05865,1,0
0,0,5,5,9,9,18,23,16,39,0.000333,0.054209,4,650.5083,36.13935,162.627075,57.05865,1,0
0,0,5,5,9,9,18,23,16,39,0.000333,0.054209,4,650.5083,36.13935,162.627075,57.05865,1,0
0,0,5,5,9,9,18,23,16,39,0.000333,0.054209,4,650.5083,36.13935,162.627075,57.05865,1,0
0,0,5,5,9,9,18,23,16,39,0.000333,0.054209,4,650.5083,36.13935,162.627075,57.05865,1,0
0,0,3,3,9,7,16,18,11,29,0.000333,0.038667,4,464,25.777778,116,48.180809,1,0
0,0,11,11,12,12,24,49,39,88,0.000333,0.134492,18,7262.580601,403.4767,403.4767,86.0391,1,0
0,0,11,11,12,12,24,49,39,88,0.000333,0.134492,18,7262.580601,403.4767,403.4767,86.0391,1,0
0,0,9,9,11,15,26,37,42,79,0.000333,0.123778,10,3713.347377,206.297077,371.334738,96.657107,1,0
0,0,9,9,11,15,26,37,42,79,0.000333,0.123778,10,3713.347377,206.297077,371.334738,96.657107,1,0
0,0,5,5,10,8,18,24,17,41,0.000333,0.056989,10,1709.669251,94.981625,170.966925,57.219281,1,0
0,0,8,8,11,10,21,42,27,69,0.000333,0.101023,10,3030.699022,168.372168,303.069902,71.273029,1,0
0,0,8,8,11,16,27,34,29,63,0.000333,0.099853,5,1497.789563,83.210531,299.557913,102.053748,1,0
0,0,5,5,10,13,23,24,25,49,0.000333,0.073885,5,1108.272679,61.570704,221.654536,81.324997,1,0
0,0,5,5,10,9,19,24,16,40,0.000333,0.056639,5,849.585503,47.199195,169.917101,61.748606,1,0
0,0,9,9,11,14,25,44,32,76,0.000333,0.117644,10,3529.330704,196.073928,352.93307,91.356717,1,0
0,0,6,6,10,14,24,24,26,50,0.000333,0.076416,5,1146.240625,63.680035,229.248125,86.52225,1,0
0,0,8,8,10,16,26,35,34,69,0.000333,0.10811,10,3243.303406,180.183523,324.330341,97.219281,1,0
0,0,10,10,10,17,27,41,48,89,0.000333,0.141062,10,4231.849877,235.102771,423.184988,102.706149,1,0
0,0,12,12,10,18,28,47,62,109,0.000333,0.174667,15,7860.025298,436.668072,524.001687,108.277931,1,0
0,0,14,14,10,19,29,53,76,129,0.000333,0.208893,20,12533.59097,696.310609,626.679548,113.929904,1,0
0,0,6,6,10,13,23,30,23,53,0.000333,0.079916,5,1198.743918,66.596884,239.748784,81.324997,1,0
0,0,9,9,11,17,28,41,37,78,0.000333,0.124991,10,3749.736839,208.318713,374.973684,107.540616,1,0
0,0,10,10,11,18,29,50,41,91,0.000333,0.147359,10,4420.762706,245.597928,442.076271,113.112398,1,0
0,0,9,9,10,17,27,43,38,81,0.000333,0.128382,10,3851.458877,213.969938,385.145888,102.706149,1,0
0,0,11,11,10,19,29,50,44,94,0.000333,0.152217,10,4566.502135,253.694563,456.650214,113.929904,1,0
0,0,11,11,11,19,30,42,49,91,0.000333,0.148842,10,4465.270442,248.07058,446.527044,118.764371,1,0
0,0,9,9,10,17,27,35,38,73,0.000333,0.115702,10,3471.067877,192.837104,347.106788,102.706149,1,0
0,0,9,9,14,19,33,42,42,84,0.000333,0.141243,14,5932.207484,329.567082,423.729106,134.013592,1,0
0,0,9,9,13,19,32,41,42,83,0.000333,0.138333,12,4980,276.666667,415,128.816339,1,0
0,0,7,7,10,10,20,36,23,59,0.000333,0.084998,10,2549.937576,141.663199,254.993758,66.438562,1,0
0,0,8,8,10,10,20,38,25,63,0.000333,0.09076,10,2722.8147,151.267483,272.28147,66.438562,1,0
0,0,8,8,10,10,20,38,25,63,0.000333,0.09076,10,2722.8147,151.267483,272.28147,66.438562,1,0
0,0,8,8,10,10,20,38,25,63,0.000333,0.09076,10,2722.8147,151.267483,272.28147,66.438562,1,0
0,0,8,8,10,10,20,38,25,63,0.000333,0.09076,10,2722.8147,151.267483,272.28147,66.438562,1,0
0,0,8,8,10,10,20,38,25,63,0.000333,0.09076,10,2722.8147,151.267483,272.28147,66.438562,1,0
0,0,8,8,10,10,20,38,25,63,0.000333,0.09076,10,2722.8147,151.267483,272.28147,66.438562,1,0
0,0,8,8,10,10,20,38,25,63,0.000333,0.09076,10,2722.8147,151.267483,272.28147,66.438562,1,0
0,0,8,8,10,10,20,38,25,63,0.000333,0.09076,10,2722.8147,151.267483,272.28147,66.438562,1,0
0,0,8,8,10,10,20,38,25,63,0.000333,0.09076,10,2722.8147,151.267483,272.28147,66.438562,1,0
0,0,8,8,10,10,20,38,25,63,0.000333,0.09076,10,2722.8147,151.267483,272.28147,66.438562,1,0
0,0,8,8,10,10,20,38,25,63,0.000333,0.09076,10,2722.8147,151.267483,272.28147,66.438562,1,0
0,0,8,8,10,10,20,38,25,63,0.000333,0.09076,10,2722.8147,151.267483,272.28147,66.438562,1,0
0,0,8,8,10,10,20,38,25,63,0.000333,0.09076,10,2722.8147,151.267483,272.28147,66.438562,1,0
0,0,8,8,10,10,20,38,25,63,0.000333,0.09076,10,2722.8147,151.267483,272.28147,66.438562,1,0
0,0,8,8,10,10,20,38,25,63,0.000333,0.09076,10,2722.8147,151.267483,272.28147,66.438562,1,0
0,0,8,8,10,10,20,38,25,63,0.000333,0.09076,10,2722.8147,151.267483,272.28147,66.438562,1,0
0,0,8,8,10,10,20,38,25,63,0.000333,0.09076,10,2722.8147,151.267483,272.28147,66.438562,1,0
0,0,8,8,10,10,20,38,25,63,0.000333,0.09076,10,2722.8147,151.267483,272.28147,66.438562,1,0
0,0,9,9,10,10,20,40,27,67,0.000333,0.096523,10,2895.691824,160.871768,289.569182,66.438562,1,0
0,0,4,4,9,7,16,15,10,25,0.000333,0.033333,4,400,22.222222,100,48.180809,1,0
0,0,8,8,10,10,20,38,25,63,0.000333,0.09076,10,2722.8147,151.267483,272.28147,66.438562,1,0
0,0,8,8,10,10,20,38,25,63,0.000333,0.09076,10,2722.8147,151.267483,272.28147,66.438562,1,0
0,0,8,8,10,10,20,38,25,63,0.000333,0.09076,10,2722.8147,151.267483,272.28147,66.438562,1,0
0,0,8,8,10,10,20,38,25,63,0.000333,0.09076,10,2722.8147,151.267483,272.28147,66.438562,1,0
0,0,8,8,10,10,20,38,25,63,0.000333,0.09076,10,2722.8147,151.267483,272.28147,66.438562,1,0
0,0,8,8,10,10,20,38,25,63,0.000333,0.09076,10,2722.8147,151.267483,272.28147,66.438562,1,0
0,0,8,8,10,10,20,38,25,63,0.000333,0.09076,10,2722.8147,151.267483,272.28147,66.438562,1,0
0,0,8,8,10,10,20,38,25,63,0.000333,0.09076,10,2722.8147,151.267483,272.28147,66.438562,1,0
0,0,8,8,10,10,20,38,25,63,0.000333,0.09076,10,2722.8147,151.267483,272.28147,66.438562,1,0
0,0,8,8,10,10,20,38,25,63,0.000333,0.09076,10,2722.8147,151.267483,272.28147,66.438562,1,0
0,0,10,10,10,11,21,44,31,75,0.000333,0.109808,10,3294.238067,183.013226,329.423807,71.273029,1,0
0,0,12,12,11,12,23,54,36,90,0.000333,0.135707,15,6106.808641,339.267147,407.120576,81.073298,1,0
0,0,9,9,11,15,26,41,31,72,0.000333,0.112811,10,3384.316597,188.017589,338.43166,96.657107,1,0
0,0,9,9,10,15,25,42,35,77,0.000333,0.119192,10,3575.769266,198.653848,357.576927,91.82264,1,0
0,0,11,11,11,14,25,53,37,90,0.000333,0.139316,10,4179.470571,232.192809,417.947057,91.356717,1,0
0,0,11,11,10,16,26,44,38,82,0.000333,0.128479,10,3854.360569,214.131143,385.436057,97.219281,1,0
0,0,10,10,10,15,25,44,37,81,0.000333,0.125384,10,3761.523514,208.973529,376.152351,91.82264,1,0
0,0,12,12,10,16,26,50,49,99,0.000333,0.155115,15,6980.152981,387.786277,465.343532,97.219281,1,0
0,0,14,14,10,17,27,56,61,117,0.000333,0.185441,15,8344.827566,463.601531,556.321838,102.706149,1,0
0,0,16,16,10,18,28,62,73,135,0.000333,0.216331,20,12979.85829,721.103238,648.992914,108.277931,1,0
0,0,11,11,11,16,27,50,40,90,0.000333,0.142647,10,4279.398752,237.744375,427.939875,102.053748,1,0
0,0,12,12,11,17,28,59,44,103,0.000333,0.165053,10,4951.57557,275.087532,495.157557,107.540616,1,0
0,0,11,11,10,16,26,52,41,93,0.000333,0.145714,10,4371.408938,242.856052,437.140894,97.219281,1,0
0,0,13,13,10,18,28,59,47,106,0.000333,0.16986,10,5095.796217,283.09979,509.579622,108.277931,1,0
0,0,13,13,11,18,29,51,50,101,0.000333,0.163552,10,4906.560805,272.586711,490.656081,113.112398,1,0
0,0,10,10,10,16,26,42,38,80,0.000333,0.125345,10,3760.351775,208.908432,376.035177,97.219281,1,0
0,0,11,11,14,18,32,51,44,95,0.000333,0.158333,14,6650,369.444444,475,128.361619,1,0
0,0,11,11,13,18,31,50,44,94,0.000333,0.155231,12,5588.333438,310.462969,465.694453,123.164366,1,0
0,0,8,8,10,10,20,38,25,63,0.000333,0.09076,10,2722.8147,151.267483,272.28147,66.438562,1,0
0,0,8,8,10,10,20,38,25,63,0.000333,0.09076,10,2722.8147,151.267483,272.28147,66.438562,1,0
0,0,8,8,10,10,20,38,25,63,0.000333,0.09076,10,2722.8147,151.267483,272.28147,66.438562,1,0
0,0,8,8,10,10,20,38,25,63,0.000333,0.09076,10,2722.8147,151.267483,272.28147,66.438562,1,0
0,0,8,8,10,10,20,38,25,63,0.000333,0.09076,10,2722.8147,151.267483,272.28147,66.438562,1,0
0,0,8,8,10,10,20,38,25,63,0.000333,0.09076,10,2722.8147,151.267483,272.28147,66.438562,1,0
0,0,8,8,10,10,20,38,25,63,0.000333,0.09076,10,2722.8147,151.267483,272.28147,66.438562,1,0
0,0,8,8,10,10,20,38,25,63,0.000333,0.09076,10,2722.8147,151.267483,272.28147,66.438562,1,0
0,0,8,8,10,10,20,38,25,63,0.000333,0.09076,10,2722.8147,151.267483,272.28147,66.438562,1,0
0,0,8,8,10,10,20,38,25,63,0.000333,0.09076,10,2722.8147,151.267483,272.28147,66.438562,1,0
0,0,8,8,10,10,20,38,25,63,0.000333,0.09076,10,2722.8147,151.267483,272.28147,66.438562,1,0
0,0,8,8,10,10,20,38,25,63,0.000333,0.09076,10,2722.8147,151.267483,272.28147,66.438562,1,0
0,0,8,8,10,10,20,38,25,63,0.000333,0.09076,10,2722.8147,151.267483,272.28147,66.438562,1,0
0,0,8,8,10,10,20,38,25,63,0.000333,0.09076,10,2722.8147,151.267483,272.28147,66.438562,1,0
0,0,8,8,10,10,20,38,25,63,0.000333,0.09076,10,2722.8147,151.267483,272.28147,66.438562,1,0
0,0,8,8,10,10,20,38,25,63,0.000333,0.09076,10,2722.8147,151.267483,272.28147,66.438562,1,0
0,0,8,8,10,10,20,38,25,63,0.000333,0.09076,10,2722.8147,151.267483,272.28147,66.438562,1,0
0,0,8,8,10,10,20,38,25,63,0.000333,0.09076,10,2722.8147,151.267483,272.28147,66.438562,1,0
0,0,8,8,10,10,20,38,25,63,0.000333,0.09076,10,2722.8147,151.267483,272.28147,66.438562,1,0
0,0,8,8,10,10,20,38,25,63,0.000333,0.09076,10,2722.8147,151.267483,272.28147,66.438562,1,0
0,0,8,8,10,10,20,38,25,63,0.000333,0.09076,10,2722.8147,151.267483,272.28147,66.438562,1,0
0,0,8,8,10,10,20,38,25,63,0.000333,0.09076,10,2722.8147,151.267483,272.28147,66.438562,1,0
0,0,8,8,10,10,20,38,25,63,0.000333,0.09076,10,2722.8147,151.267483,272.28147,66.438562,1,0
0,0,8,8,10,10,20,38,25,63,0.000333,0.09076,10,2722.8147,151.267483,272.28147,66.438562,1,0
0,0,8,8,10,10,20,38,25,63,0.000333,0.09076,10,2722.8147,151.267483,272.28147,66.438562,1,0
0,0,8,8,10,10,20,38,25,63,0.000333,0.09076,10,2722.8147,151.267483,272.28147,66.438562,1,0
0,0,8,8,10,10,20,38,25,63,0.000333,0.09076,10,2722.8147,151.267483,272.28147,66.438562,1,0
0,0,8,8,10,10,20,38,25,63,0.000333,0.09076,10,2722.8147,151.267483,272.28147,66.438562,1,0
0,0,8,8,10,10,20,38,25,63,0.000333,0.09076,10,2722.8147,151.267483,272.28147,66.438562,1,0
0,0,8,8,10,10,20,38,25,63,0.000333,0.09076,10,2722.8147,151.267483,272.28147,66.438562,1,0
0,0,8,8,10,10,20,38,25,63,0.000333,0.09076,10,2722.8147,151.267483,272.28147,66.438562,1,0
0,0,10,10,10,11,21,44,31,75,0.000333,0.109808,10,3294.238067,183.013226,329.423807,71.273029,1,0
0,0,13,13,11,12,23,59,39,98,0.000333,0.14777,15,6649.636075,369.424226,443.309072,81.073298,1,0
0,0,10,10,11,15,26,43,33,76,0.000333,0.119078,10,3572.334186,198.46301,357.233419,96.657107,1,0
0,0,10,10,10,15,25,44,37,81,0.000333,0.125384,10,3761.523514,208.973529,376.152351,91.82264,1,0
0,0,11,11,11,14,25,53,37,90,0.000333,0.139316,10,4179.470571,232.192809,417.947057,91.356717,1,0
0,0,11,11,10,16,26,44,38,82,0.000333,0.128479,10,3854.360569,214.131143,385.436057,97.219281,1,0
0,0,10,10,10,15,25,44,37,81,0.000333,0.125384,10,3761.523514,208.973529,376.152351,91.82264,1,0
0,0,12,12,10,16,26,50,49,99,0.000333,0.155115,15,6980.152981,387.786277,465.343532,97.219281,1,0
0,0,14,14,10,17,27,56,61,117,0.000333,0.185441,15,8344.827566,463.601531,556.321838,102.706149,1,0
0,0,16,16,10,19,29,62,68,130,0.000333,0.210513,15,9473.06294,526.281274,631.537529,113.929904,1,0
0,0,11,11,11,16,27,50,40,90,0.000333,0.142647,10,4279.398752,237.744375,427.939875,102.053748,1,0
0,0,12,12,11,17,28,59,44,103,0.000333,0.165053,10,4951.57557,275.087532,495.157557,107.540616,1,0
0,0,11,11,10,16,26,52,41,93,0.000333,0.145714,10,4371.408938,242.856052,437.140894,97.219281,1,0
0,0,13,13,10,18,28,59,47,106,0.000333,0.16986,10,5095.796217,283.09979,509.579622,108.277931,1,0
0,0,13,13,11,18,29,51,50,101,0.000333,0.163552,10,4906.560805,272.586711,490.656081,113.112398,1,0
0,0,11,11,10,16,26,44,40,84,0.000333,0.131612,10,3948.369363,219.353854,394.836936,97.219281,1,0
0,0,11,11,14,18,32,51,44,95,0.000333,0.158333,14,6650,369.444444,475,128.361619,1,0
0,0,11,11,13,18,31,50,44,94,0.000333,0.155231,12,5588.333438,310.462969,465.694453,123.164366,1,0
0,0,8,8,9,9,18,29,22,51,0.000333,0.070889,8,1701.329401,94.5183,212.666175,57.05865,1,0
0,0,8,8,9,9,18,29,22,51,0.000333,0.070889,8,1701.329401,94.5183,212.666175,57.05865,1,0
0,0,8,8,9,9,18,29,22,51,0.000333,0.070889,8,1701.329401,94.5183,212.666175,57.05865,1,0
0,0,8,8,9,9,18,29,22,51,0.000333,0.070889,8,1701.329401,94.5183,212.666175,57.05865,1,0
0,0,8,8,9,9,18,29,22,51,0.000333,0.070889,8,1701.329401,94.5183,212.666175,57.05865,1,0
0,0,8,8,9,9,18,29,22,51,0.000333,0.070889,8,1701.329401,94.5183,212.666175,57.05865,1,0
0,0,8,8,9,9,18,29,22,51,0.000333,0.070889,8,1701.329401,94.5183,212.666175,57.05865,1,0
0,0,8,8,9,9,18,29,22,51,0.000333,0.070889,8,1701.329401,94.5183,212.666175,57.05865,1,0
0,0,8,8,9,9,18,29,22,51,0.000333,0.070889,8,1701.329401,94.5183,212.666175,57.05865,1,0
0,0,8,8,9,9,18,29,22,51,0.000333,0.070889,8,1701.329401,94.5183,212.666175,57.05865,1,0
0,0,8,8,9,9,18,29,22,51,0.000333,0.070889,8,1701.329401,94.5183,212.666175,57.05865,1,0
0,0,8,8,9,9,18,29,22,51,0.000333,0.070889,8,1701.329401,94.5183,212.666175,57.05865,1,0
0,0,8,8,9,9,18,29,22,51,0.000333,0.070889,8,1701.329401,94.5183,212.666175,57.05865,1,0
0,0,8,8,9,9,18,29,22,51,0.000333,0.070889,8,1701.329401,94.5183,212.666175,57.05865,1,0
0,0,8,8,9,9,18,29,22,51,0.000333,0.070889,8,1701.329401,94.5183,212.666175,57.05865,1,0
0,0,8,8,9,9,18,29,22,51,0.000333,0.070889,8,1701.329401,94.5183,212.666175,57.05865,1,0
0,0,8,8,9,9,18,29,22,51,0.000333,0.070889,8,1701.329401,94.5183,212.666175,57.05865,1,0
0,0,8,8,9,9,18,29,22,51,0.000333,0.070889,8,1701.329401,94.5183,212.666175,57.05865,1,0
0,0,8,8,9,9,18,29,22,51,0.000333,0.070889,8,1701.329401,94.5183,212.666175,57.05865,1,0
0,0,8,8,9,9,18,29,22,51,0.000333,0.070889,8,1701.329401,94.5183,212.666175,57.05865,1,0
0,0,8,8,9,9,18,29,22,51,0.000333,0.070889,8,1701.329401,94.5183,212.666175,57.05865,1,0
0,0,8,8,9,9,18,29,22,51,0.000333,0.070889,8,1701.329401,94.5183,212.666175,57.05865,1,0
0,0,8,8,9,9,18,29,22,51,0.000333,0.070889,8,1701.329401,94.5183,212.666175,57.05865,1,0
0,0,8,8,9,9,18,29,22,51,0.000333,0.070889,8,1701.329401,94.5183,212.666175,57.05865,1,0
0,0,8,8,9,9,18,29,22,51,0.000333,0.070889,8,1701.329401,94.5183,212.666175,57.05865,1,0
0,0,8,8,9,9,18,29,22,51,0.000333,0.070889,8,1701.329401,94.5183,212.666175,57.05865,1,0
0,0,8,8,9,9,18,29,22,51,0.000333,0.070889,8,1701.329401,94.5183,212.666175,57.05865,1,0
0,0,8,8,9,9,18,29,22,51,0.000333,0.070889,8,1701.329401,94.5183,212.666175,57.05865,1,0
0,0,8,8,9,9,18,29,22,51,0.000333,0.070889,8,1701.329401,94.5183,212.666175,57.05865,1,0
0,0,8,8,9,9,18,29,22,51,0.000333,0.070889,8,1701.329401,94.5183,212.666175,57.05865,1,0
0,0,8,8,9,9,18,29,22,51,0.000333,0.070889,8,1701.329401,94.5183,212.666175,57.05865,1,0
0,0,8,8,9,9,18,29,22,51,0.000333,0.070889,8,1701.329401,94.5183,212.666175,57.05865,1,0
0,0,13,13,10,11,21,50,36,86,0.000333,0.125913,15,5666.089475,314.782749,377.739298,71.273029,1,0
0,0,9,9,10,14,24,32,28,60,0.000333,0.091699,10,2750.9775,152.832083,275.09775,86.52225,1,0
0,0,10,10,9,14,23,35,34,69,0.000333,0.104042,8,2497.0062,138.722567,312.125775,81.832294,1,0
0,0,11,11,10,13,23,44,34,78,0.000333,0.117613,10,3528.378326,196.021018,352.837833,81.324997,1,0
0,0,11,11,9,15,24,35,35,70,0.000333,0.106982,8,2567.579,142.643278,320.947375,87.132684,1,0
0,0,10,10,9,14,23,35,34,69,0.000333,0.104042,8,2497.0062,138.722567,312.125775,81.832294,1,0
0,0,12,12,9,15,24,41,46,87,0.000333,0.132964,12,4786.700851,265.927825,398.891738,87.132684,1,0
0,0,14,14,9,16,25,47,58,105,0.000333,0.162535,12,5851.258799,325.069933,487.6049,92.529325,1,0
0,0,16,16,9,17,26,53,70,123,0.000333,0.192718,16,9250.465365,513.914743,578.154085,98.016193,1,0
0,0,11,11,10,15,25,41,37,78,0.000333,0.12074,10,3622.207828,201.233768,362.220783,91.82264,1,0
0,0,12,12,10,16,26,50,41,91,0.000333,0.14258,10,4277.400144,237.633341,427.740014,97.219281,1,0
0,0,11,11,9,15,24,43,38,81,0.000333,0.123794,8,2971.0557,165.05865,371.381963,87.132684,1,0
0,0,13,13,9,17,26,50,44,94,0.000333,0.14728,8,3534.730668,196.373926,441.841334,98.016193,1,0
0,0,13,13,10,17,27,42,47,89,0.000333,0.141062,10,4231.849877,235.102771,423.184988,102.706149,1,0
0,0,11,11,9,16,25,35,37,72,0.000333,0.111453,8,2674.861165,148.603398,334.357646,92.529325,1,0
0,0,11,11,13,17,30,42,41,83,0.000333,0.135757,12,4887.263033,271.514613,407.271919,117.592585,1,0
0,0,11,11,12,17,29,41,41,82,0.000333,0.132785,12,4780.253299,265.569628,398.354442,112.506418,1,0
0,0,8,8,9,9,18,29,22,51,0.000333,0.070889,8,1701.329401,94.5183,212.666175,57.05865,1,0
0,0,8,8,9,9,18,29,22,51,0.000333,0.070889,8,1701.329401,94.5183,212.666175,57.05865,1,0
0,0,8,8,9,9,18,29,22,51,0.000333,0.070889,8,1701.329401,94.5183,212.666175,57.05865,1,0
0,0,8,8,9,9,18,29,22,51,0.000333,0.070889,8,1701.329401,94.5183,212.666175,57.05865,1,0
0,0,8,8,9,9,18,29,22,51,0.000333,0.070889,8,1701.329401,94.5183,212.666175,57.05865,1,0
0,0,8,8,9,9,18,29,22,51,0.000333,0.070889,8,1701.329401,94.5183,212.666175,57.05865,1,0
0,0,8,8,9,9,18,29,22,51,0.000333,0.070889,8,1701.329401,94.5183,212.666175,57.05865,1,0
0,0,8,8,9,9,18,29,22,51,0.000333,0.070889,8,1701.329401,94.5183,212.666175,57.05865,1,0
0,0,8,8,9,9,18,29,22,51,0.000333,0.070889,8,1701.329401,94.5183,212.666175,57.05865,1,0
0,0,8,8,9,9,18,29,22,51,0.000333,0.070889,8,1701.329401,94.5183,212.666175,57.05865,1,0
0,0,8,8,9,9,18,29,22,51,0.000333,0.070889,8,1701.329401,94.5183,212.666175,57.05865,1,0
0,0,8,8,9,9,18,29,22,51,0.000333,0.070889,8,1701.329401,94.5183,212.666175,57.05865,1,0
0,0,8,8,9,9,18,29,22,51,0.000333,0.070889,8,1701.329401,94.5183,212.666175,57.05865,1,0
0,0,8,8,9,9,18,29,22,51,0.000333,0.070889,8,1701.329401,94.5183,212.666175,57.05865,1,0
0,0,8,8,9,9,18,29,22,51,0.000333,0.070889,8,1701.329401,94.5183,212.666175,57.05865,1,0
0,0,8,8,9,9,18,29,22,51,0.000333,0.070889,8,1701.329401,94.5183,212.666175,57.05865,1,0
0,0,8,8,9,9,18,29,22,51,0.000333,0.070889,8,1701.329401,94.5183,212.666175,57.05865,1,0
0,0,8,8,9,9,18,29,22,51,0.000333,0.070889,8,1701.329401,94.5183,212.666175,57.05865,1,0
0,0,8,8,9,9,18,29,22,51,0.000333,0.070889,8,1701.329401,94.5183,212.666175,57.05865,1,0
0,0,8,8,9,9,18,29,22,51,0.000333,0.070889,8,1701.329401,94.5183,212.666175,57.05865,1,0
0,0,8,8,9,9,18,29,22,51,0.000333,0.070889,8,1701.329401,94.5183,212.666175,57.05865,1,0
0,0,8,8,9,9,18,29,22,51,0.000333,0.070889,8,1701.329401,94.5183,212.666175,57.05865,1,0
0,0,8,8,9,9,18,29,22,51,0.000333,0.070889,8,1701.329401,94.5183,212.666175,57.05865,1,0
0,0,8,8,9,9,18,29,22,51,0.000333,0.070889,8,1701.329401,94.5183,212.666175,57.05865,1,0
0,0,8,8,9,9,18,29,22,51,0.000333,0.070889,8,1701.329401,94.5183,212.666175,57.05865,1,0
0,0,8,8,9,9,18,29,22,51,0.000333,0.070889,8,1701.329401,94.5183,212.666175,57.05865,1,0
0,0,8,8,9,9,18,29,22,51,0.000333,0.070889,8,1701.329401,94.5183,212.666175,57.05865,1,0
0,0,8,8,9,9,18,29,22,51,0.000333,0.070889,8,1701.329401,94.5183,212.666175,57.05865,1,0
0,0,8,8,9,9,18,29,22,51,0.000333,0.070889,8,1701.329401,94.5183,212.666175,57.05865,1,0
0,0,8,8,9,9,18,29,22,51,0.000333,0.070889,8,1701.329401,94.5183,212.666175,57.05865,1,0
0,0,8,8,9,9,18,29,22,51,0.000333,0.070889,8,1701.329401,94.5183,212.666175,57.05865,1,0
0,0,10,10,9,10,19,35,28,63,0.000333,0.089206,8,2140.955467,118.94197,267.619433,61.748606,1,0
0,0,12,12,10,11,21,45,33,78,0.000333,0.1142,15,5139.011385,285.500632,342.600759,71.273029,1,0
0,0,9,9,10,14,24,32,28,60,0.000333,0.091699,10,2750.9775,152.832083,275.09775,86.52225,1,0
0,0,10,10,9,14,23,35,34,69,0.000333,0.104042,8,2497.0062,138.722567,312.125775,81.832294,1,0
0,0,11,11,10,13,23,44,34,78,0.000333,0.117613,10,3528.378326,196.021018,352.837833,81.324997,1,0
0,0,11,11,9,15,24,35,35,70,0.000333,0.106982,8,2567.579,142.643278,320.947375,87.132684,1,0
0,0,10,10,9,14,23,35,34,69,0.000333,0.104042,8,2497.0062,138.722567,312.125775,81.832294,1,0
0,0,12,12,9,15,24,41,46,87,0.000333,0.132964,12,4786.700851,265.927825,398.891738,87.132684,1,0
0,0,14,14,9,16,25,47,58,105,0.000333,0.162535,12,5851.258799,325.069933,487.6049,92.529325,1,0
0,0,16,16,9,17,26,53,70,123,0.000333,0.192718,16,9250.465365,513.914743,578.154085,98.016193,1,0
0,0,11,11,10,15,25,41,37,78,0.000333,0.12074,10,3622.207828,201.233768,362.220783,91.82264,1,0
0,0,12,12,10,16,26,50,41,91,0.000333,0.14258,10,4277.400144,237.633341,427.740014,97.219281,1,0
0,0,3,3,9,11,20,12,13,25,0.000333,0.036016,4,432.192809,24.010712,108.048202,66.583073,1,0
0,0,13,13,9,17,26,50,44,94,0.000333,0.14728,8,3534.730668,196.373926,441.841334,98.016193,1,0
0,0,13,13,10,18,28,42,47,89,0.000333,0.142618,10,4278.545881,237.696993,427.854588,108.277931,1,0
0,0,11,11,9,15,24,35,37,72,0.000333,0.110039,8,2640.9384,146.7188,330.1173,87.132684,1,0
0,0,11,11,13,17,30,42,41,83,0.000333,0.135757,12,4887.263033,271.514613,407.271919,117.592585,1,0
0,0,11,11,12,17,29,41,41,82,0.000333,0.132785,12,4780.253299,265.569628,398.354442,112.506418,1,0
0,0,8,8,10,10,20,38,25,63,0.000333,0.09076,10,2722.8147,151.267483,272.28147,66.438562,1,0
0,0,8,8,10,10,20,38,25,63,0.000333,0.09076,10,2722.8147,151.267483,272.28147,66.438562,1,0
0,0,8,8,10,10,20,38,25,63,0.000333,0.09076,10,2722.8147,151.267483,272.28147,66.438562,1,0
0,0,8,8,10,10,20,38,25,63,0.000333,0.09076,10,2722.8147,151.267483,272.28147,66.438562,1,0
0,0,8,8,10,10,20,38,25,63,0.000333,0.09076,10,2722.8147,151.267483,272.28147,66.438562,1,0
0,0,8,8,10,10,20,38,25,63,0.000333,0.09076,10,2722.8147,151.267483,272.28147,66.438562,1,0
0,0,8,8,10,10,20,38,25,63,0.000333,0.09076,10,2722.8147,151.267483,272.28147,66.438562,1,0
0,0,8,8,10,10,20,38,25,63,0.000333,0.09076,10,2722.8147,151.267483,272.28147,66.438562,1,0
0,0,8,8,10,10,20,38,25,63,0.000333,0.09076,10,2722.8147,151.267483,272.28147,66.438562,1,0
0,0,8,8,10,10,20,38,25,63,0.000333,0.09076,10,2722.8147,151.267483,272.28147,66.438562,1,0
0,0,8,8,10,10,20,38,25,63,0.000333,0.09076,10,2722.8147,151.267483,272.28147,66.438562,1,0
0,0,8,8,10,10,20,38,25,63,0.000333,0.09076,10,2722.8147,151.267483,272.28147,66.438562,1,0
0,0,8,8,10,10,20,38,25,63,0.000333,0.09076,10,2722.8147,151.267483,272.28147,66.438562,1,0
0,0,8,8,10,10,20,38,25,63,0.000333,0.09076,10,2722.8147,151.267483,272.28147,66.438562,1,0
0,0,8,8,10,10,20,38,25,63,0.000333,0.09076,10,2722.8147,151.267483,272.28147,66.438562,1,0
0,0,8,8,10,10,20,38,25,63,0.000333,0.09076,10,2722.8147,151.267483,272.28147,66.438562,1,0
0,0,8,8,10,10,20,38,25,63,0.000333,0.09076,10,2722.8147,151.267483,272.28147,66.438562,1,0
0,0,8,8,10,10,20,38,25,63,0.000333,0.09076,10,2722.8147,151.267483,272.28147,66.438562,1,0
0,0,8,8,10,10,20,38,25,63,0.000333,0.09076,10,2722.8147,151.267483,272.28147,66.438562,1,0
0,0,8,8,10,10,20,38,25,63,0.000333,0.09076,10,2722.8147,151.267483,272.28147,66.438562,1,0
0,0,8,8,10,10,20,38,25,63,0.000333,0.09076,10,2722.8147,151.267483,272.28147,66.438562,1,0
0,0,8,8,10,10,20,38,25,63,0.000333,0.09076,10,2722.8147,151.267483,272.28147,66.438562,1,0
0,0,8,8,10,10,20,38,25,63,0.000333,0.09076,10,2722.8147,151.267483,272.28147,66.438562,1,0
0,0,8,8,10,10,20,38,25,63,0.000333,0.09076,10,2722.8147,151.267483,272.28147,66.438562,1,0
0,0,8,8,10,10,20,38,25,63,0.000333,0.09076,10,2722.8147,151.267483,272.28147,66.438562,1,0
0,0,8,8,10,10,20,38,25,63,0.000333,0.09076,10,2722.8147,151.267483,272.28147,66.438562,1,0
0,0,8,8,10,10,20,38,25,63,0.000333,0.09076,10,2722.8147,151.267483,272.28147,66.438562,1,0
0,0,8,8,10,10,20,38,25,63,0.000333,0.09076,10,2722.8147,151.267483,272.28147,66.438562,1,0
0,0,8,8,10,10,20,38,25,63,0.000333,0.09076,10,2722.8147,151.267483,272.28147,66.438562,1,0
0,0,8,8,10,10,20,38,25,63,0.000333,0.09076,10,2722.8147,151.267483,272.28147,66.438562,1,0
0,0,8,8,10,10,20,38,25,63,0.000333,0.09076,10,2722.8147,151.267483,272.28147,66.438562,1,0
0,0,10,10,10,11,21,44,31,75,0.000333,0.109808,10,3294.238067,183.013226,329.423807,71.273029,1,0
0,0,13,13,11,12,23,59,39,98,0.000333,0.14777,15,6649.636075,369.424226,443.309072,81.073298,1,0
0,0,10,10,11,15,26,43,33,76,0.000333,0.119078,10,3572.334186,198.46301,357.233419,96.657107,1,0
0,0,10,10,10,15,25,44,37,81,0.000333,0.125384,10,3761.523514,208.973529,376.152351,91.82264,1,0
0,0,11,11,11,14,25,53,37,90,0.000333,0.139316,10,4179.470571,232.192809,417.947057,91.356717,1,0
0,0,11,11,10,16,26,44,38,82,0.000333,0.128479,10,3854.360569,214.131143,385.436057,97.219281,1,0
0,0,10,10,10,15,25,44,37,81,0.000333,0.125384,10,3761.523514,208.973529,376.152351,91.82264,1,0
0,0,12,12,10,16,26,50,49,99,0.000333,0.155115,15,6980.152981,387.786277,465.343532,97.219281,1,0
0,0,14,14,10,17,27,56,61,117,0.000333,0.185441,15,8344.827566,463.601531,556.321838,102.706149,1,0
0,0,16,16,10,18,28,62,73,135,0.000333,0.216331,20,12979.85829,721.103238,648.992914,108.277931,1,0
0,0,11,11,11,16,27,50,40,90,0.000333,0.142647,10,4279.398752,237.744375,427.939875,102.053748,1,0
0,0,12,12,11,17,28,59,44,103,0.000333,0.165053,10,4951.57557,275.087532,495.157557,107.540616,1,0
0,0,11,11,10,16,26,52,41,93,0.000333,0.145714,10,4371.408938,242.856052,437.140894,97.219281,1,0
0,0,8,8,9,14,23,34,30,64,0.000333,0.096503,8,2316.063722,128.670207,289.507965,81.832294,1,0
0,0,13,13,11,18,29,51,50,101,0.000333,0.163552,10,4906.560805,272.586711,490.656081,113.112398,1,0
0,0,11,11,10,16,26,44,40,84,0.000333,0.131612,10,3948.369363,219.353854,394.836936,97.219281,1,0
0,0,11,11,14,18,32,51,44,95,0.000333,0.158333,14,6650,369.444444,475,128.361619,1,0
0,0,11,11,13,18,31,50,44,94,0.000333,0.155231,12,5588.333438,310.462969,465.694453,123.164366,1,0
0,0,8,8,9,9,18,29,22,51,0.000333,0.070889,8,1701.329401,94.5183,212.666175,57.05865,1,0
0,0,8,8,9,9,18,29,22,51,0.000333,0.070889,8,1701.329401,94.5183,212.666175,57.05865,1,0
0,0,8,8,9,9,18,29,22,51,0.000333,0.070889,8,1701.329401,94.5183,212.666175,57.05865,1,0
0,0,8,8,9,9,18,29,22,51,0.000333,0.070889,8,1701.329401,94.5183,212.666175,57.05865,1,0
0,0,8,8,9,9,18,29,22,51,0.000333,0.070889,8,1701.329401,94.5183,212.666175,57.05865,1,0
0,0,8,8,9,9,18,29,22,51,0.000333,0.070889,8,1701.329401,94.5183,212.666175,57.05865,1,0
0,0,8,8,9,9,18,29,22,51,0.000333,0.070889,8,1701.329401,94.5183,212.666175,57.05865,1,0
0,0,8,8,9,9,18,29,22,51,0.000333,0.070889,8,1701.329401,94.5183,212.666175,57.05865,1,0
0,0,8,8,9,9,18,29,22,51,0.000333,0.070889,8,1701.329401,94.5183,212.666175,57.05865,1,0
0,0,8,8,9,9,18,29,22,51,0.000333,0.070889,8,1701.329401,94.5183,212.666175,57.05865,1,0
0,0,8,8,9,9,18,29,22,51,0.000333,0.070889,8,1701.329401,94.5183,212.666175,57.05865,1,0
0,0,8,8,9,9,18,29,22,51,0.000333,0.070889,8,1701.329401,94.5183,212.666175,57.05865,1,0
0,0,8,8,9,9,18,29,22,51,0.000333,0.070889,8,1701.329401,94.5183,212.666175,57.05865,1,0
0,0,8,8,9,9,18,29,22,51,0.000333,0.070889,8,1701.329401,94.5183,212.666175,57.05865,1,0
0,0,8,8,9,9,18,29,22,51,0.000333,0.070889,8,1701.329401,94.5183,212.666175,57.05865,1,0
0,0,8,8,9,9,18,29,22,51,0.000333,0.070889,8,1701.329401,94.5183,212.666175,57.05865,1,0
0,0,8,8,9,9,18,29,22,51,0.000333,0.070889,8,1701.329401,94.5183,212.666175,57.05865,1,0
0,0,8,8,9,9,18,29,22,51,0.000333,0.070889,8,1701.329401,94.5183,212.666175,57.05865,1,0
0,0,8,8,9,9,18,29,22,51,0.000333,0.070889,8,1701.329401,94.5183,212.666175,57.05865,1,0
0,0,8,8,9,9,18,29,22,51,0.000333,0.070889,8,1701.329401,94.5183,212.666175,57.05865,1,0
0,0,8,8,9,9,18,29,22,51,0.000333,0.070889,8,1701.329401,94.5183,212.666175,57.05865,1,0
0,0,8,8,9,9,18,29,22,51,0.000333,0.070889,8,1701.329401,94.5183,212.666175,57.05865,1,0
0,0,8,8,9,9,18,29,22,51,0.000333,0.070889,8,1701.329401,94.5183,212.666175,57.05865,1,0
0,0,8,8,9,9,18,29,22,51,0.000333,0.070889,8,1701.329401,94.5183,212.666175,57.05865,1,0
0,0,8,8,9,9,18,29,22,51,0.000333,0.070889,8,1701.329401,94.5183,212.666175,57.05865,1,0
0,0,8,8,9,9,18,29,22,51,0.000333,0.070889,8,1701.329401,94.5183,212.666175,57.05865,1,0
0,0,8,8,9,9,18,29,22,51,0.000333,0.070889,8,1701.329401,94.5183,212.666175,57.05865,1,0
0,0,8,8,9,9,18,29,22,51,0.000333,0.070889,8,1701.329401,94.5183,212.666175,57.05865,1,0
0,0,8,8,9,9,18,29,22,51,0.000333,0.070889,8,1701.329401,94.5183,212.666175,57.05865,1,0
0,0,8,8,9,9,18,29,22,51,0.000333,0.070889,8,1701.329401,94.5183,212.666175,57.05865,1,0
0,0,8,8,9,9,18,29,22,51,0.000333,0.070889,8,1701.329401,94.5183,212.666175,57.05865,1,0
0,0,10,10,9,10,19,35,28,63,0.000333,0.089206,8,2140.955467,118.94197,267.619433,61.748606,1,0
0,0,12,12,10,11,21,47,34,81,0.000333,0.118593,15,5336.665669,296.481426,355.777711,71.273029,1,0
0,0,10,10,10,14,24,34,30,64,0.000333,0.097813,10,2934.376,163.020889,293.4376,86.52225,1,0
0,0,10,10,9,14,23,35,34,69,0.000333,0.104042,8,2497.0062,138.722567,312.125775,81.832294,1,0
0,0,11,11,10,13,23,44,34,78,0.000333,0.117613,10,3528.378326,196.021018,352.837833,81.324997,1,0
0,0,11,11,9,15,24,35,35,70,0.000333,0.106982,8,2567.579,142.643278,320.947375,87.132684,1,0
0,0,10,10,9,14,23,35,34,69,0.000333,0.104042,8,2497.0062,138.722567,312.125775,81.832294,1,0
0,0,12,12,9,15,24,41,46,87,0.000333,0.132964,12,4786.700851,265.927825,398.891738,87.132684,1,0
0,0,14,14,9,16,25,47,58,105,0.000333,0.162535,12,5851.258799,325.069933,487.6049,92.529325,1,0
0,0,16,16,9,17,26,53,70,123,0.000333,0.192718,16,9250.465365,513.914743,578.154085,98.016193,1,0
0,0,11,11,10,15,25,41,37,78,0.000333,0.12074,10,3622.207828,201.233768,362.220783,91.82264,1,0
0,0,12,12,10,16,26,50,41,91,0.000333,0.14258,10,4277.400144,237.633341,427.740014,97.219281,1,0
0,0,11,11,9,15,24,43,38,81,0.000333,0.123794,8,2971.0557,165.05865,371.381963,87.132684,1,0
0,0,13,13,9,17,26,50,44,94,0.000333,0.14728,8,3534.730668,196.373926,441.841334,98.016193,1,0
0,0,13,13,10,17,27,42,47,89,0.000333,0.141062,10,4231.849877,235.102771,423.184988,102.706149,1,0
0,0,11,11,9,15,24,35,37,72,0.000333,0.110039,8,2640.9384,146.7188,330.1173,87.132684,1,0
0,0,11,11,13,17,30,42,41,83,0.000333,0.135757,12,4887.263033,271.514613,407.271919,117.592585,1,0
0,0,11,11,12,17,29,41,41,82,0.000333,0.132785,12,4780.253299,265.569628,398.354442,112.506418,1,0
0,0,7,7,10,10,20,35,23,58,0.000333,0.083557,10,2506.718295,139.262128,250.67183,66.438562,1,0
0,0,7,7,10,10,20,35,23,58,0.000333,0.083557,10,2506.718295,139.262128,250.67183,66.438562,1,0
0,0,7,7,10,10,20,35,23,58,0.000333,0.083557,10,2506.718295,139.262128,250.67183,66.438562,1,0
0,0,7,7,10,10,20,35,23,58,0.000333,0.083557,10,2506.718295,139.262128,250.67183,66.438562,1,0
0,0,7,7,10,10,20,35,23,58,0.000333,0.083557,10,2506.718295,139.262128,250.67183,66.438562,1,0
0,0,7,7,10,10,20,35,23,58,0.000333,0.083557,10,2506.718295,139.262128,250.67183,66.438562,1,0
0,0,7,7,10,10,20,35,23,58,0.000333,0.083557,10,2506.718295,139.262128,250.67183,66.438562,1,0
0,0,7,7,10,10,20,35,23,58,0.000333,0.083557,10,2506.718295,139.262128,250.67183,66.438562,1,0
0,0,7,7,10,10,20,35,23,58,0.000333,0.083557,10,2506.718295,139.262128,250.67183,66.438562,1,0
0,0,7,7,10,10,20,35,23,58,0.000333,0.083557,10,2506.718295,139.262128,250.67183,66.438562,1,0
0,0,7,7,10,10,20,35,23,58,0.000333,0.083557,10,2506.718295,139.262128,250.67183,66.438562,1,0
0,0,7,7,10,10,20,35,23,58,0.000333,0.083557,10,2506.718295,139.262128,250.67183,66.438562,1,0
0,0,7,7,10,10,20,35,23,58,0.000333,0.083557,10,2506.718295,139.262128,250.67183,66.438562,1,0
0,0,7,7,10,10,20,35,23,58,0.000333,0.083557,10,2506.718295,139.262128,250.67183,66.438562,1,0
0,0,7,7,10,10,20,35,23,58,0.000333,0.083557,10,2506.718295,139.262128,250.67183,66.438562,1,0
0,0,7,7,10,10,20,35,23,58,0.000333,0.083557,10,2506.718295,139.262128,250.67183,66.438562,1,0
0,0,7,7,10,10,20,35,23,58,0.000333,0.083557,10,2506.718295,139.262128,250.67183,66.438562,1,0
0,0,7,7,10,10,20,35,23,58,0.000333,0.083557,10,2506.718295,139.262128,250.67183,66.438562,1,0
0,0,7,7,10,10,20,35,23,58,0.000333,0.083557,10,2506.718295,139.262128,250.67183,66.438562,1,0
0,0,7,7,10,10,20,35,23,58,0.000333,0.083557,10,2506.718295,139.262128,250.67183,66.438562,1,0
0,0,7,7,10,10,20,35,23,58,0.000333,0.083557,10,2506.718295,139.262128,250.67183,66.438562,1,0
0,0,7,7,10,10,20,35,23,58,0.000333,0.083557,10,2506.718295,139.262128,250.67183,66.438562,1,0
0,0,7,7,10,10,20,35,23,58,0.000333,0.083557,10,2506.718295,139.262128,250.67183,66.438562,1,0
0,0,7,7,10,10,20,35,23,58,0.000333,0.083557,10,2506.718295,139.262128,250.67183,66.438562,1,0
0,0,7,7,10,10,20,35,23,58,0.000333,0.083557,10,2506.718295,139.262128,250.67183,66.438562,1,0
0,0,7,7,10,10,20,35,23,58,0.000333,0.083557,10,2506.718295,139.262128,250.67183,66.438562,1,0
0,0,7,7,10,10,20,35,23,58,0.000333,0.083557,10,2506.718295,139.262128,250.67183,66.438562,1,0
0,0,7,7,10,10,20,35,23,58,0.000333,0.083557,10,2506.718295,139.262128,250.67183,66.438562,1,0
0,0,7,7,10,10,20,35,23,58,0.000333,0.083557,10,2506.718295,139.262128,250.67183,66.438562,1,0
0,0,7,7,10,10,20,35,23,58,0.000333,0.083557,10,2506.718295,139.262128,250.67183,66.438562,1,0
0,0,7,7,10,10,20,35,23,58,0.000333,0.083557,10,2506.718295,139.262128,250.67183,66.438562,1,0
0,0,10,10,12,13,25,46,35,81,0.000333,0.125384,12,4513.828216,250.768234,376.152351,91.125266,1,0
0,0,10,10,12,13,25,46,35,81,0.000333,0.125384,12,4513.828216,250.768234,376.152351,91.125266,1,0
0,0,11,11,11,16,27,47,45,92,0.000333,0.145817,10,4374.496502,243.027583,437.44965,102.053748,1,0
0,0,11,11,11,17,28,47,45,92,0.000333,0.147426,10,4422.766528,245.709252,442.276653,107.540616,1,0
0,0,9,9,10,11,21,41,29,70,0.000333,0.102487,10,3074.622196,170.812344,307.46222,71.273029,1,0
0,0,11,11,11,12,23,53,35,88,0.000333,0.132691,10,3980.734521,221.151918,398.073452,81.073298,1,0
0,0,9,9,11,15,26,40,31,71,0.000333,0.111244,10,3337.3122,185.406233,333.73122,96.657107,1,0
0,0,9,9,10,15,25,41,35,76,0.000333,0.117644,10,3529.330704,196.073928,352.93307,91.82264,1,0
0,0,10,10,12,12,24,46,33,79,0.000333,0.120737,12,4346.544451,241.474692,362.212038,86.0391,1,0
0,0,10,10,11,14,25,50,35,85,0.000333,0.131576,10,3947.277761,219.293209,394.727776,91.356717,1,0
0,0,10,10,10,16,26,41,36,77,0.000333,0.120645,10,3619.338583,201.074366,361.933858,97.219281,1,0
0,0,9,9,10,15,25,41,35,76,0.000333,0.117644,10,3529.330704,196.073928,352.93307,91.82264,1,0
0,0,11,11,10,16,26,47,47,94,0.000333,0.14728,10,4418.413335,245.467408,441.841334,97.219281,1,0
0,0,13,13,10,17,27,53,59,112,0.000333,0.177516,15,7988.211004,443.7895,532.5474,102.706149,1,0
0,0,15,15,10,18,28,59,71,130,0.000333,0.208319,15,9374.342098,520.796783,624.95614,108.277931,1,0
0,0,9,9,11,14,25,41,30,71,0.000333,0.109905,10,3297.137895,183.174327,329.713789,91.356717,1,0
0,0,10,10,11,16,27,47,38,85,0.000333,0.134722,10,4041.654377,224.536354,404.165438,102.053748,1,0
0,0,11,11,11,17,28,56,42,98,0.000333,0.15704,10,4711.207824,261.733768,471.120782,107.540616,1,0
0,0,10,10,10,16,26,49,39,88,0.000333,0.13788,10,4136.386952,229.799275,413.638695,97.219281,1,0
0,0,12,12,10,18,28,56,45,101,0.000333,0.161848,10,4855.428471,269.746026,485.542847,108.277931,1,0
0,0,12,12,11,18,29,48,48,96,0.000333,0.155455,10,4663.661755,259.09232,466.366176,113.112398,1,0
0,0,10,10,10,16,26,41,38,79,0.000333,0.123778,10,3713.347377,206.297077,371.334738,97.219281,1,0
0,0,10,10,14,18,32,48,42,90,0.000333,0.15,14,6300,350,450,128.361619,1,0
0,0,10,10,13,18,31,47,42,89,0.000333,0.146974,12,5291.081659,293.948981,440.923472,123.164366,1,0
0,0,7,7,10,10,20,35,23,58,0.000333,0.083557,10,2506.718295,139.262128,250.67183,66.438562,1,0
0,0,7,7,10,10,20,35,23,58,0.000333,0.083557,10,2506.718295,139.262128,250.67183,66.438562,1,0
0,0,7,7,10,10,20,35,23,58,0.000333,0.083557,10,2506.718295,139.262128,250.67183,66.438562,1,0
0,0,7,7,10,10,20,35,23,58,0.000333,0.083557,10,2506.718295,139.262128,250.67183,66.438562,1,0
0,0,7,7,10,10,20,35,23,58,0.000333,0.083557,10,2506.718295,139.262128,250.67183,66.438562,1,0
0,0,7,7,10,10,20,35,23,58,0.000333,0.083557,10,2506.718295,139.262128,250.67183,66.438562,1,0
0,0,7,7,10,10,20,35,23,58,0.000333,0.083557,10,2506.718295,139.262128,250.67183,66.438562,1,0
0,0,7,7,10,10,20,35,23,58,0.000333,0.083557,10,2506.718295,139.262128,250.67183,66.438562,1,0
0,0,7,7,10,10,20,35,23,58,0.000333,0.083557,10,2506.718295,139.262128,250.67183,66.438562,1,0
0,0,7,7,10,10,20,35,23,58,0.000333,0.083557,10,2506.718295,139.262128,250.67183,66.438562,1,0
0,0,7,7,10,10,20,35,23,58,0.000333,0.083557,10,2506.718295,139.262128,250.67183,66.438562,1,0
0,0,7,7,10,10,20,35,23,58,0.000333,0.083557,10,2506.718295,139.262128,250.67183,66.438562,1,0
0,0,7,7,10,10,20,35,23,58,0.000333,0.083557,10,2506.718295,139.262128,250.67183,66.438562,1,0
0,0,7,7,10,10,20,35,23,58,0.000333,0.083557,10,2506.718295,139.262128,250.67183,66.438562,1,0
0,0,7,7,10,10,20,35,23,58,0.000333,0.083557,10,2506.718295,139.262128,250.67183,66.438562,1,0
0,0,7,7,10,10,20,35,23,58,0.000333,0.083557,10,2506.718295,139.262128,250.67183,66.438562,1,0
0,0,7,7,10,10,20,35,23,58,0.000333,0.083557,10,2506.718295,139.262128,250.67183,66.438562,1,0
0,0,7,7,10,10,20,35,23,58,0.000333,0.083557,10,2506.718295,139.262128,250.67183,66.438562,1,0
0,0,7,7,10,10,20,35,23,58,0.000333,0.083557,10,2506.718295,139.262128,250.67183,66.438562,1,0
0,0,7,7,10,10,20,35,23,58,0.000333,0.083557,10,2506.718295,139.262128,250.67183,66.438562,1,0
0,0,7,7,10,10,20,35,23,58,0.000333,0.083557,10,2506.718295,139.262128,250.67183,66.438562,1,0
0,0,7,7,10,10,20,35,23,58,0.000333,0.083557,10,2506.718295,139.262128,250.67183,66.438562,1,0
0,0,7,7,10,10,20,35,23,58,0.000333,0.083557,10,2506.718295,139.262128,250.67183,66.438562,1,0
0,0,7,7,10,10,20,35,23,58,0.000333,0.083557,10,2506.718295,139.262128,250.67183,66.438562,1,0
0,0,7,7,10,10,20,35,23,58,0.000333,0.083557,10,2506.718295,139.262128,250.67183,66.438562,1,0
0,0,7,7,10,10,20,35,23,58,0.000333,0.083557,10,2506.718295,139.262128,250.67183,66.438562,1,0
0,0,7,7,10,10,20,35,23,58,0.000333,0.083557,10,2506.718295,139.262128,250.67183,66.438562,1,0
0,0,7,7,10,10,20,35,23,58,0.000333,0.083557,10,2506.718295,139.262128,250.67183,66.438562,1,0
0,0,7,7,10,10,20,35,23,58,0.000333,0.083557,10,2506.718295,139.262128,250.67183,66.438562,1,0
0,0,7,7,10,10,20,35,23,58,0.000333,0.083557,10,2506.718295,139.262128,250.67183,66.438562,1,0
0,0,7,7,10,10,20,35,23,58,0.000333,0.083557,10,2506.718295,139.262128,250.67183,66.438562,1,0
0,0,10,10,12,13,25,46,35,81,0.000333,0.125384,12,4513.828216,250.768234,376.152351,91.125266,1,0
0,0,10,10,12,13,25,46,35,81,0.000333,0.125384,12,4513.828216,250.768234,376.152351,91.125266,1,0
0,0,10,10,11,15,26,45,39,84,0.000333,0.131612,10,3948.369363,219.353854,394.836936,96.657107,1,0
0,0,10,10,11,15,26,45,39,84,0.000333,0.131612,10,3948.369363,219.353854,394.836936,96.657107,1,0
0,0,9,9,10,11,21,41,29,70,0.000333,0.102487,10,3074.622196,170.812344,307.46222,71.273029,1,0
0,0,11,11,11,12,23,53,35,88,0.000333,0.132691,10,3980.734521,221.151918,398.073452,81.073298,1,0
0,0,9,9,11,15,26,40,31,71,0.000333,0.111244,10,3337.3122,185.406233,333.73122,96.657107,1,0
0,0,9,9,10,15,25,41,35,76,0.000333,0.117644,10,3529.330704,196.073928,352.93307,91.82264,1,0
0,0,10,10,12,12,24,46,33,79,0.000333,0.120737,12,4346.544451,241.474692,362.212038,86.0391,1,0
0,0,10,10,11,14,25,50,35,85,0.000333,0.131576,10,3947.277761,219.293209,394.727776,91.356717,1,0
0,0,10,10,10,16,26,41,36,77,0.000333,0.120645,10,3619.338583,201.074366,361.933858,97.219281,1,0
0,0,9,9,10,15,25,41,35,76,0.000333,0.117644,10,3529.330704,196.073928,352.93307,91.82264,1,0
0,0,11,11,10,16,26,47,47,94,0.000333,0.14728,10,4418.413335,245.467408,441.841334,97.219281,1,0
0,0,13,13,10,17,27,53,59,112,0.000333,0.177516,15,7988.211004,443.7895,532.5474,102.706149,1,0
0,0,15,15,10,18,28,59,71,130,0.000333,0.208319,15,9374.342098,520.796783,624.95614,108.277931,1,0
0,0,10,10,11,14,25,45,37,82,0.000333,0.126932,10,3807.962076,211.553449,380.796208,91.356717,1,0
0,0,10,10,11,16,27,47,38,85,0.000333,0.134722,10,4041.654377,224.536354,404.165438,102.053748,1,0
0,0,11,11,11,17,28,56,42,98,0.000333,0.15704,10,4711.207824,261.733768,471.120782,107.540616,1,0
0,0,10,10,10,16,26,49,39,88,0.000333,0.13788,10,4136.386952,229.799275,413.638695,97.219281,1,0
0,0,12,12,10,18,28,56,45,101,0.000333,0.161848,10,4855.428471,269.746026,485.542847,108.277931,1,0
0,0,12,12,11,18,29,48,48,96,0.000333,0.155455,10,4663.661755,259.09232,466.366176,113.112398,1,0
0,0,10,10,10,16,26,41,38,79,0.000333,0.123778,10,3713.347377,206.297077,371.334738,97.219281,1,0
0,0,10,10,14,18,32,48,42,90,0.000333,0.15,14,6300,350,450,128.361619,1,0
0,0,10,10,13,18,31,47,42,89,0.000333,0.146974,12,5291.081659,293.948981,440.923472,123.164366,1,0
0,0,7,7,9,9,18,26,20,46,0.000333,0.063939,8,1534.532401,85.2518,191.81655,57.05865,1,0
0,0,7,7,9,9,18,26,20,46,0.000333,0.063939,8,1534.532401,85.2518,191.81655,57.05865,1,0
0,0,7,7,9,9,18,26,20,46,0.000333,0.063939,8,1534.532401,85.2518,191.81655,57.05865,1,0
0,0,7,7,9,9,18,26,20,46,0.000333,0.063939,8,1534.532401,85.2518,191.81655,57.05865,1,0
0,0,7,7,9,9,18,26,20,46,0.000333,0.063939,8,1534.532401,85.2518,191.81655,57.05865,1,0
0,0,7,7,9,9,18,26,20,46,0.000333,0.063939,8,1534.532401,85.2518,191.81655,57.05865,1,0
0,0,7,7,9,9,18,26,20,46,0.000333,0.063939,8,1534.532401,85.2518,191.81655,57.05865,1,0
0,0,7,7,9,9,18,26,20,46,0.000333,0.063939,8,1534.532401,85.2518,191.81655,57.05865,1,0
0,0,7,7,9,9,18,26,20,46,0.000333,0.063939,8,1534.532401,85.2518,191.81655,57.05865,1,0
0,0,7,7,9,9,18,26,20,46,0.000333,0.063939,8,1534.532401,85.2518,191.81655,57.05865,1,0
0,0,7,7,9,9,18,26,20,46,0.000333,0.063939,8,1534.532401,85.2518,191.81655,57.05865,1,0
0,0,7,7,9,9,18,26,20,46,0.000333,0.063939,8,1534.532401,85.2518,191.81655,57.05865,1,0
0,0,7,7,9,9,18,26,20,46,0.000333,0.063939,8,1534.532401,85.2518,191.81655,57.05865,1,0
0,0,7,7,9,9,18,26,20,46,0.000333,0.063939,8,1534.532401,85.2518,191.81655,57.05865,1,0
0,0,7,7,9,9,18,26,20,46,0.000333,0.063939,8,1534.532401,85.2518,191.81655,57.05865,1,0
0,0,7,7,9,9,18,26,20,46,0.000333,0.063939,8,1534.532401,85.2518,191.81655,57.05865,1,0
0,0,7,7,9,9,18,26,20,46,0.000333,0.063939,8,1534.532401,85.2518,191.81655,57.05865,1,0
0,0,7,7,9,9,18,26,20,46,0.000333,0.063939,8,1534.532401,85.2518,191.81655,57.05865,1,0
0,0,7,7,9,9,18,26,20,46,0.000333,0.063939,8,1534.532401,85.2518,191.81655,57.05865,1,0
0,0,7,7,9,9,18,26,20,46,0.000333,0.063939,8,1534.532401,85.2518,191.81655,57.05865,1,0
0,0,7,7,9,9,18,26,20,46,0.000333,0.063939,8,1534.532401,85.2518,191.81655,57.05865,1,0
0,0,7,7,9,9,18,26,20,46,0.000333,0.063939,8,1534.532401,85.2518,191.81655,57.05865,1,0
0,0,7,7,9,9,18,26,20,46,0.000333,0.063939,8,1534.532401,85.2518,191.81655,57.05865,1,0
0,0,7,7,9,9,18,26,20,46,0.000333,0.063939,8,1534.532401,85.2518,191.81655,57.05865,1,0
0,0,7,7,9,9,18,26,20,46,0.000333,0.063939,8,1534.532401,85.2518,191.81655,57.05865,1,0
0,0,7,7,9,9,18,26,20,46,0.000333,0.063939,8,1534.532401,85.2518,191.81655,57.05865,1,0
0,0,7,7,9,9,18,26,20,46,0.000333,0.063939,8,1534.532401,85.2518,191.81655,57.05865,1,0
0,0,7,7,9,9,18,26,20,46,0.000333,0.063939,8,1534.532401,85.2518,191.81655,57.05865,1,0
0,0,7,7,9,9,18,26,20,46,0.000333,0.063939,8,1534.532401,85.2518,191.81655,57.05865,1,0
0,0,7,7,9,9,18,26,20,46,0.000333,0.063939,8,1534.532401,85.2518,191.81655,57.05865,1,0
0,0,7,7,9,9,18,26,20,46,0.000333,0.063939,8,1534.532401,85.2518,191.81655,57.05865,1,0
0,0,10,10,11,12,23,37,32,69,0.000333,0.104042,10,3121.25775,173.403208,312.125775,81.073298,1,0
0,0,10,10,11,12,23,37,32,69,0.000333,0.104042,10,3121.25775,173.403208,312.125775,81.073298,1,0
0,0,10,10,10,14,24,36,36,72,0.000333,0.110039,10,3301.173001,183.3985,330.1173,86.52225,1,0
0,0,11,11,10,16,26,38,42,80,0.000333,0.125345,10,3760.351775,208.908432,376.035177,97.219281,1,0
0,0,9,9,9,10,19,32,26,58,0.000333,0.082127,8,1971.038366,109.502131,246.379796,61.748606,1,0
0,0,12,12,10,11,21,47,34,81,0.000333,0.118593,15,5336.665669,296.481426,355.777711,71.273029,1,0
0,0,9,9,10,14,24,31,28,59,0.000333,0.090171,10,2705.127875,150.284882,270.512788,86.52225,1,0
0,0,9,9,9,14,23,32,32,64,0.000333,0.096503,8,2316.063722,128.670207,289.507965,81.832294,1,0
0,0,10,10,11,11,22,37,30,67,0.000333,0.099594,10,2987.819184,165.989955,298.781918,76.107496,1,0
0,0,10,10,10,13,23,41,32,73,0.000333,0.110073,10,3302.200228,183.455568,330.220023,81.324997,1,0
0,0,10,10,9,15,24,32,33,65,0.000333,0.099341,8,2384.1805,132.454472,298.022563,87.132684,1,0
0,0,9,9,9,14,23,32,32,64,0.000333,0.096503,8,2316.063722,128.670207,289.507965,81.832294,1,0
0,0,11,11,9,15,24,38,44,82,0.000333,0.125322,8,3007.7354,167.096411,375.966925,87.132684,1,0
0,0,13,13,9,16,25,44,56,100,0.000333,0.154795,12,5572.627428,309.590413,464.385619,92.529325,1,0
0,0,15,15,9,17,26,50,68,118,0.000333,0.184884,16,8874.430188,493.023899,554.651887,98.016193,1,0
0,0,10,10,10,13,23,36,34,70,0.000333,0.10555,10,3166.493369,175.916298,316.649337,81.324997,1,0
0,0,10,10,10,15,25,38,35,73,0.000333,0.113001,10,3390.015019,188.334168,339.001502,91.82264,1,0
0,0,11,11,10,16,26,47,39,86,0.000333,0.134746,10,4042.378158,224.576564,404.237816,97.219281,1,0
0,0,10,10,9,15,24,40,36,76,0.000333,0.116152,8,2787.6572,154.869844,348.45715,87.132684,1,0
0,0,12,12,9,17,26,47,42,89,0.000333,0.139446,8,3346.713079,185.928504,418.339135,98.016193,1,0
0,0,12,12,10,17,27,39,45,84,0.000333,0.133137,10,3994.105502,221.89475,399.41055,102.706149,1,0
0,0,10,10,9,15,24,32,35,67,0.000333,0.102397,8,2457.5399,136.529994,307.192488,87.132684,1,0
0,0,10,10,13,17,30,39,39,78,0.000333,0.127579,12,4592.849597,255.158311,382.737466,117.592585,1,0
0,0,10,10,12,18,30,38,38,76,0.000333,0.124308,12,4475.084223,248.61579,372.923685,118.0782,1,0
0,0,7,7,9,9,18,26,20,46,0.000333,0.063939,8,1534.532401,85.2518,191.81655,57.05865,1,0
0,0,7,7,9,9,18,26,20,46,0.000333,0.063939,8,1534.532401,85.2518,191.81655,57.05865,1,0
0,0,7,7,9,9,18,26,20,46,0.000333,0.063939,8,1534.532401,85.2518,191.81655,57.05865,1,0
0,0,7,7,9,9,18,26,20,46,0.000333,0.063939,8,1534.532401,85.2518,191.81655,57.05865,1,0
0,0,7,7,9,9,18,26,20,46,0.000333,0.063939,8,1534.532401,85.2518,191.81655,57.05865,1,0
0,0,7,7,9,9,18,26,20,46,0.000333,0.063939,8,1534.532401,85.2518,191.81655,57.05865,1,0
0,0,7,7,9,9,18,26,20,46,0.000333,0.063939,8,1534.532401,85.2518,191.81655,57.05865,1,0
0,0,7,7,9,9,18,26,20,46,0.000333,0.063939,8,1534.532401,85.2518,191.81655,57.05865,1,0
0,0,7,7,9,9,18,26,20,46,0.000333,0.063939,8,1534.532401,85.2518,191.81655,57.05865,1,0
0,0,7,7,9,9,18,26,20,46,0.000333,0.063939,8,1534.532401,85.2518,191.81655,57.05865,1,0
0,0,7,7,9,9,18,26,20,46,0.000333,0.063939,8,1534.532401,85.2518,191.81655,57.05865,1,0
0,0,7,7,9,9,18,26,20,46,0.000333,0.063939,8,1534.532401,85.2518,191.81655,57.05865,1,0
0,0,7,7,9,9,18,26,20,46,0.000333,0.063939,8,1534.532401,85.2518,191.81655,57.05865,1,0
0,0,7,7,9,9,18,26,20,46,0.000333,0.063939,8,1534.532401,85.2518,191.81655,57.05865,1,0
0,0,7,7,9,9,18,26,20,46,0.000333,0.063939,8,1534.532401,85.2518,191.81655,57.05865,1,0
0,0,7,7,9,9,18,26,20,46,0.000333,0.063939,8,1534.532401,85.2518,191.81655,57.05865,1,0
0,0,7,7,9,9,18,26,20,46,0.000333,0.063939,8,1534.532401,85.2518,191.81655,57.05865,1,0
0,0,7,7,9,9,18,26,20,46,0.000333,0.063939,8,1534.532401,85.2518,191.81655,57.05865,1,0
0,0,7,7,9,9,18,26,20,46,0.000333,0.063939,8,1534.532401,85.2518,191.81655,57.05865,1,0
0,0,7,7,9,9,18,26,20,46,0.000333,0.063939,8,1534.532401,85.2518,191.81655,57.05865,1,0
0,0,7,7,9,9,18,26,20,46,0.000333,0.063939,8,1534.532401,85.2518,191.81655,57.05865,1,0
0,0,7,7,9,9,18,26,20,46,0.000333,0.063939,8,1534.532401,85.2518,191.81655,57.05865,1,0
0,0,7,7,9,9,18,26,20,46,0.000333,0.063939,8,1534.532401,85.2518,191.81655,57.05865,1,0
0,0,7,7,9,9,18,26,20,46,0.000333,0.063939,8,1534.532401,85.2518,191.81655,57.05865,1,0
0,0,7,7,9,9,18,26,20,46,0.000333,0.063939,8,1534.532401,85.2518,191.81655,57.05865,1,0
0,0,7,7,9,9,18,26,20,46,0.000333,0.063939,8,1534.532401,85.2518,191.81655,57.05865,1,0
0,0,7,7,9,9,18,26,20,46,0.000333,0.063939,8,1534.532401,85.2518,191.81655,57.05865,1,0
0,0,7,7,9,9,18,26,20,46,0.000333,0.063939,8,1534.532401,85.2518,191.81655,57.05865,1,0
0,0,7,7,9,9,18,26,20,46,0.000333,0.063939,8,1534.532401,85.2518,191.81655,57.05865,1,0
0,0,7,7,9,9,18,26,20,46,0.000333,0.063939,8,1534.532401,85.2518,191.81655,57.05865,1,0
0,0,7,7,9,9,18,26,20,46,0.000333,0.063939,8,1534.532401,85.2518,191.81655,57.05865,1,0
0,0,10,10,11,12,23,37,32,69,0.000333,0.104042,10,3121.25775,173.403208,312.125775,81.073298,1,0
0,0,10,10,11,12,23,37,32,69,0.000333,0.104042,10,3121.25775,173.403208,312.125775,81.073298,1,0
0,0,11,11,10,16,26,38,42,80,0.000333,0.125345,10,3760.351775,208.908432,376.035177,97.219281,1,0
0,0,10,10,10,14,24,36,36,72,0.000333,0.110039,10,3301.173001,183.3985,330.1173,86.52225,1,0
0,0,9,9,9,10,19,32,26,58,0.000333,0.082127,8,1971.038366,109.502131,246.379796,61.748606,1,0
0,0,12,12,10,11,21,47,34,81,0.000333,0.118593,15,5336.665669,296.481426,355.777711,71.273029,1,0
0,0,9,9,10,14,24,31,28,59,0.000333,0.090171,10,2705.127875,150.284882,270.512788,86.52225,1,0
0,0,9,9,9,14,23,32,32,64,0.000333,0.096503,8,2316.063722,128.670207,289.507965,81.832294,1,0
0,0,10,10,11,11,22,37,30,67,0.000333,0.099594,10,2987.819184,165.989955,298.781918,76.107496,1,0
0,0,10,10,10,13,23,41,32,73,0.000333,0.110073,10,3302.200228,183.455568,330.220023,81.324997,1,0
0,0,10,10,9,15,24,32,33,65,0.000333,0.099341,8,2384.1805,132.454472,298.022563,87.132684,1,0
0,0,9,9,9,14,23,32,32,64,0.000333,0.096503,8,2316.063722,128.670207,289.507965,81.832294,1,0
0,0,11,11,9,15,24,38,44,82,0.000333,0.125322,8,3007.7354,167.096411,375.966925,87.132684,1,0
0,0,13,13,9,16,25,44,56,100,0.000333,0.154795,12,5572.627428,309.590413,464.385619,92.529325,1,0
0,0,17,17,9,17,26,56,80,136,0.000333,0.213087,16,10228.15683,568.230935,639.259802,98.016193,1,0
0,0,10,10,10,13,23,36,34,70,0.000333,0.10555,10,3166.493369,175.916298,316.649337,81.324997,1,0
0,0,10,10,10,15,25,38,35,73,0.000333,0.113001,10,3390.015019,188.334168,339.001502,91.82264,1,0
0,0,11,11,10,16,26,47,39,86,0.000333,0.134746,10,4042.378158,224.576564,404.237816,97.219281,1,0
0,0,10,10,9,15,24,40,36,76,0.000333,0.116152,8,2787.6572,154.869844,348.45715,87.132684,1,0
0,0,12,12,9,17,26,47,42,89,0.000333,0.139446,8,3346.713079,185.928504,418.339135,98.016193,1,0
0,0,12,12,10,17,27,39,45,84,0.000333,0.133137,10,3994.105502,221.89475,399.41055,102.706149,1,0
0,0,10,10,9,15,24,32,35,67,0.000333,0.102397,8,2457.5399,136.529994,307.192488,87.132684,1,0
0,0,10,10,13,17,30,39,39,78,0.000333,0.127579,12,4592.849597,255.158311,382.737466,117.592585,1,0
0,0,10,10,12,17,29,38,39,77,0.000333,0.124688,12,4488.774439,249.376358,374.064537,112.506418,1,0
0,0,7,7,10,10,20,35,23,58,0.000333,0.083557,10,2506.718295,139.262128,250.67183,66.438562,1,0
0,0,7,7,10,10,20,35,23,58,0.000333,0.083557,10,2506.718295,139.262128,250.67183,66.438562,1,0
0,0,7,7,10,10,20,35,23,58,0.000333,0.083557,10,2506.718295,139.262128,250.67183,66.438562,1,0
0,0,7,7,10,10,20,35,23,58,0.000333,0.083557,10,2506.718295,139.262128,250.67183,66.438562,1,0
0,0,7,7,10,10,20,35,23,58,0.000333,0.083557,10,2506.718295,139.262128,250.67183,66.438562,1,0
0,0,7,7,10,10,20,35,23,58,0.000333,0.083557,10,2506.718295,139.262128,250.67183,66.438562,1,0
0,0,7,7,10,10,20,35,23,58,0.000333,0.083557,10,2506.718295,139.262128,250.67183,66.438562,1,0
0,0,7,7,10,10,20,35,23,58,0.000333,0.083557,10,2506.718295,139.262128,250.67183,66.438562,1,0
0,0,7,7,10,10,20,35,23,58,0.000333,0.083557,10,2506.718295,139.262128,250.67183,66.438562,1,0
0,0,7,7,10,10,20,35,23,58,0.000333,0.083557,10,2506.718295,139.262128,250.67183,66.438562,1,0
0,0,7,7,10,10,20,35,23,58,0.000333,0.083557,10,2506.718295,139.262128,250.67183,66.438562,1,0
0,0,7,7,10,10,20,35,23,58,0.000333,0.083557,10,2506.718295,139.262128,250.67183,66.438562,1,0
0,0,7,7,10,10,20,35,23,58,0.000333,0.083557,10,2506.718295,139.262128,250.67183,66.438562,1,0
0,0,7,7,10,10,20,35,23,58,0.000333,0.083557,10,2506.718295,139.262128,250.67183,66.438562,1,0
0,0,7,7,10,10,20,35,23,58,0.000333,0.083557,10,2506.718295,139.262128,250.67183,66.438562,1,0
0,0,7,7,10,10,20,35,23,58,0.000333,0.083557,10,2506.718295,139.262128,250.67183,66.438562,1,0
0,0,7,7,10,10,20,35,23,58,0.000333,0.083557,10,2506.718295,139.262128,250.67183,66.438562,1,0
0,0,7,7,10,10,20,35,23,58,0.000333,0.083557,10,2506.718295,139.262128,250.67183,66.438562,1,0
0,0,7,7,10,10,20,35,23,58,0.000333,0.083557,10,2506.718295,139.262128,250.67183,66.438562,1,0
0,0,7,7,10,10,20,35,23,58,0.000333,0.083557,10,2506.718295,139.262128,250.67183,66.438562,1,0
0,0,7,7,10,10,20,35,23,58,0.000333,0.083557,10,2506.718295,139.262128,250.67183,66.438562,1,0
0,0,7,7,10,10,20,35,23,58,0.000333,0.083557,10,2506.718295,139.262128,250.67183,66.438562,1,0
0,0,7,7,10,10,20,35,23,58,0.000333,0.083557,10,2506.718295,139.262128,250.67183,66.438562,1,0
0,0,7,7,10,10,20,35,23,58,0.000333,0.083557,10,2506.718295,139.262128,250.67183,66.438562,1,0
0,0,7,7,10,10,20,35,23,58,0.000333,0.083557,10,2506.718295,139.262128,250.67183,66.438562,1,0
0,0,7,7,10,10,20,35,23,58,0.000333,0.083557,10,2506.718295,139.262128,250.67183,66.438562,1,0
0,0,7,7,10,10,20,35,23,58,0.000333,0.083557,10,2506.718295,139.262128,250.67183,66.438562,1,0
0,0,7,7,10,10,20,35,23,58,0.000333,0.083557,10,2506.718295,139.262128,250.67183,66.438562,1,0
0,0,7,7,10,10,20,35,23,58,0.000333,0.083557,10,2506.718295,139.262128,250.67183,66.438562,1,0
0,0,7,7,10,10,20,35,23,58,0.000333,0.083557,10,2506.718295,139.262128,250.67183,66.438562,1,0
0,0,7,7,10,10,20,35,23,58,0.000333,0.083557,10,2506.718295,139.262128,250.67183,66.438562,1,0
0,0,10,10,12,13,25,46,35,81,0.000333,0.125384,12,4513.828216,250.768234,376.152351,91.125266,1,0
0,0,10,10,12,13,25,46,35,81,0.000333,0.125384,12,4513.828216,250.768234,376.152351,91.125266,1,0
0,0,10,10,11,15,26,45,39,84,0.000333,0.131612,10,3948.369363,219.353854,394.836936,96.657107,1,0
0,0,11,11,11,17,28,47,45,92,0.000333,0.147426,10,4422.766528,245.709252,442.276653,107.540616,1,0
0,0,9,9,10,11,21,41,29,70,0.000333,0.102487,10,3074.622196,170.812344,307.46222,71.273029,1,0
0,0,12,12,11,12,23,56,37,93,0.000333,0.14023,15,6310.368929,350.576052,420.691262,81.073298,1,0
0,0,9,9,11,15,26,40,31,71,0.000333,0.111244,10,3337.3122,185.406233,333.73122,96.657107,1,0
0,0,9,9,10,15,25,41,35,76,0.000333,0.117644,10,3529.330704,196.073928,352.93307,91.82264,1,0
0,0,10,10,12,12,24,46,33,79,0.000333,0.120737,12,4346.544451,241.474692,362.212038,86.0391,1,0
0,0,10,10,11,14,25,50,35,85,0.000333,0.131576,10,3947.277761,219.293209,394.727776,91.356717,1,0
0,0,10,10,10,16,26,41,36,77,0.000333,0.120645,10,3619.338583,201.074366,361.933858,97.219281,1,0
0,0,9,9,10,15,25,41,35,76,0.000333,0.117644,10,3529.330704,196.073928,352.93307,91.82264,1,0
0,0,11,11,10,16,26,47,47,94,0.000333,0.14728,10,4418.413335,245.467408,441.841334,97.219281,1,0
0,0,13,13,10,19,29,53,57,110,0.000333,0.178126,15,8015.668642,445.314925,534.377909,113.929904,1,0
0,0,15,15,10,18,28,59,71,130,0.000333,0.208319,15,9374.342098,520.796783,624.95614,108.277931,1,0
0,0,10,10,11,14,25,45,37,82,0.000333,0.126932,10,3807.962076,211.553449,380.796208,91.356717,1,0
0,0,10,10,11,16,27,47,38,85,0.000333,0.134722,10,4041.654377,224.536354,404.165438,102.053748,1,0
0,0,11,11,11,17,28,56,42,98,0.000333,0.15704,10,4711.207824,261.733768,471.120782,107.540616,1,0
0,0,10,10,10,16,26,49,39,88,0.000333,0.13788,10,4136.386952,229.799275,413.638695,97.219281,1,0
0,0,12,12,10,18,28,56,45,101,0.000333,0.161848,10,4855.428471,269.746026,485.542847,108.277931,1,0
0,0,12,12,11,18,29,48,48,96,0.000333,0.155455,10,4663.661755,259.09232,466.366176,113.112398,1,0
0,0,10,10,10,16,26,41,38,79,0.000333,0.123778,10,3713.347377,206.297077,371.334738,97.219281,1,0
0,0,10,10,14,18,32,48,42,90,0.000333,0.15,14,6300,350,450,128.361619,1,0
0,0,10,10,13,18,31,47,42,89,0.000333,0.146974,12,5291.081659,293.948981,440.923472,123.164366,1,0
0,0,7,7,9,9,18,26,20,46,0.000333,0.063939,8,1534.532401,85.2518,191.81655,57.05865,1,0
0,0,7,7,9,9,18,26,20,46,0.000333,0.063939,8,1534.532401,85.2518,191.81655,57.05865,1,0
0,0,7,7,9,9,18,26,20,46,0.000333,0.063939,8,1534.532401,85.2518,191.81655,57.05865,1,0
0,0,7,7,9,9,18,26,20,46,0.000333,0.063939,8,1534.532401,85.2518,191.81655,57.05865,1,0
0,0,7,7,9,9,18,26,20,46,0.000333,0.063939,8,1534.532401,85.2518,191.81655,57.05865,1,0
0,0,7,7,9,9,18,26,20,46,0.000333,0.063939,8,1534.532401,85.2518,191.81655,57.05865,1,0
0,0,7,7,9,9,18,26,20,46,0.000333,0.063939,8,1534.532401,85.2518,191.81655,57.05865,1,0
0,0,7,7,9,9,18,26,20,46,0.000333,0.063939,8,1534.532401,85.2518,191.81655,57.05865,1,0
0,0,7,7,9,9,18,26,20,46,0.000333,0.063939,8,1534.532401,85.2518,191.81655,57.05865,1,0
0,0,7,7,9,9,18,26,20,46,0.000333,0.063939,8,1534.532401,85.2518,191.81655,57.05865,1,0
0,0,7,7,9,9,18,26,20,46,0.000333,0.063939,8,1534.532401,85.2518,191.81655,57.05865,1,0
0,0,7,7,9,9,18,26,20,46,0.000333,0.063939,8,1534.532401,85.2518,191.81655,57.05865,1,0
0,0,7,7,9,9,18,26,20,46,0.000333,0.063939,8,1534.532401,85.2518,191.81655,57.05865,1,0
0,0,7,7,9,9,18,26,20,46,0.000333,0.063939,8,1534.532401,85.2518,191.81655,57.05865,1,0
0,0,7,7,9,9,18,26,20,46,0.000333,0.063939,8,1534.532401,85.2518,191.81655,57.05865,1,0
0,0,7,7,9,9,18,26,20,46,0.000333,0.063939,8,1534.532401,85.2518,191.81655,57.05865,1,0
0,0,7,7,9,9,18,26,20,46,0.000333,0.063939,8,1534.532401,85.2518,191.81655,57.05865,1,0
0,0,7,7,9,9,18,26,20,46,0.000333,0.063939,8,1534.532401,85.2518,191.81655,57.05865,1,0
0,0,7,7,9,9,18,26,20,46,0.000333,0.063939,8,1534.532401,85.2518,191.81655,57.05865,1,0
0,0,7,7,9,9,18,26,20,46,0.000333,0.063939,8,1534.532401,85.2518,191.81655,57.05865,1,0
0,0,7,7,9,9,18,26,20,46,0.000333,0.063939,8,1534.532401,85.2518,191.81655,57.05865,1,0
0,0,7,7,9,9,18,26,20,46,0.000333,0.063939,8,1534.532401,85.2518,191.81655,57.05865,1,0
0,0,7,7,9,9,18,26,20,46,0.000333,0.063939,8,1534.532401,85.2518,191.81655,57.05865,1,0
0,0,7,7,9,9,18,26,20,46,0.000333,0.063939,8,1534.532401,85.2518,191.81655,57.05865,1,0
0,0,7,7,9,9,18,26,20,46,0.000333,0.063939,8,1534.532401,85.2518,191.81655,57.05865,1,0
0,0,7,7,9,9,18,26,20,46,0.000333,0.063939,8,1534.532401,85.2518,191.81655,57.05865,1,0
0,0,7,7,9,9,18,26,20,46,0.000333,0.063939,8,1534.532401,85.2518,191.81655,57.05865,1,0
0,0,7,7,9,9,18,26,20,46,0.000333,0.063939,8,1534.532401,85.2518,191.81655,57.05865,1,0
0,0,7,7,9,9,18,26,20,46,0.000333,0.063939,8,1534.532401,85.2518,191.81655,57.05865,1,0
0,0,7,7,9,9,18,26,20,46,0.000333,0.063939,8,1534.532401,85.2518,191.81655,57.05865,1,0
0,0,7,7,9,9,18,26,20,46,0.000333,0.063939,8,1534.532401,85.2518,191.81655,57.05865,1,0
0,0,10,10,11,12,23,37,32,69,0.000333,0.104042,10,3121.25775,173.403208,312.125775,81.073298,1,0
0,0,10,10,11,12,23,37,32,69,0.000333,0.104042,10,3121.25775,173.403208,312.125775,81.073298,1,0
0,0,10,10,10,14,24,36,36,72,0.000333,0.110039,10,3301.173001,183.3985,330.1173,86.52225,1,0
0,0,10,10,10,14,24,36,36,72,0.000333,0.110039,10,3301.173001,183.3985,330.1173,86.52225,1,0
0,0,9,9,9,10,19,32,26,58,0.000333,0.082127,8,1971.038366,109.502131,246.379796,61.748606,1,0
0,0,12,12,10,11,21,47,34,81,0.000333,0.118593,15,5336.665669,296.481426,355.777711,71.273029,1,0
0,0,9,9,10,14,24,31,28,59,0.000333,0.090171,10,2705.127875,150.284882,270.512788,86.52225,1,0
0,0,9,9,9,14,23,32,32,64,0.000333,0.096503,8,2316.063722,128.670207,289.507965,81.832294,1,0
0,0,10,10,11,11,22,37,30,67,0.000333,0.099594,10,2987.819184,165.989955,298.781918,76.107496,1,0
0,0,10,10,10,13,23,41,32,73,0.000333,0.110073,10,3302.200228,183.455568,330.220023,81.324997,1,0
0,0,10,10,9,15,24,32,33,65,0.000333,0.099341,8,2384.1805,132.454472,298.022563,87.132684,1,0
0,0,9,9,9,14,23,32,32,64,0.000333,0.096503,8,2316.063722,128.670207,289.507965,81.832294,1,0
0,0,11,11,9,15,24,38,44,82,0.000333,0.125322,8,3007.7354,167.096411,375.966925,87.132684,1,0
0,0,13,13,9,16,25,44,56,100,0.000333,0.154795,12,5572.627428,309.590413,464.385619,92.529325,1,0
0,0,15,15,9,17,26,50,68,118,0.000333,0.184884,16,8874.430188,493.023899,554.651887,98.016193,1,0
0,0,10,10,10,13,23,36,34,70,0.000333,0.10555,10,3166.493369,175.916298,316.649337,81.324997,1,0
0,0,10,10,10,15,25,38,35,73,0.000333,0.113001,10,3390.015019,188.334168,339.001502,91.82264,1,0
0,0,11,11,10,16,26,47,39,86,0.000333,0.134746,10,4042.378158,224.576564,404.237816,97.219281,1,0
0,0,10,10,9,15,24,40,36,76,0.000333,0.116152,8,2787.6572,154.869844,348.45715,87.132684,1,0
0,0,12,12,9,17,26,47,42,89,0.000333,0.139446,8,3346.713079,185.928504,418.339135,98.016193,1,0
0,0,12,12,10,17,27,39,45,84,0.000333,0.133137,10,3994.105502,221.89475,399.41055,102.706149,1,0
0,0,10,10,9,15,24,32,35,67,0.000333,0.102397,8,2457.5399,136.529994,307.192488,87.132684,1,0
0,0,10,10,13,17,30,39,39,78,0.000333,0.127579,12,4592.849597,255.158311,382.737466,117.592585,1,0
0,0,10,10,12,17,29,38,39,77,0.000333,0.124688,12,4488.774439,249.376358,374.064537,112.506418,1,0
0,0,8,8,16,21,37,40,35,75,0.000333,0.130236,8,3125.672019,173.648446,390.709002,156.238666,5,0
0,0,7,7,14,14,28,36,26,62,0.000333,0.099352,7,2086.392036,115.910669,298.056005,106.605938,5,0
0,0,6,6,13,12,25,32,23,55,0.000333,0.085137,6,1532.472543,85.137363,255.41209,91.125266,5,0
0,0,6,6,13,12,25,32,23,55,0.000333,0.085137,6,1532.472543,85.137363,255.41209,91.125266,5,0
0,0,4,4,14,9,23,23,13,36,0.000333,0.054283,7,1139.937613,63.329867,162.84823,81.832294,3,0
0,0,4,4,14,9,23,23,13,36,0.000333,0.054283,7,1139.937613,63.329867,162.84823,81.832294,3,0
0,0,3,3,13,7,20,19,10,29,0.000333,0.041779,6,752.015489,41.778638,125.335915,67.757201,3,0
0,0,3,3,13,7,20,19,10,29,0.000333,0.041779,6,752.015489,41.778638,125.335915,67.757201,3,0
0,0,8,8,16,21,37,40,35,75,0.000333,0.130236,8,3125.672019,173.648446,390.709002,156.238666,5,0
0,0,7,7,14,14,28,36,26,62,0.000333,0.099352,7,2086.392036,115.910669,298.056005,106.605938,5,0
0,0,6,6,13,12,25,32,23,55,0.000333,0.085137,6,1532.472543,85.137363,255.41209,91.125266,5,0
0,0,6,6,13,12,25,32,23,55,0.000333,0.085137,6,1532.472543,85.137363,255.41209,91.125266,5,0
0,0,8,8,14,17,31,32,38,70,0.000333,0.115598,14,4855.112384,269.728466,346.793742,122.789837,1,0
0,0,8,8,12,17,29,31,38,69,0.000333,0.111734,12,4022.408264,223.467126,335.200689,112.506418,1,0
0,0,8,8,15,18,33,42,42,84,0.000333,0.141243,14,5932.207484,329.567082,423.729106,133.662009,1,0
0,0,8,8,13,19,32,41,41,82,0.000333,0.136667,12,4920,273.333333,410,128.816339,1,0
0,0,8,8,15,18,33,42,42,84,0.000333,0.141243,14,5932.207484,329.567082,423.729106,133.662009,1,0
0,0,8,8,13,18,31,41,42,83,0.000333,0.137066,12,4934.379525,274.132196,411.198294,123.164366,1,0
0,0,8,8,14,18,32,36,41,77,0.000333,0.128333,14,5390,299.444444,385,128.361619,1,0
0,0,8,8,12,18,30,35,41,76,0.000333,0.124308,12,4475.084223,248.61579,372.923685,118.0782,1,0
0,0,8,8,14,17,31,32,38,70,0.000333,0.115598,14,4855.112384,269.728466,346.793742,122.789837,1,0
0,0,8,8,12,17,29,31,38,69,0.000333,0.111734,12,4022.408264,223.467126,335.200689,112.506418,1,0
0,0,8,8,14,18,32,36,41,77,0.000333,0.128333,14,5390,299.444444,385,128.361619,1,0
0,0,8,8,12,18,30,35,41,76,0.000333,0.124308,12,4475.084223,248.61579,372.923685,118.0782,1,0
0,0,11,11,14,18,32,45,45,90,0.000333,0.15,14,6300,350,450,128.361619,1,0
0,0,11,11,12,18,30,44,45,89,0.000333,0.145571,12,5240.559156,291.142175,436.713263,118.0782,1,0
0,0,11,11,14,18,32,46,46,92,0.000333,0.153333,14,6440,357.777778,460,128.361619,1,0
0,0,10,10,12,17,29,41,36,77,0.000333,0.124688,12,4488.774439,249.376358,374.064537,112.506418,1,0
0,0,10,10,14,17,31,43,35,78,0.000333,0.128809,14,5409.982371,300.554576,386.427312,122.789837,1,0
0,0,10,10,13,17,30,42,35,77,0.000333,0.125944,12,4533.96691,251.887051,377.830576,117.592585,1,0
0,0,10,10,13,18,31,41,35,76,0.000333,0.125506,6,2259.113518,125.506307,376.51892,123.164366,1,0
0,0,10,10,12,17,29,40,35,75,0.000333,0.12145,12,4372.182896,242.89905,364.348575,112.506418,1,0
0,0,10,10,13,17,30,42,36,78,0.000333,0.127579,12,4592.849597,255.158311,382.737466,117.592585,1,0
0,0,3,3,10,13,23,15,17,32,0.000333,0.048251,5,723.769913,40.20944,144.753983,81.324997,1,0
0,0,10,10,14,17,31,43,35,78,0.000333,0.128809,14,5409.982371,300.554576,386.427312,122.789837,1,0
0,0,10,10,13,17,30,42,35,77,0.000333,0.125944,12,4533.96691,251.887051,377.830576,117.592585,1,0
0,0,8,8,14,17,31,42,33,75,0.000333,0.123855,7,2600.953063,144.497392,371.564723,122.789837,1,0
0,0,8,8,13,17,30,41,33,74,0.000333,0.121037,6,2178.659424,121.036635,363.109904,117.592585,1,0
0,0,8,8,14,17,31,42,33,75,0.000333,0.123855,7,2600.953063,144.497392,371.564723,122.789837,1,0
0,0,8,8,13,17,30,41,33,74,0.000333,0.121037,6,2178.659424,121.036635,363.109904,117.592585,1,0
0,0,9,9,14,18,32,42,42,84,0.000333,0.14,14,5880,326.666667,420,128.361619,1,0
0,0,8,8,12,17,29,37,32,69,0.000333,0.111734,6,2011.204132,111.733563,335.200689,112.506418,1,0
0,0,8,8,13,17,30,38,32,70,0.000333,0.114494,6,2060.89405,114.494114,343.482342,117.592585,1,0
0,0,8,8,12,17,29,37,32,69,0.000333,0.111734,6,2011.204132,111.733563,335.200689,112.506418,1,0
0,0,8,8,14,17,31,40,32,72,0.000333,0.118901,7,2496.91494,138.717497,356.702134,122.789837,1,0
0,0,8,8,13,17,30,39,32,71,0.000333,0.11613,6,2090.335394,116.129744,348.389232,117.592585,1,0
0,0,8,8,13,17,30,38,32,70,0.000333,0.114494,6,2060.89405,114.494114,343.482342,117.592585,1,0
0,0,8,8,12,17,29,37,32,69,0.000333,0.111734,6,2011.204132,111.733563,335.200689,112.506418,1,0
0,0,8,8,13,17,30,38,32,70,0.000333,0.114494,6,2060.89405,114.494114,343.482342,117.592585,1,0
0,0,8,8,12,17,29,37,32,69,0.000333,0.111734,6,2011.204132,111.733563,335.200689,112.506418,1,0
0,0,8,8,14,17,31,40,32,72,0.000333,0.118901,7,2496.91494,138.717497,356.702134,122.789837,1,0
0,0,8,8,13,17,30,39,32,71,0.000333,0.11613,6,2090.335394,116.129744,348.389232,117.592585,1,0
0,0,10,10,13,16,29,40,33,73,0.000333,0.118211,12,4255.591352,236.421742,354.632613,112.105716,1,0
0,0,10,10,12,16,28,39,33,72,0.000333,0.115377,12,4153.554653,230.753036,346.129554,107.01955,1,0
0,0,10,10,13,16,29,40,33,73,0.000333,0.118211,12,4255.591352,236.421742,354.632613,112.105716,1,0
0,0,10,10,12,16,28,39,33,72,0.000333,0.115377,12,4153.554653,230.753036,346.129554,107.01955,1,0
0,0,10,10,13,16,29,40,33,73,0.000333,0.118211,12,4255.591352,236.421742,354.632613,112.105716,1,0
0,0,10,10,12,16,28,39,33,72,0.000333,0.115377,12,4153.554653,230.753036,346.129554,107.01955,1,0
0,0,8,8,13,15,28,35,29,64,0.000333,0.102557,6,1846.02429,102.556905,307.670715,106.709075,1,0
0,0,8,8,12,15,27,34,29,63,0.000333,0.099853,6,1797.347476,99.852638,299.557913,101.622909,1,0
0,0,8,8,13,15,28,35,29,64,0.000333,0.102557,6,1846.02429,102.556905,307.670715,106.709075,1,0
0,0,8,8,12,15,27,34,29,63,0.000333,0.099853,6,1797.347476,99.852638,299.557913,101.622909,1,0
0,0,8,8,13,15,28,35,29,64,0.000333,0.102557,6,1846.02429,102.556905,307.670715,106.709075,1,0
0,0,8,8,12,15,27,34,29,63,0.000333,0.099853,6,1797.347476,99.852638,299.557913,101.622909,1,0
0,0,5,5,10,11,21,35,21,56,0.000333,0.08199,5,1229.848878,68.324938,245.969776,71.273029,1,0
0,0,6,6,10,12,22,37,23,60,0.000333,0.089189,5,1337.829486,74.32386,267.565897,76.238831,1,0
0,0,6,6,10,12,22,37,23,60,0.000333,0.089189,5,1337.829486,74.32386,267.565897,76.238831,1,0
0,0,6,6,10,12,22,37,23,60,0.000333,0.089189,5,1337.829486,74.32386,267.565897,76.238831,1,0
0,0,6,6,10,12,22,37,23,60,0.000333,0.089189,5,1337.829486,74.32386,267.565897,76.238831,1,0
0,0,6,6,10,12,22,37,23,60,0.000333,0.089189,5,1337.829486,74.32386,267.565897,76.238831,1,0
0,0,6,6,10,12,22,37,23,60,0.000333,0.089189,5,1337.829486,74.32386,267.565897,76.238831,1,0
0,0,6,6,10,12,22,37,23,60,0.000333,0.089189,5,1337.829486,74.32386,267.565897,76.238831,1,0
0,0,6,6,10,12,22,37,23,60,0.000333,0.089189,5,1337.829486,74.32386,267.565897,76.238831,1,0
0,0,6,6,10,12,22,37,23,60,0.000333,0.089189,5,1337.829486,74.32386,267.565897,76.238831,1,0
0,0,6,6,10,12,22,37,23,60,0.000333,0.089189,5,1337.829486,74.32386,267.565897,76.238831,1,0
0,0,6,6,10,12,22,37,23,60,0.000333,0.089189,5,1337.829486,74.32386,267.565897,76.238831,1,0
0,0,6,6,10,12,22,37,23,60,0.000333,0.089189,5,1337.829486,74.32386,267.565897,76.238831,1,0
0,0,6,6,10,12,22,37,23,60,0.000333,0.089189,5,1337.829486,74.32386,267.565897,76.238831,1,0
0,0,6,6,10,12,22,37,23,60,0.000333,0.089189,5,1337.829486,74.32386,267.565897,76.238831,1,0
0,0,6,6,10,12,22,37,23,60,0.000333,0.089189,5,1337.829486,74.32386,267.565897,76.238831,1,0
0,0,6,6,10,12,22,37,23,60,0.000333,0.089189,5,1337.829486,74.32386,267.565897,76.238831,1,0
0,0,6,6,10,12,22,37,23,60,0.000333,0.089189,5,1337.829486,74.32386,267.565897,76.238831,1,0
0,0,6,6,10,12,22,37,23,60,0.000333,0.089189,5,1337.829486,74.32386,267.565897,76.238831,1,0
0,0,6,6,10,12,22,37,23,60,0.000333,0.089189,5,1337.829486,74.32386,267.565897,76.238831,1,0
0,0,6,6,10,12,22,37,23,60,0.000333,0.089189,5,1337.829486,74.32386,267.565897,76.238831,1,0
0,0,6,6,10,12,22,37,23,60,0.000333,0.089189,5,1337.829486,74.32386,267.565897,76.238831,1,0
0,0,6,6,10,12,22,37,23,60,0.000333,0.089189,5,1337.829486,74.32386,267.565897,76.238831,1,0
0,0,6,6,10,12,22,37,23,60,0.000333,0.089189,5,1337.829486,74.32386,267.565897,76.238831,1,0
0,0,6,6,10,12,22,37,23,60,0.000333,0.089189,5,1337.829486,74.32386,267.565897,76.238831,1,0
0,0,6,6,10,12,22,37,23,60,0.000333,0.089189,5,1337.829486,74.32386,267.565897,76.238831,1,0
0,0,6,6,10,12,22,37,23,60,0.000333,0.089189,5,1337.829486,74.32386,267.565897,76.238831,1,0
0,0,6,6,10,12,22,37,23,60,0.000333,0.089189,5,1337.829486,74.32386,267.565897,76.238831,1,0
0,0,6,6,10,12,22,37,23,60,0.000333,0.089189,5,1337.829486,74.32386,267.565897,76.238831,1,0
0,0,6,6,10,12,22,37,23,60,0.000333,0.089189,5,1337.829486,74.32386,267.565897,76.238831,1,0
0,0,6,6,10,12,22,37,23,60,0.000333,0.089189,5,1337.829486,74.32386,267.565897,76.238831,1,0
0,0,6,6,10,12,22,37,23,60,0.000333,0.089189,5,1337.829486,74.32386,267.565897,76.238831,1,0
0,0,7,7,11,13,24,42,29,71,0.000333,0.108511,10,3255.323376,180.851299,325.532338,86.159464,1,0
0,0,7,7,10,16,26,41,35,76,0.000333,0.119078,10,3572.334186,198.46301,357.233419,97.219281,1,0
0,0,7,7,10,12,22,41,27,68,0.000333,0.10108,10,3032.413501,168.467417,303.24135,76.238831,1,0
0,0,11,11,11,14,25,57,37,94,0.000333,0.145507,10,4365.224818,242.51249,436.522482,91.356717,1,0
0,0,9,9,11,18,29,44,34,78,0.000333,0.126308,5,1894.612588,105.256255,378.922518,113.112398,1,0
0,0,7,7,11,13,24,42,29,71,0.000333,0.108511,10,3255.323376,180.851299,325.532338,86.159464,1,0
0,0,10,10,12,14,26,50,35,85,0.000333,0.133179,12,4794.448513,266.358251,399.537376,96.322519,1,0
0,0,10,10,11,15,26,54,37,91,0.000333,0.14258,10,4277.400144,237.633341,427.740014,96.657107,1,0
0,0,10,10,10,19,29,45,40,85,0.000333,0.137643,10,4129.283846,229.404658,412.928385,113.929904,1,0
0,0,9,9,10,17,27,45,39,84,0.000333,0.133137,10,3994.105502,221.89475,399.41055,102.706149,1,0
0,0,11,11,10,18,28,51,53,104,0.000333,0.166655,10,4999.649119,277.758284,499.964912,108.277931,1,0
0,0,13,13,10,19,29,57,67,124,0.000333,0.200797,15,9035.844651,501.991369,602.389643,113.929904,1,0
0,0,15,15,10,20,30,63,81,144,0.000333,0.235531,20,14131.84492,785.102495,706.592246,119.657843,1,0
0,0,10,10,11,17,28,49,41,90,0.000333,0.144221,10,4326.61943,240.367746,432.661943,107.540616,1,0
0,0,10,10,11,18,29,51,42,93,0.000333,0.150597,10,4517.922325,250.995685,451.792233,113.112398,1,0
0,0,11,11,11,19,30,60,46,106,0.000333,0.173377,10,5201.304031,288.961335,520.130403,118.764371,1,0
0,0,10,10,10,18,28,53,43,96,0.000333,0.153835,10,4615.060725,256.392263,461.506073,108.277931,1,0
0,0,12,12,10,20,30,60,49,109,0.000333,0.178284,10,5348.510749,297.139486,534.851075,119.657843,1,0
0,0,12,12,11,20,31,52,54,106,0.000333,0.175048,10,5251.448089,291.747116,525.144809,124.49231,1,0
0,0,10,10,10,19,29,45,43,88,0.000333,0.142501,10,4275.023276,237.501293,427.502328,113.929904,1,0
0,0,10,10,14,20,34,52,47,99,0.000333,0.167886,14,7051.223498,391.734639,503.658821,139.741531,1,0
0,0,10,10,13,20,33,51,47,98,0.000333,0.164784,12,5932.207484,329.567082,494.350624,134.544278,1,0
0,0,8,8,15,15,30,48,32,80,0.000333,0.13085,14,5495.717467,305.317637,392.551248,117.206718,5,0
0,0,8,8,15,15,30,48,32,80,0.000333,0.13085,14,5495.717467,305.317637,392.551248,117.206718,5,0
0,0,8,8,15,15,30,48,32,80,0.000333,0.13085,14,5495.717467,305.317637,392.551248,117.206718,5,0
0,0,8,8,15,15,30,48,32,80,0.000333,0.13085,14,5495.717467,305.317637,392.551248,117.206718,5,0
0,0,8,8,15,15,30,48,32,80,0.000333,0.13085,14,5495.717467,305.317637,392.551248,117.206718,5,0
0,0,8,8,15,15,30,48,32,80,0.000333,0.13085,14,5495.717467,305.317637,392.551248,117.206718,5,0
0,0,8,8,15,15,30,48,32,80,0.000333,0.13085,14,5495.717467,305.317637,392.551248,117.206718,5,0
0,0,8,8,15,15,30,48,32,80,0.000333,0.13085,14,5495.717467,305.317637,392.551248,117.206718,5,0
0,0,8,8,15,15,30,48,32,80,0.000333,0.13085,14,5495.717467,305.317637,392.551248,117.206718,5,0
0,0,8,8,15,15,30,48,32,80,0.000333,0.13085,14,5495.717467,305.317637,392.551248,117.206718,5,0
0,0,8,8,15,15,30,48,32,80,0.000333,0.13085,14,5495.717467,305.317637,392.551248,117.206718,5,0
0,0,8,8,15,15,30,48,32,80,0.000333,0.13085,14,5495.717467,305.317637,392.551248,117.206718,5,0
0,0,8,8,15,15,30,48,32,80,0.000333,0.13085,14,5495.717467,305.317637,392.551248,117.206718,5,0
0,0,8,8,15,15,30,48,32,80,0.000333,0.13085,14,5495.717467,305.317637,392.551248,117.206718,5,0
0,0,8,8,15,15,30,48,32,80,0.000333,0.13085,14,5495.717467,305.317637,392.551248,117.206718,5,0
0,0,8,8,15,15,30,48,32,80,0.000333,0.13085,14,5495.717467,305.317637,392.551248,117.206718,5,0
0,0,8,8,15,15,30,48,32,80,0.000333,0.13085,14,5495.717467,305.317637,392.551248,117.206718,5,0
0,0,8,8,15,15,30,48,32,80,0.000333,0.13085,14,5495.717467,305.317637,392.551248,117.206718,5,0
0,0,8,8,15,15,30,48,32,80,0.000333,0.13085,14,5495.717467,305.317637,392.551248,117.206718,5,0
0,0,8,8,15,15,30,48,32,80,0.000333,0.13085,14,5495.717467,305.317637,392.551248,117.206718,5,0
0,0,8,8,15,15,30,48,32,80,0.000333,0.13085,14,5495.717467,305.317637,392.551248,117.206718,5,0
0,0,8,8,15,15,30,48,32,80,0.000333,0.13085,14,5495.717467,305.317637,392.551248,117.206718,5,0
0,0,8,8,15,15,30,48,32,80,0.000333,0.13085,14,5495.717467,305.317637,392.551248,117.206718,5,0
0,0,8,8,15,15,30,48,32,80,0.000333,0.13085,14,5495.717467,305.317637,392.551248,117.206718,5,0
0,0,8,8,15,15,30,48,32,80,0.000333,0.13085,14,5495.717467,305.317637,392.551248,117.206718,5,0
0,0,8,8,15,15,30,48,32,80,0.000333,0.13085,14,5495.717467,305.317637,392.551248,117.206718,5,0
0,0,8,8,15,15,30,48,32,80,0.000333,0.13085,14,5495.717467,305.317637,392.551248,117.206718,5,0
0,0,8,8,15,15,30,48,32,80,0.000333,0.13085,14,5495.717467,305.317637,392.551248,117.206718,5,0
0,0,8,8,15,15,30,48,32,80,0.000333,0.13085,14,5495.717467,305.317637,392.551248,117.206718,5,0
0,0,8,8,15,15,30,48,32,80,0.000333,0.13085,14,5495.717467,305.317637,392.551248,117.206718,5,0
0,0,8,8,15,15,30,48,32,80,0.000333,0.13085,14,5495.717467,305.317637,392.551248,117.206718,5,0
0,0,8,8,15,15,30,48,32,80,0.000333,0.13085,14,5495.717467,305.317637,392.551248,117.206718,5,0
0,0,10,10,16,19,35,54,42,96,0.000333,0.164137,16,7878.578714,437.698817,492.41117,144.710623,5,0
0,0,10,10,16,19,35,54,42,96,0.000333,0.164137,16,7878.578714,437.698817,492.41117,144.710623,5,0
0,0,10,10,15,22,37,53,48,101,0.000333,0.175385,14,7366.167059,409.231503,526.15479,156.710855,5,0
0,0,10,10,15,22,37,53,48,101,0.000333,0.175385,14,7366.167059,409.231503,526.15479,156.710855,5,0
0,0,10,10,15,16,31,52,38,90,0.000333,0.148626,14,6242.287351,346.793742,445.877668,122.603359,5,0
0,0,9,9,15,16,31,51,35,86,0.000333,0.14202,14,5964.852358,331.380687,426.060883,122.603359,5,0
0,0,23,23,22,25,47,106,67,173,0.000333,0.320315,22,21140.76517,1174.486954,960.943871,214.2039,7,0
0,0,22,22,18,25,43,102,67,169,0.000333,0.30568,18,16506.69738,917.038744,917.038744,191.155055,7,0
0,0,14,14,16,18,34,51,41,92,0.000333,0.156016,16,7488.745302,416.041406,468.046581,139.05865,3,0
0,0,13,13,12,18,30,47,41,88,0.000333,0.143935,12,5181.676469,287.870915,431.806372,118.0782,3,0
0,0,26,26,22,25,47,108,68,176,0.000333,0.325869,22,21507.36803,1194.85378,977.607638,214.2039,7,0
0,0,25,25,19,25,44,105,68,173,0.000333,0.314827,18,17000.67006,944.48167,944.48167,196.807027,7,0
0,0,17,17,16,19,35,53,42,95,0.000333,0.162427,16,7796.510186,433.139455,487.281887,144.710623,3,0
0,0,16,16,13,19,32,50,42,92,0.000333,0.153333,12,5520,306.666667,460,128.816339,3,0
0,0,24,24,22,25,47,108,68,176,0.000333,0.325869,22,21507.36803,1194.85378,977.607638,214.2039,7,0
0,0,23,23,19,25,44,105,68,173,0.000333,0.314827,18,17000.67006,944.48167,944.48167,196.807027,7,0
0,0,15,15,16,19,35,53,42,95,0.000333,0.162427,16,7796.510186,433.139455,487.281887,144.710623,3,0
0,0,14,14,13,19,32,50,42,92,0.000333,0.153333,12,5520,306.666667,460,128.816339,3,0
0,0,24,24,21,25,46,106,68,174,0.000333,0.320367,20,19221.99561,1067.888645,961.09978,208.335071,7,0
0,0,23,23,18,25,43,103,68,171,0.000333,0.309297,18,16702.04292,927.891273,927.891273,191.155055,7,0
0,0,15,15,15,19,34,51,42,93,0.000333,0.157711,14,6623.876619,367.993146,473.134044,139.313982,3,0
0,0,14,14,12,19,31,48,42,90,0.000333,0.148626,12,5350.532015,297.251779,445.877668,123.730173,3,0
0,0,26,26,22,25,47,106,68,174,0.000333,0.322166,22,21262.96612,1181.275896,966.49846,214.2039,7,0
0,0,25,25,19,25,44,103,68,171,0.000333,0.311188,18,16804.13052,933.562807,933.562807,196.807027,7,0
0,0,17,17,16,19,35,51,42,93,0.000333,0.159008,16,7632.373129,424.020729,477.023321,144.710623,3,0
0,0,16,16,13,19,32,48,42,90,0.000333,0.15,12,5400,300,450,128.816339,3,0
0,0,23,23,23,25,48,106,67,173,0.000333,0.322066,22,21256.36728,1180.909293,966.198513,220.13833,7,0
0,0,22,22,19,25,44,102,67,169,0.000333,0.307548,18,16607.59098,922.643944,922.643944,196.807027,7,0
0,0,14,14,17,18,35,51,41,92,0.000333,0.157298,16,7550.304601,419.461367,471.894038,144.545518,3,0
0,0,13,13,13,18,31,47,41,88,0.000333,0.145323,12,5231.631304,290.646184,435.969275,123.164366,3,0
0,0,3,3,7,5,12,10,7,17,0.000333,0.020315,3,182.833088,10.157394,60.944363,31.261125,1,0
0,0,3,3,7,5,12,10,7,17,0.000333,0.020315,3,182.833088,10.157394,60.944363,31.261125,1,0
0,0,3,3,6,7,13,10,9,19,0.000333,0.023436,3,210.925064,11.718059,70.308355,35.161259,1,0
0,0,3,3,6,7,13,10,9,19,0.000333,0.023436,3,210.925064,11.718059,70.308355,35.161259,1,0
0,0,3,3,10,6,16,19,10,29,0.000333,0.038667,5,580,32.222222,116,48.729056,1,0
0,0,3,3,10,6,16,19,10,29,0.000333,0.038667,5,580,32.222222,116,48.729056,1,0
0,0,3,3,10,6,16,19,10,29,0.000333,0.038667,5,580,32.222222,116,48.729056,1,0
0,0,3,3,6,7,13,10,9,19,0.000333,0.023436,3,210.925064,11.718059,70.308355,35.161259,1,0
0,0,24,24,23,27,50,109,70,179,0.000333,0.33675,22,22225.50568,1234.750315,1010.250258,232.423888,7,0
0,0,23,23,19,27,46,105,70,175,0.000333,0.322208,18,17399.22016,966.623342,966.623342,209.092585,7,0
0,0,15,15,17,21,38,54,44,98,0.000333,0.171432,16,8228.750341,457.152797,514.296896,161.725534,3,0
0,0,14,14,13,21,34,50,44,94,0.000333,0.159407,12,5738.658085,318.814338,478.221507,140.344382,3,0
0,0,3,3,7,5,12,10,7,17,0.000333,0.020315,3,182.833088,10.157394,60.944363,31.261125,1,0
0,0,3,3,7,5,12,10,7,17,0.000333,0.020315,3,182.833088,10.157394,60.944363,31.261125,1,0
0,0,3,3,6,7,13,10,9,19,0.000333,0.023436,3,210.925064,11.718059,70.308355,35.161259,1,0
0,0,3,3,6,7,13,10,9,19,0.000333,0.023436,3,210.925064,11.718059,70.308355,35.161259,1,0
0,0,3,3,10,6,16,19,10,29,0.000333,0.038667,5,580,32.222222,116,48.729056,1,0
0,0,3,3,10,6,16,19,10,29,0.000333,0.038667,5,580,32.222222,116,48.729056,1,0
0,0,3,3,10,6,16,19,10,29,0.000333,0.038667,5,580,32.222222,116,48.729056,1,0
0,0,3,3,6,7,13,10,9,19,0.000333,0.023436,3,210.925064,11.718059,70.308355,35.161259,1,0
0,0,28,28,22,25,47,113,64,177,0.000333,0.327721,22,21629.56899,1201.642722,983.162227,214.2039,7,0
0,0,26,26,22,24,46,109,64,173,0.000333,0.318525,22,21022.67681,1167.926489,955.576218,208.146596,7,0
0,0,17,17,16,18,34,54,38,92,0.000333,0.156016,16,7488.745302,416.041406,468.046581,139.05865,3,0
0,0,17,17,16,17,33,54,38,92,0.000333,0.154695,16,7425.348144,412.519341,464.084259,133.486868,3,0
0,0,3,3,7,5,12,10,7,17,0.000333,0.020315,3,182.833088,10.157394,60.944363,31.261125,1,0
0,0,3,3,7,5,12,10,7,17,0.000333,0.020315,3,182.833088,10.157394,60.944363,31.261125,1,0
0,0,3,3,6,7,13,10,9,19,0.000333,0.023436,3,210.925064,11.718059,70.308355,35.161259,1,0
0,0,3,3,6,7,13,10,9,19,0.000333,0.023436,3,210.925064,11.718059,70.308355,35.161259,1,0
0,0,3,3,6,7,13,10,9,19,0.000333,0.023436,3,210.925064,11.718059,70.308355,35.161259,1,0
0,0,3,3,10,6,16,19,10,29,0.000333,0.038667,5,580,32.222222,116,48.729056,1,0
0,0,3,3,10,6,16,19,10,29,0.000333,0.038667,5,580,32.222222,116,48.729056,1,0
0,0,3,3,10,6,16,19,10,29,0.000333,0.038667,5,580,32.222222,116,48.729056,1,0
0,0,23,23,19,21,40,103,60,163,0.000333,0.289158,18,15614.53703,867.474279,867.474279,172.949289,7,0
0,0,14,14,13,14,27,48,34,82,0.000333,0.129967,12,4678.809302,259.93385,389.900775,101.408685,3,0
0,0,3,3,7,5,12,10,7,17,0.000333,0.020315,3,182.833088,10.157394,60.944363,31.261125,1,0
0,0,6,6,10,10,20,29,19,48,0.000333,0.069151,5,1037.262743,57.625708,207.452549,66.438562,1,0
0,0,6,6,10,10,20,29,19,48,0.000333,0.069151,5,1037.262743,57.625708,207.452549,66.438562,1,0
0,0,21,21,21,23,44,109,68,177,0.000333,0.322106,20,19326.38793,1073.688218,966.319396,196.280591,7,0
0,0,12,12,14,17,31,54,42,96,0.000333,0.158534,14,6658.439841,369.913325,475.602846,122.789837,3,0
0,0,3,3,7,5,12,10,7,17,0.000333,0.020315,3,182.833088,10.157394,60.944363,31.261125,1,0
0,0,6,6,10,10,20,29,19,48,0.000333,0.069151,5,1037.262743,57.625708,207.452549,66.438562,1,0
0,0,6,6,10,10,20,29,19,48,0.000333,0.069151,5,1037.262743,57.625708,207.452549,66.438562,1,0
0,0,23,23,20,23,43,99,62,161,0.000333,0.29121,20,17472.57251,970.698473,873.628626,190.480487,5,0
0,0,14,14,13,16,29,44,36,80,0.000333,0.129546,12,4663.661755,259.09232,388.63848,112.105716,1,0
0,0,3,3,7,5,12,10,7,17,0.000333,0.020315,3,182.833088,10.157394,60.944363,31.261125,1,0
0,0,3,3,10,6,16,19,10,29,0.000333,0.038667,5,580,32.222222,116,48.729056,1,0
0,0,3,3,6,7,13,10,9,19,0.000333,0.023436,3,210.925064,11.718059,70.308355,35.161259,1,0
0,0,3,3,6,7,13,10,9,19,0.000333,0.023436,3,210.925064,11.718059,70.308355,35.161259,1,0
0,0,3,3,10,6,16,19,10,29,0.000333,0.038667,5,580,32.222222,116,48.729056,1,0
0,0,22,22,21,23,44,101,67,168,0.000333,0.305728,20,18343.69024,1019.093902,917.184512,196.280591,6,0
0,0,21,21,18,23,41,98,67,165,0.000333,0.294665,18,15911.92945,883.996081,883.996081,179.100575,6,0
0,0,12,12,12,15,27,43,37,80,0.000333,0.126797,12,4564.692002,253.594,380.391,101.622909,2,0
0,0,3,3,7,5,12,10,7,17,0.000333,0.020315,3,182.833088,10.157394,60.944363,31.261125,1,0
0,0,3,3,6,7,13,10,9,19,0.000333,0.023436,3,210.925064,11.718059,70.308355,35.161259,1,0
0,0,3,3,10,6,16,19,10,29,0.000333,0.038667,5,580,32.222222,116,48.729056,1,0
0,0,3,3,10,6,16,19,10,29,0.000333,0.038667,5,580,32.222222,116,48.729056,1,0
0,0,3,3,6,7,13,10,9,19,0.000333,0.023436,3,210.925064,11.718059,70.308355,35.161259,1,0
0,0,3,3,6,7,13,10,9,19,0.000333,0.023436,3,210.925064,11.718059,70.308355,35.161259,1,0
0,0,3,3,10,6,16,19,10,29,0.000333,0.038667,5,580,32.222222,116,48.729056,1,0
0,0,22,22,20,26,46,100,79,179,0.000333,0.329573,30,29661.5277,1647.86265,988.71759,208.649995,6,0
0,0,21,21,17,26,43,97,79,176,0.000333,0.318341,24,22920.54232,1273.363462,955.022597,191.698301,6,0
0,0,12,12,11,18,29,42,49,91,0.000333,0.147359,10,4420.762706,245.597928,442.076271,113.112398,2,0
0,0,3,3,7,5,12,10,7,17,0.000333,0.020315,3,182.833088,10.157394,60.944363,31.261125,1,0
0,0,3,3,10,6,16,19,10,29,0.000333,0.038667,5,580,32.222222,116,48.729056,1,0
0,0,3,3,6,7,13,10,9,19,0.000333,0.023436,3,210.925064,11.718059,70.308355,35.161259,1,0
0,0,3,3,6,7,13,10,9,19,0.000333,0.023436,3,210.925064,11.718059,70.308355,35.161259,1,0
0,0,3,3,6,7,13,10,9,19,0.000333,0.023436,3,210.925064,11.718059,70.308355,35.161259,1,0
0,0,3,3,10,6,16,19,10,29,0.000333,0.038667,5,580,32.222222,116,48.729056,1,0
0,0,3,3,10,6,16,19,10,29,0.000333,0.038667,5,580,32.222222,116,48.729056,1,0
0,0,12,12,11,15,26,44,38,82,0.000333,0.128479,10,3854.360569,214.131143,385.436057,96.657107,1,0
0,0,21,21,18,22,40,99,64,163,0.000333,0.289158,18,15614.53703,867.474279,867.474279,173.166146,5,0
0,0,3,3,7,5,12,10,7,17,0.000333,0.020315,3,182.833088,10.157394,60.944363,31.261125,1,0
0,0,3,3,10,6,16,19,10,29,0.000333,0.038667,5,580,32.222222,116,48.729056,1,0
0,0,3,3,10,6,16,19,10,29,0.000333,0.038667,5,580,32.222222,116,48.729056,1,0
0,0,3,3,6,7,13,10,9,19,0.000333,0.023436,3,210.925064,11.718059,70.308355,35.161259,1,0
0,0,3,3,6,7,13,10,9,19,0.000333,0.023436,3,210.925064,11.718059,70.308355,35.161259,1,0
0,0,15,15,12,16,28,59,46,105,0.000333,0.168257,12,6057.267202,336.514845,504.772267,107.01955,1,0
0,0,24,24,19,23,42,114,72,186,0.000333,0.334324,27,27080.2181,1504.456561,1002.971041,184.752548,5,0
0,0,3,3,7,5,12,10,7,17,0.000333,0.020315,3,182.833088,10.157394,60.944363,31.261125,1,0
0,0,3,3,10,6,16,19,10,29,0.000333,0.038667,5,580,32.222222,116,48.729056,1,0
0,0,3,3,6,7,13,10,9,19,0.000333,0.023436,3,210.925064,11.718059,70.308355,35.161259,1,0
0,0,3,3,10,6,16,19,10,29,0.000333,0.038667,5,580,32.222222,116,48.729056,1,0
0,0,3,3,6,7,13,10,9,19,0.000333,0.023436,3,210.925064,11.718059,70.308355,35.161259,1,0
0,0,17,17,15,21,36,54,52,106,0.000333,0.182671,14,7672.168702,426.231595,548.01205,150.842025,1,0
0,0,26,26,22,28,50,109,78,187,0.000333,0.3518,22,23218.82437,1289.934687,1055.401107,232.713433,5,0
0,0,3,3,7,5,12,10,7,17,0.000333,0.020315,3,182.833088,10.157394,60.944363,31.261125,1,0
0,0,3,3,6,7,13,10,9,19,0.000333,0.023436,3,210.925064,11.718059,70.308355,35.161259,1,0
0,0,3,3,10,6,16,19,10,29,0.000333,0.038667,5,580,32.222222,116,48.729056,1,0
0,0,3,3,6,7,13,10,9,19,0.000333,0.023436,3,210.925064,11.718059,70.308355,35.161259,1,0
0,0,3,3,10,6,16,19,10,29,0.000333,0.038667,5,580,32.222222,116,48.729056,1,0
0,0,12,12,11,15,26,45,40,85,0.000333,0.133179,10,3995.37376,221.965209,399.537376,96.657107,1,0
0,0,21,21,18,22,40,100,66,166,0.000333,0.29448,27,23852.88172,1325.160096,883.440064,173.166146,5,0
0,0,3,3,7,5,12,10,7,17,0.000333,0.020315,3,182.833088,10.157394,60.944363,31.261125,1,0
0,0,3,3,6,7,13,10,9,19,0.000333,0.023436,3,210.925064,11.718059,70.308355,35.161259,1,0
0,0,3,3,6,7,13,10,9,19,0.000333,0.023436,3,210.925064,11.718059,70.308355,35.161259,1,0
0,0,3,3,10,6,16,19,10,29,0.000333,0.038667,5,580,32.222222,116,48.729056,1,0
0,0,3,3,10,6,16,19,10,29,0.000333,0.038667,5,580,32.222222,116,48.729056,1,0
0,0,13,13,12,15,27,49,42,91,0.000333,0.144232,12,5192.337152,288.463175,432.694763,101.622909,1,0
0,0,22,22,19,22,41,104,68,172,0.000333,0.307166,27,24880.47151,1382.248417,921.498945,178.818118,5,0
0,0,5,5,9,7,16,19,16,35,0.000333,0.046667,8,1120,62.222222,140,48.180809,1,0
0,0,5,5,8,8,16,19,16,35,0.000333,0.046667,8,1120,62.222222,140,48,1,0
0,0,3,3,10,6,16,19,10,29,0.000333,0.038667,5,580,32.222222,116,48.729056,1,0
0,0,5,5,8,9,17,19,18,37,0.000333,0.050412,8,1209.889001,67.216056,151.236125,52.529325,1,0
0,0,3,3,10,6,16,19,10,29,0.000333,0.038667,5,580,32.222222,116,48.729056,1,0
0,0,11,11,11,15,26,47,35,82,0.000333,0.128479,10,3854.360569,214.131143,385.436057,96.657107,1,0
0,0,20,20,18,22,40,102,61,163,0.000333,0.289158,18,15614.53703,867.474279,867.474279,173.166146,5,0
0,0,3,3,7,5,12,10,7,17,0.000333,0.020315,3,182.833088,10.157394,60.944363,31.261125,1,0
0,0,3,3,6,7,13,10,9,19,0.000333,0.023436,3,210.925064,11.718059,70.308355,35.161259,1,0
0,0,3,3,10,6,16,19,10,29,0.000333,0.038667,5,580,32.222222,116,48.729056,1,0
0,0,3,3,10,6,16,19,10,29,0.000333,0.038667,5,580,32.222222,116,48.729056,1,0
0,0,3,3,6,7,13,10,9,19,0.000333,0.023436,3,210.925064,11.718059,70.308355,35.161259,1,0
0,0,14,14,11,20,31,45,50,95,0.000333,0.156883,10,4706.486495,261.471472,470.648649,124.49231,1,0
0,0,23,23,18,27,45,100,76,176,0.000333,0.322189,18,17398.19061,966.566145,966.566145,203.440613,5,0
0,0,3,3,7,5,12,10,7,17,0.000333,0.020315,3,182.833088,10.157394,60.944363,31.261125,1,0
0,0,3,3,10,6,16,19,10,29,0.000333,0.038667,5,580,32.222222,116,48.729056,1,0
0,0,3,3,6,7,13,10,9,19,0.000333,0.023436,3,210.925064,11.718059,70.308355,35.161259,1,0
0,0,3,3,10,6,16,19,10,29,0.000333,0.038667,5,580,32.222222,116,48.729056,1,0
0,0,3,3,6,7,13,10,9,19,0.000333,0.023436,3,210.925064,11.718059,70.308355,35.161259,1,0
0,0,12,12,11,19,30,44,46,90,0.000333,0.147207,10,4416.201536,245.34453,441.620154,118.764371,1,0
0,0,21,21,18,30,48,99,72,171,0.000333,0.318343,18,17190.51458,955.028588,955.028588,222.265368,5,0
0,0,3,3,7,5,12,10,7,17,0.000333,0.020315,3,182.833088,10.157394,60.944363,31.261125,1,0
0,0,3,3,10,6,16,19,10,29,0.000333,0.038667,5,580,32.222222,116,48.729056,1,0
0,0,3,3,6,7,13,10,9,19,0.000333,0.023436,3,210.925064,11.718059,70.308355,35.161259,1,0
0,0,3,3,10,6,16,19,10,29,0.000333,0.038667,5,580,32.222222,116,48.729056,1,0
0,0,3,3,6,7,13,10,9,19,0.000333,0.023436,3,210.925064,11.718059,70.308355,35.161259,1,0
0,0,14,14,11,20,31,50,60,110,0.000333,0.181654,15,8174.423912,454.134662,544.961594,124.49231,1,0
0,0,23,23,18,27,45,105,86,191,0.000333,0.349648,27,28321.48642,1573.415912,1048.943941,203.440613,5,0
0,0,3,3,7,5,12,10,7,17,0.000333,0.020315,3,182.833088,10.157394,60.944363,31.261125,1,0
0,0,3,3,10,6,16,19,10,29,0.000333,0.038667,5,580,32.222222,116,48.729056,1,0
0,0,3,3,6,7,13,10,9,19,0.000333,0.023436,3,210.925064,11.718059,70.308355,35.161259,1,0
0,0,3,3,10,6,16,19,10,29,0.000333,0.038667,5,580,32.222222,116,48.729056,1,0
0,0,3,3,6,7,13,10,9,19,0.000333,0.023436,3,210.925064,11.718059,70.308355,35.161259,1,0
0,0,16,16,11,21,32,56,74,130,0.000333,0.216667,15,9750,541.666667,650,130.292414,1,0
0,0,25,25,18,28,46,111,100,211,0.000333,0.388491,27,31467.73246,1748.207359,1165.471573,209.664588,5,0
0,0,3,3,7,5,12,10,7,17,0.000333,0.020315,3,182.833088,10.157394,60.944363,31.261125,1,0
0,0,3,3,10,6,16,19,10,29,0.000333,0.038667,5,580,32.222222,116,48.729056,1,0
0,0,3,3,6,7,13,10,9,19,0.000333,0.023436,3,210.925064,11.718059,70.308355,35.161259,1,0
0,0,3,3,10,6,16,19,10,29,0.000333,0.038667,5,580,32.222222,116,48.729056,1,0
0,0,3,3,6,7,13,10,9,19,0.000333,0.023436,3,210.925064,11.718059,70.308355,35.161259,1,0
0,0,18,18,11,24,35,62,82,144,0.000333,0.246206,15,11079.25132,615.513962,738.616754,148.092848,1,0
0,0,27,27,18,31,49,117,108,225,0.000333,0.421103,27,34109.3623,1894.964572,1263.309715,228.638736,5,0
0,0,3,3,7,5,12,10,7,17,0.000333,0.020315,3,182.833088,10.157394,60.944363,31.261125,1,0
0,0,3,3,10,6,16,19,10,29,0.000333,0.038667,5,580,32.222222,116,48.729056,1,0
0,0,3,3,6,7,13,10,9,19,0.000333,0.023436,3,210.925064,11.718059,70.308355,35.161259,1,0
0,0,3,3,10,6,16,19,10,29,0.000333,0.038667,5,580,32.222222,116,48.729056,1,0
0,0,3,3,6,7,13,10,9,19,0.000333,0.023436,3,210.925064,11.718059,70.308355,35.161259,1,0
0,0,13,13,12,19,31,48,48,96,0.000333,0.158534,12,5707.23415,317.068564,475.602846,123.730173,1,0
0,0,22,22,19,26,45,103,74,177,0.000333,0.324019,18,17497.04397,972.057998,972.057998,202.922055,5,0
0,0,2,2,5,8,13,8,10,18,0.000333,0.022203,2,133.21583,7.400879,66.607915,35.60964,1,0
0,0,2,2,5,9,14,8,11,19,0.000333,0.024113,2,144.679487,8.037749,72.339744,40.138965,1,0
0,0,5,5,7,12,19,18,24,42,0.000333,0.059471,6,1070.477733,59.470985,178.412956,62.671034,1,0
0,0,3,3,10,6,16,19,10,29,0.000333,0.038667,5,580,32.222222,116,48.729056,1,0
0,0,3,3,10,6,16,19,10,29,0.000333,0.038667,5,580,32.222222,116,48.729056,1,0
0,0,13,13,12,20,32,50,49,99,0.000333,0.165,12,5940,330,495,129.458112,1,0
0,0,22,22,19,27,46,105,75,180,0.000333,0.331414,18,17896.34074,994.241152,994.241152,209.092585,5,0
0,0,3,3,7,5,12,10,7,17,0.000333,0.020315,3,182.833088,10.157394,60.944363,31.261125,1,0
0,0,3,3,10,6,16,19,10,29,0.000333,0.038667,5,580,32.222222,116,48.729056,1,0
0,0,3,3,6,7,13,10,9,19,0.000333,0.023436,3,210.925064,11.718059,70.308355,35.161259,1,0
0,0,3,3,10,6,16,19,10,29,0.000333,0.038667,5,580,32.222222,116,48.729056,1,0
0,0,3,3,6,7,13,10,9,19,0.000333,0.023436,3,210.925064,11.718059,70.308355,35.161259,1,0
0,0,14,14,12,21,33,59,53,112,0.000333,0.188324,12,6779.665696,376.648094,564.972141,135.258216,1,0
0,0,23,23,19,28,47,114,79,193,0.000333,0.357345,18,19296.64167,1072.035648,1072.035648,215.316561,5,0
0,0,3,3,7,5,12,10,7,17,0.000333,0.020315,3,182.833088,10.157394,60.944363,31.261125,1,0
0,0,3,3,10,6,16,19,10,29,0.000333,0.038667,5,580,32.222222,116,48.729056,1,0
0,0,3,3,6,7,13,10,9,19,0.000333,0.023436,3,210.925064,11.718059,70.308355,35.161259,1,0
0,0,3,3,10,6,16,19,10,29,0.000333,0.038667,5,580,32.222222,116,48.729056,1,0
0,0,3,3,6,7,13,10,9,19,0.000333,0.023436,3,210.925064,11.718059,70.308355,35.161259,1,0
0,0,11,11,10,18,28,46,41,87,0.000333,0.139413,10,4182.398782,232.355488,418.239878,108.277931,1,0
0,0,20,20,17,25,42,101,67,168,0.000333,0.30197,16,14494.54923,805.252735,905.909327,185.583273,5,0
0,0,3,3,7,5,12,10,7,17,0.000333,0.020315,3,182.833088,10.157394,60.944363,31.261125,1,0
0,0,3,3,6,7,13,10,9,19,0.000333,0.023436,3,210.925064,11.718059,70.308355,35.161259,1,0
0,0,3,3,10,6,16,19,10,29,0.000333,0.038667,5,580,32.222222,116,48.729056,1,0
0,0,3,3,10,6,16,19,10,29,0.000333,0.038667,5,580,32.222222,116,48.729056,1,0
0,0,3,3,6,7,13,10,9,19,0.000333,0.023436,3,210.925064,11.718059,70.308355,35.161259,1,0
0,0,15,15,11,22,33,59,56,115,0.000333,0.193368,10,5801.053237,322.280735,580.105324,136.161243,1,0
0,0,24,24,18,29,47,114,82,196,0.000333,0.3629,18,19596.58947,1088.699415,1088.699415,215.940099,5,0
0,0,3,3,7,5,12,10,7,17,0.000333,0.020315,3,182.833088,10.157394,60.944363,31.261125,1,0
0,0,3,3,10,6,16,19,10,29,0.000333,0.038667,5,580,32.222222,116,48.729056,1,0
0,0,3,3,6,7,13,10,9,19,0.000333,0.023436,3,210.925064,11.718059,70.308355,35.161259,1,0
0,0,3,3,6,7,13,10,9,19,0.000333,0.023436,3,210.925064,11.718059,70.308355,35.161259,1,0
0,0,3,3,10,6,16,19,10,29,0.000333,0.038667,5,580,32.222222,116,48.729056,1,0
0,0,18,18,15,23,38,57,71,128,0.000333,0.223912,21,14106.42916,783.690509,671.734722,162.645284,1,0
0,0,27,27,22,30,52,112,97,209,0.000333,0.397131,33,39315.93274,2184.218485,1191.391901,245.314213,5,0
0,0,3,3,7,5,12,10,7,17,0.000333,0.020315,3,182.833088,10.157394,60.944363,31.261125,1,0
0,0,3,3,10,6,16,19,10,29,0.000333,0.038667,5,580,32.222222,116,48.729056,1,0
0,0,3,3,6,7,13,10,9,19,0.000333,0.023436,3,210.925064,11.718059,70.308355,35.161259,1,0
0,0,3,3,10,6,16,19,10,29,0.000333,0.038667,5,580,32.222222,116,48.729056,1,0
0,0,3,3,6,7,13,10,9,19,0.000333,0.023436,3,210.925064,11.718059,70.308355,35.161259,1,0
0,0,14,14,11,21,32,44,56,100,0.000333,0.166667,10,5000,277.777778,500,130.292414,1,0
0,0,23,23,18,28,46,99,82,181,0.000333,0.333255,18,17995.76485,999.764714,999.764714,209.664588,5,0
0,0,3,3,7,5,12,10,7,17,0.000333,0.020315,3,182.833088,10.157394,60.944363,31.261125,1,0
0,0,3,3,10,6,16,19,10,29,0.000333,0.038667,5,580,32.222222,116,48.729056,1,0
0,0,3,3,6,7,13,10,9,19,0.000333,0.023436,3,210.925064,11.718059,70.308355,35.161259,1,0
0,0,3,3,10,6,16,19,10,29,0.000333,0.038667,5,580,32.222222,116,48.729056,1,0
0,0,3,3,6,7,13,10,9,19,0.000333,0.023436,3,210.925064,11.718059,70.308355,35.161259,1,0
0,0,13,13,15,22,37,51,54,105,0.000333,0.182331,14,7657.896447,425.438692,546.992603,156.710855,1,0
0,0,22,22,22,29,51,106,80,186,0.000333,0.35169,22,23211.5645,1289.531361,1055.071114,238.988944,5,0
0,0,3,3,7,5,12,10,7,17,0.000333,0.020315,3,182.833088,10.157394,60.944363,31.261125,1,0
0,0,3,3,10,6,16,19,10,29,0.000333,0.038667,5,580,32.222222,116,48.729056,1,0
0,0,3,3,10,6,16,19,10,29,0.000333,0.038667,5,580,32.222222,116,48.729056,1,0
0,0,3,3,6,7,13,10,9,19,0.000333,0.023436,3,210.925064,11.718059,70.308355,35.161259,1,0
0,0,3,3,6,7,13,10,9,19,0.000333,0.023436,3,210.925064,11.718059,70.308355,35.161259,1,0
0,0,13,13,14,22,36,50,54,104,0.000333,0.179224,14,7527.410802,418.189489,537.6722,151.410465,1,0
0,0,22,22,21,29,50,105,80,185,0.000333,0.348038,20,20882.2679,1160.125995,1044.113395,233.120115,5,0
0,0,3,3,7,5,12,10,7,17,0.000333,0.020315,3,182.833088,10.157394,60.944363,31.261125,1,0
0,0,3,3,6,7,13,10,9,19,0.000333,0.023436,3,210.925064,11.718059,70.308355,35.161259,1,0
0,0,3,3,10,6,16,19,10,29,0.000333,0.038667,5,580,32.222222,116,48.729056,1,0
0,0,3,3,10,6,16,19,10,29,0.000333,0.038667,5,580,32.222222,116,48.729056,1,0
0,0,3,3,6,7,13,10,9,19,0.000333,0.023436,3,210.925064,11.718059,70.308355,35.161259,1,0
0,0,5,5,8,7,15,16,12,28,0.000333,0.036464,4,437.571747,24.309541,109.392937,43.651484,2,0
0,0,12,12,16,15,31,59,38,97,0.000333,0.160186,16,7688.912674,427.161815,480.557042,122.603359,6,0
0,0,4,4,11,11,22,24,17,41,0.000333,0.060946,5,914.183482,50.787971,182.836696,76.107496,2,0
0,0,4,4,11,11,22,24,17,41,0.000333,0.060946,5,914.183482,50.787971,182.836696,76.107496,2,0
0,0,3,3,7,5,12,10,7,17,0.000333,0.020315,3,182.833088,10.157394,60.944363,31.261125,1,0
0,0,5,5,11,11,22,28,20,48,0.000333,0.071351,5,1070.263588,59.459088,214.052718,76.107496,2,0
0,0,5,5,11,11,22,28,20,48,0.000333,0.071351,5,1070.263588,59.459088,214.052718,76.107496,2,0
0,0,15,15,18,15,33,68,40,108,0.000333,0.181598,18,9806.302168,544.794565,544.794565,133.662009,8,0
0,0,14,14,16,15,31,65,40,105,0.000333,0.173397,16,8323.049801,462.391656,520.190613,122.603359,8,0
0,0,8,8,12,9,21,25,14,39,0.000333,0.0571,6,1027.802277,57.100126,171.300379,71.548875,4,0
0,0,7,7,9,8,17,22,14,36,0.000333,0.04905,4,588.594649,32.699703,147.148662,52.529325,4,0
0,0,4,4,11,11,22,24,17,41,0.000333,0.060946,5,914.183482,50.787971,182.836696,76.107496,2,0
0,0,4,4,11,11,22,24,17,41,0.000333,0.060946,5,914.183482,50.787971,182.836696,76.107496,2,0
0,0,4,4,11,11,22,24,17,41,0.000333,0.060946,5,914.183482,50.787971,182.836696,76.107496,2,0
0,0,3,3,7,5,12,10,7,17,0.000333,0.020315,3,182.833088,10.157394,60.944363,31.261125,1,0
0,0,3,3,7,5,12,10,7,17,0.000333,0.020315,3,182.833088,10.157394,60.944363,31.261125,1,0
0,0,5,5,11,11,22,28,20,48,0.000333,0.071351,5,1070.263588,59.459088,214.052718,76.107496,2,0
0,0,5,5,11,11,22,28,20,48,0.000333,0.071351,5,1070.263588,59.459088,214.052718,76.107496,2,0
0,0,5,5,11,11,22,28,20,48,0.000333,0.071351,5,1070.263588,59.459088,214.052718,76.107496,2,0
0,0,15,15,18,16,34,69,42,111,0.000333,0.188236,18,10164.75076,564.708375,564.708375,139.05865,8,0
0,0,14,14,16,16,32,65,42,107,0.000333,0.178333,16,8560,475.555556,535,128,8,0
0,0,8,8,13,8,21,26,16,42,0.000333,0.061492,12,2213.727981,122.984888,184.477332,72.105716,4,0
0,0,7,7,9,8,17,22,16,38,0.000333,0.051775,8,1242.588704,69.032706,155.323588,52.529325,4,0
0,0,4,4,11,11,22,24,17,41,0.000333,0.060946,5,914.183482,50.787971,182.836696,76.107496,2,0
0,0,4,4,11,11,22,24,17,41,0.000333,0.060946,5,914.183482,50.787971,182.836696,76.107496,2,0
0,0,4,4,11,11,22,24,17,41,0.000333,0.060946,5,914.183482,50.787971,182.836696,76.107496,2,0
0,0,3,3,7,5,12,10,7,17,0.000333,0.020315,3,182.833088,10.157394,60.944363,31.261125,1,0
0,0,3,3,7,5,12,10,7,17,0.000333,0.020315,3,182.833088,10.157394,60.944363,31.261125,1,0
0,0,5,5,11,11,22,28,20,48,0.000333,0.071351,5,1070.263588,59.459088,214.052718,76.107496,2,0
0,0,5,5,11,11,22,28,20,48,0.000333,0.071351,5,1070.263588,59.459088,214.052718,76.107496,2,0
0,0,5,5,11,11,22,28,20,48,0.000333,0.071351,5,1070.263588,59.459088,214.052718,76.107496,2,0
0,0,17,17,20,17,37,76,46,122,0.000333,0.211851,20,12711.06621,706.170345,635.553311,155.92543,8,0
0,0,16,16,18,17,35,73,46,119,0.000333,0.203462,18,10986.92422,610.384679,610.384679,144.545518,8,0
0,0,10,10,14,12,26,33,20,53,0.000333,0.083041,7,1743.863135,96.881285,249.123305,96.322519,4,0
0,0,9,9,11,12,23,30,20,50,0.000333,0.075393,5,1130.890489,62.827249,226.178098,81.073298,4,0
0,0,4,4,11,11,22,24,17,41,0.000333,0.060946,5,914.183482,50.787971,182.836696,76.107496,2,0
0,0,4,4,11,11,22,24,17,41,0.000333,0.060946,5,914.183482,50.787971,182.836696,76.107496,2,0
0,0,4,4,11,11,22,24,17,41,0.000333,0.060946,5,914.183482,50.787971,182.836696,76.107496,2,0
0,0,3,3,7,5,12,10,7,17,0.000333,0.020315,3,182.833088,10.157394,60.944363,31.261125,1,0
0,0,3,3,7,5,12,10,7,17,0.000333,0.020315,3,182.833088,10.157394,60.944363,31.261125,1,0
0,0,5,5,11,11,22,28,20,48,0.000333,0.071351,5,1070.263588,59.459088,214.052718,76.107496,2,0
0,0,5,5,11,11,22,28,20,48,0.000333,0.071351,5,1070.263588,59.459088,214.052718,76.107496,2,0
0,0,5,5,11,11,22,28,20,48,0.000333,0.071351,5,1070.263588,59.459088,214.052718,76.107496,2,0
0,0,17,17,19,17,36,74,46,120,0.000333,0.206797,18,11167.038,620.391,620.391,150.197491,8,0
0,0,16,16,17,17,34,71,46,117,0.000333,0.198411,16,9523.730439,529.096135,595.233152,138.973737,8,0
0,0,10,10,13,12,25,31,20,51,0.000333,0.078946,6,1421.019994,78.945555,236.836666,91.125266,4,0
0,0,9,9,10,12,22,28,20,48,0.000333,0.071351,5,1070.263588,59.459088,214.052718,76.238831,4,0
0,0,4,4,11,11,22,24,17,41,0.000333,0.060946,5,914.183482,50.787971,182.836696,76.107496,2,0
0,0,4,4,11,11,22,24,17,41,0.000333,0.060946,5,914.183482,50.787971,182.836696,76.107496,2,0
0,0,4,4,11,11,22,24,17,41,0.000333,0.060946,5,914.183482,50.787971,182.836696,76.107496,2,0
0,0,3,3,7,5,12,10,7,17,0.000333,0.020315,3,182.833088,10.157394,60.944363,31.261125,1,0
0,0,3,3,7,5,12,10,7,17,0.000333,0.020315,3,182.833088,10.157394,60.944363,31.261125,1,0
0,0,5,5,11,11,22,28,20,48,0.000333,0.071351,5,1070.263588,59.459088,214.052718,76.107496,2,0
0,0,5,5,11,11,22,28,20,48,0.000333,0.071351,5,1070.263588,59.459088,214.052718,76.107496,2,0
0,0,5,5,11,11,22,28,20,48,0.000333,0.071351,5,1070.263588,59.459088,214.052718,76.107496,2,0
0,0,16,16,20,17,37,73,45,118,0.000333,0.204905,20,12294.30994,683.017219,614.715497,155.92543,8,0
0,0,15,15,18,17,35,69,45,114,0.000333,0.194913,18,10525.28875,584.738264,584.738264,144.545518,8,0
0,0,9,9,15,10,25,30,19,49,0.000333,0.07585,7,1592.842673,88.49126,227.548953,91.82264,4,0
0,0,8,8,11,10,21,26,19,45,0.000333,0.065885,5,988.27142,54.903968,197.654284,71.273029,4,0
0,0,4,4,11,11,22,24,17,41,0.000333,0.060946,5,914.183482,50.787971,182.836696,76.107496,2,0
0,0,4,4,11,11,22,24,17,41,0.000333,0.060946,5,914.183482,50.787971,182.836696,76.107496,2,0
0,0,4,4,11,11,22,24,17,41,0.000333,0.060946,5,914.183482,50.787971,182.836696,76.107496,2,0
0,0,3,3,7,5,12,10,7,17,0.000333,0.020315,3,182.833088,10.157394,60.944363,31.261125,1,0
0,0,3,3,7,5,12,10,7,17,0.000333,0.020315,3,182.833088,10.157394,60.944363,31.261125,1,0
0,0,5,5,11,11,22,28,20,48,0.000333,0.071351,5,1070.263588,59.459088,214.052718,76.107496,2,0
0,0,5,5,11,11,22,28,20,48,0.000333,0.071351,5,1070.263588,59.459088,214.052718,76.107496,2,0
0,0,5,5,11,11,22,28,20,48,0.000333,0.071351,5,1070.263588,59.459088,214.052718,76.107496,2,0
0,0,16,16,19,17,36,72,45,117,0.000333,0.201627,18,10887.86205,604.881225,604.881225,150.197491,8,0
0,0,15,15,17,17,34,68,45,113,0.000333,0.191628,16,9198.132817,511.007379,574.883301,138.973737,8,0
0,0,9,9,14,10,24,29,19,48,0.000333,0.073359,7,1540.5474,85.585967,220.0782,86.52225,4,0
0,0,8,8,10,10,20,25,19,44,0.000333,0.063388,5,950.824181,52.823566,190.164836,66.438562,4,0
0,0,4,4,11,11,22,24,17,41,0.000333,0.060946,5,914.183482,50.787971,182.836696,76.107496,2,0
0,0,4,4,11,11,22,24,17,41,0.000333,0.060946,5,914.183482,50.787971,182.836696,76.107496,2,0
0,0,4,4,11,11,22,24,17,41,0.000333,0.060946,5,914.183482,50.787971,182.836696,76.107496,2,0
0,0,3,3,7,5,12,10,7,17,0.000333,0.020315,3,182.833088,10.157394,60.944363,31.261125,1,0
0,0,3,3,7,5,12,10,7,17,0.000333,0.020315,3,182.833088,10.157394,60.944363,31.261125,1,0
0,0,5,5,11,11,22,28,20,48,0.000333,0.071351,5,1070.263588,59.459088,214.052718,76.107496,2,0
0,0,5,5,11,11,22,28,20,48,0.000333,0.071351,5,1070.263588,59.459088,214.052718,76.107496,2,0
0,0,5,5,11,11,22,28,20,48,0.000333,0.071351,5,1070.263588,59.459088,214.052718,76.107496,2,0
0,0,19,19,20,17,37,74,46,120,0.000333,0.208378,20,12502.68808,694.593782,625.134404,155.92543,8,0
0,0,18,18,18,17,35,71,46,117,0.000333,0.200042,18,10802.27003,600.126113,600.126113,144.545518,8,0
0,0,12,12,14,12,26,31,20,51,0.000333,0.079907,7,1678.056979,93.225388,239.722426,96.322519,4,0
0,0,11,11,11,12,23,28,20,48,0.000333,0.072377,5,1085.654869,60.314159,217.130974,81.073298,4,0
0,0,4,4,11,11,22,24,17,41,0.000333,0.060946,5,914.183482,50.787971,182.836696,76.107496,2,0
0,0,4,4,11,11,22,24,17,41,0.000333,0.060946,5,914.183482,50.787971,182.836696,76.107496,2,0
0,0,4,4,11,11,22,24,17,41,0.000333,0.060946,5,914.183482,50.787971,182.836696,76.107496,2,0
0,0,3,3,7,5,12,10,7,17,0.000333,0.020315,3,182.833088,10.157394,60.944363,31.261125,1,0
0,0,3,3,7,5,12,10,7,17,0.000333,0.020315,3,182.833088,10.157394,60.944363,31.261125,1,0
0,0,5,5,11,11,22,28,20,48,0.000333,0.071351,5,1070.263588,59.459088,214.052718,76.107496,2,0
0,0,5,5,11,11,22,28,20,48,0.000333,0.071351,5,1070.263588,59.459088,214.052718,76.107496,2,0
0,0,5,5,11,11,22,28,20,48,0.000333,0.071351,5,1070.263588,59.459088,214.052718,76.107496,2,0
0,0,17,17,19,17,36,74,46,120,0.000333,0.206797,18,11167.038,620.391,620.391,150.197491,8,0
0,0,16,16,17,17,34,71,46,117,0.000333,0.198411,16,9523.730439,529.096135,595.233152,138.973737,8,0
0,0,10,10,13,12,25,31,20,51,0.000333,0.078946,6,1421.019994,78.945555,236.836666,91.125266,4,0
0,0,9,9,10,12,22,28,20,48,0.000333,0.071351,5,1070.263588,59.459088,214.052718,76.238831,4,0
0,0,4,4,11,11,22,24,17,41,0.000333,0.060946,5,914.183482,50.787971,182.836696,76.107496,2,0
0,0,4,4,11,11,22,24,17,41,0.000333,0.060946,5,914.183482,50.787971,182.836696,76.107496,2,0
0,0,4,4,11,11,22,24,17,41,0.000333,0.060946,5,914.183482,50.787971,182.836696,76.107496,2,0
0,0,3,3,7,5,12,10,7,17,0.000333,0.020315,3,182.833088,10.157394,60.944363,31.261125,1,0
0,0,3,3,7,5,12,10,7,17,0.000333,0.020315,3,182.833088,10.157394,60.944363,31.261125,1,0
0,0,5,5,11,11,22,28,20,48,0.000333,0.071351,5,1070.263588,59.459088,214.052718,76.107496,2,0
0,0,5,5,11,11,22,28,20,48,0.000333,0.071351,5,1070.263588,59.459088,214.052718,76.107496,2,0
0,0,5,5,11,11,22,28,20,48,0.000333,0.071351,5,1070.263588,59.459088,214.052718,76.107496,2,0
0,0,17,17,18,17,35,72,46,118,0.000333,0.201752,18,10894.59713,605.255396,605.255396,144.545518,8,0
0,0,16,16,16,17,33,69,46,115,0.000333,0.193368,16,9281.68518,515.649177,580.105324,133.486868,8,0
0,0,10,10,12,12,24,29,20,49,0.000333,0.074888,6,1347.978975,74.887721,224.663163,86.0391,4,0
0,0,9,9,9,12,21,26,20,46,0.000333,0.067349,4,808.186406,44.899245,202.046601,71.548875,4,0
0,0,4,4,11,11,22,24,17,41,0.000333,0.060946,5,914.183482,50.787971,182.836696,76.107496,2,0
0,0,4,4,11,11,22,24,17,41,0.000333,0.060946,5,914.183482,50.787971,182.836696,76.107496,2,0
0,0,4,4,11,11,22,24,17,41,0.000333,0.060946,5,914.183482,50.787971,182.836696,76.107496,2,0
0,0,3,3,7,5,12,10,7,17,0.000333,0.020315,3,182.833088,10.157394,60.944363,31.261125,1,0
0,0,3,3,7,5,12,10,7,17,0.000333,0.020315,3,182.833088,10.157394,60.944363,31.261125,1,0
0,0,5,5,11,11,22,28,20,48,0.000333,0.071351,5,1070.263588,59.459088,214.052718,76.107496,2,0
0,0,5,5,11,11,22,28,20,48,0.000333,0.071351,5,1070.263588,59.459088,214.052718,76.107496,2,0
0,0,5,5,11,11,22,28,20,48,0.000333,0.071351,5,1070.263588,59.459088,214.052718,76.107496,2,0
0,0,19,19,19,17,36,72,46,118,0.000333,0.20335,18,10980.9207,610.05115,610.05115,150.197491,8,0
0,0,18,18,17,17,34,69,46,115,0.000333,0.195019,16,9360.931628,520.051757,585.058227,138.973737,8,0
0,0,12,12,13,12,25,29,20,49,0.000333,0.07585,6,1365.29372,75.849651,227.548953,91.125266,4,0
0,0,11,11,10,12,22,26,20,46,0.000333,0.068378,5,1025.669272,56.981626,205.133854,76.238831,4,0
0,0,4,4,11,11,22,24,17,41,0.000333,0.060946,5,914.183482,50.787971,182.836696,76.107496,2,0
0,0,4,4,11,11,22,24,17,41,0.000333,0.060946,5,914.183482,50.787971,182.836696,76.107496,2,0
0,0,4,4,11,11,22,24,17,41,0.000333,0.060946,5,914.183482,50.787971,182.836696,76.107496,2,0
0,0,3,3,7,5,12,10,7,17,0.000333,0.020315,3,182.833088,10.157394,60.944363,31.261125,1,0
0,0,3,3,7,5,12,10,7,17,0.000333,0.020315,3,182.833088,10.157394,60.944363,31.261125,1,0
0,0,5,5,11,11,22,28,20,48,0.000333,0.071351,5,1070.263588,59.459088,214.052718,76.107496,2,0
0,0,5,5,11,11,22,28,20,48,0.000333,0.071351,5,1070.263588,59.459088,214.052718,76.107496,2,0
0,0,5,5,11,11,22,28,20,48,0.000333,0.071351,5,1070.263588,59.459088,214.052718,76.107496,2,0
0,0,4,4,11,11,22,24,17,41,0.000333,0.060946,5,914.183482,50.787971,182.836696,76.107496,2,0
0,0,4,4,11,11,22,24,17,41,0.000333,0.060946,5,914.183482,50.787971,182.836696,76.107496,2,0
0,0,4,4,11,11,22,24,17,41,0.000333,0.060946,5,914.183482,50.787971,182.836696,76.107496,2,0
0,0,3,3,7,5,12,10,7,17,0.000333,0.020315,3,182.833088,10.157394,60.944363,31.261125,1,0
0,0,3,3,7,5,12,10,7,17,0.000333,0.020315,3,182.833088,10.157394,60.944363,31.261125,1,0
0,0,3,3,7,5,12,10,7,17,0.000333,0.020315,3,182.833088,10.157394,60.944363,31.261125,1,0
0,0,5,5,11,11,22,28,20,48,0.000333,0.071351,5,1070.263588,59.459088,214.052718,76.107496,2,0
0,0,5,5,11,11,22,28,20,48,0.000333,0.071351,5,1070.263588,59.459088,214.052718,76.107496,2,0
0,0,5,5,11,11,22,28,20,48,0.000333,0.071351,5,1070.263588,59.459088,214.052718,76.107496,2,0
0,0,16,16,19,17,36,72,45,117,0.000333,0.201627,18,10887.86205,604.881225,604.881225,150.197491,8,0
0,0,15,15,17,17,34,68,45,113,0.000333,0.191628,16,9198.132817,511.007379,574.883301,138.973737,8,0
0,0,9,9,14,10,24,29,19,48,0.000333,0.073359,7,1540.5474,85.585967,220.0782,86.52225,4,0
0,0,8,8,10,10,20,25,19,44,0.000333,0.063388,5,950.824181,52.823566,190.164836,66.438562,4,0
0,0,4,4,11,11,22,24,17,41,0.000333,0.060946,5,914.183482,50.787971,182.836696,76.107496,2,0
0,0,4,4,11,11,22,24,17,41,0.000333,0.060946,5,914.183482,50.787971,182.836696,76.107496,2,0
0,0,4,4,11,11,22,24,17,41,0.000333,0.060946,5,914.183482,50.787971,182.836696,76.107496,2,0
0,0,3,3,7,5,12,10,7,17,0.000333,0.020315,3,182.833088,10.157394,60.944363,31.261125,1,0
0,0,3,3,7,5,12,10,7,17,0.000333,0.020315,3,182.833088,10.157394,60.944363,31.261125,1,0
0,0,5,5,11,11,22,28,20,48,0.000333,0.071351,5,1070.263588,59.459088,214.052718,76.107496,2,0
0,0,5,5,11,11,22,28,20,48,0.000333,0.071351,5,1070.263588,59.459088,214.052718,76.107496,2,0
0,0,5,5,11,11,22,28,20,48,0.000333,0.071351,5,1070.263588,59.459088,214.052718,76.107496,2,0
0,0,16,16,18,17,35,71,45,116,0.000333,0.198332,18,10709.94294,594.99683,594.99683,144.545518,8,0
0,0,15,15,16,17,33,67,45,112,0.000333,0.188324,16,9039.554262,502.197459,564.972141,133.486868,8,0
0,0,9,9,13,10,23,28,19,47,0.000333,0.070869,6,1275.644472,70.869137,212.607412,81.324997,4,0
0,0,8,8,9,10,19,24,19,43,0.000333,0.060887,4,730.643532,40.591307,182.660883,61.748606,4,0
0,0,4,4,11,11,22,24,17,41,0.000333,0.060946,5,914.183482,50.787971,182.836696,76.107496,2,0
0,0,4,4,11,11,22,24,17,41,0.000333,0.060946,5,914.183482,50.787971,182.836696,76.107496,2,0
0,0,4,4,11,11,22,24,17,41,0.000333,0.060946,5,914.183482,50.787971,182.836696,76.107496,2,0
0,0,3,3,7,5,12,10,7,17,0.000333,0.020315,3,182.833088,10.157394,60.944363,31.261125,1,0
0,0,3,3,7,5,12,10,7,17,0.000333,0.020315,3,182.833088,10.157394,60.944363,31.261125,1,0
0,0,5,5,11,11,22,28,20,48,0.000333,0.071351,5,1070.263588,59.459088,214.052718,76.107496,2,0
0,0,5,5,11,11,22,28,20,48,0.000333,0.071351,5,1070.263588,59.459088,214.052718,76.107496,2,0
0,0,5,5,11,11,22,28,20,48,0.000333,0.071351,5,1070.263588,59.459088,214.052718,76.107496,2,0
0,0,22,22,21,18,39,81,42,123,0.000333,0.216701,20,13002.08946,722.338303,650.104473,167.297316,8,0
0,0,22,22,21,17,38,81,42,123,0.000333,0.215165,20,12909.90168,717.21676,645.495084,161.725534,8,0
0,0,15,15,13,10,23,38,16,54,0.000333,0.081424,6,1465.634074,81.424115,244.272346,81.324997,4,0
0,0,15,15,13,9,22,38,16,54,0.000333,0.08027,6,1444.855844,80.269769,240.809307,76.635041,4,0
0,0,4,4,11,11,22,24,17,41,0.000333,0.060946,5,914.183482,50.787971,182.836696,76.107496,2,0
0,0,4,4,11,11,22,24,17,41,0.000333,0.060946,5,914.183482,50.787971,182.836696,76.107496,2,0
0,0,4,4,11,11,22,24,17,41,0.000333,0.060946,5,914.183482,50.787971,182.836696,76.107496,2,0
0,0,3,3,7,5,12,10,7,17,0.000333,0.020315,3,182.833088,10.157394,60.944363,31.261125,1,0
0,0,3,3,7,5,12,10,7,17,0.000333,0.020315,3,182.833088,10.157394,60.944363,31.261125,1,0
0,0,5,5,11,11,22,28,20,48,0.000333,0.071351,5,1070.263588,59.459088,214.052718,76.107496,2,0
0,0,5,5,11,11,22,28,20,48,0.000333,0.071351,5,1070.263588,59.459088,214.052718,76.107496,2,0
0,0,5,5,11,11,22,28,20,48,0.000333,0.071351,5,1070.263588,59.459088,214.052718,76.107496,2,0
0,0,16,16,18,15,33,69,40,109,0.000333,0.18328,18,9897.101262,549.838959,549.838959,133.662009,8,0
0,0,9,9,10,8,18,26,14,40,0.000333,0.055599,5,833.985,46.3325,166.797,57.219281,4,0
0,0,7,7,11,12,23,37,25,62,0.000333,0.093487,10,2804.608413,155.811578,280.460841,81.073298,2,0
0,0,7,7,11,12,23,37,25,62,0.000333,0.093487,10,2804.608413,155.811578,280.460841,81.073298,2,0
0,0,3,3,7,5,12,10,7,17,0.000333,0.020315,3,182.833088,10.157394,60.944363,31.261125,1,0
0,0,7,7,11,12,23,37,25,62,0.000333,0.093487,10,2804.608413,155.811578,280.460841,81.073298,2,0
0,0,4,4,9,9,18,26,19,45,0.000333,0.062549,8,1501.173001,83.3985,187.646625,57.05865,2,0
0,0,4,4,9,9,18,26,19,45,0.000333,0.062549,8,1501.173001,83.3985,187.646625,57.05865,2,0
0,0,7,7,11,12,23,37,25,62,0.000333,0.093487,10,2804.608413,155.811578,280.460841,81.073298,2,0
0,0,14,14,19,17,36,75,48,123,0.000333,0.211967,18,11446.21395,635.900775,635.900775,150.197491,8,0
0,0,8,8,11,12,23,34,25,59,0.000333,0.088963,10,2668.901554,148.272309,266.890155,81.073298,4,0
0,0,7,7,11,12,23,37,25,62,0.000333,0.093487,10,2804.608413,155.811578,280.460841,81.073298,2,0
0,0,7,7,11,12,23,37,25,62,0.000333,0.093487,10,2804.608413,155.811578,280.460841,81.073298,2,0
0,0,3,3,7,5,12,10,7,17,0.000333,0.020315,3,182.833088,10.157394,60.944363,31.261125,1,0
0,0,4,4,9,9,18,26,19,45,0.000333,0.062549,8,1501.173001,83.3985,187.646625,57.05865,2,0
0,0,4,4,9,9,18,26,19,45,0.000333,0.062549,8,1501.173001,83.3985,187.646625,57.05865,2,0
0,0,7,7,11,12,23,37,25,62,0.000333,0.093487,10,2804.608413,155.811578,280.460841,81.073298,2,0
0,0,7,7,11,12,23,37,25,62,0.000333,0.093487,10,2804.608413,155.811578,280.460841,81.073298,2,0
0,0,16,16,18,17,35,65,42,107,0.000333,0.182944,18,9878.999091,548.833283,548.833283,144.545518,6,0
0,0,9,9,10,9,19,22,16,38,0.000333,0.053807,5,807.106228,44.839235,161.421246,61.748606,2,0
0,0,4,4,11,11,22,24,17,41,0.000333,0.060946,5,914.183482,50.787971,182.836696,76.107496,2,0
0,0,4,4,11,11,22,24,17,41,0.000333,0.060946,5,914.183482,50.787971,182.836696,76.107496,2,0
0,0,3,3,7,5,12,10,7,17,0.000333,0.020315,3,182.833088,10.157394,60.944363,31.261125,1,0
0,0,5,5,11,11,22,28,20,48,0.000333,0.071351,5,1070.263588,59.459088,214.052718,76.107496,2,0
0,0,5,5,11,11,22,28,20,48,0.000333,0.071351,5,1070.263588,59.459088,214.052718,76.107496,2,0
0,0,17,17,19,20,39,74,55,129,0.000333,0.227272,18,12272.70395,681.816886,681.816886,167.149185,7,0
0,0,16,16,17,20,37,71,55,126,0.000333,0.218797,16,10502.25799,583.458777,656.391124,155.92543,7,0
0,0,9,9,10,12,22,28,25,53,0.000333,0.078783,10,2363.498758,131.305487,236.349876,76.238831,3,0
0,0,4,4,11,11,22,24,17,41,0.000333,0.060946,5,914.183482,50.787971,182.836696,76.107496,2,0
0,0,4,4,11,11,22,24,17,41,0.000333,0.060946,5,914.183482,50.787971,182.836696,76.107496,2,0
0,0,4,4,11,11,22,24,17,41,0.000333,0.060946,5,914.183482,50.787971,182.836696,76.107496,2,0
0,0,3,3,7,5,12,10,7,17,0.000333,0.020315,3,182.833088,10.157394,60.944363,31.261125,1,0
0,0,5,5,11,11,22,28,20,48,0.000333,0.071351,5,1070.263588,59.459088,214.052718,76.107496,2,0
0,0,5,5,11,11,22,28,20,48,0.000333,0.071351,5,1070.263588,59.459088,214.052718,76.107496,2,0
0,0,5,5,11,11,22,28,20,48,0.000333,0.071351,5,1070.263588,59.459088,214.052718,76.107496,2,0
0,0,17,17,18,22,40,73,63,136,0.000333,0.241261,18,13028.07998,723.782221,723.782221,173.166146,7,0
0,0,16,16,16,22,38,70,63,133,0.000333,0.232658,16,11167.58975,620.421653,697.974359,162.107496,7,0
0,0,9,9,9,14,23,27,33,60,0.000333,0.090471,8,2171.309739,120.628319,271.413717,81.832294,3,0
0,0,4,4,11,11,22,24,17,41,0.000333,0.060946,5,914.183482,50.787971,182.836696,76.107496,2,0
0,0,4,4,11,11,22,24,17,41,0.000333,0.060946,5,914.183482,50.787971,182.836696,76.107496,2,0
0,0,4,4,11,11,22,24,17,41,0.000333,0.060946,5,914.183482,50.787971,182.836696,76.107496,2,0
0,0,3,3,7,5,12,10,7,17,0.000333,0.020315,3,182.833088,10.157394,60.944363,31.261125,1,0
0,0,5,5,11,11,22,28,20,48,0.000333,0.071351,5,1070.263588,59.459088,214.052718,76.107496,2,0
0,0,5,5,11,11,22,28,20,48,0.000333,0.071351,5,1070.263588,59.459088,214.052718,76.107496,2,0
0,0,5,5,11,11,22,28,20,48,0.000333,0.071351,5,1070.263588,59.459088,214.052718,76.107496,2,0
0,0,7,7,8,8,16,22,18,40,0.000333,0.053333,8,1280,71.111111,160,48,2,0
0,0,14,14,16,16,32,65,44,109,0.000333,0.181667,16,8720,484.444444,545,128,6,0
0,0,4,4,11,11,22,24,17,41,0.000333,0.060946,5,914.183482,50.787971,182.836696,76.107496,2,0
0,0,4,4,11,11,22,24,17,41,0.000333,0.060946,5,914.183482,50.787971,182.836696,76.107496,2,0
0,0,3,3,7,5,12,10,7,17,0.000333,0.020315,3,182.833088,10.157394,60.944363,31.261125,1,0
0,0,5,5,11,11,22,28,20,48,0.000333,0.071351,5,1070.263588,59.459088,214.052718,76.107496,2,0
0,0,5,5,11,11,22,28,20,48,0.000333,0.071351,5,1070.263588,59.459088,214.052718,76.107496,2,0
0,0,10,10,9,9,18,37,26,63,0.000333,0.087568,8,2101.642201,116.7579,262.705275,57.05865,2,0
0,0,17,17,17,17,34,80,52,132,0.000333,0.223848,24,16117.08228,895.39346,671.545095,138.973737,6,0
0,0,4,4,11,11,22,24,17,41,0.000333,0.060946,5,914.183482,50.787971,182.836696,76.107496,2,0
0,0,4,4,11,11,22,24,17,41,0.000333,0.060946,5,914.183482,50.787971,182.836696,76.107496,2,0
0,0,3,3,7,5,12,10,7,17,0.000333,0.020315,3,182.833088,10.157394,60.944363,31.261125,1,0
0,0,5,5,11,11,22,28,20,48,0.000333,0.071351,5,1070.263588,59.459088,214.052718,76.107496,2,0
0,0,5,5,11,11,22,28,20,48,0.000333,0.071351,5,1070.263588,59.459088,214.052718,76.107496,2,0
0,0,12,12,12,13,25,32,30,62,0.000333,0.095973,12,3455.029005,191.946056,287.919084,91.125266,2,0
0,0,19,19,20,21,41,75,56,131,0.000333,0.233946,20,14036.78625,779.821458,701.839313,178.677228,6,0
0,0,4,4,11,11,22,24,17,41,0.000333,0.060946,5,914.183482,50.787971,182.836696,76.107496,2,0
0,0,4,4,11,11,22,24,17,41,0.000333,0.060946,5,914.183482,50.787971,182.836696,76.107496,2,0
0,0,3,3,7,5,12,10,7,17,0.000333,0.020315,3,182.833088,10.157394,60.944363,31.261125,1,0
0,0,5,5,11,11,22,28,20,48,0.000333,0.071351,5,1070.263588,59.459088,214.052718,76.107496,2,0
0,0,5,5,11,11,22,28,20,48,0.000333,0.071351,5,1070.263588,59.459088,214.052718,76.107496,2,0
0,0,7,7,9,10,19,23,20,43,0.000333,0.060887,8,1461.287065,81.182615,182.660883,61.748606,2,0
0,0,14,14,17,18,35,66,46,112,0.000333,0.191493,16,9191.675166,510.64862,574.479698,144.545518,6,0
0,0,4,4,11,11,22,24,17,41,0.000333,0.060946,5,914.183482,50.787971,182.836696,76.107496,2,0
0,0,4,4,11,11,22,24,17,41,0.000333,0.060946,5,914.183482,50.787971,182.836696,76.107496,2,0
0,0,3,3,7,5,12,10,7,17,0.000333,0.020315,3,182.833088,10.157394,60.944363,31.261125,1,0
0,0,5,5,11,11,22,28,20,48,0.000333,0.071351,5,1070.263588,59.459088,214.052718,76.107496,2,0
0,0,5,5,11,11,22,28,20,48,0.000333,0.071351,5,1070.263588,59.459088,214.052718,76.107496,2,0
0,0,8,8,10,9,19,27,22,49,0.000333,0.069383,10,2081.484482,115.638027,208.148448,61.748606,2,0
0,0,15,15,18,17,35,70,48,118,0.000333,0.201752,18,10894.59713,605.255396,605.255396,144.545518,6,0
0,0,6,6,13,12,25,33,24,57,0.000333,0.088233,12,3176.397634,176.466535,264.699803,91.125266,2,0
0,0,6,6,13,13,26,33,26,59,0.000333,0.092442,12,3327.91132,184.883962,277.325943,96.211433,2,0
0,0,5,5,9,7,16,19,16,35,0.000333,0.046667,8,1120,62.222222,140,48.180809,1,0
0,0,7,7,13,13,26,37,29,66,0.000333,0.10341,12,3722.748257,206.819348,310.229021,96.211433,2,0
0,0,7,7,13,12,25,37,27,64,0.000333,0.099069,12,3566.481554,198.137864,297.206796,91.125266,2,0
0,0,8,8,9,11,20,31,24,55,0.000333,0.079235,8,1901.648362,105.647131,237.706045,66.583073,2,0
0,0,15,15,17,19,36,74,50,124,0.000333,0.21369,16,10257.1312,569.840622,641.0707,150.197491,6,0
0,0,4,4,11,11,22,24,17,41,0.000333,0.060946,5,914.183482,50.787971,182.836696,76.107496,2,0
0,0,4,4,11,11,22,24,17,41,0.000333,0.060946,5,914.183482,50.787971,182.836696,76.107496,2,0
0,0,3,3,7,5,12,10,7,17,0.000333,0.020315,3,182.833088,10.157394,60.944363,31.261125,1,0
0,0,5,5,11,11,22,28,20,48,0.000333,0.071351,5,1070.263588,59.459088,214.052718,76.107496,2,0
0,0,5,5,11,11,22,28,20,48,0.000333,0.071351,5,1070.263588,59.459088,214.052718,76.107496,2,0
0,0,9,9,9,14,23,23,28,51,0.000333,0.076901,8,1845.613278,102.534071,230.70166,81.832294,2,0
0,0,16,16,17,22,39,66,54,120,0.000333,0.211416,16,10147.97226,563.776237,634.248266,167.594364,6,0
0,0,4,4,11,11,22,24,17,41,0.000333,0.060946,5,914.183482,50.787971,182.836696,76.107496,2,0
0,0,4,4,11,11,22,24,17,41,0.000333,0.060946,5,914.183482,50.787971,182.836696,76.107496,2,0
0,0,3,3,7,5,12,10,7,17,0.000333,0.020315,3,182.833088,10.157394,60.944363,31.261125,1,0
0,0,5,5,11,11,22,28,20,48,0.000333,0.071351,5,1070.263588,59.459088,214.052718,76.107496,2,0
0,0,5,5,11,11,22,28,20,48,0.000333,0.071351,5,1070.263588,59.459088,214.052718,76.107496,2,0
0,0,7,7,8,12,20,22,24,46,0.000333,0.06627,8,1590.469539,88.359419,198.808692,67.01955,2,0
0,0,14,14,16,20,36,65,50,115,0.000333,0.19818,16,9512.662003,528.481222,594.541375,150.438562,6,0
0,0,4,4,11,11,22,24,17,41,0.000333,0.060946,5,914.183482,50.787971,182.836696,76.107496,2,0
0,0,4,4,11,11,22,24,17,41,0.000333,0.060946,5,914.183482,50.787971,182.836696,76.107496,2,0
0,0,3,3,7,5,12,10,7,17,0.000333,0.020315,3,182.833088,10.157394,60.944363,31.261125,1,0
0,0,5,5,11,11,22,28,20,48,0.000333,0.071351,5,1070.263588,59.459088,214.052718,76.107496,2,0
0,0,5,5,11,11,22,28,20,48,0.000333,0.071351,5,1070.263588,59.459088,214.052718,76.107496,2,0
0,0,9,9,8,13,21,28,36,64,0.000333,0.093703,8,2248.86652,124.937029,281.108315,72.105716,2,0
0,0,16,16,16,21,37,71,62,133,0.000333,0.230952,16,11085.71676,615.873153,692.857298,156.238666,6,0
0,0,4,4,11,11,22,24,17,41,0.000333,0.060946,5,914.183482,50.787971,182.836696,76.107496,2,0
0,0,4,4,11,11,22,24,17,41,0.000333,0.060946,5,914.183482,50.787971,182.836696,76.107496,2,0
0,0,3,3,7,5,12,10,7,17,0.000333,0.020315,3,182.833088,10.157394,60.944363,31.261125,1,0
0,0,5,5,11,11,22,28,20,48,0.000333,0.071351,5,1070.263588,59.459088,214.052718,76.107496,2,0
0,0,5,5,11,11,22,28,20,48,0.000333,0.071351,5,1070.263588,59.459088,214.052718,76.107496,2,0
0,0,11,11,8,14,22,34,48,82,0.000333,0.121891,12,4388.080713,243.782262,365.673393,77.302969,2,0
0,0,18,18,16,22,38,77,74,151,0.000333,0.264146,24,19018.48931,1056.582739,792.437055,162.107496,6,0
0,0,4,4,11,11,22,24,17,41,0.000333,0.060946,5,914.183482,50.787971,182.836696,76.107496,2,0
0,0,4,4,11,11,22,24,17,41,0.000333,0.060946,5,914.183482,50.787971,182.836696,76.107496,2,0
0,0,3,3,7,5,12,10,7,17,0.000333,0.020315,3,182.833088,10.157394,60.944363,31.261125,1,0
0,0,5,5,11,11,22,28,20,48,0.000333,0.071351,5,1070.263588,59.459088,214.052718,76.107496,2,0
0,0,5,5,11,11,22,28,20,48,0.000333,0.071351,5,1070.263588,59.459088,214.052718,76.107496,2,0
0,0,13,13,8,15,23,40,60,100,0.000333,0.150785,16,7237.69913,402.094396,452.356196,82.603359,2,0
0,0,20,20,16,23,39,83,86,169,0.000333,0.297744,24,21437.5914,1190.9773,893.232975,168.041925,6,0
0,0,4,4,11,11,22,24,17,41,0.000333,0.060946,5,914.183482,50.787971,182.836696,76.107496,2,0
0,0,4,4,11,11,22,24,17,41,0.000333,0.060946,5,914.183482,50.787971,182.836696,76.107496,2,0
0,0,3,3,7,5,12,10,7,17,0.000333,0.020315,3,182.833088,10.157394,60.944363,31.261125,1,0
0,0,5,5,11,11,22,28,20,48,0.000333,0.071351,5,1070.263588,59.459088,214.052718,76.107496,2,0
0,0,5,5,11,11,22,28,20,48,0.000333,0.071351,5,1070.263588,59.459088,214.052718,76.107496,2,0
0,0,8,8,9,11,20,26,26,52,0.000333,0.074913,8,1797.922087,99.88456,224.740261,66.583073,2,0
0,0,15,15,17,19,36,69,52,121,0.000333,0.20852,16,10008.9748,556.054156,625.560925,150.197491,6,0
0,0,6,6,12,15,27,32,30,62,0.000333,0.098268,12,3537.636302,196.53535,294.803025,101.622909,2,0
0,0,3,3,10,13,23,22,18,40,0.000333,0.060314,5,904.712391,50.2618,180.942478,81.324997,2,0
0,0,2,2,5,7,12,8,9,17,0.000333,0.020315,2,121.888725,6.771596,60.944363,31.261125,1,0
0,0,4,4,10,13,23,26,21,47,0.000333,0.070869,5,1063.03706,59.057614,212.607412,81.324997,2,0
0,0,7,7,12,15,27,36,33,69,0.000333,0.109362,12,3937.046852,218.724825,328.087238,101.622909,2,0
0,0,8,8,9,13,22,28,27,55,0.000333,0.081756,8,1962.149912,109.008328,245.268739,76.635041,2,0
0,0,15,15,17,21,38,71,53,124,0.000333,0.216914,16,10411.88819,578.438233,650.743012,161.725534,6,0
0,0,4,4,11,11,22,24,17,41,0.000333,0.060946,5,914.183482,50.787971,182.836696,76.107496,2,0
0,0,4,4,11,11,22,24,17,41,0.000333,0.060946,5,914.183482,50.787971,182.836696,76.107496,2,0
0,0,3,3,7,5,12,10,7,17,0.000333,0.020315,3,182.833088,10.157394,60.944363,31.261125,1,0
0,0,5,5,11,11,22,28,20,48,0.000333,0.071351,5,1070.263588,59.459088,214.052718,76.107496,2,0
0,0,5,5,11,11,22,28,20,48,0.000333,0.071351,5,1070.263588,59.459088,214.052718,76.107496,2,0
0,0,9,9,9,14,23,37,31,68,0.000333,0.102534,8,2460.817704,136.712095,307.602213,81.832294,2,0
0,0,16,16,17,22,39,80,57,137,0.000333,0.241367,16,11585.60166,643.644537,724.100104,167.594364,6,0
0,0,4,4,11,11,22,24,17,41,0.000333,0.060946,5,914.183482,50.787971,182.836696,76.107496,2,0
0,0,4,4,11,11,22,24,17,41,0.000333,0.060946,5,914.183482,50.787971,182.836696,76.107496,2,0
0,0,3,3,7,5,12,10,7,17,0.000333,0.020315,3,182.833088,10.157394,60.944363,31.261125,1,0
0,0,5,5,11,11,22,28,20,48,0.000333,0.071351,5,1070.263588,59.459088,214.052718,76.107496,2,0
0,0,5,5,11,11,22,28,20,48,0.000333,0.071351,5,1070.263588,59.459088,214.052718,76.107496,2,0
0,0,8,8,8,13,21,30,28,58,0.000333,0.084918,8,2038.035284,113.224182,254.754411,72.105716,2,0
0,0,15,15,16,21,37,73,54,127,0.000333,0.220534,16,10585.60924,588.089402,661.600577,156.238666,6,0
0,0,4,4,11,11,22,24,17,41,0.000333,0.060946,5,914.183482,50.787971,182.836696,76.107496,2,0
0,0,4,4,11,11,22,24,17,41,0.000333,0.060946,5,914.183482,50.787971,182.836696,76.107496,2,0
0,0,3,3,7,5,12,10,7,17,0.000333,0.020315,3,182.833088,10.157394,60.944363,31.261125,1,0
0,0,5,5,11,11,22,28,20,48,0.000333,0.071351,5,1070.263588,59.459088,214.052718,76.107496,2,0
0,0,5,5,11,11,22,28,20,48,0.000333,0.071351,5,1070.263588,59.459088,214.052718,76.107496,2,0
0,0,10,10,8,15,23,37,34,71,0.000333,0.107058,8,2569.383191,142.743511,321.172899,82.603359,2,0
0,0,17,17,16,23,39,80,60,140,0.000333,0.246652,16,11839.30097,657.738943,739.956311,168.041925,6,0
0,0,4,4,11,11,22,24,17,41,0.000333,0.060946,5,914.183482,50.787971,182.836696,76.107496,2,0
0,0,4,4,11,11,22,24,17,41,0.000333,0.060946,5,914.183482,50.787971,182.836696,76.107496,2,0
0,0,3,3,7,5,12,10,7,17,0.000333,0.020315,3,182.833088,10.157394,60.944363,31.261125,1,0
0,0,5,5,11,11,22,28,20,48,0.000333,0.071351,5,1070.263588,59.459088,214.052718,76.107496,2,0
0,0,5,5,11,11,22,28,20,48,0.000333,0.071351,5,1070.263588,59.459088,214.052718,76.107496,2,0
0,0,10,10,9,15,24,29,37,66,0.000333,0.100869,8,2420.8602,134.492233,302.607525,87.132684,2,0
0,0,17,17,17,23,40,72,63,135,0.000333,0.239487,16,11495.36469,638.631371,718.460293,173.528793,6,0
0,0,4,4,11,11,22,24,17,41,0.000333,0.060946,5,914.183482,50.787971,182.836696,76.107496,2,0
0,0,4,4,11,11,22,24,17,41,0.000333,0.060946,5,914.183482,50.787971,182.836696,76.107496,2,0
0,0,3,3,7,5,12,10,7,17,0.000333,0.020315,3,182.833088,10.157394,60.944363,31.261125,1,0
0,0,5,5,11,11,22,28,20,48,0.000333,0.071351,5,1070.263588,59.459088,214.052718,76.107496,2,0
0,0,5,5,11,11,22,28,20,48,0.000333,0.071351,5,1070.263588,59.459088,214.052718,76.107496,2,0
0,0,9,9,8,14,22,22,32,54,0.000333,0.08027,8,1926.474459,107.026359,240.809307,77.302969,2,0
0,0,16,16,16,22,38,65,58,123,0.000333,0.215165,16,10327.92135,573.773408,645.495084,162.107496,6,0
0,0,4,4,11,11,22,24,17,41,0.000333,0.060946,5,914.183482,50.787971,182.836696,76.107496,2,0
0,0,4,4,11,11,22,24,17,41,0.000333,0.060946,5,914.183482,50.787971,182.836696,76.107496,2,0
0,0,3,3,7,5,12,10,7,17,0.000333,0.020315,3,182.833088,10.157394,60.944363,31.261125,1,0
0,0,5,5,11,11,22,28,20,48,0.000333,0.071351,5,1070.263588,59.459088,214.052718,76.107496,2,0
0,0,5,5,11,11,22,28,20,48,0.000333,0.071351,5,1070.263588,59.459088,214.052718,76.107496,2,0
0,0,8,8,12,15,27,29,31,60,0.000333,0.095098,12,3423.519002,190.1955,285.29325,101.622909,2,0
0,0,15,15,20,23,43,72,57,129,0.000333,0.233329,20,13999.76307,777.764615,699.988153,190.480487,6,0
0,0,4,4,11,11,22,24,17,41,0.000333,0.060946,5,914.183482,50.787971,182.836696,76.107496,2,0
0,0,4,4,11,11,22,24,17,41,0.000333,0.060946,5,914.183482,50.787971,182.836696,76.107496,2,0
0,0,3,3,7,5,12,10,7,17,0.000333,0.020315,3,182.833088,10.157394,60.944363,31.261125,1,0
0,0,5,5,11,11,22,28,20,48,0.000333,0.071351,5,1070.263588,59.459088,214.052718,76.107496,2,0
0,0,5,5,11,11,22,28,20,48,0.000333,0.071351,5,1070.263588,59.459088,214.052718,76.107496,2,0
0,0,8,8,11,15,26,28,31,59,0.000333,0.092442,10,2773.259434,154.069969,277.325943,96.657107,2,0
0,0,15,15,19,23,42,71,57,128,0.000333,0.230072,18,12423.89934,690.21663,690.21663,184.752548,6,0
0,0,4,4,11,11,22,24,17,41,0.000333,0.060946,5,914.183482,50.787971,182.836696,76.107496,2,0
0,0,4,4,11,11,22,24,17,41,0.000333,0.060946,5,914.183482,50.787971,182.836696,76.107496,2,0
0,0,3,3,7,5,12,10,7,17,0.000333,0.020315,3,182.833088,10.157394,60.944363,31.261125,1,0
0,0,5,5,11,11,22,28,20,48,0.000333,0.071351,5,1070.263588,59.459088,214.052718,76.107496,2,0
0,0,5,5,11,11,22,28,20,48,0.000333,0.071351,5,1070.263588,59.459088,214.052718,76.107496,2,0
0,0,5,5,8,6,14,15,11,26,0.000333,0.032997,4,395.964912,21.998051,98.991228,39.509775,1,0
0,0,12,12,16,14,30,58,37,95,0.000333,0.155385,16,7458.473705,414.35965,466.154607,117.302969,5,0
0,0,4,4,11,11,22,24,17,41,0.000333,0.060946,5,914.183482,50.787971,182.836696,76.107496,2,0
0,0,4,4,11,11,22,24,17,41,0.000333,0.060946,5,914.183482,50.787971,182.836696,76.107496,2,0
0,0,3,3,7,5,12,10,7,17,0.000333,0.020315,3,182.833088,10.157394,60.944363,31.261125,1,0
0,0,5,5,11,11,22,28,20,48,0.000333,0.071351,5,1070.263588,59.459088,214.052718,76.107496,2,0
0,0,5,5,11,11,22,28,20,48,0.000333,0.071351,5,1070.263588,59.459088,214.052718,76.107496,2,0
0,0,15,15,18,14,32,67,39,106,0.000333,0.176667,18,9540,530,530,128.361619,7,0
0,0,14,14,16,14,30,64,39,103,0.000333,0.16847,16,8086.555702,449.253095,505.409731,117.302969,7,0
0,0,8,8,12,8,20,24,13,37,0.000333,0.053304,6,959.468037,53.30378,159.91134,67.01955,3,0
0,0,7,7,9,7,16,21,13,34,0.000333,0.045333,4,544,30.222222,136,48.180809,3,0
0,0,4,4,11,11,22,24,17,41,0.000333,0.060946,5,914.183482,50.787971,182.836696,76.107496,2,0
0,0,4,4,11,11,22,24,17,41,0.000333,0.060946,5,914.183482,50.787971,182.836696,76.107496,2,0
0,0,4,4,11,11,22,24,17,41,0.000333,0.060946,5,914.183482,50.787971,182.836696,76.107496,2,0
0,0,3,3,7,5,12,10,7,17,0.000333,0.020315,3,182.833088,10.157394,60.944363,31.261125,1,0
0,0,3,3,7,5,12,10,7,17,0.000333,0.020315,3,182.833088,10.157394,60.944363,31.261125,1,0
0,0,5,5,11,11,22,28,20,48,0.000333,0.071351,5,1070.263588,59.459088,214.052718,76.107496,2,0
0,0,5,5,11,11,22,28,20,48,0.000333,0.071351,5,1070.263588,59.459088,214.052718,76.107496,2,0
0,0,5,5,11,11,22,28,20,48,0.000333,0.071351,5,1070.263588,59.459088,214.052718,76.107496,2,0
0,0,15,15,18,15,33,68,41,109,0.000333,0.18328,18,9897.101262,549.838959,549.838959,133.662009,7,0
0,0,14,14,16,15,31,64,41,105,0.000333,0.173397,16,8323.049801,462.391656,520.190613,122.603359,7,0
0,0,8,8,13,7,20,25,15,40,0.000333,0.057626,12,2074.525486,115.251416,172.877124,67.757201,3,0
0,0,7,7,9,7,16,21,15,36,0.000333,0.048,8,1152,64,144,48.180809,3,0
0,0,4,4,11,11,22,24,17,41,0.000333,0.060946,5,914.183482,50.787971,182.836696,76.107496,2,0
0,0,4,4,11,11,22,24,17,41,0.000333,0.060946,5,914.183482,50.787971,182.836696,76.107496,2,0
0,0,4,4,11,11,22,24,17,41,0.000333,0.060946,5,914.183482,50.787971,182.836696,76.107496,2,0
0,0,3,3,7,5,12,10,7,17,0.000333,0.020315,3,182.833088,10.157394,60.944363,31.261125,1,0
0,0,3,3,7,5,12,10,7,17,0.000333,0.020315,3,182.833088,10.157394,60.944363,31.261125,1,0
0,0,5,5,11,11,22,28,20,48,0.000333,0.071351,5,1070.263588,59.459088,214.052718,76.107496,2,0
0,0,5,5,11,11,22,28,20,48,0.000333,0.071351,5,1070.263588,59.459088,214.052718,76.107496,2,0
0,0,5,5,11,11,22,28,20,48,0.000333,0.071351,5,1070.263588,59.459088,214.052718,76.107496,2,0
0,0,17,17,20,16,36,75,45,120,0.000333,0.206797,20,12407.82,689.323334,620.391,150.438562,7,0
0,0,16,16,18,16,34,72,45,117,0.000333,0.198411,18,10714.19674,595.233152,595.233152,139.05865,7,0
0,0,10,10,14,11,25,32,19,51,0.000333,0.078946,7,1657.85666,92.103148,236.836666,91.356717,3,0
0,0,9,9,11,11,22,29,19,48,0.000333,0.071351,5,1070.263588,59.459088,214.052718,76.107496,3,0
0,0,4,4,11,11,22,24,17,41,0.000333,0.060946,5,914.183482,50.787971,182.836696,76.107496,2,0
0,0,4,4,11,11,22,24,17,41,0.000333,0.060946,5,914.183482,50.787971,182.836696,76.107496,2,0
0,0,4,4,11,11,22,24,17,41,0.000333,0.060946,5,914.183482,50.787971,182.836696,76.107496,2,0
0,0,3,3,7,5,12,10,7,17,0.000333,0.020315,3,182.833088,10.157394,60.944363,31.261125,1,0
0,0,3,3,7,5,12,10,7,17,0.000333,0.020315,3,182.833088,10.157394,60.944363,31.261125,1,0
0,0,5,5,11,11,22,28,20,48,0.000333,0.071351,5,1070.263588,59.459088,214.052718,76.107496,2,0
0,0,5,5,11,11,22,28,20,48,0.000333,0.071351,5,1070.263588,59.459088,214.052718,76.107496,2,0
0,0,5,5,11,11,22,28,20,48,0.000333,0.071351,5,1070.263588,59.459088,214.052718,76.107496,2,0
0,0,17,17,19,16,35,73,45,118,0.000333,0.201752,18,10894.59713,605.255396,605.255396,144.710623,7,0
0,0,16,16,17,16,33,70,45,115,0.000333,0.193368,16,9281.68518,515.649177,580.105324,133.486868,7,0
0,0,10,10,13,11,24,30,19,49,0.000333,0.074888,6,1347.978975,74.887721,224.663163,86.159464,3,0
0,0,9,9,10,11,21,27,19,46,0.000333,0.067349,5,1010.233007,56.124056,202.046601,71.273029,3,0
0,0,4,4,11,11,22,24,17,41,0.000333,0.060946,5,914.183482,50.787971,182.836696,76.107496,2,0
0,0,4,4,11,11,22,24,17,41,0.000333,0.060946,5,914.183482,50.787971,182.836696,76.107496,2,0
0,0,4,4,11,11,22,24,17,41,0.000333,0.060946,5,914.183482,50.787971,182.836696,76.107496,2,0
0,0,3,3,7,5,12,10,7,17,0.000333,0.020315,3,182.833088,10.157394,60.944363,31.261125,1,0
0,0,3,3,7,5,12,10,7,17,0.000333,0.020315,3,182.833088,10.157394,60.944363,31.261125,1,0
0,0,5,5,11,11,22,28,20,48,0.000333,0.071351,5,1070.263588,59.459088,214.052718,76.107496,2,0
0,0,5,5,11,11,22,28,20,48,0.000333,0.071351,5,1070.263588,59.459088,214.052718,76.107496,2,0
0,0,5,5,11,11,22,28,20,48,0.000333,0.071351,5,1070.263588,59.459088,214.052718,76.107496,2,0
0,0,8,8,11,9,20,25,18,43,0.000333,0.061948,10,1858.429081,103.24606,185.842908,66.583073,3,0
0,0,16,16,20,16,36,72,44,116,0.000333,0.199904,20,11994.226,666.345889,599.7113,150.438562,7,0
0,0,15,15,18,16,34,68,44,112,0.000333,0.189932,18,10256.32509,569.795838,569.795838,139.05865,7,0
0,0,9,9,15,9,24,29,18,47,0.000333,0.071831,14,3016.905325,167.605851,215.493238,87.132684,3,0
0,0,4,4,11,11,22,24,17,41,0.000333,0.060946,5,914.183482,50.787971,182.836696,76.107496,2,0
0,0,4,4,11,11,22,24,17,41,0.000333,0.060946,5,914.183482,50.787971,182.836696,76.107496,2,0
0,0,4,4,11,11,22,24,17,41,0.000333,0.060946,5,914.183482,50.787971,182.836696,76.107496,2,0
0,0,3,3,7,5,12,10,7,17,0.000333,0.020315,3,182.833088,10.157394,60.944363,31.261125,1,0
0,0,3,3,7,5,12,10,7,17,0.000333,0.020315,3,182.833088,10.157394,60.944363,31.261125,1,0
0,0,5,5,11,11,22,28,20,48,0.000333,0.071351,5,1070.263588,59.459088,214.052718,76.107496,2,0
0,0,5,5,11,11,22,28,20,48,0.000333,0.071351,5,1070.263588,59.459088,214.052718,76.107496,2,0
0,0,5,5,11,11,22,28,20,48,0.000333,0.071351,5,1070.263588,59.459088,214.052718,76.107496,2,0
0,0,16,16,19,16,35,71,44,115,0.000333,0.196623,18,10617.61585,589.867547,589.867547,144.710623,7,0
0,0,15,15,17,16,33,67,44,111,0.000333,0.186643,16,8958.843956,497.713553,559.927747,133.486868,7,0
0,0,9,9,14,9,23,28,18,46,0.000333,0.069361,14,2913.1739,161.842994,208.08385,81.832294,3,0
0,0,8,8,10,9,19,24,18,42,0.000333,0.059471,10,1784.129556,99.118309,178.412956,61.748606,3,0
0,0,4,4,11,11,22,24,17,41,0.000333,0.060946,5,914.183482,50.787971,182.836696,76.107496,2,0
0,0,4,4,11,11,22,24,17,41,0.000333,0.060946,5,914.183482,50.787971,182.836696,76.107496,2,0
0,0,4,4,11,11,22,24,17,41,0.000333,0.060946,5,914.183482,50.787971,182.836696,76.107496,2,0
0,0,3,3,7,5,12,10,7,17,0.000333,0.020315,3,182.833088,10.157394,60.944363,31.261125,1,0
0,0,3,3,7,5,12,10,7,17,0.000333,0.020315,3,182.833088,10.157394,60.944363,31.261125,1,0
0,0,5,5,11,11,22,28,20,48,0.000333,0.071351,5,1070.263588,59.459088,214.052718,76.107496,2,0
0,0,5,5,11,11,22,28,20,48,0.000333,0.071351,5,1070.263588,59.459088,214.052718,76.107496,2,0
0,0,5,5,11,11,22,28,20,48,0.000333,0.071351,5,1070.263588,59.459088,214.052718,76.107496,2,0
0,0,19,19,20,16,36,73,45,118,0.000333,0.20335,20,12201.023,677.834611,610.05115,150.438562,7,0
0,0,18,18,18,16,34,70,45,115,0.000333,0.195019,18,10531.04808,585.058227,585.058227,139.05865,7,0
0,0,12,12,14,11,25,30,19,49,0.000333,0.07585,7,1592.842673,88.49126,227.548953,91.356717,3,0
0,0,11,11,11,11,22,27,19,46,0.000333,0.068378,5,1025.669272,56.981626,205.133854,76.107496,3,0
0,0,4,4,11,11,22,24,17,41,0.000333,0.060946,5,914.183482,50.787971,182.836696,76.107496,2,0
0,0,4,4,11,11,22,24,17,41,0.000333,0.060946,5,914.183482,50.787971,182.836696,76.107496,2,0
0,0,4,4,11,11,22,24,17,41,0.000333,0.060946,5,914.183482,50.787971,182.836696,76.107496,2,0
0,0,3,3,7,5,12,10,7,17,0.000333,0.020315,3,182.833088,10.157394,60.944363,31.261125,1,0
0,0,3,3,7,5,12,10,7,17,0.000333,0.020315,3,182.833088,10.157394,60.944363,31.261125,1,0
0,0,5,5,11,11,22,28,20,48,0.000333,0.071351,5,1070.263588,59.459088,214.052718,76.107496,2,0
0,0,5,5,11,11,22,28,20,48,0.000333,0.071351,5,1070.263588,59.459088,214.052718,76.107496,2,0
0,0,5,5,11,11,22,28,20,48,0.000333,0.071351,5,1070.263588,59.459088,214.052718,76.107496,2,0
0,0,17,17,19,16,35,73,45,118,0.000333,0.201752,18,10894.59713,605.255396,605.255396,144.710623,7,0
0,0,16,16,17,16,33,70,45,115,0.000333,0.193368,16,9281.68518,515.649177,580.105324,133.486868,7,0
0,0,10,10,13,11,24,30,19,49,0.000333,0.074888,6,1347.978975,74.887721,224.663163,86.159464,3,0
0,0,9,9,10,11,21,27,19,46,0.000333,0.067349,5,1010.233007,56.124056,202.046601,71.273029,3,0
0,0,4,4,11,11,22,24,17,41,0.000333,0.060946,5,914.183482,50.787971,182.836696,76.107496,2,0
0,0,4,4,11,11,22,24,17,41,0.000333,0.060946,5,914.183482,50.787971,182.836696,76.107496,2,0
0,0,4,4,11,11,22,24,17,41,0.000333,0.060946,5,914.183482,50.787971,182.836696,76.107496,2,0
0,0,3,3,7,5,12,10,7,17,0.000333,0.020315,3,182.833088,10.157394,60.944363,31.261125,1,0
0,0,3,3,7,5,12,10,7,17,0.000333,0.020315,3,182.833088,10.157394,60.944363,31.261125,1,0
0,0,5,5,11,11,22,28,20,48,0.000333,0.071351,5,1070.263588,59.459088,214.052718,76.107496,2,0
0,0,5,5,11,11,22,28,20,48,0.000333,0.071351,5,1070.263588,59.459088,214.052718,76.107496,2,0
0,0,5,5,11,11,22,28,20,48,0.000333,0.071351,5,1070.263588,59.459088,214.052718,76.107496,2,0
0,0,17,17,18,16,34,71,45,116,0.000333,0.196715,18,10622.62241,590.14569,590.14569,139.05865,7,0
0,0,16,16,16,16,32,68,45,113,0.000333,0.188333,16,9040,502.222222,565,128,7,0
0,0,10,10,12,11,23,28,19,47,0.000333,0.070869,6,1275.644472,70.869137,212.607412,81.073298,3,0
0,0,9,9,9,11,20,25,19,44,0.000333,0.063388,4,760.659345,42.258852,190.164836,66.583073,3,0
0,0,4,4,11,11,22,24,17,41,0.000333,0.060946,5,914.183482,50.787971,182.836696,76.107496,2,0
0,0,4,4,11,11,22,24,17,41,0.000333,0.060946,5,914.183482,50.787971,182.836696,76.107496,2,0
0,0,4,4,11,11,22,24,17,41,0.000333,0.060946,5,914.183482,50.787971,182.836696,76.107496,2,0
0,0,3,3,7,5,12,10,7,17,0.000333,0.020315,3,182.833088,10.157394,60.944363,31.261125,1,0
0,0,3,3,7,5,12,10,7,17,0.000333,0.020315,3,182.833088,10.157394,60.944363,31.261125,1,0
0,0,5,5,11,11,22,28,20,48,0.000333,0.071351,5,1070.263588,59.459088,214.052718,76.107496,2,0
0,0,5,5,11,11,22,28,20,48,0.000333,0.071351,5,1070.263588,59.459088,214.052718,76.107496,2,0
0,0,5,5,11,11,22,28,20,48,0.000333,0.071351,5,1070.263588,59.459088,214.052718,76.107496,2,0
0,0,19,19,19,16,35,71,45,116,0.000333,0.198332,18,10709.94294,594.99683,594.99683,144.710623,7,0
0,0,18,18,17,16,33,68,45,113,0.000333,0.190006,16,9120.264568,506.681365,570.016535,133.486868,7,0
0,0,12,12,13,11,24,28,19,47,0.000333,0.071831,6,1292.959425,71.831079,215.493238,86.159464,3,0
0,0,11,11,10,11,21,25,19,44,0.000333,0.064421,5,966.309833,53.68388,193.261967,71.273029,3,0
0,0,4,4,11,11,22,24,17,41,0.000333,0.060946,5,914.183482,50.787971,182.836696,76.107496,2,0
0,0,4,4,11,11,22,24,17,41,0.000333,0.060946,5,914.183482,50.787971,182.836696,76.107496,2,0
0,0,4,4,11,11,22,24,17,41,0.000333,0.060946,5,914.183482,50.787971,182.836696,76.107496,2,0
0,0,3,3,7,5,12,10,7,17,0.000333,0.020315,3,182.833088,10.157394,60.944363,31.261125,1,0
0,0,3,3,7,5,12,10,7,17,0.000333,0.020315,3,182.833088,10.157394,60.944363,31.261125,1,0
0,0,5,5,11,11,22,28,20,48,0.000333,0.071351,5,1070.263588,59.459088,214.052718,76.107496,2,0
0,0,5,5,11,11,22,28,20,48,0.000333,0.071351,5,1070.263588,59.459088,214.052718,76.107496,2,0
0,0,5,5,11,11,22,28,20,48,0.000333,0.071351,5,1070.263588,59.459088,214.052718,76.107496,2,0
0,0,16,16,19,16,35,71,44,115,0.000333,0.196623,18,10617.61585,589.867547,589.867547,144.710623,7,0
0,0,15,15,17,16,33,67,44,111,0.000333,0.186643,16,8958.843956,497.713553,559.927747,133.486868,7,0
0,0,9,9,14,9,23,28,18,46,0.000333,0.069361,14,2913.1739,161.842994,208.08385,81.832294,3,0
0,0,8,8,10,9,19,24,18,42,0.000333,0.059471,10,1784.129556,99.118309,178.412956,61.748606,3,0
0,0,4,4,11,11,22,24,17,41,0.000333,0.060946,5,914.183482,50.787971,182.836696,76.107496,2,0
0,0,4,4,11,11,22,24,17,41,0.000333,0.060946,5,914.183482,50.787971,182.836696,76.107496,2,0
0,0,4,4,11,11,22,24,17,41,0.000333,0.060946,5,914.183482,50.787971,182.836696,76.107496,2,0
0,0,3,3,7,5,12,10,7,17,0.000333,0.020315,3,182.833088,10.157394,60.944363,31.261125,1,0
0,0,3,3,7,5,12,10,7,17,0.000333,0.020315,3,182.833088,10.157394,60.944363,31.261125,1,0
0,0,5,5,11,11,22,28,20,48,0.000333,0.071351,5,1070.263588,59.459088,214.052718,76.107496,2,0
0,0,5,5,11,11,22,28,20,48,0.000333,0.071351,5,1070.263588,59.459088,214.052718,76.107496,2,0
0,0,5,5,11,11,22,28,20,48,0.000333,0.071351,5,1070.263588,59.459088,214.052718,76.107496,2,0
0,0,16,16,18,16,34,70,44,114,0.000333,0.193324,18,10439.47375,579.970764,579.970764,139.05865,7,0
0,0,15,15,16,16,32,66,44,110,0.000333,0.183333,16,8800,488.888889,550,128,7,0
0,0,9,9,13,9,22,27,18,45,0.000333,0.066891,12,2408.093074,133.782949,200.674423,76.635041,3,0
0,0,8,8,9,9,18,23,18,41,0.000333,0.056989,8,1367.7354,75.9853,170.966925,57.05865,3,0
0,0,4,4,11,11,22,24,17,41,0.000333,0.060946,5,914.183482,50.787971,182.836696,76.107496,2,0
0,0,4,4,11,11,22,24,17,41,0.000333,0.060946,5,914.183482,50.787971,182.836696,76.107496,2,0
0,0,4,4,11,11,22,24,17,41,0.000333,0.060946,5,914.183482,50.787971,182.836696,76.107496,2,0
0,0,3,3,7,5,12,10,7,17,0.000333,0.020315,3,182.833088,10.157394,60.944363,31.261125,1,0
0,0,3,3,7,5,12,10,7,17,0.000333,0.020315,3,182.833088,10.157394,60.944363,31.261125,1,0
0,0,5,5,11,11,22,28,20,48,0.000333,0.071351,5,1070.263588,59.459088,214.052718,76.107496,2,0
0,0,5,5,11,11,22,28,20,48,0.000333,0.071351,5,1070.263588,59.459088,214.052718,76.107496,2,0
0,0,5,5,11,11,22,28,20,48,0.000333,0.071351,5,1070.263588,59.459088,214.052718,76.107496,2,0
0,0,22,22,21,17,38,80,41,121,0.000333,0.211666,20,12699.98458,705.554699,634.999229,161.725534,7,0
0,0,22,22,21,16,37,80,41,121,0.000333,0.210115,20,12606.87715,700.382064,630.343857,156.238666,7,0
0,0,15,15,13,9,22,37,15,52,0.000333,0.077297,6,1391.342665,77.296815,231.890444,76.635041,3,0
0,0,15,15,13,8,21,37,15,52,0.000333,0.076134,6,1370.403036,76.133502,228.400506,72.105716,3,0
0,0,4,4,11,11,22,24,17,41,0.000333,0.060946,5,914.183482,50.787971,182.836696,76.107496,2,0
0,0,4,4,11,11,22,24,17,41,0.000333,0.060946,5,914.183482,50.787971,182.836696,76.107496,2,0
0,0,4,4,11,11,22,24,17,41,0.000333,0.060946,5,914.183482,50.787971,182.836696,76.107496,2,0
0,0,3,3,7,5,12,10,7,17,0.000333,0.020315,3,182.833088,10.157394,60.944363,31.261125,1,0
0,0,3,3,7,5,12,10,7,17,0.000333,0.020315,3,182.833088,10.157394,60.944363,31.261125,1,0
0,0,5,5,11,11,22,28,20,48,0.000333,0.071351,5,1070.263588,59.459088,214.052718,76.107496,2,0
0,0,5,5,11,11,22,28,20,48,0.000333,0.071351,5,1070.263588,59.459088,214.052718,76.107496,2,0
0,0,5,5,11,11,22,28,20,48,0.000333,0.071351,5,1070.263588,59.459088,214.052718,76.107496,2,0
0,0,16,16,18,14,32,68,39,107,0.000333,0.178333,18,9630,535,535,128.361619,7,0
0,0,9,9,10,7,17,25,13,38,0.000333,0.051775,5,776.61794,43.145441,155.323588,52.870765,3,0
0,0,7,7,11,12,23,37,25,62,0.000333,0.093487,10,2804.608413,155.811578,280.460841,81.073298,2,0
0,0,7,7,11,12,23,37,25,62,0.000333,0.093487,10,2804.608413,155.811578,280.460841,81.073298,2,0
0,0,3,3,7,5,12,10,7,17,0.000333,0.020315,3,182.833088,10.157394,60.944363,31.261125,1,0
0,0,7,7,11,12,23,37,25,62,0.000333,0.093487,10,2804.608413,155.811578,280.460841,81.073298,2,0
0,0,4,4,9,9,18,26,19,45,0.000333,0.062549,8,1501.173001,83.3985,187.646625,57.05865,2,0
0,0,4,4,9,9,18,26,19,45,0.000333,0.062549,8,1501.173001,83.3985,187.646625,57.05865,2,0
0,0,7,7,11,12,23,37,25,62,0.000333,0.093487,10,2804.608413,155.811578,280.460841,81.073298,2,0
0,0,14,14,19,16,35,74,47,121,0.000333,0.206881,18,11171.57841,620.643245,620.643245,144.710623,7,0
0,0,7,7,11,10,21,31,21,52,0.000333,0.076134,10,2284.00506,126.88917,228.400506,71.273029,3,0
0,0,7,7,11,12,23,37,25,62,0.000333,0.093487,10,2804.608413,155.811578,280.460841,81.073298,2,0
0,0,7,7,11,12,23,37,25,62,0.000333,0.093487,10,2804.608413,155.811578,280.460841,81.073298,2,0
0,0,3,3,7,5,12,10,7,17,0.000333,0.020315,3,182.833088,10.157394,60.944363,31.261125,1,0
0,0,4,4,9,9,18,26,19,45,0.000333,0.062549,8,1501.173001,83.3985,187.646625,57.05865,2,0
0,0,4,4,9,9,18,26,19,45,0.000333,0.062549,8,1501.173001,83.3985,187.646625,57.05865,2,0
0,0,7,7,11,12,23,37,25,62,0.000333,0.093487,10,2804.608413,155.811578,280.460841,81.073298,2,0
0,0,7,7,11,12,23,37,25,62,0.000333,0.093487,10,2804.608413,155.811578,280.460841,81.073298,2,0
0,0,16,16,18,16,34,64,41,105,0.000333,0.178061,18,9615.30477,534.183598,534.183598,139.05865,5,0
0,0,9,9,10,8,18,21,15,36,0.000333,0.050039,5,750.5865,41.69925,150.1173,57.219281,1,0
0,0,4,4,11,11,22,24,17,41,0.000333,0.060946,5,914.183482,50.787971,182.836696,76.107496,2,0
0,0,4,4,11,11,22,24,17,41,0.000333,0.060946,5,914.183482,50.787971,182.836696,76.107496,2,0
0,0,3,3,7,5,12,10,7,17,0.000333,0.020315,3,182.833088,10.157394,60.944363,31.261125,1,0
0,0,5,5,11,11,22,28,20,48,0.000333,0.071351,5,1070.263588,59.459088,214.052718,76.107496,2,0
0,0,5,5,11,11,22,28,20,48,0.000333,0.071351,5,1070.263588,59.459088,214.052718,76.107496,2,0
0,0,17,17,19,19,38,73,54,127,0.000333,0.222162,18,11996.7623,666.486794,666.486794,161.421246,6,0
0,0,16,16,17,19,36,70,54,124,0.000333,0.21369,16,10257.1312,569.840622,641.0707,150.197491,6,0
0,0,9,9,10,11,21,27,24,51,0.000333,0.074669,10,2240.081886,124.448994,224.008189,71.273029,2,0
0,0,4,4,11,11,22,24,17,41,0.000333,0.060946,5,914.183482,50.787971,182.836696,76.107496,2,0
0,0,4,4,11,11,22,24,17,41,0.000333,0.060946,5,914.183482,50.787971,182.836696,76.107496,2,0
0,0,4,4,11,11,22,24,17,41,0.000333,0.060946,5,914.183482,50.787971,182.836696,76.107496,2,0
0,0,3,3,7,5,12,10,7,17,0.000333,0.020315,3,182.833088,10.157394,60.944363,31.261125,1,0
0,0,5,5,11,11,22,28,20,48,0.000333,0.071351,5,1070.263588,59.459088,214.052718,76.107496,2,0
0,0,5,5,11,11,22,28,20,48,0.000333,0.071351,5,1070.263588,59.459088,214.052718,76.107496,2,0
0,0,5,5,11,11,22,28,20,48,0.000333,0.071351,5,1070.263588,59.459088,214.052718,76.107496,2,0
0,0,17,17,18,21,39,72,62,134,0.000333,0.236081,18,12748.39015,708.243897,708.243897,167.297316,6,0
0,0,16,16,16,21,37,69,62,131,0.000333,0.227479,16,10919.01425,606.611903,682.438391,156.238666,6,0
0,0,9,9,9,13,22,26,32,58,0.000333,0.086216,8,2069.176271,114.954237,258.647034,76.635041,2,0
0,0,4,4,11,11,22,24,17,41,0.000333,0.060946,5,914.183482,50.787971,182.836696,76.107496,2,0
0,0,4,4,11,11,22,24,17,41,0.000333,0.060946,5,914.183482,50.787971,182.836696,76.107496,2,0
0,0,4,4,11,11,22,24,17,41,0.000333,0.060946,5,914.183482,50.787971,182.836696,76.107496,2,0
0,0,3,3,7,5,12,10,7,17,0.000333,0.020315,3,182.833088,10.157394,60.944363,31.261125,1,0
0,0,5,5,11,11,22,28,20,48,0.000333,0.071351,5,1070.263588,59.459088,214.052718,76.107496,2,0
0,0,5,5,11,11,22,28,20,48,0.000333,0.071351,5,1070.263588,59.459088,214.052718,76.107496,2,0
0,0,5,5,11,11,22,28,20,48,0.000333,0.071351,5,1070.263588,59.459088,214.052718,76.107496,2,0
0,0,7,7,8,7,15,21,17,38,0.000333,0.049487,8,1187.694741,65.983041,148.461843,43.651484,1,0
0,0,14,14,16,15,31,64,43,107,0.000333,0.1767,16,8481.584083,471.199116,530.099005,122.603359,5,0
0,0,4,4,11,11,22,24,17,41,0.000333,0.060946,5,914.183482,50.787971,182.836696,76.107496,2,0
0,0,4,4,11,11,22,24,17,41,0.000333,0.060946,5,914.183482,50.787971,182.836696,76.107496,2,0
0,0,3,3,7,5,12,10,7,17,0.000333,0.020315,3,182.833088,10.157394,60.944363,31.261125,1,0
0,0,5,5,11,11,22,28,20,48,0.000333,0.071351,5,1070.263588,59.459088,214.052718,76.107496,2,0
0,0,5,5,11,11,22,28,20,48,0.000333,0.071351,5,1070.263588,59.459088,214.052718,76.107496,2,0
0,0,10,10,9,8,17,36,25,61,0.000333,0.083112,12,2992.0228,166.223489,249.335233,52.529325,1,0
0,0,17,17,17,16,33,79,51,130,0.000333,0.21859,24,15738.50965,874.361647,655.771236,133.486868,5,0
0,0,4,4,11,11,22,24,17,41,0.000333,0.060946,5,914.183482,50.787971,182.836696,76.107496,2,0
0,0,4,4,11,11,22,24,17,41,0.000333,0.060946,5,914.183482,50.787971,182.836696,76.107496,2,0
0,0,3,3,7,5,12,10,7,17,0.000333,0.020315,3,182.833088,10.157394,60.944363,31.261125,1,0
0,0,5,5,11,11,22,28,20,48,0.000333,0.071351,5,1070.263588,59.459088,214.052718,76.107496,2,0
0,0,5,5,11,11,22,28,20,48,0.000333,0.071351,5,1070.263588,59.459088,214.052718,76.107496,2,0
0,0,8,8,9,12,21,23,22,45,0.000333,0.065885,4,790.617136,43.923174,197.654284,71.548875,1,0
0,0,15,15,17,20,37,66,48,114,0.000333,0.197959,16,9502.042939,527.891274,593.877684,155.92543,5,0
0,0,4,4,11,11,22,24,17,41,0.000333,0.060946,5,914.183482,50.787971,182.836696,76.107496,2,0
0,0,4,4,11,11,22,24,17,41,0.000333,0.060946,5,914.183482,50.787971,182.836696,76.107496,2,0
0,0,3,3,7,5,12,10,7,17,0.000333,0.020315,3,182.833088,10.157394,60.944363,31.261125,1,0
0,0,5,5,11,11,22,28,20,48,0.000333,0.071351,5,1070.263588,59.459088,214.052718,76.107496,2,0
0,0,5,5,11,11,22,28,20,48,0.000333,0.071351,5,1070.263588,59.459088,214.052718,76.107496,2,0
0,0,7,7,9,9,18,22,19,41,0.000333,0.056989,8,1367.7354,75.9853,170.966925,57.05865,1,0
0,0,14,14,17,17,34,65,45,110,0.000333,0.18654,16,8953.934601,497.440811,559.620913,138.973737,5,0
0,0,4,4,11,11,22,24,17,41,0.000333,0.060946,5,914.183482,50.787971,182.836696,76.107496,2,0
0,0,4,4,11,11,22,24,17,41,0.000333,0.060946,5,914.183482,50.787971,182.836696,76.107496,2,0
0,0,3,3,7,5,12,10,7,17,0.000333,0.020315,3,182.833088,10.157394,60.944363,31.261125,1,0
0,0,5,5,11,11,22,28,20,48,0.000333,0.071351,5,1070.263588,59.459088,214.052718,76.107496,2,0
0,0,5,5,11,11,22,28,20,48,0.000333,0.071351,5,1070.263588,59.459088,214.052718,76.107496,2,0
0,0,8,8,10,8,18,26,21,47,0.000333,0.065329,10,1959.864751,108.881375,195.986475,57.219281,1,0
0,0,15,15,18,16,34,69,47,116,0.000333,0.196715,18,10622.62241,590.14569,590.14569,139.05865,5,0
0,0,6,6,13,12,25,33,24,57,0.000333,0.088233,12,3176.397634,176.466535,264.699803,91.125266,2,0
0,0,6,6,13,13,26,33,26,59,0.000333,0.092442,12,3327.91132,184.883962,277.325943,96.211433,2,0
0,0,5,5,9,7,16,19,16,35,0.000333,0.046667,8,1120,62.222222,140,48.180809,1,0
0,0,7,7,13,13,26,37,29,66,0.000333,0.10341,12,3722.748257,206.819348,310.229021,96.211433,2,0
0,0,7,7,13,12,25,37,27,64,0.000333,0.099069,12,3566.481554,198.137864,297.206796,91.125266,2,0
0,0,8,8,9,10,19,30,23,53,0.000333,0.075047,8,1801.121266,100.062293,225.140158,61.748606,1,0
0,0,14,14,17,18,35,71,47,118,0.000333,0.201752,16,9684.086336,538.004796,605.255396,144.545518,5,0
0,0,4,4,11,11,22,24,17,41,0.000333,0.060946,5,914.183482,50.787971,182.836696,76.107496,2,0
0,0,4,4,11,11,22,24,17,41,0.000333,0.060946,5,914.183482,50.787971,182.836696,76.107496,2,0
0,0,3,3,7,5,12,10,7,17,0.000333,0.020315,3,182.833088,10.157394,60.944363,31.261125,1,0
0,0,5,5,11,11,22,28,20,48,0.000333,0.071351,5,1070.263588,59.459088,214.052718,76.107496,2,0
0,0,5,5,11,11,22,28,20,48,0.000333,0.071351,5,1070.263588,59.459088,214.052718,76.107496,2,0
0,0,9,9,9,13,22,22,27,49,0.000333,0.072837,8,1748.097195,97.116511,218.512149,76.635041,1,0
0,0,15,15,17,21,38,63,51,114,0.000333,0.199421,16,9572.219785,531.789988,598.263737,161.725534,5,0
0,0,4,4,11,11,22,24,17,41,0.000333,0.060946,5,914.183482,50.787971,182.836696,76.107496,2,0
0,0,4,4,11,11,22,24,17,41,0.000333,0.060946,5,914.183482,50.787971,182.836696,76.107496,2,0
0,0,3,3,7,5,12,10,7,17,0.000333,0.020315,3,182.833088,10.157394,60.944363,31.261125,1,0
0,0,5,5,11,11,22,28,20,48,0.000333,0.071351,5,1070.263588,59.459088,214.052718,76.107496,2,0
0,0,5,5,11,11,22,28,20,48,0.000333,0.071351,5,1070.263588,59.459088,214.052718,76.107496,2,0
0,0,7,7,8,11,19,21,23,44,0.000333,0.062303,8,1495.270485,83.070582,186.908811,62.053748,1,0
0,0,14,14,16,19,35,64,49,113,0.000333,0.193203,16,9273.743695,515.207983,579.608981,144.710623,5,0
0,0,4,4,11,11,22,24,17,41,0.000333,0.060946,5,914.183482,50.787971,182.836696,76.107496,2,0
0,0,4,4,11,11,22,24,17,41,0.000333,0.060946,5,914.183482,50.787971,182.836696,76.107496,2,0
0,0,3,3,7,5,12,10,7,17,0.000333,0.020315,3,182.833088,10.157394,60.944363,31.261125,1,0
0,0,5,5,11,11,22,28,20,48,0.000333,0.071351,5,1070.263588,59.459088,214.052718,76.107496,2,0
0,0,5,5,11,11,22,28,20,48,0.000333,0.071351,5,1070.263588,59.459088,214.052718,76.107496,2,0
0,0,9,9,8,12,20,27,35,62,0.000333,0.08932,8,2143.676335,119.09313,267.959542,67.01955,1,0
0,0,16,16,16,20,36,70,61,131,0.000333,0.225753,24,16254.24421,903.013567,677.260175,150.438562,5,0
0,0,4,4,11,11,22,24,17,41,0.000333,0.060946,5,914.183482,50.787971,182.836696,76.107496,2,0
0,0,4,4,11,11,22,24,17,41,0.000333,0.060946,5,914.183482,50.787971,182.836696,76.107496,2,0
0,0,3,3,7,5,12,10,7,17,0.000333,0.020315,3,182.833088,10.157394,60.944363,31.261125,1,0
0,0,5,5,11,11,22,28,20,48,0.000333,0.071351,5,1070.263588,59.459088,214.052718,76.107496,2,0
0,0,5,5,11,11,22,28,20,48,0.000333,0.071351,5,1070.263588,59.459088,214.052718,76.107496,2,0
0,0,11,11,8,13,21,33,47,80,0.000333,0.117128,12,4216.624726,234.256929,351.385394,72.105716,1,0
0,0,18,18,16,21,37,76,73,149,0.000333,0.258736,24,18629.00524,1034.944735,776.208551,156.238666,5,0
0,0,4,4,11,11,22,24,17,41,0.000333,0.060946,5,914.183482,50.787971,182.836696,76.107496,2,0
0,0,4,4,11,11,22,24,17,41,0.000333,0.060946,5,914.183482,50.787971,182.836696,76.107496,2,0
0,0,3,3,7,5,12,10,7,17,0.000333,0.020315,3,182.833088,10.157394,60.944363,31.261125,1,0
0,0,5,5,11,11,22,28,20,48,0.000333,0.071351,5,1070.263588,59.459088,214.052718,76.107496,2,0
0,0,5,5,11,11,22,28,20,48,0.000333,0.071351,5,1070.263588,59.459088,214.052718,76.107496,2,0
0,0,13,13,8,15,23,39,59,98,0.000333,0.14777,12,5319.70886,295.539381,443.309072,82.603359,1,0
0,0,20,20,16,22,38,82,85,167,0.000333,0.292135,24,21033.69347,1168.538526,876.403895,162.107496,5,0
0,0,4,4,11,11,22,24,17,41,0.000333,0.060946,5,914.183482,50.787971,182.836696,76.107496,2,0
0,0,4,4,11,11,22,24,17,41,0.000333,0.060946,5,914.183482,50.787971,182.836696,76.107496,2,0
0,0,3,3,7,5,12,10,7,17,0.000333,0.020315,3,182.833088,10.157394,60.944363,31.261125,1,0
0,0,5,5,11,11,22,28,20,48,0.000333,0.071351,5,1070.263588,59.459088,214.052718,76.107496,2,0
0,0,5,5,11,11,22,28,20,48,0.000333,0.071351,5,1070.263588,59.459088,214.052718,76.107496,2,0
0,0,8,8,9,10,19,25,25,50,0.000333,0.070799,8,1699.171005,94.398389,212.396376,61.748606,1,0
0,0,15,15,17,18,35,68,51,119,0.000333,0.203462,16,9766.154864,542.564159,610.384679,144.545518,5,0
0,0,6,6,12,15,27,32,30,62,0.000333,0.098268,12,3537.636302,196.53535,294.803025,101.622909,2,0
0,0,3,3,10,13,23,22,18,40,0.000333,0.060314,5,904.712391,50.2618,180.942478,81.324997,2,0
0,0,2,2,5,7,12,8,9,17,0.000333,0.020315,2,121.888725,6.771596,60.944363,31.261125,1,0
0,0,4,4,10,13,23,26,21,47,0.000333,0.070869,5,1063.03706,59.057614,212.607412,81.324997,2,0
0,0,7,7,12,15,27,36,33,69,0.000333,0.109362,12,3937.046852,218.724825,328.087238,101.622909,2,0
0,0,8,8,9,12,21,27,26,53,0.000333,0.077598,8,1862.342587,103.463477,232.792823,71.548875,1,0
0,0,14,14,17,20,37,68,50,118,0.000333,0.204905,16,9835.447954,546.413775,614.715497,155.92543,5,0
0,0,4,4,11,11,22,24,17,41,0.000333,0.060946,5,914.183482,50.787971,182.836696,76.107496,2,0
0,0,4,4,11,11,22,24,17,41,0.000333,0.060946,5,914.183482,50.787971,182.836696,76.107496,2,0
0,0,3,3,7,5,12,10,7,17,0.000333,0.020315,3,182.833088,10.157394,60.944363,31.261125,1,0
0,0,5,5,11,11,22,28,20,48,0.000333,0.071351,5,1070.263588,59.459088,214.052718,76.107496,2,0
0,0,5,5,11,11,22,28,20,48,0.000333,0.071351,5,1070.263588,59.459088,214.052718,76.107496,2,0
0,0,9,9,9,13,22,36,30,66,0.000333,0.098107,8,2354.579895,130.809994,294.322487,76.635041,1,0
0,0,16,16,17,21,38,79,56,135,0.000333,0.236157,16,11335.52343,629.751302,708.470214,161.725534,5,0
0,0,4,4,11,11,22,24,17,41,0.000333,0.060946,5,914.183482,50.787971,182.836696,76.107496,2,0
0,0,4,4,11,11,22,24,17,41,0.000333,0.060946,5,914.183482,50.787971,182.836696,76.107496,2,0
0,0,3,3,7,5,12,10,7,17,0.000333,0.020315,3,182.833088,10.157394,60.944363,31.261125,1,0
0,0,5,5,11,11,22,28,20,48,0.000333,0.071351,5,1070.263588,59.459088,214.052718,76.107496,2,0
0,0,5,5,11,11,22,28,20,48,0.000333,0.071351,5,1070.263588,59.459088,214.052718,76.107496,2,0
0,0,8,8,8,12,20,29,27,56,0.000333,0.080676,8,1936.223787,107.567988,242.027973,67.01955,1,0
0,0,15,15,16,20,36,72,53,125,0.000333,0.215414,16,10339.85,574.436111,646.240625,150.438562,5,0
0,0,4,4,11,11,22,24,17,41,0.000333,0.060946,5,914.183482,50.787971,182.836696,76.107496,2,0
0,0,4,4,11,11,22,24,17,41,0.000333,0.060946,5,914.183482,50.787971,182.836696,76.107496,2,0
0,0,3,3,7,5,12,10,7,17,0.000333,0.020315,3,182.833088,10.157394,60.944363,31.261125,1,0
0,0,5,5,11,11,22,28,20,48,0.000333,0.071351,5,1070.263588,59.459088,214.052718,76.107496,2,0
0,0,5,5,11,11,22,28,20,48,0.000333,0.071351,5,1070.263588,59.459088,214.052718,76.107496,2,0
0,0,10,10,8,14,22,36,33,69,0.000333,0.102567,8,2461.606253,136.755903,307.700782,77.302969,1,0
0,0,17,17,16,22,38,79,59,138,0.000333,0.241405,16,11587.42395,643.745775,724.213997,162.107496,5,0
0,0,4,4,11,11,22,24,17,41,0.000333,0.060946,5,914.183482,50.787971,182.836696,76.107496,2,0
0,0,4,4,11,11,22,24,17,41,0.000333,0.060946,5,914.183482,50.787971,182.836696,76.107496,2,0
0,0,3,3,7,5,12,10,7,17,0.000333,0.020315,3,182.833088,10.157394,60.944363,31.261125,1,0
0,0,5,5,11,11,22,28,20,48,0.000333,0.071351,5,1070.263588,59.459088,214.052718,76.107496,2,0
0,0,5,5,11,11,22,28,20,48,0.000333,0.071351,5,1070.263588,59.459088,214.052718,76.107496,2,0
0,0,10,10,9,14,23,28,36,64,0.000333,0.096503,8,2316.063722,128.670207,289.507965,81.832294,1,0
0,0,17,17,17,22,39,71,62,133,0.000333,0.234319,16,11247.33592,624.851996,702.958495,167.594364,5,0
0,0,4,4,11,11,22,24,17,41,0.000333,0.060946,5,914.183482,50.787971,182.836696,76.107496,2,0
0,0,4,4,11,11,22,24,17,41,0.000333,0.060946,5,914.183482,50.787971,182.836696,76.107496,2,0
0,0,3,3,7,5,12,10,7,17,0.000333,0.020315,3,182.833088,10.157394,60.944363,31.261125,1,0
0,0,5,5,11,11,22,28,20,48,0.000333,0.071351,5,1070.263588,59.459088,214.052718,76.107496,2,0
0,0,5,5,11,11,22,28,20,48,0.000333,0.071351,5,1070.263588,59.459088,214.052718,76.107496,2,0
0,0,9,9,8,13,21,21,31,52,0.000333,0.076134,8,1827.204048,101.511336,228.400506,72.105716,1,0
0,0,16,16,16,21,37,64,57,121,0.000333,0.210115,16,10085.50172,560.305651,630.343857,156.238666,5,0
0,0,4,4,11,11,22,24,17,41,0.000333,0.060946,5,914.183482,50.787971,182.836696,76.107496,2,0
0,0,4,4,11,11,22,24,17,41,0.000333,0.060946,5,914.183482,50.787971,182.836696,76.107496,2,0
0,0,3,3,7,5,12,10,7,17,0.000333,0.020315,3,182.833088,10.157394,60.944363,31.261125,1,0
0,0,5,5,11,11,22,28,20,48,0.000333,0.071351,5,1070.263588,59.459088,214.052718,76.107496,2,0
0,0,5,5,11,11,22,28,20,48,0.000333,0.071351,5,1070.263588,59.459088,214.052718,76.107496,2,0
0,0,8,8,12,14,26,28,30,58,0.000333,0.090875,12,3271.506044,181.750336,272.625504,96.322519,1,0
0,0,14,14,20,22,42,69,54,123,0.000333,0.221085,20,13265.10086,736.950048,663.255043,184.546058,5,0
0,0,4,4,11,11,22,24,17,41,0.000333,0.060946,5,914.183482,50.787971,182.836696,76.107496,2,0
0,0,4,4,11,11,22,24,17,41,0.000333,0.060946,5,914.183482,50.787971,182.836696,76.107496,2,0
0,0,3,3,7,5,12,10,7,17,0.000333,0.020315,3,182.833088,10.157394,60.944363,31.261125,1,0
0,0,5,5,11,11,22,28,20,48,0.000333,0.071351,5,1070.263588,59.459088,214.052718,76.107496,2,0
0,0,5,5,11,11,22,28,20,48,0.000333,0.071351,5,1070.263588,59.459088,214.052718,76.107496,2,0
0,0,7,7,11,14,25,25,28,53,0.000333,0.082041,10,2461.243781,136.735766,246.124378,91.356717,1,0
0,0,14,14,19,22,41,68,54,122,0.000333,0.217874,18,11765.1842,653.621345,653.621345,178.818118,5,0
0,0,4,4,11,11,22,24,17,41,0.000333,0.060946,5,914.183482,50.787971,182.836696,76.107496,2,0
0,0,4,4,11,11,22,24,17,41,0.000333,0.060946,5,914.183482,50.787971,182.836696,76.107496,2,0
0,0,3,3,7,5,12,10,7,17,0.000333,0.020315,3,182.833088,10.157394,60.944363,31.261125,1,0
0,0,5,5,11,11,22,28,20,48,0.000333,0.071351,5,1070.263588,59.459088,214.052718,76.107496,2,0
0,0,5,5,11,11,22,28,20,48,0.000333,0.071351,5,1070.263588,59.459088,214.052718,76.107496,2,0
0,0,11,11,10,14,24,23,26,49,0.000333,0.074888,5,1123.315813,62.406434,224.663163,86.52225,3,0
0,0,18,18,16,21,37,66,52,118,0.000333,0.204905,16,9835.447954,546.413775,614.715497,156.238666,7,0
0,0,3,3,7,5,12,10,7,17,0.000333,0.020315,3,182.833088,10.157394,60.944363,31.261125,1,0
0,0,4,4,11,11,22,24,17,41,0.000333,0.060946,5,914.183482,50.787971,182.836696,76.107496,2,0
0,0,4,4,11,11,22,24,17,41,0.000333,0.060946,5,914.183482,50.787971,182.836696,76.107496,2,0
0,0,5,5,11,11,22,28,20,48,0.000333,0.071351,5,1070.263588,59.459088,214.052718,76.107496,2,0
0,0,5,5,11,11,22,28,20,48,0.000333,0.071351,5,1070.263588,59.459088,214.052718,76.107496,2,0
0,0,20,20,17,21,38,73,52,125,0.000333,0.218664,16,10495.85503,583.103057,655.990939,161.725534,9,0
0,0,19,19,15,21,36,70,52,122,0.000333,0.210244,14,8830.231902,490.568439,630.73085,150.842025,9,0
0,0,13,13,12,15,27,30,26,56,0.000333,0.088758,6,1597.642201,88.7579,266.2737,101.622909,5,0
0,0,13,13,11,14,25,29,28,57,0.000333,0.088233,10,2646.998028,147.055446,264.699803,91.356717,5,0
0,0,3,3,7,5,12,10,7,17,0.000333,0.020315,3,182.833088,10.157394,60.944363,31.261125,1,0
0,0,3,3,7,5,12,10,7,17,0.000333,0.020315,3,182.833088,10.157394,60.944363,31.261125,1,0
0,0,4,4,11,11,22,24,17,41,0.000333,0.060946,5,914.183482,50.787971,182.836696,76.107496,2,0
0,0,4,4,11,11,22,24,17,41,0.000333,0.060946,5,914.183482,50.787971,182.836696,76.107496,2,0
0,0,4,4,11,11,22,24,17,41,0.000333,0.060946,5,914.183482,50.787971,182.836696,76.107496,2,0
0,0,5,5,11,11,22,28,20,48,0.000333,0.071351,5,1070.263588,59.459088,214.052718,76.107496,2,0
0,0,5,5,11,11,22,28,20,48,0.000333,0.071351,5,1070.263588,59.459088,214.052718,76.107496,2,0
0,0,5,5,11,11,22,28,20,48,0.000333,0.071351,5,1070.263588,59.459088,214.052718,76.107496,2,0
0,0,20,20,17,22,39,74,54,128,0.000333,0.22551,16,10824.50374,601.361319,676.531484,167.594364,9,0
0,0,19,19,15,22,37,70,54,124,0.000333,0.215324,14,9043.611043,502.422836,645.972217,156.710855,9,0
0,0,13,13,13,15,28,31,28,59,0.000333,0.094545,6,1701.803642,94.544647,283.63394,106.709075,5,0
0,0,12,12,10,15,25,27,28,55,0.000333,0.085137,5,1277.060452,70.947803,255.41209,91.82264,5,0
0,0,3,3,7,5,12,10,7,17,0.000333,0.020315,3,182.833088,10.157394,60.944363,31.261125,1,0
0,0,3,3,7,5,12,10,7,17,0.000333,0.020315,3,182.833088,10.157394,60.944363,31.261125,1,0
0,0,4,4,11,11,22,24,17,41,0.000333,0.060946,5,914.183482,50.787971,182.836696,76.107496,2,0
0,0,4,4,11,11,22,24,17,41,0.000333,0.060946,5,914.183482,50.787971,182.836696,76.107496,2,0
0,0,4,4,11,11,22,24,17,41,0.000333,0.060946,5,914.183482,50.787971,182.836696,76.107496,2,0
0,0,5,5,11,11,22,28,20,48,0.000333,0.071351,5,1070.263588,59.459088,214.052718,76.107496,2,0
0,0,5,5,11,11,22,28,20,48,0.000333,0.071351,5,1070.263588,59.459088,214.052718,76.107496,2,0
0,0,5,5,11,11,22,28,20,48,0.000333,0.071351,5,1070.263588,59.459088,214.052718,76.107496,2,0
0,0,22,22,19,23,42,81,58,139,0.000333,0.249844,18,13491.57819,749.532122,749.532122,184.752548,9,0
0,0,21,21,17,23,40,78,58,136,0.000333,0.241261,16,11580.51553,643.361974,723.782221,173.528793,9,0
0,0,15,15,14,18,32,38,32,70,0.000333,0.116667,7,2450,136.111111,350,128.361619,5,0
0,0,14,14,12,18,30,35,32,67,0.000333,0.109587,6,1972.570019,109.587223,328.76167,118.0782,5,0
0,0,3,3,7,5,12,10,7,17,0.000333,0.020315,3,182.833088,10.157394,60.944363,31.261125,1,0
0,0,3,3,7,5,12,10,7,17,0.000333,0.020315,3,182.833088,10.157394,60.944363,31.261125,1,0
0,0,4,4,11,11,22,24,17,41,0.000333,0.060946,5,914.183482,50.787971,182.836696,76.107496,2,0
0,0,4,4,11,11,22,24,17,41,0.000333,0.060946,5,914.183482,50.787971,182.836696,76.107496,2,0
0,0,4,4,11,11,22,24,17,41,0.000333,0.060946,5,914.183482,50.787971,182.836696,76.107496,2,0
0,0,5,5,11,11,22,28,20,48,0.000333,0.071351,5,1070.263588,59.459088,214.052718,76.107496,2,0
0,0,5,5,11,11,22,28,20,48,0.000333,0.071351,5,1070.263588,59.459088,214.052718,76.107496,2,0
0,0,5,5,11,11,22,28,20,48,0.000333,0.071351,5,1070.263588,59.459088,214.052718,76.107496,2,0
0,0,22,22,18,23,41,79,58,137,0.000333,0.244662,18,13211.72324,733.984625,733.984625,179.100575,9,0
0,0,21,21,16,23,39,76,58,134,0.000333,0.236081,16,11331.90236,629.550131,708.243897,168.041925,9,0
0,0,15,15,13,18,31,36,32,68,0.000333,0.112295,6,2021.312095,112.295116,336.885349,123.164366,5,0
0,0,14,14,11,18,29,33,32,65,0.000333,0.105256,5,1578.843823,87.713546,315.768765,113.112398,5,0
0,0,3,3,7,5,12,10,7,17,0.000333,0.020315,3,182.833088,10.157394,60.944363,31.261125,1,0
0,0,3,3,7,5,12,10,7,17,0.000333,0.020315,3,182.833088,10.157394,60.944363,31.261125,1,0
0,0,4,4,11,11,22,24,17,41,0.000333,0.060946,5,914.183482,50.787971,182.836696,76.107496,2,0
0,0,4,4,11,11,22,24,17,41,0.000333,0.060946,5,914.183482,50.787971,182.836696,76.107496,2,0
0,0,4,4,11,11,22,24,17,41,0.000333,0.060946,5,914.183482,50.787971,182.836696,76.107496,2,0
0,0,5,5,11,11,22,28,20,48,0.000333,0.071351,5,1070.263588,59.459088,214.052718,76.107496,2,0
0,0,5,5,11,11,22,28,20,48,0.000333,0.071351,5,1070.263588,59.459088,214.052718,76.107496,2,0
0,0,5,5,11,11,22,28,20,48,0.000333,0.071351,5,1070.263588,59.459088,214.052718,76.107496,2,0
0,0,21,21,19,23,42,78,57,135,0.000333,0.242654,18,13103.33134,727.962852,727.962852,184.752548,9,0
0,0,20,20,17,23,40,74,57,131,0.000333,0.232391,16,11154.76129,619.70896,697.17258,173.528793,9,0
0,0,14,14,15,17,32,35,31,66,0.000333,0.11,7,2310,128.333333,330,128.090227,5,0
0,0,13,13,12,17,29,31,31,62,0.000333,0.100398,6,1807.16893,100.398274,301.194822,112.506418,5,0
0,0,3,3,7,5,12,10,7,17,0.000333,0.020315,3,182.833088,10.157394,60.944363,31.261125,1,0
0,0,3,3,7,5,12,10,7,17,0.000333,0.020315,3,182.833088,10.157394,60.944363,31.261125,1,0
0,0,4,4,11,11,22,24,17,41,0.000333,0.060946,5,914.183482,50.787971,182.836696,76.107496,2,0
0,0,4,4,11,11,22,24,17,41,0.000333,0.060946,5,914.183482,50.787971,182.836696,76.107496,2,0
0,0,4,4,11,11,22,24,17,41,0.000333,0.060946,5,914.183482,50.787971,182.836696,76.107496,2,0
0,0,5,5,11,11,22,28,20,48,0.000333,0.071351,5,1070.263588,59.459088,214.052718,76.107496,2,0
0,0,5,5,11,11,22,28,20,48,0.000333,0.071351,5,1070.263588,59.459088,214.052718,76.107496,2,0
0,0,5,5,11,11,22,28,20,48,0.000333,0.071351,5,1070.263588,59.459088,214.052718,76.107496,2,0
0,0,21,21,18,23,41,77,57,134,0.000333,0.239304,18,12922.41544,717.911969,717.911969,179.100575,9,0
0,0,20,20,16,23,39,73,57,130,0.000333,0.229034,16,10993.63662,610.75759,687.102288,168.041925,9,0
0,0,14,14,14,17,31,34,31,65,0.000333,0.107341,7,2254.159321,125.231073,322.02276,122.789837,5,0
0,0,13,13,11,17,28,30,31,61,0.000333,0.09775,5,1466.243251,81.457958,293.24865,107.540616,5,0
0,0,3,3,7,5,12,10,7,17,0.000333,0.020315,3,182.833088,10.157394,60.944363,31.261125,1,0
0,0,3,3,7,5,12,10,7,17,0.000333,0.020315,3,182.833088,10.157394,60.944363,31.261125,1,0
0,0,4,4,11,11,22,24,17,41,0.000333,0.060946,5,914.183482,50.787971,182.836696,76.107496,2,0
0,0,4,4,11,11,22,24,17,41,0.000333,0.060946,5,914.183482,50.787971,182.836696,76.107496,2,0
0,0,4,4,11,11,22,24,17,41,0.000333,0.060946,5,914.183482,50.787971,182.836696,76.107496,2,0
0,0,5,5,11,11,22,28,20,48,0.000333,0.071351,5,1070.263588,59.459088,214.052718,76.107496,2,0
0,0,5,5,11,11,22,28,20,48,0.000333,0.071351,5,1070.263588,59.459088,214.052718,76.107496,2,0
0,0,5,5,11,11,22,28,20,48,0.000333,0.071351,5,1070.263588,59.459088,214.052718,76.107496,2,0
0,0,24,24,19,23,42,79,58,137,0.000333,0.246249,18,13297.45477,738.747487,738.747487,184.752548,9,0
0,0,23,23,17,23,40,76,58,134,0.000333,0.237713,16,11410.21384,633.900769,713.138365,173.528793,9,0
0,0,17,17,14,18,32,36,32,68,0.000333,0.113333,7,2380,132.222222,340,128.361619,5,0
0,0,16,16,12,18,30,33,32,65,0.000333,0.106316,6,1913.687332,106.315963,318.947889,118.0782,5,0
0,0,3,3,7,5,12,10,7,17,0.000333,0.020315,3,182.833088,10.157394,60.944363,31.261125,1,0
0,0,3,3,7,5,12,10,7,17,0.000333,0.020315,3,182.833088,10.157394,60.944363,31.261125,1,0
0,0,4,4,11,11,22,24,17,41,0.000333,0.060946,5,914.183482,50.787971,182.836696,76.107496,2,0
0,0,4,4,11,11,22,24,17,41,0.000333,0.060946,5,914.183482,50.787971,182.836696,76.107496,2,0
0,0,4,4,11,11,22,24,17,41,0.000333,0.060946,5,914.183482,50.787971,182.836696,76.107496,2,0
0,0,5,5,11,11,22,28,20,48,0.000333,0.071351,5,1070.263588,59.459088,214.052718,76.107496,2,0
0,0,5,5,11,11,22,28,20,48,0.000333,0.071351,5,1070.263588,59.459088,214.052718,76.107496,2,0
0,0,5,5,11,11,22,28,20,48,0.000333,0.071351,5,1070.263588,59.459088,214.052718,76.107496,2,0
0,0,22,22,18,23,41,79,58,137,0.000333,0.244662,18,13211.72324,733.984625,733.984625,179.100575,9,0
0,0,21,21,16,23,39,76,58,134,0.000333,0.236081,16,11331.90236,629.550131,708.243897,168.041925,9,0
0,0,15,15,13,18,31,36,32,68,0.000333,0.112295,6,2021.312095,112.295116,336.885349,123.164366,5,0
0,0,14,14,11,18,29,33,32,65,0.000333,0.105256,5,1578.843823,87.713546,315.768765,113.112398,5,0
0,0,3,3,7,5,12,10,7,17,0.000333,0.020315,3,182.833088,10.157394,60.944363,31.261125,1,0
0,0,3,3,7,5,12,10,7,17,0.000333,0.020315,3,182.833088,10.157394,60.944363,31.261125,1,0
0,0,4,4,11,11,22,24,17,41,0.000333,0.060946,5,914.183482,50.787971,182.836696,76.107496,2,0
0,0,4,4,11,11,22,24,17,41,0.000333,0.060946,5,914.183482,50.787971,182.836696,76.107496,2,0
0,0,4,4,11,11,22,24,17,41,0.000333,0.060946,5,914.183482,50.787971,182.836696,76.107496,2,0
0,0,5,5,11,11,22,28,20,48,0.000333,0.071351,5,1070.263588,59.459088,214.052718,76.107496,2,0
0,0,5,5,11,11,22,28,20,48,0.000333,0.071351,5,1070.263588,59.459088,214.052718,76.107496,2,0
0,0,5,5,11,11,22,28,20,48,0.000333,0.071351,5,1070.263588,59.459088,214.052718,76.107496,2,0
0,0,22,22,17,23,40,77,58,135,0.000333,0.239487,16,11495.36469,638.631371,718.460293,173.528793,9,0
0,0,21,21,15,23,38,74,58,132,0.000333,0.230909,14,9698.170045,538.787225,692.726432,162.645284,9,0
0,0,15,15,12,18,30,34,32,66,0.000333,0.107952,6,1943.128676,107.951593,323.854779,118.0782,5,0
0,0,14,14,10,18,28,31,32,63,0.000333,0.100954,5,1514.3168,84.128711,302.86336,108.277931,5,0
0,0,3,3,7,5,12,10,7,17,0.000333,0.020315,3,182.833088,10.157394,60.944363,31.261125,1,0
0,0,3,3,7,5,12,10,7,17,0.000333,0.020315,3,182.833088,10.157394,60.944363,31.261125,1,0
0,0,4,4,11,11,22,24,17,41,0.000333,0.060946,5,914.183482,50.787971,182.836696,76.107496,2,0
0,0,4,4,11,11,22,24,17,41,0.000333,0.060946,5,914.183482,50.787971,182.836696,76.107496,2,0
0,0,4,4,11,11,22,24,17,41,0.000333,0.060946,5,914.183482,50.787971,182.836696,76.107496,2,0
0,0,5,5,11,11,22,28,20,48,0.000333,0.071351,5,1070.263588,59.459088,214.052718,76.107496,2,0
0,0,5,5,11,11,22,28,20,48,0.000333,0.071351,5,1070.263588,59.459088,214.052718,76.107496,2,0
0,0,5,5,11,11,22,28,20,48,0.000333,0.071351,5,1070.263588,59.459088,214.052718,76.107496,2,0
0,0,24,24,18,23,41,77,58,135,0.000333,0.24109,18,13018.85137,723.269521,723.269521,179.100575,9,0
0,0,23,23,16,23,39,74,58,132,0.000333,0.232558,16,11162.76949,620.15386,697.673093,168.041925,9,0
0,0,17,17,13,18,31,34,32,66,0.000333,0.108992,6,1961.861739,108.992319,326.976956,123.164366,5,0
0,0,16,16,11,18,29,31,32,63,0.000333,0.102018,5,1530.264013,85.014667,306.052803,113.112398,5,0
0,0,3,3,7,5,12,10,7,17,0.000333,0.020315,3,182.833088,10.157394,60.944363,31.261125,1,0
0,0,3,3,7,5,12,10,7,17,0.000333,0.020315,3,182.833088,10.157394,60.944363,31.261125,1,0
0,0,4,4,11,11,22,24,17,41,0.000333,0.060946,5,914.183482,50.787971,182.836696,76.107496,2,0
0,0,4,4,11,11,22,24,17,41,0.000333,0.060946,5,914.183482,50.787971,182.836696,76.107496,2,0
0,0,4,4,11,11,22,24,17,41,0.000333,0.060946,5,914.183482,50.787971,182.836696,76.107496,2,0
0,0,5,5,11,11,22,28,20,48,0.000333,0.071351,5,1070.263588,59.459088,214.052718,76.107496,2,0
0,0,5,5,11,11,22,28,20,48,0.000333,0.071351,5,1070.263588,59.459088,214.052718,76.107496,2,0
0,0,5,5,11,11,22,28,20,48,0.000333,0.071351,5,1070.263588,59.459088,214.052718,76.107496,2,0
0,0,3,3,7,5,12,10,7,17,0.000333,0.020315,3,182.833088,10.157394,60.944363,31.261125,1,0
0,0,3,3,7,5,12,10,7,17,0.000333,0.020315,3,182.833088,10.157394,60.944363,31.261125,1,0
0,0,3,3,7,5,12,10,7,17,0.000333,0.020315,3,182.833088,10.157394,60.944363,31.261125,1,0
0,0,4,4,11,11,22,24,17,41,0.000333,0.060946,5,914.183482,50.787971,182.836696,76.107496,2,0
0,0,4,4,11,11,22,24,17,41,0.000333,0.060946,5,914.183482,50.787971,182.836696,76.107496,2,0
0,0,4,4,11,11,22,24,17,41,0.000333,0.060946,5,914.183482,50.787971,182.836696,76.107496,2,0
0,0,5,5,11,11,22,28,20,48,0.000333,0.071351,5,1070.263588,59.459088,214.052718,76.107496,2,0
0,0,5,5,11,11,22,28,20,48,0.000333,0.071351,5,1070.263588,59.459088,214.052718,76.107496,2,0
0,0,5,5,11,11,22,28,20,48,0.000333,0.071351,5,1070.263588,59.459088,214.052718,76.107496,2,0
0,0,21,21,18,23,41,77,57,134,0.000333,0.239304,18,12922.41544,717.911969,717.911969,179.100575,9,0
0,0,20,20,16,23,39,73,57,130,0.000333,0.229034,16,10993.63662,610.75759,687.102288,168.041925,9,0
0,0,14,14,14,17,31,34,31,65,0.000333,0.107341,7,2254.159321,125.231073,322.02276,122.789837,5,0
0,0,13,13,11,17,28,30,31,61,0.000333,0.09775,5,1466.243251,81.457958,293.24865,107.540616,5,0
0,0,3,3,7,5,12,10,7,17,0.000333,0.020315,3,182.833088,10.157394,60.944363,31.261125,1,0
0,0,3,3,7,5,12,10,7,17,0.000333,0.020315,3,182.833088,10.157394,60.944363,31.261125,1,0
0,0,4,4,11,11,22,24,17,41,0.000333,0.060946,5,914.183482,50.787971,182.836696,76.107496,2,0
0,0,4,4,11,11,22,24,17,41,0.000333,0.060946,5,914.183482,50.787971,182.836696,76.107496,2,0
0,0,4,4,11,11,22,24,17,41,0.000333,0.060946,5,914.183482,50.787971,182.836696,76.107496,2,0
0,0,5,5,11,11,22,28,20,48,0.000333,0.071351,5,1070.263588,59.459088,214.052718,76.107496,2,0
0,0,5,5,11,11,22,28,20,48,0.000333,0.071351,5,1070.263588,59.459088,214.052718,76.107496,2,0
0,0,5,5,11,11,22,28,20,48,0.000333,0.071351,5,1070.263588,59.459088,214.052718,76.107496,2,0
0,0,21,21,17,23,40,76,57,133,0.000333,0.235939,16,11325.06299,629.170166,707.816437,173.528793,9,0
0,0,20,20,15,23,38,72,57,129,0.000333,0.225661,14,9477.757089,526.542061,676.982649,162.645284,9,0
0,0,14,14,13,17,30,33,31,64,0.000333,0.10468,6,1884.245989,104.680333,314.040998,117.592585,5,0
0,0,13,13,10,17,27,29,31,60,0.000333,0.095098,5,1426.466251,79.248125,285.29325,102.706149,5,0
0,0,3,3,7,5,12,10,7,17,0.000333,0.020315,3,182.833088,10.157394,60.944363,31.261125,1,0
0,0,3,3,7,5,12,10,7,17,0.000333,0.020315,3,182.833088,10.157394,60.944363,31.261125,1,0
0,0,4,4,11,11,22,24,17,41,0.000333,0.060946,5,914.183482,50.787971,182.836696,76.107496,2,0
0,0,4,4,11,11,22,24,17,41,0.000333,0.060946,5,914.183482,50.787971,182.836696,76.107496,2,0
0,0,4,4,11,11,22,24,17,41,0.000333,0.060946,5,914.183482,50.787971,182.836696,76.107496,2,0
0,0,5,5,11,11,22,28,20,48,0.000333,0.071351,5,1070.263588,59.459088,214.052718,76.107496,2,0
0,0,5,5,11,11,22,28,20,48,0.000333,0.071351,5,1070.263588,59.459088,214.052718,76.107496,2,0
0,0,5,5,11,11,22,28,20,48,0.000333,0.071351,5,1070.263588,59.459088,214.052718,76.107496,2,0
0,0,27,27,20,24,44,86,54,140,0.000333,0.254773,20,15286.40853,849.244918,764.320427,196.477662,9,0
0,0,27,27,20,23,43,86,54,140,0.000333,0.253226,20,15193.54131,844.085629,759.677066,190.480487,9,0
0,0,20,20,14,17,31,43,28,71,0.000333,0.117249,7,2462.235566,136.790865,351.747938,122.789837,5,0
0,0,20,20,14,16,30,43,28,71,0.000333,0.11613,7,2438.724626,135.484701,348.389232,117.302969,5,0
0,0,3,3,7,5,12,10,7,17,0.000333,0.020315,3,182.833088,10.157394,60.944363,31.261125,1,0
0,0,3,3,7,5,12,10,7,17,0.000333,0.020315,3,182.833088,10.157394,60.944363,31.261125,1,0
0,0,4,4,11,11,22,24,17,41,0.000333,0.060946,5,914.183482,50.787971,182.836696,76.107496,2,0
0,0,4,4,11,11,22,24,17,41,0.000333,0.060946,5,914.183482,50.787971,182.836696,76.107496,2,0
0,0,4,4,11,11,22,24,17,41,0.000333,0.060946,5,914.183482,50.787971,182.836696,76.107496,2,0
0,0,5,5,11,11,22,28,20,48,0.000333,0.071351,5,1070.263588,59.459088,214.052718,76.107496,2,0
0,0,5,5,11,11,22,28,20,48,0.000333,0.071351,5,1070.263588,59.459088,214.052718,76.107496,2,0
0,0,5,5,11,11,22,28,20,48,0.000333,0.071351,5,1070.263588,59.459088,214.052718,76.107496,2,0
0,0,21,21,17,21,38,74,52,126,0.000333,0.220413,16,10579.82187,587.767882,661.238867,161.725534,9,0
0,0,14,14,11,14,25,31,26,57,0.000333,0.088233,5,1323.499014,73.527723,264.699803,91.356717,5,0
0,0,3,3,7,5,12,10,7,17,0.000333,0.020315,3,182.833088,10.157394,60.944363,31.261125,1,0
0,0,7,7,11,12,23,37,25,62,0.000333,0.093487,10,2804.608413,155.811578,280.460841,81.073298,2,0
0,0,7,7,11,12,23,37,25,62,0.000333,0.093487,10,2804.608413,155.811578,280.460841,81.073298,2,0
0,0,7,7,11,12,23,37,25,62,0.000333,0.093487,10,2804.608413,155.811578,280.460841,81.073298,2,0
0,0,4,4,9,9,18,26,19,45,0.000333,0.062549,8,1501.173001,83.3985,187.646625,57.05865,2,0
0,0,4,4,9,9,18,26,19,45,0.000333,0.062549,8,1501.173001,83.3985,187.646625,57.05865,2,0
0,0,7,7,11,12,23,37,25,62,0.000333,0.093487,10,2804.608413,155.811578,280.460841,81.073298,2,0
0,0,19,19,18,23,41,80,60,140,0.000333,0.250019,18,13501.03105,750.057281,750.057281,179.100575,9,0
0,0,12,12,12,17,29,37,34,71,0.000333,0.114972,12,4138.999808,229.944434,344.916651,112.506418,5,0
0,0,3,3,7,5,12,10,7,17,0.000333,0.020315,3,182.833088,10.157394,60.944363,31.261125,1,0
0,0,7,7,11,12,23,37,25,62,0.000333,0.093487,10,2804.608413,155.811578,280.460841,81.073298,2,0
0,0,7,7,11,12,23,37,25,62,0.000333,0.093487,10,2804.608413,155.811578,280.460841,81.073298,2,0
0,0,4,4,9,9,18,26,19,45,0.000333,0.062549,8,1501.173001,83.3985,187.646625,57.05865,2,0
0,0,4,4,9,9,18,26,19,45,0.000333,0.062549,8,1501.173001,83.3985,187.646625,57.05865,2,0
0,0,7,7,11,12,23,37,25,62,0.000333,0.093487,10,2804.608413,155.811578,280.460841,81.073298,2,0
0,0,7,7,11,12,23,37,25,62,0.000333,0.093487,10,2804.608413,155.811578,280.460841,81.073298,2,0
0,0,21,21,17,23,40,70,54,124,0.000333,0.219973,16,10558.70534,586.594741,659.919084,173.528793,7,0
0,0,14,14,11,16,27,27,28,55,0.000333,0.087173,5,1307.594063,72.644115,261.518813,102.053748,3,0
0,0,3,3,7,5,12,10,7,17,0.000333,0.020315,3,182.833088,10.157394,60.944363,31.261125,1,0
0,0,4,4,11,11,22,24,17,41,0.000333,0.060946,5,914.183482,50.787971,182.836696,76.107496,2,0
0,0,4,4,11,11,22,24,17,41,0.000333,0.060946,5,914.183482,50.787971,182.836696,76.107496,2,0
0,0,5,5,11,11,22,28,20,48,0.000333,0.071351,5,1070.263588,59.459088,214.052718,76.107496,2,0
0,0,5,5,11,11,22,28,20,48,0.000333,0.071351,5,1070.263588,59.459088,214.052718,76.107496,2,0
0,0,22,22,19,26,45,79,67,146,0.000333,0.26727,18,14432.58994,801.810552,801.810552,202.922055,8,0
0,0,21,21,17,26,43,76,67,143,0.000333,0.258652,16,12415.29376,689.738542,775.95586,191.698301,8,0
0,0,14,14,12,18,30,33,37,70,0.000333,0.114494,12,4121.7881,228.988228,343.482342,118.0782,4,0
0,0,3,3,7,5,12,10,7,17,0.000333,0.020315,3,182.833088,10.157394,60.944363,31.261125,1,0
0,0,4,4,11,11,22,24,17,41,0.000333,0.060946,5,914.183482,50.787971,182.836696,76.107496,2,0
0,0,4,4,11,11,22,24,17,41,0.000333,0.060946,5,914.183482,50.787971,182.836696,76.107496,2,0
0,0,4,4,11,11,22,24,17,41,0.000333,0.060946,5,914.183482,50.787971,182.836696,76.107496,2,0
0,0,5,5,11,11,22,28,20,48,0.000333,0.071351,5,1070.263588,59.459088,214.052718,76.107496,2,0
0,0,5,5,11,11,22,28,20,48,0.000333,0.071351,5,1070.263588,59.459088,214.052718,76.107496,2,0
0,0,5,5,11,11,22,28,20,48,0.000333,0.071351,5,1070.263588,59.459088,214.052718,76.107496,2,0
0,0,22,22,18,28,46,78,75,153,0.000333,0.281702,18,15211.88963,845.104979,845.104979,209.664588,8,0
0,0,21,21,16,28,44,75,75,150,0.000333,0.272972,16,13102.63589,727.924216,818.914743,198.605938,8,0
0,0,15,15,11,20,31,34,47,81,0.000333,0.133763,10,4012.899011,222.938834,401.289901,124.49231,4,0
0,0,3,3,7,5,12,10,7,17,0.000333,0.020315,3,182.833088,10.157394,60.944363,31.261125,1,0
0,0,4,4,11,11,22,24,17,41,0.000333,0.060946,5,914.183482,50.787971,182.836696,76.107496,2,0
0,0,4,4,11,11,22,24,17,41,0.000333,0.060946,5,914.183482,50.787971,182.836696,76.107496,2,0
0,0,4,4,11,11,22,24,17,41,0.000333,0.060946,5,914.183482,50.787971,182.836696,76.107496,2,0
0,0,5,5,11,11,22,28,20,48,0.000333,0.071351,5,1070.263588,59.459088,214.052718,76.107496,2,0
0,0,5,5,11,11,22,28,20,48,0.000333,0.071351,5,1070.263588,59.459088,214.052718,76.107496,2,0
0,0,5,5,11,11,22,28,20,48,0.000333,0.071351,5,1070.263588,59.459088,214.052718,76.107496,2,0
0,0,13,13,10,15,25,29,32,61,0.000333,0.094425,10,2832.752276,157.375126,283.275228,91.82264,3,0
0,0,19,19,16,22,38,70,56,126,0.000333,0.220413,16,10579.82187,587.767882,661.238867,162.107496,7,0
0,0,3,3,7,5,12,10,7,17,0.000333,0.020315,3,182.833088,10.157394,60.944363,31.261125,1,0
0,0,4,4,11,11,22,24,17,41,0.000333,0.060946,5,914.183482,50.787971,182.836696,76.107496,2,0
0,0,4,4,11,11,22,24,17,41,0.000333,0.060946,5,914.183482,50.787971,182.836696,76.107496,2,0
0,0,5,5,11,11,22,28,20,48,0.000333,0.071351,5,1070.263588,59.459088,214.052718,76.107496,2,0
0,0,5,5,11,11,22,28,20,48,0.000333,0.071351,5,1070.263588,59.459088,214.052718,76.107496,2,0
0,0,15,15,11,16,27,42,38,80,0.000333,0.126797,10,3803.910002,211.328333,380.391,102.053748,3,0
0,0,22,22,17,23,40,85,64,149,0.000333,0.264322,16,12687.47658,704.85981,792.967286,173.528793,7,0
0,0,3,3,7,5,12,10,7,17,0.000333,0.020315,3,182.833088,10.157394,60.944363,31.261125,1,0
0,0,4,4,11,11,22,24,17,41,0.000333,0.060946,5,914.183482,50.787971,182.836696,76.107496,2,0
0,0,4,4,11,11,22,24,17,41,0.000333,0.060946,5,914.183482,50.787971,182.836696,76.107496,2,0
0,0,5,5,11,11,22,28,20,48,0.000333,0.071351,5,1070.263588,59.459088,214.052718,76.107496,2,0
0,0,5,5,11,11,22,28,20,48,0.000333,0.071351,5,1070.263588,59.459088,214.052718,76.107496,2,0
0,0,14,14,11,20,31,31,37,68,0.000333,0.112295,5,1684.426746,93.579264,336.885349,124.49231,3,0
0,0,21,21,17,27,44,74,63,137,0.000333,0.249314,16,11967.07411,664.83745,747.942132,197.868831,7,0
0,0,3,3,7,5,12,10,7,17,0.000333,0.020315,3,182.833088,10.157394,60.944363,31.261125,1,0
0,0,4,4,11,11,22,24,17,41,0.000333,0.060946,5,914.183482,50.787971,182.836696,76.107496,2,0
0,0,4,4,11,11,22,24,17,41,0.000333,0.060946,5,914.183482,50.787971,182.836696,76.107496,2,0
0,0,5,5,11,11,22,28,20,48,0.000333,0.071351,5,1070.263588,59.459088,214.052718,76.107496,2,0
0,0,5,5,11,11,22,28,20,48,0.000333,0.071351,5,1070.263588,59.459088,214.052718,76.107496,2,0
0,0,13,13,11,17,28,30,34,64,0.000333,0.102557,10,3076.70715,170.928175,307.670715,107.540616,3,0
0,0,19,19,17,24,41,71,58,129,0.000333,0.230375,16,11057.98734,614.33263,691.124209,179.525968,7,0
0,0,3,3,7,5,12,10,7,17,0.000333,0.020315,3,182.833088,10.157394,60.944363,31.261125,1,0
0,0,4,4,11,11,22,24,17,41,0.000333,0.060946,5,914.183482,50.787971,182.836696,76.107496,2,0
0,0,4,4,11,11,22,24,17,41,0.000333,0.060946,5,914.183482,50.787971,182.836696,76.107496,2,0
0,0,5,5,11,11,22,28,20,48,0.000333,0.071351,5,1070.263588,59.459088,214.052718,76.107496,2,0
0,0,5,5,11,11,22,28,20,48,0.000333,0.071351,5,1070.263588,59.459088,214.052718,76.107496,2,0
0,0,14,14,12,16,28,34,36,70,0.000333,0.112172,12,4038.178135,224.34323,336.514845,107.01955,3,0
0,0,21,21,18,23,41,77,62,139,0.000333,0.248233,18,13404.59512,744.699729,744.699729,179.100575,7,0
0,0,5,5,9,7,16,19,16,35,0.000333,0.046667,8,1120,62.222222,140,48.180809,1,0
0,0,6,6,13,13,26,33,26,59,0.000333,0.092442,12,3327.91132,184.883962,277.325943,96.211433,2,0
0,0,6,6,13,12,25,33,24,57,0.000333,0.088233,12,3176.397634,176.466535,264.699803,91.125266,2,0
0,0,7,7,13,13,26,37,29,66,0.000333,0.10341,12,3722.748257,206.819348,310.229021,96.211433,2,0
0,0,7,7,13,12,25,37,27,64,0.000333,0.099069,12,3566.481554,198.137864,297.206796,91.125266,2,0
0,0,14,14,11,18,29,38,38,76,0.000333,0.123069,10,3692.065556,205.114753,369.206556,113.112398,3,0
0,0,21,21,17,25,42,81,64,145,0.000333,0.260629,16,12510.17642,695.009801,781.886026,185.583273,7,0
0,0,3,3,7,5,12,10,7,17,0.000333,0.020315,3,182.833088,10.157394,60.944363,31.261125,1,0
0,0,4,4,11,11,22,24,17,41,0.000333,0.060946,5,914.183482,50.787971,182.836696,76.107496,2,0
0,0,4,4,11,11,22,24,17,41,0.000333,0.060946,5,914.183482,50.787971,182.836696,76.107496,2,0
0,0,5,5,11,11,22,28,20,48,0.000333,0.071351,5,1070.263588,59.459088,214.052718,76.107496,2,0
0,0,5,5,11,11,22,28,20,48,0.000333,0.071351,5,1070.263588,59.459088,214.052718,76.107496,2,0
0,0,15,15,11,21,32,30,42,72,0.000333,0.12,10,3600,200,360,130.292414,3,0
0,0,22,22,17,28,45,73,68,141,0.000333,0.258117,16,12389.62059,688.312255,774.351287,204.092806,7,0
0,0,3,3,7,5,12,10,7,17,0.000333,0.020315,3,182.833088,10.157394,60.944363,31.261125,1,0
0,0,4,4,11,11,22,24,17,41,0.000333,0.060946,5,914.183482,50.787971,182.836696,76.107496,2,0
0,0,4,4,11,11,22,24,17,41,0.000333,0.060946,5,914.183482,50.787971,182.836696,76.107496,2,0
0,0,5,5,11,11,22,28,20,48,0.000333,0.071351,5,1070.263588,59.459088,214.052718,76.107496,2,0
0,0,5,5,11,11,22,28,20,48,0.000333,0.071351,5,1070.263588,59.459088,214.052718,76.107496,2,0
0,0,13,13,10,19,29,29,38,67,0.000333,0.108495,10,3254.847267,180.824848,325.484727,113.929904,3,0
0,0,19,19,16,26,42,70,62,132,0.000333,0.237262,16,11388.5744,632.698578,711.7859,186.211433,7,0
0,0,3,3,7,5,12,10,7,17,0.000333,0.020315,3,182.833088,10.157394,60.944363,31.261125,1,0
0,0,4,4,11,11,22,24,17,41,0.000333,0.060946,5,914.183482,50.787971,182.836696,76.107496,2,0
0,0,4,4,11,11,22,24,17,41,0.000333,0.060946,5,914.183482,50.787971,182.836696,76.107496,2,0
0,0,5,5,11,11,22,28,20,48,0.000333,0.071351,5,1070.263588,59.459088,214.052718,76.107496,2,0
0,0,5,5,11,11,22,28,20,48,0.000333,0.071351,5,1070.263588,59.459088,214.052718,76.107496,2,0
0,0,15,15,10,20,30,35,50,85,0.000333,0.139029,10,4170.857006,231.714278,417.085701,119.657843,3,0
0,0,22,22,16,27,43,78,76,154,0.000333,0.278548,16,13370.31636,742.795353,835.644772,192.381963,7,0
0,0,3,3,7,5,12,10,7,17,0.000333,0.020315,3,182.833088,10.157394,60.944363,31.261125,1,0
0,0,4,4,11,11,22,24,17,41,0.000333,0.060946,5,914.183482,50.787971,182.836696,76.107496,2,0
0,0,4,4,11,11,22,24,17,41,0.000333,0.060946,5,914.183482,50.787971,182.836696,76.107496,2,0
0,0,5,5,11,11,22,28,20,48,0.000333,0.071351,5,1070.263588,59.459088,214.052718,76.107496,2,0
0,0,5,5,11,11,22,28,20,48,0.000333,0.071351,5,1070.263588,59.459088,214.052718,76.107496,2,0
0,0,17,17,10,21,31,41,62,103,0.000333,0.170094,10,5102.8222,283.490122,510.28222,125.457947,3,0
0,0,23,23,16,28,44,82,86,168,0.000333,0.305728,24,22012.42829,1222.912683,917.184512,198.605938,7,0
0,0,3,3,7,5,12,10,7,17,0.000333,0.020315,3,182.833088,10.157394,60.944363,31.261125,1,0
0,0,4,4,11,11,22,24,17,41,0.000333,0.060946,5,914.183482,50.787971,182.836696,76.107496,2,0
0,0,4,4,11,11,22,24,17,41,0.000333,0.060946,5,914.183482,50.787971,182.836696,76.107496,2,0
0,0,5,5,11,11,22,28,20,48,0.000333,0.071351,5,1070.263588,59.459088,214.052718,76.107496,2,0
0,0,5,5,11,11,22,28,20,48,0.000333,0.071351,5,1070.263588,59.459088,214.052718,76.107496,2,0
0,0,19,19,10,22,32,47,74,121,0.000333,0.201667,15,9075,504.166667,605,131.326777,3,0
0,0,26,26,16,29,45,90,100,190,0.000333,0.347817,24,25042.85012,1391.269451,1043.452088,204.881449,7,0
0,0,3,3,7,5,12,10,7,17,0.000333,0.020315,3,182.833088,10.157394,60.944363,31.261125,1,0
0,0,4,4,11,11,22,24,17,41,0.000333,0.060946,5,914.183482,50.787971,182.836696,76.107496,2,0
0,0,4,4,11,11,22,24,17,41,0.000333,0.060946,5,914.183482,50.787971,182.836696,76.107496,2,0
0,0,5,5,11,11,22,28,20,48,0.000333,0.071351,5,1070.263588,59.459088,214.052718,76.107496,2,0
0,0,5,5,11,11,22,28,20,48,0.000333,0.071351,5,1070.263588,59.459088,214.052718,76.107496,2,0
0,0,14,14,11,18,29,33,40,73,0.000333,0.118211,10,3546.326126,197.018118,354.632613,113.112398,3,0
0,0,21,21,17,25,42,76,66,142,0.000333,0.255236,16,12251.34519,680.630288,765.709074,185.583273,7,0
0,0,2,2,5,7,12,8,9,17,0.000333,0.020315,2,121.888725,6.771596,60.944363,31.261125,1,0
0,0,6,6,12,15,27,32,30,62,0.000333,0.098268,12,3537.636302,196.53535,294.803025,101.622909,2,0
0,0,3,3,10,13,23,22,18,40,0.000333,0.060314,5,904.712391,50.2618,180.942478,81.324997,2,0
0,0,4,4,10,13,23,26,21,47,0.000333,0.070869,5,1063.03706,59.057614,212.607412,81.324997,2,0
0,0,7,7,12,15,27,36,33,69,0.000333,0.109362,12,3937.046852,218.724825,328.087238,101.622909,2,0
0,0,14,14,11,20,31,35,41,76,0.000333,0.125506,10,3765.189196,209.177178,376.51892,124.49231,3,0
0,0,21,21,17,27,44,78,67,145,0.000333,0.263873,16,12665.88136,703.660075,791.617585,197.868831,7,0
0,0,3,3,7,5,12,10,7,17,0.000333,0.020315,3,182.833088,10.157394,60.944363,31.261125,1,0
0,0,4,4,11,11,22,24,17,41,0.000333,0.060946,5,914.183482,50.787971,182.836696,76.107496,2,0
0,0,4,4,11,11,22,24,17,41,0.000333,0.060946,5,914.183482,50.787971,182.836696,76.107496,2,0
0,0,5,5,11,11,22,28,20,48,0.000333,0.071351,5,1070.263588,59.459088,214.052718,76.107496,2,0
0,0,5,5,11,11,22,28,20,48,0.000333,0.071351,5,1070.263588,59.459088,214.052718,76.107496,2,0
0,0,15,15,11,21,32,44,45,89,0.000333,0.148333,10,4450,247.222222,445,130.292414,3,0
0,0,21,21,17,28,45,85,69,154,0.000333,0.281915,16,13531.92603,751.773668,845.745377,204.092806,7,0
0,0,3,3,7,5,12,10,7,17,0.000333,0.020315,3,182.833088,10.157394,60.944363,31.261125,1,0
0,0,4,4,11,11,22,24,17,41,0.000333,0.060946,5,914.183482,50.787971,182.836696,76.107496,2,0
0,0,4,4,11,11,22,24,17,41,0.000333,0.060946,5,914.183482,50.787971,182.836696,76.107496,2,0
0,0,5,5,11,11,22,28,20,48,0.000333,0.071351,5,1070.263588,59.459088,214.052718,76.107496,2,0
0,0,5,5,11,11,22,28,20,48,0.000333,0.071351,5,1070.263588,59.459088,214.052718,76.107496,2,0
0,0,14,14,10,20,30,37,42,79,0.000333,0.129215,10,3876.443571,215.357976,387.644357,119.657843,3,0
0,0,21,21,16,27,43,80,68,148,0.000333,0.267696,16,12849.39494,713.855274,803.087184,192.381963,7,0
0,0,3,3,7,5,12,10,7,17,0.000333,0.020315,3,182.833088,10.157394,60.944363,31.261125,1,0
0,0,4,4,11,11,22,24,17,41,0.000333,0.060946,5,914.183482,50.787971,182.836696,76.107496,2,0
0,0,4,4,11,11,22,24,17,41,0.000333,0.060946,5,914.183482,50.787971,182.836696,76.107496,2,0
0,0,5,5,11,11,22,28,20,48,0.000333,0.071351,5,1070.263588,59.459088,214.052718,76.107496,2,0
0,0,5,5,11,11,22,28,20,48,0.000333,0.071351,5,1070.263588,59.459088,214.052718,76.107496,2,0
0,0,16,16,10,22,32,44,48,92,0.000333,0.153333,10,4600,255.555556,460,131.326777,3,0
0,0,23,23,16,29,45,87,74,161,0.000333,0.294729,16,14147.01358,785.945199,884.188349,204.881449,7,0
0,0,3,3,7,5,12,10,7,17,0.000333,0.020315,3,182.833088,10.157394,60.944363,31.261125,1,0
0,0,4,4,11,11,22,24,17,41,0.000333,0.060946,5,914.183482,50.787971,182.836696,76.107496,2,0
0,0,4,4,11,11,22,24,17,41,0.000333,0.060946,5,914.183482,50.787971,182.836696,76.107496,2,0
0,0,5,5,11,11,22,28,20,48,0.000333,0.071351,5,1070.263588,59.459088,214.052718,76.107496,2,0
0,0,5,5,11,11,22,28,20,48,0.000333,0.071351,5,1070.263588,59.459088,214.052718,76.107496,2,0
0,0,16,16,11,22,33,36,51,87,0.000333,0.146287,10,4388.622884,243.812382,438.862288,136.161243,3,0
0,0,23,23,17,29,46,79,77,156,0.000333,0.287225,16,13786.81064,765.933925,861.675665,210.368317,7,0
0,0,3,3,7,5,12,10,7,17,0.000333,0.020315,3,182.833088,10.157394,60.944363,31.261125,1,0
0,0,4,4,11,11,22,24,17,41,0.000333,0.060946,5,914.183482,50.787971,182.836696,76.107496,2,0
0,0,4,4,11,11,22,24,17,41,0.000333,0.060946,5,914.183482,50.787971,182.836696,76.107496,2,0
0,0,5,5,11,11,22,28,20,48,0.000333,0.071351,5,1070.263588,59.459088,214.052718,76.107496,2,0
0,0,5,5,11,11,22,28,20,48,0.000333,0.071351,5,1070.263588,59.459088,214.052718,76.107496,2,0
0,0,15,15,10,21,31,29,46,75,0.000333,0.123855,10,3715.647233,206.424846,371.564723,125.457947,3,0
0,0,22,22,16,28,44,72,72,144,0.000333,0.262053,16,12578.53045,698.807247,786.158153,198.605938,7,0
0,0,3,3,7,5,12,10,7,17,0.000333,0.020315,3,182.833088,10.157394,60.944363,31.261125,1,0
0,0,4,4,11,11,22,24,17,41,0.000333,0.060946,5,914.183482,50.787971,182.836696,76.107496,2,0
0,0,4,4,11,11,22,24,17,41,0.000333,0.060946,5,914.183482,50.787971,182.836696,76.107496,2,0
0,0,5,5,11,11,22,28,20,48,0.000333,0.071351,5,1070.263588,59.459088,214.052718,76.107496,2,0
0,0,5,5,11,11,22,28,20,48,0.000333,0.071351,5,1070.263588,59.459088,214.052718,76.107496,2,0
0,0,14,14,14,22,36,36,45,81,0.000333,0.139588,14,5862.694952,325.705275,418.763925,151.410465,3,0
0,0,21,21,20,29,49,79,71,150,0.000333,0.280735,20,16844.12953,935.784974,842.206477,227.320011,7,0
0,0,4,4,11,11,22,24,17,41,0.000333,0.060946,5,914.183482,50.787971,182.836696,76.107496,2,0
0,0,4,4,11,11,22,24,17,41,0.000333,0.060946,5,914.183482,50.787971,182.836696,76.107496,2,0
0,0,3,3,7,5,12,10,7,17,0.000333,0.020315,3,182.833088,10.157394,60.944363,31.261125,1,0
0,0,5,5,11,11,22,28,20,48,0.000333,0.071351,5,1070.263588,59.459088,214.052718,76.107496,2,0
0,0,5,5,11,11,22,28,20,48,0.000333,0.071351,5,1070.263588,59.459088,214.052718,76.107496,2,0
0,0,14,14,13,22,35,35,45,80,0.000333,0.136781,12,4924.111696,273.561761,410.342641,146.213212,3,0
0,0,21,21,19,29,48,78,71,149,0.000333,0.277386,18,14978.86943,832.159413,832.159413,221.592072,7,0
0,0,4,4,11,11,22,24,17,41,0.000333,0.060946,5,914.183482,50.787971,182.836696,76.107496,2,0
0,0,4,4,11,11,22,24,17,41,0.000333,0.060946,5,914.183482,50.787971,182.836696,76.107496,2,0
0,0,3,3,7,5,12,10,7,17,0.000333,0.020315,3,182.833088,10.157394,60.944363,31.261125,1,0
0,0,5,5,11,11,22,28,20,48,0.000333,0.071351,5,1070.263588,59.459088,214.052718,76.107496,2,0
0,0,5,5,11,11,22,28,20,48,0.000333,0.071351,5,1070.263588,59.459088,214.052718,76.107496,2,0
0,0,10,10,10,14,24,35,29,64,0.000333,0.097813,10,2934.376,163.020889,293.4376,86.52225,2,0
0,0,16,16,18,22,40,75,52,127,0.000333,0.225295,18,12165.92763,675.884868,675.884868,173.166146,6,0
0,0,4,4,11,11,22,24,17,41,0.000333,0.060946,5,914.183482,50.787971,182.836696,76.107496,2,0
0,0,4,4,11,11,22,24,17,41,0.000333,0.060946,5,914.183482,50.787971,182.836696,76.107496,2,0
0,0,3,3,7,5,12,10,7,17,0.000333,0.020315,3,182.833088,10.157394,60.944363,31.261125,1,0
0,0,5,5,11,11,22,28,20,48,0.000333,0.071351,5,1070.263588,59.459088,214.052718,76.107496,2,0
0,0,5,5,11,11,22,28,20,48,0.000333,0.071351,5,1070.263588,59.459088,214.052718,76.107496,2,0
0,0,19,19,20,23,43,84,56,140,0.000333,0.253226,20,15193.54131,844.085629,759.677066,190.480487,8,0
0,0,18,18,18,23,41,81,56,137,0.000333,0.244662,18,13211.72324,733.984625,733.984625,179.100575,8,0
0,0,12,12,14,17,31,42,31,73,0.000333,0.120552,7,2531.594315,140.644129,361.656331,122.789837,4,0
0,0,11,11,11,16,27,39,31,70,0.000333,0.110947,5,1664.210626,92.456146,332.842125,102.053748,4,0
0,0,4,4,11,11,22,24,17,41,0.000333,0.060946,5,914.183482,50.787971,182.836696,76.107496,2,0
0,0,4,4,11,11,22,24,17,41,0.000333,0.060946,5,914.183482,50.787971,182.836696,76.107496,2,0
0,0,4,4,11,11,22,24,17,41,0.000333,0.060946,5,914.183482,50.787971,182.836696,76.107496,2,0
0,0,3,3,7,5,12,10,7,17,0.000333,0.020315,3,182.833088,10.157394,60.944363,31.261125,1,0
0,0,3,3,7,5,12,10,7,17,0.000333,0.020315,3,182.833088,10.157394,60.944363,31.261125,1,0
0,0,5,5,11,11,22,28,20,48,0.000333,0.071351,5,1070.263588,59.459088,214.052718,76.107496,2,0
0,0,5,5,11,11,22,28,20,48,0.000333,0.071351,5,1070.263588,59.459088,214.052718,76.107496,2,0
0,0,5,5,11,11,22,28,20,48,0.000333,0.071351,5,1070.263588,59.459088,214.052718,76.107496,2,0
0,0,19,19,20,24,44,85,58,143,0.000333,0.260233,20,15613.97443,867.443024,780.698721,196.477662,8,0
0,0,18,18,18,24,42,81,58,139,0.000333,0.249844,18,13491.57819,749.532122,749.532122,185.09775,8,0
0,0,12,12,15,16,31,43,33,76,0.000333,0.125506,14,5271.264874,292.848049,376.51892,122.603359,4,0
0,0,11,11,11,16,27,39,33,72,0.000333,0.114117,10,3423.519002,190.1955,342.3519,102.053748,4,0
0,0,4,4,11,11,22,24,17,41,0.000333,0.060946,5,914.183482,50.787971,182.836696,76.107496,2,0
0,0,4,4,11,11,22,24,17,41,0.000333,0.060946,5,914.183482,50.787971,182.836696,76.107496,2,0
0,0,4,4,11,11,22,24,17,41,0.000333,0.060946,5,914.183482,50.787971,182.836696,76.107496,2,0
0,0,3,3,7,5,12,10,7,17,0.000333,0.020315,3,182.833088,10.157394,60.944363,31.261125,1,0
0,0,3,3,7,5,12,10,7,17,0.000333,0.020315,3,182.833088,10.157394,60.944363,31.261125,1,0
0,0,5,5,11,11,22,28,20,48,0.000333,0.071351,5,1070.263588,59.459088,214.052718,76.107496,2,0
0,0,5,5,11,11,22,28,20,48,0.000333,0.071351,5,1070.263588,59.459088,214.052718,76.107496,2,0
0,0,5,5,11,11,22,28,20,48,0.000333,0.071351,5,1070.263588,59.459088,214.052718,76.107496,2,0
0,0,21,21,21,25,46,92,62,154,0.000333,0.283543,20,17012.57083,945.142824,850.628541,208.335071,8,0
0,0,20,20,19,25,44,89,62,151,0.000333,0.274791,18,14838.73514,824.374174,824.374174,196.807027,8,0
0,0,14,14,15,20,35,50,37,87,0.000333,0.148749,7,3123.733357,173.540742,446.247622,145.041921,4,0
0,0,13,13,12,20,32,47,37,84,0.000333,0.14,6,2520,140,420,129.458112,4,0
0,0,4,4,11,11,22,24,17,41,0.000333,0.060946,5,914.183482,50.787971,182.836696,76.107496,2,0
0,0,4,4,11,11,22,24,17,41,0.000333,0.060946,5,914.183482,50.787971,182.836696,76.107496,2,0
0,0,4,4,11,11,22,24,17,41,0.000333,0.060946,5,914.183482,50.787971,182.836696,76.107496,2,0
0,0,3,3,7,5,12,10,7,17,0.000333,0.020315,3,182.833088,10.157394,60.944363,31.261125,1,0
0,0,3,3,7,5,12,10,7,17,0.000333,0.020315,3,182.833088,10.157394,60.944363,31.261125,1,0
0,0,5,5,11,11,22,28,20,48,0.000333,0.071351,5,1070.263588,59.459088,214.052718,76.107496,2,0
0,0,5,5,11,11,22,28,20,48,0.000333,0.071351,5,1070.263588,59.459088,214.052718,76.107496,2,0
0,0,5,5,11,11,22,28,20,48,0.000333,0.071351,5,1070.263588,59.459088,214.052718,76.107496,2,0
0,0,21,21,20,25,45,90,62,152,0.000333,0.278254,20,16695.23341,927.512967,834.761671,202.534967,8,0
0,0,20,20,18,25,43,87,62,149,0.000333,0.269504,18,14553.24207,808.513448,808.513448,191.155055,8,0
0,0,14,14,14,20,34,48,37,85,0.000333,0.144145,7,3027.040391,168.168911,432.434342,139.741531,4,0
0,0,13,13,11,20,31,45,37,82,0.000333,0.135415,5,2031.220487,112.845583,406.244097,124.49231,4,0
0,0,4,4,11,11,22,24,17,41,0.000333,0.060946,5,914.183482,50.787971,182.836696,76.107496,2,0
0,0,4,4,11,11,22,24,17,41,0.000333,0.060946,5,914.183482,50.787971,182.836696,76.107496,2,0
0,0,4,4,11,11,22,24,17,41,0.000333,0.060946,5,914.183482,50.787971,182.836696,76.107496,2,0
0,0,3,3,7,5,12,10,7,17,0.000333,0.020315,3,182.833088,10.157394,60.944363,31.261125,1,0
0,0,3,3,7,5,12,10,7,17,0.000333,0.020315,3,182.833088,10.157394,60.944363,31.261125,1,0
0,0,5,5,11,11,22,28,20,48,0.000333,0.071351,5,1070.263588,59.459088,214.052718,76.107496,2,0
0,0,5,5,11,11,22,28,20,48,0.000333,0.071351,5,1070.263588,59.459088,214.052718,76.107496,2,0
0,0,5,5,11,11,22,28,20,48,0.000333,0.071351,5,1070.263588,59.459088,214.052718,76.107496,2,0
0,0,20,20,21,25,46,89,61,150,0.000333,0.276178,20,16570.68587,920.593659,828.534293,208.335071,8,0
0,0,19,19,19,25,44,85,61,146,0.000333,0.265692,18,14347.38629,797.077016,797.077016,196.807027,8,0
0,0,13,13,16,18,34,47,36,83,0.000333,0.140753,16,6756.150653,375.341703,422.259416,139.05865,4,0
0,0,12,12,12,18,30,43,36,79,0.000333,0.129215,12,4651.732285,258.429571,387.644357,118.0782,4,0
0,0,4,4,11,11,22,24,17,41,0.000333,0.060946,5,914.183482,50.787971,182.836696,76.107496,2,0
0,0,4,4,11,11,22,24,17,41,0.000333,0.060946,5,914.183482,50.787971,182.836696,76.107496,2,0
0,0,4,4,11,11,22,24,17,41,0.000333,0.060946,5,914.183482,50.787971,182.836696,76.107496,2,0
0,0,3,3,7,5,12,10,7,17,0.000333,0.020315,3,182.833088,10.157394,60.944363,31.261125,1,0
0,0,3,3,7,5,12,10,7,17,0.000333,0.020315,3,182.833088,10.157394,60.944363,31.261125,1,0
0,0,5,5,11,11,22,28,20,48,0.000333,0.071351,5,1070.263588,59.459088,214.052718,76.107496,2,0
0,0,5,5,11,11,22,28,20,48,0.000333,0.071351,5,1070.263588,59.459088,214.052718,76.107496,2,0
0,0,5,5,11,11,22,28,20,48,0.000333,0.071351,5,1070.263588,59.459088,214.052718,76.107496,2,0
0,0,20,20,20,25,45,88,61,149,0.000333,0.272762,20,16365.72223,909.20679,818.286111,202.534967,8,0
0,0,19,19,18,25,43,84,61,145,0.000333,0.262269,18,14162.55101,786.808389,786.808389,191.155055,8,0
0,0,13,13,15,18,33,46,36,82,0.000333,0.13788,14,5790.964449,321.720247,413.640318,133.662009,4,0
0,0,12,12,11,18,29,42,36,78,0.000333,0.126308,10,3789.225176,210.51251,378.922518,113.112398,4,0
0,0,4,4,11,11,22,24,17,41,0.000333,0.060946,5,914.183482,50.787971,182.836696,76.107496,2,0
0,0,4,4,11,11,22,24,17,41,0.000333,0.060946,5,914.183482,50.787971,182.836696,76.107496,2,0
0,0,4,4,11,11,22,24,17,41,0.000333,0.060946,5,914.183482,50.787971,182.836696,76.107496,2,0
0,0,3,3,7,5,12,10,7,17,0.000333,0.020315,3,182.833088,10.157394,60.944363,31.261125,1,0
0,0,3,3,7,5,12,10,7,17,0.000333,0.020315,3,182.833088,10.157394,60.944363,31.261125,1,0
0,0,5,5,11,11,22,28,20,48,0.000333,0.071351,5,1070.263588,59.459088,214.052718,76.107496,2,0
0,0,5,5,11,11,22,28,20,48,0.000333,0.071351,5,1070.263588,59.459088,214.052718,76.107496,2,0
0,0,5,5,11,11,22,28,20,48,0.000333,0.071351,5,1070.263588,59.459088,214.052718,76.107496,2,0
0,0,23,23,21,25,46,90,62,152,0.000333,0.27986,20,16791.62835,932.868241,839.581417,208.335071,8,0
0,0,22,22,19,25,44,87,62,149,0.000333,0.271152,18,14642.1956,813.455311,813.455311,196.807027,8,0
0,0,16,16,15,20,35,48,37,85,0.000333,0.14533,7,3051.923395,169.5513,435.989056,145.041921,4,0
0,0,15,15,12,20,32,45,37,82,0.000333,0.136667,6,2460,136.666667,410,129.458112,4,0
0,0,4,4,11,11,22,24,17,41,0.000333,0.060946,5,914.183482,50.787971,182.836696,76.107496,2,0
0,0,4,4,11,11,22,24,17,41,0.000333,0.060946,5,914.183482,50.787971,182.836696,76.107496,2,0
0,0,4,4,11,11,22,24,17,41,0.000333,0.060946,5,914.183482,50.787971,182.836696,76.107496,2,0
0,0,3,3,7,5,12,10,7,17,0.000333,0.020315,3,182.833088,10.157394,60.944363,31.261125,1,0
0,0,3,3,7,5,12,10,7,17,0.000333,0.020315,3,182.833088,10.157394,60.944363,31.261125,1,0
0,0,5,5,11,11,22,28,20,48,0.000333,0.071351,5,1070.263588,59.459088,214.052718,76.107496,2,0
0,0,5,5,11,11,22,28,20,48,0.000333,0.071351,5,1070.263588,59.459088,214.052718,76.107496,2,0
0,0,5,5,11,11,22,28,20,48,0.000333,0.071351,5,1070.263588,59.459088,214.052718,76.107496,2,0
0,0,21,21,21,25,46,90,62,152,0.000333,0.27986,20,16791.62835,932.868241,839.581417,208.335071,8,0
0,0,20,20,19,25,44,87,62,149,0.000333,0.271152,18,14642.1956,813.455311,813.455311,196.807027,8,0
0,0,14,14,15,20,35,48,37,85,0.000333,0.14533,7,3051.923395,169.5513,435.989056,145.041921,4,0
0,0,13,13,12,20,32,45,37,82,0.000333,0.136667,6,2460,136.666667,410,129.458112,4,0
0,0,4,4,11,11,22,24,17,41,0.000333,0.060946,5,914.183482,50.787971,182.836696,76.107496,2,0
0,0,4,4,11,11,22,24,17,41,0.000333,0.060946,5,914.183482,50.787971,182.836696,76.107496,2,0
0,0,4,4,11,11,22,24,17,41,0.000333,0.060946,5,914.183482,50.787971,182.836696,76.107496,2,0
0,0,3,3,7,5,12,10,7,17,0.000333,0.020315,3,182.833088,10.157394,60.944363,31.261125,1,0
0,0,3,3,7,5,12,10,7,17,0.000333,0.020315,3,182.833088,10.157394,60.944363,31.261125,1,0
0,0,5,5,11,11,22,28,20,48,0.000333,0.071351,5,1070.263588,59.459088,214.052718,76.107496,2,0
0,0,5,5,11,11,22,28,20,48,0.000333,0.071351,5,1070.263588,59.459088,214.052718,76.107496,2,0
0,0,5,5,11,11,22,28,20,48,0.000333,0.071351,5,1070.263588,59.459088,214.052718,76.107496,2,0
0,0,21,21,20,25,45,88,62,150,0.000333,0.274593,20,16475.55929,915.308849,823.777964,202.534967,8,0
0,0,20,20,18,25,43,85,62,147,0.000333,0.265887,18,14357.89654,797.660919,797.660919,191.155055,8,0
0,0,14,14,14,20,34,46,37,83,0.000333,0.140753,7,2955.815911,164.211995,422.259416,139.741531,4,0
0,0,13,13,11,20,31,43,37,80,0.000333,0.132112,5,1981.678524,110.093251,396.335705,124.49231,4,0
0,0,4,4,11,11,22,24,17,41,0.000333,0.060946,5,914.183482,50.787971,182.836696,76.107496,2,0
0,0,4,4,11,11,22,24,17,41,0.000333,0.060946,5,914.183482,50.787971,182.836696,76.107496,2,0
0,0,4,4,11,11,22,24,17,41,0.000333,0.060946,5,914.183482,50.787971,182.836696,76.107496,2,0
0,0,3,3,7,5,12,10,7,17,0.000333,0.020315,3,182.833088,10.157394,60.944363,31.261125,1,0
0,0,3,3,7,5,12,10,7,17,0.000333,0.020315,3,182.833088,10.157394,60.944363,31.261125,1,0
0,0,5,5,11,11,22,28,20,48,0.000333,0.071351,5,1070.263588,59.459088,214.052718,76.107496,2,0
0,0,5,5,11,11,22,28,20,48,0.000333,0.071351,5,1070.263588,59.459088,214.052718,76.107496,2,0
0,0,5,5,11,11,22,28,20,48,0.000333,0.071351,5,1070.263588,59.459088,214.052718,76.107496,2,0
0,0,23,23,21,25,46,88,62,150,0.000333,0.276178,20,16570.68587,920.593659,828.534293,208.335071,8,0
0,0,22,22,19,25,44,85,62,147,0.000333,0.267512,18,14445.65606,802.536448,802.536448,196.807027,8,0
0,0,16,16,15,20,35,46,37,83,0.000333,0.14191,7,2980.113433,165.561857,425.73049,145.041921,4,0
0,0,15,15,12,20,32,43,37,80,0.000333,0.133333,6,2400,133.333333,400,129.458112,4,0
0,0,4,4,11,11,22,24,17,41,0.000333,0.060946,5,914.183482,50.787971,182.836696,76.107496,2,0
0,0,4,4,11,11,22,24,17,41,0.000333,0.060946,5,914.183482,50.787971,182.836696,76.107496,2,0
0,0,4,4,11,11,22,24,17,41,0.000333,0.060946,5,914.183482,50.787971,182.836696,76.107496,2,0
0,0,3,3,7,5,12,10,7,17,0.000333,0.020315,3,182.833088,10.157394,60.944363,31.261125,1,0
0,0,3,3,7,5,12,10,7,17,0.000333,0.020315,3,182.833088,10.157394,60.944363,31.261125,1,0
0,0,5,5,11,11,22,28,20,48,0.000333,0.071351,5,1070.263588,59.459088,214.052718,76.107496,2,0
0,0,5,5,11,11,22,28,20,48,0.000333,0.071351,5,1070.263588,59.459088,214.052718,76.107496,2,0
0,0,5,5,11,11,22,28,20,48,0.000333,0.071351,5,1070.263588,59.459088,214.052718,76.107496,2,0
0,0,4,4,11,11,22,24,17,41,0.000333,0.060946,5,914.183482,50.787971,182.836696,76.107496,2,0
0,0,4,4,11,11,22,24,17,41,0.000333,0.060946,5,914.183482,50.787971,182.836696,76.107496,2,0
0,0,4,4,11,11,22,24,17,41,0.000333,0.060946,5,914.183482,50.787971,182.836696,76.107496,2,0
0,0,3,3,7,5,12,10,7,17,0.000333,0.020315,3,182.833088,10.157394,60.944363,31.261125,1,0
0,0,3,3,7,5,12,10,7,17,0.000333,0.020315,3,182.833088,10.157394,60.944363,31.261125,1,0
0,0,3,3,7,5,12,10,7,17,0.000333,0.020315,3,182.833088,10.157394,60.944363,31.261125,1,0
0,0,5,5,11,11,22,28,20,48,0.000333,0.071351,5,1070.263588,59.459088,214.052718,76.107496,2,0
0,0,5,5,11,11,22,28,20,48,0.000333,0.071351,5,1070.263588,59.459088,214.052718,76.107496,2,0
0,0,5,5,11,11,22,28,20,48,0.000333,0.071351,5,1070.263588,59.459088,214.052718,76.107496,2,0
0,0,20,20,21,25,46,88,61,149,0.000333,0.274337,20,16460.21463,914.456368,823.010731,208.335071,8,0
0,0,19,19,19,25,44,84,61,145,0.000333,0.263873,18,14249.11653,791.617585,791.617585,196.807027,8,0
0,0,13,13,16,18,34,46,36,82,0.000333,0.139057,16,6674.751248,370.819514,417.171953,139.05865,4,0
0,0,12,12,12,18,30,42,36,78,0.000333,0.127579,12,4592.849597,255.158311,382.737466,118.0782,4,0
0,0,4,4,11,11,22,24,17,41,0.000333,0.060946,5,914.183482,50.787971,182.836696,76.107496,2,0
0,0,4,4,11,11,22,24,17,41,0.000333,0.060946,5,914.183482,50.787971,182.836696,76.107496,2,0
0,0,4,4,11,11,22,24,17,41,0.000333,0.060946,5,914.183482,50.787971,182.836696,76.107496,2,0
0,0,3,3,7,5,12,10,7,17,0.000333,0.020315,3,182.833088,10.157394,60.944363,31.261125,1,0
0,0,3,3,7,5,12,10,7,17,0.000333,0.020315,3,182.833088,10.157394,60.944363,31.261125,1,0
0,0,5,5,11,11,22,28,20,48,0.000333,0.071351,5,1070.263588,59.459088,214.052718,76.107496,2,0
0,0,5,5,11,11,22,28,20,48,0.000333,0.071351,5,1070.263588,59.459088,214.052718,76.107496,2,0
0,0,5,5,11,11,22,28,20,48,0.000333,0.071351,5,1070.263588,59.459088,214.052718,76.107496,2,0
0,0,20,20,20,25,45,87,61,148,0.000333,0.270931,20,16255.88517,903.104731,812.794258,202.534967,8,0
0,0,19,19,18,25,43,83,61,144,0.000333,0.260461,18,14064.87824,781.382125,781.382125,191.155055,8,0
0,0,13,13,15,18,33,45,36,81,0.000333,0.136199,14,5720.342931,317.79683,408.595924,133.662009,4,0
0,0,12,12,11,18,29,41,36,77,0.000333,0.124688,10,3740.645366,207.813631,374.064537,113.112398,4,0
0,0,4,4,11,11,22,24,17,41,0.000333,0.060946,5,914.183482,50.787971,182.836696,76.107496,2,0
0,0,4,4,11,11,22,24,17,41,0.000333,0.060946,5,914.183482,50.787971,182.836696,76.107496,2,0
0,0,4,4,11,11,22,24,17,41,0.000333,0.060946,5,914.183482,50.787971,182.836696,76.107496,2,0
0,0,3,3,7,5,12,10,7,17,0.000333,0.020315,3,182.833088,10.157394,60.944363,31.261125,1,0
0,0,3,3,7,5,12,10,7,17,0.000333,0.020315,3,182.833088,10.157394,60.944363,31.261125,1,0
0,0,5,5,11,11,22,28,20,48,0.000333,0.071351,5,1070.263588,59.459088,214.052718,76.107496,2,0
0,0,5,5,11,11,22,28,20,48,0.000333,0.071351,5,1070.263588,59.459088,214.052718,76.107496,2,0
0,0,5,5,11,11,22,28,20,48,0.000333,0.071351,5,1070.263588,59.459088,214.052718,76.107496,2,0
0,0,25,25,23,26,49,95,58,153,0.000333,0.28635,22,18899.11334,1049.950741,859.050606,226.253358,8,0
0,0,23,23,23,25,48,91,58,149,0.000333,0.277386,22,18307.50708,1017.083727,832.159413,220.13833,8,0
0,0,16,16,15,18,33,49,33,82,0.000333,0.13788,7,2895.482225,160.860124,413.640318,133.662009,4,0
0,0,16,16,15,17,32,49,33,82,0.000333,0.136667,7,2870,159.444444,410,128.090227,4,0
0,0,4,4,11,11,22,24,17,41,0.000333,0.060946,5,914.183482,50.787971,182.836696,76.107496,2,0
0,0,4,4,11,11,22,24,17,41,0.000333,0.060946,5,914.183482,50.787971,182.836696,76.107496,2,0
0,0,4,4,11,11,22,24,17,41,0.000333,0.060946,5,914.183482,50.787971,182.836696,76.107496,2,0
0,0,3,3,7,5,12,10,7,17,0.000333,0.020315,3,182.833088,10.157394,60.944363,31.261125,1,0
0,0,3,3,7,5,12,10,7,17,0.000333,0.020315,3,182.833088,10.157394,60.944363,31.261125,1,0
0,0,5,5,11,11,22,28,20,48,0.000333,0.071351,5,1070.263588,59.459088,214.052718,76.107496,2,0
0,0,5,5,11,11,22,28,20,48,0.000333,0.071351,5,1070.263588,59.459088,214.052718,76.107496,2,0
0,0,5,5,11,11,22,28,20,48,0.000333,0.071351,5,1070.263588,59.459088,214.052718,76.107496,2,0
0,0,21,21,20,22,42,87,56,143,0.000333,0.257034,20,15422.02783,856.779324,771.101391,184.546058,8,0
0,0,13,13,12,15,27,43,29,72,0.000333,0.114117,6,2054.111401,114.1173,342.3519,101.622909,4,0
0,0,7,7,11,12,23,37,25,62,0.000333,0.093487,10,2804.608413,155.811578,280.460841,81.073298,2,0
0,0,7,7,11,12,23,37,25,62,0.000333,0.093487,10,2804.608413,155.811578,280.460841,81.073298,2,0
0,0,3,3,7,5,12,10,7,17,0.000333,0.020315,3,182.833088,10.157394,60.944363,31.261125,1,0
0,0,4,4,9,9,18,26,19,45,0.000333,0.062549,8,1501.173001,83.3985,187.646625,57.05865,2,0
0,0,4,4,9,9,18,26,19,45,0.000333,0.062549,8,1501.173001,83.3985,187.646625,57.05865,2,0
0,0,7,7,11,12,23,37,25,62,0.000333,0.093487,10,2804.608413,155.811578,280.460841,81.073298,2,0
0,0,7,7,11,12,23,37,25,62,0.000333,0.093487,10,2804.608413,155.811578,280.460841,81.073298,2,0
0,0,19,19,21,24,45,93,64,157,0.000333,0.287407,20,17244.41872,958.023262,862.220936,202.277766,8,0
0,0,12,12,13,18,31,51,39,90,0.000333,0.148626,12,5350.532015,297.251779,445.877668,123.164366,4,0
0,0,7,7,11,12,23,37,25,62,0.000333,0.093487,10,2804.608413,155.811578,280.460841,81.073298,2,0
0,0,7,7,11,12,23,37,25,62,0.000333,0.093487,10,2804.608413,155.811578,280.460841,81.073298,2,0
0,0,3,3,7,5,12,10,7,17,0.000333,0.020315,3,182.833088,10.157394,60.944363,31.261125,1,0
0,0,4,4,9,9,18,26,19,45,0.000333,0.062549,8,1501.173001,83.3985,187.646625,57.05865,2,0
0,0,4,4,9,9,18,26,19,45,0.000333,0.062549,8,1501.173001,83.3985,187.646625,57.05865,2,0
0,0,7,7,11,12,23,37,25,62,0.000333,0.093487,10,2804.608413,155.811578,280.460841,81.073298,2,0
0,0,7,7,11,12,23,37,25,62,0.000333,0.093487,10,2804.608413,155.811578,280.460841,81.073298,2,0
0,0,20,20,20,24,44,81,56,137,0.000333,0.249314,20,14958.84264,831.046813,747.942132,196.477662,6,0
0,0,13,13,12,16,28,39,31,70,0.000333,0.112172,6,2019.089067,112.171615,336.514845,107.01955,2,0
0,0,4,4,11,11,22,24,17,41,0.000333,0.060946,5,914.183482,50.787971,182.836696,76.107496,2,0
0,0,4,4,11,11,22,24,17,41,0.000333,0.060946,5,914.183482,50.787971,182.836696,76.107496,2,0
0,0,3,3,7,5,12,10,7,17,0.000333,0.020315,3,182.833088,10.157394,60.944363,31.261125,1,0
0,0,5,5,11,11,22,28,20,48,0.000333,0.071351,5,1070.263588,59.459088,214.052718,76.107496,2,0
0,0,5,5,11,11,22,28,20,48,0.000333,0.071351,5,1070.263588,59.459088,214.052718,76.107496,2,0
0,0,19,19,20,24,44,83,61,144,0.000333,0.262053,20,15723.16306,873.509059,786.158153,196.477662,7,0
0,0,18,18,18,24,42,80,61,141,0.000333,0.253439,18,13685.70162,760.316757,760.316757,185.09775,7,0
0,0,12,12,11,16,27,40,34,74,0.000333,0.117287,10,3518.616752,195.478708,351.861675,102.053748,3,0
0,0,4,4,11,11,22,24,17,41,0.000333,0.060946,5,914.183482,50.787971,182.836696,76.107496,2,0
0,0,4,4,11,11,22,24,17,41,0.000333,0.060946,5,914.183482,50.787971,182.836696,76.107496,2,0
0,0,4,4,11,11,22,24,17,41,0.000333,0.060946,5,914.183482,50.787971,182.836696,76.107496,2,0
0,0,3,3,7,5,12,10,7,17,0.000333,0.020315,3,182.833088,10.157394,60.944363,31.261125,1,0
0,0,5,5,11,11,22,28,20,48,0.000333,0.071351,5,1070.263588,59.459088,214.052718,76.107496,2,0
0,0,5,5,11,11,22,28,20,48,0.000333,0.071351,5,1070.263588,59.459088,214.052718,76.107496,2,0
0,0,5,5,11,11,22,28,20,48,0.000333,0.071351,5,1070.263588,59.459088,214.052718,76.107496,2,0
0,0,19,19,19,26,45,82,69,151,0.000333,0.276423,18,14926.85672,829.269818,829.269818,202.922055,7,0
0,0,18,18,17,26,43,79,69,148,0.000333,0.267696,16,12849.39494,713.855274,803.087184,191.698301,7,0
0,0,11,11,10,18,28,37,40,77,0.000333,0.123389,10,3701.66329,205.647961,370.166329,108.277931,3,0
0,0,4,4,11,11,22,24,17,41,0.000333,0.060946,5,914.183482,50.787971,182.836696,76.107496,2,0
0,0,4,4,11,11,22,24,17,41,0.000333,0.060946,5,914.183482,50.787971,182.836696,76.107496,2,0
0,0,4,4,11,11,22,24,17,41,0.000333,0.060946,5,914.183482,50.787971,182.836696,76.107496,2,0
0,0,3,3,7,5,12,10,7,17,0.000333,0.020315,3,182.833088,10.157394,60.944363,31.261125,1,0
0,0,5,5,11,11,22,28,20,48,0.000333,0.071351,5,1070.263588,59.459088,214.052718,76.107496,2,0
0,0,5,5,11,11,22,28,20,48,0.000333,0.071351,5,1070.263588,59.459088,214.052718,76.107496,2,0
0,0,5,5,11,11,22,28,20,48,0.000333,0.071351,5,1070.263588,59.459088,214.052718,76.107496,2,0
0,0,11,11,10,15,25,39,33,72,0.000333,0.111453,10,3343.576457,185.754248,334.357646,91.82264,2,0
0,0,18,18,18,23,41,81,58,139,0.000333,0.248233,18,13404.59512,744.699729,744.699729,179.100575,6,0
0,0,4,4,11,11,22,24,17,41,0.000333,0.060946,5,914.183482,50.787971,182.836696,76.107496,2,0
0,0,4,4,11,11,22,24,17,41,0.000333,0.060946,5,914.183482,50.787971,182.836696,76.107496,2,0
0,0,3,3,7,5,12,10,7,17,0.000333,0.020315,3,182.833088,10.157394,60.944363,31.261125,1,0
0,0,5,5,11,11,22,28,20,48,0.000333,0.071351,5,1070.263588,59.459088,214.052718,76.107496,2,0
0,0,5,5,11,11,22,28,20,48,0.000333,0.071351,5,1070.263588,59.459088,214.052718,76.107496,2,0
0,0,14,14,11,16,27,54,41,95,0.000333,0.150571,10,4517.143127,250.952396,451.714313,102.053748,2,0
0,0,21,21,19,24,43,96,66,162,0.000333,0.293018,18,15822.98803,879.05489,879.05489,190.749723,6,0
0,0,4,4,11,11,22,24,17,41,0.000333,0.060946,5,914.183482,50.787971,182.836696,76.107496,2,0
0,0,4,4,11,11,22,24,17,41,0.000333,0.060946,5,914.183482,50.787971,182.836696,76.107496,2,0
0,0,3,3,7,5,12,10,7,17,0.000333,0.020315,3,182.833088,10.157394,60.944363,31.261125,1,0
0,0,5,5,11,11,22,28,20,48,0.000333,0.071351,5,1070.263588,59.459088,214.052718,76.107496,2,0
0,0,5,5,11,11,22,28,20,48,0.000333,0.071351,5,1070.263588,59.459088,214.052718,76.107496,2,0
0,0,13,13,11,20,31,43,40,83,0.000333,0.137066,10,4111.982938,228.443497,411.198294,124.49231,2,0
0,0,19,19,19,28,47,83,63,146,0.000333,0.270323,18,14597.4595,810.969972,810.969972,215.316561,6,0
0,0,4,4,11,11,22,24,17,41,0.000333,0.060946,5,914.183482,50.787971,182.836696,76.107496,2,0
0,0,4,4,11,11,22,24,17,41,0.000333,0.060946,5,914.183482,50.787971,182.836696,76.107496,2,0
0,0,3,3,7,5,12,10,7,17,0.000333,0.020315,3,182.833088,10.157394,60.944363,31.261125,1,0
0,0,5,5,11,11,22,28,20,48,0.000333,0.071351,5,1070.263588,59.459088,214.052718,76.107496,2,0
0,0,5,5,11,11,22,28,20,48,0.000333,0.071351,5,1070.263588,59.459088,214.052718,76.107496,2,0
0,0,12,12,10,15,25,42,37,79,0.000333,0.122288,10,3668.64639,203.813688,366.864639,91.82264,2,0
0,0,18,18,18,23,41,82,60,142,0.000333,0.253591,18,13693.90292,760.772385,760.772385,179.100575,6,0
0,0,4,4,11,11,22,24,17,41,0.000333,0.060946,5,914.183482,50.787971,182.836696,76.107496,2,0
0,0,4,4,11,11,22,24,17,41,0.000333,0.060946,5,914.183482,50.787971,182.836696,76.107496,2,0
0,0,3,3,7,5,12,10,7,17,0.000333,0.020315,3,182.833088,10.157394,60.944363,31.261125,1,0
0,0,5,5,11,11,22,28,20,48,0.000333,0.071351,5,1070.263588,59.459088,214.052718,76.107496,2,0
0,0,5,5,11,11,22,28,20,48,0.000333,0.071351,5,1070.263588,59.459088,214.052718,76.107496,2,0
0,0,13,13,11,15,26,46,39,85,0.000333,0.133179,10,3995.37376,221.965209,399.537376,96.657107,2,0
0,0,20,20,19,23,42,88,64,152,0.000333,0.273211,18,14753.38047,819.632248,819.632248,184.752548,6,0
0,0,6,6,13,13,26,33,26,59,0.000333,0.092442,12,3327.91132,184.883962,277.325943,96.211433,2,0
0,0,6,6,13,12,25,33,24,57,0.000333,0.088233,12,3176.397634,176.466535,264.699803,91.125266,2,0
0,0,5,5,9,7,16,19,16,35,0.000333,0.046667,8,1120,62.222222,140,48.180809,1,0
0,0,7,7,13,12,25,37,27,64,0.000333,0.099069,12,3566.481554,198.137864,297.206796,91.125266,2,0
0,0,7,7,13,13,26,37,29,66,0.000333,0.10341,12,3722.748257,206.819348,310.229021,96.211433,2,0
0,0,11,11,10,15,25,44,32,76,0.000333,0.117644,10,3529.330704,196.073928,352.93307,91.82264,2,0
0,0,17,17,18,23,41,84,55,139,0.000333,0.248233,18,13404.59512,744.699729,744.699729,179.100575,6,0
0,0,4,4,11,11,22,24,17,41,0.000333,0.060946,5,914.183482,50.787971,182.836696,76.107496,2,0
0,0,4,4,11,11,22,24,17,41,0.000333,0.060946,5,914.183482,50.787971,182.836696,76.107496,2,0
0,0,3,3,7,5,12,10,7,17,0.000333,0.020315,3,182.833088,10.157394,60.944363,31.261125,1,0
0,0,5,5,11,11,22,28,20,48,0.000333,0.071351,5,1070.263588,59.459088,214.052718,76.107496,2,0
0,0,5,5,11,11,22,28,20,48,0.000333,0.071351,5,1070.263588,59.459088,214.052718,76.107496,2,0
0,0,14,14,10,19,29,42,45,87,0.000333,0.140881,10,4226.443466,234.802415,422.644347,113.929904,2,0
0,0,20,20,18,27,45,82,68,150,0.000333,0.274593,18,14828.00336,823.777964,823.777964,203.440613,6,0
0,0,4,4,11,11,22,24,17,41,0.000333,0.060946,5,914.183482,50.787971,182.836696,76.107496,2,0
0,0,4,4,11,11,22,24,17,41,0.000333,0.060946,5,914.183482,50.787971,182.836696,76.107496,2,0
0,0,3,3,7,5,12,10,7,17,0.000333,0.020315,3,182.833088,10.157394,60.944363,31.261125,1,0
0,0,5,5,11,11,22,28,20,48,0.000333,0.071351,5,1070.263588,59.459088,214.052718,76.107496,2,0
0,0,5,5,11,11,22,28,20,48,0.000333,0.071351,5,1070.263588,59.459088,214.052718,76.107496,2,0
0,0,12,12,10,18,28,41,41,82,0.000333,0.131401,10,3942.031036,219.001724,394.203104,108.277931,2,0
0,0,18,18,18,26,44,81,64,145,0.000333,0.263873,18,14249.11653,791.617585,791.617585,197.270083,6,0
0,0,4,4,11,11,22,24,17,41,0.000333,0.060946,5,914.183482,50.787971,182.836696,76.107496,2,0
0,0,4,4,11,11,22,24,17,41,0.000333,0.060946,5,914.183482,50.787971,182.836696,76.107496,2,0
0,0,3,3,7,5,12,10,7,17,0.000333,0.020315,3,182.833088,10.157394,60.944363,31.261125,1,0
0,0,5,5,11,11,22,28,20,48,0.000333,0.071351,5,1070.263588,59.459088,214.052718,76.107496,2,0
0,0,5,5,11,11,22,28,20,48,0.000333,0.071351,5,1070.263588,59.459088,214.052718,76.107496,2,0
0,0,13,13,10,19,29,45,51,96,0.000333,0.155455,10,4663.661755,259.09232,466.366176,113.929904,2,0
0,0,20,20,18,27,45,87,76,163,0.000333,0.298391,18,16113.09699,895.172055,895.172055,203.440613,6,0
0,0,4,4,11,11,22,24,17,41,0.000333,0.060946,5,914.183482,50.787971,182.836696,76.107496,2,0
0,0,4,4,11,11,22,24,17,41,0.000333,0.060946,5,914.183482,50.787971,182.836696,76.107496,2,0
0,0,3,3,7,5,12,10,7,17,0.000333,0.020315,3,182.833088,10.157394,60.944363,31.261125,1,0
0,0,5,5,11,11,22,28,20,48,0.000333,0.071351,5,1070.263588,59.459088,214.052718,76.107496,2,0
0,0,5,5,11,11,22,28,20,48,0.000333,0.071351,5,1070.263588,59.459088,214.052718,76.107496,2,0
0,0,16,16,10,20,30,53,65,118,0.000333,0.193004,15,8685.196354,482.510909,579.01309,119.657843,2,0
0,0,22,22,18,28,46,93,88,181,0.000333,0.333255,27,26993.64728,1499.647071,999.764714,209.664588,6,0
0,0,4,4,11,11,22,24,17,41,0.000333,0.060946,5,914.183482,50.787971,182.836696,76.107496,2,0
0,0,4,4,11,11,22,24,17,41,0.000333,0.060946,5,914.183482,50.787971,182.836696,76.107496,2,0
0,0,3,3,7,5,12,10,7,17,0.000333,0.020315,3,182.833088,10.157394,60.944363,31.261125,1,0
0,0,5,5,11,11,22,28,20,48,0.000333,0.071351,5,1070.263588,59.459088,214.052718,76.107496,2,0
0,0,5,5,11,11,22,28,20,48,0.000333,0.071351,5,1070.263588,59.459088,214.052718,76.107496,2,0
0,0,18,18,10,21,31,59,77,136,0.000333,0.22459,15,10106.56047,561.475582,673.770698,125.457947,2,0
0,0,24,24,18,29,47,99,100,199,0.000333,0.368454,27,29844.8059,1658.044772,1105.363181,215.940099,6,0
0,0,4,4,11,11,22,24,17,41,0.000333,0.060946,5,914.183482,50.787971,182.836696,76.107496,2,0
0,0,4,4,11,11,22,24,17,41,0.000333,0.060946,5,914.183482,50.787971,182.836696,76.107496,2,0
0,0,3,3,7,5,12,10,7,17,0.000333,0.020315,3,182.833088,10.157394,60.944363,31.261125,1,0
0,0,5,5,11,11,22,28,20,48,0.000333,0.071351,5,1070.263588,59.459088,214.052718,76.107496,2,0
0,0,5,5,11,11,22,28,20,48,0.000333,0.071351,5,1070.263588,59.459088,214.052718,76.107496,2,0
0,0,13,13,11,18,29,45,43,88,0.000333,0.142501,10,4275.023276,237.501293,427.502328,113.112398,2,0
0,0,20,20,19,26,45,87,68,155,0.000333,0.283746,18,15322.27014,851.23723,851.23723,202.922055,6,0
0,0,6,6,12,15,27,32,30,62,0.000333,0.098268,12,3537.636302,196.53535,294.803025,101.622909,2,0
0,0,3,3,10,13,23,22,18,40,0.000333,0.060314,5,904.712391,50.2618,180.942478,81.324997,2,0
0,0,2,2,5,7,12,8,9,17,0.000333,0.020315,2,121.888725,6.771596,60.944363,31.261125,1,0
0,0,4,4,10,13,23,26,21,47,0.000333,0.070869,5,1063.03706,59.057614,212.607412,81.324997,2,0
0,0,7,7,12,15,27,36,33,69,0.000333,0.109362,12,3937.046852,218.724825,328.087238,101.622909,2,0
0,0,13,13,11,19,30,47,44,91,0.000333,0.148842,10,4465.270442,248.07058,446.527044,118.764371,2,0
0,0,19,19,19,27,46,87,67,154,0.000333,0.283543,18,15311.31374,850.628541,850.628541,209.092585,6,0
0,0,4,4,11,11,22,24,17,41,0.000333,0.060946,5,914.183482,50.787971,182.836696,76.107496,2,0
0,0,4,4,11,11,22,24,17,41,0.000333,0.060946,5,914.183482,50.787971,182.836696,76.107496,2,0
0,0,3,3,7,5,12,10,7,17,0.000333,0.020315,3,182.833088,10.157394,60.944363,31.261125,1,0
0,0,5,5,11,11,22,28,20,48,0.000333,0.071351,5,1070.263588,59.459088,214.052718,76.107496,2,0
0,0,5,5,11,11,22,28,20,48,0.000333,0.071351,5,1070.263588,59.459088,214.052718,76.107496,2,0
0,0,14,14,11,20,31,56,48,104,0.000333,0.171745,10,5152.364163,286.242453,515.236416,124.49231,2,0
0,0,20,20,19,28,47,96,71,167,0.000333,0.309205,18,16697.09409,927.616338,927.616338,215.316561,6,0
0,0,4,4,11,11,22,24,17,41,0.000333,0.060946,5,914.183482,50.787971,182.836696,76.107496,2,0
0,0,4,4,11,11,22,24,17,41,0.000333,0.060946,5,914.183482,50.787971,182.836696,76.107496,2,0
0,0,3,3,7,5,12,10,7,17,0.000333,0.020315,3,182.833088,10.157394,60.944363,31.261125,1,0
0,0,5,5,11,11,22,28,20,48,0.000333,0.071351,5,1070.263588,59.459088,214.052718,76.107496,2,0
0,0,5,5,11,11,22,28,20,48,0.000333,0.071351,5,1070.263588,59.459088,214.052718,76.107496,2,0
0,0,11,11,9,17,26,43,36,79,0.000333,0.123778,8,2970.677902,165.037661,371.334738,98.016193,2,0
0,0,17,17,17,25,42,83,59,142,0.000333,0.255236,16,12251.34519,680.630288,765.709074,185.583273,6,0
0,0,4,4,11,11,22,24,17,41,0.000333,0.060946,5,914.183482,50.787971,182.836696,76.107496,2,0
0,0,4,4,11,11,22,24,17,41,0.000333,0.060946,5,914.183482,50.787971,182.836696,76.107496,2,0
0,0,3,3,7,5,12,10,7,17,0.000333,0.020315,3,182.833088,10.157394,60.944363,31.261125,1,0
0,0,5,5,11,11,22,28,20,48,0.000333,0.071351,5,1070.263588,59.459088,214.052718,76.107496,2,0
0,0,5,5,11,11,22,28,20,48,0.000333,0.071351,5,1070.263588,59.459088,214.052718,76.107496,2,0
0,0,14,14,10,21,31,54,49,103,0.000333,0.170094,10,5102.8222,283.490122,510.28222,125.457947,2,0
0,0,21,21,18,29,47,96,74,170,0.000333,0.31476,18,16997.04189,944.280105,944.280105,215.940099,6,0
0,0,4,4,11,11,22,24,17,41,0.000333,0.060946,5,914.183482,50.787971,182.836696,76.107496,2,0
0,0,4,4,11,11,22,24,17,41,0.000333,0.060946,5,914.183482,50.787971,182.836696,76.107496,2,0
0,0,3,3,7,5,12,10,7,17,0.000333,0.020315,3,182.833088,10.157394,60.944363,31.261125,1,0
0,0,5,5,11,11,22,28,20,48,0.000333,0.071351,5,1070.263588,59.459088,214.052718,76.107496,2,0
0,0,5,5,11,11,22,28,20,48,0.000333,0.071351,5,1070.263588,59.459088,214.052718,76.107496,2,0
0,0,14,14,11,21,32,46,52,98,0.000333,0.163333,10,4900,272.222222,490,130.292414,2,0
0,0,21,21,19,29,48,88,77,165,0.000333,0.307173,18,16587.33863,921.518813,921.518813,221.592072,6,0
0,0,4,4,11,11,22,24,17,41,0.000333,0.060946,5,914.183482,50.787971,182.836696,76.107496,2,0
0,0,4,4,11,11,22,24,17,41,0.000333,0.060946,5,914.183482,50.787971,182.836696,76.107496,2,0
0,0,3,3,7,5,12,10,7,17,0.000333,0.020315,3,182.833088,10.157394,60.944363,31.261125,1,0
0,0,5,5,11,11,22,28,20,48,0.000333,0.071351,5,1070.263588,59.459088,214.052718,76.107496,2,0
0,0,5,5,11,11,22,28,20,48,0.000333,0.071351,5,1070.263588,59.459088,214.052718,76.107496,2,0
0,0,13,13,10,20,30,39,47,86,0.000333,0.140664,10,4219.925912,234.440328,421.992591,119.657843,2,0
0,0,20,20,18,28,46,81,72,153,0.000333,0.281702,18,15211.88963,845.104979,845.104979,209.664588,6,0
0,0,4,4,11,11,22,24,17,41,0.000333,0.060946,5,914.183482,50.787971,182.836696,76.107496,2,0
0,0,4,4,11,11,22,24,17,41,0.000333,0.060946,5,914.183482,50.787971,182.836696,76.107496,2,0
0,0,3,3,7,5,12,10,7,17,0.000333,0.020315,3,182.833088,10.157394,60.944363,31.261125,1,0
0,0,5,5,11,11,22,28,20,48,0.000333,0.071351,5,1070.263588,59.459088,214.052718,76.107496,2,0
0,0,5,5,11,11,22,28,20,48,0.000333,0.071351,5,1070.263588,59.459088,214.052718,76.107496,2,0
0,0,13,13,14,21,35,48,48,96,0.000333,0.164137,14,6893.756375,382.986465,492.41117,145.541635,2,0
0,0,19,19,22,29,51,88,71,159,0.000333,0.300639,22,19842.14385,1102.341325,901.915629,238.988944,6,0
0,0,4,4,11,11,22,24,17,41,0.000333,0.060946,5,914.183482,50.787971,182.836696,76.107496,2,0
0,0,4,4,11,11,22,24,17,41,0.000333,0.060946,5,914.183482,50.787971,182.836696,76.107496,2,0
0,0,3,3,7,5,12,10,7,17,0.000333,0.020315,3,182.833088,10.157394,60.944363,31.261125,1,0
0,0,5,5,11,11,22,28,20,48,0.000333,0.071351,5,1070.263588,59.459088,214.052718,76.107496,2,0
0,0,5,5,11,11,22,28,20,48,0.000333,0.071351,5,1070.263588,59.459088,214.052718,76.107496,2,0
0,0,12,12,13,21,34,45,46,91,0.000333,0.15432,12,5555.509423,308.639412,462.959119,140.344382,2,0
0,0,19,19,21,29,50,87,71,158,0.000333,0.297243,20,17834.58556,990.810309,891.729278,233.120115,6,0
0,0,4,4,11,11,22,24,17,41,0.000333,0.060946,5,914.183482,50.787971,182.836696,76.107496,2,0
0,0,4,4,11,11,22,24,17,41,0.000333,0.060946,5,914.183482,50.787971,182.836696,76.107496,2,0
0,0,3,3,7,5,12,10,7,17,0.000333,0.020315,3,182.833088,10.157394,60.944363,31.261125,1,0
0,0,5,5,11,11,22,28,20,48,0.000333,0.071351,5,1070.263588,59.459088,214.052718,76.107496,2,0
0,0,5,5,11,11,22,28,20,48,0.000333,0.071351,5,1070.263588,59.459088,214.052718,76.107496,2,0