Empty_Lines,Lines_Of_Comments,Lines_Of_Program,Physic_Lines,n1_Number_Of_Distinct_Operators,n2_Number_Of_Distinct_Operands,n_Program_Vocabulary,N1_Total_Number_Of_Operators,N2_Total_Number_Of_Operands,N_Program_Length,B_Number_of_Delivered_Bugs_1,B_Number_of_Delivered_Bugs_2,D_Difficulty,E_Effort,T_Time_Required_To_Program,V_Volume,_N_Calculated_Program_Length,McCab_Number,IsVulnerable
0,0,10,10,14,15,29,74,35,109,0.000333,0.176507,14,7413.278999,411.848833,529.519928,111.906328,5,4
0,0,17,17,16,44,60,120,87,207,0.000333,0.407575,8,9781.810826,543.433935,1222.726353,304.214991,6,4
0,0,4,4,7,9,16,16,12,28,0.000333,0.037333,3,336,18.666667,112,48.180809,3,4
0,0,20,20,21,30,51,109,77,186,0.000333,0.35169,20,21101.42227,1172.301237,1055.071114,239.445384,10,4
0,0,3,3,7,9,16,13,11,24,0.000333,0.032,3,288,16,96,48.180809,3,4
0,0,8,8,16,12,28,50,27,77,0.000333,0.123389,16,5922.661264,329.036737,370.166329,107.01955,6,4
0,0,7,7,11,13,24,37,19,56,0.000333,0.085586,5,1283.7895,71.321639,256.7579,86.159464,5,4
0,0,4,4,8,7,15,18,12,30,0.000333,0.039069,4,468.826871,26.045937,117.206718,43.651484,3,4
0,0,7,7,10,16,26,41,25,66,0.000333,0.10341,5,1551.145107,86.174728,310.229021,97.219281,3,4
0,0,4,4,10,7,17,22,10,32,0.000333,0.0436,5,653.994055,36.333003,130.798811,52.870765,3,4
0,0,4,4,8,7,15,18,12,30,0.000333,0.039069,4,468.826871,26.045937,117.206718,43.651484,3,4
0,0,10,10,17,15,32,57,33,90,0.000333,0.15,16,7200,400,450,128.090227,6,4
0,0,3,3,7,9,16,13,11,24,0.000333,0.032,3,288,16,96,48.180809,3,4
0,0,3,3,9,9,18,18,13,31,0.000333,0.043089,4,517.0707,28.72615,129.267675,57.05865,2,4
0,0,4,4,8,7,15,18,12,30,0.000333,0.039069,4,468.826871,26.045937,117.206718,43.651484,3,4
0,0,7,7,11,13,24,37,19,56,0.000333,0.085586,5,1283.7895,71.321639,256.7579,86.159464,5,4
0,0,5,5,9,15,24,25,20,45,0.000333,0.068774,4,825.29325,45.849625,206.323313,87.132684,1,4
0,0,7,7,10,16,26,41,25,66,0.000333,0.10341,5,1551.145107,86.174728,310.229021,97.219281,3,4
0,0,6,6,12,12,24,32,19,51,0.000333,0.077944,6,1402.998525,77.944363,233.833088,86.0391,4,4
0,0,8,8,16,12,28,50,27,77,0.000333,0.123389,16,5922.661264,329.036737,370.166329,107.01955,6,4
0,0,7,7,11,13,24,37,19,56,0.000333,0.085586,5,1283.7895,71.321639,256.7579,86.159464,5,4
0,0,4,4,8,7,15,18,12,30,0.000333,0.039069,4,468.826871,26.045937,117.206718,43.651484,3,4
0,0,8,8,16,12,28,50,27,77,0.000333,0.123389,16,5922.661264,329.036737,370.166329,107.01955,6,4
0,0,24,24,20,37,57,127,73,200,0.000333,0.388859,10,11665.78003,648.09889,1166.578003,279.188336,10,4
0,0,21,21,19,32,51,113,64,177,0.000333,0.334673,18,18072.34714,1004.019286,1004.019286,240.710623,10,4
0,0,7,7,10,16,26,41,25,66,0.000333,0.10341,5,1551.145107,86.174728,310.229021,97.219281,3,4
0,0,31,31,17,34,51,155,81,236,0.000333,0.446231,16,21419.07809,1189.948783,1338.692381,242.460605,11,4
0,0,3,3,15,10,25,45,22,67,0.000333,0.103713,14,4355.937106,241.996506,311.138365,91.82264,3,4
0,0,20,20,21,30,51,109,77,186,0.000333,0.35169,20,21101.42227,1172.301237,1055.071114,239.445384,10,4
0,0,11,11,16,17,33,56,37,93,0.000333,0.156376,16,7506.05845,417.003247,469.128653,133.486868,6,4
0,0,3,3,7,9,16,13,11,24,0.000333,0.032,3,288,16,96,48.180809,3,4
0,0,22,22,20,36,56,121,69,190,0.000333,0.367799,10,11033.97435,612.998575,1103.397435,272.555862,10,4
0,0,45,45,21,50,71,275,156,431,0.000333,0.883514,30,79516.23026,4417.568348,2650.541009,374.431475,20,4
0,0,4,4,7,6,13,16,9,25,0.000333,0.030837,3,277.532979,15.418499,92.510993,35.161259,3,4
0,0,3,3,15,10,25,45,22,67,0.000333,0.103713,14,4355.937106,241.996506,311.138365,91.82264,3,4
0,0,30,30,17,47,64,161,92,253,0.000333,0.506,8,12144,674.666667,1518,330.552544,11,4
0,0,32,32,21,48,69,181,103,284,0.000333,0.578274,20,34696.41891,1927.578829,1734.820946,360.316866,14,4
0,0,4,4,8,7,15,18,12,30,0.000333,0.039069,4,468.826871,26.045937,117.206718,43.651484,3,4
0,0,6,6,14,10,24,35,18,53,0.000333,0.081001,7,1701.021088,94.501172,243.003013,86.52225,4,4
0,0,7,7,8,12,20,30,20,50,0.000333,0.072032,4,864.385619,48.021423,216.096405,67.01955,1,4
0,0,51,51,16,47,63,258,177,435,0.000333,0.866706,24,62402.8024,3466.822356,2600.116767,325.065676,4,4
0,0,20,20,21,30,51,109,77,186,0.000333,0.35169,20,21101.42227,1172.301237,1055.071114,239.445384,10,4
0,0,26,26,20,37,57,194,94,288,0.000333,0.559957,20,33597.44648,1866.524805,1679.872324,279.188336,11,4
0,0,3,3,15,10,25,45,22,67,0.000333,0.103713,14,4355.937106,241.996506,311.138365,91.82264,3,4
0,0,9,9,14,15,29,41,28,69,0.000333,0.111734,7,2346.404821,130.355823,335.200689,111.906328,4,4
0,0,7,7,10,16,26,41,25,66,0.000333,0.10341,5,1551.145107,86.174728,310.229021,97.219281,3,4
0,0,15,15,13,18,31,77,50,127,0.000333,0.209728,12,7550.195177,419.455288,629.182931,123.164366,3,4
0,0,7,7,11,13,24,37,19,56,0.000333,0.085586,5,1283.7895,71.321639,256.7579,86.159464,5,4
0,0,4,4,8,7,15,18,12,30,0.000333,0.039069,4,468.826871,26.045937,117.206718,43.651484,3,4
0,0,30,30,20,44,64,159,91,250,0.000333,0.5,20,30000,1666.666667,1500,326.653553,11,4
0,0,6,6,14,10,24,35,18,53,0.000333,0.081001,7,1701.021088,94.501172,243.003013,86.52225,4,4
0,0,19,19,17,24,41,110,60,170,0.000333,0.303595,16,14572.54145,809.585636,910.783841,179.525968,9,4
0,0,4,4,7,6,13,16,9,25,0.000333,0.030837,3,277.532979,15.418499,92.510993,35.161259,3,4
0,0,5,5,9,15,24,25,20,45,0.000333,0.068774,4,825.29325,45.849625,206.323313,87.132684,1,4
0,0,4,4,7,6,13,16,9,25,0.000333,0.030837,3,277.532979,15.418499,92.510993,35.161259,3,4
0,0,7,7,10,16,26,41,25,66,0.000333,0.10341,5,1551.145107,86.174728,310.229021,97.219281,3,4
0,0,9,9,12,16,28,38,29,67,0.000333,0.107364,6,1932.556679,107.36426,322.09278,107.01955,4,4
0,0,10,10,17,15,32,57,33,90,0.000333,0.15,16,7200,400,450,128.090227,6,4
0,0,6,6,14,10,24,35,18,53,0.000333,0.081001,7,1701.021088,94.501172,243.003013,86.52225,4,4
0,0,3,3,15,10,25,45,22,67,0.000333,0.103713,14,4355.937106,241.996506,311.138365,91.82264,3,4
0,0,7,7,11,13,24,37,19,56,0.000333,0.085586,5,1283.7895,71.321639,256.7579,86.159464,5,4
0,0,4,4,8,7,15,18,12,30,0.000333,0.039069,4,468.826871,26.045937,117.206718,43.651484,3,4
0,0,4,4,10,7,17,22,10,32,0.000333,0.0436,5,653.994055,36.333003,130.798811,52.870765,3,4
0,0,4,4,7,9,16,16,12,28,0.000333,0.037333,3,336,18.666667,112,48.180809,3,4
0,0,45,45,16,45,61,235,162,397,0.000333,0.784834,24,56508.06535,3139.336964,2354.502723,311.133389,4,4
0,0,3,3,7,9,16,13,11,24,0.000333,0.032,3,288,16,96,48.180809,3,4
0,0,16,16,22,25,47,116,60,176,0.000333,0.325869,22,21507.36803,1194.85378,977.607638,214.2039,8,4
0,0,8,8,16,12,28,50,27,77,0.000333,0.123389,16,5922.661264,329.036737,370.166329,107.01955,6,4
0,0,42,42,21,56,77,260,135,395,0.000333,0.825127,20,49507.61367,2750.422982,2475.380684,417.450542,14,4
0,0,3,3,7,9,16,13,11,24,0.000333,0.032,3,288,16,96,48.180809,3,4
0,0,8,8,16,12,28,50,27,77,0.000333,0.123389,16,5922.661264,329.036737,370.166329,107.01955,6,4
0,0,4,4,8,7,15,18,12,30,0.000333,0.039069,4,468.826871,26.045937,117.206718,43.651484,3,4
0,0,5,5,8,15,23,24,20,44,0.000333,0.066346,4,796.146904,44.230384,199.036726,82.603359,1,4
0,0,3,3,15,10,25,45,22,67,0.000333,0.103713,14,4355.937106,241.996506,311.138365,91.82264,3,4
0,0,4,4,7,6,13,16,9,25,0.000333,0.030837,3,277.532979,15.418499,92.510993,35.161259,3,4
0,0,9,9,16,23,39,65,42,107,0.000333,0.188513,8,4524.304299,251.350239,565.538037,168.041925,2,4
0,0,17,17,17,33,50,104,59,163,0.000333,0.30665,8,7359.588471,408.866026,919.948559,235.951874,6,4
0,0,6,6,14,10,24,35,18,53,0.000333,0.081001,7,1701.021088,94.501172,243.003013,86.52225,4,4
0,0,6,6,14,10,24,35,18,53,0.000333,0.081001,7,1701.021088,94.501172,243.003013,86.52225,4,4
0,0,8,8,15,13,28,42,24,66,0.000333,0.105762,7,2220.997974,123.388776,317.285425,106.709075,4,4
0,0,3,3,9,9,18,18,13,31,0.000333,0.043089,4,517.0707,28.72615,129.267675,57.05865,2,4
0,0,4,4,7,9,16,16,12,28,0.000333,0.037333,3,336,18.666667,112,48.180809,3,4
0,0,5,5,8,15,23,24,20,44,0.000333,0.066346,4,796.146904,44.230384,199.036726,82.603359,1,4
0,0,5,5,8,9,17,20,13,33,0.000333,0.044962,4,539.545095,29.974728,134.886274,52.529325,3,4
0,0,37,37,21,52,73,239,126,365,0.000333,0.753095,20,45185.71928,2510.317738,2259.285964,388.661531,16,4
0,0,10,10,17,15,32,57,33,90,0.000333,0.15,16,7200,400,450,128.090227,6,4
0,0,8,8,15,13,28,42,24,66,0.000333,0.105762,7,2220.997974,123.388776,317.285425,106.709075,4,4
0,0,8,8,13,14,27,39,25,64,0.000333,0.101438,6,1825.876801,101.4376,304.3128,101.408685,4,4
0,0,3,3,15,10,25,45,22,67,0.000333,0.103713,14,4355.937106,241.996506,311.138365,91.82264,3,4
0,0,6,6,12,12,24,32,19,51,0.000333,0.077944,6,1402.998525,77.944363,233.833088,86.0391,4,4
0,0,40,40,17,43,60,206,139,345,0.000333,0.679292,24,48909.05413,2717.169674,2037.877255,302.816253,3,4
0,0,3,3,15,10,25,45,22,67,0.000333,0.103713,14,4355.937106,241.996506,311.138365,91.82264,3,4
0,0,2,2,12,8,20,16,10,26,0.000333,0.037457,6,674.220783,37.45671,112.37013,67.01955,3,4
0,0,31,31,17,38,55,156,88,244,0.000333,0.470217,16,22570.42832,1253.912685,1410.65177,268.908114,11,4
0,0,5,5,8,11,19,20,16,36,0.000333,0.050975,4,611.701562,33.98342,152.92539,62.053748,3,4
0,0,3,3,7,9,16,13,11,24,0.000333,0.032,3,288,16,96,48.180809,3,4
0,0,4,4,8,7,15,18,12,30,0.000333,0.039069,4,468.826871,26.045937,117.206718,43.651484,3,4
0,0,7,7,11,13,24,37,19,56,0.000333,0.085586,5,1283.7895,71.321639,256.7579,86.159464,5,4
0,0,5,5,8,9,17,20,13,33,0.000333,0.044962,4,539.545095,29.974728,134.886274,52.529325,3,4
0,0,3,3,9,9,18,18,13,31,0.000333,0.043089,4,517.0707,28.72615,129.267675,57.05865,2,4
0,0,8,8,10,16,26,49,30,79,0.000333,0.123778,5,1856.673689,103.148538,371.334738,97.219281,4,4
0,0,20,20,17,27,44,122,60,182,0.000333,0.331206,16,15897.86487,883.214715,993.616555,197.868831,20,4
0,0,3,3,9,9,18,18,13,31,0.000333,0.043089,4,517.0707,28.72615,129.267675,57.05865,2,4
0,0,12,12,14,23,37,58,45,103,0.000333,0.178858,7,3756.015877,208.667549,536.573697,157.344894,3,4
0,0,47,47,22,50,72,316,176,492,0.000333,1.011868,33,100174.9023,5565.272351,3035.603101,380.300305,6,4
0,0,4,4,8,11,19,17,15,32,0.000333,0.045311,4,543.734722,30.207485,135.93368,62.053748,3,4
0,0,19,19,17,39,56,111,68,179,0.000333,0.346506,8,8316.132248,462.007347,1039.516531,275.617555,6,4
0,0,7,7,10,16,26,41,25,66,0.000333,0.10341,5,1551.145107,86.174728,310.229021,97.219281,3,4
0,0,3,3,7,9,16,13,11,24,0.000333,0.032,3,288,16,96,48.180809,3,4
0,0,28,28,20,42,62,209,103,312,0.000333,0.619236,20,37154.18498,2064.121388,1857.709249,312.915894,11,4
0,0,20,20,21,30,51,109,77,186,0.000333,0.35169,20,21101.42227,1172.301237,1055.071114,239.445384,10,4
0,0,5,5,9,15,24,25,20,45,0.000333,0.068774,4,825.29325,45.849625,206.323313,87.132684,1,4
0,0,7,7,10,16,26,41,25,66,0.000333,0.10341,5,1551.145107,86.174728,310.229021,97.219281,3,4
0,0,31,31,20,47,67,165,94,259,0.000333,0.523706,20,31422.34201,1745.685667,1571.1171,347.504238,11,4
0,0,29,29,17,37,54,182,90,272,0.000333,0.521776,16,25045.27041,1391.403912,1565.329401,262.236643,12,4
0,0,22,22,16,30,46,139,70,209,0.000333,0.384808,16,18470.79118,1026.155066,1154.424449,211.206718,10,4
0,0,5,5,8,9,17,20,13,33,0.000333,0.044962,4,539.545095,29.974728,134.886274,52.529325,3,4
0,0,20,20,21,30,51,109,77,186,0.000333,0.35169,20,21101.42227,1172.301237,1055.071114,239.445384,10,4
0,0,3,3,9,9,18,18,13,31,0.000333,0.043089,4,517.0707,28.72615,129.267675,57.05865,2,4
0,0,3,3,7,9,16,13,11,24,0.000333,0.032,3,288,16,96,48.180809,3,4
0,0,9,9,11,19,30,47,31,78,0.000333,0.127579,5,1913.687332,106.315963,382.737466,118.764371,3,4
0,0,9,9,10,18,28,45,31,76,0.000333,0.121786,5,1826.79487,101.488604,365.358974,108.277931,3,4
0,0,51,51,26,54,80,279,185,464,0.000333,0.977792,39,114401.6108,6355.645045,2933.374636,432.975358,23,4
0,0,5,5,8,15,23,24,20,44,0.000333,0.066346,4,796.146904,44.230384,199.036726,82.603359,1,4
0,0,4,4,7,6,13,16,9,25,0.000333,0.030837,3,277.532979,15.418499,92.510993,35.161259,3,4
0,0,7,7,10,16,26,41,25,66,0.000333,0.10341,5,1551.145107,86.174728,310.229021,97.219281,3,4
0,0,16,16,17,32,49,102,57,159,0.000333,0.29758,8,7141.910922,396.772829,892.738865,229.486868,6,4
0,0,3,3,15,10,25,45,22,67,0.000333,0.103713,14,4355.937106,241.996506,311.138365,91.82264,3,4
0,0,3,3,9,9,18,18,13,31,0.000333,0.043089,4,517.0707,28.72615,129.267675,57.05865,2,4
0,0,10,10,17,13,30,56,31,87,0.000333,0.1423,16,6830.391709,379.466206,426.899482,117.592585,6,4
0,0,20,20,21,30,51,109,77,186,0.000333,0.35169,20,21101.42227,1172.301237,1055.071114,239.445384,10,4
0,0,8,8,16,12,28,50,27,77,0.000333,0.123389,16,5922.661264,329.036737,370.166329,107.01955,6,4
0,0,30,30,17,35,52,150,85,235,0.000333,0.446534,16,21433.65334,1190.758519,1339.603334,249.011774,11,4
0,0,5,5,8,11,19,20,16,36,0.000333,0.050975,4,611.701562,33.98342,152.92539,62.053748,3,4
0,0,31,31,17,34,51,155,81,236,0.000333,0.446231,16,21419.07809,1189.948783,1338.692381,242.460605,11,4
0,0,5,5,8,11,19,20,16,36,0.000333,0.050975,4,611.701562,33.98342,152.92539,62.053748,3,4
0,0,25,25,21,43,64,136,82,218,0.000333,0.436,10,13080,726.666667,1308,325.56805,10,4
0,0,3,3,7,9,16,13,11,24,0.000333,0.032,3,288,16,96,48.180809,3,4
0,0,20,20,21,30,51,109,77,186,0.000333,0.35169,20,21101.42227,1172.301237,1055.071114,239.445384,10,4
0,0,3,3,7,9,16,13,11,24,0.000333,0.032,3,288,16,96,48.180809,3,4
0,0,32,32,20,49,69,167,97,264,0.000333,0.53755,10,16126.50457,895.91692,1612.650457,361.559344,11,4
0,0,4,4,7,9,16,16,12,28,0.000333,0.037333,3,336,18.666667,112,48.180809,3,4
0,0,5,5,9,15,24,25,20,45,0.000333,0.068774,4,825.29325,45.849625,206.323313,87.132684,1,4
0,0,32,32,22,41,63,219,109,328,0.000333,0.653516,22,43132.05193,2396.225107,1960.547815,317.767128,13,4
0,0,3,3,9,9,18,18,13,31,0.000333,0.043089,4,517.0707,28.72615,129.267675,57.05865,2,4
0,0,8,8,16,12,28,50,27,77,0.000333,0.123389,16,5922.661264,329.036737,370.166329,107.01955,6,4
0,0,18,18,22,31,53,122,70,192,0.000333,0.366587,22,24194.736,1344.152,1099.760727,251.687581,9,4
0,0,31,31,17,34,51,153,81,234,0.000333,0.442449,16,21237.56048,1179.864471,1327.34753,242.460605,11,4
0,0,41,41,16,43,59,209,140,349,0.000333,0.684347,24,49273.01818,2737.389899,2053.042424,297.329384,7,4
0,0,5,5,9,15,24,25,20,45,0.000333,0.068774,4,825.29325,45.849625,206.323313,87.132684,1,4
0,0,3,3,15,10,25,45,22,67,0.000333,0.103713,14,4355.937106,241.996506,311.138365,91.82264,3,4
0,0,3,3,15,10,25,45,22,67,0.000333,0.103713,14,4355.937106,241.996506,311.138365,91.82264,3,4
0,0,5,5,9,15,24,25,20,45,0.000333,0.068774,4,825.29325,45.849625,206.323313,87.132684,1,4
0,0,4,4,7,9,16,16,12,28,0.000333,0.037333,3,336,18.666667,112,48.180809,3,4
0,0,3,3,7,9,16,13,11,24,0.000333,0.032,3,288,16,96,48.180809,3,4
0,0,18,18,18,34,52,120,63,183,0.000333,0.347727,9,9388.624216,521.590234,1043.180468,248.032387,8,4
0,0,4,4,7,6,13,16,9,25,0.000333,0.030837,3,277.532979,15.418499,92.510993,35.161259,3,4
0,0,7,7,11,13,24,37,19,56,0.000333,0.085586,5,1283.7895,71.321639,256.7579,86.159464,5,4
0,0,30,30,17,35,52,150,85,235,0.000333,0.446534,16,21433.65334,1190.758519,1339.603334,249.011774,11,4
0,0,22,22,20,39,59,141,74,215,0.000333,0.421589,10,12647.68256,702.649031,1264.768256,292.569248,9,4
0,0,4,4,7,9,16,16,12,28,0.000333,0.037333,3,336,18.666667,112,48.180809,3,4
0,0,31,31,20,46,66,164,93,257,0.000333,0.517803,20,31068.18577,1726.010321,1553.409289,340.522412,12,4
0,0,4,4,7,9,16,16,12,28,0.000333,0.037333,3,336,18.666667,112,48.180809,3,4
0,0,8,8,16,12,28,50,27,77,0.000333,0.123389,16,5922.661264,329.036737,370.166329,107.01955,6,4
0,0,20,20,21,30,51,109,77,186,0.000333,0.35169,20,21101.42227,1172.301237,1055.071114,239.445384,10,4
0,0,28,28,18,43,61,184,94,278,0.000333,0.549582,18,29677.40964,1648.74498,1648.74498,308.388034,10,4
0,0,6,6,14,10,24,35,18,53,0.000333,0.081001,7,1701.021088,94.501172,243.003013,86.52225,4,4
0,0,4,4,8,7,15,18,12,30,0.000333,0.039069,4,468.826871,26.045937,117.206718,43.651484,3,4
0,0,7,7,8,12,20,30,20,50,0.000333,0.072032,4,864.385619,48.021423,216.096405,67.01955,1,4
0,0,31,31,17,35,52,156,82,238,0.000333,0.452235,16,21707.27445,1205.959691,1356.704653,249.011774,11,4
0,0,4,4,7,6,13,16,9,25,0.000333,0.030837,3,277.532979,15.418499,92.510993,35.161259,3,4
0,0,8,8,16,12,28,50,27,77,0.000333,0.123389,16,5922.661264,329.036737,370.166329,107.01955,6,4
0,0,19,19,17,31,48,147,66,213,0.000333,0.396532,16,19033.5522,1057.419567,1189.597013,223.066954,11,4
0,0,28,28,17,41,58,150,85,235,0.000333,0.458875,16,22026.00854,1223.667141,1376.625534,289.1465,10,4
0,0,3,3,7,9,16,13,11,24,0.000333,0.032,3,288,16,96,48.180809,3,4
0,0,4,4,7,6,13,16,9,25,0.000333,0.030837,3,277.532979,15.418499,92.510993,35.161259,3,4
0,0,7,7,10,16,26,41,25,66,0.000333,0.10341,5,1551.145107,86.174728,310.229021,97.219281,3,4
0,0,4,4,7,9,16,16,12,28,0.000333,0.037333,3,336,18.666667,112,48.180809,3,4
0,0,31,31,20,47,67,165,94,259,0.000333,0.523706,20,31422.34201,1745.685667,1571.1171,347.504238,11,4
0,0,5,5,8,15,23,24,20,44,0.000333,0.066346,4,796.146904,44.230384,199.036726,82.603359,1,4
0,0,6,6,12,12,24,32,19,51,0.000333,0.077944,6,1402.998525,77.944363,233.833088,86.0391,4,4
0,0,3,3,15,10,25,45,22,67,0.000333,0.103713,14,4355.937106,241.996506,311.138365,91.82264,3,4
0,0,33,33,21,43,64,185,101,286,0.000333,0.572,20,34320,1906.666667,1716,325.56805,14,4
0,0,31,31,17,35,52,156,82,238,0.000333,0.452235,16,21707.27445,1205.959691,1356.704653,249.011774,11,4
0,0,6,6,14,10,24,35,18,53,0.000333,0.081001,7,1701.021088,94.501172,243.003013,86.52225,4,4
0,0,31,31,20,47,67,165,94,259,0.000333,0.523706,20,31422.34201,1745.685667,1571.1171,347.504238,11,4
0,0,4,4,7,6,13,16,9,25,0.000333,0.030837,3,277.532979,15.418499,92.510993,35.161259,3,4
0,0,4,4,11,5,16,19,9,28,0.000333,0.037333,5,560,31.111111,112,49.663388,2,4
0,0,3,3,15,10,25,45,22,67,0.000333,0.103713,14,4355.937106,241.996506,311.138365,91.82264,3,4
0,0,28,28,17,42,59,153,86,239,0.000333,0.468651,16,22495.22702,1249.734834,1405.951689,295.9642,10,4
0,0,8,8,15,13,28,42,24,66,0.000333,0.105762,7,2220.997974,123.388776,317.285425,106.709075,4,4
0,0,20,20,21,30,51,109,77,186,0.000333,0.35169,20,21101.42227,1172.301237,1055.071114,239.445384,10,4
0,0,17,17,19,26,45,121,62,183,0.000333,0.335003,18,18090.1641,1005.009117,1005.009117,202.922055,9,4
0,0,3,3,9,9,18,18,13,31,0.000333,0.043089,4,517.0707,28.72615,129.267675,57.05865,2,4
0,0,40,40,17,43,60,206,139,345,0.000333,0.679292,24,48909.05413,2717.169674,2037.877255,302.816253,5,4
0,0,6,6,8,10,18,26,18,44,0.000333,0.061159,4,733.9068,40.7726,183.4767,57.219281,1,4
0,0,4,4,8,7,15,18,12,30,0.000333,0.039069,4,468.826871,26.045937,117.206718,43.651484,3,4
0,0,7,7,11,13,24,37,19,56,0.000333,0.085586,5,1283.7895,71.321639,256.7579,86.159464,5,4
0,0,37,37,21,54,75,215,123,338,0.000333,0.70178,20,42106.81435,2339.267464,2105.340717,403.002591,18,4
0,0,25,25,22,34,56,176,89,265,0.000333,0.512983,22,33856.8792,1880.937733,1538.949054,271.081232,11,4
0,0,16,16,16,24,40,125,54,179,0.000333,0.317542,16,15242.00206,846.777892,952.625129,174.0391,8,4
0,0,4,4,7,6,13,16,9,25,0.000333,0.030837,3,277.532979,15.418499,92.510993,35.161259,3,4
0,0,30,30,20,44,64,159,91,250,0.000333,0.5,20,30000,1666.666667,1500,326.653553,11,4
0,0,20,20,21,30,51,109,77,186,0.000333,0.35169,20,21101.42227,1172.301237,1055.071114,239.445384,10,4
0,0,3,3,15,10,25,45,22,67,0.000333,0.103713,14,4355.937106,241.996506,311.138365,91.82264,3,4
0,0,16,16,17,25,42,102,54,156,0.000333,0.280401,16,13459.22429,747.734683,841.201518,185.583273,8,4
0,0,7,7,8,12,20,30,20,50,0.000333,0.072032,4,864.385619,48.021423,216.096405,67.01955,1,4
0,0,29,29,17,43,60,156,88,244,0.000333,0.480427,16,23060.50089,1281.138938,1441.281305,302.816253,10,4
0,0,10,10,16,14,30,56,33,89,0.000333,0.145571,16,6987.412208,388.189567,436.713263,117.302969,6,4
0,0,9,9,16,23,39,65,42,107,0.000333,0.188513,8,4524.304299,251.350239,565.538037,168.041925,2,4
0,0,3,3,7,9,16,13,11,24,0.000333,0.032,3,288,16,96,48.180809,3,4
0,0,8,8,13,13,26,38,23,61,0.000333,0.095576,6,1720.360937,95.575608,286.726823,96.211433,4,4
0,0,3,3,15,10,25,45,22,67,0.000333,0.103713,14,4355.937106,241.996506,311.138365,91.82264,3,4
0,0,8,8,16,12,28,50,27,77,0.000333,0.123389,16,5922.661264,329.036737,370.166329,107.01955,6,4
0,0,10,10,16,14,30,56,33,89,0.000333,0.145571,16,6987.412208,388.189567,436.713263,117.302969,6,4
0,0,4,4,8,7,15,18,12,30,0.000333,0.039069,4,468.826871,26.045937,117.206718,43.651484,3,4
0,0,4,4,10,7,17,22,10,32,0.000333,0.0436,5,653.994055,36.333003,130.798811,52.870765,3,4
0,0,5,5,8,15,23,24,20,44,0.000333,0.066346,4,796.146904,44.230384,199.036726,82.603359,1,4
0,0,5,5,8,15,23,24,20,44,0.000333,0.066346,4,796.146904,44.230384,199.036726,82.603359,1,4
0,0,7,7,10,16,26,41,25,66,0.000333,0.10341,5,1551.145107,86.174728,310.229021,97.219281,3,4
0,0,44,44,21,51,72,255,148,403,0.000333,0.828827,20,49729.59551,2762.755306,2486.479776,381.532358,20,4
0,0,3,3,15,10,25,45,22,67,0.000333,0.103713,14,4355.937106,241.996506,311.138365,91.82264,3,4
0,0,7,7,10,16,26,41,25,66,0.000333,0.10341,5,1551.145107,86.174728,310.229021,97.219281,3,4
0,0,4,4,7,9,16,16,12,28,0.000333,0.037333,3,336,18.666667,112,48.180809,3,4
0,0,6,6,8,10,18,26,18,44,0.000333,0.061159,4,733.9068,40.7726,183.4767,57.219281,1,4
0,0,10,10,10,21,31,46,35,81,0.000333,0.133763,5,2006.449506,111.469417,401.289901,125.457947,3,4
0,0,3,3,7,9,16,13,11,24,0.000333,0.032,3,288,16,96,48.180809,3,4
0,0,5,5,8,9,17,20,13,33,0.000333,0.044962,4,539.545095,29.974728,134.886274,52.529325,3,4
0,0,5,5,9,14,23,25,19,44,0.000333,0.066346,4,796.146904,44.230384,199.036726,81.832294,1,4
0,0,20,20,21,30,51,109,77,186,0.000333,0.35169,20,21101.42227,1172.301237,1055.071114,239.445384,10,4
0,0,11,11,16,17,33,62,34,96,0.000333,0.161421,16,7748.189367,430.454965,484.261835,133.486868,8,4
0,0,19,19,19,44,63,137,76,213,0.000333,0.424387,9,11458.44561,636.580312,1273.160624,320.925614,6,4
0,0,62,62,18,55,73,327,213,540,0.000333,1.114168,27,90247.64207,5013.757893,3342.505262,393.033434,5,4
0,0,18,18,16,26,42,104,53,157,0.000333,0.282198,16,13545.50137,752.527854,846.593835,186.211433,11,4
0,0,3,3,9,9,18,18,13,31,0.000333,0.043089,4,517.0707,28.72615,129.267675,57.05865,2,4
0,0,4,4,7,9,16,16,12,28,0.000333,0.037333,3,336,18.666667,112,48.180809,3,4
0,0,33,33,22,52,74,201,112,313,0.000333,0.647853,22,42758.29588,2375.460882,1943.558903,394.530361,10,4
0,0,3,3,9,9,18,18,13,31,0.000333,0.043089,4,517.0707,28.72615,129.267675,57.05865,2,4
0,0,3,3,9,9,18,18,13,31,0.000333,0.043089,4,517.0707,28.72615,129.267675,57.05865,2,4
0,0,3,3,9,9,18,18,13,31,0.000333,0.043089,4,517.0707,28.72615,129.267675,57.05865,2,4
0,0,11,11,16,17,33,56,37,93,0.000333,0.156376,16,7506.05845,417.003247,469.128653,133.486868,6,4
0,0,4,4,8,11,19,17,15,32,0.000333,0.045311,4,543.734722,30.207485,135.93368,62.053748,3,4
0,0,5,5,8,11,19,20,16,36,0.000333,0.050975,4,611.701562,33.98342,152.92539,62.053748,3,4
0,0,4,4,7,6,13,16,9,25,0.000333,0.030837,3,277.532979,15.418499,92.510993,35.161259,3,4
0,0,3,3,7,9,16,13,11,24,0.000333,0.032,3,288,16,96,48.180809,3,4
0,0,31,31,20,47,67,165,94,259,0.000333,0.523706,20,31422.34201,1745.685667,1571.1171,347.504238,11,4
0,0,30,30,17,35,52,150,85,235,0.000333,0.446534,16,21433.65334,1190.758519,1339.603334,249.011774,11,4
0,0,3,3,15,10,25,45,22,67,0.000333,0.103713,14,4355.937106,241.996506,311.138365,91.82264,3,4
0,0,8,8,15,11,26,41,22,63,0.000333,0.098709,14,4145.787831,230.321546,296.127702,96.657107,4,4
0,0,60,60,16,49,65,330,217,547,0.000333,1.098078,32,105415.5262,5856.418122,3294.235194,339.120782,4,4
0,0,3,3,7,9,16,13,11,24,0.000333,0.032,3,288,16,96,48.180809,3,4
0,0,40,40,24,47,71,218,137,355,0.000333,0.72772,24,52395.84546,2910.880303,2183.160227,371.104776,24,4
0,0,3,3,7,9,16,13,11,24,0.000333,0.032,3,288,16,96,48.180809,3,4
0,0,5,5,8,15,23,24,20,44,0.000333,0.066346,4,796.146904,44.230384,199.036726,82.603359,1,4
0,0,18,18,19,28,47,99,58,157,0.000333,0.29069,18,15697.2681,872.07045,872.07045,215.316561,10,4
0,0,6,6,14,10,24,35,18,53,0.000333,0.081001,7,1701.021088,94.501172,243.003013,86.52225,4,4
0,0,4,4,7,9,16,16,12,28,0.000333,0.037333,3,336,18.666667,112,48.180809,3,4
0,0,5,5,9,15,24,25,20,45,0.000333,0.068774,4,825.29325,45.849625,206.323313,87.132684,1,4
0,0,4,4,10,12,22,24,18,42,0.000333,0.062432,5,936.48064,52.026702,187.296128,76.238831,2,4
0,0,3,3,9,9,18,18,13,31,0.000333,0.043089,4,517.0707,28.72615,129.267675,57.05865,2,4
0,0,6,6,14,10,24,35,18,53,0.000333,0.081001,7,1701.021088,94.501172,243.003013,86.52225,4,4
0,0,10,10,17,15,32,57,33,90,0.000333,0.15,16,7200,400,450,128.090227,6,4
0,0,3,3,15,10,25,45,22,67,0.000333,0.103713,14,4355.937106,241.996506,311.138365,91.82264,3,4
0,0,5,5,9,15,24,25,20,45,0.000333,0.068774,4,825.29325,45.849625,206.323313,87.132684,1,4
0,0,3,3,7,9,16,13,11,24,0.000333,0.032,3,288,16,96,48.180809,3,4
0,0,14,14,15,20,35,89,42,131,0.000333,0.223979,14,9407.105053,522.616947,671.936075,145.041921,8,4
0,0,6,6,14,10,24,35,18,53,0.000333,0.081001,7,1701.021088,94.501172,243.003013,86.52225,4,4
0,0,32,32,17,39,56,158,89,247,0.000333,0.478139,16,22950.66665,1275.037036,1434.416666,275.617555,11,4
0,0,40,40,17,54,71,197,118,315,0.000333,0.645723,16,30994.72548,1721.929193,1937.170343,380.250793,13,4
0,0,5,5,8,15,23,24,20,44,0.000333,0.066346,4,796.146904,44.230384,199.036726,82.603359,1,4
0,0,5,5,8,15,23,24,20,44,0.000333,0.066346,4,796.146904,44.230384,199.036726,82.603359,1,4
0,0,3,3,15,10,25,45,22,67,0.000333,0.103713,14,4355.937106,241.996506,311.138365,91.82264,3,4
0,0,3,3,15,10,25,45,22,67,0.000333,0.103713,14,4355.937106,241.996506,311.138365,91.82264,3,4
0,0,7,7,10,16,26,41,25,66,0.000333,0.10341,5,1551.145107,86.174728,310.229021,97.219281,3,4
0,0,21,21,18,38,56,131,72,203,0.000333,0.392964,9,10610.03744,589.446525,1178.893049,274.479896,8,4
0,0,4,4,7,9,16,16,12,28,0.000333,0.037333,3,336,18.666667,112,48.180809,3,4
0,0,5,5,8,15,23,24,20,44,0.000333,0.066346,4,796.146904,44.230384,199.036726,82.603359,1,4
0,0,31,31,22,46,68,196,108,304,0.000333,0.616863,22,40712.95148,2261.830638,1850.588704,352.191346,18,4
0,0,20,20,21,30,51,109,77,186,0.000333,0.35169,20,21101.42227,1172.301237,1055.071114,239.445384,10,4
0,0,9,9,15,13,28,53,29,82,0.000333,0.131401,14,5518.843451,306.602414,394.203104,106.709075,6,4
0,0,4,4,7,6,13,16,9,25,0.000333,0.030837,3,277.532979,15.418499,92.510993,35.161259,3,4
0,0,31,31,17,34,51,155,81,236,0.000333,0.446231,16,21419.07809,1189.948783,1338.692381,242.460605,11,4
0,0,11,11,17,13,30,68,38,106,0.000333,0.173377,16,8322.08645,462.338136,520.130403,117.592585,8,4
0,0,26,26,19,32,51,153,80,233,0.000333,0.440558,18,23790.15188,1321.675105,1321.675105,240.710623,11,4
0,0,12,12,14,23,37,58,45,103,0.000333,0.178858,7,3756.015877,208.667549,536.573697,157.344894,3,4
0,0,6,6,14,10,24,35,18,53,0.000333,0.081001,7,1701.021088,94.501172,243.003013,86.52225,4,4
0,0,20,20,21,30,51,109,77,186,0.000333,0.35169,20,21101.42227,1172.301237,1055.071114,239.445384,10,4
0,0,5,5,8,11,19,20,16,36,0.000333,0.050975,4,611.701562,33.98342,152.92539,62.053748,3,4
0,0,4,4,8,7,15,18,12,30,0.000333,0.039069,4,468.826871,26.045937,117.206718,43.651484,3,4
0,0,4,4,10,7,17,22,10,32,0.000333,0.0436,5,653.994055,36.333003,130.798811,52.870765,3,4
0,0,3,3,15,10,25,45,22,67,0.000333,0.103713,14,4355.937106,241.996506,311.138365,91.82264,3,4
0,0,29,29,17,44,61,157,89,246,0.000333,0.48632,16,23343.38216,1296.854564,1458.961385,309.70186,10,4
0,0,6,6,8,10,18,26,18,44,0.000333,0.061159,4,733.9068,40.7726,183.4767,57.219281,1,4
0,0,30,30,17,32,49,150,79,229,0.000333,0.42859,16,20572.29687,1142.905382,1285.768554,229.486868,11,4
0,0,5,5,9,15,24,25,20,45,0.000333,0.068774,4,825.29325,45.849625,206.323313,87.132684,1,4
0,0,31,31,17,34,51,155,81,236,0.000333,0.446231,16,21419.07809,1189.948783,1338.692381,242.460605,11,4
0,0,4,4,7,9,16,16,12,28,0.000333,0.037333,3,336,18.666667,112,48.180809,3,4
0,0,4,4,8,7,15,18,12,30,0.000333,0.039069,4,468.826871,26.045937,117.206718,43.651484,3,4
0,0,4,4,10,7,17,22,10,32,0.000333,0.0436,5,653.994055,36.333003,130.798811,52.870765,3,4
0,0,25,25,19,38,57,136,88,224,0.000333,0.435522,18,23518.21254,1306.567363,1306.567363,280.131868,11,4
0,0,8,8,15,13,28,42,24,66,0.000333,0.105762,7,2220.997974,123.388776,317.285425,106.709075,4,4
0,0,20,20,21,30,51,109,77,186,0.000333,0.35169,20,21101.42227,1172.301237,1055.071114,239.445384,10,4
0,0,7,7,10,16,26,41,25,66,0.000333,0.10341,5,1551.145107,86.174728,310.229021,97.219281,3,4
0,0,4,4,7,9,16,16,12,28,0.000333,0.037333,3,336,18.666667,112,48.180809,3,4
0,0,5,5,8,15,23,24,20,44,0.000333,0.066346,4,796.146904,44.230384,199.036726,82.603359,1,4
0,0,5,5,8,9,17,20,13,33,0.000333,0.044962,4,539.545095,29.974728,134.886274,52.529325,3,4
0,0,40,40,22,53,75,241,131,372,0.000333,0.772374,22,50976.65216,2832.036231,2317.120553,401.68728,13,4
0,0,4,4,7,6,13,16,9,25,0.000333,0.030837,3,277.532979,15.418499,92.510993,35.161259,3,4
0,0,20,20,21,30,51,109,77,186,0.000333,0.35169,20,21101.42227,1172.301237,1055.071114,239.445384,10,4
0,0,3,3,7,9,16,13,11,24,0.000333,0.032,3,288,16,96,48.180809,3,4
0,0,5,5,8,9,17,20,13,33,0.000333,0.044962,4,539.545095,29.974728,134.886274,52.529325,3,4
0,0,34,34,17,44,61,170,96,266,0.000333,0.525859,16,25241.21811,1402.289895,1577.576132,309.70186,11,4
0,0,7,7,10,16,26,41,25,66,0.000333,0.10341,5,1551.145107,86.174728,310.229021,97.219281,3,4
0,0,7,7,10,16,26,41,25,66,0.000333,0.10341,5,1551.145107,86.174728,310.229021,97.219281,3,4
0,0,31,31,17,37,54,155,87,242,0.000333,0.464228,16,22282.92441,1237.940245,1392.682776,262.236643,11,4
0,0,6,6,14,10,24,35,18,53,0.000333,0.081001,7,1701.021088,94.501172,243.003013,86.52225,4,4
0,0,5,5,7,9,16,23,14,37,0.000333,0.049333,3,444,24.666667,148,48.180809,1,4
0,0,3,3,9,9,18,18,13,31,0.000333,0.043089,4,517.0707,28.72615,129.267675,57.05865,2,4
0,0,33,33,20,52,72,173,100,273,0.000333,0.561463,10,16843.89525,935.771959,1684.389525,382.861427,12,4
0,0,4,4,7,9,16,16,12,28,0.000333,0.037333,3,336,18.666667,112,48.180809,3,4
0,0,9,9,11,17,28,47,29,76,0.000333,0.121786,5,1826.79487,101.488604,365.358974,107.540616,3,4
0,0,32,32,21,46,67,178,99,277,0.000333,0.560102,20,33606.13412,1867.007451,1680.306706,346.322516,12,4
0,0,8,8,7,9,16,17,12,29,0.000333,0.038667,3,348,19.333333,116,48.180809,1,4
0,0,3,3,7,9,16,13,11,24,0.000333,0.032,3,288,16,96,48.180809,3,4
0,0,4,4,8,7,15,18,12,30,0.000333,0.039069,4,468.826871,26.045937,117.206718,43.651484,3,4
0,0,3,3,7,9,16,13,11,24,0.000333,0.032,3,288,16,96,48.180809,3,4
0,0,7,7,11,13,24,37,19,56,0.000333,0.085586,5,1283.7895,71.321639,256.7579,86.159464,5,4
0,0,2,2,12,8,20,16,10,26,0.000333,0.037457,6,674.220783,37.45671,112.37013,67.01955,3,4
0,0,8,8,10,16,26,49,30,79,0.000333,0.123778,5,1856.673689,103.148538,371.334738,97.219281,4,4
0,0,32,32,20,40,60,229,110,339,0.000333,0.667479,20,40048.71824,2224.928791,2002.435912,299.315686,16,4
0,0,32,32,17,39,56,159,90,249,0.000333,0.48201,16,23136.50201,1285.361223,1446.031376,275.617555,11,4
0,0,8,8,16,12,28,50,27,77,0.000333,0.123389,16,5922.661264,329.036737,370.166329,107.01955,6,4
0,0,6,6,14,10,24,35,18,53,0.000333,0.081001,7,1701.021088,94.501172,243.003013,86.52225,4,4
0,0,6,6,14,10,24,35,18,53,0.000333,0.081001,7,1701.021088,94.501172,243.003013,86.52225,4,4
0,0,20,20,21,30,51,109,77,186,0.000333,0.35169,20,21101.42227,1172.301237,1055.071114,239.445384,10,4
0,0,4,4,7,9,16,16,12,28,0.000333,0.037333,3,336,18.666667,112,48.180809,3,4
0,0,6,6,12,12,24,32,19,51,0.000333,0.077944,6,1402.998525,77.944363,233.833088,86.0391,4,4
0,0,37,37,21,54,75,270,124,394,0.000333,0.818052,20,49083.09128,2726.838405,2454.154564,403.002591,15,4
0,0,31,31,20,46,66,164,93,257,0.000333,0.517803,20,31068.18577,1726.010321,1553.409289,340.522412,11,4
0,0,3,3,15,10,25,45,22,67,0.000333,0.103713,14,4355.937106,241.996506,311.138365,91.82264,3,4
0,0,3,3,15,10,25,45,22,67,0.000333,0.103713,14,4355.937106,241.996506,311.138365,91.82264,3,4
0,0,4,4,8,7,15,18,12,30,0.000333,0.039069,4,468.826871,26.045937,117.206718,43.651484,3,4
0,0,7,7,11,13,24,37,19,56,0.000333,0.085586,5,1283.7895,71.321639,256.7579,86.159464,5,4
0,0,5,5,8,11,19,20,16,36,0.000333,0.050975,4,611.701562,33.98342,152.92539,62.053748,3,4
0,0,3,3,9,9,18,18,13,31,0.000333,0.043089,4,517.0707,28.72615,129.267675,57.05865,2,4
0,0,32,32,20,49,69,168,96,264,0.000333,0.53755,10,16126.50457,895.91692,1612.650457,361.559344,12,4
0,0,7,7,8,12,20,30,20,50,0.000333,0.072032,4,864.385619,48.021423,216.096405,67.01955,1,4
0,0,8,8,13,14,27,39,25,64,0.000333,0.101438,6,1825.876801,101.4376,304.3128,101.408685,4,4
0,0,7,7,10,16,26,41,25,66,0.000333,0.10341,5,1551.145107,86.174728,310.229021,97.219281,3,4
0,0,7,7,11,13,24,37,19,56,0.000333,0.085586,5,1283.7895,71.321639,256.7579,86.159464,5,4
0,0,4,4,7,9,16,16,12,28,0.000333,0.037333,3,336,18.666667,112,48.180809,3,4
0,0,7,7,10,16,26,41,25,66,0.000333,0.10341,5,1551.145107,86.174728,310.229021,97.219281,3,4
0,0,59,59,18,54,72,313,208,521,0.000333,1.07151,27,86792.335,4821.796389,3214.530926,385.822575,5,4
0,0,6,6,12,12,24,32,19,51,0.000333,0.077944,6,1402.998525,77.944363,233.833088,86.0391,4,4
0,0,29,29,20,41,61,164,90,254,0.000333,0.502136,20,30128.14568,1673.785871,1506.407284,306.098194,12,4
0,0,4,4,7,6,13,16,9,25,0.000333,0.030837,3,277.532979,15.418499,92.510993,35.161259,3,4
0,0,6,6,14,10,24,35,18,53,0.000333,0.081001,7,1701.021088,94.501172,243.003013,86.52225,4,4
0,0,6,6,12,12,24,32,19,51,0.000333,0.077944,6,1402.998525,77.944363,233.833088,86.0391,4,4
0,0,31,31,17,35,52,156,82,238,0.000333,0.452235,16,21707.27445,1205.959691,1356.704653,249.011774,11,4
0,0,7,7,11,13,24,37,19,56,0.000333,0.085586,5,1283.7895,71.321639,256.7579,86.159464,5,4
0,0,4,4,8,7,15,18,12,30,0.000333,0.039069,4,468.826871,26.045937,117.206718,43.651484,3,4
0,0,5,5,9,15,24,25,20,45,0.000333,0.068774,4,825.29325,45.849625,206.323313,87.132684,1,4
0,0,7,7,11,13,24,37,19,56,0.000333,0.085586,5,1283.7895,71.321639,256.7579,86.159464,5,4
0,0,33,33,17,39,56,163,87,250,0.000333,0.483946,16,23229.41969,1290.523316,1451.838731,275.617555,12,4
0,0,4,4,8,7,15,18,12,30,0.000333,0.039069,4,468.826871,26.045937,117.206718,43.651484,3,4
0,0,7,7,11,13,24,37,19,56,0.000333,0.085586,5,1283.7895,71.321639,256.7579,86.159464,5,4
0,0,43,43,27,52,79,239,149,388,0.000333,0.815289,26,63592.54019,3532.918899,2445.86693,424.804828,20,4
0,0,12,12,10,14,24,58,35,93,0.000333,0.142134,10,4264.015126,236.889729,426.401513,86.52225,1,4
0,0,4,4,7,9,16,16,12,28,0.000333,0.037333,3,336,18.666667,112,48.180809,3,4
0,0,6,6,8,10,18,26,18,44,0.000333,0.061159,4,733.9068,40.7726,183.4767,57.219281,1,4
0,0,15,15,20,24,44,104,56,160,0.000333,0.29117,20,17470.18118,970.565621,873.509059,196.477662,9,4
0,0,4,4,7,9,16,16,12,28,0.000333,0.037333,3,336,18.666667,112,48.180809,3,4
0,0,6,6,14,10,24,35,18,53,0.000333,0.081001,7,1701.021088,94.501172,243.003013,86.52225,4,4
0,0,20,20,21,30,51,109,77,186,0.000333,0.35169,20,21101.42227,1172.301237,1055.071114,239.445384,10,4
0,0,6,6,14,10,24,35,18,53,0.000333,0.081001,7,1701.021088,94.501172,243.003013,86.52225,4,4
0,0,4,4,7,9,16,16,12,28,0.000333,0.037333,3,336,18.666667,112,48.180809,3,4
0,0,28,28,17,42,59,153,86,239,0.000333,0.468651,16,22495.22702,1249.734834,1405.951689,295.9642,11,4
0,0,6,6,14,10,24,35,18,53,0.000333,0.081001,7,1701.021088,94.501172,243.003013,86.52225,4,4
0,0,4,4,7,6,13,16,9,25,0.000333,0.030837,3,277.532979,15.418499,92.510993,35.161259,3,4
0,0,4,4,11,10,21,26,17,43,0.000333,0.062957,5,944.348246,52.463791,188.869649,71.273029,2,4
0,0,6,6,12,12,24,32,19,51,0.000333,0.077944,6,1402.998525,77.944363,233.833088,86.0391,4,4
0,0,12,12,14,23,37,58,45,103,0.000333,0.178858,7,3756.015877,208.667549,536.573697,157.344894,3,4
0,0,3,3,15,10,25,45,22,67,0.000333,0.103713,14,4355.937106,241.996506,311.138365,91.82264,3,4
0,0,6,6,12,12,24,32,19,51,0.000333,0.077944,6,1402.998525,77.944363,233.833088,86.0391,4,4
0,0,4,4,11,10,21,26,17,43,0.000333,0.062957,5,944.348246,52.463791,188.869649,71.273029,2,4
0,0,8,8,16,12,28,50,27,77,0.000333,0.123389,16,5922.661264,329.036737,370.166329,107.01955,6,4
0,0,39,39,17,52,69,195,117,312,0.000333,0.635287,16,30493.75409,1694.097449,1905.859631,365.909734,11,4
0,0,35,35,18,41,59,170,99,269,0.000333,0.527477,18,28483.75765,1582.43098,1582.43098,294.718282,12,4
0,0,23,23,22,33,55,159,86,245,0.000333,0.472144,22,31161.52886,1731.196048,1416.43313,264.572502,16,4
0,0,20,20,21,30,51,109,77,186,0.000333,0.35169,20,21101.42227,1172.301237,1055.071114,239.445384,10,4
0,0,32,32,17,37,54,160,85,245,0.000333,0.469982,16,22559.15901,1253.286612,1409.947438,262.236643,11,4
0,0,3,3,7,9,16,13,11,24,0.000333,0.032,3,288,16,96,48.180809,3,4
0,0,8,8,16,12,28,50,27,77,0.000333,0.123389,16,5922.661264,329.036737,370.166329,107.01955,6,4
0,0,3,3,7,9,16,13,11,24,0.000333,0.032,3,288,16,96,48.180809,3,4
0,0,7,7,8,12,20,30,20,50,0.000333,0.072032,4,864.385619,48.021423,216.096405,67.01955,1,4
0,0,4,4,7,9,16,16,12,28,0.000333,0.037333,3,336,18.666667,112,48.180809,3,4
0,0,30,30,20,44,64,159,91,250,0.000333,0.5,20,30000,1666.666667,1500,326.653553,11,4
0,0,28,28,17,41,58,152,85,237,0.000333,0.46278,16,22213.46393,1234.08133,1388.341496,289.1465,10,4
0,0,6,6,14,10,24,35,18,53,0.000333,0.081001,7,1701.021088,94.501172,243.003013,86.52225,4,4
0,0,20,20,21,30,51,109,77,186,0.000333,0.35169,20,21101.42227,1172.301237,1055.071114,239.445384,10,4
0,0,4,4,8,7,15,18,12,30,0.000333,0.039069,4,468.826871,26.045937,117.206718,43.651484,3,4
0,0,4,4,10,7,17,22,10,32,0.000333,0.0436,5,653.994055,36.333003,130.798811,52.870765,3,4
0,0,8,8,16,12,28,50,27,77,0.000333,0.123389,16,5922.661264,329.036737,370.166329,107.01955,6,4
0,0,6,6,14,10,24,35,18,53,0.000333,0.081001,7,1701.021088,94.501172,243.003013,86.52225,4,4
0,0,16,16,17,25,42,140,48,188,0.000333,0.337919,8,8110.045404,450.558078,1013.755675,185.583273,8,4
0,0,4,4,7,6,13,16,9,25,0.000333,0.030837,3,277.532979,15.418499,92.510993,35.161259,3,4
0,0,18,18,19,28,47,143,68,211,0.000333,0.390673,18,21096.32846,1172.018248,1172.018248,215.316561,9,4
0,0,17,17,19,26,45,94,52,146,0.000333,0.26727,18,14432.58994,801.810552,801.810552,202.922055,13,4
0,0,3,3,9,9,18,18,13,31,0.000333,0.043089,4,517.0707,28.72615,129.267675,57.05865,2,4
0,0,7,7,11,13,24,37,19,56,0.000333,0.085586,5,1283.7895,71.321639,256.7579,86.159464,5,4
0,0,3,3,9,9,18,18,13,31,0.000333,0.043089,4,517.0707,28.72615,129.267675,57.05865,2,4
0,0,6,6,12,12,24,32,19,51,0.000333,0.077944,6,1402.998525,77.944363,233.833088,86.0391,4,4
0,0,31,31,17,34,51,153,81,234,0.000333,0.442449,16,21237.56048,1179.864471,1327.34753,242.460605,12,4
0,0,3,3,15,10,25,45,22,67,0.000333,0.103713,14,4355.937106,241.996506,311.138365,91.82264,3,4
0,0,18,18,17,26,43,96,52,148,0.000333,0.267696,16,12849.39494,713.855274,803.087184,191.698301,15,4
0,0,4,4,7,9,16,16,12,28,0.000333,0.037333,3,336,18.666667,112,48.180809,3,4
0,0,6,6,7,10,17,25,16,41,0.000333,0.055862,3,502.757929,27.930996,167.585976,52.870765,1,4
0,0,5,5,8,15,23,24,20,44,0.000333,0.066346,4,796.146904,44.230384,199.036726,82.603359,1,4
0,0,4,4,8,7,15,18,12,30,0.000333,0.039069,4,468.826871,26.045937,117.206718,43.651484,3,4
0,0,7,7,11,13,24,37,19,56,0.000333,0.085586,5,1283.7895,71.321639,256.7579,86.159464,5,4
0,0,22,22,21,34,55,112,70,182,0.000333,0.350736,20,21044.14936,1169.119409,1052.207468,265.212402,10,4
0,0,4,4,8,11,19,17,15,32,0.000333,0.045311,4,543.734722,30.207485,135.93368,62.053748,3,4
0,0,4,4,8,7,15,18,12,30,0.000333,0.039069,4,468.826871,26.045937,117.206718,43.651484,3,4
0,0,7,7,11,13,24,37,19,56,0.000333,0.085586,5,1283.7895,71.321639,256.7579,86.159464,5,4
0,0,38,38,21,43,64,200,122,322,0.000333,0.644,20,38640,2146.666667,1932,325.56805,18,4
0,0,7,7,11,13,24,37,19,56,0.000333,0.085586,5,1283.7895,71.321639,256.7579,86.159464,5,4
0,0,4,4,8,7,15,18,12,30,0.000333,0.039069,4,468.826871,26.045937,117.206718,43.651484,3,4
0,0,20,20,20,33,53,158,77,235,0.000333,0.448687,20,26921.22614,1495.623674,1346.061307,252.903568,9,4
0,0,28,28,17,42,59,153,86,239,0.000333,0.468651,16,22495.22702,1249.734834,1405.951689,295.9642,10,4
0,0,8,8,16,12,28,50,27,77,0.000333,0.123389,16,5922.661264,329.036737,370.166329,107.01955,6,4
0,0,20,20,21,30,51,109,77,186,0.000333,0.35169,20,21101.42227,1172.301237,1055.071114,239.445384,10,4
0,0,4,4,7,9,16,16,12,28,0.000333,0.037333,3,336,18.666667,112,48.180809,3,4
0,0,3,3,9,9,18,18,13,31,0.000333,0.043089,4,517.0707,28.72615,129.267675,57.05865,2,4
0,0,5,5,8,15,23,24,20,44,0.000333,0.066346,4,796.146904,44.230384,199.036726,82.603359,1,4
0,0,6,6,14,10,24,35,18,53,0.000333,0.081001,7,1701.021088,94.501172,243.003013,86.52225,4,4
0,0,20,20,19,37,56,136,71,207,0.000333,0.400707,9,10819.10222,601.061234,1202.122469,273.460397,9,4
0,0,4,4,7,9,16,16,12,28,0.000333,0.037333,3,336,18.666667,112,48.180809,3,4
0,0,3,3,15,10,25,45,22,67,0.000333,0.103713,14,4355.937106,241.996506,311.138365,91.82264,3,4
0,0,37,37,21,52,73,204,119,323,0.000333,0.666438,20,39986.26665,2221.459258,1999.313333,388.661531,12,4
0,0,24,24,18,37,55,161,81,242,0.000333,0.466363,18,25183.60291,1399.089051,1399.089051,267.808425,9,4
0,0,32,32,17,37,54,158,85,243,0.000333,0.466146,16,22375.00261,1243.0557,1398.437663,262.236643,12,4
0,0,20,20,21,30,51,109,77,186,0.000333,0.35169,20,21101.42227,1172.301237,1055.071114,239.445384,10,4
0,0,4,4,7,6,13,16,9,25,0.000333,0.030837,3,277.532979,15.418499,92.510993,35.161259,3,4
0,0,4,4,7,6,13,16,9,25,0.000333,0.030837,3,277.532979,15.418499,92.510993,35.161259,3,4
0,0,7,7,8,12,20,30,20,50,0.000333,0.072032,4,864.385619,48.021423,216.096405,67.01955,1,4
0,0,20,20,21,30,51,109,77,186,0.000333,0.35169,20,21101.42227,1172.301237,1055.071114,239.445384,10,4
0,0,4,4,7,6,13,16,9,25,0.000333,0.030837,3,277.532979,15.418499,92.510993,35.161259,3,4
0,0,4,4,7,6,13,16,9,25,0.000333,0.030837,3,277.532979,15.418499,92.510993,35.161259,3,4
0,0,3,3,15,10,25,45,22,67,0.000333,0.103713,14,4355.937106,241.996506,311.138365,91.82264,3,4
0,0,8,8,14,12,26,41,24,65,0.000333,0.101843,14,4277.400144,237.633341,305.528582,96.322519,4,4
0,0,3,3,7,9,16,13,11,24,0.000333,0.032,3,288,16,96,48.180809,3,4
0,0,6,6,14,10,24,35,18,53,0.000333,0.081001,7,1701.021088,94.501172,243.003013,86.52225,4,4
0,0,4,4,8,11,19,17,15,32,0.000333,0.045311,4,543.734722,30.207485,135.93368,62.053748,3,4
0,0,7,7,10,16,26,41,25,66,0.000333,0.10341,5,1551.145107,86.174728,310.229021,97.219281,3,4
0,0,8,8,16,12,28,50,27,77,0.000333,0.123389,16,5922.661264,329.036737,370.166329,107.01955,6,4
0,0,8,8,16,12,28,50,27,77,0.000333,0.123389,16,5922.661264,329.036737,370.166329,107.01955,6,4
0,0,6,6,12,12,24,32,19,51,0.000333,0.077944,6,1402.998525,77.944363,233.833088,86.0391,4,4
0,0,4,4,10,7,17,22,10,32,0.000333,0.0436,5,653.994055,36.333003,130.798811,52.870765,3,4
0,0,4,4,8,7,15,18,12,30,0.000333,0.039069,4,468.826871,26.045937,117.206718,43.651484,3,4
0,0,8,8,16,12,28,50,27,77,0.000333,0.123389,16,5922.661264,329.036737,370.166329,107.01955,6,4
0,0,20,20,21,30,51,109,77,186,0.000333,0.35169,20,21101.42227,1172.301237,1055.071114,239.445384,10,4
0,0,4,4,9,12,21,23,18,41,0.000333,0.060028,4,720.340057,40.018892,180.085014,71.548875,2,4
0,0,3,3,9,9,18,18,13,31,0.000333,0.043089,4,517.0707,28.72615,129.267675,57.05865,2,4
0,0,13,13,15,19,34,79,40,119,0.000333,0.201803,14,8475.713094,470.87295,605.408078,139.313982,18,4
0,0,9,9,11,19,30,47,31,78,0.000333,0.127579,5,1913.687332,106.315963,382.737466,118.764371,3,4
0,0,20,20,21,30,51,109,77,186,0.000333,0.35169,20,21101.42227,1172.301237,1055.071114,239.445384,10,4
0,0,26,26,19,35,54,147,78,225,0.000333,0.431617,18,23307.29438,1294.849688,1294.849688,260.235528,17,4
0,0,3,3,7,9,16,13,11,24,0.000333,0.032,3,288,16,96,48.180809,3,4
0,0,3,3,15,10,25,45,22,67,0.000333,0.103713,14,4355.937106,241.996506,311.138365,91.82264,3,4
0,0,31,31,17,38,55,156,88,244,0.000333,0.470217,16,22570.42832,1253.912685,1410.65177,268.908114,11,4
0,0,20,20,21,30,51,109,77,186,0.000333,0.35169,20,21101.42227,1172.301237,1055.071114,239.445384,10,4
0,0,7,7,10,16,26,41,25,66,0.000333,0.10341,5,1551.145107,86.174728,310.229021,97.219281,3,4
0,0,8,8,14,12,26,41,24,65,0.000333,0.101843,14,4277.400144,237.633341,305.528582,96.322519,4,4
0,0,6,6,14,10,24,35,18,53,0.000333,0.081001,7,1701.021088,94.501172,243.003013,86.52225,4,4
0,0,4,4,7,6,13,16,9,25,0.000333,0.030837,3,277.532979,15.418499,92.510993,35.161259,3,4
0,0,4,4,10,7,17,22,10,32,0.000333,0.0436,5,653.994055,36.333003,130.798811,52.870765,3,4
0,0,4,4,8,7,15,18,12,30,0.000333,0.039069,4,468.826871,26.045937,117.206718,43.651484,3,4
0,0,38,38,21,43,64,200,122,322,0.000333,0.644,20,38640,2146.666667,1932,325.56805,13,4
0,0,39,39,24,52,76,225,136,361,0.000333,0.751834,24,54132.04398,3007.335776,2255.501832,406.461965,18,4
0,0,9,9,11,17,28,47,29,76,0.000333,0.121786,5,1826.79487,101.488604,365.358974,107.540616,3,4
0,0,8,8,16,12,28,50,27,77,0.000333,0.123389,16,5922.661264,329.036737,370.166329,107.01955,6,4
0,0,35,35,18,40,58,171,94,265,0.000333,0.517455,18,27942.56935,1552.364964,1552.364964,287.935774,12,4
0,0,4,4,7,6,13,16,9,25,0.000333,0.030837,3,277.532979,15.418499,92.510993,35.161259,3,4
0,0,30,30,17,32,49,150,79,229,0.000333,0.42859,16,20572.29687,1142.905382,1285.768554,229.486868,11,4
0,0,9,9,16,23,39,65,42,107,0.000333,0.188513,8,4524.304299,251.350239,565.538037,168.041925,2,4
0,0,4,4,10,7,17,22,10,32,0.000333,0.0436,5,653.994055,36.333003,130.798811,52.870765,3,4
0,0,4,4,7,9,16,16,12,28,0.000333,0.037333,3,336,18.666667,112,48.180809,3,4
0,0,4,4,8,7,15,18,12,30,0.000333,0.039069,4,468.826871,26.045937,117.206718,43.651484,3,4
0,0,5,5,8,11,19,20,16,36,0.000333,0.050975,4,611.701562,33.98342,152.92539,62.053748,3,4
0,0,4,4,8,7,15,18,12,30,0.000333,0.039069,4,468.826871,26.045937,117.206718,43.651484,3,4
0,0,3,3,7,9,16,13,11,24,0.000333,0.032,3,288,16,96,48.180809,3,4
0,0,3,3,7,9,16,13,11,24,0.000333,0.032,3,288,16,96,48.180809,3,4
0,0,3,3,7,9,16,13,11,24,0.000333,0.032,3,288,16,96,48.180809,3,4
0,0,4,4,7,9,16,16,12,28,0.000333,0.037333,3,336,18.666667,112,48.180809,3,4
0,0,4,4,11,10,21,26,17,43,0.000333,0.062957,5,944.348246,52.463791,188.869649,71.273029,2,4
0,0,5,5,8,11,19,20,16,36,0.000333,0.050975,4,611.701562,33.98342,152.92539,62.053748,3,4
0,0,3,3,7,9,16,13,11,24,0.000333,0.032,3,288,16,96,48.180809,3,4
0,0,4,4,7,6,13,16,9,25,0.000333,0.030837,3,277.532979,15.418499,92.510993,35.161259,3,4
0,0,32,32,18,52,70,177,96,273,0.000333,0.557765,9,15059.64837,836.647132,1673.294264,371.481515,11,4
0,0,7,7,10,16,26,41,25,66,0.000333,0.10341,5,1551.145107,86.174728,310.229021,97.219281,3,4
0,0,8,8,10,16,26,49,30,79,0.000333,0.123778,5,1856.673689,103.148538,371.334738,97.219281,4,4
0,0,3,3,15,10,25,45,22,67,0.000333,0.103713,14,4355.937106,241.996506,311.138365,91.82264,3,4
0,0,4,4,7,6,13,16,9,25,0.000333,0.030837,3,277.532979,15.418499,92.510993,35.161259,3,4
0,0,44,44,18,44,62,237,137,374,0.000333,0.74229,27,60125.47434,3340.30413,2226.86942,315.273641,15,4
0,0,4,4,10,7,17,22,10,32,0.000333,0.0436,5,653.994055,36.333003,130.798811,52.870765,3,4
0,0,4,4,8,7,15,18,12,30,0.000333,0.039069,4,468.826871,26.045937,117.206718,43.651484,3,4
0,0,30,30,21,41,62,175,92,267,0.000333,0.529923,20,31795.4083,1766.411572,1589.770415,311.898298,18,4
0,0,4,4,10,12,22,26,14,40,0.000333,0.059459,5,891.886324,49.54924,178.377265,76.238831,4,4
0,0,4,4,8,7,15,18,12,30,0.000333,0.039069,4,468.826871,26.045937,117.206718,43.651484,3,4
0,0,4,4,10,7,17,22,10,32,0.000333,0.0436,5,653.994055,36.333003,130.798811,52.870765,3,4
0,0,4,4,8,7,15,18,12,30,0.000333,0.039069,4,468.826871,26.045937,117.206718,43.651484,3,4
0,0,6,6,14,10,24,35,18,53,0.000333,0.081001,7,1701.021088,94.501172,243.003013,86.52225,4,4
0,0,6,6,14,10,24,35,18,53,0.000333,0.081001,7,1701.021088,94.501172,243.003013,86.52225,4,4
0,0,35,35,19,48,67,227,114,341,0.000333,0.689512,18,37233.65545,2068.536414,2068.536414,348.788823,16,4
0,0,30,30,17,47,64,161,92,253,0.000333,0.506,8,12144,674.666667,1518,330.552544,11,4
0,0,6,6,12,12,24,32,19,51,0.000333,0.077944,6,1402.998525,77.944363,233.833088,86.0391,4,4
0,0,31,31,17,37,54,155,87,242,0.000333,0.464228,16,22282.92441,1237.940245,1392.682776,262.236643,12,4
0,0,4,4,7,6,13,16,9,25,0.000333,0.030837,3,277.532979,15.418499,92.510993,35.161259,3,4
0,0,3,3,15,10,25,45,22,67,0.000333,0.103713,14,4355.937106,241.996506,311.138365,91.82264,3,4
0,0,31,31,20,46,66,164,93,257,0.000333,0.517803,20,31068.18577,1726.010321,1553.409289,340.522412,11,4
0,0,20,20,21,30,51,109,77,186,0.000333,0.35169,20,21101.42227,1172.301237,1055.071114,239.445384,10,4
0,0,5,5,10,14,24,24,23,47,0.000333,0.071831,5,1077.466188,59.859233,215.493238,86.52225,2,4
0,0,43,43,18,48,66,222,148,370,0.000333,0.745475,27,60383.49725,3354.638736,2236.425824,343.13685,3,4
0,0,6,6,14,10,24,35,18,53,0.000333,0.081001,7,1701.021088,94.501172,243.003013,86.52225,4,4
0,0,4,4,9,12,21,25,17,42,0.000333,0.061492,4,737.909327,40.994963,184.477332,71.548875,1,4
0,0,5,5,8,11,19,20,16,36,0.000333,0.050975,4,611.701562,33.98342,152.92539,62.053748,3,4
0,0,4,4,9,12,21,25,17,42,0.000333,0.061492,4,737.909327,40.994963,184.477332,71.548875,1,4
0,0,7,7,11,13,24,37,19,56,0.000333,0.085586,5,1283.7895,71.321639,256.7579,86.159464,5,4
0,0,4,4,7,9,16,16,12,28,0.000333,0.037333,3,336,18.666667,112,48.180809,3,4
0,0,4,4,7,6,13,16,9,25,0.000333,0.030837,3,277.532979,15.418499,92.510993,35.161259,3,4
0,0,20,20,21,30,51,109,77,186,0.000333,0.35169,20,21101.42227,1172.301237,1055.071114,239.445384,10,4
0,0,4,4,7,6,13,16,9,25,0.000333,0.030837,3,277.532979,15.418499,92.510993,35.161259,3,4
0,0,7,7,10,16,26,41,25,66,0.000333,0.10341,5,1551.145107,86.174728,310.229021,97.219281,3,4
0,0,20,20,21,30,51,109,77,186,0.000333,0.35169,20,21101.42227,1172.301237,1055.071114,239.445384,10,4
0,0,35,35,18,42,60,171,100,271,0.000333,0.533589,18,28813.81233,1600.767351,1600.767351,301.535982,13,4
0,0,43,43,25,52,77,239,145,384,0.000333,0.802149,24,57754.70476,3208.594709,2406.446032,412.51927,21,4
0,0,4,4,7,6,13,16,9,25,0.000333,0.030837,3,277.532979,15.418499,92.510993,35.161259,3,4
0,0,34,34,21,49,70,195,111,306,0.000333,0.625187,20,37511.21206,2083.956226,1875.560603,367.359448,12,4
0,0,20,20,21,30,51,109,77,186,0.000333,0.35169,20,21101.42227,1172.301237,1055.071114,239.445384,10,4
0,0,6,6,14,10,24,35,18,53,0.000333,0.081001,7,1701.021088,94.501172,243.003013,86.52225,4,4
0,0,3,3,7,9,16,13,11,24,0.000333,0.032,3,288,16,96,48.180809,3,4
0,0,6,6,14,10,24,35,18,53,0.000333,0.081001,7,1701.021088,94.501172,243.003013,86.52225,4,4
0,0,5,5,9,15,24,25,20,45,0.000333,0.068774,4,825.29325,45.849625,206.323313,87.132684,1,4
0,0,31,31,20,46,66,162,93,255,0.000333,0.513774,20,30826.41001,1712.578334,1541.3205,340.522412,11,4
0,0,4,4,7,6,13,16,9,25,0.000333,0.030837,3,277.532979,15.418499,92.510993,35.161259,3,4
0,0,19,19,19,33,52,107,63,170,0.000333,0.323025,9,8721.672769,484.537376,969.074752,247.175629,8,4
0,0,31,31,20,47,67,165,94,259,0.000333,0.523706,20,31422.34201,1745.685667,1571.1171,347.504238,11,4
0,0,3,3,15,10,25,45,22,67,0.000333,0.103713,14,4355.937106,241.996506,311.138365,91.82264,3,4
0,0,60,60,17,50,67,311,202,513,0.000333,1.037301,32,99580.92015,5532.273342,3111.903755,351.679678,4,4
0,0,7,7,11,13,24,37,19,56,0.000333,0.085586,5,1283.7895,71.321639,256.7579,86.159464,5,4
0,0,4,4,8,7,15,18,12,30,0.000333,0.039069,4,468.826871,26.045937,117.206718,43.651484,3,4
0,0,35,35,19,50,69,227,114,341,0.000333,0.694336,18,37494.12312,2083.00684,2083.00684,362.903432,12,4
0,0,30,30,17,32,49,150,79,229,0.000333,0.42859,16,20572.29687,1142.905382,1285.768554,229.486868,11,4
0,0,26,26,19,45,64,161,91,252,0.000333,0.504,18,27216,1512,1512,327.844012,8,4
0,0,25,25,20,35,55,172,88,260,0.000333,0.501051,20,30063.07051,1670.170584,1503.153526,265.963467,11,4
0,0,4,4,7,6,13,16,9,25,0.000333,0.030837,3,277.532979,15.418499,92.510993,35.161259,3,4
0,0,5,5,8,9,17,20,13,33,0.000333,0.044962,4,539.545095,29.974728,134.886274,52.529325,3,4
0,0,4,4,7,9,16,16,12,28,0.000333,0.037333,3,336,18.666667,112,48.180809,3,4
0,0,6,6,9,12,21,31,21,52,0.000333,0.076134,4,913.602024,50.755668,228.400506,71.548875,1,4
0,0,42,42,19,50,69,216,130,346,0.000333,0.704516,18,38043.89032,2113.549462,2113.549462,362.903432,16,4
0,0,8,8,15,12,27,50,25,75,0.000333,0.118872,14,4992.631877,277.368438,356.616563,101.622909,9,4
0,0,7,7,10,16,26,41,25,66,0.000333,0.10341,5,1551.145107,86.174728,310.229021,97.219281,3,4
0,0,8,8,15,11,26,41,22,63,0.000333,0.098709,14,4145.787831,230.321546,296.127702,96.657107,4,4
0,0,7,7,8,12,20,30,20,50,0.000333,0.072032,4,864.385619,48.021423,216.096405,67.01955,1,4
0,0,4,4,13,13,26,26,16,42,0.000333,0.065806,6,1184.510809,65.806156,197.418468,96.211433,4,4
0,0,3,3,7,9,16,13,11,24,0.000333,0.032,3,288,16,96,48.180809,3,4
0,0,3,3,15,10,25,45,22,67,0.000333,0.103713,14,4355.937106,241.996506,311.138365,91.82264,3,4
0,0,31,31,17,38,55,156,88,244,0.000333,0.470217,16,22570.42832,1253.912685,1410.65177,268.908114,11,4
0,0,6,6,14,10,24,35,18,53,0.000333,0.081001,7,1701.021088,94.501172,243.003013,86.52225,4,4
0,0,6,6,8,10,18,26,18,44,0.000333,0.061159,4,733.9068,40.7726,183.4767,57.219281,1,4
0,0,6,6,12,12,24,32,19,51,0.000333,0.077944,6,1402.998525,77.944363,233.833088,86.0391,4,4
0,0,23,23,18,33,51,145,74,219,0.000333,0.414087,18,22360.7007,1242.26115,1242.26115,241.523656,10,4
0,0,4,4,7,6,13,16,9,25,0.000333,0.030837,3,277.532979,15.418499,92.510993,35.161259,3,4
0,0,3,3,7,9,16,13,11,24,0.000333,0.032,3,288,16,96,48.180809,3,4
0,0,4,4,10,7,17,22,10,32,0.000333,0.0436,5,653.994055,36.333003,130.798811,52.870765,3,4
0,0,4,4,8,7,15,18,12,30,0.000333,0.039069,4,468.826871,26.045937,117.206718,43.651484,3,4
0,0,8,8,16,12,28,50,27,77,0.000333,0.123389,16,5922.661264,329.036737,370.166329,107.01955,6,4
0,0,5,5,9,15,24,25,20,45,0.000333,0.068774,4,825.29325,45.849625,206.323313,87.132684,1,4
0,0,32,32,20,48,68,168,96,264,0.000333,0.535697,20,32141.8038,1785.655767,1607.09019,354.516762,11,4
0,0,9,9,11,19,30,47,31,78,0.000333,0.127579,5,1913.687332,106.315963,382.737466,118.764371,3,4
0,0,20,20,21,30,51,109,77,186,0.000333,0.35169,20,21101.42227,1172.301237,1055.071114,239.445384,10,4
0,0,42,42,24,51,75,229,143,372,0.000333,0.772374,24,55610.89327,3089.49407,2317.120553,399.332792,18,4
0,0,30,30,17,46,63,160,91,251,0.000333,0.500099,8,12002.37809,666.798783,1500.297261,323.570718,10,4
0,0,3,3,9,9,18,18,13,31,0.000333,0.043089,4,517.0707,28.72615,129.267675,57.05865,2,4
0,0,8,8,10,16,26,49,30,79,0.000333,0.123778,5,1856.673689,103.148538,371.334738,97.219281,4,4
0,0,4,4,7,6,13,16,9,25,0.000333,0.030837,3,277.532979,15.418499,92.510993,35.161259,3,4
0,0,30,30,20,44,64,159,91,250,0.000333,0.5,20,30000,1666.666667,1500,326.653553,11,4
0,0,6,6,14,10,24,35,18,53,0.000333,0.081001,7,1701.021088,94.501172,243.003013,86.52225,4,4
0,0,23,23,17,32,49,168,74,242,0.000333,0.45292,16,21740.15652,1207.786473,1358.759782,229.486868,10,4
0,0,7,7,10,16,26,41,25,66,0.000333,0.10341,5,1551.145107,86.174728,310.229021,97.219281,3,4
0,0,14,14,16,22,38,79,41,120,0.000333,0.209917,8,5038.010413,279.889467,629.751302,162.107496,8,4
0,0,25,25,18,38,56,150,83,233,0.000333,0.451038,18,24356.04654,1353.113697,1353.113697,274.479896,13,4
0,0,16,16,16,25,41,377,47,424,0.000333,0.757201,8,18172.8164,1009.600911,2271.60205,180.096405,8,4
0,0,7,7,10,16,26,41,25,66,0.000333,0.10341,5,1551.145107,86.174728,310.229021,97.219281,3,4
0,0,12,12,12,17,29,70,42,112,0.000333,0.181365,12,6529.126457,362.729248,544.093871,112.506418,5,4
0,0,6,6,9,13,22,31,19,50,0.000333,0.074324,4,891.886324,49.54924,222.971581,76.635041,1,4
0,0,12,12,12,17,29,70,42,112,0.000333,0.181365,12,6529.126457,362.729248,544.093871,112.506418,5,4
0,0,14,14,21,22,43,100,53,153,0.000333,0.27674,20,16604.37015,922.465008,830.218507,190.346161,7,4
0,0,32,32,17,39,56,158,89,247,0.000333,0.478139,16,22950.66665,1275.037036,1434.416666,275.617555,13,4
0,0,6,6,14,10,24,35,18,53,0.000333,0.081001,7,1701.021088,94.501172,243.003013,86.52225,4,4
0,0,5,5,8,15,23,24,20,44,0.000333,0.066346,4,796.146904,44.230384,199.036726,82.603359,1,4
0,0,3,3,15,10,25,45,22,67,0.000333,0.103713,14,4355.937106,241.996506,311.138365,91.82264,3,4
0,0,19,19,21,28,49,120,71,191,0.000333,0.35747,20,21448.19161,1191.5662,1072.40958,226.844604,4,4
0,0,6,6,14,10,24,35,18,53,0.000333,0.081001,7,1701.021088,94.501172,243.003013,86.52225,4,4
0,0,20,20,21,30,51,109,77,186,0.000333,0.35169,20,21101.42227,1172.301237,1055.071114,239.445384,10,4
0,0,6,6,12,12,24,32,19,51,0.000333,0.077944,6,1402.998525,77.944363,233.833088,86.0391,4,4
0,0,25,25,20,33,53,186,90,276,0.000333,0.526969,20,31618.12091,1756.562273,1580.906045,252.903568,14,4
0,0,31,31,17,35,52,156,82,238,0.000333,0.452235,16,21707.27445,1205.959691,1356.704653,249.011774,11,4
0,0,3,3,7,9,16,13,11,24,0.000333,0.032,3,288,16,96,48.180809,3,4
0,0,5,5,8,15,23,24,20,44,0.000333,0.066346,4,796.146904,44.230384,199.036726,82.603359,1,4
0,0,9,9,16,23,39,65,42,107,0.000333,0.188513,8,4524.304299,251.350239,565.538037,168.041925,2,4
0,0,5,5,8,15,23,24,20,44,0.000333,0.066346,4,796.146904,44.230384,199.036726,82.603359,1,4
0,0,6,6,12,12,24,32,19,51,0.000333,0.077944,6,1402.998525,77.944363,233.833088,86.0391,4,4
0,0,6,6,12,12,24,32,19,51,0.000333,0.077944,6,1402.998525,77.944363,233.833088,86.0391,4,4
0,0,6,6,12,12,24,32,19,51,0.000333,0.077944,6,1402.998525,77.944363,233.833088,86.0391,4,4
0,0,5,5,8,14,22,24,19,43,0.000333,0.063919,4,767.022238,42.612347,191.75556,77.302969,1,4
0,0,3,3,9,9,18,18,13,31,0.000333,0.043089,4,517.0707,28.72615,129.267675,57.05865,2,4
0,0,32,32,20,58,78,240,122,362,0.000333,0.758439,20,45506.31207,2528.128448,2275.315603,426.20146,9,4
0,0,20,20,21,30,51,109,77,186,0.000333,0.35169,20,21101.42227,1172.301237,1055.071114,239.445384,10,4
0,0,8,8,12,13,25,38,25,63,0.000333,0.097521,6,1755.37764,97.52098,292.56294,91.125266,4,4
0,0,33,33,21,46,67,195,105,300,0.000333,0.606609,20,36396.53514,2022.02973,1819.826757,346.322516,14,4
0,0,3,3,15,10,25,45,22,67,0.000333,0.103713,14,4355.937106,241.996506,311.138365,91.82264,3,4
0,0,3,3,15,10,25,45,22,67,0.000333,0.103713,14,4355.937106,241.996506,311.138365,91.82264,3,4
0,0,7,7,10,16,26,41,25,66,0.000333,0.10341,5,1551.145107,86.174728,310.229021,97.219281,3,4
0,0,5,5,9,15,24,25,20,45,0.000333,0.068774,4,825.29325,45.849625,206.323313,87.132684,1,4
0,0,21,21,17,28,45,132,62,194,0.000333,0.35514,16,17046.71201,947.039556,1065.419501,204.092806,10,4
0,0,12,12,10,14,24,58,35,93,0.000333,0.142134,10,4264.015126,236.889729,426.401513,86.52225,1,4
0,0,3,3,9,9,18,18,13,31,0.000333,0.043089,4,517.0707,28.72615,129.267675,57.05865,2,4
0,0,7,7,10,16,26,41,25,66,0.000333,0.10341,5,1551.145107,86.174728,310.229021,97.219281,3,4
0,0,4,4,10,12,22,24,18,42,0.000333,0.062432,5,936.48064,52.026702,187.296128,76.238831,2,4
0,0,6,6,9,13,22,31,19,50,0.000333,0.074324,4,891.886324,49.54924,222.971581,76.635041,1,4
0,0,4,4,8,7,15,18,12,30,0.000333,0.039069,4,468.826871,26.045937,117.206718,43.651484,3,4
0,0,4,4,10,7,17,22,10,32,0.000333,0.0436,5,653.994055,36.333003,130.798811,52.870765,3,4
0,0,9,9,14,15,29,41,28,69,0.000333,0.111734,7,2346.404821,130.355823,335.200689,111.906328,4,4
0,0,5,5,9,15,24,25,20,45,0.000333,0.068774,4,825.29325,45.849625,206.323313,87.132684,1,4
0,0,4,4,7,9,16,16,12,28,0.000333,0.037333,3,336,18.666667,112,48.180809,3,4
0,0,34,34,21,50,71,238,118,356,0.000333,0.72977,20,43786.19949,2432.566638,2189.309975,374.431475,14,4
0,0,3,3,15,10,25,45,22,67,0.000333,0.103713,14,4355.937106,241.996506,311.138365,91.82264,3,4
0,0,4,4,7,9,16,16,12,28,0.000333,0.037333,3,336,18.666667,112,48.180809,3,4
0,0,4,4,7,9,16,16,12,28,0.000333,0.037333,3,336,18.666667,112,48.180809,3,4
0,0,3,3,15,10,25,45,22,67,0.000333,0.103713,14,4355.937106,241.996506,311.138365,91.82264,3,4
0,0,31,31,17,34,51,155,81,236,0.000333,0.446231,16,21419.07809,1189.948783,1338.692381,242.460605,11,4
0,0,4,4,10,7,17,22,10,32,0.000333,0.0436,5,653.994055,36.333003,130.798811,52.870765,3,4
0,0,34,34,21,58,79,203,116,319,0.000333,0.670302,20,40218.12117,2234.340065,2010.906059,432.001564,14,4
0,0,17,17,22,28,50,113,62,175,0.000333,0.329225,22,21728.84633,1207.158129,987.674833,232.713433,9,4
0,0,5,5,8,14,22,24,19,43,0.000333,0.063919,4,767.022238,42.612347,191.75556,77.302969,1,4
0,0,4,4,7,6,13,16,9,25,0.000333,0.030837,3,277.532979,15.418499,92.510993,35.161259,3,4
0,0,12,12,14,23,37,58,45,103,0.000333,0.178858,7,3756.015877,208.667549,536.573697,157.344894,3,4
0,0,7,7,10,16,26,41,25,66,0.000333,0.10341,5,1551.145107,86.174728,310.229021,97.219281,3,4
0,0,35,35,18,40,58,170,95,265,0.000333,0.517455,18,27942.56935,1552.364964,1552.364964,287.935774,14,4
0,0,6,6,12,12,24,32,19,51,0.000333,0.077944,6,1402.998525,77.944363,233.833088,86.0391,4,4
0,0,28,28,17,42,59,153,86,239,0.000333,0.468651,16,22495.22702,1249.734834,1405.951689,295.9642,10,4
0,0,7,7,10,16,26,41,25,66,0.000333,0.10341,5,1551.145107,86.174728,310.229021,97.219281,3,4
0,0,27,27,17,39,56,147,83,230,0.000333,0.445231,16,21371.06611,1187.281451,1335.691632,275.617555,10,4
0,0,7,7,10,16,26,41,25,66,0.000333,0.10341,5,1551.145107,86.174728,310.229021,97.219281,3,4
0,0,44,44,21,51,72,255,148,403,0.000333,0.828827,20,49729.59551,2762.755306,2486.479776,381.532358,25,4
0,0,3,3,15,10,25,45,22,67,0.000333,0.103713,14,4355.937106,241.996506,311.138365,91.82264,3,4
0,0,32,32,20,48,68,168,96,264,0.000333,0.535697,20,32141.8038,1785.655767,1607.09019,354.516762,11,4
0,0,9,9,10,18,28,45,31,76,0.000333,0.121786,5,1826.79487,101.488604,365.358974,108.277931,3,4
0,0,4,4,7,9,16,16,12,28,0.000333,0.037333,3,336,18.666667,112,48.180809,3,4
0,0,5,5,9,15,24,25,20,45,0.000333,0.068774,4,825.29325,45.849625,206.323313,87.132684,1,4
0,0,17,17,17,26,43,82,49,131,0.000333,0.236947,8,5686.725463,315.929192,710.840683,191.698301,10,4
0,0,4,4,13,13,26,26,16,42,0.000333,0.065806,6,1184.510809,65.806156,197.418468,96.211433,4,4
0,0,6,6,14,10,24,35,18,53,0.000333,0.081001,7,1701.021088,94.501172,243.003013,86.52225,4,4
0,0,20,20,21,30,51,109,77,186,0.000333,0.35169,20,21101.42227,1172.301237,1055.071114,239.445384,10,4
0,0,6,6,8,10,18,26,18,44,0.000333,0.061159,4,733.9068,40.7726,183.4767,57.219281,1,4
0,0,20,20,20,34,54,113,65,178,0.000333,0.341457,10,10243.69975,569.094431,1024.369975,259.412299,8,4
0,0,3,3,9,9,18,18,13,31,0.000333,0.043089,4,517.0707,28.72615,129.267675,57.05865,2,4
0,0,9,9,16,23,39,65,42,107,0.000333,0.188513,8,4524.304299,251.350239,565.538037,168.041925,2,4
0,0,33,33,18,43,61,169,95,264,0.000333,0.521905,18,28182.86383,1565.714657,1565.714657,308.388034,12,4
0,0,7,7,10,16,26,41,25,66,0.000333,0.10341,5,1551.145107,86.174728,310.229021,97.219281,3,4
0,0,10,10,10,21,31,46,35,81,0.000333,0.133763,5,2006.449506,111.469417,401.289901,125.457947,3,4
0,0,6,6,14,10,24,35,18,53,0.000333,0.081001,7,1701.021088,94.501172,243.003013,86.52225,4,4
0,0,3,3,15,10,25,45,22,67,0.000333,0.103713,14,4355.937106,241.996506,311.138365,91.82264,3,4
0,0,12,12,14,23,37,58,45,103,0.000333,0.178858,7,3756.015877,208.667549,536.573697,157.344894,3,4
0,0,3,3,15,10,25,45,22,67,0.000333,0.103713,14,4355.937106,241.996506,311.138365,91.82264,3,4
0,0,3,3,9,9,18,18,13,31,0.000333,0.043089,4,517.0707,28.72615,129.267675,57.05865,2,4
0,0,4,4,9,12,21,23,18,41,0.000333,0.060028,4,720.340057,40.018892,180.085014,71.548875,2,4
0,0,35,35,21,50,71,178,106,284,0.000333,0.582176,20,34930.56364,1940.586869,1746.528182,374.431475,12,4
0,0,3,3,7,9,16,13,11,24,0.000333,0.032,3,288,16,96,48.180809,3,4
0,0,42,42,24,49,73,226,143,369,0.000333,0.761348,24,54817.08629,3045.393683,2284.045262,385.159882,18,4
0,0,20,20,21,30,51,109,77,186,0.000333,0.35169,20,21101.42227,1172.301237,1055.071114,239.445384,10,4
0,0,4,4,10,13,23,22,14,36,0.000333,0.054283,5,814.241152,45.23562,162.84823,81.324997,3,4
0,0,20,20,21,30,51,109,77,186,0.000333,0.35169,20,21101.42227,1172.301237,1055.071114,239.445384,10,4
0,0,4,4,8,7,15,18,12,30,0.000333,0.039069,4,468.826871,26.045937,117.206718,43.651484,3,4
0,0,28,28,17,41,58,152,85,237,0.000333,0.46278,16,22213.46393,1234.08133,1388.341496,289.1465,10,4
0,0,28,28,19,45,64,174,92,266,0.000333,0.532,18,28728,1596,1596,327.844012,10,4
0,0,6,6,14,10,24,35,18,53,0.000333,0.081001,7,1701.021088,94.501172,243.003013,86.52225,4,4
0,0,7,7,10,16,26,41,25,66,0.000333,0.10341,5,1551.145107,86.174728,310.229021,97.219281,3,4
0,0,4,4,7,9,16,16,12,28,0.000333,0.037333,3,336,18.666667,112,48.180809,3,4
0,0,5,5,9,15,24,25,20,45,0.000333,0.068774,4,825.29325,45.849625,206.323313,87.132684,1,4
0,0,7,7,11,13,24,37,19,56,0.000333,0.085586,5,1283.7895,71.321639,256.7579,86.159464,5,4
0,0,4,4,8,7,15,18,12,30,0.000333,0.039069,4,468.826871,26.045937,117.206718,43.651484,3,4
0,0,4,4,8,7,15,18,12,30,0.000333,0.039069,4,468.826871,26.045937,117.206718,43.651484,3,4
0,0,28,28,17,41,58,150,85,235,0.000333,0.458875,16,22026.00854,1223.667141,1376.625534,289.1465,10,4
0,0,4,4,7,6,13,16,9,25,0.000333,0.030837,3,277.532979,15.418499,92.510993,35.161259,3,4
0,0,4,4,8,7,15,18,12,30,0.000333,0.039069,4,468.826871,26.045937,117.206718,43.651484,3,4
0,0,7,7,11,13,24,37,19,56,0.000333,0.085586,5,1283.7895,71.321639,256.7579,86.159464,5,4
0,0,20,20,21,30,51,109,77,186,0.000333,0.35169,20,21101.42227,1172.301237,1055.071114,239.445384,10,4
0,0,37,37,22,54,76,228,127,355,0.000333,0.739338,22,48796.31388,2710.906327,2218.014267,408.871421,16,4
0,0,4,4,7,9,16,16,12,28,0.000333,0.037333,3,336,18.666667,112,48.180809,3,4
0,0,31,31,18,39,57,169,94,263,0.000333,0.51135,18,27612.90133,1534.050074,1534.050074,281.189337,11,4
0,0,27,27,20,42,62,172,92,264,0.000333,0.523969,20,31438.15652,1746.564251,1571.907826,312.915894,10,4
0,0,7,7,10,16,26,41,25,66,0.000333,0.10341,5,1551.145107,86.174728,310.229021,97.219281,3,4
0,0,20,20,21,30,51,109,77,186,0.000333,0.35169,20,21101.42227,1172.301237,1055.071114,239.445384,10,4
0,0,3,3,15,10,25,45,22,67,0.000333,0.103713,14,4355.937106,241.996506,311.138365,91.82264,3,4
0,0,23,23,19,35,54,119,72,191,0.000333,0.366395,18,19785.30323,1099.183513,1099.183513,260.235528,11,4
0,0,9,9,11,19,30,47,31,78,0.000333,0.127579,5,1913.687332,106.315963,382.737466,118.764371,3,4
0,0,5,5,9,15,24,25,20,45,0.000333,0.068774,4,825.29325,45.849625,206.323313,87.132684,1,4
0,0,6,6,14,10,24,35,18,53,0.000333,0.081001,7,1701.021088,94.501172,243.003013,86.52225,4,4
0,0,4,4,7,9,16,16,12,28,0.000333,0.037333,3,336,18.666667,112,48.180809,3,4
0,0,10,10,17,13,30,56,31,87,0.000333,0.1423,16,6830.391709,379.466206,426.899482,117.592585,6,4
0,0,18,18,16,29,45,90,71,161,0.000333,0.294729,16,14147.01358,785.945199,884.188349,204.881449,7,4
0,0,25,25,24,36,60,132,95,227,0.000333,0.446955,24,32180.73997,1787.818887,1340.864165,296.1564,6,4
0,0,18,18,17,29,46,93,71,164,0.000333,0.301955,16,14493.82657,805.212587,905.864161,210.368317,7,4
0,0,25,25,25,36,61,137,95,232,0.000333,0.458644,24,33022.3455,1834.57475,1375.931062,302.213705,6,4
0,0,19,19,16,30,46,98,75,173,0.000333,0.318525,16,15289.21949,849.401083,955.576218,211.206718,7,4
0,0,26,26,24,37,61,140,100,240,0.000333,0.474459,24,34161.04706,1897.835948,1423.376961,302.788875,6,4
0,0,17,17,15,29,44,86,67,153,0.000333,0.278431,14,11694.10253,649.672363,835.293038,199.484808,7,4
0,0,24,24,24,35,59,125,90,215,0.000333,0.421589,24,30354.43814,1686.357674,1264.768256,289.564006,6,4
0,0,16,16,15,29,44,81,64,145,0.000333,0.263873,14,11082.64619,615.702566,791.617585,199.484808,7,4
0,0,23,23,24,35,59,122,87,209,0.000333,0.409824,24,29507.33754,1639.29653,1229.472397,289.564006,6,4
0,0,15,15,15,28,43,79,62,141,0.000333,0.255034,14,10711.44663,595.080368,765.10333,193.209297,7,4
0,0,22,22,24,34,58,120,85,205,0.000333,0.400295,24,28821.2665,1601.181472,1200.886104,283.012837,6,4
0,0,21,21,18,32,50,105,81,186,0.000333,0.349919,18,18895.63052,1049.757251,1049.757251,235.05865,7,4
0,0,28,28,24,38,62,147,105,252,0.000333,0.500152,24,36010.97929,2000.60996,1500.45747,309.460346,6,4
0,0,21,21,16,33,49,97,80,177,0.000333,0.331268,16,15900.85828,883.381015,993.803642,230.465006,7,4
0,0,28,28,25,40,65,139,104,243,0.000333,0.487812,24,35122.44909,1951.247171,1463.435379,328.973529,6,4
0,0,21,21,16,32,48,97,80,177,0.000333,0.329513,16,15816.6138,878.700767,988.538363,224,7,4
0,0,28,28,25,39,64,139,104,243,0.000333,0.486,24,34992,1944,1458,322.227091,6,4
0,0,15,15,15,28,43,79,62,141,0.000333,0.255034,14,10711.44663,595.080368,765.10333,193.209297,7,4
0,0,22,22,24,34,58,120,85,205,0.000333,0.400295,24,28821.2665,1601.181472,1200.886104,283.012837,6,4
0,0,17,17,25,30,55,124,84,208,0.000333,0.400841,24,28860.54769,1603.363761,1202.52282,263.303123,6,4
0,0,4,4,10,16,26,23,21,44,0.000333,0.06894,5,1034.096738,57.449819,206.819348,97.219281,1,4
0,0,6,6,11,14,25,22,19,41,0.000333,0.063466,5,951.990519,52.888362,190.398104,91.356717,2,4
0,0,8,8,13,21,34,40,33,73,0.000333,0.123795,6,2228.308724,123.794929,371.384787,140.344382,2,4
0,0,15,15,18,30,48,88,69,157,0.000333,0.29228,18,15783.10403,876.839113,876.839113,222.265368,4,4
0,0,18,18,18,21,39,115,84,199,0.000333,0.350598,36,37864.6215,2103.590083,1051.795042,167.297316,4,4
0,0,16,16,11,23,34,46,48,94,0.000333,0.159407,10,4782.215071,265.678615,478.221507,142.095673,3,4
0,0,25,25,11,31,42,82,74,156,0.000333,0.280401,10,8412.01518,467.334177,841.201518,191.633833,5,4
0,0,9,9,13,20,33,38,28,66,0.000333,0.110977,6,1997.580071,110.976671,332.930012,134.544278,2,4
0,0,16,16,16,28,44,65,50,115,0.000333,0.209278,8,5022.677089,279.037616,627.834636,198.605938,2,4
0,0,13,13,14,19,33,62,37,99,0.000333,0.166465,7,3495.765125,194.209174,499.395018,134.013592,3,4
0,0,23,23,21,25,46,108,73,181,0.000333,0.333255,20,19995.29428,1110.849682,999.764714,208.335071,7,4
0,0,17,17,20,36,56,106,77,183,0.000333,0.354249,20,21254.91902,1180.828834,1062.745951,272.555862,7,4
0,0,11,11,15,26,41,59,46,105,0.000333,0.187514,7,3937.800723,218.766707,562.54296,180.814792,2,4
0,0,27,27,14,41,55,105,88,193,0.000333,0.371934,14,15621.23395,867.84633,1115.802425,272.962601,3,4
0,0,16,16,21,25,46,56,35,91,0.000333,0.167548,10,5026.44138,279.246743,502.644138,208.335071,2,4
0,0,19,19,27,30,57,140,93,233,0.000333,0.453021,39,53003.47156,2944.637309,1359.063373,275.58868,6,4
0,0,9,9,17,16,33,48,37,85,0.000333,0.142925,16,6860.376002,381.132,428.7735,133.486868,2,4
0,0,8,8,12,16,28,54,37,91,0.000333,0.145823,12,5249.631575,291.646199,437.469298,107.01955,2,4
0,0,7,7,11,10,21,36,23,59,0.000333,0.086382,10,2591.467279,143.970404,259.146728,71.273029,1,4
0,0,14,14,18,33,51,105,68,173,0.000333,0.32711,18,17663.93252,981.329584,981.329584,241.523656,6,4
0,0,8,8,14,13,27,46,31,77,0.000333,0.122042,14,5125.768727,284.764929,366.126338,101.408685,2,4
0,0,17,17,20,30,50,104,78,182,0.000333,0.342394,20,20543.63653,1141.313141,1027.181827,233.64528,4,4
0,0,6,6,12,11,23,42,24,66,0.000333,0.099518,12,3582.661069,199.036726,298.555089,81.073298,1,4
0,0,18,18,12,23,35,59,58,117,0.000333,0.200042,12,7201.513356,400.084075,600.126113,147.061475,3,4
0,0,27,27,12,31,43,95,84,179,0.000333,0.323767,12,11655.61669,647.534261,971.301391,196.599636,5,4
0,0,10,10,17,18,35,62,39,101,0.000333,0.172686,16,8288.921355,460.495631,518.057585,144.545518,4,4
0,0,18,18,17,28,45,81,58,139,0.000333,0.254456,16,12213.88129,678.54896,763.36758,204.092806,2,4
0,0,25,25,22,25,47,127,85,212,0.000333,0.392524,33,38859.90361,2158.883534,1177.572837,214.2039,7,4
0,0,20,20,22,36,58,124,84,208,0.000333,0.406153,22,26806.12103,1489.228946,1218.460047,284.224796,7,4
0,0,13,13,17,27,44,78,56,134,0.000333,0.243855,16,11705.02139,650.278966,731.563837,197.868831,2,4
0,0,20,20,16,41,57,119,96,215,0.000333,0.418024,16,20065.14165,1114.730092,1254.071353,283.659632,3,4
0,0,20,20,25,31,56,146,98,244,0.000333,0.472332,36,51011.80564,2833.989202,1416.994601,269.67649,6,4
0,0,10,10,16,17,33,54,42,96,0.000333,0.161421,16,7748.189367,430.454965,484.261835,133.486868,2,4
0,0,10,10,13,18,31,39,27,66,0.000333,0.108992,6,1961.861739,108.992319,326.976956,123.164366,2,4
0,0,11,11,11,26,37,54,48,102,0.000333,0.177121,5,2656.821216,147.601179,531.364243,160.26518,3,4
0,0,15,15,15,31,46,78,51,129,0.000333,0.237513,7,4987.776446,277.098691,712.539492,212.183445,4,4
0,0,9,9,10,17,27,58,42,100,0.000333,0.158496,10,4754.887502,264.160417,475.48875,102.706149,2,4
0,0,8,8,10,11,21,38,28,66,0.000333,0.096631,10,2898.929499,161.051639,289.89295,71.273029,1,4
0,0,15,15,17,34,51,107,77,184,0.000333,0.347909,16,16699.62021,927.756678,1043.726263,242.460605,6,4
0,0,9,9,12,14,26,54,38,92,0.000333,0.144147,12,5189.285449,288.293636,432.440454,96.322519,2,4
0,0,18,18,18,31,49,109,83,192,0.000333,0.359341,18,19404.43722,1078.02429,1078.02429,228.638736,4,4
0,0,21,21,18,22,40,125,91,216,0.000333,0.383179,36,41383.31287,2299.072937,1149.536468,173.166146,4,4
0,0,7,7,10,12,22,46,25,71,0.000333,0.10554,10,3166.196449,175.899803,316.619645,76.238831,1,4
0,0,19,19,12,24,36,62,65,127,0.000333,0.21886,12,7878.965702,437.720317,656.580475,153.05865,3,4
0,0,28,28,12,32,44,98,91,189,0.000333,0.343944,12,12381.99091,687.888384,1031.832576,203.01955,5,4
0,0,11,11,17,19,36,66,44,110,0.000333,0.189564,16,9099.068003,505.503778,568.69175,150.197491,4,4
0,0,9,9,11,13,24,33,23,56,0.000333,0.085586,5,1283.7895,71.321639,256.7579,86.159464,2,4
0,0,19,19,16,29,45,89,63,152,0.000333,0.278254,16,13356.18673,742.010374,834.761671,204.881449,2,4
0,0,16,16,14,21,35,70,44,114,0.000333,0.194913,14,8186.335695,454.796428,584.738264,145.541635,3,4
0,0,26,26,21,26,47,135,93,228,0.000333,0.422149,30,37993.38775,2110.743764,1266.446258,214.450099,7,4
0,0,21,21,21,37,58,125,90,215,0.000333,0.419822,20,25189.31828,1399.406571,1259.465914,284.98844,7,4
0,0,14,14,16,28,44,84,62,146,0.000333,0.265692,16,12753.23226,708.512903,797.077016,198.605938,2,4
0,0,19,19,25,30,55,137,93,230,0.000333,0.443238,36,47869.65843,2659.425468,1329.712734,263.303123,6,4
0,0,9,9,16,16,32,46,37,83,0.000333,0.138333,16,6640,368.888889,415,128,2,4
0,0,9,9,13,17,30,32,24,56,0.000333,0.091595,6,1648.71524,91.595291,274.785873,117.592585,2,4
0,0,10,10,11,25,36,46,43,89,0.000333,0.153374,5,2300.616626,127.812035,460.123325,154.150153,3,4
0,0,14,14,15,30,45,72,48,120,0.000333,0.219674,7,4613.156601,256.286478,659.022372,205.810077,4,4
0,0,8,8,10,16,26,49,37,86,0.000333,0.134746,10,4042.378158,224.576564,404.237816,97.219281,2,4
0,0,7,7,10,10,20,31,23,54,0.000333,0.077795,10,2333.841171,129.657843,233.384117,66.438562,1,4
0,0,14,14,17,33,50,99,68,167,0.000333,0.314175,16,15080.38374,837.799097,942.523984,235.951874,6,4
0,0,8,8,12,13,25,43,31,74,0.000333,0.114548,12,4123.744297,229.096905,343.645358,91.125266,2,4
0,0,17,17,18,30,48,101,78,179,0.000333,0.333236,18,17994.74918,999.708288,999.708288,222.265368,4,4
0,0,20,20,18,21,39,119,88,207,0.000333,0.364693,36,39386.81734,2188.156519,1094.078259,167.297316,4,4
0,0,6,6,10,11,21,35,20,55,0.000333,0.080526,5,1207.887291,67.10485,241.577458,71.273029,1,4
0,0,18,18,12,23,35,55,58,113,0.000333,0.193203,12,6955.307771,386.405987,579.608981,147.061475,3,4
0,0,27,27,12,31,43,91,84,175,0.000333,0.316532,12,11395.15599,633.064221,949.596332,196.599636,5,4
0,0,10,10,17,18,35,58,39,97,0.000333,0.165847,16,7960.647242,442.25818,497.540453,144.545518,4,4
0,0,8,8,11,12,23,27,20,47,0.000333,0.070869,5,1063.03706,59.057614,212.607412,81.073298,2,4
0,0,18,18,16,28,44,78,58,136,0.000333,0.247494,16,11879.7232,659.984622,742.4827,198.605938,2,4
0,0,15,15,14,20,34,65,41,106,0.000333,0.179757,14,7549.794856,419.433048,539.271061,139.741531,3,4
0,0,25,25,21,25,46,123,85,208,0.000333,0.382967,30,34467.02661,1914.834811,1148.900887,208.335071,7,4
0,0,20,20,21,36,57,116,85,201,0.000333,0.390804,20,23448.21786,1302.67877,1172.410893,278.355966,7,4
0,0,13,13,16,27,43,73,56,129,0.000333,0.233329,16,11199.81045,622.211692,699.988153,192.381963,2,4
0,0,20,20,15,41,56,114,96,210,0.000333,0.406515,14,17073.62347,948.534637,1219.544534,278.262991,3,4
0,0,17,17,25,30,55,125,85,210,0.000333,0.404695,24,29138.05296,1618.78072,1214.08554,263.303123,6,4
0,0,7,7,15,16,31,34,29,63,0.000333,0.104038,7,2184.800573,121.37781,312.114368,122.603359,2,4
0,0,6,6,11,13,24,29,21,50,0.000333,0.076416,5,1146.240625,63.680035,229.248125,86.159464,2,4
0,0,7,7,12,17,29,30,21,51,0.000333,0.082586,6,1486.542185,82.585677,247.757031,112.506418,2,4
0,0,8,8,10,25,35,41,38,79,0.000333,0.135071,5,2026.066792,112.559266,405.213358,149.315686,3,4
0,0,12,12,14,30,44,69,45,114,0.000333,0.207458,7,4356.626432,242.034802,622.375205,200.509687,4,4
0,0,7,7,12,20,32,35,30,65,0.000333,0.108333,6,1950,108.333333,325,129.458112,3,4
0,0,5,5,9,16,25,29,28,57,0.000333,0.088233,4,1058.799211,58.822178,264.699803,92.529325,1,4
0,0,4,4,10,16,26,24,23,47,0.000333,0.07364,5,1104.603334,61.366852,220.920667,97.219281,1,4
0,0,5,5,9,10,19,20,16,36,0.000333,0.050975,4,611.701562,33.98342,152.92539,61.748606,1,4
0,0,14,14,16,33,49,89,61,150,0.000333,0.280735,8,6737.651813,374.31399,842.206477,230.465006,6,4
0,0,6,6,11,13,24,30,21,51,0.000333,0.077944,5,1169.165438,64.953635,233.833088,86.159464,2,4
0,0,7,7,13,21,34,41,34,75,0.000333,0.127187,6,2289.358279,127.186571,381.559713,140.344382,2,4
0,0,18,18,18,21,39,116,85,201,0.000333,0.354122,36,38245.17046,2124.731692,1062.365846,167.297316,4,4
0,0,4,4,9,11,20,25,17,42,0.000333,0.060507,4,726.08392,40.337996,181.52098,66.583073,1,4
0,0,16,16,11,23,34,48,49,97,0.000333,0.164495,10,4934.838956,274.15772,493.483896,142.095673,3,4
0,0,25,25,11,31,42,82,76,158,0.000333,0.283995,10,8519.861528,473.32564,851.986153,191.633833,5,4
0,0,8,8,15,18,33,48,32,80,0.000333,0.134517,7,2824.860707,156.936706,403.55153,133.662009,4,4
0,0,16,16,16,28,44,67,51,118,0.000333,0.214738,8,5153.703448,286.316858,644.212931,198.605938,2,4
0,0,13,13,14,19,33,64,38,102,0.000333,0.171509,14,7203.394802,400.1886,514.5282,134.013592,3,4
0,0,23,23,21,25,46,108,74,182,0.000333,0.335096,20,20105.76552,1116.986973,1005.288276,208.335071,7,4
0,0,18,18,20,36,56,108,78,186,0.000333,0.360056,20,21603.36031,1200.186684,1080.168016,272.555862,7,4
0,0,11,11,15,26,41,61,48,109,0.000333,0.194658,7,4087.81218,227.100677,583.973169,180.814792,2,4
0,0,16,16,21,25,46,57,36,93,0.000333,0.17123,10,5136.912619,285.384034,513.691262,208.335071,2,4
0,0,22,22,25,33,58,152,103,255,0.000333,0.497928,36,53776.26554,2987.570308,1493.785154,282.561411,6,4
0,0,12,12,16,19,35,60,47,107,0.000333,0.182944,16,8781.332525,487.851807,548.833283,144.710623,2,4
0,0,11,11,12,19,31,64,47,111,0.000333,0.183305,12,6598.989485,366.610527,549.91579,123.730173,2,4
0,0,10,10,12,13,25,48,33,81,0.000333,0.125384,12,4513.828216,250.768234,376.152351,91.125266,1,4
0,0,17,17,19,36,55,111,78,189,0.000333,0.364226,18,19668.18575,1092.676986,1092.676986,266.827923,6,4
0,0,11,11,14,16,30,57,41,98,0.000333,0.160292,14,6732.253897,374.014105,480.875278,117.302969,2,4
0,0,20,20,18,33,51,116,88,204,0.000333,0.385725,18,20829.14586,1157.17477,1157.17477,241.523656,4,4
0,0,9,9,12,14,26,54,34,88,0.000333,0.13788,12,4963.664342,275.75913,413.638695,96.322519,1,4
0,0,21,21,14,26,40,68,70,138,0.000333,0.244809,14,10281.96508,571.220282,734.426077,175.514402,3,4
0,0,30,30,14,34,48,104,96,200,0.000333,0.372331,14,15637.895,868.771945,1116.9925,226.276706,5,4
0,0,13,13,18,21,39,70,49,119,0.000333,0.209654,18,11321.33155,628.962864,628.962864,167.297316,4,4
0,0,21,21,18,31,49,95,68,163,0.000333,0.305066,18,16473.55868,915.197705,915.197705,228.638736,2,4
0,0,28,28,23,28,51,136,97,233,0.000333,0.440558,33,43615.27845,2423.071025,1321.675105,238.647863,7,4
0,0,23,23,23,39,62,133,95,228,0.000333,0.452519,22,29866.24869,1659.236038,1357.556759,310.172612,7,4
0,0,16,16,18,31,49,90,66,156,0.000333,0.291965,18,15766.10524,875.894736,875.894736,228.638736,2,4
0,0,23,23,17,44,61,131,106,237,0.000333,0.468528,16,22489.35598,1249.408666,1405.584749,309.70186,3,4
0,0,22,22,26,33,59,144,102,246,0.000333,0.482377,39,56438.07742,3135.448745,1447.13019,288.676439,6,4
0,0,12,12,17,19,36,53,46,99,0.000333,0.170608,16,8189.161202,454.9534,511.822575,150.197491,2,4
0,0,11,11,11,19,30,56,46,102,0.000333,0.166834,10,5005.028408,278.057134,500.502841,118.764371,2,4
0,0,10,10,11,13,24,39,32,71,0.000333,0.108511,10,3255.323376,180.851299,325.532338,86.159464,1,4
0,0,17,17,18,36,54,106,77,183,0.000333,0.351048,18,18956.59943,1053.144413,1053.144413,261.17595,6,4
0,0,11,11,13,16,29,49,40,89,0.000333,0.14412,12,5188.323703,288.240206,432.360309,112.105716,2,4
0,0,20,20,19,33,52,108,87,195,0.000333,0.370529,18,20008.54341,1111.585745,1111.585745,247.175629,4,4
0,0,9,9,11,14,25,44,33,77,0.000333,0.119192,10,3575.769266,198.653848,357.576927,91.356717,1,4
0,0,21,21,13,26,39,62,67,129,0.000333,0.227272,12,8181.802635,454.544591,681.816886,170.317149,3,4
0,0,30,30,13,34,47,98,93,191,0.000333,0.353642,12,12731.11765,707.284314,1060.926471,221.079453,5,4
0,0,13,13,17,21,38,64,48,112,0.000333,0.195923,16,9404.286104,522.460339,587.767882,161.725534,4,4
0,0,21,21,16,31,47,85,67,152,0.000333,0.281433,16,13508.76009,750.486672,844.297505,217.580086,2,4
0,0,28,28,22,28,50,130,94,224,0.000333,0.421408,33,41719.38496,2317.743609,1264.223787,232.713433,7,4
0,0,23,23,22,39,61,123,94,217,0.000333,0.42899,22,28313.34005,1572.963336,1286.970002,304.238182,7,4
0,0,16,16,16,30,46,80,65,145,0.000333,0.266972,16,12814.66374,711.925763,800.916484,211.206718,2,4
0,0,23,23,15,44,59,121,105,226,0.000333,0.443159,14,18612.68261,1034.037923,1329.477329,298.81835,3,4
0,0,22,22,26,34,60,144,102,246,0.000333,0.484365,39,56670.70837,3148.372687,1453.095087,295.185169,6,4
0,0,12,12,17,20,37,53,46,99,0.000333,0.171912,16,8251.774131,458.431896,515.735883,155.92543,2,4
0,0,11,11,11,20,31,56,46,102,0.000333,0.168443,10,5053.280237,280.737791,505.328024,124.49231,2,4
0,0,10,10,11,13,24,39,32,71,0.000333,0.108511,10,3255.323376,180.851299,325.532338,86.159464,1,4
0,0,17,17,18,37,55,106,77,183,0.000333,0.352663,18,19043.7989,1057.988828,1057.988828,267.808425,6,4
0,0,11,11,13,17,30,49,40,89,0.000333,0.145571,12,5240.559156,291.142175,436.713263,117.592585,2,4
0,0,20,20,19,34,53,108,87,195,0.000333,0.372315,18,20105.0008,1116.944489,1116.944489,253.684359,4,4
0,0,9,9,11,15,26,44,33,77,0.000333,0.120645,10,3619.338583,201.074366,361.933858,96.657107,1,4
0,0,21,21,13,27,40,62,67,129,0.000333,0.228843,12,8238.344691,457.685816,686.528724,176.487679,3,4
0,0,30,30,13,35,48,98,93,191,0.000333,0.355576,12,12800.73405,711.151892,1066.727838,227.630622,5,4
0,0,13,13,17,22,39,64,48,112,0.000333,0.197322,16,9471.440776,526.191154,591.965049,167.594364,4,4
0,0,21,21,16,32,48,85,67,152,0.000333,0.282971,16,13582.6288,754.590489,848.9143,224,2,4
0,0,28,28,22,29,51,130,94,224,0.000333,0.423541,33,41930.56813,2329.476007,1270.623277,238.988944,7,4
0,0,23,23,22,40,62,123,94,217,0.000333,0.430687,22,28425.33319,1579.185177,1292.060599,310.984619,7,4
0,0,16,16,16,31,47,80,65,145,0.000333,0.268472,16,12886.64614,715.924785,805.415383,217.580086,2,4
0,0,23,23,15,45,60,121,105,226,0.000333,0.444986,14,18689.40185,1038.300102,1334.957275,305.736748,3,4
0,0,16,16,25,29,54,122,82,204,0.000333,0.391332,24,28175.92921,1565.329401,1173.99705,256.977854,6,4
0,0,5,5,11,12,23,27,18,45,0.000333,0.067853,5,1017.80144,56.544524,203.560288,81.073298,2,4
0,0,7,7,10,24,34,36,33,69,0.000333,0.117012,5,1755.17468,97.509704,351.034936,143.258381,3,4
0,0,11,11,14,29,43,66,42,108,0.000333,0.195346,7,4102.256155,227.90312,586.036594,194.184418,4,4
0,0,4,4,9,9,18,17,13,30,0.000333,0.041699,4,500.391,27.7995,125.09775,57.05865,1,4
0,0,13,13,16,32,48,87,58,145,0.000333,0.26994,8,6478.556501,359.919806,809.819563,224,6,4
0,0,5,5,11,12,23,27,18,45,0.000333,0.067853,5,1017.80144,56.544524,203.560288,81.073298,2,4
0,0,7,7,13,20,33,38,31,69,0.000333,0.116021,6,2088.379165,116.021065,348.063194,134.544278,2,4
0,0,14,14,18,29,47,86,67,153,0.000333,0.283284,18,15297.3377,849.852094,849.852094,215.940099,4,4
0,0,17,17,18,20,38,113,82,195,0.000333,0.341115,36,36840.45114,2046.69173,1023.345865,161.497212,4,4
0,0,15,15,11,22,33,44,46,90,0.000333,0.151332,10,4539.954707,252.219706,453.995471,136.161243,3,4
0,0,24,24,11,30,41,80,72,152,0.000333,0.271449,10,8143.479047,452.415503,814.347905,185.260466,5,4
0,0,8,8,13,19,32,36,26,62,0.000333,0.103333,6,1860,103.333333,310,128.816339,2,4
0,0,15,15,16,27,43,63,48,111,0.000333,0.200772,8,4818.523102,267.695728,602.315388,192.381963,2,4
0,0,12,12,14,18,32,60,35,95,0.000333,0.158333,7,3325,184.722222,475,128.361619,3,4
0,0,22,22,21,24,45,106,71,177,0.000333,0.324019,20,19441.15996,1080.064442,972.057998,202.277766,7,4
0,0,17,17,20,35,55,104,75,179,0.000333,0.344954,20,20697.26777,1149.84821,1034.863389,265.963467,7,4
0,0,10,10,15,25,40,57,44,101,0.000333,0.179172,7,3762.603163,209.033509,537.514738,174.699764,2,4
0,0,26,26,14,40,54,103,86,189,0.000333,0.362558,14,15227.43233,845.968463,1087.673738,266.180093,3,4
0,0,13,13,21,24,45,54,33,87,0.000333,0.159264,10,4777.912194,265.439566,477.791219,202.277766,2,4
0,0,16,16,25,29,54,122,82,204,0.000333,0.391332,24,28175.92921,1565.329401,1173.99705,256.977854,6,4
0,0,6,6,15,14,29,32,26,58,0.000333,0.093921,7,1972.340284,109.57446,281.762898,111.906328,2,4
0,0,6,6,11,12,23,27,18,45,0.000333,0.067853,5,1017.80144,56.544524,203.560288,81.073298,2,4
0,0,6,6,12,16,28,27,18,45,0.000333,0.07211,6,1297.985829,72.110324,216.330971,107.01955,2,4
0,0,7,7,10,24,34,36,33,69,0.000333,0.117012,5,1755.17468,97.509704,351.034936,143.258381,3,4
0,0,11,11,14,29,43,66,42,108,0.000333,0.195346,7,4102.256155,227.90312,586.036594,194.184418,4,4
0,0,5,5,9,14,23,30,24,54,0.000333,0.081424,4,977.089383,54.282743,244.272346,81.832294,2,4
0,0,6,6,9,15,24,33,26,59,0.000333,0.090171,4,1082.05115,60.113953,270.512788,87.132684,2,4
0,0,6,6,12,19,31,32,27,59,0.000333,0.097433,6,1753.785494,97.432527,292.297582,123.730173,3,4
0,0,4,4,9,15,24,26,24,50,0.000333,0.076416,4,916.9925,50.944028,229.248125,87.132684,1,4
0,0,3,3,10,15,25,21,19,40,0.000333,0.061918,5,928.771238,51.598402,185.754248,91.82264,1,4
0,0,4,4,9,9,18,17,13,30,0.000333,0.041699,4,500.391,27.7995,125.09775,57.05865,1,4
0,0,2,2,6,6,12,8,7,15,0.000333,0.017925,3,161.323313,8.962406,53.774438,31.01955,1,4
0,0,3,3,6,7,13,12,10,22,0.000333,0.027137,3,244.229021,13.568279,81.409674,35.161259,1,4
0,0,13,13,16,32,48,87,58,145,0.000333,0.26994,8,6478.556501,359.919806,809.819563,224,6,4
0,0,5,5,11,13,24,20,17,37,0.000333,0.056548,5,848.218063,47.123226,169.643613,86.159464,2,4
0,0,5,5,11,12,23,27,18,45,0.000333,0.067853,5,1017.80144,56.544524,203.560288,81.073298,2,4
0,0,8,8,13,20,33,38,31,69,0.000333,0.116021,6,2088.379165,116.021065,348.063194,134.544278,2,4
0,0,15,15,19,34,53,88,72,160,0.000333,0.305489,18,16496.41091,916.467273,916.467273,253.684359,4,4
0,0,17,17,18,20,38,113,82,195,0.000333,0.341115,36,36840.45114,2046.69173,1023.345865,161.497212,4,4
0,0,2,2,4,5,9,4,5,9,0.000333,0.00951,2,57.05865,3.169925,28.529325,19.60964,1,4
0,0,2,2,4,5,9,4,5,9,0.000333,0.00951,2,57.05865,3.169925,28.529325,19.60964,1,4
0,0,3,3,9,10,19,21,14,35,0.000333,0.049559,4,594.709852,33.039436,148.677463,61.748606,1,4
0,0,15,15,11,22,33,44,46,90,0.000333,0.151332,10,4539.954707,252.219706,453.995471,136.161243,3,4
0,0,24,24,11,30,41,80,72,152,0.000333,0.271449,10,8143.479047,452.415503,814.347905,185.260466,5,4
0,0,7,7,15,17,32,46,29,75,0.000333,0.125,7,2625,145.833333,375,128.090227,4,4
0,0,7,7,15,16,31,46,30,76,0.000333,0.125506,7,2635.632437,146.424024,376.51892,122.603359,4,4
0,0,8,8,13,19,32,36,26,62,0.000333,0.103333,6,1860,103.333333,310,128.816339,2,4
0,0,5,5,10,10,20,21,14,35,0.000333,0.050422,5,756.337417,42.018745,151.267483,66.438562,2,4
0,0,15,15,16,27,43,63,48,111,0.000333,0.200772,8,4818.523102,267.695728,602.315388,192.381963,2,4
0,0,12,12,14,18,32,60,35,95,0.000333,0.158333,7,3325,184.722222,475,128.361619,3,4
0,0,22,22,21,24,45,106,71,177,0.000333,0.324019,20,19441.15996,1080.064442,972.057998,202.277766,7,4
0,0,17,17,20,35,55,104,75,179,0.000333,0.344954,20,20697.26777,1149.84821,1034.863389,265.963467,7,4
0,0,8,8,13,23,36,44,35,79,0.000333,0.136141,6,2450.544451,136.141358,408.424075,152.147641,1,4
0,0,10,10,15,25,40,57,44,101,0.000333,0.179172,7,3762.603163,209.033509,537.514738,174.699764,2,4
0,0,26,26,14,40,54,103,86,189,0.000333,0.362558,14,15227.43233,845.968463,1087.673738,266.180093,3,4
0,0,15,15,21,24,45,54,33,87,0.000333,0.159264,10,4777.912194,265.439566,477.791219,202.277766,2,4
0,0,11,11,13,14,27,41,28,69,0.000333,0.109362,12,3937.046852,218.724825,328.087238,101.408685,2,4
0,0,12,12,13,16,29,47,31,78,0.000333,0.126308,6,2273.535106,126.307506,378.922518,112.105716,2,4
0,0,10,10,10,16,26,39,27,66,0.000333,0.10341,5,1551.145107,86.174728,310.229021,97.219281,2,4
0,0,9,9,10,14,24,31,23,54,0.000333,0.082529,5,1237.939875,68.774438,247.587975,86.52225,2,4
0,0,7,7,10,12,22,25,17,42,0.000333,0.062432,5,936.48064,52.026702,187.296128,76.238831,2,4
0,0,13,13,13,17,30,49,35,84,0.000333,0.137393,12,4946.14572,274.785873,412.17881,117.592585,2,4
0,0,10,10,11,17,28,33,26,59,0.000333,0.094545,5,1418.169702,78.787206,283.63394,107.540616,2,4
0,0,13,13,12,17,29,41,34,75,0.000333,0.12145,12,4372.182896,242.89905,364.348575,112.506418,2,4
0,0,11,11,13,14,27,39,26,65,0.000333,0.103023,6,1854.406126,103.022563,309.067688,101.408685,2,4
0,0,12,12,13,16,29,45,29,74,0.000333,0.11983,6,2156.943562,119.830198,359.490594,112.105716,2,4
0,0,10,10,10,16,26,37,25,62,0.000333,0.097142,5,1457.136313,80.952017,291.427263,97.219281,2,4
0,0,9,9,10,14,24,29,21,50,0.000333,0.076416,5,1146.240625,63.680035,229.248125,86.52225,2,4
0,0,7,7,10,12,22,23,15,38,0.000333,0.056486,5,847.292008,47.071778,169.458402,76.238831,2,4
0,0,13,13,13,17,30,47,33,80,0.000333,0.13085,6,2355.307486,130.850416,392.551248,117.592585,2,4
0,0,10,10,11,17,28,31,24,55,0.000333,0.088135,5,1322.022604,73.4457,264.404521,107.540616,2,4
0,0,13,13,12,17,29,39,32,71,0.000333,0.114972,6,2069.499904,114.972217,344.916651,112.506418,2,4
0,0,17,17,18,25,43,76,62,138,0.000333,0.249608,18,13478.84165,748.824536,748.824536,191.155055,8,4
0,0,18,18,19,26,45,83,65,148,0.000333,0.270931,18,14630.29665,812.794258,812.794258,202.922055,8,4
0,0,16,16,16,27,43,74,61,135,0.000333,0.244182,16,11720.73187,651.151771,732.545742,192.381963,8,4
0,0,15,15,16,25,41,67,57,124,0.000333,0.221445,16,10629.38318,590.521288,664.336449,180.096405,8,4
0,0,14,14,16,25,41,62,53,115,0.000333,0.205373,16,9857.895688,547.660872,616.118481,180.096405,8,4
0,0,13,13,16,24,40,61,51,112,0.000333,0.198685,16,9536.895146,529.827508,596.055947,174.0391,8,4
0,0,19,19,19,30,49,84,69,153,0.000333,0.28635,18,15462.91091,859.050606,859.050606,227.917341,8,4
0,0,16,16,16,28,44,69,60,129,0.000333,0.234756,16,11268.26686,626.014826,704.266679,198.605938,8,4
0,0,19,19,17,29,46,77,68,145,0.000333,0.266972,16,12814.66374,711.925763,800.916484,210.368317,8,4
0,0,18,18,16,17,33,116,86,202,0.000333,0.339656,40,40758.70448,2264.372471,1018.967612,133.486868,2,4
0,0,19,19,17,18,35,123,89,212,0.000333,0.362469,32,34797.05599,1933.169777,1087.408,144.545518,2,4
0,0,17,17,15,19,34,115,85,200,0.000333,0.339164,28,28489.79191,1582.766217,1017.492568,139.313982,2,4
0,0,16,16,15,17,32,107,81,188,0.000333,0.313333,28,26320,1462.222222,940,128.090227,2,4
0,0,15,15,15,17,32,101,75,176,0.000333,0.293333,28,24640,1368.888889,880,128.090227,2,4
0,0,20,20,17,21,38,124,93,217,0.000333,0.3796,32,36441.60865,2024.533814,1138.80027,161.725534,2,4
0,0,17,17,16,20,36,109,84,193,0.000333,0.332599,32,31929.45681,1773.858712,997.795525,150.438562,2,4
0,0,20,20,16,21,37,117,92,209,0.000333,0.362925,32,34840.82411,1935.601339,1088.775753,156.238666,2,4
0,0,19,19,18,28,46,94,70,164,0.000333,0.301955,18,16305.55489,905.864161,905.864161,209.664588,4,4
0,0,20,20,18,29,47,100,73,173,0.000333,0.320315,18,17296.98968,960.943871,960.943871,215.940099,4,4
0,0,18,18,17,29,46,93,69,162,0.000333,0.298272,16,14317.07259,795.392922,894.817037,210.368317,4,4
0,0,17,17,17,28,45,85,65,150,0.000333,0.274593,16,13180.44743,732.24708,823.777964,204.092806,4,4
0,0,16,16,17,28,45,81,61,142,0.000333,0.259948,16,12477.49024,693.193902,779.84314,204.092806,4,4
0,0,21,21,20,31,51,103,77,180,0.000333,0.340346,20,20420.73123,1134.485068,1021.036562,240.018648,4,4
0,0,18,18,18,31,49,87,68,155,0.000333,0.290093,18,15665.04047,870.280026,870.280026,228.638736,4,4
0,0,21,21,19,31,50,95,76,171,0.000333,0.3217,18,17371.78935,965.099408,965.099408,234.290708,4,4
0,0,19,19,18,28,46,93,69,162,0.000333,0.298272,18,16106.70666,894.817037,894.817037,209.664588,4,4
0,0,20,20,18,29,47,99,72,171,0.000333,0.316612,18,17097.02449,949.834694,949.834694,215.940099,4,4
0,0,18,18,17,29,46,92,68,160,0.000333,0.29459,16,14140.31861,785.573256,883.769913,210.368317,4,4
0,0,17,17,17,28,45,84,64,148,0.000333,0.270931,16,13004.70813,722.483785,812.794258,204.092806,4,4
0,0,16,16,17,28,45,80,60,140,0.000333,0.256286,16,12301.75094,683.430608,768.859433,204.092806,4,4
0,0,21,21,20,31,51,102,76,178,0.000333,0.336564,20,20193.83422,1121.879679,1009.691711,240.018648,4,4
0,0,18,18,18,31,49,86,67,153,0.000333,0.28635,18,15462.91091,859.050606,859.050606,228.638736,4,4
0,0,21,21,19,31,50,94,75,169,0.000333,0.317937,18,17168.61053,953.811696,953.811696,234.290708,4,4
0,0,12,12,15,13,28,61,21,82,0.000333,0.131401,7,2759.421725,153.301207,394.203104,106.709075,3,4
0,0,13,13,16,14,30,68,24,92,0.000333,0.150478,8,3611.471478,200.637304,451.433935,117.302969,3,4
0,0,11,11,15,15,30,56,24,80,0.000333,0.13085,7,2747.858734,152.658819,392.551248,117.206718,3,4
0,0,10,10,15,13,28,48,20,68,0.000333,0.108967,7,2288.300943,127.12783,326.900135,106.709075,3,4
0,0,9,9,15,13,28,42,18,60,0.000333,0.096147,7,2019.089067,112.171615,288.441295,106.709075,3,4
0,0,14,14,17,17,34,68,30,98,0.000333,0.16619,8,3988.570868,221.58727,498.571358,138.973737,3,4
0,0,11,11,16,16,32,50,23,73,0.000333,0.121667,8,2920,162.222222,365,128,3,4
0,0,14,14,16,17,33,60,29,89,0.000333,0.14965,8,3591.608613,199.533812,448.951077,133.486868,3,4
0,0,10,10,13,17,30,49,33,82,0.000333,0.134122,6,2414.190173,134.121676,402.365029,117.592585,6,4
0,0,11,11,13,18,31,55,36,91,0.000333,0.150277,12,5409.982371,300.554576,450.831864,123.164366,6,4
0,0,9,9,12,18,30,48,32,80,0.000333,0.13085,6,2355.307486,130.850416,392.551248,118.0782,6,4
0,0,8,8,12,17,29,40,28,68,0.000333,0.110114,6,1982.056246,110.114236,330.342708,112.506418,6,4
0,0,12,12,15,20,35,58,41,99,0.000333,0.169266,14,7109.186261,394.954792,507.799019,145.041921,6,4
0,0,9,9,13,20,33,42,31,73,0.000333,0.122747,6,2209.444624,122.746924,368.240771,134.544278,6,4
0,0,12,12,14,20,34,50,39,89,0.000333,0.150928,7,3169.48935,176.082742,452.784193,139.741531,6,4
0,0,19,19,12,23,35,85,67,152,0.000333,0.259884,12,9355.812223,519.767346,779.651019,147.061475,1,4
0,0,20,20,13,24,37,91,70,161,0.000333,0.279574,12,10064.6639,559.147995,838.721992,158.144816,1,4
0,0,18,18,11,25,36,84,66,150,0.000333,0.258496,10,7754.887502,430.827083,775.48875,154.150153,1,4
0,0,17,17,11,23,34,76,62,138,0.000333,0.234023,10,7020.698721,390.038818,702.069872,142.095673,1,4
0,0,16,16,11,23,34,71,58,129,0.000333,0.218761,10,6562.827065,364.601504,656.282707,142.095673,1,4
0,0,15,15,11,22,33,70,56,126,0.000333,0.211865,10,6355.93659,353.107588,635.593659,136.161243,1,4
0,0,21,21,13,27,40,94,74,168,0.000333,0.298028,12,10729.00704,596.055947,894.08392,176.487679,1,4
0,0,18,18,12,26,38,78,65,143,0.000333,0.250151,12,9005.443613,500.302423,750.453634,165.230983,1,4
0,0,21,21,12,27,39,86,73,159,0.000333,0.280126,12,10084.54743,560.252635,840.378953,171.401513,1,4
0,0,16,16,16,22,38,58,44,102,0.000333,0.17843,16,8564.617702,475.812095,535.288606,162.107496,5,4
0,0,17,17,17,23,40,64,47,111,0.000333,0.196911,16,9451.744297,525.096905,590.734019,173.528793,5,4
0,0,15,15,14,24,38,57,43,100,0.000333,0.174931,7,3673.549259,204.08607,524.792751,163.342069,5,4
0,0,14,14,14,22,36,49,39,88,0.000333,0.151651,7,3184.673801,176.926322,454.9534,151.410465,5,4
0,0,13,13,14,22,36,45,35,80,0.000333,0.137865,7,2895.158001,160.842111,413.594,151.410465,5,4
0,0,12,12,14,21,35,43,33,76,0.000333,0.129942,7,2728.778565,151.598809,389.825509,145.541635,5,4
0,0,18,18,17,26,43,67,51,118,0.000333,0.213433,8,5122.393928,284.57744,640.299241,191.698301,5,4
0,0,15,15,15,25,40,51,42,93,0.000333,0.16498,7,3464.57519,192.476399,494.939313,174.699764,5,4
0,0,18,18,16,26,42,59,50,109,0.000333,0.195921,8,4702.100793,261.227822,587.762599,186.211433,5,4
0,0,16,16,13,19,32,70,56,126,0.000333,0.21,12,7560,420,630,128.816339,3,4
0,0,17,17,14,20,34,77,59,136,0.000333,0.230632,14,9686.52925,538.140514,691.894946,139.741531,3,4
0,0,15,15,12,21,33,69,55,124,0.000333,0.208502,12,7506.05845,417.003247,625.504871,135.258216,3,4
0,0,14,14,12,19,31,61,51,112,0.000333,0.184957,12,6658.439841,369.913325,554.869987,123.730173,3,4
0,0,13,13,12,19,31,57,47,104,0.000333,0.171745,12,6182.836995,343.490944,515.236416,123.730173,3,4
0,0,12,12,12,18,30,55,45,100,0.000333,0.163563,12,5888.268715,327.12604,490.68906,118.0782,3,4
0,0,18,18,15,23,38,79,63,142,0.000333,0.248402,14,10432.8799,579.604439,745.205707,162.645284,3,4
0,0,15,15,13,22,35,63,54,117,0.000333,0.200042,12,7201.513356,400.084075,600.126113,146.213212,3,4
0,0,18,18,14,23,37,70,62,132,0.000333,0.229216,14,9627.06982,534.837212,687.647844,157.344894,3,4
0,0,16,16,15,19,34,75,46,121,0.000333,0.205194,14,8618.162053,478.786781,615.583004,139.313982,3,4
0,0,17,17,16,20,36,81,49,130,0.000333,0.22403,16,10753.444,597.413556,672.09025,150.438562,3,4
0,0,15,15,14,20,34,74,45,119,0.000333,0.201803,14,8475.713094,470.87295,605.408078,139.741531,3,4
0,0,14,14,14,19,33,66,41,107,0.000333,0.179917,14,7556.502391,419.805688,539.750171,134.013592,3,4
0,0,13,13,14,19,33,62,37,99,0.000333,0.166465,7,3495.765125,194.209174,499.395018,134.013592,3,4
0,0,12,12,14,18,32,60,35,95,0.000333,0.158333,7,3325,184.722222,475,128.361619,3,4
0,0,18,18,16,22,38,84,53,137,0.000333,0.239655,16,11503.45711,639.080951,718.966069,162.107496,3,4
0,0,15,15,15,22,37,68,44,112,0.000333,0.194486,14,8168.422877,453.801271,583.458777,156.710855,3,4
0,0,18,18,15,22,37,76,52,128,0.000333,0.22227,14,9335.340431,518.630024,666.810031,156.710855,3,4
0,0,12,12,14,13,27,60,21,81,0.000333,0.128382,7,2696.021214,149.778956,385.145888,101.408685,3,4
0,0,13,13,15,14,29,67,24,91,0.000333,0.147359,7,3094.533894,171.91855,442.076271,111.906328,3,4
0,0,11,11,14,15,29,55,24,79,0.000333,0.127927,7,2686.46349,149.247972,383.780499,111.906328,3,4
0,0,10,10,14,13,27,47,20,67,0.000333,0.106192,7,2230.042239,123.891235,318.577463,101.408685,3,4
0,0,9,9,14,13,27,41,18,59,0.000333,0.093513,7,1963.768538,109.098252,280.538363,101.408685,3,4
0,0,14,14,16,17,33,67,30,97,0.000333,0.163102,8,3914.449837,217.469435,489.30623,133.486868,3,4
0,0,11,11,15,16,31,49,23,72,0.000333,0.118901,7,2496.91494,138.717497,356.702134,122.603359,3,4
0,0,14,14,15,17,32,59,29,88,0.000333,0.146667,7,3080,171.111111,440,128.090227,3,4
0,0,9,9,11,11,22,36,25,61,0.000333,0.090675,10,2720.253287,151.125183,272.025329,76.107496,2,4
0,0,10,10,12,12,24,43,28,71,0.000333,0.108511,12,3906.388051,217.021558,325.532338,86.0391,2,4
0,0,8,8,10,12,22,35,24,59,0.000333,0.087702,10,2631.064655,146.170259,263.106465,76.238831,2,4
0,0,7,7,10,11,21,27,20,47,0.000333,0.068813,5,1032.194594,57.344144,206.438919,71.273029,2,4
0,0,6,6,10,11,21,23,16,39,0.000333,0.0571,5,856.501897,47.583439,171.300379,71.273029,2,4
0,0,11,11,13,14,27,45,32,77,0.000333,0.122042,12,4393.516052,244.084225,366.126338,101.408685,2,4
0,0,8,8,11,14,25,29,23,52,0.000333,0.080494,5,1207.402609,67.077923,241.480522,91.356717,2,4
0,0,11,11,12,14,26,37,31,68,0.000333,0.106543,12,3835.55881,213.086601,319.629901,96.322519,2,4
0,0,16,16,13,25,38,71,63,134,0.000333,0.234407,12,8438.667442,468.814858,703.222287,164.202121,2,4
0,0,17,17,13,26,39,78,66,144,0.000333,0.253699,12,9133.175034,507.398613,761.09792,170.317149,2,4
0,0,15,15,13,26,39,70,62,132,0.000333,0.232558,12,8372.077115,465.115395,697.673093,170.317149,2,4
0,0,14,14,13,25,38,62,58,120,0.000333,0.209917,12,7557.015619,419.834201,629.751302,164.202121,2,4
0,0,13,13,13,24,37,57,54,111,0.000333,0.19275,12,6938.991883,385.499549,578.249324,158.144816,2,4
0,0,18,18,15,28,43,80,70,150,0.000333,0.271313,14,11395.15599,633.064221,813.939713,193.209297,2,4
0,0,15,15,14,28,42,64,61,125,0.000333,0.22468,14,9436.55549,524.253083,674.039678,187.908907,2,4
0,0,18,18,14,28,42,72,69,141,0.000333,0.253439,14,10644.43459,591.357477,760.316757,187.908907,2,4
0,0,6,6,9,11,20,23,15,38,0.000333,0.054744,4,656.93307,36.496282,164.233268,66.583073,2,4
0,0,13,13,16,24,40,61,51,112,0.000333,0.198685,16,9536.895146,529.827508,596.055947,174.0391,8,4
0,0,14,14,15,16,31,101,75,176,0.000333,0.290646,28,24414.27942,1356.348857,871.938551,122.603359,2,4
0,0,15,15,17,27,44,79,59,138,0.000333,0.251134,16,12054.42501,669.690279,753.401563,197.868831,4,4
0,0,15,15,17,27,44,78,58,136,0.000333,0.247494,16,11879.7232,659.984622,742.4827,197.868831,4,4
0,0,8,8,15,12,27,40,16,56,0.000333,0.088758,7,1863.915901,103.550883,266.2737,101.622909,3,4
0,0,6,6,11,16,27,34,22,56,0.000333,0.088758,5,1331.368501,73.964917,266.2737,102.053748,6,4
0,0,15,15,11,22,33,70,56,126,0.000333,0.211865,10,6355.93659,353.107588,635.593659,136.161243,1,4
0,0,12,12,14,21,35,43,33,76,0.000333,0.129942,7,2728.778565,151.598809,389.825509,145.541635,5,4
0,0,12,12,12,18,30,55,45,100,0.000333,0.163563,12,5888.268715,327.12604,490.68906,118.0782,3,4
0,0,12,12,14,18,32,60,35,95,0.000333,0.158333,7,3325,184.722222,475,128.361619,3,4
0,0,8,8,14,12,26,39,16,55,0.000333,0.086175,7,1809.669291,100.537183,258.524184,96.322519,3,4
0,0,5,5,10,10,20,21,14,35,0.000333,0.050422,5,756.337417,42.018745,151.267483,66.438562,2,4
0,0,12,12,13,24,37,56,52,108,0.000333,0.18754,12,6751.451562,375.080642,562.620963,158.144816,2,4
0,0,3,3,6,6,12,10,8,18,0.000333,0.02151,3,193.587975,10.754888,64.529325,31.01955,1,4
0,0,4,4,7,3,10,12,6,18,0.000333,0.019932,6,358.768234,19.931569,59.794706,24.406372,1,4
0,0,6,6,7,7,14,14,12,26,0.000333,0.032997,3,296.973684,16.498538,98.991228,39.302969,1,4
0,0,4,4,9,4,13,18,10,28,0.000333,0.034537,8,828.898497,46.049916,103.612312,36.529325,2,4
0,0,5,5,14,7,21,30,14,44,0.000333,0.064421,14,2705.667532,150.314863,193.261967,72.954453,2,4
0,0,5,5,11,6,17,23,12,35,0.000333,0.047687,10,1430.611994,79.478444,143.061199,53.563523,2,4
0,0,9,9,14,11,25,49,36,85,0.000333,0.131576,21,8289.283299,460.515739,394.727776,91.356717,2,4
0,0,10,10,11,9,20,41,29,70,0.000333,0.100845,15,4538.0245,252.112472,302.534967,66.583073,2,4
0,0,10,10,13,11,24,44,31,75,0.000333,0.114624,12,4126.466251,229.248125,343.872188,86.159464,2,4
0,0,4,4,9,7,16,20,14,34,0.000333,0.045333,8,1088,60.444444,136,48.180809,2,4
0,0,10,10,16,15,31,54,32,86,0.000333,0.14202,16,6816.974123,378.720785,426.060883,122.603359,3,4
0,0,5,5,11,6,17,23,12,35,0.000333,0.047687,10,1430.611994,79.478444,143.061199,53.563523,2,4
0,0,10,10,14,11,25,51,38,89,0.000333,0.137768,21,8679.367219,482.187068,413.303201,91.356717,2,4
0,0,10,10,11,9,20,41,29,70,0.000333,0.100845,15,4538.0245,252.112472,302.534967,66.583073,2,4
0,0,10,10,13,11,24,44,31,75,0.000333,0.114624,12,4126.466251,229.248125,343.872188,86.159464,2,4
0,0,4,4,9,4,13,18,10,28,0.000333,0.034537,8,828.898497,46.049916,103.612312,36.529325,2,4
0,0,5,5,13,12,25,28,19,47,0.000333,0.072754,6,1309.567446,72.753747,218.261241,91.125266,2,4
0,0,5,5,11,6,17,23,12,35,0.000333,0.047687,10,1430.611994,79.478444,143.061199,53.563523,2,4
0,0,15,15,18,22,40,85,60,145,0.000333,0.257227,18,13890.23233,771.679574,771.679574,173.166146,3,4
0,0,16,16,18,21,39,77,53,130,0.000333,0.229034,18,12367.84119,687.102288,687.102288,167.297316,3,4
0,0,16,16,17,21,38,80,55,135,0.000333,0.236157,16,11335.52343,629.751302,708.470214,161.725534,3,4
0,0,4,4,9,4,13,18,10,28,0.000333,0.034537,8,828.898497,46.049916,103.612312,36.529325,2,4
0,0,8,8,16,14,30,44,26,70,0.000333,0.114494,8,2747.858734,152.658819,343.482342,117.302969,3,4
0,0,5,5,11,6,17,23,12,35,0.000333,0.047687,10,1430.611994,79.478444,143.061199,53.563523,2,4
0,0,20,20,18,25,43,106,71,177,0.000333,0.32015,18,17288.07951,960.448862,960.448862,191.155055,5,4
0,0,20,20,18,24,42,96,62,158,0.000333,0.283995,18,15335.75075,851.986153,851.986153,185.09775,5,4
0,0,20,20,17,23,40,99,64,163,0.000333,0.289158,16,13879.58847,771.088248,867.474279,173.528793,5,4
0,0,4,4,9,4,13,18,10,28,0.000333,0.034537,8,828.898497,46.049916,103.612312,36.529325,2,4
0,0,6,6,13,8,21,27,15,42,0.000333,0.061492,6,1106.863991,61.492444,184.477332,72.105716,2,4
0,0,5,5,11,6,17,23,12,35,0.000333,0.047687,10,1430.611994,79.478444,143.061199,53.563523,2,4
0,0,13,13,15,16,31,70,48,118,0.000333,0.194865,21,12276.49846,682.027692,584.595165,122.603359,2,4
0,0,13,13,15,14,29,60,39,99,0.000333,0.160313,14,6733.161659,374.064537,480.940119,111.906328,2,4
0,0,13,13,14,15,29,63,41,104,0.000333,0.16841,14,7073.220329,392.956685,505.230023,111.906328,2,4
0,0,4,4,9,4,13,18,10,28,0.000333,0.034537,8,828.898497,46.049916,103.612312,36.529325,2,4
0,0,5,5,14,7,21,30,14,44,0.000333,0.064421,14,2705.667532,150.314863,193.261967,72.954453,2,4
0,0,5,5,11,6,17,23,12,35,0.000333,0.047687,10,1430.611994,79.478444,143.061199,53.563523,2,4
0,0,24,24,21,23,44,130,80,210,0.000333,0.38216,30,34394.4192,1910.801067,1146.48064,196.280591,6,4
0,0,24,24,21,22,43,120,71,191,0.000333,0.345472,30,31092.49704,1727.360947,1036.416568,190.346161,6,4
0,0,23,23,20,22,42,121,71,192,0.000333,0.345108,30,31059.74836,1725.541575,1035.324945,184.546058,6,4
0,0,4,4,9,4,13,18,10,28,0.000333,0.034537,8,828.898497,46.049916,103.612312,36.529325,2,4
0,0,5,5,14,7,21,30,14,44,0.000333,0.064421,14,2705.667532,150.314863,193.261967,72.954453,2,4
0,0,5,5,11,6,17,23,12,35,0.000333,0.047687,10,1430.611994,79.478444,143.061199,53.563523,2,4
0,0,4,4,12,8,20,21,13,34,0.000333,0.048982,6,881.673331,48.981852,146.945555,67.01955,2,4
0,0,17,17,21,21,42,96,59,155,0.000333,0.278603,20,16716.18401,928.676889,835.809201,184.477332,4,4
0,0,17,17,20,21,41,99,61,160,0.000333,0.285736,20,17144.16642,952.45369,857.208321,178.677228,4,4
0,0,4,4,9,4,13,18,10,28,0.000333,0.034537,8,828.898497,46.049916,103.612312,36.529325,2,4
0,0,10,10,16,15,31,54,32,86,0.000333,0.14202,16,6816.974123,378.720785,426.060883,122.603359,3,4
0,0,5,5,11,6,17,23,12,35,0.000333,0.047687,10,1430.611994,79.478444,143.061199,53.563523,2,4
0,0,20,20,20,21,41,111,73,184,0.000333,0.328597,30,29573.68707,1642.982615,985.789569,178.677228,6,4
0,0,20,20,20,20,40,101,64,165,0.000333,0.292706,30,26343.54407,1463.530226,878.118136,172.877124,6,4
0,0,20,20,19,19,38,104,66,170,0.000333,0.297383,27,24087.98729,1338.221516,892.147677,161.421246,6,4
0,0,4,4,9,4,13,18,10,28,0.000333,0.034537,8,828.898497,46.049916,103.612312,36.529325,2,4
0,0,5,5,13,12,25,28,19,47,0.000333,0.072754,6,1309.567446,72.753747,218.261241,91.125266,2,4
0,0,5,5,11,6,17,23,12,35,0.000333,0.047687,10,1430.611994,79.478444,143.061199,53.563523,2,4
0,0,16,16,18,22,40,87,62,149,0.000333,0.264322,18,14273.41115,792.967286,792.967286,173.166146,3,4
0,0,16,16,18,21,39,77,53,130,0.000333,0.229034,18,12367.84119,687.102288,687.102288,167.297316,3,4
0,0,16,16,17,21,38,80,55,135,0.000333,0.236157,16,11335.52343,629.751302,708.470214,161.725534,3,4
0,0,4,4,9,4,13,18,10,28,0.000333,0.034537,8,828.898497,46.049916,103.612312,36.529325,2,4
0,0,8,8,16,14,30,44,26,70,0.000333,0.114494,8,2747.858734,152.658819,343.482342,117.302969,3,4
0,0,5,5,11,6,17,23,12,35,0.000333,0.047687,10,1430.611994,79.478444,143.061199,53.563523,2,4
0,0,20,20,18,25,43,106,71,177,0.000333,0.32015,18,17288.07951,960.448862,960.448862,191.155055,5,4
0,0,20,20,18,24,42,96,62,158,0.000333,0.283995,18,15335.75075,851.986153,851.986153,185.09775,5,4
0,0,20,20,17,23,40,99,64,163,0.000333,0.289158,16,13879.58847,771.088248,867.474279,173.528793,5,4
0,0,4,4,9,4,13,18,10,28,0.000333,0.034537,8,828.898497,46.049916,103.612312,36.529325,2,4
0,0,6,6,13,8,21,27,15,42,0.000333,0.061492,6,1106.863991,61.492444,184.477332,72.105716,2,4
0,0,5,5,11,6,17,23,12,35,0.000333,0.047687,10,1430.611994,79.478444,143.061199,53.563523,2,4
0,0,13,13,15,16,31,70,48,118,0.000333,0.194865,21,12276.49846,682.027692,584.595165,122.603359,2,4
0,0,13,13,15,14,29,60,39,99,0.000333,0.160313,14,6733.161659,374.064537,480.940119,111.906328,2,4
0,0,13,13,14,15,29,63,41,104,0.000333,0.16841,14,7073.220329,392.956685,505.230023,111.906328,2,4
0,0,4,4,9,4,13,18,10,28,0.000333,0.034537,8,828.898497,46.049916,103.612312,36.529325,2,4
0,0,5,5,14,7,21,30,14,44,0.000333,0.064421,14,2705.667532,150.314863,193.261967,72.954453,2,4
0,0,5,5,11,6,17,23,12,35,0.000333,0.047687,10,1430.611994,79.478444,143.061199,53.563523,2,4
0,0,24,24,21,24,45,130,80,210,0.000333,0.38443,30,34598.67451,1922.148584,1153.28915,202.277766,6,4
0,0,24,24,21,23,44,120,71,191,0.000333,0.347584,30,31282.54318,1737.919065,1042.751439,196.280591,6,4
0,0,24,24,20,23,43,123,73,196,0.000333,0.354516,30,31906.43676,1772.57982,1063.547892,190.480487,6,4
0,0,8,8,13,12,25,48,35,83,0.000333,0.12848,12,4625.280765,256.960043,385.440064,91.125266,1,4
0,0,16,16,15,21,36,64,48,112,0.000333,0.193011,14,8106.442402,450.357911,579.0316,150.842025,4,4
0,0,16,16,16,22,38,66,48,114,0.000333,0.199421,16,9572.219785,531.789988,598.263737,162.107496,4,4
0,0,16,16,15,22,37,65,48,113,0.000333,0.196223,14,8241.355224,457.853068,588.66823,156.710855,4,4
0,0,21,21,16,27,43,94,74,168,0.000333,0.303871,16,14585.79966,810.322203,911.612479,192.381963,4,4
0,0,21,21,16,26,42,84,65,149,0.000333,0.267818,16,12855.28474,714.182485,803.455296,186.211433,4,4
0,0,21,21,15,26,41,87,67,154,0.000333,0.275021,14,11550.88212,641.715673,825.063009,180.814792,4,4
0,0,13,13,13,18,31,55,40,95,0.000333,0.156883,12,5647.783794,313.765766,470.648649,123.164366,3,4
0,0,13,13,14,19,33,57,40,97,0.000333,0.163102,14,6850.287214,380.571512,489.30623,134.013592,3,4
0,0,13,13,13,19,32,56,40,96,0.000333,0.16,12,5760,320,480,128.816339,3,4
0,0,18,18,14,25,39,85,66,151,0.000333,0.266032,14,11173.34029,620.741127,798.095735,169.399374,3,4
0,0,18,18,14,23,37,75,57,132,0.000333,0.229216,14,9627.06982,534.837212,687.647844,157.344894,3,4
0,0,18,18,14,27,41,80,62,142,0.000333,0.253591,14,10650.81339,591.711855,760.772385,181.684931,4,4
0,0,11,11,11,14,25,44,30,74,0.000333,0.114548,10,3436.45358,190.914088,343.645358,91.356717,2,4
0,0,11,11,12,15,27,46,30,76,0.000333,0.120457,12,4336.457402,240.9143,361.37145,101.622909,2,4
0,0,9,9,9,14,23,40,27,67,0.000333,0.101026,4,1212.314604,67.350811,303.078651,81.832294,1,4
0,0,14,14,14,20,34,66,51,117,0.000333,0.198411,14,8333.264134,462.959119,595.233152,139.741531,1,4
0,0,14,14,12,18,30,56,42,98,0.000333,0.160292,12,5770.50334,320.583519,480.875278,118.0782,1,4
0,0,14,14,13,19,32,59,44,103,0.000333,0.171667,12,6180,343.333333,515,128.816339,1,4
0,0,16,16,15,21,36,64,48,112,0.000333,0.193011,14,8106.442402,450.357911,579.0316,150.842025,4,4
0,0,16,16,16,22,38,66,48,114,0.000333,0.199421,16,9572.219785,531.789988,598.263737,162.107496,4,4
0,0,15,15,15,22,37,66,48,114,0.000333,0.197959,14,8314.287572,461.904865,593.877684,156.710855,4,4
0,0,20,20,16,27,43,92,72,164,0.000333,0.296636,16,14238.51872,791.028818,889.90742,192.381963,4,4
0,0,20,20,16,26,42,82,63,145,0.000333,0.260629,16,12510.17642,695.009801,781.886026,186.211433,4,4
0,0,20,20,15,26,41,85,65,150,0.000333,0.267878,14,11250.85921,625.047734,803.632801,180.814792,4,4
0,0,11,11,10,13,23,39,29,68,0.000333,0.102534,10,3076.02213,170.890118,307.602213,81.324997,2,4
0,0,11,11,11,14,25,41,29,70,0.000333,0.108357,10,3250.699333,180.594407,325.069933,91.356717,2,4
0,0,10,10,10,14,24,41,29,70,0.000333,0.106982,10,3209.473751,178.304097,320.947375,86.52225,2,4
0,0,15,15,13,20,33,67,53,120,0.000333,0.201776,12,7263.927532,403.55153,605.327294,134.544278,2,4
0,0,15,15,11,18,29,57,44,101,0.000333,0.163552,10,4906.560805,272.586711,490.656081,113.112398,2,4
0,0,15,15,12,19,31,60,46,106,0.000333,0.175048,12,6301.737707,350.096539,525.144809,123.730173,2,4
0,0,16,16,15,22,37,64,48,112,0.000333,0.194486,14,8168.422877,453.801271,583.458777,156.710855,4,4
0,0,16,16,16,23,39,66,48,114,0.000333,0.200845,16,9640.573647,535.587425,602.535853,168.041925,4,4
0,0,16,16,15,23,38,65,48,113,0.000333,0.197672,14,8302.221326,461.234518,593.015809,162.645284,4,4
0,0,21,21,16,28,44,94,74,168,0.000333,0.305728,16,14674.95219,815.275122,917.184512,198.605938,4,4
0,0,21,21,16,27,43,84,65,149,0.000333,0.269504,16,12936.21518,718.678621,808.513448,192.381963,4,4
0,0,21,21,15,27,42,87,67,154,0.000333,0.276806,14,11625.83636,645.879798,830.416883,186.985321,4,4
0,0,13,13,13,19,32,55,40,95,0.000333,0.158333,12,5700,316.666667,475,128.816339,3,4
0,0,11,11,14,20,34,54,36,90,0.000333,0.152624,7,3205.10159,178.061199,457.871656,139.741531,3,4
0,0,13,13,13,20,33,56,40,96,0.000333,0.161421,12,5811.142026,322.841224,484.261835,134.544278,3,4
0,0,18,18,14,26,40,85,66,151,0.000333,0.26787,14,11250.55599,625.030888,803.611142,175.514402,3,4
0,0,18,18,14,24,38,75,57,132,0.000333,0.230909,14,9698.170045,538.787225,692.726432,163.342069,3,4
0,0,18,18,13,25,38,78,59,137,0.000333,0.239655,12,8627.592832,479.310713,718.966069,164.202121,3,4
0,0,11,11,11,14,25,44,30,74,0.000333,0.114548,10,3436.45358,190.914088,343.645358,91.356717,2,4
0,0,11,11,12,15,27,46,30,76,0.000333,0.120457,12,4336.457402,240.9143,361.37145,101.622909,2,4
0,0,11,11,11,15,26,45,30,75,0.000333,0.117511,10,3525.329789,195.851655,352.532979,96.657107,2,4
0,0,16,16,15,21,36,74,56,130,0.000333,0.22403,14,9409.263503,522.736861,672.09025,150.842025,2,4
0,0,16,16,13,19,32,64,47,111,0.000333,0.185,12,6660,370,555,128.816339,2,4
0,0,16,16,14,20,34,67,49,116,0.000333,0.196715,14,8262.039654,459.002203,590.14569,139.741531,2,4
0,0,16,16,15,22,37,64,48,112,0.000333,0.194486,14,8168.422877,453.801271,583.458777,156.710855,4,4
0,0,11,11,11,16,27,41,30,71,0.000333,0.112532,5,1687.985063,93.776948,337.597013,102.053748,2,4
0,0,16,16,15,23,38,65,48,113,0.000333,0.197672,14,8302.221326,461.234518,593.015809,162.645284,4,4
0,0,21,21,16,28,44,94,74,168,0.000333,0.305728,16,14674.95219,815.275122,917.184512,198.605938,4,4
0,0,21,21,16,27,43,84,65,149,0.000333,0.269504,16,12936.21518,718.678621,808.513448,192.381963,4,4
0,0,21,21,15,27,42,87,67,154,0.000333,0.276806,14,11625.83636,645.879798,830.416883,186.985321,4,4
0,0,11,11,10,13,23,39,29,68,0.000333,0.102534,10,3076.02213,170.890118,307.602213,81.324997,2,4
0,0,11,11,11,14,25,41,29,70,0.000333,0.108357,10,3250.699333,180.594407,325.069933,91.356717,2,4
0,0,11,11,10,14,24,40,29,69,0.000333,0.105454,10,3163.624125,175.756896,316.362413,86.52225,2,4
0,0,16,16,13,20,33,69,55,124,0.000333,0.208502,12,7506.05845,417.003247,625.504871,134.544278,2,4
0,0,16,16,11,18,29,59,46,105,0.000333,0.170029,10,5100.880045,283.382225,510.088004,113.112398,2,4
0,0,16,16,12,19,31,62,48,110,0.000333,0.181654,12,6539.53913,363.307729,544.961594,123.730173,2,4
0,0,14,14,15,18,33,54,39,93,0.000333,0.156376,14,6567.801143,364.877841,469.128653,133.662009,4,4
0,0,16,16,15,18,33,60,41,101,0.000333,0.169828,14,7132.773285,396.265182,509.483806,133.662009,6,4
0,0,16,16,15,19,34,60,43,103,0.000333,0.17467,14,7336.121417,407.562301,524.008673,139.313982,6,4
0,0,17,17,15,19,34,65,44,109,0.000333,0.184844,14,7763.468296,431.303794,554.53345,139.313982,6,4
0,0,16,16,15,19,34,60,41,101,0.000333,0.171278,14,7193.672458,399.64847,513.833747,139.313982,6,4
0,0,16,16,15,20,35,60,43,103,0.000333,0.176105,14,7396.42611,410.912562,528.316151,145.041921,6,4
0,0,16,16,15,20,35,60,43,103,0.000333,0.176105,14,7396.42611,410.912562,528.316151,145.041921,6,4
0,0,16,16,15,19,34,60,41,101,0.000333,0.171278,14,7193.672458,399.64847,513.833747,139.313982,6,4
0,0,16,16,15,19,34,60,41,101,0.000333,0.171278,14,7193.672458,399.64847,513.833747,139.313982,6,4
0,0,16,16,15,19,34,60,41,101,0.000333,0.171278,14,7193.672458,399.64847,513.833747,139.313982,6,4
0,0,16,16,15,19,34,60,41,101,0.000333,0.171278,14,7193.672458,399.64847,513.833747,139.313982,6,4
0,0,16,16,15,20,35,60,43,103,0.000333,0.176105,14,7396.42611,410.912562,528.316151,145.041921,6,4
0,0,16,16,15,20,35,60,43,103,0.000333,0.176105,14,7396.42611,410.912562,528.316151,145.041921,6,4
0,0,22,22,19,21,40,74,45,119,0.000333,0.211103,18,11399.56998,633.309443,633.309443,172.949289,6,4
0,0,18,18,16,18,34,64,41,105,0.000333,0.178061,16,8546.937573,474.829865,534.183598,139.05865,6,4
0,0,16,16,18,20,38,70,49,119,0.000333,0.208168,18,11241.06073,624.503374,624.503374,161.497212,6,4
0,0,18,18,17,20,37,60,43,103,0.000333,0.178858,16,8585.179147,476.954397,536.573697,155.92543,4,4
0,0,18,18,16,21,37,65,48,113,0.000333,0.196223,16,9418.691685,523.260649,588.66823,156.238666,5,4
0,0,18,18,15,21,36,64,48,112,0.000333,0.193011,14,8106.442402,450.357911,579.0316,150.842025,5,4
0,0,16,16,15,19,34,58,45,103,0.000333,0.17467,14,7336.121417,407.562301,524.008673,139.313982,4,4
0,0,19,19,16,20,36,71,53,124,0.000333,0.21369,16,10257.1312,569.840622,641.0707,150.438562,4,4
0,0,16,16,16,19,35,59,45,104,0.000333,0.177815,16,8535.12694,474.173719,533.445434,144.710623,4,4
0,0,17,17,16,22,38,61,48,109,0.000333,0.190675,16,9152.385583,508.465866,572.024099,162.107496,4,4
0,0,16,16,16,20,36,60,45,105,0.000333,0.180947,16,8685.474002,482.526333,542.842125,150.438562,4,4
0,0,17,17,17,19,36,63,47,110,0.000333,0.189564,16,9099.068003,505.503778,568.69175,150.197491,4,4
0,0,16,16,16,20,36,60,45,105,0.000333,0.180947,16,8685.474002,482.526333,542.842125,150.438562,4,4
0,0,17,17,16,21,37,67,49,116,0.000333,0.201432,16,9668.745447,537.152525,604.29659,156.238666,4,4
0,0,18,18,16,21,37,60,47,107,0.000333,0.185804,16,8918.584162,495.476898,557.41151,156.238666,4,4
0,0,16,16,15,20,35,59,45,104,0.000333,0.177815,14,7468.236073,414.902004,533.445434,145.041921,4,4
0,0,18,18,15,21,36,64,51,115,0.000333,0.19818,14,8323.579252,462.42107,594.541375,150.842025,4,4
0,0,20,20,15,22,37,69,57,126,0.000333,0.218797,14,9189.475737,510.52643,656.391124,156.710855,4,4
0,0,22,22,15,23,38,74,63,137,0.000333,0.239655,14,10065.52497,559.195832,718.966069,162.645284,4,4
0,0,17,17,16,19,35,62,47,109,0.000333,0.186364,16,8945.469582,496.970532,559.091849,144.710623,4,4
0,0,16,16,16,20,36,60,45,105,0.000333,0.180947,16,8685.474002,482.526333,542.842125,150.438562,4,4
0,0,17,17,16,21,37,64,48,112,0.000333,0.194486,16,9335.340431,518.630024,583.458777,156.238666,4,4
0,0,18,18,16,22,38,72,52,124,0.000333,0.216914,16,10411.88819,578.438233,650.743012,162.107496,4,4
0,0,17,17,15,21,36,66,49,115,0.000333,0.19818,14,8323.579252,462.42107,594.541375,150.842025,4,4
0,0,19,19,15,23,38,72,55,127,0.000333,0.222162,14,9330.815119,518.378618,666.486794,162.645284,4,4
0,0,19,19,16,23,39,66,54,120,0.000333,0.211416,16,10147.97226,563.776237,634.248266,168.041925,4,4
0,0,18,18,15,21,36,59,47,106,0.000333,0.182671,14,7672.168702,426.231595,548.01205,150.842025,4,4
0,0,21,21,17,25,42,89,71,160,0.000333,0.28759,16,13804.3326,766.907367,862.770788,185.583273,4,4
0,0,21,21,17,24,41,79,62,141,0.000333,0.251805,16,12086.63732,671.479851,755.414833,179.525968,4,4
0,0,21,21,16,24,40,82,64,146,0.000333,0.259001,16,12432.02403,690.668002,777.001502,174.0391,4,4
0,0,11,11,13,15,28,45,31,76,0.000333,0.121786,12,4384.307689,243.572649,365.358974,106.709075,3,4
0,0,13,13,13,16,29,51,33,84,0.000333,0.136023,12,4896.844843,272.046936,408.070404,112.105716,5,4
0,0,13,13,13,16,29,51,35,86,0.000333,0.139262,12,5013.436387,278.524244,417.786366,112.105716,5,4
0,0,13,13,13,16,29,51,33,84,0.000333,0.136023,12,4896.844843,272.046936,408.070404,112.105716,5,4
0,0,13,13,13,16,29,51,33,84,0.000333,0.136023,12,4896.844843,272.046936,408.070404,112.105716,5,4
0,0,13,13,13,17,30,51,35,86,0.000333,0.140664,12,5063.911095,281.328394,421.992591,117.592585,5,4
0,0,13,13,13,17,30,51,35,86,0.000333,0.140664,12,5063.911095,281.328394,421.992591,117.592585,5,4
0,0,13,13,13,16,29,51,33,84,0.000333,0.136023,12,4896.844843,272.046936,408.070404,112.105716,5,4
0,0,13,13,13,16,29,51,33,84,0.000333,0.136023,12,4896.844843,272.046936,408.070404,112.105716,5,4
0,0,13,13,13,16,29,51,33,84,0.000333,0.136023,12,4896.844843,272.046936,408.070404,112.105716,5,4
0,0,13,13,13,16,29,51,33,84,0.000333,0.136023,12,4896.844843,272.046936,408.070404,112.105716,5,4
0,0,13,13,13,17,30,51,35,86,0.000333,0.140664,12,5063.911095,281.328394,421.992591,117.592585,5,4
0,0,13,13,13,17,30,51,35,86,0.000333,0.140664,12,5063.911095,281.328394,421.992591,117.592585,5,4
0,0,19,19,18,18,36,65,37,102,0.000333,0.175777,18,9491.982303,527.33235,527.33235,150.1173,5,4
0,0,3,3,6,6,12,10,8,18,0.000333,0.02151,3,193.587975,10.754888,64.529325,31.01955,1,4
0,0,5,5,8,8,16,20,16,36,0.000333,0.048,8,1152,64,144,48,1,4
0,0,4,4,7,3,10,12,6,18,0.000333,0.019932,6,358.768234,19.931569,59.794706,24.406372,1,4
0,0,6,6,9,6,15,22,13,35,0.000333,0.04558,8,1093.929367,60.773854,136.741171,44.0391,1,4
0,0,6,6,7,7,14,14,12,26,0.000333,0.032997,3,296.973684,16.498538,98.991228,39.302969,1,4
0,0,6,6,7,7,14,14,12,26,0.000333,0.032997,3,296.973684,16.498538,98.991228,39.302969,1,4
0,0,4,4,9,4,13,18,10,28,0.000333,0.034537,8,828.898497,46.049916,103.612312,36.529325,2,4
0,0,7,7,9,7,16,35,20,55,0.000333,0.073333,8,1760,97.777778,220,48.180809,2,4
0,0,5,5,14,7,21,30,14,44,0.000333,0.064421,14,2705.667532,150.314863,193.261967,72.954453,2,4
0,0,8,8,14,10,24,47,24,71,0.000333,0.108511,14,4557.452726,253.191818,325.532338,86.52225,2,4
0,0,5,5,11,6,17,23,12,35,0.000333,0.047687,10,1430.611994,79.478444,143.061199,53.563523,2,4
0,0,7,7,11,7,18,38,18,56,0.000333,0.077839,10,2335.158001,129.731,233.5158,57.705232,2,4
0,0,9,9,14,11,25,49,36,85,0.000333,0.131576,21,8289.283299,460.515739,394.727776,91.356717,2,4
0,0,10,10,14,12,26,62,41,103,0.000333,0.161382,21,10167.05111,564.836173,484.145291,96.322519,2,4
0,0,10,10,11,9,20,41,29,70,0.000333,0.100845,15,4538.0245,252.112472,302.534967,66.583073,2,4
0,0,11,11,11,10,21,54,34,88,0.000333,0.128841,15,5797.858998,322.103278,386.523933,71.273029,2,4
0,0,10,10,13,11,24,44,31,75,0.000333,0.114624,12,4126.466251,229.248125,343.872188,86.159464,2,4
0,0,11,11,13,13,26,58,37,95,0.000333,0.148847,12,5358.501279,297.694515,446.541773,96.211433,2,4
0,0,4,4,9,7,16,20,14,34,0.000333,0.045333,8,1088,60.444444,136,48.180809,2,4
0,0,5,5,9,8,17,22,16,38,0.000333,0.051775,8,1242.588704,69.032706,155.323588,52.529325,2,4
0,0,10,10,16,15,31,54,32,86,0.000333,0.14202,16,6816.974123,378.720785,426.060883,122.603359,3,4
0,0,11,11,16,16,32,65,36,101,0.000333,0.168333,16,8080,448.888889,505,128,3,4
0,0,11,11,16,17,33,55,34,89,0.000333,0.14965,16,7183.217226,399.067624,448.951077,133.486868,3,4
0,0,11,11,16,16,32,55,34,89,0.000333,0.148333,16,7120,395.555556,445,128,3,4
0,0,5,5,11,6,17,23,12,35,0.000333,0.047687,10,1430.611994,79.478444,143.061199,53.563523,2,4
0,0,6,6,11,7,18,35,16,51,0.000333,0.070889,10,2126.661751,118.147875,212.666175,57.705232,2,4
0,0,10,10,14,11,25,51,38,89,0.000333,0.137768,21,8679.367219,482.187068,413.303201,91.356717,2,4
0,0,11,11,14,12,26,64,43,107,0.000333,0.167649,21,10561.88805,586.771558,502.94705,96.322519,2,4
0,0,10,10,11,9,20,41,29,70,0.000333,0.100845,15,4538.0245,252.112472,302.534967,66.583073,2,4
0,0,11,11,11,10,21,54,34,88,0.000333,0.128841,15,5797.858998,322.103278,386.523933,71.273029,2,4
0,0,10,10,13,11,24,44,31,75,0.000333,0.114624,12,4126.466251,229.248125,343.872188,86.159464,2,4
0,0,12,12,13,12,25,61,39,100,0.000333,0.154795,18,8358.941142,464.385619,464.385619,91.125266,2,4
0,0,4,4,9,4,13,18,10,28,0.000333,0.034537,8,828.898497,46.049916,103.612312,36.529325,2,4
0,0,7,7,9,7,16,35,20,55,0.000333,0.073333,8,1760,97.777778,220,48.180809,2,4
0,0,9,9,11,10,21,38,26,64,0.000333,0.093703,10,2811.083151,156.171286,281.108315,71.273029,2,4
0,0,5,5,13,12,25,28,19,47,0.000333,0.072754,6,1309.567446,72.753747,218.261241,91.125266,2,4
0,0,6,6,13,13,26,29,21,50,0.000333,0.078341,6,1410.131915,78.340662,235.021986,96.211433,2,4
0,0,5,5,11,6,17,23,12,35,0.000333,0.047687,10,1430.611994,79.478444,143.061199,53.563523,2,4
0,0,6,6,11,7,18,34,16,50,0.000333,0.069499,10,2084.962501,115.83125,208.49625,57.705232,2,4
0,0,8,8,10,10,20,35,22,57,0.000333,0.082117,10,2463.499014,136.861056,246.349901,66.438562,2,4
0,0,15,15,18,22,40,85,60,145,0.000333,0.257227,18,13890.23233,771.679574,771.679574,173.166146,3,4
0,0,16,16,18,23,41,98,65,163,0.000333,0.291094,18,15719.05758,873.280977,873.280977,179.100575,3,4
0,0,16,16,18,21,39,77,53,130,0.000333,0.229034,18,12367.84119,687.102288,687.102288,167.297316,3,4
0,0,17,17,18,22,40,90,58,148,0.000333,0.262548,18,14177.61645,787.645358,787.645358,173.166146,3,4
0,0,16,16,17,21,38,80,55,135,0.000333,0.236157,16,11335.52343,629.751302,708.470214,161.725534,3,4
0,0,17,17,17,22,39,94,61,155,0.000333,0.273079,16,13107.7975,728.210972,819.237344,167.594364,3,4
0,0,4,4,9,4,13,18,10,28,0.000333,0.034537,8,828.898497,46.049916,103.612312,36.529325,2,4
0,0,7,7,9,7,16,35,20,55,0.000333,0.073333,8,1760,97.777778,220,48.180809,2,4
0,0,9,9,11,9,20,38,26,64,0.000333,0.092201,10,2766.033981,153.668554,276.603398,66.583073,2,4
0,0,8,8,16,14,30,44,26,70,0.000333,0.114494,8,2747.858734,152.658819,343.482342,117.302969,3,4
0,0,9,9,16,15,31,45,28,73,0.000333,0.120552,8,2893.250645,160.736147,361.656331,122.603359,3,4
0,0,5,5,11,6,17,23,12,35,0.000333,0.047687,10,1430.611994,79.478444,143.061199,53.563523,2,4
0,0,6,6,11,7,18,34,16,50,0.000333,0.069499,10,2084.962501,115.83125,208.49625,57.705232,2,4
0,0,20,20,18,25,43,106,71,177,0.000333,0.32015,18,17288.07951,960.448862,960.448862,191.155055,5,4
0,0,21,21,18,26,44,107,73,180,0.000333,0.327566,18,17688.55844,982.697691,982.697691,197.270083,5,4
0,0,21,21,18,27,45,119,76,195,0.000333,0.35697,18,19276.40437,1070.911354,1070.911354,203.440613,5,4
0,0,20,20,18,24,42,96,62,158,0.000333,0.283995,18,15335.75075,851.986153,851.986153,185.09775,5,4
0,0,21,21,18,25,43,109,67,176,0.000333,0.318341,18,17190.40674,955.022597,955.022597,191.155055,5,4
0,0,21,21,18,25,43,97,64,161,0.000333,0.29121,18,15725.31526,873.628626,873.628626,191.155055,5,4
0,0,20,20,17,23,40,99,64,163,0.000333,0.289158,16,13879.58847,771.088248,867.474279,173.528793,5,4
0,0,21,21,17,24,41,113,70,183,0.000333,0.326811,16,15686.91227,871.495126,980.432017,179.525968,5,4
0,0,21,21,17,24,41,101,66,167,0.000333,0.298237,16,14315.37896,795.298831,894.711185,179.525968,5,4
0,0,4,4,9,4,13,18,10,28,0.000333,0.034537,8,828.898497,46.049916,103.612312,36.529325,2,4
0,0,7,7,9,7,16,36,20,56,0.000333,0.074667,8,1792,99.555556,224,48.180809,2,4
0,0,6,6,13,8,21,27,15,42,0.000333,0.061492,6,1106.863991,61.492444,184.477332,72.105716,2,4
0,0,7,7,13,9,22,38,19,57,0.000333,0.084729,12,3050.251227,169.458402,254.187602,76.635041,2,4
0,0,5,5,11,6,17,23,12,35,0.000333,0.047687,10,1430.611994,79.478444,143.061199,53.563523,2,4
0,0,6,6,11,7,18,34,16,50,0.000333,0.069499,10,2084.962501,115.83125,208.49625,57.705232,2,4
0,0,13,13,15,16,31,70,48,118,0.000333,0.194865,21,12276.49846,682.027692,584.595165,122.603359,2,4
0,0,14,14,15,17,32,83,53,136,0.000333,0.226667,21,14280,793.333333,680,128.090227,2,4
0,0,13,13,15,14,29,60,39,99,0.000333,0.160313,14,6733.161659,374.064537,480.940119,111.906328,2,4
0,0,14,14,15,16,31,73,44,117,0.000333,0.193214,14,8114.973556,450.831864,579.640968,122.603359,2,4
0,0,13,13,15,14,29,60,39,99,0.000333,0.160313,14,6733.161659,374.064537,480.940119,111.906328,2,4
0,0,13,13,14,15,29,63,41,104,0.000333,0.16841,14,7073.220329,392.956685,505.230023,111.906328,2,4
0,0,15,15,14,16,30,80,49,129,0.000333,0.210996,21,13292.76662,738.487035,632.988887,117.302969,2,4
0,0,13,13,14,15,29,63,41,104,0.000333,0.16841,14,7073.220329,392.956685,505.230023,111.906328,2,4
0,0,4,4,9,4,13,18,10,28,0.000333,0.034537,8,828.898497,46.049916,103.612312,36.529325,2,4
0,0,7,7,9,7,16,36,20,56,0.000333,0.074667,8,1792,99.555556,224,48.180809,2,4
0,0,5,5,14,7,21,30,14,44,0.000333,0.064421,14,2705.667532,150.314863,193.261967,72.954453,2,4
0,0,8,8,15,10,25,48,24,72,0.000333,0.111453,14,4681.007039,260.055947,334.357646,91.82264,2,4
0,0,5,5,11,6,17,23,12,35,0.000333,0.047687,10,1430.611994,79.478444,143.061199,53.563523,2,4
0,0,6,6,11,7,18,34,16,50,0.000333,0.069499,10,2084.962501,115.83125,208.49625,57.705232,2,4
0,0,24,24,21,23,44,130,80,210,0.000333,0.38216,30,34394.4192,1910.801067,1146.48064,196.280591,6,4
0,0,24,24,21,23,44,130,80,210,0.000333,0.38216,30,34394.4192,1910.801067,1146.48064,196.280591,6,4
0,0,25,25,21,25,46,129,82,211,0.000333,0.388491,30,34964.14718,1942.452621,1165.471573,208.335071,6,4
0,0,25,25,21,24,45,143,85,228,0.000333,0.417381,30,37564.27518,2086.904177,1252.142506,202.277766,6,4
0,0,24,24,21,22,43,120,71,191,0.000333,0.345472,30,31092.49704,1727.360947,1036.416568,190.346161,6,4
0,0,25,25,21,23,44,133,76,209,0.000333,0.38034,30,34230.63625,1901.702014,1141.021208,196.280591,6,4
0,0,25,25,21,24,45,119,73,192,0.000333,0.351479,30,31633.07384,1757.392991,1054.435794,202.277766,6,4
0,0,23,23,20,22,42,121,71,192,0.000333,0.345108,30,31059.74836,1725.541575,1035.324945,184.546058,6,4
0,0,24,24,20,23,43,135,77,212,0.000333,0.383456,30,34511.04384,1917.280213,1150.368128,190.480487,6,4
0,0,23,23,20,22,42,121,71,192,0.000333,0.345108,30,31059.74836,1725.541575,1035.324945,184.546058,6,4
0,0,24,24,20,23,43,120,73,193,0.000333,0.34909,30,31418.07293,1745.448496,1047.269098,190.480487,6,4
0,0,4,4,9,4,13,18,10,28,0.000333,0.034537,8,828.898497,46.049916,103.612312,36.529325,2,4
0,0,7,7,9,7,16,36,20,56,0.000333,0.074667,8,1792,99.555556,224,48.180809,2,4
0,0,5,5,14,7,21,30,14,44,0.000333,0.064421,14,2705.667532,150.314863,193.261967,72.954453,2,4
0,0,8,8,15,10,25,48,24,72,0.000333,0.111453,14,4681.007039,260.055947,334.357646,91.82264,2,4
0,0,6,6,14,8,22,31,16,47,0.000333,0.069864,14,2934.306005,163.017,209.593286,77.302969,2,4
0,0,5,5,11,6,17,23,12,35,0.000333,0.047687,10,1430.611994,79.478444,143.061199,53.563523,2,4
0,0,6,6,11,7,18,34,16,50,0.000333,0.069499,10,2084.962501,115.83125,208.49625,57.705232,2,4
0,0,4,4,12,8,20,21,13,34,0.000333,0.048982,6,881.673331,48.981852,146.945555,67.01955,2,4
0,0,17,17,21,21,42,96,59,155,0.000333,0.278603,20,16716.18401,928.676889,835.809201,184.477332,4,4
0,0,18,18,21,22,43,109,64,173,0.000333,0.312915,20,18774.87605,1043.04867,938.743803,190.346161,4,4
0,0,18,18,21,22,43,95,61,156,0.000333,0.282166,20,16929.94604,940.552557,846.497302,190.346161,4,4
0,0,17,17,21,21,42,96,59,155,0.000333,0.278603,20,16716.18401,928.676889,835.809201,184.477332,4,4
0,0,17,17,20,21,41,99,61,160,0.000333,0.285736,20,17144.16642,952.45369,857.208321,178.677228,4,4
0,0,18,18,20,22,42,113,67,180,0.000333,0.323539,30,29118.51408,1617.695227,970.617136,184.546058,4,4
0,0,18,18,20,23,43,99,63,162,0.000333,0.293018,20,17581.09781,976.727656,879.05489,190.480487,4,4
0,0,4,4,9,4,13,18,10,28,0.000333,0.034537,8,828.898497,46.049916,103.612312,36.529325,2,4
0,0,7,7,9,7,16,36,20,56,0.000333,0.074667,8,1792,99.555556,224,48.180809,2,4
0,0,10,10,16,15,31,54,32,86,0.000333,0.14202,16,6816.974123,378.720785,426.060883,122.603359,3,4
0,0,11,11,16,16,32,55,34,89,0.000333,0.148333,16,7120,395.555556,445,128,3,4
0,0,5,5,11,6,17,23,12,35,0.000333,0.047687,10,1430.611994,79.478444,143.061199,53.563523,2,4
0,0,6,6,11,7,18,33,16,49,0.000333,0.068109,10,2043.263251,113.514625,204.326325,57.705232,2,4
0,0,20,20,20,21,41,111,73,184,0.000333,0.328597,30,29573.68707,1642.982615,985.789569,178.677228,6,4
0,0,21,21,20,22,42,124,78,202,0.000333,0.363083,30,32677.44358,1815.413532,1089.248119,184.546058,6,4
0,0,21,21,20,22,42,113,75,188,0.000333,0.337919,30,30412.67026,1689.592792,1013.755675,184.546058,6,4
0,0,20,20,20,20,40,101,64,165,0.000333,0.292706,30,26343.54407,1463.530226,878.118136,172.877124,6,4
0,0,21,21,20,21,41,114,69,183,0.000333,0.326811,30,29412.96051,1634.053361,980.432017,178.677228,6,4
0,0,21,21,20,21,41,103,66,169,0.000333,0.301809,30,27162.78866,1509.043815,905.426289,178.677228,6,4
0,0,20,20,19,19,38,104,66,170,0.000333,0.297383,27,24087.98729,1338.221516,892.147677,161.421246,6,4
0,0,21,21,19,20,39,118,72,190,0.000333,0.334742,27,27114.11338,1506.339632,1004.226422,167.149185,6,4
0,0,21,21,19,20,39,106,68,174,0.000333,0.306553,27,24830.81962,1379.489979,919.659986,167.149185,6,4
0,0,4,4,9,4,13,18,10,28,0.000333,0.034537,8,828.898497,46.049916,103.612312,36.529325,2,4
0,0,7,7,9,7,16,36,20,56,0.000333,0.074667,8,1792,99.555556,224,48.180809,2,4
0,0,9,9,11,10,21,38,26,64,0.000333,0.093703,10,2811.083151,156.171286,281.108315,71.273029,2,4
0,0,5,5,13,12,25,28,19,47,0.000333,0.072754,6,1309.567446,72.753747,218.261241,91.125266,2,4
0,0,6,6,13,13,26,29,21,50,0.000333,0.078341,6,1410.131915,78.340662,235.021986,96.211433,2,4
0,0,5,5,11,6,17,23,12,35,0.000333,0.047687,10,1430.611994,79.478444,143.061199,53.563523,2,4
0,0,6,6,11,7,18,33,16,49,0.000333,0.068109,10,2043.263251,113.514625,204.326325,57.705232,2,4
0,0,16,16,18,22,40,87,62,149,0.000333,0.264322,18,14273.41115,792.967286,792.967286,173.166146,3,4
0,0,17,17,18,23,41,100,67,167,0.000333,0.298237,18,16104.80133,894.711185,894.711185,179.100575,3,4
0,0,17,17,18,23,41,88,64,152,0.000333,0.271449,18,14658.26229,814.347905,814.347905,179.100575,3,4
0,0,16,16,18,21,39,77,53,130,0.000333,0.229034,18,12367.84119,687.102288,687.102288,167.297316,3,4
0,0,17,17,18,22,40,90,58,148,0.000333,0.262548,18,14177.61645,787.645358,787.645358,173.166146,3,4
0,0,17,17,18,22,40,78,55,133,0.000333,0.235939,18,12740.69586,707.816437,707.816437,173.166146,3,4
0,0,16,16,17,21,38,80,55,135,0.000333,0.236157,16,11335.52343,629.751302,708.470214,161.725534,3,4
0,0,17,17,17,22,39,94,61,155,0.000333,0.273079,16,13107.7975,728.210972,819.237344,167.594364,3,4
0,0,17,17,17,22,39,81,57,138,0.000333,0.243129,16,11670.1681,648.342672,729.385506,167.594364,3,4
0,0,4,4,9,4,13,18,10,28,0.000333,0.034537,8,828.898497,46.049916,103.612312,36.529325,2,4
0,0,7,7,9,8,17,36,20,56,0.000333,0.076299,8,1831.183353,101.732408,228.897919,52.529325,2,4
0,0,9,9,11,9,20,38,26,64,0.000333,0.092201,10,2766.033981,153.668554,276.603398,66.583073,2,4
0,0,8,8,16,14,30,44,26,70,0.000333,0.114494,8,2747.858734,152.658819,343.482342,117.302969,3,4
0,0,10,10,16,16,32,59,34,93,0.000333,0.155,16,7440,413.333333,465,128,3,4
0,0,9,9,16,15,31,45,28,73,0.000333,0.120552,8,2893.250645,160.736147,361.656331,122.603359,3,4
0,0,5,5,11,6,17,23,12,35,0.000333,0.047687,10,1430.611994,79.478444,143.061199,53.563523,2,4
0,0,6,6,11,8,19,34,16,50,0.000333,0.070799,10,2123.963757,117.997986,212.396376,62.053748,2,4
0,0,20,20,18,25,43,106,71,177,0.000333,0.32015,18,17288.07951,960.448862,960.448862,191.155055,5,4
0,0,21,21,18,26,44,119,76,195,0.000333,0.354863,18,19162.60498,1064.589166,1064.589166,197.270083,5,4
0,0,21,21,18,26,44,108,73,181,0.000333,0.329386,18,17786.82821,988.157123,988.157123,197.270083,5,4
0,0,20,20,18,24,42,96,62,158,0.000333,0.283995,18,15335.75075,851.986153,851.986153,185.09775,5,4
0,0,21,21,18,25,43,109,67,176,0.000333,0.318341,18,17190.40674,955.022597,955.022597,191.155055,5,4
0,0,21,21,18,25,43,98,64,162,0.000333,0.293018,18,15822.98803,879.05489,879.05489,191.155055,5,4
0,0,20,20,17,23,40,99,64,163,0.000333,0.289158,16,13879.58847,771.088248,867.474279,173.528793,5,4
0,0,21,21,17,24,41,113,70,183,0.000333,0.326811,16,15686.91227,871.495126,980.432017,179.525968,5,4
0,0,21,21,17,24,41,101,66,167,0.000333,0.298237,16,14315.37896,795.298831,894.711185,179.525968,5,4
0,0,4,4,9,4,13,18,10,28,0.000333,0.034537,8,828.898497,46.049916,103.612312,36.529325,2,4
0,0,7,7,9,8,17,36,20,56,0.000333,0.076299,8,1831.183353,101.732408,228.897919,52.529325,2,4
0,0,9,9,11,9,20,38,26,64,0.000333,0.092201,10,2766.033981,153.668554,276.603398,66.583073,2,4
0,0,6,6,13,8,21,27,15,42,0.000333,0.061492,6,1106.863991,61.492444,184.477332,72.105716,2,4
0,0,7,7,13,10,23,38,19,57,0.000333,0.085948,6,1547.058189,85.947677,257.843031,81.324997,2,4
0,0,9,9,12,11,23,40,25,65,0.000333,0.098011,12,3528.378326,196.021018,294.031527,81.073298,2,4
0,0,5,5,11,6,17,23,12,35,0.000333,0.047687,10,1430.611994,79.478444,143.061199,53.563523,2,4
0,0,6,6,11,8,19,34,16,50,0.000333,0.070799,10,2123.963757,117.997986,212.396376,62.053748,2,4
0,0,8,8,10,9,19,36,22,58,0.000333,0.082127,10,2463.797958,136.877664,246.379796,61.748606,2,4
0,0,13,13,15,16,31,70,48,118,0.000333,0.194865,21,12276.49846,682.027692,584.595165,122.603359,2,4
0,0,14,14,15,17,32,83,53,136,0.000333,0.226667,21,14280,793.333333,680,128.090227,2,4
0,0,13,13,15,14,29,60,39,99,0.000333,0.160313,14,6733.161659,374.064537,480.940119,111.906328,2,4
0,0,14,14,15,15,30,73,44,117,0.000333,0.191369,14,8037.486796,446.527044,574.1062,117.206718,2,4
0,0,13,13,14,15,29,63,41,104,0.000333,0.16841,14,7073.220329,392.956685,505.230023,111.906328,2,4
0,0,14,14,14,16,30,77,47,124,0.000333,0.202818,14,8518.362074,473.242337,608.454434,117.302969,2,4
0,0,13,13,14,15,29,63,41,104,0.000333,0.16841,14,7073.220329,392.956685,505.230023,111.906328,2,4
0,0,4,4,9,4,13,18,10,28,0.000333,0.034537,8,828.898497,46.049916,103.612312,36.529325,2,4
0,0,7,7,9,8,17,36,20,56,0.000333,0.076299,8,1831.183353,101.732408,228.897919,52.529325,2,4
0,0,9,9,11,9,20,38,26,64,0.000333,0.092201,10,2766.033981,153.668554,276.603398,66.583073,2,4
0,0,5,5,14,7,21,30,14,44,0.000333,0.064421,14,2705.667532,150.314863,193.261967,72.954453,2,4
0,0,8,8,15,11,26,48,24,72,0.000333,0.112811,14,4738.043236,263.224624,338.43166,96.657107,2,4
0,0,10,10,14,12,26,50,30,80,0.000333,0.125345,14,5264.492484,292.471805,376.035177,96.322519,2,4
0,0,5,5,11,6,17,23,12,35,0.000333,0.047687,10,1430.611994,79.478444,143.061199,53.563523,2,4
0,0,6,6,11,8,19,34,16,50,0.000333,0.070799,10,2123.963757,117.997986,212.396376,62.053748,2,4
0,0,8,8,10,9,19,35,22,57,0.000333,0.080711,10,2421.318683,134.517705,242.131868,61.748606,2,4
0,0,24,24,21,24,45,130,80,210,0.000333,0.38443,30,34598.67451,1922.148584,1153.28915,202.277766,6,4
0,0,25,25,21,25,46,143,85,228,0.000333,0.419791,30,37781.16378,2098.953543,1259.372126,208.335071,6,4
0,0,25,25,21,25,46,131,82,213,0.000333,0.392173,30,35295.5609,1960.864494,1176.518697,208.335071,6,4
0,0,24,24,21,23,44,120,71,191,0.000333,0.347584,30,31282.54318,1737.919065,1042.751439,196.280591,6,4
0,0,26,26,22,25,47,137,80,217,0.000333,0.401782,33,39776.41077,2209.800598,1205.345781,214.2039,6,4
0,0,25,25,21,24,45,122,73,195,0.000333,0.35697,30,32127.34061,1784.852256,1070.911354,202.277766,6,4
0,0,24,24,20,23,43,123,73,196,0.000333,0.354516,30,31906.43676,1772.57982,1063.547892,190.480487,6,4
0,0,25,25,20,24,44,137,79,216,0.000333,0.393079,30,35377.11689,1965.395383,1179.23723,196.477662,6,4
0,0,25,25,20,24,44,125,75,200,0.000333,0.363962,30,32756.58971,1819.81054,1091.886324,196.477662,6,4
0,0,8,8,13,12,25,48,35,83,0.000333,0.12848,12,4625.280765,256.960043,385.440064,91.125266,1,4
0,0,9,9,13,13,26,61,40,101,0.000333,0.158248,18,8545.399408,474.744412,474.744412,96.211433,1,4
0,0,16,16,15,21,36,64,48,112,0.000333,0.193011,14,8106.442402,450.357911,579.0316,150.842025,4,4
0,0,19,19,15,24,39,79,58,137,0.000333,0.241367,14,10137.40146,563.18897,724.100104,168.642459,4,4
0,0,17,17,15,22,37,66,50,116,0.000333,0.201432,14,8460.152266,470.008459,604.29659,156.710855,4,4
0,0,21,21,15,26,41,84,64,148,0.000333,0.264306,14,11100.84775,616.713764,792.917697,180.814792,4,4
0,0,16,16,16,22,38,66,48,114,0.000333,0.199421,16,9572.219785,531.789988,598.263737,162.107496,4,4
0,0,17,17,16,23,39,76,52,128,0.000333,0.22551,16,10824.50374,601.361319,676.531484,168.041925,4,4
0,0,17,17,16,23,39,68,50,118,0.000333,0.207892,16,9978.839389,554.379966,623.677462,168.041925,4,4
0,0,19,19,14,25,39,79,58,137,0.000333,0.241367,14,10137.40146,563.18897,724.100104,169.399374,4,4
0,0,16,16,15,22,37,65,48,113,0.000333,0.196223,14,8241.355224,457.853068,588.66823,156.710855,4,4
0,0,17,17,15,23,38,75,52,127,0.000333,0.222162,14,9330.815119,518.378618,666.486794,162.645284,4,4
0,0,17,17,15,23,38,67,50,117,0.000333,0.204669,14,8596.105267,477.561404,614.007519,162.645284,4,4
0,0,19,19,14,25,39,79,58,137,0.000333,0.241367,14,10137.40146,563.18897,724.100104,169.399374,4,4
0,0,21,21,16,27,43,94,74,168,0.000333,0.303871,16,14585.79966,810.322203,911.612479,192.381963,4,4
0,0,22,22,16,28,44,106,79,185,0.000333,0.336665,16,16159.91759,897.7732,1009.994849,198.605938,4,4
0,0,22,22,16,29,45,96,76,172,0.000333,0.314866,16,15113.57972,839.643318,944.598733,204.881449,4,4
0,0,21,21,16,27,43,94,74,168,0.000333,0.303871,16,14585.79966,810.322203,911.612479,192.381963,4,4
0,0,21,21,16,26,42,84,65,149,0.000333,0.267818,16,12855.28474,714.182485,803.455296,186.211433,4,4
0,0,22,22,16,27,43,96,70,166,0.000333,0.300253,16,14412.15919,800.67551,900.759949,192.381963,4,4
0,0,22,22,16,27,43,86,67,153,0.000333,0.27674,16,13283.49612,737.972007,830.218507,192.381963,4,4
0,0,21,21,16,26,42,84,65,149,0.000333,0.267818,16,12855.28474,714.182485,803.455296,186.211433,4,4
0,0,21,21,15,26,41,87,67,154,0.000333,0.275021,14,11550.88212,641.715673,825.063009,180.814792,4,4
0,0,22,22,15,27,42,100,73,173,0.000333,0.310957,14,13060.1928,725.566267,932.870914,186.985321,4,4
0,0,22,22,15,27,42,89,69,158,0.000333,0.283995,14,11927.80614,662.655897,851.986153,186.985321,4,4
0,0,21,21,15,26,41,87,67,154,0.000333,0.275021,14,11550.88212,641.715673,825.063009,180.814792,4,4
0,0,13,13,13,18,31,55,40,95,0.000333,0.156883,12,5647.783794,313.765766,470.648649,123.164366,3,4
0,0,14,14,13,19,32,57,42,99,0.000333,0.165,12,5940,330,495,128.816339,3,4
0,0,13,13,14,19,33,57,40,97,0.000333,0.163102,14,6850.287214,380.571512,489.30623,134.013592,3,4
0,0,15,15,14,20,34,69,48,117,0.000333,0.198411,14,8333.264134,462.959119,595.233152,139.741531,3,4
0,0,14,14,14,20,34,59,42,101,0.000333,0.171278,14,7193.672458,399.64847,513.833747,139.741531,3,4
0,0,16,16,13,22,35,71,50,121,0.000333,0.206881,12,7447.718941,413.762163,620.643245,146.213212,3,4
0,0,13,13,13,19,32,56,40,96,0.000333,0.16,12,5760,320,480,128.816339,3,4
0,0,14,14,13,20,33,66,44,110,0.000333,0.184961,12,6658.600238,369.922235,554.883353,134.544278,3,4
0,0,14,14,13,20,33,58,42,100,0.000333,0.168146,12,6053.272943,336.292941,504.439412,134.544278,3,4
0,0,16,16,12,22,34,70,50,120,0.000333,0.203499,12,7325.946491,406.997027,610.495541,141.127046,3,4
0,0,18,18,14,25,39,85,66,151,0.000333,0.266032,14,11173.34029,620.741127,798.095735,169.399374,3,4
0,0,19,19,14,26,40,97,71,168,0.000333,0.298028,14,12517.17488,695.398604,894.08392,175.514402,3,4
0,0,19,19,14,26,40,87,68,155,0.000333,0.274966,14,11548.58397,641.587998,824.898855,175.514402,3,4
0,0,18,18,14,23,37,75,57,132,0.000333,0.229216,14,9627.06982,534.837212,687.647844,157.344894,3,4
0,0,19,19,14,24,38,87,62,149,0.000333,0.260647,14,10947.17679,608.176489,781.9412,163.342069,3,4
0,0,19,19,14,24,38,77,59,136,0.000333,0.237906,14,9992.053986,555.11411,713.718142,163.342069,3,4
0,0,18,18,14,23,37,75,57,132,0.000333,0.229216,14,9627.06982,534.837212,687.647844,157.344894,3,4
0,0,18,18,14,27,41,80,62,142,0.000333,0.253591,14,10650.81339,591.711855,760.772385,181.684931,4,4
0,0,19,19,14,27,41,93,70,163,0.000333,0.291094,14,12225.93368,679.218537,873.280977,181.684931,4,4
0,0,19,19,14,28,42,82,64,146,0.000333,0.262426,14,11021.89681,612.327601,787.278344,187.908907,4,4
0,0,18,18,14,27,41,80,62,142,0.000333,0.253591,14,10650.81339,591.711855,760.772385,181.684931,4,4
0,0,11,11,11,14,25,44,30,74,0.000333,0.114548,10,3436.45358,190.914088,343.645358,91.356717,2,4
0,0,14,14,11,17,28,59,40,99,0.000333,0.158643,10,4759.281373,264.404521,475.928137,107.540616,2,4
0,0,12,12,11,15,26,46,32,78,0.000333,0.122211,10,3666.34298,203.685721,366.634298,96.657107,2,4
0,0,16,16,13,19,32,64,46,110,0.000333,0.183333,12,6600,366.666667,550,128.816339,2,4
0,0,11,11,12,15,27,46,30,76,0.000333,0.120457,12,4336.457402,240.9143,361.37145,101.622909,2,4
0,0,12,12,12,16,28,56,34,90,0.000333,0.144221,12,5191.943316,288.441295,432.661943,107.01955,2,4
0,0,12,12,12,17,29,48,32,80,0.000333,0.129546,6,2331.830878,129.54616,388.63848,112.506418,2,4
0,0,14,14,13,18,31,59,40,99,0.000333,0.163488,12,5885.585217,326.976956,490.465435,123.164366,2,4
0,0,9,9,9,14,23,40,27,67,0.000333,0.101026,4,1212.314604,67.350811,303.078651,81.832294,1,4
0,0,10,10,9,15,24,50,31,81,0.000333,0.123794,8,2971.0557,165.05865,371.381963,87.132684,1,4
0,0,11,11,11,17,28,50,33,83,0.000333,0.133003,5,1995.052293,110.836238,399.010459,107.540616,1,4
0,0,14,14,14,20,34,66,51,117,0.000333,0.198411,14,8333.264134,462.959119,595.233152,139.741531,1,4
0,0,15,15,14,21,35,78,56,134,0.000333,0.229108,14,9622.53494,534.585274,687.323924,145.541635,1,4
0,0,14,14,14,20,34,66,51,117,0.000333,0.198411,14,8333.264134,462.959119,595.233152,139.741531,1,4
0,0,14,14,12,18,30,56,42,98,0.000333,0.160292,12,5770.50334,320.583519,480.875278,118.0782,1,4
0,0,15,15,12,19,31,68,47,115,0.000333,0.189911,12,6836.790908,379.821717,569.732576,123.730173,1,4
0,0,14,14,12,18,30,56,42,98,0.000333,0.160292,12,5770.50334,320.583519,480.875278,118.0782,1,4
0,0,14,14,13,19,32,59,44,103,0.000333,0.171667,12,6180,343.333333,515,128.816339,1,4
0,0,15,15,13,20,33,72,50,122,0.000333,0.205139,12,7384.992991,410.277388,615.416083,134.544278,1,4
0,0,14,14,13,19,32,59,44,103,0.000333,0.171667,12,6180,343.333333,515,128.816339,1,4
0,0,16,16,15,21,36,64,48,112,0.000333,0.193011,14,8106.442402,450.357911,579.0316,150.842025,4,4
0,0,19,19,15,24,39,79,58,137,0.000333,0.241367,14,10137.40146,563.18897,724.100104,168.642459,4,4
0,0,17,17,15,23,38,66,50,116,0.000333,0.20292,14,8522.634282,473.479682,608.759592,162.645284,4,4
0,0,21,21,15,26,41,84,64,148,0.000333,0.264306,14,11100.84775,616.713764,792.917697,180.814792,4,4
0,0,16,16,16,22,38,66,48,114,0.000333,0.199421,16,9572.219785,531.789988,598.263737,162.107496,4,4
0,0,17,17,16,23,39,76,52,128,0.000333,0.22551,16,10824.50374,601.361319,676.531484,168.041925,4,4
0,0,17,17,16,24,40,68,50,118,0.000333,0.209329,16,10047.80024,558.211125,627.987515,174.0391,4,4
0,0,19,19,15,25,40,80,58,138,0.000333,0.244809,14,10281.96508,571.220282,734.426077,174.699764,4,4
0,0,15,15,15,22,37,66,48,114,0.000333,0.197959,14,8314.287572,461.904865,593.877684,156.710855,4,4
0,0,16,16,15,23,38,76,52,128,0.000333,0.223912,14,9404.286104,522.460339,671.734722,162.645284,4,4
0,0,16,16,15,24,39,68,50,118,0.000333,0.207892,14,8731.484466,485.08247,623.677462,168.642459,4,4
0,0,18,18,14,25,39,82,58,140,0.000333,0.246652,14,10359.38835,575.521575,739.956311,169.399374,4,4
0,0,20,20,16,27,43,92,72,164,0.000333,0.296636,16,14238.51872,791.028818,889.90742,192.381963,4,4
0,0,21,21,16,28,44,104,77,181,0.000333,0.329386,16,15810.51397,878.361887,988.157123,198.605938,4,4
0,0,21,21,16,28,44,94,74,168,0.000333,0.305728,16,14674.95219,815.275122,917.184512,198.605938,4,4
0,0,20,20,16,27,43,92,72,164,0.000333,0.296636,16,14238.51872,791.028818,889.90742,192.381963,4,4
0,0,20,20,16,26,42,82,63,145,0.000333,0.260629,16,12510.17642,695.009801,781.886026,186.211433,4,4
0,0,22,22,16,28,44,96,72,168,0.000333,0.305728,16,14674.95219,815.275122,917.184512,198.605938,4,4
0,0,21,21,16,28,44,84,65,149,0.000333,0.271152,16,13015.28498,723.071388,813.455311,198.605938,4,4
0,0,20,20,16,26,42,82,63,145,0.000333,0.260629,16,12510.17642,695.009801,781.886026,186.211433,4,4
0,0,20,20,15,26,41,85,65,150,0.000333,0.267878,14,11250.85921,625.047734,803.632801,180.814792,4,4
0,0,21,21,15,27,42,98,71,169,0.000333,0.303767,14,12758.22302,708.790168,911.301644,186.985321,4,4
0,0,21,21,15,27,42,87,67,154,0.000333,0.276806,14,11625.83636,645.879798,830.416883,186.985321,4,4
0,0,20,20,15,26,41,85,65,150,0.000333,0.267878,14,11250.85921,625.047734,803.632801,180.814792,4,4
0,0,11,11,10,13,23,39,29,68,0.000333,0.102534,10,3076.02213,170.890118,307.602213,81.324997,2,4
0,0,14,14,10,16,26,54,39,93,0.000333,0.145714,10,4371.408938,242.856052,437.140894,97.219281,2,4
0,0,12,12,10,15,25,41,31,72,0.000333,0.111453,10,3343.576457,185.754248,334.357646,91.82264,2,4
0,0,16,16,12,18,30,59,45,104,0.000333,0.170106,12,6123.799463,340.211081,510.316622,118.0782,2,4
0,0,11,11,11,14,25,41,29,70,0.000333,0.108357,10,3250.699333,180.594407,325.069933,91.356717,2,4
0,0,12,12,11,15,26,51,33,84,0.000333,0.131612,10,3948.369363,219.353854,394.836936,96.657107,2,4
0,0,12,12,11,15,26,43,31,74,0.000333,0.115944,10,3478.325391,193.2403,347.832539,96.657107,2,4
0,0,14,14,12,17,29,55,39,94,0.000333,0.152217,12,5479.802563,304.433476,456.650214,112.506418,2,4
0,0,10,10,10,14,24,41,29,70,0.000333,0.106982,10,3209.473751,178.304097,320.947375,86.52225,2,4
0,0,11,11,10,15,25,51,33,84,0.000333,0.130028,10,3900.839199,216.713289,390.08392,91.82264,2,4
0,0,11,11,10,16,26,43,31,74,0.000333,0.115944,5,1739.162696,96.62015,347.832539,97.219281,2,4
0,0,13,13,12,17,29,55,39,94,0.000333,0.152217,12,5479.802563,304.433476,456.650214,112.506418,2,4
0,0,15,15,13,20,33,67,53,120,0.000333,0.201776,12,7263.927532,403.55153,605.327294,134.544278,2,4
0,0,16,16,13,21,34,79,58,137,0.000333,0.232327,12,8363.788911,464.65494,696.982409,140.344382,2,4
0,0,16,16,13,21,34,69,55,124,0.000333,0.210282,12,7570.144708,420.563595,630.845392,140.344382,2,4
0,0,15,15,13,20,33,67,53,120,0.000333,0.201776,12,7263.927532,403.55153,605.327294,134.544278,2,4
0,0,15,15,11,18,29,57,44,101,0.000333,0.163552,10,4906.560805,272.586711,490.656081,113.112398,2,4
0,0,16,16,11,19,30,69,49,118,0.000333,0.193004,10,5790.130903,321.673939,579.01309,118.764371,2,4
0,0,16,16,11,20,31,59,46,105,0.000333,0.173397,10,5201.906126,288.994785,520.190613,124.49231,2,4
0,0,15,15,11,18,29,57,44,101,0.000333,0.163552,10,4906.560805,272.586711,490.656081,113.112398,2,4
0,0,15,15,12,19,31,60,46,106,0.000333,0.175048,12,6301.737707,350.096539,525.144809,123.730173,2,4
0,0,16,16,12,20,32,73,52,125,0.000333,0.208333,12,7500,416.666667,625,129.458112,2,4
0,0,16,16,12,20,32,62,48,110,0.000333,0.183333,12,6600,366.666667,550,129.458112,2,4
0,0,15,15,12,19,31,60,46,106,0.000333,0.175048,12,6301.737707,350.096539,525.144809,123.730173,2,4
0,0,16,16,15,22,37,64,48,112,0.000333,0.194486,14,8168.422877,453.801271,583.458777,156.710855,4,4
0,0,17,17,15,24,39,66,50,116,0.000333,0.204369,14,8583.493203,476.860734,613.106657,168.642459,4,4
0,0,16,16,16,23,39,66,48,114,0.000333,0.200845,16,9640.573647,535.587425,602.535853,168.041925,4,4
0,0,17,17,16,24,40,76,52,128,0.000333,0.227069,16,10899.30874,605.517152,681.206796,174.0391,4,4
0,0,17,17,16,25,41,68,50,118,0.000333,0.21073,16,10115.05819,561.947677,632.191137,180.096405,4,4
0,0,19,19,15,26,41,80,58,138,0.000333,0.246447,14,10350.79047,575.043915,739.342177,180.814792,4,4
0,0,16,16,15,23,38,65,48,113,0.000333,0.197672,14,8302.221326,461.234518,593.015809,162.645284,4,4
0,0,17,17,15,24,39,75,52,127,0.000333,0.223749,14,9397.445145,522.080286,671.246082,168.642459,4,4
0,0,17,17,15,24,39,67,50,117,0.000333,0.206131,14,8657.488834,480.971602,618.39206,168.642459,4,4
0,0,19,19,14,26,40,79,58,137,0.000333,0.243035,14,10207.45809,567.081005,729.104149,175.514402,4,4
0,0,21,21,16,28,44,94,74,168,0.000333,0.305728,16,14674.95219,815.275122,917.184512,198.605938,4,4
0,0,22,22,16,29,45,106,79,185,0.000333,0.338664,16,16255.88517,903.104731,1015.992823,204.881449,4,4
0,0,22,22,16,30,46,96,76,172,0.000333,0.316684,16,15200.8425,844.49125,950.052656,211.206718,4,4
0,0,21,21,16,28,44,94,74,168,0.000333,0.305728,16,14674.95219,815.275122,917.184512,198.605938,4,4
0,0,21,21,16,27,43,84,65,149,0.000333,0.269504,16,12936.21518,718.678621,808.513448,192.381963,4,4
0,0,22,22,16,28,44,96,70,166,0.000333,0.302089,16,14500.25038,805.569466,906.265649,198.605938,4,4
0,0,22,22,16,29,45,86,67,153,0.000333,0.280085,16,13444.05638,746.892021,840.253524,204.881449,4,4
0,0,21,21,16,27,43,84,65,149,0.000333,0.269504,16,12936.21518,718.678621,808.513448,192.381963,4,4
0,0,21,21,15,27,42,87,67,154,0.000333,0.276806,14,11625.83636,645.879798,830.416883,186.985321,4,4
0,0,22,22,15,28,43,100,73,173,0.000333,0.312915,14,13142.41324,730.134069,938.743803,193.209297,4,4
0,0,22,22,15,29,44,89,69,158,0.000333,0.28753,14,12076.26274,670.903486,862.590196,199.484808,4,4
0,0,21,21,15,27,42,87,67,154,0.000333,0.276806,14,11625.83636,645.879798,830.416883,186.985321,4,4
0,0,13,13,13,19,32,55,40,95,0.000333,0.158333,12,5700,316.666667,475,128.816339,3,4
0,0,16,16,13,22,35,70,50,120,0.000333,0.205171,12,7386.167544,410.342641,615.513962,146.213212,3,4
0,0,14,14,13,21,34,57,42,99,0.000333,0.167886,12,6043.905855,335.772548,503.658821,140.344382,3,4
0,0,18,18,13,24,37,75,56,131,0.000333,0.227479,12,8189.260691,454.958927,682.438391,158.144816,3,4
0,0,11,11,14,20,34,54,36,90,0.000333,0.152624,7,3205.10159,178.061199,457.871656,139.741531,3,4
0,0,12,12,14,21,35,64,40,104,0.000333,0.177815,7,3734.118036,207.451002,533.445434,145.541635,3,4
0,0,12,12,14,21,35,56,38,94,0.000333,0.160718,7,3375.068225,187.50379,482.152604,145.541635,3,4
0,0,14,14,13,23,36,68,46,114,0.000333,0.196457,12,7072.457402,392.9143,589.37145,152.147641,3,4
0,0,13,13,13,20,33,56,40,96,0.000333,0.161421,12,5811.142026,322.841224,484.261835,134.544278,3,4
0,0,14,14,13,21,34,66,44,110,0.000333,0.18654,12,6715.45095,373.080608,559.620913,140.344382,3,4
0,0,14,14,13,21,34,58,42,100,0.000333,0.169582,12,6104.95541,339.164189,508.746284,140.344382,3,4
0,0,16,16,12,23,35,70,50,120,0.000333,0.205171,12,7386.167544,410.342641,615.513962,147.061475,3,4
0,0,18,18,14,26,40,85,66,151,0.000333,0.26787,14,11250.55599,625.030888,803.611142,175.514402,3,4
0,0,19,19,14,27,41,97,71,168,0.000333,0.300023,14,12600.96232,700.053462,900.068737,181.684931,3,4
0,0,19,19,14,27,41,87,68,155,0.000333,0.276807,14,11625.88785,645.882658,830.420561,181.684931,3,4
0,0,18,18,14,26,40,85,66,151,0.000333,0.26787,14,11250.55599,625.030888,803.611142,175.514402,3,4
0,0,18,18,14,24,38,75,57,132,0.000333,0.230909,14,9698.170045,538.787225,692.726432,163.342069,3,4
0,0,18,18,14,24,38,75,57,132,0.000333,0.230909,14,9698.170045,538.787225,692.726432,163.342069,3,4
0,0,19,19,14,25,39,87,62,149,0.000333,0.262508,14,11025.34903,612.51939,787.524931,169.399374,3,4
0,0,19,19,14,25,39,77,59,136,0.000333,0.239605,14,10063.40583,559.078101,718.814702,169.399374,3,4
0,0,18,18,14,24,38,75,57,132,0.000333,0.230909,14,9698.170045,538.787225,692.726432,163.342069,3,4
0,0,18,18,13,25,38,78,59,137,0.000333,0.239655,12,8627.592832,479.310713,718.966069,164.202121,3,4
0,0,19,19,13,26,39,91,65,156,0.000333,0.274841,12,9894.272954,549.681831,824.522746,170.317149,3,4
0,0,19,19,13,26,39,80,61,141,0.000333,0.248414,12,8942.900554,496.827809,745.241713,170.317149,3,4
0,0,18,18,13,25,38,78,59,137,0.000333,0.239655,12,8627.592832,479.310713,718.966069,164.202121,3,4
0,0,11,11,11,14,25,44,30,74,0.000333,0.114548,10,3436.45358,190.914088,343.645358,91.356717,2,4
0,0,14,14,11,17,28,59,40,99,0.000333,0.158643,10,4759.281373,264.404521,475.928137,107.540616,2,4
0,0,12,12,11,15,26,46,32,78,0.000333,0.122211,10,3666.34298,203.685721,366.634298,96.657107,2,4
0,0,16,16,13,19,32,64,46,110,0.000333,0.183333,12,6600,366.666667,550,128.816339,2,4
0,0,11,11,12,15,27,46,30,76,0.000333,0.120457,12,4336.457402,240.9143,361.37145,101.622909,2,4
0,0,12,12,12,16,28,56,34,90,0.000333,0.144221,12,5191.943316,288.441295,432.661943,107.01955,2,4
0,0,12,12,12,16,28,48,32,80,0.000333,0.128196,12,4615.060725,256.392263,384.588394,107.01955,2,4
0,0,14,14,14,18,32,60,40,100,0.000333,0.166667,14,7000,388.888889,500,128.361619,2,4
0,0,11,11,11,15,26,45,30,75,0.000333,0.117511,10,3525.329789,195.851655,352.532979,96.657107,2,4
0,0,12,12,11,16,27,55,34,89,0.000333,0.141062,10,4231.849877,235.102771,423.184988,102.053748,2,4
0,0,12,12,11,17,28,47,32,79,0.000333,0.126594,5,1898.905194,105.494733,379.781039,107.540616,2,4
0,0,14,14,13,18,31,59,40,99,0.000333,0.163488,12,5885.585217,326.976956,490.465435,123.164366,2,4
0,0,16,16,15,21,36,74,56,130,0.000333,0.22403,14,9409.263503,522.736861,672.09025,150.842025,2,4
0,0,17,17,15,22,37,86,61,147,0.000333,0.255263,14,10721.05503,595.614168,765.789645,156.710855,2,4
0,0,17,17,15,22,37,76,58,134,0.000333,0.232689,14,9772.934514,542.940806,698.066751,156.710855,2,4
0,0,16,16,15,21,36,74,56,130,0.000333,0.22403,14,9409.263503,522.736861,672.09025,150.842025,2,4
0,0,16,16,13,19,32,64,47,111,0.000333,0.185,12,6660,370,555,128.816339,2,4
0,0,18,18,13,21,34,78,56,134,0.000333,0.22724,12,8180.640249,454.480014,681.720021,140.344382,2,4
0,0,17,17,13,20,33,66,49,115,0.000333,0.193368,12,6961.263885,386.736882,580.105324,134.544278,2,4
0,0,16,16,13,19,32,64,47,111,0.000333,0.185,12,6660,370,555,128.816339,2,4
0,0,16,16,14,20,34,67,49,116,0.000333,0.196715,14,8262.039654,459.002203,590.14569,139.741531,2,4
0,0,17,17,14,21,35,80,55,135,0.000333,0.230818,14,9694.344902,538.574717,692.453207,145.541635,2,4
0,0,17,17,14,21,35,69,51,120,0.000333,0.205171,14,8617.195468,478.733082,615.513962,145.541635,2,4
0,0,16,16,14,20,34,67,49,116,0.000333,0.196715,14,8262.039654,459.002203,590.14569,139.741531,2,4
0,0,16,16,15,22,37,64,48,112,0.000333,0.194486,14,8168.422877,453.801271,583.458777,156.710855,4,4
0,0,19,19,15,25,40,79,58,137,0.000333,0.243035,14,10207.45809,567.081005,729.104149,174.699764,4,4
0,0,17,17,15,23,38,66,50,116,0.000333,0.20292,14,8522.634282,473.479682,608.759592,162.645284,4,4
0,0,21,21,15,27,42,84,64,148,0.000333,0.266021,14,11172.8817,620.71565,798.062979,186.985321,4,4
0,0,11,11,11,16,27,41,30,71,0.000333,0.112532,5,1687.985063,93.776948,337.597013,102.053748,2,4
0,0,12,12,11,17,28,51,34,85,0.000333,0.136208,10,4086.251684,227.013982,408.625168,107.540616,2,4
0,0,12,12,11,17,28,43,32,75,0.000333,0.120184,5,1802.758096,100.153228,360.551619,107.540616,2,4
0,0,14,14,11,19,30,54,40,94,0.000333,0.153749,10,4612.47716,256.248731,461.247716,118.764371,2,4
0,0,16,16,15,23,38,65,48,113,0.000333,0.197672,14,8302.221326,461.234518,593.015809,162.645284,4,4
0,0,17,17,15,24,39,75,52,127,0.000333,0.223749,14,9397.445145,522.080286,671.246082,168.642459,4,4
0,0,17,17,15,24,39,67,50,117,0.000333,0.206131,14,8657.488834,480.971602,618.39206,168.642459,4,4
0,0,19,19,14,26,40,79,58,137,0.000333,0.243035,14,10207.45809,567.081005,729.104149,175.514402,4,4
0,0,21,21,16,28,44,94,74,168,0.000333,0.305728,16,14674.95219,815.275122,917.184512,198.605938,4,4
0,0,22,22,16,29,45,106,79,185,0.000333,0.338664,16,16255.88517,903.104731,1015.992823,204.881449,4,4
0,0,22,22,16,29,45,96,76,172,0.000333,0.314866,16,15113.57972,839.643318,944.598733,204.881449,4,4
0,0,21,21,16,28,44,94,74,168,0.000333,0.305728,16,14674.95219,815.275122,917.184512,198.605938,4,4
0,0,21,21,16,27,43,84,65,149,0.000333,0.269504,16,12936.21518,718.678621,808.513448,192.381963,4,4
0,0,22,22,16,28,44,96,70,166,0.000333,0.302089,16,14500.25038,805.569466,906.265649,198.605938,4,4
0,0,22,22,16,28,44,86,67,153,0.000333,0.278431,16,13364.6886,742.4827,835.293038,198.605938,4,4
0,0,21,21,16,27,43,84,65,149,0.000333,0.269504,16,12936.21518,718.678621,808.513448,192.381963,4,4
0,0,21,21,15,27,42,87,67,154,0.000333,0.276806,14,11625.83636,645.879798,830.416883,186.985321,4,4
0,0,22,22,15,28,43,100,73,173,0.000333,0.312915,14,13142.41324,730.134069,938.743803,193.209297,4,4
0,0,22,22,15,28,43,89,69,158,0.000333,0.285783,14,12002.89764,666.827647,857.349831,193.209297,4,4
0,0,21,21,15,27,42,87,67,154,0.000333,0.276806,14,11625.83636,645.879798,830.416883,186.985321,4,4
0,0,11,11,10,13,23,39,29,68,0.000333,0.102534,10,3076.02213,170.890118,307.602213,81.324997,2,4
0,0,14,14,10,16,26,54,39,93,0.000333,0.145714,10,4371.408938,242.856052,437.140894,97.219281,2,4
0,0,12,12,10,14,24,41,31,72,0.000333,0.110039,10,3301.173001,183.3985,330.1173,86.52225,2,4
0,0,16,16,12,18,30,59,45,104,0.000333,0.170106,12,6123.799463,340.211081,510.316622,118.0782,2,4
0,0,11,11,11,14,25,41,29,70,0.000333,0.108357,10,3250.699333,180.594407,325.069933,91.356717,2,4
0,0,12,12,11,15,26,51,33,84,0.000333,0.131612,10,3948.369363,219.353854,394.836936,96.657107,2,4
0,0,12,12,11,15,26,43,31,74,0.000333,0.115944,10,3478.325391,193.2403,347.832539,96.657107,2,4
0,0,14,14,12,17,29,55,39,94,0.000333,0.152217,12,5479.802563,304.433476,456.650214,112.506418,2,4
0,0,11,11,10,14,24,40,29,69,0.000333,0.105454,10,3163.624125,175.756896,316.362413,86.52225,2,4
0,0,12,12,10,15,25,50,33,83,0.000333,0.12848,10,3854.400638,214.133369,385.440064,91.82264,2,4
0,0,12,12,10,15,25,42,31,73,0.000333,0.113001,10,3390.015019,188.334168,339.001502,91.82264,2,4
0,0,14,14,11,17,28,54,39,93,0.000333,0.149028,10,4470.840078,248.380004,447.084008,107.540616,2,4
0,0,16,16,13,20,33,69,55,124,0.000333,0.208502,12,7506.05845,417.003247,625.504871,134.544278,2,4
0,0,17,17,13,21,34,81,60,141,0.000333,0.239111,12,8607.987127,478.221507,717.332261,140.344382,2,4
0,0,17,17,13,21,34,71,57,128,0.000333,0.217065,12,7814.342924,434.130162,651.195244,140.344382,2,4
0,0,16,16,13,20,33,69,55,124,0.000333,0.208502,12,7506.05845,417.003247,625.504871,134.544278,2,4
0,0,16,16,11,18,29,59,46,105,0.000333,0.170029,10,5100.880045,283.382225,510.088004,113.112398,2,4
0,0,17,17,11,19,30,71,51,122,0.000333,0.199547,10,5986.406527,332.57814,598.640653,118.764371,2,4
0,0,17,17,11,19,30,61,48,109,0.000333,0.178284,10,5348.510749,297.139486,534.851075,118.764371,2,4
0,0,16,16,11,18,29,59,46,105,0.000333,0.170029,10,5100.880045,283.382225,510.088004,113.112398,2,4
0,0,16,16,12,19,31,62,48,110,0.000333,0.181654,12,6539.53913,363.307729,544.961594,123.730173,2,4
0,0,17,17,12,20,32,75,54,129,0.000333,0.215,12,7740,430,645,129.458112,2,4
0,0,17,17,12,20,32,64,50,114,0.000333,0.19,12,6840,380,570,129.458112,2,4
0,0,16,16,12,19,31,62,48,110,0.000333,0.181654,12,6539.53913,363.307729,544.961594,123.730173,2,4
0,0,14,14,15,18,33,54,39,93,0.000333,0.156376,14,6567.801143,364.877841,469.128653,133.662009,4,4
0,0,17,17,15,21,36,69,49,118,0.000333,0.20335,14,8540.716102,474.484228,610.05115,150.842025,4,4
0,0,15,15,15,19,34,56,41,97,0.000333,0.164495,14,6908.774538,383.820808,493.483896,139.313982,4,4
0,0,19,19,15,23,38,74,55,129,0.000333,0.225661,14,9477.757089,526.542061,676.982649,162.645284,4,4
0,0,16,16,15,18,33,60,41,101,0.000333,0.169828,14,7132.773285,396.265182,509.483806,133.662009,6,4
0,0,19,19,15,21,36,75,51,126,0.000333,0.217137,14,9119.747703,506.65265,651.41055,150.842025,6,4
0,0,17,17,15,19,34,62,43,105,0.000333,0.178061,14,7478.570377,415.476132,534.183598,139.313982,6,4
0,0,21,21,15,23,38,80,57,137,0.000333,0.239655,14,10065.52497,559.195832,718.966069,162.645284,6,4
0,0,16,16,15,19,34,60,43,103,0.000333,0.17467,14,7336.121417,407.562301,524.008673,139.313982,6,4
0,0,19,19,15,22,37,75,53,128,0.000333,0.22227,14,9335.340431,518.630024,666.810031,156.710855,6,4
0,0,17,17,15,20,35,62,45,107,0.000333,0.182944,14,7683.665959,426.870331,548.833283,145.041921,6,4
0,0,21,21,15,23,38,80,59,139,0.000333,0.243154,14,10212.46694,567.359275,729.461924,162.645284,6,4
0,0,17,17,15,19,34,65,44,109,0.000333,0.184844,14,7763.468296,431.303794,554.53345,139.313982,6,4
0,0,20,20,15,22,37,80,54,134,0.000333,0.232689,14,9772.934514,542.940806,698.066751,156.710855,6,4
0,0,18,18,15,20,35,67,46,113,0.000333,0.193203,14,8114.525733,450.806985,579.608981,145.041921,6,4
0,0,22,22,15,24,39,85,60,145,0.000333,0.255461,14,10729.3665,596.075917,766.383322,168.642459,6,4
0,0,16,16,15,19,34,60,41,101,0.000333,0.171278,14,7193.672458,399.64847,513.833747,139.313982,6,4
0,0,19,19,15,22,37,75,51,126,0.000333,0.218797,14,9189.475737,510.52643,656.391124,156.710855,6,4
0,0,17,17,15,20,35,62,43,105,0.000333,0.179525,14,7540.046035,418.891446,538.574717,145.041921,6,4
0,0,21,21,15,24,39,80,57,137,0.000333,0.241367,14,10137.40146,563.18897,724.100104,168.642459,6,4
0,0,16,16,15,20,35,60,43,103,0.000333,0.176105,14,7396.42611,410.912562,528.316151,145.041921,6,4
0,0,19,19,15,23,38,75,53,128,0.000333,0.223912,14,9404.286104,522.460339,671.734722,162.645284,6,4
0,0,17,17,15,21,36,62,45,107,0.000333,0.184394,14,7744.547652,430.252647,553.181975,150.842025,6,4
0,0,21,21,15,24,39,80,59,139,0.000333,0.24489,14,10285.39272,571.410707,734.670908,168.642459,6,4
0,0,16,16,15,20,35,60,43,103,0.000333,0.176105,14,7396.42611,410.912562,528.316151,145.041921,6,4
0,0,19,19,15,23,38,75,53,128,0.000333,0.223912,14,9404.286104,522.460339,671.734722,162.645284,6,4
0,0,17,17,15,21,36,62,45,107,0.000333,0.184394,14,7744.547652,430.252647,553.181975,150.842025,6,4
0,0,21,21,15,24,39,80,59,139,0.000333,0.24489,14,10285.39272,571.410707,734.670908,168.642459,6,4
0,0,16,16,15,19,34,60,41,101,0.000333,0.171278,14,7193.672458,399.64847,513.833747,139.313982,6,4
0,0,19,19,15,22,37,75,51,126,0.000333,0.218797,14,9189.475737,510.52643,656.391124,156.710855,6,4
0,0,17,17,15,20,35,62,43,105,0.000333,0.179525,14,7540.046035,418.891446,538.574717,145.041921,6,4
0,0,21,21,15,24,39,80,57,137,0.000333,0.241367,14,10137.40146,563.18897,724.100104,168.642459,6,4
0,0,16,16,15,19,34,60,41,101,0.000333,0.171278,14,7193.672458,399.64847,513.833747,139.313982,6,4
0,0,19,19,15,22,37,75,51,126,0.000333,0.218797,14,9189.475737,510.52643,656.391124,156.710855,6,4
0,0,17,17,15,20,35,62,43,105,0.000333,0.179525,14,7540.046035,418.891446,538.574717,145.041921,6,4
0,0,21,21,15,24,39,80,57,137,0.000333,0.241367,14,10137.40146,563.18897,724.100104,168.642459,6,4
0,0,16,16,15,19,34,60,41,101,0.000333,0.171278,14,7193.672458,399.64847,513.833747,139.313982,6,4
0,0,19,19,15,22,37,75,51,126,0.000333,0.218797,14,9189.475737,510.52643,656.391124,156.710855,6,4
0,0,17,17,15,20,35,62,43,105,0.000333,0.179525,14,7540.046035,418.891446,538.574717,145.041921,6,4
0,0,21,21,15,24,39,80,57,137,0.000333,0.241367,14,10137.40146,563.18897,724.100104,168.642459,6,4
0,0,16,16,15,19,34,60,41,101,0.000333,0.171278,14,7193.672458,399.64847,513.833747,139.313982,6,4
0,0,19,19,15,22,37,75,51,126,0.000333,0.218797,14,9189.475737,510.52643,656.391124,156.710855,6,4
0,0,17,17,15,20,35,62,43,105,0.000333,0.179525,14,7540.046035,418.891446,538.574717,145.041921,6,4
0,0,21,21,15,24,39,80,57,137,0.000333,0.241367,14,10137.40146,563.18897,724.100104,168.642459,6,4
0,0,16,16,15,20,35,60,43,103,0.000333,0.176105,14,7396.42611,410.912562,528.316151,145.041921,6,4
0,0,19,19,15,23,38,75,53,128,0.000333,0.223912,14,9404.286104,522.460339,671.734722,162.645284,6,4
0,0,17,17,15,21,36,62,45,107,0.000333,0.184394,14,7744.547652,430.252647,553.181975,150.842025,6,4
0,0,21,21,15,24,39,80,59,139,0.000333,0.24489,14,10285.39272,571.410707,734.670908,168.642459,6,4
0,0,16,16,15,20,35,60,43,103,0.000333,0.176105,14,7396.42611,410.912562,528.316151,145.041921,6,4
0,0,19,19,15,23,38,75,53,128,0.000333,0.223912,14,9404.286104,522.460339,671.734722,162.645284,6,4
0,0,17,17,15,21,36,62,45,107,0.000333,0.184394,14,7744.547652,430.252647,553.181975,150.842025,6,4
0,0,21,21,15,24,39,80,59,139,0.000333,0.24489,14,10285.39272,571.410707,734.670908,168.642459,6,4
0,0,22,22,19,21,40,74,45,119,0.000333,0.211103,18,11399.56998,633.309443,633.309443,172.949289,6,4
0,0,25,25,19,24,43,89,55,144,0.000333,0.260461,18,14064.87824,781.382125,781.382125,190.749723,6,4
0,0,23,23,19,22,41,76,47,123,0.000333,0.21966,18,11861.62014,658.978897,658.978897,178.818118,6,4
0,0,27,27,19,26,45,94,61,155,0.000333,0.283746,18,15322.27014,851.23723,851.23723,202.922055,6,4
0,0,18,18,16,18,34,64,41,105,0.000333,0.178061,16,8546.937573,474.829865,534.183598,139.05865,6,4
0,0,21,21,16,21,37,79,51,130,0.000333,0.225743,16,10835.663,601.981278,677.228938,156.238666,6,4
0,0,19,19,16,19,35,66,43,109,0.000333,0.186364,16,8945.469582,496.970532,559.091849,144.710623,6,4
0,0,23,23,16,23,39,84,57,141,0.000333,0.248414,16,11923.86741,662.437078,745.241713,168.041925,6,4
0,0,16,16,18,20,38,70,49,119,0.000333,0.208168,18,11241.06073,624.503374,624.503374,161.497212,6,4
0,0,19,19,18,23,41,85,59,144,0.000333,0.257162,18,13886.7748,771.487489,771.487489,179.100575,6,4
0,0,17,17,18,21,39,72,51,123,0.000333,0.216701,18,11701.88051,650.104473,650.104473,167.297316,6,4
0,0,21,21,18,25,43,90,65,155,0.000333,0.280357,18,15139.27867,841.071037,841.071037,191.155055,6,4
0,0,18,18,17,20,37,60,43,103,0.000333,0.178858,16,8585.179147,476.954397,536.573697,155.92543,4,4
0,0,21,21,17,23,40,75,53,128,0.000333,0.227069,16,10899.30874,605.517152,681.206796,173.528793,4,4
0,0,19,19,17,21,38,62,45,107,0.000333,0.187176,16,8984.451903,499.136217,561.528244,161.725534,4,4
0,0,23,23,17,25,42,80,59,139,0.000333,0.249844,16,11992.51395,666.250775,749.532122,185.583273,4,4
0,0,18,18,16,21,37,65,48,113,0.000333,0.196223,16,9418.691685,523.260649,588.66823,156.238666,5,4
0,0,19,19,16,22,38,75,52,127,0.000333,0.222162,16,10663.78871,592.432706,666.486794,162.107496,5,4
0,0,19,19,16,22,38,67,50,117,0.000333,0.204669,16,9824.120305,545.784461,614.007519,162.107496,5,4
0,0,21,21,16,24,40,80,58,138,0.000333,0.244809,16,11750.81723,652.82318,734.426077,174.0391,5,4
0,0,18,18,15,21,36,64,48,112,0.000333,0.193011,14,8106.442402,450.357911,579.0316,150.842025,5,4
0,0,19,19,15,22,37,74,52,126,0.000333,0.218797,14,9189.475737,510.52643,656.391124,156.710855,5,4
0,0,19,19,15,22,37,66,50,116,0.000333,0.201432,14,8460.152266,470.008459,604.29659,156.710855,5,4
0,0,21,21,15,24,39,79,58,137,0.000333,0.241367,14,10137.40146,563.18897,724.100104,168.642459,5,4
0,0,16,16,15,19,34,58,45,103,0.000333,0.17467,14,7336.121417,407.562301,524.008673,139.313982,4,4
0,0,19,19,15,22,37,73,55,128,0.000333,0.22227,14,9335.340431,518.630024,666.810031,156.710855,4,4
0,0,17,17,15,20,35,60,47,107,0.000333,0.182944,14,7683.665959,426.870331,548.833283,145.041921,4,4
0,0,21,21,15,24,39,78,61,139,0.000333,0.24489,14,10285.39272,571.410707,734.670908,168.642459,4,4
0,0,19,19,16,20,36,71,53,124,0.000333,0.21369,16,10257.1312,569.840622,641.0707,150.438562,4,4
0,0,22,22,16,23,39,86,63,149,0.000333,0.262508,16,12600.39889,700.022161,787.524931,168.041925,4,4
0,0,20,20,16,21,37,73,55,128,0.000333,0.22227,16,10668.96049,592.720027,666.810031,156.238666,4,4
0,0,24,24,16,25,41,91,69,160,0.000333,0.285736,16,13715.33313,761.962952,857.208321,180.096405,4,4
0,0,16,16,16,19,35,59,45,104,0.000333,0.177815,16,8535.12694,474.173719,533.445434,144.710623,4,4
0,0,19,19,16,22,38,74,55,129,0.000333,0.225661,16,10831.72239,601.762355,676.982649,162.107496,4,4
0,0,17,17,16,20,36,61,47,108,0.000333,0.186117,16,8933.630402,496.3128,558.3519,150.438562,4,4
0,0,21,21,16,24,40,79,61,140,0.000333,0.248357,16,11921.11893,662.284385,745.069933,174.0391,4,4
0,0,17,17,16,22,38,61,48,109,0.000333,0.190675,16,9152.385583,508.465866,572.024099,162.107496,4,4
0,0,20,20,16,25,41,76,58,134,0.000333,0.239304,16,11486.5915,638.143972,717.911969,180.096405,4,4
0,0,18,18,16,23,39,63,50,113,0.000333,0.199083,16,9556.007212,530.88929,597.250451,168.041925,4,4
0,0,22,22,16,27,43,81,64,145,0.000333,0.262269,16,12588.93423,699.385235,786.808389,192.381963,4,4
0,0,16,16,16,20,36,60,45,105,0.000333,0.180947,16,8685.474002,482.526333,542.842125,150.438562,4,4
0,0,17,17,16,21,37,70,49,119,0.000333,0.206642,16,9918.799208,551.0444,619.924951,156.238666,4,4
0,0,17,17,16,21,37,62,47,109,0.000333,0.189277,16,9085.28667,504.738148,567.830417,156.238666,4,4
0,0,19,19,16,23,39,75,55,130,0.000333,0.229034,16,10993.63662,610.75759,687.102288,168.041925,4,4
0,0,17,17,17,19,36,63,47,110,0.000333,0.189564,16,9099.068003,505.503778,568.69175,150.197491,4,4
0,0,20,20,17,21,38,78,57,135,0.000333,0.236157,16,11335.52343,629.751302,708.470214,161.725534,4,4
0,0,18,18,17,20,37,65,49,114,0.000333,0.197959,16,9502.042939,527.891274,593.877684,155.92543,4,4
0,0,22,22,17,23,40,83,63,146,0.000333,0.259001,16,12432.02403,690.668002,777.001502,173.528793,4,4
0,0,16,16,16,20,36,60,45,105,0.000333,0.180947,16,8685.474002,482.526333,542.842125,150.438562,4,4
0,0,17,17,16,21,37,70,49,119,0.000333,0.206642,16,9918.799208,551.0444,619.924951,156.238666,4,4
0,0,17,17,16,21,37,62,47,109,0.000333,0.189277,16,9085.28667,504.738148,567.830417,156.238666,4,4
0,0,19,19,15,23,38,74,55,129,0.000333,0.225661,14,9477.757089,526.542061,676.982649,162.645284,4,4
0,0,17,17,16,21,37,67,49,116,0.000333,0.201432,16,9668.745447,537.152525,604.29659,156.238666,4,4
0,0,18,18,16,22,38,69,51,120,0.000333,0.209917,16,10076.02083,559.778935,629.751302,162.107496,4,4
0,0,18,18,16,21,37,60,47,107,0.000333,0.185804,16,8918.584162,495.476898,557.41151,156.238666,4,4
0,0,19,19,16,22,38,68,50,118,0.000333,0.206418,16,9908.087145,550.449286,619.255447,162.107496,4,4
0,0,19,19,16,22,38,62,49,111,0.000333,0.194173,16,9320.319264,517.795515,582.519954,162.107496,4,4
0,0,16,16,15,20,35,59,45,104,0.000333,0.177815,14,7468.236073,414.902004,533.445434,145.041921,4,4
0,0,17,17,15,21,36,69,49,118,0.000333,0.20335,14,8540.716102,474.484228,610.05115,150.842025,4,4
0,0,17,17,15,21,36,61,47,108,0.000333,0.186117,14,7816.926602,434.2737,558.3519,150.842025,4,4
0,0,19,19,15,23,38,74,55,129,0.000333,0.225661,14,9477.757089,526.542061,676.982649,162.645284,4,4
0,0,18,18,15,21,36,64,51,115,0.000333,0.19818,14,8323.579252,462.42107,594.541375,150.842025,4,4
0,0,19,19,15,22,37,74,55,129,0.000333,0.224006,14,9408.272778,522.681821,672.019484,156.710855,4,4
0,0,19,19,15,22,37,66,53,119,0.000333,0.206642,14,8678.949307,482.16385,619.924951,156.710855,4,4
0,0,21,21,15,24,39,79,61,140,0.000333,0.246652,14,10359.38835,575.521575,739.956311,168.642459,4,4
0,0,20,20,15,22,37,69,57,126,0.000333,0.218797,14,9189.475737,510.52643,656.391124,156.710855,4,4
0,0,21,21,15,23,38,79,61,140,0.000333,0.244903,14,10285.93793,571.440996,734.709852,162.645284,4,4
0,0,21,21,15,23,38,71,59,130,0.000333,0.22741,14,9551.228074,530.623782,682.230577,162.645284,4,4
0,0,23,23,15,25,40,84,67,151,0.000333,0.26787,14,11250.55599,625.030888,803.611142,174.699764,4,4
0,0,22,22,15,23,38,74,63,137,0.000333,0.239655,14,10065.52497,559.195832,718.966069,162.645284,4,4
0,0,23,23,15,24,39,84,67,151,0.000333,0.266032,14,11173.34029,620.741127,798.095735,168.642459,4,4
0,0,23,23,15,24,39,76,65,141,0.000333,0.248414,14,10433.38398,579.632443,745.241713,168.642459,4,4
0,0,25,25,15,26,41,89,73,162,0.000333,0.289308,14,12150.92795,675.051553,867.923425,180.814792,4,4
0,0,17,17,16,19,35,62,47,109,0.000333,0.186364,16,8945.469582,496.970532,559.091849,144.710623,4,4
0,0,18,18,16,20,36,72,51,123,0.000333,0.211967,16,10174.4124,565.245133,635.900775,150.438562,4,4
0,0,18,18,16,20,36,64,49,113,0.000333,0.194734,16,9347.224403,519.290245,584.201525,150.438562,4,4
0,0,20,20,16,22,38,77,57,134,0.000333,0.234407,16,11251.55659,625.086477,703.222287,162.107496,4,4
0,0,16,16,16,20,36,60,45,105,0.000333,0.180947,16,8685.474002,482.526333,542.842125,150.438562,4,4
0,0,17,17,16,21,37,70,49,119,0.000333,0.206642,16,9918.799208,551.0444,619.924951,156.238666,4,4
0,0,17,17,16,21,37,62,47,109,0.000333,0.189277,16,9085.28667,504.738148,567.830417,156.238666,4,4
0,0,19,19,15,23,38,74,55,129,0.000333,0.225661,14,9477.757089,526.542061,676.982649,162.645284,4,4
0,0,17,17,16,21,37,64,48,112,0.000333,0.194486,16,9335.340431,518.630024,583.458777,156.238666,4,4
0,0,18,18,16,22,38,75,52,127,0.000333,0.222162,16,10663.78871,592.432706,666.486794,162.107496,4,4
0,0,18,18,16,22,38,66,50,116,0.000333,0.20292,16,9740.153465,541.119637,608.759592,162.107496,4,4
0,0,18,18,16,22,38,72,52,124,0.000333,0.216914,16,10411.88819,578.438233,650.743012,162.107496,4,4
0,0,19,19,16,23,39,82,56,138,0.000333,0.243129,16,11670.1681,648.342672,729.385506,168.041925,4,4
0,0,19,19,16,23,39,74,54,128,0.000333,0.22551,16,10824.50374,601.361319,676.531484,168.041925,4,4
0,0,17,17,15,21,36,66,49,115,0.000333,0.19818,14,8323.579252,462.42107,594.541375,150.842025,4,4
0,0,18,18,15,22,37,68,51,119,0.000333,0.206642,14,8678.949307,482.16385,619.924951,156.710855,4,4
0,0,19,19,15,23,38,72,55,127,0.000333,0.222162,14,9330.815119,518.378618,666.486794,162.645284,4,4
0,0,20,20,15,24,39,74,57,131,0.000333,0.230796,14,9693.427669,538.523759,692.387691,168.642459,4,4
0,0,20,20,15,24,39,82,59,141,0.000333,0.248414,14,10433.38398,579.632443,745.241713,168.642459,4,4
0,0,19,19,16,23,39,66,54,120,0.000333,0.211416,16,10147.97226,563.776237,634.248266,168.041925,4,4
0,0,20,20,16,24,40,76,58,134,0.000333,0.237713,16,11410.21384,633.900769,713.138365,174.0391,4,4
0,0,20,20,16,24,40,68,56,124,0.000333,0.219973,16,10558.70534,586.594741,659.919084,174.0391,4,4
0,0,19,19,16,23,39,66,54,120,0.000333,0.211416,16,10147.97226,563.776237,634.248266,168.041925,4,4
0,0,18,18,15,21,36,59,47,106,0.000333,0.182671,14,7672.168702,426.231595,548.01205,150.842025,4,4
0,0,19,19,15,22,37,67,50,117,0.000333,0.203169,14,8533.084613,474.060256,609.506044,156.710855,4,4
0,0,19,19,15,22,37,61,49,110,0.000333,0.191013,14,8022.558183,445.697677,573.03987,156.710855,4,4
0,0,21,21,17,25,42,89,71,160,0.000333,0.28759,16,13804.3326,766.907367,862.770788,185.583273,4,4
0,0,22,22,17,26,43,101,76,177,0.000333,0.32015,16,15367.18179,853.732321,960.448862,191.698301,4,4
0,0,22,22,17,26,43,91,73,164,0.000333,0.296636,16,14238.51872,791.028818,889.90742,191.698301,4,4
0,0,21,21,17,25,42,89,71,160,0.000333,0.28759,16,13804.3326,766.907367,862.770788,185.583273,4,4
0,0,21,21,17,24,41,79,62,141,0.000333,0.251805,16,12086.63732,671.479851,755.414833,179.525968,4,4
0,0,22,22,17,25,42,91,67,158,0.000333,0.283995,16,13631.77845,757.321025,851.986153,185.583273,4,4
0,0,22,22,17,25,42,81,64,145,0.000333,0.260629,16,12510.17642,695.009801,781.886026,185.583273,4,4
0,0,21,21,17,24,41,79,62,141,0.000333,0.251805,16,12086.63732,671.479851,755.414833,179.525968,4,4
0,0,21,21,16,24,40,82,64,146,0.000333,0.259001,16,12432.02403,690.668002,777.001502,174.0391,4,4
0,0,22,22,16,25,41,95,70,165,0.000333,0.294665,16,14143.93729,785.774294,883.996081,180.096405,4,4
0,0,22,22,16,25,41,84,66,150,0.000333,0.267878,16,12858.12481,714.340267,803.632801,180.096405,4,4
0,0,21,21,16,24,40,82,64,146,0.000333,0.259001,16,12432.02403,690.668002,777.001502,174.0391,4,4
0,0,11,11,13,15,28,45,31,76,0.000333,0.121786,12,4384.307689,243.572649,365.358974,106.709075,3,4
0,0,14,14,13,18,31,60,41,101,0.000333,0.166791,12,6004.485928,333.582552,500.373827,123.164366,3,4
0,0,12,12,13,16,29,47,33,80,0.000333,0.129546,12,4663.661755,259.09232,388.63848,112.105716,3,4
0,0,16,16,13,20,33,65,47,112,0.000333,0.188324,12,6779.665696,376.648094,564.972141,134.544278,3,4
0,0,13,13,13,16,29,51,33,84,0.000333,0.136023,12,4896.844843,272.046936,408.070404,112.105716,5,4
0,0,16,16,13,19,32,66,43,109,0.000333,0.181667,12,6540,363.333333,545,128.816339,5,4
0,0,14,14,13,17,30,53,35,88,0.000333,0.143935,12,5181.676469,287.870915,431.806372,117.592585,5,4
0,0,18,18,13,21,34,71,49,120,0.000333,0.203499,12,7325.946491,406.997027,610.495541,140.344382,5,4
0,0,13,13,13,16,29,51,35,86,0.000333,0.139262,12,5013.436387,278.524244,417.786366,112.105716,5,4
0,0,13,13,13,16,29,51,35,86,0.000333,0.139262,12,5013.436387,278.524244,417.786366,112.105716,5,4
0,0,16,16,13,19,32,66,45,111,0.000333,0.185,12,6660,370,555,128.816339,5,4
0,0,14,14,13,17,30,53,37,90,0.000333,0.147207,12,5299.441843,294.413436,441.620154,117.592585,5,4
0,0,18,18,13,20,33,71,51,122,0.000333,0.205139,12,7384.992991,410.277388,615.416083,134.544278,5,4
0,0,13,13,13,16,29,51,33,84,0.000333,0.136023,12,4896.844843,272.046936,408.070404,112.105716,5,4
0,0,16,16,13,19,32,66,43,109,0.000333,0.181667,12,6540,363.333333,545,128.816339,5,4
0,0,14,14,13,17,30,53,35,88,0.000333,0.143935,12,5181.676469,287.870915,431.806372,117.592585,5,4
0,0,18,18,13,21,34,71,49,120,0.000333,0.203499,12,7325.946491,406.997027,610.495541,140.344382,5,4
0,0,13,13,13,16,29,51,33,84,0.000333,0.136023,12,4896.844843,272.046936,408.070404,112.105716,5,4
0,0,16,16,13,19,32,66,43,109,0.000333,0.181667,12,6540,363.333333,545,128.816339,5,4
0,0,14,14,13,17,30,53,35,88,0.000333,0.143935,12,5181.676469,287.870915,431.806372,117.592585,5,4
0,0,18,18,13,21,34,71,49,120,0.000333,0.203499,12,7325.946491,406.997027,610.495541,140.344382,5,4
0,0,13,13,13,17,30,51,35,86,0.000333,0.140664,12,5063.911095,281.328394,421.992591,117.592585,5,4
0,0,16,16,13,20,33,66,45,111,0.000333,0.186643,12,6719.132967,373.285165,559.927747,134.544278,5,4
0,0,14,14,13,18,31,53,37,90,0.000333,0.148626,12,5350.532015,297.251779,445.877668,123.164366,5,4
0,0,18,18,13,21,34,71,51,122,0.000333,0.20689,12,7448.0456,413.780311,620.670467,140.344382,5,4
0,0,13,13,13,17,30,51,35,86,0.000333,0.140664,12,5063.911095,281.328394,421.992591,117.592585,5,4
0,0,16,16,13,20,33,66,45,111,0.000333,0.186643,12,6719.132967,373.285165,559.927747,134.544278,5,4
0,0,14,14,13,18,31,53,37,90,0.000333,0.148626,12,5350.532015,297.251779,445.877668,123.164366,5,4
0,0,18,18,13,21,34,71,51,122,0.000333,0.20689,12,7448.0456,413.780311,620.670467,140.344382,5,4
0,0,13,13,13,16,29,51,33,84,0.000333,0.136023,12,4896.844843,272.046936,408.070404,112.105716,5,4
0,0,16,16,13,19,32,66,43,109,0.000333,0.181667,12,6540,363.333333,545,128.816339,5,4
0,0,14,14,13,17,30,53,35,88,0.000333,0.143935,12,5181.676469,287.870915,431.806372,117.592585,5,4
0,0,18,18,13,21,34,71,49,120,0.000333,0.203499,12,7325.946491,406.997027,610.495541,140.344382,5,4
0,0,13,13,13,16,29,51,33,84,0.000333,0.136023,12,4896.844843,272.046936,408.070404,112.105716,5,4
0,0,16,16,13,19,32,66,43,109,0.000333,0.181667,12,6540,363.333333,545,128.816339,5,4
0,0,14,14,13,17,30,53,35,88,0.000333,0.143935,12,5181.676469,287.870915,431.806372,117.592585,5,4
0,0,18,18,13,21,34,71,49,120,0.000333,0.203499,12,7325.946491,406.997027,610.495541,140.344382,5,4
0,0,13,13,13,16,29,51,33,84,0.000333,0.136023,12,4896.844843,272.046936,408.070404,112.105716,5,4
0,0,16,16,13,19,32,66,43,109,0.000333,0.181667,12,6540,363.333333,545,128.816339,5,4
0,0,14,14,13,17,30,53,35,88,0.000333,0.143935,12,5181.676469,287.870915,431.806372,117.592585,5,4
0,0,18,18,13,21,34,71,49,120,0.000333,0.203499,12,7325.946491,406.997027,610.495541,140.344382,5,4
0,0,13,13,13,16,29,51,33,84,0.000333,0.136023,12,4896.844843,272.046936,408.070404,112.105716,5,4
0,0,16,16,13,19,32,66,43,109,0.000333,0.181667,12,6540,363.333333,545,128.816339,5,4
0,0,14,14,13,17,30,53,35,88,0.000333,0.143935,12,5181.676469,287.870915,431.806372,117.592585,5,4
0,0,18,18,13,21,34,71,49,120,0.000333,0.203499,12,7325.946491,406.997027,610.495541,140.344382,5,4
0,0,13,13,13,17,30,51,35,86,0.000333,0.140664,12,5063.911095,281.328394,421.992591,117.592585,5,4
0,0,16,16,13,20,33,66,45,111,0.000333,0.186643,12,6719.132967,373.285165,559.927747,134.544278,5,4
0,0,14,14,13,18,31,53,37,90,0.000333,0.148626,12,5350.532015,297.251779,445.877668,123.164366,5,4
0,0,18,18,13,21,34,71,51,122,0.000333,0.20689,12,7448.0456,413.780311,620.670467,140.344382,5,4
0,0,13,13,13,17,30,51,35,86,0.000333,0.140664,12,5063.911095,281.328394,421.992591,117.592585,5,4
0,0,16,16,13,20,33,66,45,111,0.000333,0.186643,12,6719.132967,373.285165,559.927747,134.544278,5,4
0,0,14,14,13,18,31,53,37,90,0.000333,0.148626,12,5350.532015,297.251779,445.877668,123.164366,5,4
0,0,18,18,13,21,34,71,51,122,0.000333,0.20689,12,7448.0456,413.780311,620.670467,140.344382,5,4
0,0,19,19,18,18,36,65,37,102,0.000333,0.175777,18,9491.982303,527.33235,527.33235,150.1173,5,4
0,0,22,22,18,21,39,80,47,127,0.000333,0.223749,18,12082.42947,671.246082,671.246082,167.297316,5,4
0,0,20,20,18,19,37,67,39,106,0.000333,0.184067,18,9939.637022,552.202057,552.202057,155.769273,5,4
0,0,24,24,18,23,41,85,53,138,0.000333,0.246447,18,13308.15918,739.342177,739.342177,179.100575,5,4
0,0,15,15,15,16,31,55,33,88,0.000333,0.145323,14,6103.569854,339.087214,435.969275,122.603359,5,4
0,0,13,13,16,18,34,61,41,102,0.000333,0.172974,16,8302.739357,461.263298,518.92121,139.05865,5,4
0,0,15,15,15,17,32,51,35,86,0.000333,0.143333,14,6020,334.444444,430,128.090227,3,4
0,0,15,15,14,19,33,56,40,96,0.000333,0.161421,14,6779.665696,376.648094,484.261835,134.013592,4,4
0,0,15,15,13,19,32,55,40,95,0.000333,0.158333,12,5700,316.666667,475,128.816339,4,4
0,0,13,13,13,16,29,49,37,86,0.000333,0.139262,12,5013.436387,278.524244,417.786366,112.105716,3,4
0,0,16,16,14,17,31,62,45,107,0.000333,0.1767,14,7421.386073,412.299226,530.099005,122.789837,3,4
0,0,13,13,14,16,30,50,37,87,0.000333,0.1423,14,5976.592745,332.03293,426.899482,117.302969,3,4
0,0,14,14,14,19,33,52,40,92,0.000333,0.154695,14,6497.179626,360.954424,464.084259,134.013592,3,4
0,0,13,13,14,17,31,51,37,88,0.000333,0.145323,14,6103.569854,339.087214,435.969275,122.789837,3,4
0,0,14,14,15,16,31,54,39,93,0.000333,0.15358,14,6450.363596,358.353533,460.740257,122.603359,3,4
0,0,13,13,14,17,31,51,37,88,0.000333,0.145323,14,6103.569854,339.087214,435.969275,122.789837,3,4
0,0,14,14,14,18,32,58,41,99,0.000333,0.165,14,6930,385,495,128.361619,3,4
0,0,15,15,14,18,32,51,39,90,0.000333,0.15,14,6300,350,450,128.361619,3,4
0,0,13,13,13,17,30,50,37,87,0.000333,0.1423,12,5122.793782,284.599655,426.899482,117.592585,3,4
0,0,15,15,13,18,31,55,43,98,0.000333,0.161837,12,5826.134861,323.674159,485.511238,123.164366,3,4
0,0,17,17,13,19,32,60,49,109,0.000333,0.181667,12,6540,363.333333,545,128.816339,3,4
0,0,19,19,13,20,33,65,55,120,0.000333,0.201776,12,7263.927532,403.55153,605.327294,134.544278,3,4
0,0,14,14,14,16,30,53,39,92,0.000333,0.150478,14,6320.075087,351.115283,451.433935,117.302969,3,4
0,0,13,13,14,17,31,51,37,88,0.000333,0.145323,14,6103.569854,339.087214,435.969275,122.789837,3,4
0,0,14,14,14,18,32,55,40,95,0.000333,0.158333,14,6650,369.444444,475,128.361619,3,4
0,0,15,15,14,19,33,63,44,107,0.000333,0.179917,14,7556.502391,419.805688,539.750171,134.013592,3,4
0,0,14,14,13,18,31,57,41,98,0.000333,0.161837,12,5826.134861,323.674159,485.511238,123.164366,3,4
0,0,16,16,13,20,33,63,47,110,0.000333,0.184961,12,6658.600238,369.922235,554.883353,134.544278,3,4
0,0,16,16,14,20,34,57,46,103,0.000333,0.17467,14,7336.121417,407.562301,524.008673,139.741531,3,4
0,0,15,15,13,18,31,50,39,89,0.000333,0.146974,12,5291.081659,293.948981,440.923472,123.164366,3,4
0,0,18,18,15,23,38,80,63,143,0.000333,0.250151,14,10506.35088,583.68616,750.453634,162.645284,3,4
0,0,18,18,15,21,36,70,54,124,0.000333,0.21369,14,8974.989803,498.610545,641.0707,150.842025,3,4
0,0,18,18,14,22,36,73,56,129,0.000333,0.222307,14,9336.884553,518.715808,666.920325,151.410465,3,4
0,0,9,9,14,11,25,34,21,55,0.000333,0.085137,7,1787.884633,99.326924,255.41209,91.356717,2,4
0,0,11,11,14,12,26,40,23,63,0.000333,0.098709,7,2072.893916,115.160773,296.127702,96.322519,4,4
0,0,11,11,14,12,26,40,25,65,0.000333,0.101843,14,4277.400144,237.633341,305.528582,96.322519,4,4
0,0,11,11,14,12,26,40,23,63,0.000333,0.098709,7,2072.893916,115.160773,296.127702,96.322519,4,4
0,0,11,11,14,12,26,40,23,63,0.000333,0.098709,7,2072.893916,115.160773,296.127702,96.322519,4,4
0,0,11,11,14,13,27,40,25,65,0.000333,0.103023,7,2163.473813,120.19299,309.067688,101.408685,4,4
0,0,11,11,14,13,27,40,25,65,0.000333,0.103023,7,2163.473813,120.19299,309.067688,101.408685,4,4
0,0,11,11,14,12,26,40,23,63,0.000333,0.098709,7,2072.893916,115.160773,296.127702,96.322519,4,4
0,0,11,11,14,12,26,40,23,63,0.000333,0.098709,7,2072.893916,115.160773,296.127702,96.322519,4,4
0,0,11,11,14,12,26,40,23,63,0.000333,0.098709,7,2072.893916,115.160773,296.127702,96.322519,4,4
0,0,11,11,14,12,26,40,23,63,0.000333,0.098709,7,2072.893916,115.160773,296.127702,96.322519,4,4
0,0,11,11,14,13,27,40,25,65,0.000333,0.103023,7,2163.473813,120.19299,309.067688,101.408685,4,4
0,0,11,11,14,13,27,40,25,65,0.000333,0.103023,7,2163.473813,120.19299,309.067688,101.408685,4,4
0,0,16,16,19,13,32,50,25,75,0.000333,0.125,9,3375,187.5,375,128.816339,4,4
0,0,13,13,16,12,28,44,23,67,0.000333,0.107364,8,2576.742238,143.152347,322.09278,107.01955,4,4
0,0,11,11,17,14,31,50,31,81,0.000333,0.133763,16,6420.638418,356.702134,401.289901,122.789837,4,4
0,0,13,13,16,13,29,40,25,65,0.000333,0.105256,8,2526.150117,140.341673,315.768765,112.105716,2,4
0,0,13,13,15,15,30,45,30,75,0.000333,0.122672,14,5152.235125,286.235285,368.016795,117.206718,3,4
0,0,13,13,14,15,29,44,30,74,0.000333,0.11983,14,5032.868311,279.603795,359.490594,111.906328,3,4
0,0,11,11,14,12,26,38,27,65,0.000333,0.101843,14,4277.400144,237.633341,305.528582,96.322519,2,4
0,0,14,14,14,13,27,51,35,86,0.000333,0.136307,14,5724.884553,318.049142,408.920325,101.408685,2,4
0,0,11,11,14,12,26,39,27,66,0.000333,0.10341,14,4343.2063,241.289239,310.229021,96.322519,2,4
0,0,12,12,15,15,30,41,30,71,0.000333,0.11613,14,4877.449252,270.969403,348.389232,117.206718,2,4
0,0,11,11,15,13,28,40,27,67,0.000333,0.107364,14,4509.298917,250.516606,322.09278,106.709075,2,4
0,0,12,12,16,12,28,43,29,72,0.000333,0.115377,16,5538.07287,307.670715,346.129554,107.01955,2,4
0,0,11,11,14,13,27,40,27,67,0.000333,0.106192,14,4460.084477,247.782471,318.577463,101.408685,2,4
0,0,12,12,15,14,29,47,31,78,0.000333,0.126308,14,5304.915247,294.717514,378.922518,111.906328,2,4
0,0,13,13,15,14,29,40,29,69,0.000333,0.111734,14,4692.809641,260.711647,335.200689,111.906328,2,4
0,0,11,11,14,13,27,39,27,66,0.000333,0.104608,14,4393.516052,244.084225,313.822575,101.408685,2,4
0,0,13,13,14,14,28,44,33,77,0.000333,0.123389,14,5182.328606,287.907145,370.166329,106.605938,2,4
0,0,15,15,14,15,29,49,39,88,0.000333,0.142501,14,5985.032586,332.50181,427.502328,111.906328,2,4
0,0,17,17,14,16,30,54,45,99,0.000333,0.161927,14,6800.950366,377.830576,485.782169,117.302969,2,4
0,0,12,12,15,12,27,42,29,71,0.000333,0.112532,14,4726.358177,262.575454,337.597013,101.622909,2,4
0,0,11,11,14,13,27,40,27,67,0.000333,0.106192,14,4460.084477,247.782471,318.577463,101.408685,2,4
0,0,12,12,14,14,28,44,30,74,0.000333,0.118581,14,4980.419699,276.689983,355.744264,106.605938,2,4
0,0,13,13,14,15,29,52,34,86,0.000333,0.139262,14,5849.009118,324.944951,417.786366,111.906328,2,4
0,0,12,12,14,14,28,46,31,77,0.000333,0.123389,14,5182.328606,287.907145,370.166329,106.605938,2,4
0,0,14,14,14,16,30,52,37,89,0.000333,0.145571,14,6113.985682,339.665871,436.713263,117.302969,2,4
0,0,14,14,15,16,31,46,36,82,0.000333,0.135415,14,5687.417364,315.967631,406.244097,122.603359,2,4
0,0,13,13,14,14,28,39,29,68,0.000333,0.108967,14,4576.601886,254.25566,326.900135,106.605938,2,4
0,0,16,16,16,19,35,69,53,122,0.000333,0.208591,16,10012.36045,556.242247,625.772528,144.710623,2,4
0,0,16,16,16,17,33,59,44,103,0.000333,0.173191,16,8313.161509,461.842306,519.572594,133.486868,2,4
0,0,16,16,15,18,33,62,46,108,0.000333,0.181598,14,7627.123908,423.729106,544.794565,133.662009,2,4
0,0,14,14,15,18,33,54,39,93,0.000333,0.156376,14,6567.801143,364.877841,469.128653,133.662009,4,4
0,0,16,16,15,18,33,60,41,101,0.000333,0.169828,14,7132.773285,396.265182,509.483806,133.662009,6,4
0,0,16,16,15,19,34,60,43,103,0.000333,0.17467,14,7336.121417,407.562301,524.008673,139.313982,6,4
0,0,16,16,15,19,34,60,41,101,0.000333,0.171278,14,7193.672458,399.64847,513.833747,139.313982,6,4
0,0,16,16,17,20,37,62,43,105,0.000333,0.182331,16,8751.881654,486.215647,546.992603,155.92543,7,4
0,0,16,16,15,20,35,60,43,103,0.000333,0.176105,14,7396.42611,410.912562,528.316151,145.041921,6,4
0,0,16,16,15,20,35,60,43,103,0.000333,0.176105,14,7396.42611,410.912562,528.316151,145.041921,6,4
0,0,16,16,15,19,34,60,41,101,0.000333,0.171278,14,7193.672458,399.64847,513.833747,139.313982,6,4
0,0,16,16,15,19,34,60,41,101,0.000333,0.171278,14,7193.672458,399.64847,513.833747,139.313982,6,4
0,0,16,16,15,19,34,60,41,101,0.000333,0.171278,14,7193.672458,399.64847,513.833747,139.313982,6,4
0,0,16,16,15,19,34,60,41,101,0.000333,0.171278,14,7193.672458,399.64847,513.833747,139.313982,6,4
0,0,16,16,15,20,35,60,43,103,0.000333,0.176105,14,7396.42611,410.912562,528.316151,145.041921,6,4
0,0,16,16,15,20,35,60,43,103,0.000333,0.176105,14,7396.42611,410.912562,528.316151,145.041921,6,4
0,0,21,21,19,20,39,70,43,113,0.000333,0.199083,18,10750.50811,597.250451,597.250451,167.149185,6,4
0,0,18,18,16,18,34,64,41,105,0.000333,0.178061,16,8546.937573,474.829865,534.183598,139.05865,6,4
0,0,16,16,18,20,38,70,49,119,0.000333,0.208168,18,11241.06073,624.503374,624.503374,161.497212,6,4
0,0,18,18,17,20,37,60,43,103,0.000333,0.178858,16,8585.179147,476.954397,536.573697,155.92543,4,4
0,0,18,18,16,21,37,65,48,113,0.000333,0.196223,16,9418.691685,523.260649,588.66823,156.238666,5,4
0,0,18,18,15,21,36,64,48,112,0.000333,0.193011,14,8106.442402,450.357911,579.0316,150.842025,5,4
0,0,16,16,15,19,34,58,45,103,0.000333,0.17467,14,7336.121417,407.562301,524.008673,139.313982,4,4
0,0,19,19,16,20,36,71,53,124,0.000333,0.21369,16,10257.1312,569.840622,641.0707,150.438562,4,4
0,0,16,16,16,19,35,59,45,104,0.000333,0.177815,16,8535.12694,474.173719,533.445434,144.710623,4,4
0,0,17,17,16,22,38,61,48,109,0.000333,0.190675,16,9152.385583,508.465866,572.024099,162.107496,4,4
0,0,16,16,16,20,36,60,45,105,0.000333,0.180947,16,8685.474002,482.526333,542.842125,150.438562,4,4
0,0,17,17,17,19,36,63,47,110,0.000333,0.189564,16,9099.068003,505.503778,568.69175,150.197491,4,4
0,0,11,11,14,13,27,36,28,64,0.000333,0.101438,14,4260.379202,236.687733,304.3128,101.408685,2,4
0,0,17,17,16,21,37,67,49,116,0.000333,0.201432,16,9668.745447,537.152525,604.29659,156.238666,4,4
0,0,18,18,16,21,37,60,47,107,0.000333,0.185804,16,8918.584162,495.476898,557.41151,156.238666,4,4
0,0,16,16,15,20,35,59,45,104,0.000333,0.177815,14,7468.236073,414.902004,533.445434,145.041921,4,4
0,0,18,18,15,21,36,64,51,115,0.000333,0.19818,14,8323.579252,462.42107,594.541375,150.842025,4,4
0,0,20,20,15,22,37,69,57,126,0.000333,0.218797,14,9189.475737,510.52643,656.391124,156.710855,4,4
0,0,22,22,15,22,37,74,63,137,0.000333,0.237898,14,9991.731555,555.096198,713.695111,156.710855,4,4
0,0,17,17,16,19,35,62,47,109,0.000333,0.186364,16,8945.469582,496.970532,559.091849,144.710623,4,4
0,0,16,16,16,20,36,60,45,105,0.000333,0.180947,16,8685.474002,482.526333,542.842125,150.438562,4,4
0,0,17,17,16,21,37,64,48,112,0.000333,0.194486,16,9335.340431,518.630024,583.458777,156.238666,4,4
0,0,18,18,16,22,38,72,52,124,0.000333,0.216914,16,10411.88819,578.438233,650.743012,162.107496,4,4
0,0,17,17,15,21,36,66,49,115,0.000333,0.19818,14,8323.579252,462.42107,594.541375,150.842025,4,4
0,0,19,19,15,23,38,72,55,127,0.000333,0.222162,14,9330.815119,518.378618,666.486794,162.645284,4,4
0,0,19,19,16,23,39,66,54,120,0.000333,0.211416,16,10147.97226,563.776237,634.248266,168.041925,4,4
0,0,18,18,15,21,36,59,47,106,0.000333,0.182671,14,7672.168702,426.231595,548.01205,150.842025,4,4
0,0,21,21,17,25,42,89,71,160,0.000333,0.28759,16,13804.3326,766.907367,862.770788,185.583273,4,4
0,0,21,21,17,24,41,79,62,141,0.000333,0.251805,16,12086.63732,671.479851,755.414833,179.525968,4,4
0,0,21,21,16,24,40,82,64,146,0.000333,0.259001,16,12432.02403,690.668002,777.001502,174.0391,4,4
0,0,9,9,12,10,22,29,20,49,0.000333,0.072837,12,2622.145792,145.674766,218.512149,76.238831,2,4
0,0,11,11,12,11,23,35,22,57,0.000333,0.085948,12,3094.116378,171.895354,257.843031,81.073298,4,4
0,0,11,11,12,11,23,35,24,59,0.000333,0.088963,12,3202.681865,177.92677,266.890155,81.073298,4,4
0,0,11,11,12,11,23,35,22,57,0.000333,0.085948,12,3094.116378,171.895354,257.843031,81.073298,4,4
0,0,11,11,12,11,23,35,22,57,0.000333,0.085948,12,3094.116378,171.895354,257.843031,81.073298,4,4
0,0,11,11,12,12,24,35,24,59,0.000333,0.090171,12,3246.153451,180.341858,270.512788,86.0391,4,4
0,0,11,11,12,12,24,35,24,59,0.000333,0.090171,12,3246.153451,180.341858,270.512788,86.0391,4,4
0,0,11,11,12,11,23,35,22,57,0.000333,0.085948,12,3094.116378,171.895354,257.843031,81.073298,4,4
0,0,11,11,12,11,23,35,22,57,0.000333,0.085948,12,3094.116378,171.895354,257.843031,81.073298,4,4
0,0,11,11,12,11,23,35,22,57,0.000333,0.085948,12,3094.116378,171.895354,257.843031,81.073298,4,4
0,0,11,11,12,11,23,35,22,57,0.000333,0.085948,12,3094.116378,171.895354,257.843031,81.073298,4,4
0,0,11,11,12,12,24,35,24,59,0.000333,0.090171,12,3246.153451,180.341858,270.512788,86.0391,4,4
0,0,11,11,12,12,24,35,24,59,0.000333,0.090171,12,3246.153451,180.341858,270.512788,86.0391,4,4
0,0,16,16,17,12,29,45,24,69,0.000333,0.111734,16,5363.211019,297.956168,335.200689,112.506418,4,4
0,0,13,13,14,11,25,39,22,61,0.000333,0.094425,14,3965.853186,220.325177,283.275228,91.356717,4,4
0,0,11,11,15,13,28,45,30,75,0.000333,0.120184,14,5047.722668,280.429037,360.551619,106.709075,4,4
0,0,13,13,14,12,26,35,24,59,0.000333,0.092442,14,3882.563207,215.697956,277.325943,96.322519,2,4
0,0,13,13,13,14,27,40,29,69,0.000333,0.109362,12,3937.046852,218.724825,328.087238,101.408685,3,4
0,0,11,11,17,16,33,58,30,88,0.000333,0.147969,8,3551.25346,197.291859,443.906683,133.486868,3,4
0,0,11,11,17,15,32,57,29,86,0.000333,0.143333,8,3440,191.111111,430,128.090227,3,4
0,0,11,11,17,15,32,57,29,86,0.000333,0.143333,8,3440,191.111111,430,128.090227,3,4
0,0,11,11,17,15,32,57,29,86,0.000333,0.143333,8,3440,191.111111,430,128.090227,3,4
0,0,11,11,17,15,32,57,29,86,0.000333,0.143333,8,3440,191.111111,430,128.090227,3,4
0,0,11,11,17,15,32,57,29,86,0.000333,0.143333,8,3440,191.111111,430,128.090227,3,4
0,0,11,11,17,15,32,57,29,86,0.000333,0.143333,8,3440,191.111111,430,128.090227,3,4
0,0,11,11,17,15,32,57,29,86,0.000333,0.143333,8,3440,191.111111,430,128.090227,3,4
0,0,11,11,17,15,32,57,29,86,0.000333,0.143333,8,3440,191.111111,430,128.090227,3,4
0,0,11,11,17,15,32,57,29,86,0.000333,0.143333,8,3440,191.111111,430,128.090227,3,4
0,0,13,13,18,17,35,64,35,99,0.000333,0.169266,18,9140.382336,507.799019,507.799019,144.545518,3,4
0,0,9,9,14,15,29,41,25,66,0.000333,0.106876,7,2244.38722,124.688179,320.626746,111.906328,3,4
0,0,13,13,17,16,33,63,35,98,0.000333,0.164784,16,7909.609979,439.422777,494.350624,133.486868,3,4
0,0,7,7,12,9,21,30,16,46,0.000333,0.067349,6,1212.279609,67.348867,202.046601,71.548875,3,4
0,0,7,7,12,13,25,26,18,44,0.000333,0.06811,6,1225.978034,68.109891,204.329672,91.125266,3,4
0,0,13,13,18,17,35,64,35,99,0.000333,0.169266,18,9140.382336,507.799019,507.799019,144.545518,3,4
0,0,13,13,18,16,34,63,33,96,0.000333,0.162799,18,8791.13579,488.396433,488.396433,139.05865,3,4
0,0,6,6,11,10,21,25,14,39,0.000333,0.0571,5,856.501897,47.583439,171.300379,71.273029,3,4
0,0,14,14,17,19,36,63,39,102,0.000333,0.175777,16,8437.317602,468.739867,527.33235,150.197491,3,4
0,0,6,6,10,12,22,24,16,40,0.000333,0.059459,5,891.886324,49.54924,178.377265,76.238831,3,4
0,0,6,6,10,12,22,24,16,40,0.000333,0.059459,5,891.886324,49.54924,178.377265,76.238831,3,4
0,0,6,6,10,12,22,24,16,40,0.000333,0.059459,5,891.886324,49.54924,178.377265,76.238831,3,4
0,0,6,6,10,12,22,24,16,40,0.000333,0.059459,5,891.886324,49.54924,178.377265,76.238831,3,4
0,0,6,6,11,10,21,25,15,40,0.000333,0.058564,5,878.463485,48.803527,175.692697,71.273029,3,4
0,0,7,7,11,13,24,29,19,48,0.000333,0.073359,5,1100.391,61.132833,220.0782,86.159464,3,4
0,0,8,8,11,14,25,38,23,61,0.000333,0.094425,5,1416.376138,78.687563,283.275228,91.356717,3,4
0,0,6,6,10,12,22,24,16,40,0.000333,0.059459,5,891.886324,49.54924,178.377265,76.238831,3,4
0,0,7,7,13,14,27,31,20,51,0.000333,0.080833,6,1454.995576,80.833088,242.499263,101.408685,3,4
0,0,7,7,12,15,27,27,22,49,0.000333,0.077663,6,1397.936926,77.663163,232.989488,101.622909,3,4
0,0,6,6,11,11,22,24,15,39,0.000333,0.057973,5,869.589166,48.310509,173.917833,76.107496,3,4
0,0,6,6,12,13,25,26,17,43,0.000333,0.066562,6,1198.114897,66.561939,199.685816,91.125266,3,4
0,0,6,6,11,13,24,25,17,42,0.000333,0.064189,5,962.842125,53.491229,192.568425,86.159464,3,4
0,0,13,13,17,19,36,69,39,108,0.000333,0.186117,16,8933.630402,496.3128,558.3519,150.197491,4,4
0,0,13,13,17,19,36,69,39,108,0.000333,0.186117,16,8933.630402,496.3128,558.3519,150.197491,4,4
0,0,13,13,17,19,36,69,39,108,0.000333,0.186117,16,8933.630402,496.3128,558.3519,150.197491,4,4
0,0,13,13,17,19,36,69,39,108,0.000333,0.186117,16,8933.630402,496.3128,558.3519,150.197491,4,4
0,0,13,13,17,19,36,69,39,108,0.000333,0.186117,16,8933.630402,496.3128,558.3519,150.197491,4,4
0,0,13,13,17,19,36,69,39,108,0.000333,0.186117,16,8933.630402,496.3128,558.3519,150.197491,4,4
0,0,13,13,17,19,36,69,39,108,0.000333,0.186117,16,8933.630402,496.3128,558.3519,150.197491,4,4
0,0,13,13,17,19,36,69,39,108,0.000333,0.186117,16,8933.630402,496.3128,558.3519,150.197491,4,4
0,0,13,13,17,19,36,69,39,108,0.000333,0.186117,16,8933.630402,496.3128,558.3519,150.197491,4,4
0,0,13,13,17,19,36,69,39,108,0.000333,0.186117,16,8933.630402,496.3128,558.3519,150.197491,4,4
0,0,13,13,17,19,36,69,39,108,0.000333,0.186117,16,8933.630402,496.3128,558.3519,150.197491,4,4
0,0,13,13,17,19,36,69,39,108,0.000333,0.186117,16,8933.630402,496.3128,558.3519,150.197491,4,4
0,0,13,13,17,19,36,69,39,108,0.000333,0.186117,16,8933.630402,496.3128,558.3519,150.197491,4,4
0,0,13,13,17,19,36,69,39,108,0.000333,0.186117,16,8933.630402,496.3128,558.3519,150.197491,4,4
0,0,13,13,17,19,36,69,39,108,0.000333,0.186117,16,8933.630402,496.3128,558.3519,150.197491,4,4
0,0,13,13,17,19,36,69,39,108,0.000333,0.186117,16,8933.630402,496.3128,558.3519,150.197491,4,4
0,0,13,13,17,19,36,69,39,108,0.000333,0.186117,16,8933.630402,496.3128,558.3519,150.197491,4,4
0,0,13,13,17,19,36,69,39,108,0.000333,0.186117,16,8933.630402,496.3128,558.3519,150.197491,4,4
0,0,15,15,18,21,39,76,45,121,0.000333,0.213178,18,11511.60603,639.533668,639.533668,167.297316,4,4
0,0,6,6,10,12,22,24,16,40,0.000333,0.059459,5,891.886324,49.54924,178.377265,76.238831,3,4
0,0,15,15,17,20,37,75,45,120,0.000333,0.208378,16,10002.15046,555.675026,625.134404,155.92543,4,4
0,0,7,7,12,9,21,30,16,46,0.000333,0.067349,6,1212.279609,67.348867,202.046601,71.548875,3,4
0,0,7,7,12,13,25,26,18,44,0.000333,0.06811,6,1225.978034,68.109891,204.329672,91.125266,3,4
0,0,15,15,18,21,39,76,45,121,0.000333,0.213178,18,11511.60603,639.533668,639.533668,167.297316,4,4
0,0,15,15,18,20,38,75,43,118,0.000333,0.206418,18,11146.59804,619.255447,619.255447,161.497212,4,4
0,0,6,6,11,10,21,25,14,39,0.000333,0.0571,5,856.501897,47.583439,171.300379,71.273029,3,4
0,0,16,16,17,23,40,75,49,124,0.000333,0.219973,16,10558.70534,586.594741,659.919084,173.528793,4,4
0,0,6,6,10,12,22,24,16,40,0.000333,0.059459,5,891.886324,49.54924,178.377265,76.238831,3,4
0,0,6,6,10,12,22,24,16,40,0.000333,0.059459,5,891.886324,49.54924,178.377265,76.238831,3,4
0,0,6,6,10,12,22,24,16,40,0.000333,0.059459,5,891.886324,49.54924,178.377265,76.238831,3,4
0,0,6,6,10,12,22,24,16,40,0.000333,0.059459,5,891.886324,49.54924,178.377265,76.238831,3,4
0,0,6,6,11,10,21,25,15,40,0.000333,0.058564,5,878.463485,48.803527,175.692697,71.273029,3,4
0,0,7,7,11,13,24,29,19,48,0.000333,0.073359,5,1100.391,61.132833,220.0782,86.159464,3,4
0,0,8,8,11,14,25,38,23,61,0.000333,0.094425,5,1416.376138,78.687563,283.275228,91.356717,3,4
0,0,6,6,10,12,22,24,16,40,0.000333,0.059459,5,891.886324,49.54924,178.377265,76.238831,3,4
0,0,7,7,13,14,27,31,20,51,0.000333,0.080833,6,1454.995576,80.833088,242.499263,101.408685,3,4
0,0,7,7,12,15,27,27,22,49,0.000333,0.077663,6,1397.936926,77.663163,232.989488,101.622909,3,4
0,0,6,6,11,11,22,24,15,39,0.000333,0.057973,5,869.589166,48.310509,173.917833,76.107496,3,4
0,0,6,6,12,13,25,26,17,43,0.000333,0.066562,6,1198.114897,66.561939,199.685816,91.125266,3,4
0,0,6,6,11,13,24,25,17,42,0.000333,0.064189,5,962.842125,53.491229,192.568425,86.159464,3,4
0,0,10,10,17,17,34,50,30,80,0.000333,0.135666,8,3255.976218,180.887568,406.997027,138.973737,3,4
0,0,10,10,17,17,34,50,30,80,0.000333,0.135666,8,3255.976218,180.887568,406.997027,138.973737,3,4
0,0,10,10,17,17,34,50,30,80,0.000333,0.135666,8,3255.976218,180.887568,406.997027,138.973737,3,4
0,0,10,10,17,17,34,50,30,80,0.000333,0.135666,8,3255.976218,180.887568,406.997027,138.973737,3,4
0,0,10,10,17,17,34,50,30,80,0.000333,0.135666,8,3255.976218,180.887568,406.997027,138.973737,3,4
0,0,10,10,17,17,34,50,30,80,0.000333,0.135666,8,3255.976218,180.887568,406.997027,138.973737,3,4
0,0,10,10,17,17,34,50,30,80,0.000333,0.135666,8,3255.976218,180.887568,406.997027,138.973737,3,4
0,0,10,10,17,17,34,50,30,80,0.000333,0.135666,8,3255.976218,180.887568,406.997027,138.973737,3,4
0,0,10,10,17,17,34,50,30,80,0.000333,0.135666,8,3255.976218,180.887568,406.997027,138.973737,3,4
0,0,10,10,17,17,34,50,30,80,0.000333,0.135666,8,3255.976218,180.887568,406.997027,138.973737,3,4
0,0,10,10,17,17,34,50,30,80,0.000333,0.135666,8,3255.976218,180.887568,406.997027,138.973737,3,4
0,0,10,10,17,17,34,50,30,80,0.000333,0.135666,8,3255.976218,180.887568,406.997027,138.973737,3,4
0,0,10,10,17,17,34,50,30,80,0.000333,0.135666,8,3255.976218,180.887568,406.997027,138.973737,3,4
0,0,10,10,17,17,34,50,30,80,0.000333,0.135666,8,3255.976218,180.887568,406.997027,138.973737,3,4
0,0,10,10,17,17,34,50,30,80,0.000333,0.135666,8,3255.976218,180.887568,406.997027,138.973737,3,4
0,0,10,10,17,17,34,50,30,80,0.000333,0.135666,8,3255.976218,180.887568,406.997027,138.973737,3,4
0,0,10,10,17,17,34,50,30,80,0.000333,0.135666,8,3255.976218,180.887568,406.997027,138.973737,3,4
0,0,10,10,17,17,34,50,30,80,0.000333,0.135666,8,3255.976218,180.887568,406.997027,138.973737,3,4
0,0,12,12,18,19,37,57,36,93,0.000333,0.161493,9,4360.312467,242.239582,484.479163,155.769273,3,4
0,0,6,6,10,12,22,24,16,40,0.000333,0.059459,5,891.886324,49.54924,178.377265,76.238831,3,4
0,0,12,12,17,18,35,56,36,92,0.000333,0.157298,16,7550.304601,419.461367,471.894038,144.545518,3,4
0,0,7,7,12,9,21,30,16,46,0.000333,0.067349,6,1212.279609,67.348867,202.046601,71.548875,3,4
0,0,7,7,12,13,25,26,18,44,0.000333,0.06811,6,1225.978034,68.109891,204.329672,91.125266,3,4
0,0,12,12,18,19,37,57,36,93,0.000333,0.161493,9,4360.312467,242.239582,484.479163,155.769273,3,4
0,0,9,9,14,12,26,42,22,64,0.000333,0.100276,7,2105.796994,116.988722,300.828142,96.322519,3,4
0,0,6,6,11,10,21,25,14,39,0.000333,0.0571,5,856.501897,47.583439,171.300379,71.273029,3,4
0,0,13,13,17,21,38,56,40,96,0.000333,0.167934,8,4030.40833,223.911574,503.801041,161.725534,3,4
0,0,6,6,10,12,22,24,16,40,0.000333,0.059459,5,891.886324,49.54924,178.377265,76.238831,3,4
0,0,6,6,10,12,22,24,16,40,0.000333,0.059459,5,891.886324,49.54924,178.377265,76.238831,3,4
0,0,6,6,10,12,22,24,16,40,0.000333,0.059459,5,891.886324,49.54924,178.377265,76.238831,3,4
0,0,6,6,10,12,22,24,16,40,0.000333,0.059459,5,891.886324,49.54924,178.377265,76.238831,3,4
0,0,6,6,11,10,21,25,15,40,0.000333,0.058564,5,878.463485,48.803527,175.692697,71.273029,3,4
0,0,7,7,11,13,24,29,19,48,0.000333,0.073359,5,1100.391,61.132833,220.0782,86.159464,3,4
0,0,8,8,11,14,25,38,23,61,0.000333,0.094425,5,1416.376138,78.687563,283.275228,91.356717,3,4
0,0,6,6,10,12,22,24,16,40,0.000333,0.059459,5,891.886324,49.54924,178.377265,76.238831,3,4
0,0,7,7,13,14,27,31,20,51,0.000333,0.080833,6,1454.995576,80.833088,242.499263,101.408685,3,4
0,0,7,7,12,15,27,27,22,49,0.000333,0.077663,6,1397.936926,77.663163,232.989488,101.622909,3,4
0,0,6,6,11,11,22,24,15,39,0.000333,0.057973,5,869.589166,48.310509,173.917833,76.107496,3,4
0,0,6,6,12,13,25,26,17,43,0.000333,0.066562,6,1198.114897,66.561939,199.685816,91.125266,3,4
0,0,6,6,11,13,24,25,17,42,0.000333,0.064189,5,962.842125,53.491229,192.568425,86.159464,3,4
0,0,11,11,17,18,35,59,33,92,0.000333,0.157298,8,3775.1523,209.730683,471.894038,144.545518,4,4
0,0,11,11,17,18,35,59,33,92,0.000333,0.157298,8,3775.1523,209.730683,471.894038,144.545518,4,4
0,0,11,11,17,18,35,59,33,92,0.000333,0.157298,8,3775.1523,209.730683,471.894038,144.545518,4,4
0,0,11,11,17,18,35,59,33,92,0.000333,0.157298,8,3775.1523,209.730683,471.894038,144.545518,4,4
0,0,11,11,17,18,35,59,33,92,0.000333,0.157298,8,3775.1523,209.730683,471.894038,144.545518,4,4
0,0,11,11,17,18,35,59,33,92,0.000333,0.157298,8,3775.1523,209.730683,471.894038,144.545518,4,4
0,0,11,11,17,18,35,59,33,92,0.000333,0.157298,8,3775.1523,209.730683,471.894038,144.545518,4,4
0,0,11,11,17,18,35,59,33,92,0.000333,0.157298,8,3775.1523,209.730683,471.894038,144.545518,4,4
0,0,11,11,17,18,35,59,33,92,0.000333,0.157298,8,3775.1523,209.730683,471.894038,144.545518,4,4
0,0,11,11,17,18,35,59,33,92,0.000333,0.157298,8,3775.1523,209.730683,471.894038,144.545518,4,4
0,0,11,11,17,18,35,59,33,92,0.000333,0.157298,8,3775.1523,209.730683,471.894038,144.545518,4,4
0,0,11,11,17,18,35,59,33,92,0.000333,0.157298,8,3775.1523,209.730683,471.894038,144.545518,4,4
0,0,11,11,17,18,35,59,33,92,0.000333,0.157298,8,3775.1523,209.730683,471.894038,144.545518,4,4
0,0,11,11,17,18,35,59,33,92,0.000333,0.157298,8,3775.1523,209.730683,471.894038,144.545518,4,4
0,0,11,11,17,18,35,59,33,92,0.000333,0.157298,8,3775.1523,209.730683,471.894038,144.545518,4,4
0,0,11,11,17,18,35,59,33,92,0.000333,0.157298,8,3775.1523,209.730683,471.894038,144.545518,4,4
0,0,11,11,17,18,35,59,33,92,0.000333,0.157298,8,3775.1523,209.730683,471.894038,144.545518,4,4
0,0,11,11,17,18,35,59,33,92,0.000333,0.157298,8,3775.1523,209.730683,471.894038,144.545518,4,4
0,0,13,13,18,20,38,66,39,105,0.000333,0.183677,9,4959.2915,275.516194,551.032389,161.497212,4,4
0,0,6,6,10,12,22,24,16,40,0.000333,0.059459,5,891.886324,49.54924,178.377265,76.238831,3,4
0,0,13,13,17,19,36,65,39,104,0.000333,0.179224,16,8602.755202,477.930845,537.6722,150.197491,4,4
0,0,7,7,12,9,21,30,16,46,0.000333,0.067349,6,1212.279609,67.348867,202.046601,71.548875,3,4
0,0,7,7,12,13,25,26,18,44,0.000333,0.06811,6,1225.978034,68.109891,204.329672,91.125266,3,4
0,0,13,13,18,20,38,66,39,105,0.000333,0.183677,9,4959.2915,275.516194,551.032389,161.497212,4,4
0,0,9,9,14,12,26,42,22,64,0.000333,0.100276,7,2105.796994,116.988722,300.828142,96.322519,3,4
0,0,6,6,11,10,21,25,14,39,0.000333,0.0571,5,856.501897,47.583439,171.300379,71.273029,3,4
0,0,7,7,11,11,22,24,15,39,0.000333,0.057973,5,869.589166,48.310509,173.917833,76.107496,3,4
0,0,6,6,10,12,22,24,16,40,0.000333,0.059459,5,891.886324,49.54924,178.377265,76.238831,3,4
0,0,6,6,10,12,22,24,16,40,0.000333,0.059459,5,891.886324,49.54924,178.377265,76.238831,3,4
0,0,6,6,10,12,22,24,16,40,0.000333,0.059459,5,891.886324,49.54924,178.377265,76.238831,3,4
0,0,6,6,10,12,22,24,16,40,0.000333,0.059459,5,891.886324,49.54924,178.377265,76.238831,3,4
0,0,6,6,11,10,21,25,15,40,0.000333,0.058564,5,878.463485,48.803527,175.692697,71.273029,3,4
0,0,7,7,11,13,24,29,19,48,0.000333,0.073359,5,1100.391,61.132833,220.0782,86.159464,3,4
0,0,8,8,11,14,25,38,23,61,0.000333,0.094425,5,1416.376138,78.687563,283.275228,91.356717,3,4
0,0,6,6,10,12,22,24,16,40,0.000333,0.059459,5,891.886324,49.54924,178.377265,76.238831,3,4
0,0,7,7,13,14,27,31,20,51,0.000333,0.080833,6,1454.995576,80.833088,242.499263,101.408685,3,4
0,0,7,7,12,15,27,27,22,49,0.000333,0.077663,6,1397.936926,77.663163,232.989488,101.622909,3,4
0,0,6,6,11,11,22,24,15,39,0.000333,0.057973,5,869.589166,48.310509,173.917833,76.107496,3,4
0,0,6,6,12,13,25,26,17,43,0.000333,0.066562,6,1198.114897,66.561939,199.685816,91.125266,3,4
0,0,6,6,11,13,24,25,17,42,0.000333,0.064189,5,962.842125,53.491229,192.568425,86.159464,3,4
0,0,9,9,15,13,28,42,22,64,0.000333,0.102557,7,2153.695005,119.649723,307.670715,106.709075,3,4
0,0,9,9,15,13,28,42,22,64,0.000333,0.102557,7,2153.695005,119.649723,307.670715,106.709075,3,4
0,0,9,9,15,13,28,42,22,64,0.000333,0.102557,7,2153.695005,119.649723,307.670715,106.709075,3,4
0,0,9,9,15,13,28,42,22,64,0.000333,0.102557,7,2153.695005,119.649723,307.670715,106.709075,3,4
0,0,9,9,15,13,28,42,22,64,0.000333,0.102557,7,2153.695005,119.649723,307.670715,106.709075,3,4
0,0,9,9,15,13,28,42,22,64,0.000333,0.102557,7,2153.695005,119.649723,307.670715,106.709075,3,4
0,0,9,9,15,13,28,42,22,64,0.000333,0.102557,7,2153.695005,119.649723,307.670715,106.709075,3,4
0,0,9,9,15,13,28,42,22,64,0.000333,0.102557,7,2153.695005,119.649723,307.670715,106.709075,3,4
0,0,9,9,15,13,28,42,22,64,0.000333,0.102557,7,2153.695005,119.649723,307.670715,106.709075,3,4
0,0,9,9,15,13,28,42,22,64,0.000333,0.102557,7,2153.695005,119.649723,307.670715,106.709075,3,4
0,0,9,9,15,13,28,42,22,64,0.000333,0.102557,7,2153.695005,119.649723,307.670715,106.709075,3,4
0,0,9,9,15,13,28,42,22,64,0.000333,0.102557,7,2153.695005,119.649723,307.670715,106.709075,3,4
0,0,9,9,15,13,28,42,22,64,0.000333,0.102557,7,2153.695005,119.649723,307.670715,106.709075,3,4
0,0,9,9,15,13,28,42,22,64,0.000333,0.102557,7,2153.695005,119.649723,307.670715,106.709075,3,4
0,0,9,9,15,13,28,42,22,64,0.000333,0.102557,7,2153.695005,119.649723,307.670715,106.709075,3,4
0,0,9,9,15,13,28,42,22,64,0.000333,0.102557,7,2153.695005,119.649723,307.670715,106.709075,3,4
0,0,9,9,15,13,28,42,22,64,0.000333,0.102557,7,2153.695005,119.649723,307.670715,106.709075,3,4
0,0,9,9,15,13,28,42,22,64,0.000333,0.102557,7,2153.695005,119.649723,307.670715,106.709075,3,4
0,0,11,11,16,15,31,49,28,77,0.000333,0.127158,8,3051.784927,169.543607,381.473116,122.603359,3,4
0,0,6,6,10,12,22,24,16,40,0.000333,0.059459,5,891.886324,49.54924,178.377265,76.238831,3,4
0,0,11,11,15,14,29,48,28,76,0.000333,0.123069,14,5168.891779,287.160654,369.206556,111.906328,3,4
0,0,7,7,12,9,21,30,16,46,0.000333,0.067349,6,1212.279609,67.348867,202.046601,71.548875,3,4
0,0,7,7,12,13,25,26,18,44,0.000333,0.06811,6,1225.978034,68.109891,204.329672,91.125266,3,4
0,0,11,11,16,15,31,49,28,77,0.000333,0.127158,8,3051.784927,169.543607,381.473116,122.603359,3,4
0,0,9,9,14,12,26,42,22,64,0.000333,0.100276,7,2105.796994,116.988722,300.828142,96.322519,3,4
0,0,6,6,11,10,21,25,14,39,0.000333,0.0571,5,856.501897,47.583439,171.300379,71.273029,3,4
0,0,12,12,15,17,32,48,32,80,0.000333,0.133333,7,2800,155.555556,400,128.090227,3,4
0,0,6,6,10,12,22,24,16,40,0.000333,0.059459,5,891.886324,49.54924,178.377265,76.238831,3,4
0,0,6,6,10,12,22,24,16,40,0.000333,0.059459,5,891.886324,49.54924,178.377265,76.238831,3,4
0,0,6,6,10,12,22,24,16,40,0.000333,0.059459,5,891.886324,49.54924,178.377265,76.238831,3,4
0,0,6,6,10,12,22,24,16,40,0.000333,0.059459,5,891.886324,49.54924,178.377265,76.238831,3,4
0,0,6,6,11,10,21,25,15,40,0.000333,0.058564,5,878.463485,48.803527,175.692697,71.273029,3,4
0,0,7,7,11,13,24,29,19,48,0.000333,0.073359,5,1100.391,61.132833,220.0782,86.159464,3,4
0,0,8,8,11,14,25,38,23,61,0.000333,0.094425,5,1416.376138,78.687563,283.275228,91.356717,3,4
0,0,6,6,10,12,22,24,16,40,0.000333,0.059459,5,891.886324,49.54924,178.377265,76.238831,3,4
0,0,7,7,13,14,27,31,20,51,0.000333,0.080833,6,1454.995576,80.833088,242.499263,101.408685,3,4
0,0,7,7,12,15,27,27,22,49,0.000333,0.077663,6,1397.936926,77.663163,232.989488,101.622909,3,4
0,0,6,6,11,11,22,24,15,39,0.000333,0.057973,5,869.589166,48.310509,173.917833,76.107496,3,4
0,0,6,6,12,13,25,26,17,43,0.000333,0.066562,6,1198.114897,66.561939,199.685816,91.125266,3,4
0,0,6,6,11,13,24,25,17,42,0.000333,0.064189,5,962.842125,53.491229,192.568425,86.159464,3,4
0,0,11,11,17,15,32,57,29,86,0.000333,0.143333,8,3440,191.111111,430,128.090227,3,4
0,0,11,11,17,15,32,57,29,86,0.000333,0.143333,8,3440,191.111111,430,128.090227,3,4
0,0,11,11,17,15,32,57,29,86,0.000333,0.143333,8,3440,191.111111,430,128.090227,3,4
0,0,11,11,17,15,32,57,29,86,0.000333,0.143333,8,3440,191.111111,430,128.090227,3,4
0,0,11,11,17,15,32,57,29,86,0.000333,0.143333,8,3440,191.111111,430,128.090227,3,4
0,0,11,11,17,15,32,57,29,86,0.000333,0.143333,8,3440,191.111111,430,128.090227,3,4
0,0,11,11,17,15,32,57,29,86,0.000333,0.143333,8,3440,191.111111,430,128.090227,3,4
0,0,11,11,17,15,32,57,29,86,0.000333,0.143333,8,3440,191.111111,430,128.090227,3,4
0,0,11,11,17,15,32,57,29,86,0.000333,0.143333,8,3440,191.111111,430,128.090227,3,4
0,0,11,11,17,15,32,57,29,86,0.000333,0.143333,8,3440,191.111111,430,128.090227,3,4
0,0,11,11,17,15,32,57,29,86,0.000333,0.143333,8,3440,191.111111,430,128.090227,3,4
0,0,11,11,17,15,32,57,29,86,0.000333,0.143333,8,3440,191.111111,430,128.090227,3,4
0,0,11,11,17,15,32,57,29,86,0.000333,0.143333,8,3440,191.111111,430,128.090227,3,4
0,0,11,11,17,15,32,57,29,86,0.000333,0.143333,8,3440,191.111111,430,128.090227,3,4
0,0,11,11,17,15,32,57,29,86,0.000333,0.143333,8,3440,191.111111,430,128.090227,3,4
0,0,11,11,17,15,32,57,29,86,0.000333,0.143333,8,3440,191.111111,430,128.090227,3,4
0,0,11,11,17,15,32,57,29,86,0.000333,0.143333,8,3440,191.111111,430,128.090227,3,4
0,0,11,11,17,15,32,57,29,86,0.000333,0.143333,8,3440,191.111111,430,128.090227,3,4
0,0,13,13,18,17,35,64,35,99,0.000333,0.169266,18,9140.382336,507.799019,507.799019,144.545518,3,4
0,0,6,6,10,12,22,24,16,40,0.000333,0.059459,5,891.886324,49.54924,178.377265,76.238831,3,4
0,0,13,13,17,16,33,63,35,98,0.000333,0.164784,16,7909.609979,439.422777,494.350624,133.486868,3,4
0,0,7,7,12,9,21,30,16,46,0.000333,0.067349,6,1212.279609,67.348867,202.046601,71.548875,3,4
0,0,7,7,12,13,25,26,18,44,0.000333,0.06811,6,1225.978034,68.109891,204.329672,91.125266,3,4
0,0,13,13,18,17,35,64,35,99,0.000333,0.169266,18,9140.382336,507.799019,507.799019,144.545518,3,4
0,0,13,13,18,16,34,63,33,96,0.000333,0.162799,18,8791.13579,488.396433,488.396433,139.05865,3,4
0,0,6,6,11,10,21,25,14,39,0.000333,0.0571,5,856.501897,47.583439,171.300379,71.273029,3,4
0,0,14,14,17,19,36,63,39,102,0.000333,0.175777,16,8437.317602,468.739867,527.33235,150.197491,3,4
0,0,6,6,10,12,22,24,16,40,0.000333,0.059459,5,891.886324,49.54924,178.377265,76.238831,3,4
0,0,6,6,10,12,22,24,16,40,0.000333,0.059459,5,891.886324,49.54924,178.377265,76.238831,3,4
0,0,6,6,10,12,22,24,16,40,0.000333,0.059459,5,891.886324,49.54924,178.377265,76.238831,3,4
0,0,6,6,10,12,22,24,16,40,0.000333,0.059459,5,891.886324,49.54924,178.377265,76.238831,3,4
0,0,6,6,11,10,21,25,15,40,0.000333,0.058564,5,878.463485,48.803527,175.692697,71.273029,3,4
0,0,7,7,11,13,24,29,19,48,0.000333,0.073359,5,1100.391,61.132833,220.0782,86.159464,3,4
0,0,8,8,11,14,25,38,23,61,0.000333,0.094425,5,1416.376138,78.687563,283.275228,91.356717,3,4
0,0,6,6,10,12,22,24,16,40,0.000333,0.059459,5,891.886324,49.54924,178.377265,76.238831,3,4
0,0,7,7,13,14,27,31,20,51,0.000333,0.080833,6,1454.995576,80.833088,242.499263,101.408685,3,4
0,0,7,7,12,15,27,27,22,49,0.000333,0.077663,6,1397.936926,77.663163,232.989488,101.622909,3,4
0,0,6,6,11,11,22,24,15,39,0.000333,0.057973,5,869.589166,48.310509,173.917833,76.107496,3,4
0,0,6,6,12,13,25,26,17,43,0.000333,0.066562,6,1198.114897,66.561939,199.685816,91.125266,3,4
0,0,6,6,11,13,24,25,17,42,0.000333,0.064189,5,962.842125,53.491229,192.568425,86.159464,3,4
0,0,7,7,9,14,23,34,22,56,0.000333,0.08444,4,1013.277878,56.293215,253.31947,81.832294,2,4
0,0,7,7,9,11,20,30,19,49,0.000333,0.070591,4,847.097907,47.060995,211.774477,66.583073,2,4
0,0,9,9,12,18,30,48,32,80,0.000333,0.13085,6,2355.307486,130.850416,392.551248,118.0782,2,4
0,0,6,6,9,10,19,29,17,46,0.000333,0.065135,4,781.618662,43.423259,195.404666,61.748606,2,4
0,0,7,7,9,11,20,30,19,49,0.000333,0.070591,4,847.097907,47.060995,211.774477,66.583073,2,4
0,0,7,7,9,11,20,30,19,49,0.000333,0.070591,4,847.097907,47.060995,211.774477,66.583073,2,4
0,0,7,7,9,14,23,34,22,56,0.000333,0.08444,4,1013.277878,56.293215,253.31947,81.832294,2,4
0,0,7,7,9,11,20,31,19,50,0.000333,0.072032,4,864.385619,48.021423,216.096405,66.583073,2,4
0,0,7,7,9,11,20,31,19,50,0.000333,0.072032,4,864.385619,48.021423,216.096405,66.583073,2,4
0,0,8,8,11,14,25,39,24,63,0.000333,0.097521,5,1462.8147,81.267483,292.56294,91.356717,2,4
0,0,7,7,9,11,20,30,19,49,0.000333,0.070591,4,847.097907,47.060995,211.774477,66.583073,2,4
0,0,7,7,9,11,20,30,19,49,0.000333,0.070591,4,847.097907,47.060995,211.774477,66.583073,2,4
0,0,7,7,9,14,23,34,22,56,0.000333,0.08444,4,1013.277878,56.293215,253.31947,81.832294,2,4
0,0,7,7,9,11,20,31,19,50,0.000333,0.072032,4,864.385619,48.021423,216.096405,66.583073,2,4
0,0,7,7,9,11,20,31,19,50,0.000333,0.072032,4,864.385619,48.021423,216.096405,66.583073,2,4
0,0,8,8,11,14,25,39,24,63,0.000333,0.097521,5,1462.8147,81.267483,292.56294,91.356717,2,4
0,0,7,7,9,11,20,30,19,49,0.000333,0.070591,4,847.097907,47.060995,211.774477,66.583073,2,4
0,0,7,7,9,11,20,30,19,49,0.000333,0.070591,4,847.097907,47.060995,211.774477,66.583073,2,4
0,0,7,7,9,14,23,34,22,56,0.000333,0.08444,4,1013.277878,56.293215,253.31947,81.832294,2,4
0,0,8,8,11,14,25,39,24,63,0.000333,0.097521,5,1462.8147,81.267483,292.56294,91.356717,2,4
0,0,7,7,9,11,20,31,19,50,0.000333,0.072032,4,864.385619,48.021423,216.096405,66.583073,2,4
0,0,7,7,9,11,20,31,19,50,0.000333,0.072032,4,864.385619,48.021423,216.096405,66.583073,2,4
0,0,7,7,9,11,20,30,19,49,0.000333,0.070591,4,847.097907,47.060995,211.774477,66.583073,2,4
0,0,7,7,9,11,20,30,19,49,0.000333,0.070591,4,847.097907,47.060995,211.774477,66.583073,2,4
0,0,7,7,9,14,23,34,22,56,0.000333,0.08444,4,1013.277878,56.293215,253.31947,81.832294,2,4
0,0,8,8,11,14,25,39,24,63,0.000333,0.097521,5,1462.8147,81.267483,292.56294,91.356717,2,4
0,0,7,7,9,11,20,31,19,50,0.000333,0.072032,4,864.385619,48.021423,216.096405,66.583073,2,4
0,0,7,7,9,11,20,31,19,50,0.000333,0.072032,4,864.385619,48.021423,216.096405,66.583073,2,4
0,0,7,7,9,11,20,30,19,49,0.000333,0.070591,4,847.097907,47.060995,211.774477,66.583073,2,4
0,0,7,7,9,11,20,30,19,49,0.000333,0.070591,4,847.097907,47.060995,211.774477,66.583073,2,4
0,0,7,7,9,14,23,34,22,56,0.000333,0.08444,4,1013.277878,56.293215,253.31947,81.832294,2,4
0,0,7,7,9,11,20,31,19,50,0.000333,0.072032,4,864.385619,48.021423,216.096405,66.583073,2,4
0,0,7,7,9,11,20,31,19,50,0.000333,0.072032,4,864.385619,48.021423,216.096405,66.583073,2,4
0,0,8,8,11,14,25,39,24,63,0.000333,0.097521,5,1462.8147,81.267483,292.56294,91.356717,2,4
0,0,7,7,9,11,20,30,19,49,0.000333,0.070591,4,847.097907,47.060995,211.774477,66.583073,2,4
0,0,7,7,9,11,20,30,19,49,0.000333,0.070591,4,847.097907,47.060995,211.774477,66.583073,2,4
0,0,7,7,9,14,23,34,22,56,0.000333,0.08444,4,1013.277878,56.293215,253.31947,81.832294,2,4
0,0,7,7,9,11,20,31,19,50,0.000333,0.072032,4,864.385619,48.021423,216.096405,66.583073,2,4
0,0,7,7,9,11,20,31,19,50,0.000333,0.072032,4,864.385619,48.021423,216.096405,66.583073,2,4
0,0,8,8,11,14,25,39,24,63,0.000333,0.097521,5,1462.8147,81.267483,292.56294,91.356717,2,4
0,0,7,7,9,11,20,30,19,49,0.000333,0.070591,4,847.097907,47.060995,211.774477,66.583073,2,4
0,0,7,7,9,14,23,34,22,56,0.000333,0.08444,4,1013.277878,56.293215,253.31947,81.832294,2,4
0,0,7,7,9,11,20,30,19,49,0.000333,0.070591,4,847.097907,47.060995,211.774477,66.583073,2,4
0,0,7,7,9,11,20,31,19,50,0.000333,0.072032,4,864.385619,48.021423,216.096405,66.583073,2,4
0,0,8,8,11,14,25,39,24,63,0.000333,0.097521,5,1462.8147,81.267483,292.56294,91.356717,2,4
0,0,7,7,9,11,20,31,19,50,0.000333,0.072032,4,864.385619,48.021423,216.096405,66.583073,2,4
0,0,7,7,9,11,20,30,19,49,0.000333,0.070591,4,847.097907,47.060995,211.774477,66.583073,2,4
0,0,7,7,9,11,20,30,19,49,0.000333,0.070591,4,847.097907,47.060995,211.774477,66.583073,2,4
0,0,7,7,9,14,23,34,22,56,0.000333,0.08444,4,1013.277878,56.293215,253.31947,81.832294,2,4
0,0,7,7,9,11,20,31,19,50,0.000333,0.072032,4,864.385619,48.021423,216.096405,66.583073,2,4
0,0,7,7,9,11,20,31,19,50,0.000333,0.072032,4,864.385619,48.021423,216.096405,66.583073,2,4
0,0,8,8,11,14,25,39,24,63,0.000333,0.097521,5,1462.8147,81.267483,292.56294,91.356717,2,4
0,0,7,7,9,11,20,30,19,49,0.000333,0.070591,4,847.097907,47.060995,211.774477,66.583073,2,4
0,0,7,7,9,11,20,30,19,49,0.000333,0.070591,4,847.097907,47.060995,211.774477,66.583073,2,4
0,0,7,7,9,14,23,34,22,56,0.000333,0.08444,4,1013.277878,56.293215,253.31947,81.832294,2,4
0,0,7,7,9,11,20,31,19,50,0.000333,0.072032,4,864.385619,48.021423,216.096405,66.583073,2,4
0,0,7,7,9,11,20,31,19,50,0.000333,0.072032,4,864.385619,48.021423,216.096405,66.583073,2,4
0,0,8,8,11,14,25,39,24,63,0.000333,0.097521,5,1462.8147,81.267483,292.56294,91.356717,2,4
0,0,7,7,9,11,20,30,19,49,0.000333,0.070591,4,847.097907,47.060995,211.774477,66.583073,2,4
0,0,7,7,9,11,20,30,19,49,0.000333,0.070591,4,847.097907,47.060995,211.774477,66.583073,2,4
0,0,7,7,9,14,23,34,22,56,0.000333,0.08444,4,1013.277878,56.293215,253.31947,81.832294,2,4
0,0,7,7,9,11,20,31,19,50,0.000333,0.072032,4,864.385619,48.021423,216.096405,66.583073,2,4
0,0,7,7,9,11,20,31,19,50,0.000333,0.072032,4,864.385619,48.021423,216.096405,66.583073,2,4
0,0,8,8,11,14,25,39,24,63,0.000333,0.097521,5,1462.8147,81.267483,292.56294,91.356717,2,4
0,0,7,7,9,14,23,34,22,56,0.000333,0.08444,4,1013.277878,56.293215,253.31947,81.832294,2,4
0,0,7,7,9,11,20,30,19,49,0.000333,0.070591,4,847.097907,47.060995,211.774477,66.583073,2,4
0,0,7,7,9,11,20,30,19,49,0.000333,0.070591,4,847.097907,47.060995,211.774477,66.583073,2,4
0,0,11,11,12,18,30,58,39,97,0.000333,0.158656,12,5711.620653,317.312259,475.968388,118.0782,2,4
0,0,7,7,9,10,19,31,19,50,0.000333,0.070799,4,849.585503,47.199195,212.396376,61.748606,2,4
0,0,10,10,12,19,31,50,34,84,0.000333,0.138717,6,2496.91494,138.717497,416.15249,123.730173,2,4
0,0,7,7,9,11,20,30,19,49,0.000333,0.070591,4,847.097907,47.060995,211.774477,66.583073,2,4
0,0,7,7,9,11,20,30,19,49,0.000333,0.070591,4,847.097907,47.060995,211.774477,66.583073,2,4
0,0,7,7,9,14,23,34,22,56,0.000333,0.08444,4,1013.277878,56.293215,253.31947,81.832294,2,4
0,0,7,7,9,11,20,31,19,50,0.000333,0.072032,4,864.385619,48.021423,216.096405,66.583073,2,4
0,0,7,7,9,11,20,31,19,50,0.000333,0.072032,4,864.385619,48.021423,216.096405,66.583073,2,4
0,0,8,8,11,14,25,39,24,63,0.000333,0.097521,5,1462.8147,81.267483,292.56294,91.356717,2,4
0,0,7,7,9,11,20,30,19,49,0.000333,0.070591,4,847.097907,47.060995,211.774477,66.583073,2,4
0,0,7,7,9,11,20,30,19,49,0.000333,0.070591,4,847.097907,47.060995,211.774477,66.583073,2,4
0,0,7,7,9,14,23,34,22,56,0.000333,0.08444,4,1013.277878,56.293215,253.31947,81.832294,2,4
0,0,7,7,9,11,20,31,19,50,0.000333,0.072032,4,864.385619,48.021423,216.096405,66.583073,2,4
0,0,7,7,9,11,20,31,19,50,0.000333,0.072032,4,864.385619,48.021423,216.096405,66.583073,2,4
0,0,8,8,11,14,25,39,24,63,0.000333,0.097521,5,1462.8147,81.267483,292.56294,91.356717,2,4
0,0,7,7,9,11,20,30,19,49,0.000333,0.070591,4,847.097907,47.060995,211.774477,66.583073,2,4
0,0,7,7,9,14,23,34,22,56,0.000333,0.08444,4,1013.277878,56.293215,253.31947,81.832294,2,4
0,0,7,7,9,11,20,30,19,49,0.000333,0.070591,4,847.097907,47.060995,211.774477,66.583073,2,4
0,0,8,8,11,14,25,39,24,63,0.000333,0.097521,5,1462.8147,81.267483,292.56294,91.356717,2,4
0,0,7,7,9,11,20,31,19,50,0.000333,0.072032,4,864.385619,48.021423,216.096405,66.583073,2,4
0,0,7,7,9,11,20,31,19,50,0.000333,0.072032,4,864.385619,48.021423,216.096405,66.583073,2,4
0,0,7,7,9,11,20,30,19,49,0.000333,0.070591,4,847.097907,47.060995,211.774477,66.583073,2,4
0,0,7,7,9,14,23,34,22,56,0.000333,0.08444,4,1013.277878,56.293215,253.31947,81.832294,2,4
0,0,8,8,11,14,25,39,24,63,0.000333,0.097521,5,1462.8147,81.267483,292.56294,91.356717,2,4
0,0,8,8,11,14,25,39,24,63,0.000333,0.097521,5,1462.8147,81.267483,292.56294,91.356717,2,4
0,0,7,7,9,11,20,30,19,49,0.000333,0.070591,4,847.097907,47.060995,211.774477,66.583073,2,4
0,0,7,7,9,14,23,34,22,56,0.000333,0.08444,4,1013.277878,56.293215,253.31947,81.832294,2,4
0,0,8,8,11,14,25,39,24,63,0.000333,0.097521,5,1462.8147,81.267483,292.56294,91.356717,2,4
0,0,8,8,11,14,25,39,24,63,0.000333,0.097521,5,1462.8147,81.267483,292.56294,91.356717,2,4
0,0,7,7,9,14,23,34,22,56,0.000333,0.08444,4,1013.277878,56.293215,253.31947,81.832294,2,4
0,0,7,7,9,11,20,30,19,49,0.000333,0.070591,4,847.097907,47.060995,211.774477,66.583073,2,4
0,0,9,9,12,18,30,48,32,80,0.000333,0.13085,6,2355.307486,130.850416,392.551248,118.0782,2,4
0,0,9,9,12,18,30,48,32,80,0.000333,0.13085,6,2355.307486,130.850416,392.551248,118.0782,2,4
0,0,7,7,9,14,23,34,22,56,0.000333,0.08444,4,1013.277878,56.293215,253.31947,81.832294,2,4
0,0,7,7,9,11,20,30,19,49,0.000333,0.070591,4,847.097907,47.060995,211.774477,66.583073,2,4
0,0,8,8,10,14,24,35,25,60,0.000333,0.091699,5,1375.48875,76.416042,275.09775,86.52225,2,4
0,0,11,11,13,21,34,54,38,92,0.000333,0.156016,6,2808.279488,156.015527,468.046581,140.344382,2,4
0,0,7,7,9,14,23,34,22,56,0.000333,0.08444,4,1013.277878,56.293215,253.31947,81.832294,2,4
0,0,7,7,9,11,20,30,19,49,0.000333,0.070591,4,847.097907,47.060995,211.774477,66.583073,2,4
0,0,8,8,9,16,25,34,29,63,0.000333,0.097521,4,1170.25176,65.013987,292.56294,92.529325,2,4
0,0,6,6,9,14,23,29,21,50,0.000333,0.075393,4,904.712391,50.2618,226.178098,81.832294,2,4
0,0,7,7,9,11,20,30,19,49,0.000333,0.070591,4,847.097907,47.060995,211.774477,66.583073,2,4
0,0,7,7,9,14,23,34,22,56,0.000333,0.08444,4,1013.277878,56.293215,253.31947,81.832294,2,4
0,0,8,8,9,12,21,33,23,56,0.000333,0.08199,4,983.879103,54.65995,245.969776,71.548875,2,4
0,0,11,11,12,20,32,52,38,90,0.000333,0.15,6,2700,150,450,129.458112,2,4
0,0,7,7,9,14,23,34,22,56,0.000333,0.08444,4,1013.277878,56.293215,253.31947,81.832294,2,4
0,0,7,7,9,11,20,30,19,49,0.000333,0.070591,4,847.097907,47.060995,211.774477,66.583073,2,4
0,0,7,7,10,11,21,34,21,55,0.000333,0.080526,5,1207.887291,67.10485,241.577458,71.273029,2,4
0,0,7,7,10,11,21,34,21,55,0.000333,0.080526,5,1207.887291,67.10485,241.577458,71.273029,2,4
0,0,7,7,9,11,20,30,19,49,0.000333,0.070591,4,847.097907,47.060995,211.774477,66.583073,2,4
0,0,7,7,9,14,23,34,22,56,0.000333,0.08444,4,1013.277878,56.293215,253.31947,81.832294,2,4
0,0,7,7,10,15,25,31,23,54,0.000333,0.083589,5,1253.841171,69.657843,250.768234,91.82264,2,4
0,0,7,7,10,15,25,31,23,54,0.000333,0.083589,5,1253.841171,69.657843,250.768234,91.82264,2,4
0,0,7,7,9,14,23,34,22,56,0.000333,0.08444,4,1013.277878,56.293215,253.31947,81.832294,2,4
0,0,7,7,9,11,20,30,19,49,0.000333,0.070591,4,847.097907,47.060995,211.774477,66.583073,2,4
0,0,8,8,10,14,24,35,25,60,0.000333,0.091699,5,1375.48875,76.416042,275.09775,86.52225,2,4
0,0,11,11,13,21,34,54,38,92,0.000333,0.156016,6,2808.279488,156.015527,468.046581,140.344382,2,4
0,0,7,7,9,11,20,30,19,49,0.000333,0.070591,4,847.097907,47.060995,211.774477,66.583073,2,4
0,0,7,7,9,14,23,34,22,56,0.000333,0.08444,4,1013.277878,56.293215,253.31947,81.832294,2,4
0,0,8,8,10,12,22,35,22,57,0.000333,0.084729,5,1270.938011,70.607667,254.187602,76.238831,2,4
0,0,11,11,13,19,32,54,36,90,0.000333,0.15,6,2700,150,450,128.816339,2,4
0,0,7,7,9,14,23,34,22,56,0.000333,0.08444,4,1013.277878,56.293215,253.31947,81.832294,2,4
0,0,7,7,9,11,20,30,19,49,0.000333,0.070591,4,847.097907,47.060995,211.774477,66.583073,2,4
0,0,6,6,10,13,23,30,20,50,0.000333,0.075393,5,1130.890489,62.827249,226.178098,81.324997,2,4
0,0,6,6,10,12,22,30,19,49,0.000333,0.072837,5,1092.560747,60.697819,218.512149,76.238831,2,4
0,0,7,7,9,11,20,30,19,49,0.000333,0.070591,4,847.097907,47.060995,211.774477,66.583073,2,4
0,0,7,7,9,14,23,34,22,56,0.000333,0.08444,4,1013.277878,56.293215,253.31947,81.832294,2,4
0,0,9,9,9,17,26,34,30,64,0.000333,0.100276,4,1203.312568,66.850698,300.828142,98.016193,2,4
0,0,12,12,12,23,35,53,42,95,0.000333,0.162427,6,2923.69132,162.427296,487.281887,147.061475,2,4
0,0,7,7,9,11,20,30,19,49,0.000333,0.070591,4,847.097907,47.060995,211.774477,66.583073,2,4
0,0,7,7,9,14,23,34,22,56,0.000333,0.08444,4,1013.277878,56.293215,253.31947,81.832294,2,4
0,0,6,6,9,15,24,29,22,51,0.000333,0.077944,4,935.33235,51.962908,233.833088,87.132684,2,4
0,0,6,6,9,14,23,29,21,50,0.000333,0.075393,4,904.712391,50.2618,226.178098,81.832294,2,4
0,0,7,7,9,14,23,34,22,56,0.000333,0.08444,4,1013.277878,56.293215,253.31947,81.832294,2,4
0,0,7,7,9,11,20,30,19,49,0.000333,0.070591,4,847.097907,47.060995,211.774477,66.583073,2,4
0,0,6,6,9,15,24,29,22,51,0.000333,0.077944,4,935.33235,51.962908,233.833088,87.132684,2,4
0,0,6,6,9,14,23,29,21,50,0.000333,0.075393,4,904.712391,50.2618,226.178098,81.832294,2,4
0,0,7,7,9,14,23,34,22,56,0.000333,0.08444,4,1013.277878,56.293215,253.31947,81.832294,2,4
0,0,7,7,9,11,20,30,19,49,0.000333,0.070591,4,847.097907,47.060995,211.774477,66.583073,2,4
0,0,6,6,9,15,24,29,22,51,0.000333,0.077944,4,935.33235,51.962908,233.833088,87.132684,2,4
0,0,6,6,9,14,23,29,21,50,0.000333,0.075393,4,904.712391,50.2618,226.178098,81.832294,2,4
0,0,7,7,9,14,23,34,22,56,0.000333,0.08444,4,1013.277878,56.293215,253.31947,81.832294,2,4
0,0,7,7,9,11,20,30,19,49,0.000333,0.070591,4,847.097907,47.060995,211.774477,66.583073,2,4
0,0,6,6,9,15,24,29,22,51,0.000333,0.077944,4,935.33235,51.962908,233.833088,87.132684,2,4
0,0,6,6,9,14,23,29,21,50,0.000333,0.075393,4,904.712391,50.2618,226.178098,81.832294,2,4
0,0,7,7,9,14,23,34,22,56,0.000333,0.08444,4,1013.277878,56.293215,253.31947,81.832294,2,4
0,0,7,7,9,11,20,30,19,49,0.000333,0.070591,4,847.097907,47.060995,211.774477,66.583073,2,4
0,0,6,6,9,12,21,31,20,51,0.000333,0.074669,4,896.032754,49.779597,224.008189,71.548875,2,4
0,0,6,6,9,13,22,31,21,52,0.000333,0.077297,4,927.561777,51.53121,231.890444,76.635041,2,4
0,0,7,7,9,14,23,34,22,56,0.000333,0.08444,4,1013.277878,56.293215,253.31947,81.832294,2,4
0,0,7,7,9,11,20,30,19,49,0.000333,0.070591,4,847.097907,47.060995,211.774477,66.583073,2,4
0,0,7,7,9,16,25,33,25,58,0.000333,0.089781,4,1077.374636,59.854146,269.343659,92.529325,2,4
0,0,7,7,9,15,24,33,24,57,0.000333,0.087114,4,1045.37145,58.076192,261.342863,87.132684,2,4
0,0,7,7,9,11,20,30,19,49,0.000333,0.070591,4,847.097907,47.060995,211.774477,66.583073,2,4
0,0,7,7,9,14,23,34,22,56,0.000333,0.08444,4,1013.277878,56.293215,253.31947,81.832294,2,4
0,0,8,8,9,17,26,41,29,70,0.000333,0.109677,4,1316.123121,73.117951,329.03078,98.016193,2,4
0,0,8,8,9,16,25,41,28,69,0.000333,0.106809,4,1281.704308,71.205795,320.426077,92.529325,2,4
0,0,7,7,9,14,23,34,22,56,0.000333,0.08444,4,1013.277878,56.293215,253.31947,81.832294,2,4
0,0,7,7,9,11,20,30,19,49,0.000333,0.070591,4,847.097907,47.060995,211.774477,66.583073,2,4
0,0,6,6,9,15,24,29,22,51,0.000333,0.077944,4,935.33235,51.962908,233.833088,87.132684,2,4
0,0,6,6,9,14,23,29,21,50,0.000333,0.075393,4,904.712391,50.2618,226.178098,81.832294,2,4
0,0,7,7,9,14,23,34,22,56,0.000333,0.08444,4,1013.277878,56.293215,253.31947,81.832294,2,4
0,0,6,6,11,12,23,31,19,50,0.000333,0.075393,5,1130.890489,62.827249,226.178098,81.073298,2,4
0,0,7,7,11,17,28,35,26,61,0.000333,0.09775,5,1466.243251,81.457958,293.24865,107.540616,2,4
0,0,7,7,11,16,27,35,25,60,0.000333,0.095098,5,1426.466251,79.248125,285.29325,102.053748,2,4
0,0,7,7,9,14,23,34,22,56,0.000333,0.08444,4,1013.277878,56.293215,253.31947,81.832294,2,4
0,0,7,7,9,11,20,30,19,49,0.000333,0.070591,4,847.097907,47.060995,211.774477,66.583073,2,4
0,0,7,7,10,18,28,32,28,60,0.000333,0.096147,5,1442.206477,80.122582,288.441295,108.277931,2,4
0,0,7,7,10,17,27,32,27,59,0.000333,0.093513,5,1402.691813,77.927323,280.538363,102.706149,2,4
0,0,7,7,9,11,20,30,19,49,0.000333,0.070591,4,847.097907,47.060995,211.774477,66.583073,2,4
0,0,5,5,9,14,23,25,19,44,0.000333,0.066346,4,796.146904,44.230384,199.036726,81.832294,1,4
0,0,7,7,9,11,20,30,19,49,0.000333,0.070591,4,847.097907,47.060995,211.774477,66.583073,2,4
0,0,5,5,8,14,22,24,19,43,0.000333,0.063919,4,767.022238,42.612347,191.75556,77.302969,1,4
0,0,7,7,9,11,20,30,19,49,0.000333,0.070591,4,847.097907,47.060995,211.774477,66.583073,2,4
0,0,7,7,9,14,23,34,22,56,0.000333,0.08444,4,1013.277878,56.293215,253.31947,81.832294,2,4
0,0,9,9,12,16,28,47,30,77,0.000333,0.123389,6,2220.997974,123.388776,370.166329,107.01955,3,4
0,0,6,6,9,10,19,29,17,46,0.000333,0.065135,4,781.618662,43.423259,195.404666,61.748606,2,4
0,0,7,7,9,11,20,30,19,49,0.000333,0.070591,4,847.097907,47.060995,211.774477,66.583073,2,4
0,0,7,7,9,11,20,30,19,49,0.000333,0.070591,4,847.097907,47.060995,211.774477,66.583073,2,4
0,0,7,7,9,14,23,34,22,56,0.000333,0.08444,4,1013.277878,56.293215,253.31947,81.832294,2,4
0,0,9,9,12,16,28,47,30,77,0.000333,0.123389,6,2220.997974,123.388776,370.166329,107.01955,3,4
0,0,7,7,9,11,20,31,19,50,0.000333,0.072032,4,864.385619,48.021423,216.096405,66.583073,2,4
0,0,7,7,9,11,20,31,19,50,0.000333,0.072032,4,864.385619,48.021423,216.096405,66.583073,2,4
0,0,7,7,9,11,20,30,19,49,0.000333,0.070591,4,847.097907,47.060995,211.774477,66.583073,2,4
0,0,7,7,9,11,20,30,19,49,0.000333,0.070591,4,847.097907,47.060995,211.774477,66.583073,2,4
0,0,7,7,9,14,23,34,22,56,0.000333,0.08444,4,1013.277878,56.293215,253.31947,81.832294,2,4
0,0,9,9,12,16,28,47,30,77,0.000333,0.123389,6,2220.997974,123.388776,370.166329,107.01955,3,4
0,0,7,7,9,11,20,31,19,50,0.000333,0.072032,4,864.385619,48.021423,216.096405,66.583073,2,4
0,0,7,7,9,11,20,31,19,50,0.000333,0.072032,4,864.385619,48.021423,216.096405,66.583073,2,4
0,0,7,7,9,14,23,34,22,56,0.000333,0.08444,4,1013.277878,56.293215,253.31947,81.832294,2,4
0,0,7,7,9,11,20,30,19,49,0.000333,0.070591,4,847.097907,47.060995,211.774477,66.583073,2,4
0,0,7,7,9,11,20,30,19,49,0.000333,0.070591,4,847.097907,47.060995,211.774477,66.583073,2,4
0,0,9,9,12,16,28,47,30,77,0.000333,0.123389,6,2220.997974,123.388776,370.166329,107.01955,3,4
0,0,7,7,9,11,20,31,19,50,0.000333,0.072032,4,864.385619,48.021423,216.096405,66.583073,2,4
0,0,7,7,9,11,20,31,19,50,0.000333,0.072032,4,864.385619,48.021423,216.096405,66.583073,2,4
0,0,7,7,9,14,23,34,22,56,0.000333,0.08444,4,1013.277878,56.293215,253.31947,81.832294,2,4
0,0,7,7,9,11,20,30,19,49,0.000333,0.070591,4,847.097907,47.060995,211.774477,66.583073,2,4
0,0,7,7,9,11,20,30,19,49,0.000333,0.070591,4,847.097907,47.060995,211.774477,66.583073,2,4
0,0,9,9,12,16,28,47,30,77,0.000333,0.123389,6,2220.997974,123.388776,370.166329,107.01955,3,4
0,0,7,7,9,11,20,31,19,50,0.000333,0.072032,4,864.385619,48.021423,216.096405,66.583073,2,4
0,0,7,7,9,11,20,31,19,50,0.000333,0.072032,4,864.385619,48.021423,216.096405,66.583073,2,4
0,0,7,7,9,11,20,30,19,49,0.000333,0.070591,4,847.097907,47.060995,211.774477,66.583073,2,4
0,0,7,7,9,11,20,30,19,49,0.000333,0.070591,4,847.097907,47.060995,211.774477,66.583073,2,4
0,0,7,7,9,14,23,34,22,56,0.000333,0.08444,4,1013.277878,56.293215,253.31947,81.832294,2,4
0,0,7,7,9,11,20,31,19,50,0.000333,0.072032,4,864.385619,48.021423,216.096405,66.583073,2,4
0,0,9,9,12,16,28,47,30,77,0.000333,0.123389,6,2220.997974,123.388776,370.166329,107.01955,3,4
0,0,7,7,9,11,20,31,19,50,0.000333,0.072032,4,864.385619,48.021423,216.096405,66.583073,2,4
0,0,7,7,9,11,20,30,19,49,0.000333,0.070591,4,847.097907,47.060995,211.774477,66.583073,2,4
0,0,7,7,9,11,20,30,19,49,0.000333,0.070591,4,847.097907,47.060995,211.774477,66.583073,2,4
0,0,7,7,9,14,23,34,22,56,0.000333,0.08444,4,1013.277878,56.293215,253.31947,81.832294,2,4
0,0,7,7,9,11,20,31,19,50,0.000333,0.072032,4,864.385619,48.021423,216.096405,66.583073,2,4
0,0,9,9,12,16,28,47,30,77,0.000333,0.123389,6,2220.997974,123.388776,370.166329,107.01955,3,4
0,0,7,7,9,11,20,31,19,50,0.000333,0.072032,4,864.385619,48.021423,216.096405,66.583073,2,4
0,0,7,7,9,11,20,30,19,49,0.000333,0.070591,4,847.097907,47.060995,211.774477,66.583073,2,4
0,0,7,7,9,11,20,30,19,49,0.000333,0.070591,4,847.097907,47.060995,211.774477,66.583073,2,4
0,0,7,7,9,14,23,34,22,56,0.000333,0.08444,4,1013.277878,56.293215,253.31947,81.832294,2,4
0,0,7,7,9,11,20,31,19,50,0.000333,0.072032,4,864.385619,48.021423,216.096405,66.583073,2,4
0,0,9,9,12,16,28,47,30,77,0.000333,0.123389,6,2220.997974,123.388776,370.166329,107.01955,3,4
0,0,7,7,9,11,20,31,19,50,0.000333,0.072032,4,864.385619,48.021423,216.096405,66.583073,2,4
0,0,7,7,9,11,20,30,19,49,0.000333,0.070591,4,847.097907,47.060995,211.774477,66.583073,2,4
0,0,7,7,9,11,20,30,19,49,0.000333,0.070591,4,847.097907,47.060995,211.774477,66.583073,2,4
0,0,7,7,9,14,23,34,22,56,0.000333,0.08444,4,1013.277878,56.293215,253.31947,81.832294,2,4
0,0,9,9,12,16,28,47,30,77,0.000333,0.123389,6,2220.997974,123.388776,370.166329,107.01955,3,4
0,0,7,7,9,11,20,31,19,50,0.000333,0.072032,4,864.385619,48.021423,216.096405,66.583073,2,4
0,0,7,7,9,11,20,31,19,50,0.000333,0.072032,4,864.385619,48.021423,216.096405,66.583073,2,4
0,0,7,7,9,11,20,30,19,49,0.000333,0.070591,4,847.097907,47.060995,211.774477,66.583073,2,4
0,0,7,7,9,11,20,30,19,49,0.000333,0.070591,4,847.097907,47.060995,211.774477,66.583073,2,4
0,0,7,7,9,14,23,34,22,56,0.000333,0.08444,4,1013.277878,56.293215,253.31947,81.832294,2,4
0,0,9,9,12,16,28,47,30,77,0.000333,0.123389,6,2220.997974,123.388776,370.166329,107.01955,3,4
0,0,7,7,9,11,20,31,19,50,0.000333,0.072032,4,864.385619,48.021423,216.096405,66.583073,2,4
0,0,7,7,9,11,20,31,19,50,0.000333,0.072032,4,864.385619,48.021423,216.096405,66.583073,2,4
0,0,7,7,9,11,20,30,19,49,0.000333,0.070591,4,847.097907,47.060995,211.774477,66.583073,2,4
0,0,7,7,9,11,20,30,19,49,0.000333,0.070591,4,847.097907,47.060995,211.774477,66.583073,2,4
0,0,7,7,9,14,23,34,22,56,0.000333,0.08444,4,1013.277878,56.293215,253.31947,81.832294,2,4
0,0,9,9,12,16,28,47,30,77,0.000333,0.123389,6,2220.997974,123.388776,370.166329,107.01955,3,4
0,0,7,7,9,11,20,31,19,50,0.000333,0.072032,4,864.385619,48.021423,216.096405,66.583073,2,4
0,0,7,7,9,11,20,31,19,50,0.000333,0.072032,4,864.385619,48.021423,216.096405,66.583073,2,4
0,0,7,7,9,14,23,34,22,56,0.000333,0.08444,4,1013.277878,56.293215,253.31947,81.832294,2,4
0,0,7,7,9,11,20,30,19,49,0.000333,0.070591,4,847.097907,47.060995,211.774477,66.583073,2,4
0,0,7,7,9,11,20,30,19,49,0.000333,0.070591,4,847.097907,47.060995,211.774477,66.583073,2,4
0,0,7,7,9,10,19,31,19,50,0.000333,0.070799,4,849.585503,47.199195,212.396376,61.748606,2,4
0,0,7,7,9,10,19,31,19,50,0.000333,0.070799,4,849.585503,47.199195,212.396376,61.748606,2,4
0,0,10,10,12,17,29,49,32,81,0.000333,0.131165,6,2360.978764,131.165487,393.496461,112.506418,3,4
0,0,7,7,9,11,20,30,19,49,0.000333,0.070591,4,847.097907,47.060995,211.774477,66.583073,2,4
0,0,7,7,9,11,20,30,19,49,0.000333,0.070591,4,847.097907,47.060995,211.774477,66.583073,2,4
0,0,7,7,9,14,23,34,22,56,0.000333,0.08444,4,1013.277878,56.293215,253.31947,81.832294,2,4
0,0,9,9,12,16,28,47,30,77,0.000333,0.123389,6,2220.997974,123.388776,370.166329,107.01955,3,4
0,0,7,7,9,11,20,31,19,50,0.000333,0.072032,4,864.385619,48.021423,216.096405,66.583073,2,4
0,0,7,7,9,11,20,31,19,50,0.000333,0.072032,4,864.385619,48.021423,216.096405,66.583073,2,4
0,0,7,7,9,11,20,30,19,49,0.000333,0.070591,4,847.097907,47.060995,211.774477,66.583073,2,4
0,0,7,7,9,11,20,30,19,49,0.000333,0.070591,4,847.097907,47.060995,211.774477,66.583073,2,4
0,0,7,7,9,14,23,34,22,56,0.000333,0.08444,4,1013.277878,56.293215,253.31947,81.832294,2,4
0,0,9,9,12,16,28,47,30,77,0.000333,0.123389,6,2220.997974,123.388776,370.166329,107.01955,3,4
0,0,7,7,9,11,20,31,19,50,0.000333,0.072032,4,864.385619,48.021423,216.096405,66.583073,2,4
0,0,7,7,9,11,20,31,19,50,0.000333,0.072032,4,864.385619,48.021423,216.096405,66.583073,2,4
0,0,7,7,9,11,20,30,19,49,0.000333,0.070591,4,847.097907,47.060995,211.774477,66.583073,2,4
0,0,7,7,9,14,23,34,22,56,0.000333,0.08444,4,1013.277878,56.293215,253.31947,81.832294,2,4
0,0,7,7,9,11,20,30,19,49,0.000333,0.070591,4,847.097907,47.060995,211.774477,66.583073,2,4
0,0,7,7,9,11,20,31,19,50,0.000333,0.072032,4,864.385619,48.021423,216.096405,66.583073,2,4
0,0,7,7,9,11,20,31,19,50,0.000333,0.072032,4,864.385619,48.021423,216.096405,66.583073,2,4
0,0,9,9,12,16,28,47,30,77,0.000333,0.123389,6,2220.997974,123.388776,370.166329,107.01955,3,4
0,0,7,7,9,14,23,34,22,56,0.000333,0.08444,4,1013.277878,56.293215,253.31947,81.832294,2,4
0,0,7,7,9,11,20,30,19,49,0.000333,0.070591,4,847.097907,47.060995,211.774477,66.583073,2,4
0,0,9,9,12,16,28,47,30,77,0.000333,0.123389,6,2220.997974,123.388776,370.166329,107.01955,3,4
0,0,9,9,12,16,28,47,30,77,0.000333,0.123389,6,2220.997974,123.388776,370.166329,107.01955,3,4
0,0,7,7,9,14,23,34,22,56,0.000333,0.08444,4,1013.277878,56.293215,253.31947,81.832294,2,4
0,0,7,7,9,11,20,30,19,49,0.000333,0.070591,4,847.097907,47.060995,211.774477,66.583073,2,4
0,0,9,9,12,16,28,47,30,77,0.000333,0.123389,6,2220.997974,123.388776,370.166329,107.01955,3,4
0,0,9,9,12,16,28,47,30,77,0.000333,0.123389,6,2220.997974,123.388776,370.166329,107.01955,3,4
0,0,7,7,9,11,20,30,19,49,0.000333,0.070591,4,847.097907,47.060995,211.774477,66.583073,2,4
0,0,7,7,9,14,23,34,22,56,0.000333,0.08444,4,1013.277878,56.293215,253.31947,81.832294,2,4
0,0,9,9,12,16,28,47,30,77,0.000333,0.123389,6,2220.997974,123.388776,370.166329,107.01955,3,4
0,0,9,9,12,16,28,47,30,77,0.000333,0.123389,6,2220.997974,123.388776,370.166329,107.01955,3,4
0,0,7,7,9,11,20,30,19,49,0.000333,0.070591,4,847.097907,47.060995,211.774477,66.583073,2,4
0,0,7,7,9,14,23,34,22,56,0.000333,0.08444,4,1013.277878,56.293215,253.31947,81.832294,2,4
0,0,8,8,10,14,24,35,25,60,0.000333,0.091699,5,1375.48875,76.416042,275.09775,86.52225,2,4
0,0,11,11,13,19,32,53,36,89,0.000333,0.148333,6,2670,148.333333,445,128.816339,3,4
0,0,7,7,9,11,20,30,19,49,0.000333,0.070591,4,847.097907,47.060995,211.774477,66.583073,2,4
0,0,7,7,9,14,23,34,22,56,0.000333,0.08444,4,1013.277878,56.293215,253.31947,81.832294,2,4
0,0,8,8,9,16,25,34,29,63,0.000333,0.097521,4,1170.25176,65.013987,292.56294,92.529325,2,4
0,0,6,6,9,14,23,29,21,50,0.000333,0.075393,4,904.712391,50.2618,226.178098,81.832294,2,4
0,0,7,7,9,14,23,34,22,56,0.000333,0.08444,4,1013.277878,56.293215,253.31947,81.832294,2,4
0,0,7,7,9,11,20,30,19,49,0.000333,0.070591,4,847.097907,47.060995,211.774477,66.583073,2,4
0,0,11,11,12,18,30,51,36,87,0.000333,0.1423,12,5122.793782,284.599655,426.899482,118.0782,3,4
0,0,8,8,9,12,21,33,23,56,0.000333,0.08199,4,983.879103,54.65995,245.969776,71.548875,2,4
0,0,7,7,9,11,20,30,19,49,0.000333,0.070591,4,847.097907,47.060995,211.774477,66.583073,2,4
0,0,7,7,9,14,23,34,22,56,0.000333,0.08444,4,1013.277878,56.293215,253.31947,81.832294,2,4
0,0,7,7,10,11,21,34,21,55,0.000333,0.080526,5,1207.887291,67.10485,241.577458,71.273029,2,4
0,0,7,7,10,11,21,34,21,55,0.000333,0.080526,5,1207.887291,67.10485,241.577458,71.273029,2,4
0,0,7,7,9,11,20,30,19,49,0.000333,0.070591,4,847.097907,47.060995,211.774477,66.583073,2,4
0,0,7,7,9,14,23,34,22,56,0.000333,0.08444,4,1013.277878,56.293215,253.31947,81.832294,2,4
0,0,7,7,10,15,25,31,23,54,0.000333,0.083589,5,1253.841171,69.657843,250.768234,91.82264,2,4
0,0,7,7,10,15,25,31,23,54,0.000333,0.083589,5,1253.841171,69.657843,250.768234,91.82264,2,4
0,0,7,7,9,11,20,30,19,49,0.000333,0.070591,4,847.097907,47.060995,211.774477,66.583073,2,4
0,0,7,7,9,14,23,34,22,56,0.000333,0.08444,4,1013.277878,56.293215,253.31947,81.832294,2,4
0,0,8,8,10,14,24,35,25,60,0.000333,0.091699,5,1375.48875,76.416042,275.09775,86.52225,2,4
0,0,11,11,13,19,32,53,36,89,0.000333,0.148333,6,2670,148.333333,445,128.816339,3,4
0,0,7,7,9,14,23,34,22,56,0.000333,0.08444,4,1013.277878,56.293215,253.31947,81.832294,2,4
0,0,7,7,9,11,20,30,19,49,0.000333,0.070591,4,847.097907,47.060995,211.774477,66.583073,2,4
0,0,19,19,14,18,32,91,59,150,0.000333,0.25,21,15750,875,750,128.361619,4,4
0,0,8,8,10,12,22,35,22,57,0.000333,0.084729,5,1270.938011,70.607667,254.187602,76.238831,2,4
0,0,7,7,9,11,20,30,19,49,0.000333,0.070591,4,847.097907,47.060995,211.774477,66.583073,2,4
0,0,7,7,9,14,23,34,22,56,0.000333,0.08444,4,1013.277878,56.293215,253.31947,81.832294,2,4
0,0,6,6,10,13,23,30,20,50,0.000333,0.075393,5,1130.890489,62.827249,226.178098,81.324997,2,4
0,0,6,6,10,12,22,30,19,49,0.000333,0.072837,5,1092.560747,60.697819,218.512149,76.238831,2,4
0,0,7,7,9,11,20,30,19,49,0.000333,0.070591,4,847.097907,47.060995,211.774477,66.583073,2,4
0,0,7,7,9,14,23,34,22,56,0.000333,0.08444,4,1013.277878,56.293215,253.31947,81.832294,2,4
0,0,12,12,12,21,33,52,40,92,0.000333,0.154695,6,2784.505554,154.694753,464.084259,135.258216,3,4
0,0,9,9,9,17,26,34,30,64,0.000333,0.100276,4,1203.312568,66.850698,300.828142,98.016193,2,4
0,0,7,7,9,14,23,34,22,56,0.000333,0.08444,4,1013.277878,56.293215,253.31947,81.832294,2,4
0,0,7,7,9,11,20,30,19,49,0.000333,0.070591,4,847.097907,47.060995,211.774477,66.583073,2,4
0,0,6,6,9,15,24,29,22,51,0.000333,0.077944,4,935.33235,51.962908,233.833088,87.132684,2,4
0,0,6,6,9,14,23,29,21,50,0.000333,0.075393,4,904.712391,50.2618,226.178098,81.832294,2,4
0,0,7,7,9,14,23,34,22,56,0.000333,0.08444,4,1013.277878,56.293215,253.31947,81.832294,2,4
0,0,7,7,9,11,20,30,19,49,0.000333,0.070591,4,847.097907,47.060995,211.774477,66.583073,2,4
0,0,6,6,9,15,24,29,22,51,0.000333,0.077944,4,935.33235,51.962908,233.833088,87.132684,2,4
0,0,6,6,9,14,23,29,21,50,0.000333,0.075393,4,904.712391,50.2618,226.178098,81.832294,2,4
0,0,7,7,9,14,23,34,22,56,0.000333,0.08444,4,1013.277878,56.293215,253.31947,81.832294,2,4
0,0,7,7,9,11,20,30,19,49,0.000333,0.070591,4,847.097907,47.060995,211.774477,66.583073,2,4
0,0,6,6,9,15,24,29,22,51,0.000333,0.077944,4,935.33235,51.962908,233.833088,87.132684,2,4
0,0,6,6,9,14,23,29,21,50,0.000333,0.075393,4,904.712391,50.2618,226.178098,81.832294,2,4
0,0,7,7,9,14,23,34,22,56,0.000333,0.08444,4,1013.277878,56.293215,253.31947,81.832294,2,4
0,0,7,7,9,11,20,30,19,49,0.000333,0.070591,4,847.097907,47.060995,211.774477,66.583073,2,4
0,0,6,6,9,15,24,29,22,51,0.000333,0.077944,4,935.33235,51.962908,233.833088,87.132684,2,4
0,0,6,6,9,14,23,29,21,50,0.000333,0.075393,4,904.712391,50.2618,226.178098,81.832294,2,4
0,0,7,7,9,14,23,34,22,56,0.000333,0.08444,4,1013.277878,56.293215,253.31947,81.832294,2,4
0,0,7,7,9,11,20,30,19,49,0.000333,0.070591,4,847.097907,47.060995,211.774477,66.583073,2,4
0,0,6,6,9,13,22,31,21,52,0.000333,0.077297,4,927.561777,51.53121,231.890444,76.635041,2,4
0,0,6,6,9,12,21,31,20,51,0.000333,0.074669,4,896.032754,49.779597,224.008189,71.548875,2,4
0,0,7,7,9,14,23,34,22,56,0.000333,0.08444,4,1013.277878,56.293215,253.31947,81.832294,2,4
0,0,7,7,9,11,20,30,19,49,0.000333,0.070591,4,847.097907,47.060995,211.774477,66.583073,2,4
0,0,7,7,9,15,24,33,24,57,0.000333,0.087114,4,1045.37145,58.076192,261.342863,87.132684,2,4
0,0,7,7,9,16,25,33,25,58,0.000333,0.089781,4,1077.374636,59.854146,269.343659,92.529325,2,4
0,0,7,7,9,14,23,34,22,56,0.000333,0.08444,4,1013.277878,56.293215,253.31947,81.832294,2,4
0,0,7,7,9,11,20,30,19,49,0.000333,0.070591,4,847.097907,47.060995,211.774477,66.583073,2,4
0,0,8,8,9,16,25,41,28,69,0.000333,0.106809,4,1281.704308,71.205795,320.426077,92.529325,2,4
0,0,8,8,9,17,26,41,29,70,0.000333,0.109677,4,1316.123121,73.117951,329.03078,98.016193,2,4
0,0,7,7,9,14,23,34,22,56,0.000333,0.08444,4,1013.277878,56.293215,253.31947,81.832294,2,4
0,0,7,7,9,11,20,30,19,49,0.000333,0.070591,4,847.097907,47.060995,211.774477,66.583073,2,4
0,0,6,6,9,15,24,29,22,51,0.000333,0.077944,4,935.33235,51.962908,233.833088,87.132684,2,4
0,0,6,6,9,14,23,29,21,50,0.000333,0.075393,4,904.712391,50.2618,226.178098,81.832294,2,4
0,0,6,6,11,12,23,31,19,50,0.000333,0.075393,5,1130.890489,62.827249,226.178098,81.073298,2,4
0,0,6,6,11,12,23,31,19,50,0.000333,0.075393,5,1130.890489,62.827249,226.178098,81.073298,2,4
0,0,7,7,11,16,27,35,25,60,0.000333,0.095098,5,1426.466251,79.248125,285.29325,102.053748,2,4
0,0,7,7,11,17,28,35,26,61,0.000333,0.09775,5,1466.243251,81.457958,293.24865,107.540616,2,4
0,0,7,7,9,14,23,34,22,56,0.000333,0.08444,4,1013.277878,56.293215,253.31947,81.832294,2,4
0,0,7,7,9,11,20,30,19,49,0.000333,0.070591,4,847.097907,47.060995,211.774477,66.583073,2,4
0,0,7,7,10,17,27,32,27,59,0.000333,0.093513,5,1402.691813,77.927323,280.538363,102.706149,2,4
0,0,7,7,10,18,28,32,28,60,0.000333,0.096147,5,1442.206477,80.122582,288.441295,108.277931,2,4
0,0,7,7,9,11,20,30,19,49,0.000333,0.070591,4,847.097907,47.060995,211.774477,66.583073,2,4
0,0,6,6,11,15,26,31,22,53,0.000333,0.083041,5,1245.616525,69.200918,249.123305,96.657107,2,4
0,0,7,7,9,11,20,30,19,49,0.000333,0.070591,4,847.097907,47.060995,211.774477,66.583073,2,4
0,0,6,6,10,15,25,30,22,52,0.000333,0.080494,5,1207.402609,67.077923,241.480522,91.82264,2,4
0,0,7,7,9,14,23,34,22,56,0.000333,0.08444,4,1013.277878,56.293215,253.31947,81.832294,2,4
0,0,7,7,9,11,20,30,19,49,0.000333,0.070591,4,847.097907,47.060995,211.774477,66.583073,2,4
0,0,7,7,11,12,23,36,20,56,0.000333,0.08444,5,1266.597348,70.366519,253.31947,81.073298,2,4
0,0,6,6,9,10,19,29,17,46,0.000333,0.065135,4,781.618662,43.423259,195.404666,61.748606,2,4
0,0,7,7,9,11,20,30,19,49,0.000333,0.070591,4,847.097907,47.060995,211.774477,66.583073,2,4
0,0,7,7,9,11,20,30,19,49,0.000333,0.070591,4,847.097907,47.060995,211.774477,66.583073,2,4
0,0,7,7,9,14,23,34,22,56,0.000333,0.08444,4,1013.277878,56.293215,253.31947,81.832294,2,4
0,0,7,7,9,11,20,31,19,50,0.000333,0.072032,4,864.385619,48.021423,216.096405,66.583073,2,4
0,0,7,7,11,12,23,36,20,56,0.000333,0.08444,5,1266.597348,70.366519,253.31947,81.073298,2,4
0,0,7,7,9,11,20,31,19,50,0.000333,0.072032,4,864.385619,48.021423,216.096405,66.583073,2,4
0,0,7,7,9,11,20,30,19,49,0.000333,0.070591,4,847.097907,47.060995,211.774477,66.583073,2,4
0,0,7,7,9,11,20,30,19,49,0.000333,0.070591,4,847.097907,47.060995,211.774477,66.583073,2,4
0,0,7,7,9,14,23,34,22,56,0.000333,0.08444,4,1013.277878,56.293215,253.31947,81.832294,2,4
0,0,7,7,9,11,20,31,19,50,0.000333,0.072032,4,864.385619,48.021423,216.096405,66.583073,2,4
0,0,7,7,11,12,23,36,20,56,0.000333,0.08444,5,1266.597348,70.366519,253.31947,81.073298,2,4
0,0,7,7,9,11,20,31,19,50,0.000333,0.072032,4,864.385619,48.021423,216.096405,66.583073,2,4
0,0,7,7,9,14,23,34,22,56,0.000333,0.08444,4,1013.277878,56.293215,253.31947,81.832294,2,4
0,0,7,7,9,11,20,30,19,49,0.000333,0.070591,4,847.097907,47.060995,211.774477,66.583073,2,4
0,0,7,7,9,11,20,30,19,49,0.000333,0.070591,4,847.097907,47.060995,211.774477,66.583073,2,4
0,0,7,7,11,12,23,36,20,56,0.000333,0.08444,5,1266.597348,70.366519,253.31947,81.073298,2,4
0,0,7,7,9,11,20,31,19,50,0.000333,0.072032,4,864.385619,48.021423,216.096405,66.583073,2,4
0,0,7,7,9,11,20,31,19,50,0.000333,0.072032,4,864.385619,48.021423,216.096405,66.583073,2,4
0,0,7,7,9,14,23,34,22,56,0.000333,0.08444,4,1013.277878,56.293215,253.31947,81.832294,2,4
0,0,7,7,9,11,20,30,19,49,0.000333,0.070591,4,847.097907,47.060995,211.774477,66.583073,2,4
0,0,7,7,9,11,20,30,19,49,0.000333,0.070591,4,847.097907,47.060995,211.774477,66.583073,2,4
0,0,7,7,11,12,23,36,20,56,0.000333,0.08444,5,1266.597348,70.366519,253.31947,81.073298,2,4
0,0,7,7,9,11,20,31,19,50,0.000333,0.072032,4,864.385619,48.021423,216.096405,66.583073,2,4
0,0,7,7,9,11,20,31,19,50,0.000333,0.072032,4,864.385619,48.021423,216.096405,66.583073,2,4
0,0,7,7,9,11,20,30,19,49,0.000333,0.070591,4,847.097907,47.060995,211.774477,66.583073,2,4
0,0,7,7,9,11,20,30,19,49,0.000333,0.070591,4,847.097907,47.060995,211.774477,66.583073,2,4
0,0,7,7,9,14,23,34,22,56,0.000333,0.08444,4,1013.277878,56.293215,253.31947,81.832294,2,4
0,0,7,7,9,11,20,31,19,50,0.000333,0.072032,4,864.385619,48.021423,216.096405,66.583073,2,4
0,0,7,7,11,12,23,36,20,56,0.000333,0.08444,5,1266.597348,70.366519,253.31947,81.073298,2,4
0,0,7,7,9,11,20,31,19,50,0.000333,0.072032,4,864.385619,48.021423,216.096405,66.583073,2,4
0,0,7,7,9,11,20,30,19,49,0.000333,0.070591,4,847.097907,47.060995,211.774477,66.583073,2,4
0,0,7,7,9,11,20,30,19,49,0.000333,0.070591,4,847.097907,47.060995,211.774477,66.583073,2,4
0,0,7,7,9,14,23,34,22,56,0.000333,0.08444,4,1013.277878,56.293215,253.31947,81.832294,2,4
0,0,7,7,9,11,20,31,19,50,0.000333,0.072032,4,864.385619,48.021423,216.096405,66.583073,2,4
0,0,7,7,11,12,23,36,20,56,0.000333,0.08444,5,1266.597348,70.366519,253.31947,81.073298,2,4
0,0,7,7,9,11,20,31,19,50,0.000333,0.072032,4,864.385619,48.021423,216.096405,66.583073,2,4
0,0,7,7,9,11,20,30,19,49,0.000333,0.070591,4,847.097907,47.060995,211.774477,66.583073,2,4
0,0,7,7,9,11,20,30,19,49,0.000333,0.070591,4,847.097907,47.060995,211.774477,66.583073,2,4
0,0,7,7,9,14,23,34,22,56,0.000333,0.08444,4,1013.277878,56.293215,253.31947,81.832294,2,4
0,0,7,7,9,11,20,31,19,50,0.000333,0.072032,4,864.385619,48.021423,216.096405,66.583073,2,4
0,0,7,7,11,12,23,36,20,56,0.000333,0.08444,5,1266.597348,70.366519,253.31947,81.073298,2,4
0,0,7,7,9,11,20,31,19,50,0.000333,0.072032,4,864.385619,48.021423,216.096405,66.583073,2,4
0,0,7,7,9,11,20,30,19,49,0.000333,0.070591,4,847.097907,47.060995,211.774477,66.583073,2,4
0,0,7,7,9,11,20,30,19,49,0.000333,0.070591,4,847.097907,47.060995,211.774477,66.583073,2,4
0,0,7,7,9,14,23,34,22,56,0.000333,0.08444,4,1013.277878,56.293215,253.31947,81.832294,2,4
0,0,7,7,9,11,20,31,19,50,0.000333,0.072032,4,864.385619,48.021423,216.096405,66.583073,2,4
0,0,7,7,11,12,23,36,20,56,0.000333,0.08444,5,1266.597348,70.366519,253.31947,81.073298,2,4
0,0,7,7,9,11,20,31,19,50,0.000333,0.072032,4,864.385619,48.021423,216.096405,66.583073,2,4
0,0,7,7,9,11,20,30,19,49,0.000333,0.070591,4,847.097907,47.060995,211.774477,66.583073,2,4
0,0,7,7,9,11,20,30,19,49,0.000333,0.070591,4,847.097907,47.060995,211.774477,66.583073,2,4
0,0,7,7,9,14,23,34,22,56,0.000333,0.08444,4,1013.277878,56.293215,253.31947,81.832294,2,4
0,0,7,7,9,11,20,31,19,50,0.000333,0.072032,4,864.385619,48.021423,216.096405,66.583073,2,4
0,0,7,7,11,12,23,36,20,56,0.000333,0.08444,5,1266.597348,70.366519,253.31947,81.073298,2,4
0,0,7,7,9,11,20,31,19,50,0.000333,0.072032,4,864.385619,48.021423,216.096405,66.583073,2,4
0,0,7,7,9,11,20,30,19,49,0.000333,0.070591,4,847.097907,47.060995,211.774477,66.583073,2,4
0,0,7,7,9,11,20,30,19,49,0.000333,0.070591,4,847.097907,47.060995,211.774477,66.583073,2,4
0,0,7,7,9,14,23,34,22,56,0.000333,0.08444,4,1013.277878,56.293215,253.31947,81.832294,2,4
0,0,7,7,9,11,20,31,19,50,0.000333,0.072032,4,864.385619,48.021423,216.096405,66.583073,2,4
0,0,7,7,11,12,23,36,20,56,0.000333,0.08444,5,1266.597348,70.366519,253.31947,81.073298,2,4
0,0,7,7,9,11,20,31,19,50,0.000333,0.072032,4,864.385619,48.021423,216.096405,66.583073,2,4
0,0,7,7,9,11,20,30,19,49,0.000333,0.070591,4,847.097907,47.060995,211.774477,66.583073,2,4
0,0,7,7,9,14,23,34,22,56,0.000333,0.08444,4,1013.277878,56.293215,253.31947,81.832294,2,4
0,0,7,7,9,11,20,30,19,49,0.000333,0.070591,4,847.097907,47.060995,211.774477,66.583073,2,4
0,0,8,8,11,13,24,38,22,60,0.000333,0.091699,5,1375.48875,76.416042,275.09775,86.159464,2,4
0,0,7,7,9,10,19,31,19,50,0.000333,0.070799,4,849.585503,47.199195,212.396376,61.748606,2,4
0,0,7,7,9,10,19,31,19,50,0.000333,0.070799,4,849.585503,47.199195,212.396376,61.748606,2,4
0,0,7,7,9,11,20,30,19,49,0.000333,0.070591,4,847.097907,47.060995,211.774477,66.583073,2,4
0,0,7,7,9,11,20,30,19,49,0.000333,0.070591,4,847.097907,47.060995,211.774477,66.583073,2,4
0,0,7,7,9,14,23,34,22,56,0.000333,0.08444,4,1013.277878,56.293215,253.31947,81.832294,2,4
0,0,7,7,9,11,20,31,19,50,0.000333,0.072032,4,864.385619,48.021423,216.096405,66.583073,2,4
0,0,7,7,11,12,23,36,20,56,0.000333,0.08444,5,1266.597348,70.366519,253.31947,81.073298,2,4
0,0,7,7,9,11,20,31,19,50,0.000333,0.072032,4,864.385619,48.021423,216.096405,66.583073,2,4
0,0,7,7,9,11,20,30,19,49,0.000333,0.070591,4,847.097907,47.060995,211.774477,66.583073,2,4
0,0,7,7,9,11,20,30,19,49,0.000333,0.070591,4,847.097907,47.060995,211.774477,66.583073,2,4
0,0,7,7,9,14,23,34,22,56,0.000333,0.08444,4,1013.277878,56.293215,253.31947,81.832294,2,4
0,0,7,7,9,11,20,31,19,50,0.000333,0.072032,4,864.385619,48.021423,216.096405,66.583073,2,4
0,0,7,7,11,12,23,36,20,56,0.000333,0.08444,5,1266.597348,70.366519,253.31947,81.073298,2,4
0,0,7,7,9,11,20,31,19,50,0.000333,0.072032,4,864.385619,48.021423,216.096405,66.583073,2,4
0,0,7,7,9,11,20,30,19,49,0.000333,0.070591,4,847.097907,47.060995,211.774477,66.583073,2,4
0,0,7,7,9,14,23,34,22,56,0.000333,0.08444,4,1013.277878,56.293215,253.31947,81.832294,2,4
0,0,7,7,9,11,20,30,19,49,0.000333,0.070591,4,847.097907,47.060995,211.774477,66.583073,2,4
0,0,7,7,9,11,20,31,19,50,0.000333,0.072032,4,864.385619,48.021423,216.096405,66.583073,2,4
0,0,7,7,9,11,20,31,19,50,0.000333,0.072032,4,864.385619,48.021423,216.096405,66.583073,2,4
0,0,7,7,11,12,23,36,20,56,0.000333,0.08444,5,1266.597348,70.366519,253.31947,81.073298,2,4
0,0,7,7,9,11,20,30,19,49,0.000333,0.070591,4,847.097907,47.060995,211.774477,66.583073,2,4
0,0,7,7,9,14,23,34,22,56,0.000333,0.08444,4,1013.277878,56.293215,253.31947,81.832294,2,4
0,0,7,7,11,12,23,36,20,56,0.000333,0.08444,5,1266.597348,70.366519,253.31947,81.073298,2,4
0,0,7,7,11,12,23,36,20,56,0.000333,0.08444,5,1266.597348,70.366519,253.31947,81.073298,2,4
0,0,7,7,9,14,23,34,22,56,0.000333,0.08444,4,1013.277878,56.293215,253.31947,81.832294,2,4
0,0,7,7,9,11,20,30,19,49,0.000333,0.070591,4,847.097907,47.060995,211.774477,66.583073,2,4
0,0,7,7,11,12,23,36,20,56,0.000333,0.08444,5,1266.597348,70.366519,253.31947,81.073298,2,4
0,0,7,7,11,12,23,36,20,56,0.000333,0.08444,5,1266.597348,70.366519,253.31947,81.073298,2,4
0,0,7,7,9,11,20,30,19,49,0.000333,0.070591,4,847.097907,47.060995,211.774477,66.583073,2,4
0,0,7,7,9,14,23,34,22,56,0.000333,0.08444,4,1013.277878,56.293215,253.31947,81.832294,2,4
0,0,7,7,11,12,23,36,20,56,0.000333,0.08444,5,1266.597348,70.366519,253.31947,81.073298,2,4
0,0,7,7,11,12,23,36,20,56,0.000333,0.08444,5,1266.597348,70.366519,253.31947,81.073298,2,4
0,0,7,7,9,14,23,34,22,56,0.000333,0.08444,4,1013.277878,56.293215,253.31947,81.832294,2,4
0,0,7,7,9,11,20,30,19,49,0.000333,0.070591,4,847.097907,47.060995,211.774477,66.583073,2,4
0,0,9,9,12,15,27,42,26,68,0.000333,0.107777,6,1939.994101,107.77745,323.33235,101.622909,2,4
0,0,8,8,10,14,24,35,25,60,0.000333,0.091699,5,1375.48875,76.416042,275.09775,86.52225,2,4
0,0,7,7,9,14,23,34,22,56,0.000333,0.08444,4,1013.277878,56.293215,253.31947,81.832294,2,4
0,0,7,7,9,11,20,30,19,49,0.000333,0.070591,4,847.097907,47.060995,211.774477,66.583073,2,4
0,0,8,8,9,16,25,34,29,63,0.000333,0.097521,4,1170.25176,65.013987,292.56294,92.529325,2,4
0,0,6,6,9,14,23,29,21,50,0.000333,0.075393,4,904.712391,50.2618,226.178098,81.832294,2,4
0,0,7,7,9,14,23,34,22,56,0.000333,0.08444,4,1013.277878,56.293215,253.31947,81.832294,2,4
0,0,7,7,9,11,20,30,19,49,0.000333,0.070591,4,847.097907,47.060995,211.774477,66.583073,2,4
0,0,9,9,11,14,25,40,26,66,0.000333,0.102165,5,1532.472543,85.137363,306.494509,91.356717,2,4
0,0,8,8,9,12,21,33,23,56,0.000333,0.08199,4,983.879103,54.65995,245.969776,71.548875,2,4
0,0,7,7,9,14,23,34,22,56,0.000333,0.08444,4,1013.277878,56.293215,253.31947,81.832294,2,4
0,0,7,7,9,11,20,30,19,49,0.000333,0.070591,4,847.097907,47.060995,211.774477,66.583073,2,4
0,0,7,7,10,11,21,34,21,55,0.000333,0.080526,5,1207.887291,67.10485,241.577458,71.273029,2,4
0,0,7,7,10,11,21,34,21,55,0.000333,0.080526,5,1207.887291,67.10485,241.577458,71.273029,2,4
0,0,7,7,9,11,20,30,19,49,0.000333,0.070591,4,847.097907,47.060995,211.774477,66.583073,2,4
0,0,7,7,9,14,23,34,22,56,0.000333,0.08444,4,1013.277878,56.293215,253.31947,81.832294,2,4
0,0,7,7,10,15,25,31,23,54,0.000333,0.083589,5,1253.841171,69.657843,250.768234,91.82264,2,4
0,0,7,7,10,15,25,31,23,54,0.000333,0.083589,5,1253.841171,69.657843,250.768234,91.82264,2,4
0,0,7,7,9,11,20,30,19,49,0.000333,0.070591,4,847.097907,47.060995,211.774477,66.583073,2,4
0,0,7,7,9,14,23,34,22,56,0.000333,0.08444,4,1013.277878,56.293215,253.31947,81.832294,2,4
0,0,9,9,12,15,27,42,26,68,0.000333,0.107777,6,1939.994101,107.77745,323.33235,101.622909,2,4
0,0,8,8,10,14,24,35,25,60,0.000333,0.091699,5,1375.48875,76.416042,275.09775,86.52225,2,4
0,0,7,7,9,11,20,30,19,49,0.000333,0.070591,4,847.097907,47.060995,211.774477,66.583073,2,4
0,0,7,7,9,14,23,34,22,56,0.000333,0.08444,4,1013.277878,56.293215,253.31947,81.832294,2,4
0,0,16,16,13,14,27,72,44,116,0.000333,0.183856,18,9928.205105,551.56695,551.56695,101.408685,2,4
0,0,8,8,10,12,22,35,22,57,0.000333,0.084729,5,1270.938011,70.607667,254.187602,76.238831,2,4
0,0,7,7,9,14,23,34,22,56,0.000333,0.08444,4,1013.277878,56.293215,253.31947,81.832294,2,4
0,0,7,7,9,11,20,30,19,49,0.000333,0.070591,4,847.097907,47.060995,211.774477,66.583073,2,4
0,0,6,6,10,12,22,30,19,49,0.000333,0.072837,5,1092.560747,60.697819,218.512149,76.238831,2,4
0,0,6,6,10,13,23,30,20,50,0.000333,0.075393,5,1130.890489,62.827249,226.178098,81.324997,2,4
0,0,7,7,9,14,23,34,22,56,0.000333,0.08444,4,1013.277878,56.293215,253.31947,81.832294,2,4
0,0,7,7,9,11,20,30,19,49,0.000333,0.070591,4,847.097907,47.060995,211.774477,66.583073,2,4
0,0,10,10,11,17,28,41,30,71,0.000333,0.113774,5,1706.610997,94.811722,341.322199,107.540616,2,4
0,0,9,9,9,17,26,34,30,64,0.000333,0.100276,4,1203.312568,66.850698,300.828142,98.016193,2,4
0,0,7,7,9,11,20,30,19,49,0.000333,0.070591,4,847.097907,47.060995,211.774477,66.583073,2,4
0,0,7,7,9,14,23,34,22,56,0.000333,0.08444,4,1013.277878,56.293215,253.31947,81.832294,2,4
0,0,6,6,9,15,24,29,22,51,0.000333,0.077944,4,935.33235,51.962908,233.833088,87.132684,2,4
0,0,6,6,9,14,23,29,21,50,0.000333,0.075393,4,904.712391,50.2618,226.178098,81.832294,2,4
0,0,7,7,9,14,23,34,22,56,0.000333,0.08444,4,1013.277878,56.293215,253.31947,81.832294,2,4
0,0,7,7,9,11,20,30,19,49,0.000333,0.070591,4,847.097907,47.060995,211.774477,66.583073,2,4
0,0,6,6,9,15,24,29,22,51,0.000333,0.077944,4,935.33235,51.962908,233.833088,87.132684,2,4
0,0,6,6,9,14,23,29,21,50,0.000333,0.075393,4,904.712391,50.2618,226.178098,81.832294,2,4
0,0,7,7,9,14,23,34,22,56,0.000333,0.08444,4,1013.277878,56.293215,253.31947,81.832294,2,4
0,0,7,7,9,11,20,30,19,49,0.000333,0.070591,4,847.097907,47.060995,211.774477,66.583073,2,4
0,0,6,6,9,14,23,29,21,50,0.000333,0.075393,4,904.712391,50.2618,226.178098,81.832294,2,4
0,0,6,6,9,15,24,29,22,51,0.000333,0.077944,4,935.33235,51.962908,233.833088,87.132684,2,4
0,0,7,7,9,14,23,34,22,56,0.000333,0.08444,4,1013.277878,56.293215,253.31947,81.832294,2,4
0,0,7,7,9,11,20,30,19,49,0.000333,0.070591,4,847.097907,47.060995,211.774477,66.583073,2,4
0,0,6,6,9,15,24,29,22,51,0.000333,0.077944,4,935.33235,51.962908,233.833088,87.132684,2,4
0,0,6,6,9,14,23,29,21,50,0.000333,0.075393,4,904.712391,50.2618,226.178098,81.832294,2,4
0,0,7,7,9,11,20,30,19,49,0.000333,0.070591,4,847.097907,47.060995,211.774477,66.583073,2,4
0,0,7,7,9,14,23,34,22,56,0.000333,0.08444,4,1013.277878,56.293215,253.31947,81.832294,2,4
0,0,6,6,9,13,22,31,21,52,0.000333,0.077297,4,927.561777,51.53121,231.890444,76.635041,2,4
0,0,6,6,9,12,21,31,20,51,0.000333,0.074669,4,896.032754,49.779597,224.008189,71.548875,2,4
0,0,7,7,9,14,23,34,22,56,0.000333,0.08444,4,1013.277878,56.293215,253.31947,81.832294,2,4
0,0,7,7,9,11,20,30,19,49,0.000333,0.070591,4,847.097907,47.060995,211.774477,66.583073,2,4
0,0,7,7,9,16,25,33,25,58,0.000333,0.089781,4,1077.374636,59.854146,269.343659,92.529325,2,4
0,0,7,7,9,15,24,33,24,57,0.000333,0.087114,4,1045.37145,58.076192,261.342863,87.132684,2,4
0,0,7,7,9,11,20,30,19,49,0.000333,0.070591,4,847.097907,47.060995,211.774477,66.583073,2,4
0,0,7,7,9,14,23,34,22,56,0.000333,0.08444,4,1013.277878,56.293215,253.31947,81.832294,2,4
0,0,8,8,9,17,26,41,29,70,0.000333,0.109677,4,1316.123121,73.117951,329.03078,98.016193,2,4
0,0,8,8,9,16,25,41,28,69,0.000333,0.106809,4,1281.704308,71.205795,320.426077,92.529325,2,4
0,0,7,7,9,14,23,34,22,56,0.000333,0.08444,4,1013.277878,56.293215,253.31947,81.832294,2,4
0,0,7,7,9,11,20,30,19,49,0.000333,0.070591,4,847.097907,47.060995,211.774477,66.583073,2,4
0,0,6,6,9,15,24,29,22,51,0.000333,0.077944,4,935.33235,51.962908,233.833088,87.132684,2,4
0,0,6,6,9,14,23,29,21,50,0.000333,0.075393,4,904.712391,50.2618,226.178098,81.832294,2,4
0,0,6,6,11,12,23,31,19,50,0.000333,0.075393,5,1130.890489,62.827249,226.178098,81.073298,2,4
0,0,6,6,11,12,23,31,19,50,0.000333,0.075393,5,1130.890489,62.827249,226.178098,81.073298,2,4
0,0,7,7,11,17,28,35,26,61,0.000333,0.09775,5,1466.243251,81.457958,293.24865,107.540616,2,4
0,0,7,7,11,16,27,35,25,60,0.000333,0.095098,5,1426.466251,79.248125,285.29325,102.053748,2,4
0,0,7,7,9,14,23,34,22,56,0.000333,0.08444,4,1013.277878,56.293215,253.31947,81.832294,2,4
0,0,7,7,9,11,20,30,19,49,0.000333,0.070591,4,847.097907,47.060995,211.774477,66.583073,2,4
0,0,7,7,10,18,28,32,28,60,0.000333,0.096147,5,1442.206477,80.122582,288.441295,108.277931,2,4
0,0,7,7,10,17,27,32,27,59,0.000333,0.093513,5,1402.691813,77.927323,280.538363,102.706149,2,4
0,0,7,7,9,11,20,30,19,49,0.000333,0.070591,4,847.097907,47.060995,211.774477,66.583073,2,4
0,0,7,7,9,14,23,34,22,56,0.000333,0.08444,4,1013.277878,56.293215,253.31947,81.832294,2,4
0,0,6,6,9,14,23,29,21,50,0.000333,0.075393,4,904.712391,50.2618,226.178098,81.832294,2,4
0,0,6,6,9,13,22,29,20,49,0.000333,0.072837,4,874.048597,48.558255,218.512149,76.635041,2,4
0,0,7,7,9,11,20,30,19,49,0.000333,0.070591,4,847.097907,47.060995,211.774477,66.583073,2,4
0,0,6,6,11,15,26,31,22,53,0.000333,0.083041,5,1245.616525,69.200918,249.123305,96.657107,2,4
0,0,7,7,9,11,20,30,19,49,0.000333,0.070591,4,847.097907,47.060995,211.774477,66.583073,2,4
0,0,6,6,10,16,26,30,23,53,0.000333,0.083041,5,1245.616525,69.200918,249.123305,97.219281,2,4
0,0,7,7,9,11,20,30,19,49,0.000333,0.070591,4,847.097907,47.060995,211.774477,66.583073,2,4
0,0,7,7,9,14,23,34,22,56,0.000333,0.08444,4,1013.277878,56.293215,253.31947,81.832294,2,4
0,0,6,6,9,10,19,29,17,46,0.000333,0.065135,4,781.618662,43.423259,195.404666,61.748606,2,4
0,0,9,9,12,18,30,48,32,80,0.000333,0.13085,6,2355.307486,130.850416,392.551248,118.0782,2,4
0,0,7,7,9,11,20,30,19,49,0.000333,0.070591,4,847.097907,47.060995,211.774477,66.583073,2,4
0,0,7,7,9,14,23,34,22,56,0.000333,0.08444,4,1013.277878,56.293215,253.31947,81.832294,2,4
0,0,7,7,9,11,20,30,19,49,0.000333,0.070591,4,847.097907,47.060995,211.774477,66.583073,2,4
0,0,7,7,9,11,20,31,19,50,0.000333,0.072032,4,864.385619,48.021423,216.096405,66.583073,2,4
0,0,7,7,9,11,20,31,19,50,0.000333,0.072032,4,864.385619,48.021423,216.096405,66.583073,2,4
0,0,8,8,11,14,25,39,24,63,0.000333,0.097521,5,1462.8147,81.267483,292.56294,91.356717,2,4
0,0,7,7,9,11,20,30,19,49,0.000333,0.070591,4,847.097907,47.060995,211.774477,66.583073,2,4
0,0,7,7,9,14,23,34,22,56,0.000333,0.08444,4,1013.277878,56.293215,253.31947,81.832294,2,4
0,0,7,7,9,11,20,30,19,49,0.000333,0.070591,4,847.097907,47.060995,211.774477,66.583073,2,4
0,0,7,7,9,11,20,31,19,50,0.000333,0.072032,4,864.385619,48.021423,216.096405,66.583073,2,4
0,0,7,7,9,11,20,31,19,50,0.000333,0.072032,4,864.385619,48.021423,216.096405,66.583073,2,4
0,0,8,8,11,14,25,39,24,63,0.000333,0.097521,5,1462.8147,81.267483,292.56294,91.356717,2,4
0,0,7,7,9,11,20,30,19,49,0.000333,0.070591,4,847.097907,47.060995,211.774477,66.583073,2,4
0,0,7,7,9,11,20,30,19,49,0.000333,0.070591,4,847.097907,47.060995,211.774477,66.583073,2,4
0,0,7,7,9,14,23,34,22,56,0.000333,0.08444,4,1013.277878,56.293215,253.31947,81.832294,2,4
0,0,7,7,9,11,20,31,19,50,0.000333,0.072032,4,864.385619,48.021423,216.096405,66.583073,2,4
0,0,8,8,11,14,25,39,24,63,0.000333,0.097521,5,1462.8147,81.267483,292.56294,91.356717,2,4
0,0,7,7,9,11,20,31,19,50,0.000333,0.072032,4,864.385619,48.021423,216.096405,66.583073,2,4
0,0,7,7,9,11,20,30,19,49,0.000333,0.070591,4,847.097907,47.060995,211.774477,66.583073,2,4
0,0,7,7,9,11,20,30,19,49,0.000333,0.070591,4,847.097907,47.060995,211.774477,66.583073,2,4
0,0,7,7,9,14,23,34,22,56,0.000333,0.08444,4,1013.277878,56.293215,253.31947,81.832294,2,4
0,0,7,7,9,11,20,31,19,50,0.000333,0.072032,4,864.385619,48.021423,216.096405,66.583073,2,4
0,0,8,8,11,14,25,39,24,63,0.000333,0.097521,5,1462.8147,81.267483,292.56294,91.356717,2,4
0,0,7,7,9,11,20,31,19,50,0.000333,0.072032,4,864.385619,48.021423,216.096405,66.583073,2,4
0,0,7,7,9,14,23,34,22,56,0.000333,0.08444,4,1013.277878,56.293215,253.31947,81.832294,2,4
0,0,7,7,9,11,20,30,19,49,0.000333,0.070591,4,847.097907,47.060995,211.774477,66.583073,2,4
0,0,7,7,9,11,20,30,19,49,0.000333,0.070591,4,847.097907,47.060995,211.774477,66.583073,2,4
0,0,8,8,11,14,25,39,24,63,0.000333,0.097521,5,1462.8147,81.267483,292.56294,91.356717,2,4
0,0,7,7,9,11,20,31,19,50,0.000333,0.072032,4,864.385619,48.021423,216.096405,66.583073,2,4
0,0,7,7,9,11,20,31,19,50,0.000333,0.072032,4,864.385619,48.021423,216.096405,66.583073,2,4
0,0,7,7,9,14,23,34,22,56,0.000333,0.08444,4,1013.277878,56.293215,253.31947,81.832294,2,4
0,0,7,7,9,11,20,30,19,49,0.000333,0.070591,4,847.097907,47.060995,211.774477,66.583073,2,4
0,0,7,7,9,11,20,30,19,49,0.000333,0.070591,4,847.097907,47.060995,211.774477,66.583073,2,4
0,0,8,8,11,14,25,39,24,63,0.000333,0.097521,5,1462.8147,81.267483,292.56294,91.356717,2,4
0,0,7,7,9,11,20,31,19,50,0.000333,0.072032,4,864.385619,48.021423,216.096405,66.583073,2,4
0,0,7,7,9,11,20,31,19,50,0.000333,0.072032,4,864.385619,48.021423,216.096405,66.583073,2,4
0,0,7,7,9,14,23,34,22,56,0.000333,0.08444,4,1013.277878,56.293215,253.31947,81.832294,2,4
0,0,7,7,9,11,20,30,19,49,0.000333,0.070591,4,847.097907,47.060995,211.774477,66.583073,2,4
0,0,7,7,9,11,20,30,19,49,0.000333,0.070591,4,847.097907,47.060995,211.774477,66.583073,2,4
0,0,8,8,11,14,25,39,24,63,0.000333,0.097521,5,1462.8147,81.267483,292.56294,91.356717,2,4
0,0,7,7,9,11,20,31,19,50,0.000333,0.072032,4,864.385619,48.021423,216.096405,66.583073,2,4
0,0,7,7,9,11,20,31,19,50,0.000333,0.072032,4,864.385619,48.021423,216.096405,66.583073,2,4
0,0,7,7,9,11,20,30,19,49,0.000333,0.070591,4,847.097907,47.060995,211.774477,66.583073,2,4
0,0,7,7,9,14,23,34,22,56,0.000333,0.08444,4,1013.277878,56.293215,253.31947,81.832294,2,4
0,0,7,7,9,11,20,30,19,49,0.000333,0.070591,4,847.097907,47.060995,211.774477,66.583073,2,4
0,0,7,7,9,11,20,31,19,50,0.000333,0.072032,4,864.385619,48.021423,216.096405,66.583073,2,4
0,0,7,7,9,11,20,31,19,50,0.000333,0.072032,4,864.385619,48.021423,216.096405,66.583073,2,4
0,0,8,8,11,14,25,39,24,63,0.000333,0.097521,5,1462.8147,81.267483,292.56294,91.356717,2,4
0,0,7,7,9,11,20,30,19,49,0.000333,0.070591,4,847.097907,47.060995,211.774477,66.583073,2,4
0,0,7,7,9,14,23,34,22,56,0.000333,0.08444,4,1013.277878,56.293215,253.31947,81.832294,2,4
0,0,7,7,9,11,20,30,19,49,0.000333,0.070591,4,847.097907,47.060995,211.774477,66.583073,2,4
0,0,7,7,9,11,20,31,19,50,0.000333,0.072032,4,864.385619,48.021423,216.096405,66.583073,2,4
0,0,7,7,9,11,20,31,19,50,0.000333,0.072032,4,864.385619,48.021423,216.096405,66.583073,2,4
0,0,8,8,11,14,25,39,24,63,0.000333,0.097521,5,1462.8147,81.267483,292.56294,91.356717,2,4
0,0,7,7,9,11,20,30,19,49,0.000333,0.070591,4,847.097907,47.060995,211.774477,66.583073,2,4
0,0,7,7,9,14,23,34,22,56,0.000333,0.08444,4,1013.277878,56.293215,253.31947,81.832294,2,4
0,0,7,7,9,11,20,30,19,49,0.000333,0.070591,4,847.097907,47.060995,211.774477,66.583073,2,4
0,0,7,7,9,11,20,31,19,50,0.000333,0.072032,4,864.385619,48.021423,216.096405,66.583073,2,4
0,0,7,7,9,11,20,31,19,50,0.000333,0.072032,4,864.385619,48.021423,216.096405,66.583073,2,4
0,0,8,8,11,14,25,39,24,63,0.000333,0.097521,5,1462.8147,81.267483,292.56294,91.356717,2,4
0,0,7,7,9,14,23,34,22,56,0.000333,0.08444,4,1013.277878,56.293215,253.31947,81.832294,2,4
0,0,7,7,9,11,20,30,19,49,0.000333,0.070591,4,847.097907,47.060995,211.774477,66.583073,2,4
0,0,7,7,9,11,20,30,19,49,0.000333,0.070591,4,847.097907,47.060995,211.774477,66.583073,2,4
0,0,7,7,9,10,19,31,19,50,0.000333,0.070799,4,849.585503,47.199195,212.396376,61.748606,2,4
0,0,7,7,9,10,19,31,19,50,0.000333,0.070799,4,849.585503,47.199195,212.396376,61.748606,2,4
0,0,10,10,12,19,31,50,34,84,0.000333,0.138717,6,2496.91494,138.717497,416.15249,123.730173,2,4
0,0,7,7,9,11,20,30,19,49,0.000333,0.070591,4,847.097907,47.060995,211.774477,66.583073,2,4
0,0,7,7,9,14,23,34,22,56,0.000333,0.08444,4,1013.277878,56.293215,253.31947,81.832294,2,4
0,0,7,7,9,11,20,30,19,49,0.000333,0.070591,4,847.097907,47.060995,211.774477,66.583073,2,4
0,0,7,7,9,11,20,31,19,50,0.000333,0.072032,4,864.385619,48.021423,216.096405,66.583073,2,4
0,0,7,7,9,11,20,31,19,50,0.000333,0.072032,4,864.385619,48.021423,216.096405,66.583073,2,4
0,0,8,8,11,14,25,39,24,63,0.000333,0.097521,5,1462.8147,81.267483,292.56294,91.356717,2,4
0,0,7,7,9,11,20,30,19,49,0.000333,0.070591,4,847.097907,47.060995,211.774477,66.583073,2,4
0,0,7,7,9,14,23,34,22,56,0.000333,0.08444,4,1013.277878,56.293215,253.31947,81.832294,2,4
0,0,7,7,9,11,20,30,19,49,0.000333,0.070591,4,847.097907,47.060995,211.774477,66.583073,2,4
0,0,7,7,9,11,20,31,19,50,0.000333,0.072032,4,864.385619,48.021423,216.096405,66.583073,2,4
0,0,7,7,9,11,20,31,19,50,0.000333,0.072032,4,864.385619,48.021423,216.096405,66.583073,2,4
0,0,8,8,11,14,25,39,24,63,0.000333,0.097521,5,1462.8147,81.267483,292.56294,91.356717,2,4
0,0,7,7,9,11,20,30,19,49,0.000333,0.070591,4,847.097907,47.060995,211.774477,66.583073,2,4
0,0,7,7,9,11,20,30,19,49,0.000333,0.070591,4,847.097907,47.060995,211.774477,66.583073,2,4
0,0,7,7,9,14,23,34,22,56,0.000333,0.08444,4,1013.277878,56.293215,253.31947,81.832294,2,4
0,0,8,8,11,14,25,39,24,63,0.000333,0.097521,5,1462.8147,81.267483,292.56294,91.356717,2,4
0,0,7,7,9,11,20,31,19,50,0.000333,0.072032,4,864.385619,48.021423,216.096405,66.583073,2,4
0,0,7,7,9,11,20,31,19,50,0.000333,0.072032,4,864.385619,48.021423,216.096405,66.583073,2,4
0,0,7,7,9,14,23,34,22,56,0.000333,0.08444,4,1013.277878,56.293215,253.31947,81.832294,2,4
0,0,7,7,9,11,20,30,19,49,0.000333,0.070591,4,847.097907,47.060995,211.774477,66.583073,2,4
0,0,8,8,11,14,25,39,24,63,0.000333,0.097521,5,1462.8147,81.267483,292.56294,91.356717,2,4
0,0,8,8,11,14,25,39,24,63,0.000333,0.097521,5,1462.8147,81.267483,292.56294,91.356717,2,4
0,0,7,7,9,11,20,30,19,49,0.000333,0.070591,4,847.097907,47.060995,211.774477,66.583073,2,4
0,0,7,7,9,14,23,34,22,56,0.000333,0.08444,4,1013.277878,56.293215,253.31947,81.832294,2,4
0,0,8,8,11,14,25,39,24,63,0.000333,0.097521,5,1462.8147,81.267483,292.56294,91.356717,2,4
0,0,8,8,11,14,25,39,24,63,0.000333,0.097521,5,1462.8147,81.267483,292.56294,91.356717,2,4
0,0,7,7,9,11,20,30,19,49,0.000333,0.070591,4,847.097907,47.060995,211.774477,66.583073,2,4
0,0,7,7,9,14,23,34,22,56,0.000333,0.08444,4,1013.277878,56.293215,253.31947,81.832294,2,4
0,0,9,9,12,18,30,48,32,80,0.000333,0.13085,6,2355.307486,130.850416,392.551248,118.0782,2,4
0,0,9,9,12,18,30,48,32,80,0.000333,0.13085,6,2355.307486,130.850416,392.551248,118.0782,2,4
0,0,7,7,9,14,23,34,22,56,0.000333,0.08444,4,1013.277878,56.293215,253.31947,81.832294,2,4
0,0,7,7,9,11,20,30,19,49,0.000333,0.070591,4,847.097907,47.060995,211.774477,66.583073,2,4
0,0,8,8,10,14,24,35,25,60,0.000333,0.091699,5,1375.48875,76.416042,275.09775,86.52225,2,4
0,0,11,11,13,21,34,54,38,92,0.000333,0.156016,6,2808.279488,156.015527,468.046581,140.344382,2,4
0,0,7,7,9,14,23,34,22,56,0.000333,0.08444,4,1013.277878,56.293215,253.31947,81.832294,2,4
0,0,7,7,9,11,20,30,19,49,0.000333,0.070591,4,847.097907,47.060995,211.774477,66.583073,2,4
0,0,6,6,9,14,23,29,21,50,0.000333,0.075393,4,904.712391,50.2618,226.178098,81.832294,2,4
0,0,8,8,9,16,25,34,29,63,0.000333,0.097521,4,1170.25176,65.013987,292.56294,92.529325,2,4
0,0,7,7,9,11,20,30,19,49,0.000333,0.070591,4,847.097907,47.060995,211.774477,66.583073,2,4
0,0,7,7,9,14,23,34,22,56,0.000333,0.08444,4,1013.277878,56.293215,253.31947,81.832294,2,4
0,0,8,8,9,12,21,33,23,56,0.000333,0.08199,4,983.879103,54.65995,245.969776,71.548875,2,4
0,0,11,11,12,20,32,52,38,90,0.000333,0.15,6,2700,150,450,129.458112,2,4
0,0,7,7,9,14,23,34,22,56,0.000333,0.08444,4,1013.277878,56.293215,253.31947,81.832294,2,4
0,0,7,7,9,11,20,30,19,49,0.000333,0.070591,4,847.097907,47.060995,211.774477,66.583073,2,4
0,0,7,7,10,11,21,34,21,55,0.000333,0.080526,5,1207.887291,67.10485,241.577458,71.273029,2,4
0,0,7,7,10,11,21,34,21,55,0.000333,0.080526,5,1207.887291,67.10485,241.577458,71.273029,2,4
0,0,7,7,9,11,20,30,19,49,0.000333,0.070591,4,847.097907,47.060995,211.774477,66.583073,2,4
0,0,7,7,9,14,23,34,22,56,0.000333,0.08444,4,1013.277878,56.293215,253.31947,81.832294,2,4
0,0,7,7,10,15,25,31,23,54,0.000333,0.083589,5,1253.841171,69.657843,250.768234,91.82264,2,4
0,0,7,7,10,15,25,31,23,54,0.000333,0.083589,5,1253.841171,69.657843,250.768234,91.82264,2,4
0,0,7,7,9,11,20,30,19,49,0.000333,0.070591,4,847.097907,47.060995,211.774477,66.583073,2,4
0,0,7,7,9,14,23,34,22,56,0.000333,0.08444,4,1013.277878,56.293215,253.31947,81.832294,2,4
0,0,8,8,10,14,24,35,25,60,0.000333,0.091699,5,1375.48875,76.416042,275.09775,86.52225,2,4
0,0,11,11,13,21,34,54,38,92,0.000333,0.156016,6,2808.279488,156.015527,468.046581,140.344382,2,4
0,0,7,7,9,14,23,34,22,56,0.000333,0.08444,4,1013.277878,56.293215,253.31947,81.832294,2,4
0,0,7,7,9,11,20,30,19,49,0.000333,0.070591,4,847.097907,47.060995,211.774477,66.583073,2,4
0,0,8,8,10,12,22,35,22,57,0.000333,0.084729,5,1270.938011,70.607667,254.187602,76.238831,2,4
0,0,11,11,13,19,32,54,36,90,0.000333,0.15,6,2700,150,450,128.816339,2,4
0,0,7,7,9,14,23,34,22,56,0.000333,0.08444,4,1013.277878,56.293215,253.31947,81.832294,2,4
0,0,7,7,9,11,20,30,19,49,0.000333,0.070591,4,847.097907,47.060995,211.774477,66.583073,2,4
0,0,6,6,10,13,23,30,20,50,0.000333,0.075393,5,1130.890489,62.827249,226.178098,81.324997,2,4
0,0,6,6,10,12,22,30,19,49,0.000333,0.072837,5,1092.560747,60.697819,218.512149,76.238831,2,4
0,0,7,7,9,11,20,30,19,49,0.000333,0.070591,4,847.097907,47.060995,211.774477,66.583073,2,4
0,0,7,7,9,14,23,34,22,56,0.000333,0.08444,4,1013.277878,56.293215,253.31947,81.832294,2,4
0,0,9,9,9,17,26,34,30,64,0.000333,0.100276,4,1203.312568,66.850698,300.828142,98.016193,2,4
0,0,12,12,12,23,35,53,42,95,0.000333,0.162427,6,2923.69132,162.427296,487.281887,147.061475,2,4
0,0,7,7,9,14,23,34,22,56,0.000333,0.08444,4,1013.277878,56.293215,253.31947,81.832294,2,4
0,0,7,7,9,11,20,30,19,49,0.000333,0.070591,4,847.097907,47.060995,211.774477,66.583073,2,4
0,0,6,6,9,15,24,29,22,51,0.000333,0.077944,4,935.33235,51.962908,233.833088,87.132684,2,4
0,0,6,6,9,14,23,29,21,50,0.000333,0.075393,4,904.712391,50.2618,226.178098,81.832294,2,4
0,0,7,7,9,14,23,34,22,56,0.000333,0.08444,4,1013.277878,56.293215,253.31947,81.832294,2,4
0,0,7,7,9,11,20,30,19,49,0.000333,0.070591,4,847.097907,47.060995,211.774477,66.583073,2,4
0,0,6,6,9,15,24,29,22,51,0.000333,0.077944,4,935.33235,51.962908,233.833088,87.132684,2,4
0,0,6,6,9,14,23,29,21,50,0.000333,0.075393,4,904.712391,50.2618,226.178098,81.832294,2,4
0,0,7,7,9,14,23,34,22,56,0.000333,0.08444,4,1013.277878,56.293215,253.31947,81.832294,2,4
0,0,7,7,9,11,20,30,19,49,0.000333,0.070591,4,847.097907,47.060995,211.774477,66.583073,2,4
0,0,6,6,9,15,24,29,22,51,0.000333,0.077944,4,935.33235,51.962908,233.833088,87.132684,2,4
0,0,6,6,9,14,23,29,21,50,0.000333,0.075393,4,904.712391,50.2618,226.178098,81.832294,2,4
0,0,7,7,9,14,23,34,22,56,0.000333,0.08444,4,1013.277878,56.293215,253.31947,81.832294,2,4
0,0,7,7,9,11,20,30,19,49,0.000333,0.070591,4,847.097907,47.060995,211.774477,66.583073,2,4
0,0,6,6,9,15,24,29,22,51,0.000333,0.077944,4,935.33235,51.962908,233.833088,87.132684,2,4
0,0,6,6,9,14,23,29,21,50,0.000333,0.075393,4,904.712391,50.2618,226.178098,81.832294,2,4
0,0,7,7,9,14,23,34,22,56,0.000333,0.08444,4,1013.277878,56.293215,253.31947,81.832294,2,4
0,0,7,7,9,11,20,30,19,49,0.000333,0.070591,4,847.097907,47.060995,211.774477,66.583073,2,4
0,0,6,6,9,12,21,31,20,51,0.000333,0.074669,4,896.032754,49.779597,224.008189,71.548875,2,4
0,0,6,6,9,13,22,31,21,52,0.000333,0.077297,4,927.561777,51.53121,231.890444,76.635041,2,4
0,0,7,7,9,14,23,34,22,56,0.000333,0.08444,4,1013.277878,56.293215,253.31947,81.832294,2,4
0,0,7,7,9,11,20,30,19,49,0.000333,0.070591,4,847.097907,47.060995,211.774477,66.583073,2,4
0,0,7,7,9,15,24,33,24,57,0.000333,0.087114,4,1045.37145,58.076192,261.342863,87.132684,2,4
0,0,7,7,9,16,25,33,25,58,0.000333,0.089781,4,1077.374636,59.854146,269.343659,92.529325,2,4
0,0,7,7,9,14,23,34,22,56,0.000333,0.08444,4,1013.277878,56.293215,253.31947,81.832294,2,4
0,0,7,7,9,11,20,30,19,49,0.000333,0.070591,4,847.097907,47.060995,211.774477,66.583073,2,4
0,0,8,8,9,16,25,41,28,69,0.000333,0.106809,4,1281.704308,71.205795,320.426077,92.529325,2,4
0,0,8,8,9,17,26,41,29,70,0.000333,0.109677,4,1316.123121,73.117951,329.03078,98.016193,2,4
0,0,7,7,9,14,23,34,22,56,0.000333,0.08444,4,1013.277878,56.293215,253.31947,81.832294,2,4
0,0,7,7,9,11,20,30,19,49,0.000333,0.070591,4,847.097907,47.060995,211.774477,66.583073,2,4
0,0,6,6,9,15,24,29,22,51,0.000333,0.077944,4,935.33235,51.962908,233.833088,87.132684,2,4
0,0,6,6,9,14,23,29,21,50,0.000333,0.075393,4,904.712391,50.2618,226.178098,81.832294,2,4
0,0,6,6,11,12,23,31,19,50,0.000333,0.075393,5,1130.890489,62.827249,226.178098,81.073298,2,4
0,0,6,6,11,12,23,31,19,50,0.000333,0.075393,5,1130.890489,62.827249,226.178098,81.073298,2,4
0,0,7,7,11,16,27,35,25,60,0.000333,0.095098,5,1426.466251,79.248125,285.29325,102.053748,2,4
0,0,7,7,11,17,28,35,26,61,0.000333,0.09775,5,1466.243251,81.457958,293.24865,107.540616,2,4
0,0,7,7,9,14,23,34,22,56,0.000333,0.08444,4,1013.277878,56.293215,253.31947,81.832294,2,4
0,0,7,7,9,11,20,30,19,49,0.000333,0.070591,4,847.097907,47.060995,211.774477,66.583073,2,4
0,0,7,7,10,17,27,32,27,59,0.000333,0.093513,5,1402.691813,77.927323,280.538363,102.706149,2,4
0,0,7,7,10,18,28,32,28,60,0.000333,0.096147,5,1442.206477,80.122582,288.441295,108.277931,2,4
0,0,7,7,9,14,23,34,22,56,0.000333,0.08444,4,1013.277878,56.293215,253.31947,81.832294,2,4
0,0,7,7,9,11,20,30,19,49,0.000333,0.070591,4,847.097907,47.060995,211.774477,66.583073,2,4
0,0,6,6,9,13,22,29,20,49,0.000333,0.072837,4,874.048597,48.558255,218.512149,76.635041,2,4
0,0,6,6,9,14,23,29,21,50,0.000333,0.075393,4,904.712391,50.2618,226.178098,81.832294,2,4
0,0,7,7,9,11,20,30,19,49,0.000333,0.070591,4,847.097907,47.060995,211.774477,66.583073,2,4
0,0,6,6,11,16,27,31,23,54,0.000333,0.085588,5,1283.819626,71.323313,256.763925,102.053748,2,4
0,0,7,7,9,11,20,30,19,49,0.000333,0.070591,4,847.097907,47.060995,211.774477,66.583073,2,4
0,0,6,6,10,16,26,30,23,53,0.000333,0.083041,5,1245.616525,69.200918,249.123305,97.219281,2,4
0,0,7,7,9,14,23,34,22,56,0.000333,0.08444,4,1013.277878,56.293215,253.31947,81.832294,2,4
0,0,7,7,9,11,20,30,19,49,0.000333,0.070591,4,847.097907,47.060995,211.774477,66.583073,2,4
0,0,6,6,9,10,19,29,17,46,0.000333,0.065135,4,781.618662,43.423259,195.404666,61.748606,2,4
0,0,6,6,9,10,19,29,17,46,0.000333,0.065135,4,781.618662,43.423259,195.404666,61.748606,2,4
0,0,7,7,9,11,20,30,19,49,0.000333,0.070591,4,847.097907,47.060995,211.774477,66.583073,2,4
0,0,7,7,9,11,20,30,19,49,0.000333,0.070591,4,847.097907,47.060995,211.774477,66.583073,2,4
0,0,7,7,9,14,23,34,22,56,0.000333,0.08444,4,1013.277878,56.293215,253.31947,81.832294,2,4
0,0,7,7,9,11,20,31,19,50,0.000333,0.072032,4,864.385619,48.021423,216.096405,66.583073,2,4
0,0,7,7,9,11,20,31,19,50,0.000333,0.072032,4,864.385619,48.021423,216.096405,66.583073,2,4
0,0,7,7,9,11,20,31,19,50,0.000333,0.072032,4,864.385619,48.021423,216.096405,66.583073,2,4
0,0,7,7,9,11,20,30,19,49,0.000333,0.070591,4,847.097907,47.060995,211.774477,66.583073,2,4
0,0,7,7,9,11,20,30,19,49,0.000333,0.070591,4,847.097907,47.060995,211.774477,66.583073,2,4
0,0,7,7,9,14,23,34,22,56,0.000333,0.08444,4,1013.277878,56.293215,253.31947,81.832294,2,4
0,0,7,7,9,11,20,31,19,50,0.000333,0.072032,4,864.385619,48.021423,216.096405,66.583073,2,4
0,0,7,7,9,11,20,31,19,50,0.000333,0.072032,4,864.385619,48.021423,216.096405,66.583073,2,4
0,0,7,7,9,11,20,31,19,50,0.000333,0.072032,4,864.385619,48.021423,216.096405,66.583073,2,4
0,0,7,7,9,14,23,34,22,56,0.000333,0.08444,4,1013.277878,56.293215,253.31947,81.832294,2,4
0,0,7,7,9,11,20,30,19,49,0.000333,0.070591,4,847.097907,47.060995,211.774477,66.583073,2,4
0,0,7,7,9,11,20,30,19,49,0.000333,0.070591,4,847.097907,47.060995,211.774477,66.583073,2,4
0,0,7,7,9,11,20,31,19,50,0.000333,0.072032,4,864.385619,48.021423,216.096405,66.583073,2,4
0,0,7,7,9,11,20,31,19,50,0.000333,0.072032,4,864.385619,48.021423,216.096405,66.583073,2,4
0,0,7,7,9,11,20,31,19,50,0.000333,0.072032,4,864.385619,48.021423,216.096405,66.583073,2,4
0,0,7,7,9,14,23,34,22,56,0.000333,0.08444,4,1013.277878,56.293215,253.31947,81.832294,2,4
0,0,7,7,9,11,20,30,19,49,0.000333,0.070591,4,847.097907,47.060995,211.774477,66.583073,2,4
0,0,7,7,9,11,20,30,19,49,0.000333,0.070591,4,847.097907,47.060995,211.774477,66.583073,2,4
0,0,7,7,9,11,20,31,19,50,0.000333,0.072032,4,864.385619,48.021423,216.096405,66.583073,2,4
0,0,7,7,9,11,20,31,19,50,0.000333,0.072032,4,864.385619,48.021423,216.096405,66.583073,2,4
0,0,7,7,9,11,20,31,19,50,0.000333,0.072032,4,864.385619,48.021423,216.096405,66.583073,2,4
0,0,7,7,9,11,20,30,19,49,0.000333,0.070591,4,847.097907,47.060995,211.774477,66.583073,2,4
0,0,7,7,9,11,20,30,19,49,0.000333,0.070591,4,847.097907,47.060995,211.774477,66.583073,2,4
0,0,7,7,9,14,23,34,22,56,0.000333,0.08444,4,1013.277878,56.293215,253.31947,81.832294,2,4
0,0,7,7,9,11,20,31,19,50,0.000333,0.072032,4,864.385619,48.021423,216.096405,66.583073,2,4
0,0,7,7,9,11,20,31,19,50,0.000333,0.072032,4,864.385619,48.021423,216.096405,66.583073,2,4
0,0,7,7,9,11,20,31,19,50,0.000333,0.072032,4,864.385619,48.021423,216.096405,66.583073,2,4
0,0,7,7,9,11,20,30,19,49,0.000333,0.070591,4,847.097907,47.060995,211.774477,66.583073,2,4
0,0,7,7,9,11,20,30,19,49,0.000333,0.070591,4,847.097907,47.060995,211.774477,66.583073,2,4
0,0,7,7,9,14,23,34,22,56,0.000333,0.08444,4,1013.277878,56.293215,253.31947,81.832294,2,4
0,0,7,7,9,11,20,31,19,50,0.000333,0.072032,4,864.385619,48.021423,216.096405,66.583073,2,4
0,0,7,7,9,11,20,31,19,50,0.000333,0.072032,4,864.385619,48.021423,216.096405,66.583073,2,4
0,0,7,7,9,11,20,31,19,50,0.000333,0.072032,4,864.385619,48.021423,216.096405,66.583073,2,4
0,0,7,7,9,11,20,30,19,49,0.000333,0.070591,4,847.097907,47.060995,211.774477,66.583073,2,4
0,0,7,7,9,11,20,30,19,49,0.000333,0.070591,4,847.097907,47.060995,211.774477,66.583073,2,4
0,0,7,7,9,14,23,34,22,56,0.000333,0.08444,4,1013.277878,56.293215,253.31947,81.832294,2,4
0,0,7,7,9,11,20,31,19,50,0.000333,0.072032,4,864.385619,48.021423,216.096405,66.583073,2,4
0,0,7,7,9,11,20,31,19,50,0.000333,0.072032,4,864.385619,48.021423,216.096405,66.583073,2,4
0,0,7,7,9,11,20,31,19,50,0.000333,0.072032,4,864.385619,48.021423,216.096405,66.583073,2,4
0,0,7,7,9,11,20,30,19,49,0.000333,0.070591,4,847.097907,47.060995,211.774477,66.583073,2,4
0,0,7,7,9,11,20,30,19,49,0.000333,0.070591,4,847.097907,47.060995,211.774477,66.583073,2,4
0,0,7,7,9,14,23,34,22,56,0.000333,0.08444,4,1013.277878,56.293215,253.31947,81.832294,2,4
0,0,7,7,9,11,20,31,19,50,0.000333,0.072032,4,864.385619,48.021423,216.096405,66.583073,2,4
0,0,7,7,9,11,20,31,19,50,0.000333,0.072032,4,864.385619,48.021423,216.096405,66.583073,2,4
0,0,7,7,9,11,20,31,19,50,0.000333,0.072032,4,864.385619,48.021423,216.096405,66.583073,2,4
0,0,7,7,9,11,20,30,19,49,0.000333,0.070591,4,847.097907,47.060995,211.774477,66.583073,2,4
0,0,7,7,9,11,20,30,19,49,0.000333,0.070591,4,847.097907,47.060995,211.774477,66.583073,2,4
0,0,7,7,9,14,23,34,22,56,0.000333,0.08444,4,1013.277878,56.293215,253.31947,81.832294,2,4
0,0,7,7,9,11,20,31,19,50,0.000333,0.072032,4,864.385619,48.021423,216.096405,66.583073,2,4
0,0,7,7,9,11,20,31,19,50,0.000333,0.072032,4,864.385619,48.021423,216.096405,66.583073,2,4
0,0,7,7,9,11,20,31,19,50,0.000333,0.072032,4,864.385619,48.021423,216.096405,66.583073,2,4
0,0,7,7,9,11,20,30,19,49,0.000333,0.070591,4,847.097907,47.060995,211.774477,66.583073,2,4
0,0,7,7,9,11,20,30,19,49,0.000333,0.070591,4,847.097907,47.060995,211.774477,66.583073,2,4
0,0,7,7,9,14,23,34,22,56,0.000333,0.08444,4,1013.277878,56.293215,253.31947,81.832294,2,4
0,0,7,7,9,11,20,31,19,50,0.000333,0.072032,4,864.385619,48.021423,216.096405,66.583073,2,4
0,0,7,7,9,11,20,31,19,50,0.000333,0.072032,4,864.385619,48.021423,216.096405,66.583073,2,4
0,0,7,7,9,11,20,31,19,50,0.000333,0.072032,4,864.385619,48.021423,216.096405,66.583073,2,4
0,0,7,7,9,11,20,30,19,49,0.000333,0.070591,4,847.097907,47.060995,211.774477,66.583073,2,4
0,0,7,7,9,14,23,34,22,56,0.000333,0.08444,4,1013.277878,56.293215,253.31947,81.832294,2,4
0,0,7,7,9,11,20,30,19,49,0.000333,0.070591,4,847.097907,47.060995,211.774477,66.583073,2,4
0,0,7,7,9,10,19,31,19,50,0.000333,0.070799,4,849.585503,47.199195,212.396376,61.748606,2,4
0,0,7,7,9,11,20,31,19,50,0.000333,0.072032,4,864.385619,48.021423,216.096405,66.583073,2,4
0,0,7,7,9,10,19,31,19,50,0.000333,0.070799,4,849.585503,47.199195,212.396376,61.748606,2,4
0,0,7,7,9,11,20,30,19,49,0.000333,0.070591,4,847.097907,47.060995,211.774477,66.583073,2,4
0,0,7,7,9,11,20,30,19,49,0.000333,0.070591,4,847.097907,47.060995,211.774477,66.583073,2,4
0,0,7,7,9,14,23,34,22,56,0.000333,0.08444,4,1013.277878,56.293215,253.31947,81.832294,2,4
0,0,7,7,9,11,20,31,19,50,0.000333,0.072032,4,864.385619,48.021423,216.096405,66.583073,2,4
0,0,7,7,9,11,20,31,19,50,0.000333,0.072032,4,864.385619,48.021423,216.096405,66.583073,2,4
0,0,7,7,9,11,20,31,19,50,0.000333,0.072032,4,864.385619,48.021423,216.096405,66.583073,2,4
0,0,7,7,9,11,20,30,19,49,0.000333,0.070591,4,847.097907,47.060995,211.774477,66.583073,2,4
0,0,7,7,9,11,20,30,19,49,0.000333,0.070591,4,847.097907,47.060995,211.774477,66.583073,2,4
0,0,7,7,9,14,23,34,22,56,0.000333,0.08444,4,1013.277878,56.293215,253.31947,81.832294,2,4
0,0,7,7,9,11,20,31,19,50,0.000333,0.072032,4,864.385619,48.021423,216.096405,66.583073,2,4
0,0,7,7,9,11,20,31,19,50,0.000333,0.072032,4,864.385619,48.021423,216.096405,66.583073,2,4
0,0,7,7,9,11,20,31,19,50,0.000333,0.072032,4,864.385619,48.021423,216.096405,66.583073,2,4
0,0,7,7,9,11,20,30,19,49,0.000333,0.070591,4,847.097907,47.060995,211.774477,66.583073,2,4
0,0,7,7,9,14,23,34,22,56,0.000333,0.08444,4,1013.277878,56.293215,253.31947,81.832294,2,4
0,0,7,7,9,11,20,30,19,49,0.000333,0.070591,4,847.097907,47.060995,211.774477,66.583073,2,4
0,0,7,7,9,11,20,31,19,50,0.000333,0.072032,4,864.385619,48.021423,216.096405,66.583073,2,4
0,0,7,7,9,11,20,31,19,50,0.000333,0.072032,4,864.385619,48.021423,216.096405,66.583073,2,4
0,0,7,7,9,11,20,31,19,50,0.000333,0.072032,4,864.385619,48.021423,216.096405,66.583073,2,4
0,0,7,7,9,11,20,30,19,49,0.000333,0.070591,4,847.097907,47.060995,211.774477,66.583073,2,4
0,0,7,7,9,14,23,34,22,56,0.000333,0.08444,4,1013.277878,56.293215,253.31947,81.832294,2,4
0,0,7,7,9,11,20,31,19,50,0.000333,0.072032,4,864.385619,48.021423,216.096405,66.583073,2,4
0,0,7,7,9,11,20,31,19,50,0.000333,0.072032,4,864.385619,48.021423,216.096405,66.583073,2,4
0,0,7,7,9,14,23,34,22,56,0.000333,0.08444,4,1013.277878,56.293215,253.31947,81.832294,2,4
0,0,7,7,9,11,20,30,19,49,0.000333,0.070591,4,847.097907,47.060995,211.774477,66.583073,2,4
0,0,7,7,9,11,20,31,19,50,0.000333,0.072032,4,864.385619,48.021423,216.096405,66.583073,2,4
0,0,7,7,9,11,20,31,19,50,0.000333,0.072032,4,864.385619,48.021423,216.096405,66.583073,2,4
0,0,7,7,9,11,20,30,19,49,0.000333,0.070591,4,847.097907,47.060995,211.774477,66.583073,2,4
0,0,7,7,9,14,23,34,22,56,0.000333,0.08444,4,1013.277878,56.293215,253.31947,81.832294,2,4
0,0,6,6,9,10,19,29,17,46,0.000333,0.065135,4,781.618662,43.423259,195.404666,61.748606,2,4
0,0,6,6,9,10,19,29,17,46,0.000333,0.065135,4,781.618662,43.423259,195.404666,61.748606,2,4
0,0,7,7,9,14,23,34,22,56,0.000333,0.08444,4,1013.277878,56.293215,253.31947,81.832294,2,4
0,0,7,7,9,11,20,30,19,49,0.000333,0.070591,4,847.097907,47.060995,211.774477,66.583073,2,4
0,0,8,8,10,14,24,35,25,60,0.000333,0.091699,5,1375.48875,76.416042,275.09775,86.52225,2,4
0,0,8,8,10,13,23,35,23,58,0.000333,0.087456,5,1311.832967,72.879609,262.366593,81.324997,2,4
0,0,7,7,9,14,23,34,22,56,0.000333,0.08444,4,1013.277878,56.293215,253.31947,81.832294,2,4
0,0,7,7,9,11,20,30,19,49,0.000333,0.070591,4,847.097907,47.060995,211.774477,66.583073,2,4
0,0,8,8,9,16,25,34,29,63,0.000333,0.097521,4,1170.25176,65.013987,292.56294,92.529325,2,4
0,0,6,6,9,14,23,29,21,50,0.000333,0.075393,4,904.712391,50.2618,226.178098,81.832294,2,4
0,0,7,7,9,14,23,34,22,56,0.000333,0.08444,4,1013.277878,56.293215,253.31947,81.832294,2,4
0,0,7,7,9,11,20,30,19,49,0.000333,0.070591,4,847.097907,47.060995,211.774477,66.583073,2,4
0,0,8,8,9,12,21,33,23,56,0.000333,0.08199,4,983.879103,54.65995,245.969776,71.548875,2,4
0,0,8,8,9,12,21,33,23,56,0.000333,0.08199,4,983.879103,54.65995,245.969776,71.548875,2,4
0,0,7,7,9,14,23,34,22,56,0.000333,0.08444,4,1013.277878,56.293215,253.31947,81.832294,2,4
0,0,7,7,9,11,20,30,19,49,0.000333,0.070591,4,847.097907,47.060995,211.774477,66.583073,2,4
0,0,7,7,10,11,21,34,21,55,0.000333,0.080526,5,1207.887291,67.10485,241.577458,71.273029,2,4
0,0,7,7,10,11,21,34,21,55,0.000333,0.080526,5,1207.887291,67.10485,241.577458,71.273029,2,4
0,0,7,7,9,11,20,30,19,49,0.000333,0.070591,4,847.097907,47.060995,211.774477,66.583073,2,4
0,0,7,7,9,14,23,34,22,56,0.000333,0.08444,4,1013.277878,56.293215,253.31947,81.832294,2,4
0,0,7,7,10,15,25,31,23,54,0.000333,0.083589,5,1253.841171,69.657843,250.768234,91.82264,2,4
0,0,7,7,10,15,25,31,23,54,0.000333,0.083589,5,1253.841171,69.657843,250.768234,91.82264,2,4
0,0,7,7,9,11,20,30,19,49,0.000333,0.070591,4,847.097907,47.060995,211.774477,66.583073,2,4
0,0,7,7,9,14,23,34,22,56,0.000333,0.08444,4,1013.277878,56.293215,253.31947,81.832294,2,4
0,0,8,8,10,13,23,35,23,58,0.000333,0.087456,5,1311.832967,72.879609,262.366593,81.324997,2,4
0,0,8,8,10,14,24,35,25,60,0.000333,0.091699,5,1375.48875,76.416042,275.09775,86.52225,2,4
0,0,7,7,9,11,20,30,19,49,0.000333,0.070591,4,847.097907,47.060995,211.774477,66.583073,2,4
0,0,7,7,9,14,23,34,22,56,0.000333,0.08444,4,1013.277878,56.293215,253.31947,81.832294,2,4
0,0,8,8,10,11,21,35,21,56,0.000333,0.08199,5,1229.848878,68.324938,245.969776,71.273029,2,4
0,0,8,8,10,12,22,35,22,57,0.000333,0.084729,5,1270.938011,70.607667,254.187602,76.238831,2,4
0,0,7,7,9,14,23,34,22,56,0.000333,0.08444,4,1013.277878,56.293215,253.31947,81.832294,2,4
0,0,7,7,9,11,20,30,19,49,0.000333,0.070591,4,847.097907,47.060995,211.774477,66.583073,2,4
0,0,6,6,10,12,22,30,19,49,0.000333,0.072837,5,1092.560747,60.697819,218.512149,76.238831,2,4
0,0,6,6,10,13,23,30,20,50,0.000333,0.075393,5,1130.890489,62.827249,226.178098,81.324997,2,4
0,0,7,7,9,14,23,34,22,56,0.000333,0.08444,4,1013.277878,56.293215,253.31947,81.832294,2,4
0,0,7,7,9,11,20,30,19,49,0.000333,0.070591,4,847.097907,47.060995,211.774477,66.583073,2,4
0,0,9,9,9,15,24,34,27,61,0.000333,0.093228,4,1118.73085,62.151714,279.682713,87.132684,2,4
0,0,9,9,9,17,26,34,30,64,0.000333,0.100276,4,1203.312568,66.850698,300.828142,98.016193,2,4
0,0,7,7,9,11,20,30,19,49,0.000333,0.070591,4,847.097907,47.060995,211.774477,66.583073,2,4
0,0,7,7,9,14,23,34,22,56,0.000333,0.08444,4,1013.277878,56.293215,253.31947,81.832294,2,4
0,0,6,6,9,15,24,29,22,51,0.000333,0.077944,4,935.33235,51.962908,233.833088,87.132684,2,4
0,0,6,6,9,14,23,29,21,50,0.000333,0.075393,4,904.712391,50.2618,226.178098,81.832294,2,4
0,0,7,7,9,14,23,34,22,56,0.000333,0.08444,4,1013.277878,56.293215,253.31947,81.832294,2,4
0,0,7,7,9,11,20,30,19,49,0.000333,0.070591,4,847.097907,47.060995,211.774477,66.583073,2,4
0,0,6,6,9,15,24,29,22,51,0.000333,0.077944,4,935.33235,51.962908,233.833088,87.132684,2,4
0,0,6,6,9,14,23,29,21,50,0.000333,0.075393,4,904.712391,50.2618,226.178098,81.832294,2,4
0,0,7,7,9,14,23,34,22,56,0.000333,0.08444,4,1013.277878,56.293215,253.31947,81.832294,2,4
0,0,7,7,9,11,20,30,19,49,0.000333,0.070591,4,847.097907,47.060995,211.774477,66.583073,2,4
0,0,6,6,9,14,23,29,21,50,0.000333,0.075393,4,904.712391,50.2618,226.178098,81.832294,2,4
0,0,6,6,9,15,24,29,22,51,0.000333,0.077944,4,935.33235,51.962908,233.833088,87.132684,2,4
0,0,7,7,9,14,23,34,22,56,0.000333,0.08444,4,1013.277878,56.293215,253.31947,81.832294,2,4
0,0,7,7,9,11,20,30,19,49,0.000333,0.070591,4,847.097907,47.060995,211.774477,66.583073,2,4
0,0,6,6,9,15,24,29,22,51,0.000333,0.077944,4,935.33235,51.962908,233.833088,87.132684,2,4
0,0,6,6,9,14,23,29,21,50,0.000333,0.075393,4,904.712391,50.2618,226.178098,81.832294,2,4
0,0,7,7,9,11,20,30,19,49,0.000333,0.070591,4,847.097907,47.060995,211.774477,66.583073,2,4
0,0,7,7,9,14,23,34,22,56,0.000333,0.08444,4,1013.277878,56.293215,253.31947,81.832294,2,4
0,0,6,6,9,13,22,31,21,52,0.000333,0.077297,4,927.561777,51.53121,231.890444,76.635041,2,4
0,0,6,6,9,12,21,31,20,51,0.000333,0.074669,4,896.032754,49.779597,224.008189,71.548875,2,4
0,0,7,7,9,14,23,34,22,56,0.000333,0.08444,4,1013.277878,56.293215,253.31947,81.832294,2,4
0,0,7,7,9,11,20,30,19,49,0.000333,0.070591,4,847.097907,47.060995,211.774477,66.583073,2,4
0,0,7,7,9,16,25,33,25,58,0.000333,0.089781,4,1077.374636,59.854146,269.343659,92.529325,2,4
0,0,7,7,9,15,24,33,24,57,0.000333,0.087114,4,1045.37145,58.076192,261.342863,87.132684,2,4
0,0,7,7,9,11,20,30,19,49,0.000333,0.070591,4,847.097907,47.060995,211.774477,66.583073,2,4
0,0,7,7,9,14,23,34,22,56,0.000333,0.08444,4,1013.277878,56.293215,253.31947,81.832294,2,4
0,0,8,8,9,17,26,41,29,70,0.000333,0.109677,4,1316.123121,73.117951,329.03078,98.016193,2,4
0,0,8,8,9,16,25,41,28,69,0.000333,0.106809,4,1281.704308,71.205795,320.426077,92.529325,2,4
0,0,6,6,11,12,23,31,19,50,0.000333,0.075393,5,1130.890489,62.827249,226.178098,81.073298,2,4
0,0,6,6,11,12,23,31,19,50,0.000333,0.075393,5,1130.890489,62.827249,226.178098,81.073298,2,4
0,0,6,6,9,15,24,29,22,51,0.000333,0.077944,4,935.33235,51.962908,233.833088,87.132684,2,4
0,0,6,6,9,14,23,29,21,50,0.000333,0.075393,4,904.712391,50.2618,226.178098,81.832294,2,4
0,0,6,6,11,12,23,31,19,50,0.000333,0.075393,5,1130.890489,62.827249,226.178098,81.073298,2,4
0,0,6,6,11,12,23,31,19,50,0.000333,0.075393,5,1130.890489,62.827249,226.178098,81.073298,2,4
0,0,7,7,11,17,28,35,26,61,0.000333,0.09775,5,1466.243251,81.457958,293.24865,107.540616,2,4
0,0,7,7,11,16,27,35,25,60,0.000333,0.095098,5,1426.466251,79.248125,285.29325,102.053748,2,4
0,0,7,7,9,14,23,34,22,56,0.000333,0.08444,4,1013.277878,56.293215,253.31947,81.832294,2,4
0,0,7,7,9,11,20,30,19,49,0.000333,0.070591,4,847.097907,47.060995,211.774477,66.583073,2,4
0,0,7,7,10,18,28,32,28,60,0.000333,0.096147,5,1442.206477,80.122582,288.441295,108.277931,2,4
0,0,7,7,10,17,27,32,27,59,0.000333,0.093513,5,1402.691813,77.927323,280.538363,102.706149,2,4
0,0,7,7,9,11,20,30,19,49,0.000333,0.070591,4,847.097907,47.060995,211.774477,66.583073,2,4
0,0,7,7,9,14,23,34,22,56,0.000333,0.08444,4,1013.277878,56.293215,253.31947,81.832294,2,4
0,0,6,6,9,14,23,29,21,50,0.000333,0.075393,4,904.712391,50.2618,226.178098,81.832294,2,4
0,0,6,6,9,13,22,29,20,49,0.000333,0.072837,4,874.048597,48.558255,218.512149,76.635041,2,4
0,0,7,7,9,11,20,30,19,49,0.000333,0.070591,4,847.097907,47.060995,211.774477,66.583073,2,4
0,0,6,6,11,15,26,31,22,53,0.000333,0.083041,5,1245.616525,69.200918,249.123305,96.657107,2,4
0,0,7,7,9,11,20,30,19,49,0.000333,0.070591,4,847.097907,47.060995,211.774477,66.583073,2,4
0,0,6,6,10,15,25,30,22,52,0.000333,0.080494,5,1207.402609,67.077923,241.480522,91.82264,2,4
0,0,7,7,9,14,23,34,22,56,0.000333,0.08444,4,1013.277878,56.293215,253.31947,81.832294,2,4
0,0,7,7,9,11,20,30,19,49,0.000333,0.070591,4,847.097907,47.060995,211.774477,66.583073,2,4
0,0,9,9,12,19,31,48,32,80,0.000333,0.132112,6,2378.014229,132.111902,396.335705,123.730173,2,4
0,0,6,6,9,10,19,29,17,46,0.000333,0.065135,4,781.618662,43.423259,195.404666,61.748606,2,4
0,0,7,7,9,11,20,30,19,49,0.000333,0.070591,4,847.097907,47.060995,211.774477,66.583073,2,4
0,0,7,7,9,14,23,34,22,56,0.000333,0.08444,4,1013.277878,56.293215,253.31947,81.832294,2,4
0,0,7,7,9,11,20,30,19,49,0.000333,0.070591,4,847.097907,47.060995,211.774477,66.583073,2,4
0,0,7,7,9,11,20,31,19,50,0.000333,0.072032,4,864.385619,48.021423,216.096405,66.583073,2,4
0,0,7,7,9,11,20,31,19,50,0.000333,0.072032,4,864.385619,48.021423,216.096405,66.583073,2,4
0,0,8,8,11,14,25,39,24,63,0.000333,0.097521,5,1462.8147,81.267483,292.56294,91.356717,2,4
0,0,7,7,9,11,20,30,19,49,0.000333,0.070591,4,847.097907,47.060995,211.774477,66.583073,2,4
0,0,7,7,9,14,23,34,22,56,0.000333,0.08444,4,1013.277878,56.293215,253.31947,81.832294,2,4
0,0,7,7,9,11,20,30,19,49,0.000333,0.070591,4,847.097907,47.060995,211.774477,66.583073,2,4
0,0,7,7,9,11,20,31,19,50,0.000333,0.072032,4,864.385619,48.021423,216.096405,66.583073,2,4
0,0,7,7,9,11,20,31,19,50,0.000333,0.072032,4,864.385619,48.021423,216.096405,66.583073,2,4
0,0,8,8,11,14,25,39,24,63,0.000333,0.097521,5,1462.8147,81.267483,292.56294,91.356717,2,4
0,0,7,7,9,11,20,30,19,49,0.000333,0.070591,4,847.097907,47.060995,211.774477,66.583073,2,4
0,0,7,7,9,11,20,30,19,49,0.000333,0.070591,4,847.097907,47.060995,211.774477,66.583073,2,4
0,0,7,7,9,14,23,34,22,56,0.000333,0.08444,4,1013.277878,56.293215,253.31947,81.832294,2,4
0,0,8,8,11,14,25,39,24,63,0.000333,0.097521,5,1462.8147,81.267483,292.56294,91.356717,2,4
0,0,7,7,9,11,20,31,19,50,0.000333,0.072032,4,864.385619,48.021423,216.096405,66.583073,2,4
0,0,7,7,9,11,20,31,19,50,0.000333,0.072032,4,864.385619,48.021423,216.096405,66.583073,2,4
0,0,7,7,9,11,20,30,19,49,0.000333,0.070591,4,847.097907,47.060995,211.774477,66.583073,2,4
0,0,7,7,9,11,20,30,19,49,0.000333,0.070591,4,847.097907,47.060995,211.774477,66.583073,2,4
0,0,7,7,9,14,23,34,22,56,0.000333,0.08444,4,1013.277878,56.293215,253.31947,81.832294,2,4
0,0,8,8,11,14,25,39,24,63,0.000333,0.097521,5,1462.8147,81.267483,292.56294,91.356717,2,4
0,0,7,7,9,11,20,31,19,50,0.000333,0.072032,4,864.385619,48.021423,216.096405,66.583073,2,4
0,0,7,7,9,11,20,31,19,50,0.000333,0.072032,4,864.385619,48.021423,216.096405,66.583073,2,4
0,0,7,7,9,14,23,34,22,56,0.000333,0.08444,4,1013.277878,56.293215,253.31947,81.832294,2,4
0,0,7,7,9,11,20,30,19,49,0.000333,0.070591,4,847.097907,47.060995,211.774477,66.583073,2,4
0,0,7,7,9,11,20,30,19,49,0.000333,0.070591,4,847.097907,47.060995,211.774477,66.583073,2,4
0,0,7,7,9,11,20,31,19,50,0.000333,0.072032,4,864.385619,48.021423,216.096405,66.583073,2,4
0,0,7,7,9,11,20,31,19,50,0.000333,0.072032,4,864.385619,48.021423,216.096405,66.583073,2,4
0,0,8,8,11,14,25,39,24,63,0.000333,0.097521,5,1462.8147,81.267483,292.56294,91.356717,2,4
0,0,7,7,9,14,23,34,22,56,0.000333,0.08444,4,1013.277878,56.293215,253.31947,81.832294,2,4
0,0,7,7,9,11,20,30,19,49,0.000333,0.070591,4,847.097907,47.060995,211.774477,66.583073,2,4
0,0,7,7,9,11,20,30,19,49,0.000333,0.070591,4,847.097907,47.060995,211.774477,66.583073,2,4
0,0,7,7,9,11,20,31,19,50,0.000333,0.072032,4,864.385619,48.021423,216.096405,66.583073,2,4
0,0,7,7,9,11,20,31,19,50,0.000333,0.072032,4,864.385619,48.021423,216.096405,66.583073,2,4
0,0,8,8,11,14,25,39,24,63,0.000333,0.097521,5,1462.8147,81.267483,292.56294,91.356717,2,4
0,0,7,7,9,11,20,30,19,49,0.000333,0.070591,4,847.097907,47.060995,211.774477,66.583073,2,4
0,0,7,7,9,11,20,30,19,49,0.000333,0.070591,4,847.097907,47.060995,211.774477,66.583073,2,4
0,0,7,7,9,14,23,34,22,56,0.000333,0.08444,4,1013.277878,56.293215,253.31947,81.832294,2,4
0,0,7,7,9,11,20,31,19,50,0.000333,0.072032,4,864.385619,48.021423,216.096405,66.583073,2,4
0,0,8,8,11,14,25,39,24,63,0.000333,0.097521,5,1462.8147,81.267483,292.56294,91.356717,2,4
0,0,7,7,9,11,20,31,19,50,0.000333,0.072032,4,864.385619,48.021423,216.096405,66.583073,2,4
0,0,7,7,9,11,20,30,19,49,0.000333,0.070591,4,847.097907,47.060995,211.774477,66.583073,2,4
0,0,7,7,9,14,23,34,22,56,0.000333,0.08444,4,1013.277878,56.293215,253.31947,81.832294,2,4
0,0,7,7,9,11,20,30,19,49,0.000333,0.070591,4,847.097907,47.060995,211.774477,66.583073,2,4
0,0,7,7,9,11,20,31,19,50,0.000333,0.072032,4,864.385619,48.021423,216.096405,66.583073,2,4
0,0,7,7,9,11,20,31,19,50,0.000333,0.072032,4,864.385619,48.021423,216.096405,66.583073,2,4
0,0,8,8,11,14,25,39,24,63,0.000333,0.097521,5,1462.8147,81.267483,292.56294,91.356717,2,4
0,0,7,7,9,11,20,30,19,49,0.000333,0.070591,4,847.097907,47.060995,211.774477,66.583073,2,4
0,0,7,7,9,14,23,34,22,56,0.000333,0.08444,4,1013.277878,56.293215,253.31947,81.832294,2,4
0,0,7,7,9,11,20,30,19,49,0.000333,0.070591,4,847.097907,47.060995,211.774477,66.583073,2,4
0,0,7,7,9,11,20,31,19,50,0.000333,0.072032,4,864.385619,48.021423,216.096405,66.583073,2,4
0,0,7,7,9,11,20,31,19,50,0.000333,0.072032,4,864.385619,48.021423,216.096405,66.583073,2,4
0,0,8,8,11,14,25,39,24,63,0.000333,0.097521,5,1462.8147,81.267483,292.56294,91.356717,2,4
0,0,7,7,9,11,20,30,19,49,0.000333,0.070591,4,847.097907,47.060995,211.774477,66.583073,2,4
0,0,7,7,9,14,23,34,22,56,0.000333,0.08444,4,1013.277878,56.293215,253.31947,81.832294,2,4
0,0,7,7,9,11,20,30,19,49,0.000333,0.070591,4,847.097907,47.060995,211.774477,66.583073,2,4
0,0,7,7,9,11,20,31,19,50,0.000333,0.072032,4,864.385619,48.021423,216.096405,66.583073,2,4
0,0,7,7,9,11,20,31,19,50,0.000333,0.072032,4,864.385619,48.021423,216.096405,66.583073,2,4
0,0,8,8,11,14,25,39,24,63,0.000333,0.097521,5,1462.8147,81.267483,292.56294,91.356717,2,4
0,0,7,7,9,11,20,30,19,49,0.000333,0.070591,4,847.097907,47.060995,211.774477,66.583073,2,4
0,0,7,7,9,14,23,34,22,56,0.000333,0.08444,4,1013.277878,56.293215,253.31947,81.832294,2,4
0,0,7,7,9,11,20,30,19,49,0.000333,0.070591,4,847.097907,47.060995,211.774477,66.583073,2,4
0,0,7,7,9,10,19,31,19,50,0.000333,0.070799,4,849.585503,47.199195,212.396376,61.748606,2,4
0,0,7,7,9,10,19,31,19,50,0.000333,0.070799,4,849.585503,47.199195,212.396376,61.748606,2,4
0,0,10,10,12,20,32,50,34,84,0.000333,0.14,6,2520,140,420,129.458112,2,4
0,0,7,7,9,11,20,30,19,49,0.000333,0.070591,4,847.097907,47.060995,211.774477,66.583073,2,4
0,0,7,7,9,14,23,34,22,56,0.000333,0.08444,4,1013.277878,56.293215,253.31947,81.832294,2,4
0,0,7,7,9,11,20,30,19,49,0.000333,0.070591,4,847.097907,47.060995,211.774477,66.583073,2,4
0,0,7,7,9,11,20,31,19,50,0.000333,0.072032,4,864.385619,48.021423,216.096405,66.583073,2,4
0,0,7,7,9,11,20,31,19,50,0.000333,0.072032,4,864.385619,48.021423,216.096405,66.583073,2,4
0,0,8,8,11,14,25,39,24,63,0.000333,0.097521,5,1462.8147,81.267483,292.56294,91.356717,2,4
0,0,7,7,9,11,20,30,19,49,0.000333,0.070591,4,847.097907,47.060995,211.774477,66.583073,2,4
0,0,7,7,9,14,23,34,22,56,0.000333,0.08444,4,1013.277878,56.293215,253.31947,81.832294,2,4
0,0,7,7,9,11,20,30,19,49,0.000333,0.070591,4,847.097907,47.060995,211.774477,66.583073,2,4
0,0,7,7,9,11,20,31,19,50,0.000333,0.072032,4,864.385619,48.021423,216.096405,66.583073,2,4
0,0,7,7,9,11,20,31,19,50,0.000333,0.072032,4,864.385619,48.021423,216.096405,66.583073,2,4
0,0,8,8,11,14,25,39,24,63,0.000333,0.097521,5,1462.8147,81.267483,292.56294,91.356717,2,4
0,0,7,7,9,11,20,30,19,49,0.000333,0.070591,4,847.097907,47.060995,211.774477,66.583073,2,4
0,0,7,7,9,14,23,34,22,56,0.000333,0.08444,4,1013.277878,56.293215,253.31947,81.832294,2,4
0,0,7,7,9,11,20,30,19,49,0.000333,0.070591,4,847.097907,47.060995,211.774477,66.583073,2,4
0,0,8,8,11,14,25,39,24,63,0.000333,0.097521,5,1462.8147,81.267483,292.56294,91.356717,2,4
0,0,7,7,9,11,20,31,19,50,0.000333,0.072032,4,864.385619,48.021423,216.096405,66.583073,2,4
0,0,7,7,9,11,20,31,19,50,0.000333,0.072032,4,864.385619,48.021423,216.096405,66.583073,2,4
0,0,7,7,9,11,20,30,19,49,0.000333,0.070591,4,847.097907,47.060995,211.774477,66.583073,2,4
0,0,7,7,9,14,23,34,22,56,0.000333,0.08444,4,1013.277878,56.293215,253.31947,81.832294,2,4
0,0,8,8,11,14,25,39,24,63,0.000333,0.097521,5,1462.8147,81.267483,292.56294,91.356717,2,4
0,0,8,8,11,14,25,39,24,63,0.000333,0.097521,5,1462.8147,81.267483,292.56294,91.356717,2,4
0,0,7,7,9,11,20,30,19,49,0.000333,0.070591,4,847.097907,47.060995,211.774477,66.583073,2,4
0,0,7,7,9,14,23,34,22,56,0.000333,0.08444,4,1013.277878,56.293215,253.31947,81.832294,2,4
0,0,8,8,11,14,25,39,24,63,0.000333,0.097521,5,1462.8147,81.267483,292.56294,91.356717,2,4
0,0,8,8,11,14,25,39,24,63,0.000333,0.097521,5,1462.8147,81.267483,292.56294,91.356717,2,4
0,0,7,7,9,14,23,34,22,56,0.000333,0.08444,4,1013.277878,56.293215,253.31947,81.832294,2,4
0,0,7,7,9,11,20,30,19,49,0.000333,0.070591,4,847.097907,47.060995,211.774477,66.583073,2,4
0,0,9,9,12,19,31,48,32,80,0.000333,0.132112,6,2378.014229,132.111902,396.335705,123.730173,2,4
0,0,9,9,12,19,31,48,32,80,0.000333,0.132112,6,2378.014229,132.111902,396.335705,123.730173,2,4
0,0,7,7,9,14,23,34,22,56,0.000333,0.08444,4,1013.277878,56.293215,253.31947,81.832294,2,4
0,0,7,7,9,11,20,30,19,49,0.000333,0.070591,4,847.097907,47.060995,211.774477,66.583073,2,4
0,0,8,8,10,14,24,35,25,60,0.000333,0.091699,5,1375.48875,76.416042,275.09775,86.52225,2,4
0,0,11,11,13,22,35,54,38,92,0.000333,0.157298,6,2831.364225,157.298013,471.894038,146.213212,2,4
0,0,7,7,9,14,23,34,22,56,0.000333,0.08444,4,1013.277878,56.293215,253.31947,81.832294,2,4
0,0,7,7,9,11,20,30,19,49,0.000333,0.070591,4,847.097907,47.060995,211.774477,66.583073,2,4
0,0,8,8,9,16,25,34,29,63,0.000333,0.097521,4,1170.25176,65.013987,292.56294,92.529325,2,4
0,0,6,6,9,14,23,29,21,50,0.000333,0.075393,4,904.712391,50.2618,226.178098,81.832294,2,4
0,0,7,7,9,11,20,30,19,49,0.000333,0.070591,4,847.097907,47.060995,211.774477,66.583073,2,4
0,0,7,7,9,14,23,34,22,56,0.000333,0.08444,4,1013.277878,56.293215,253.31947,81.832294,2,4
0,0,8,8,9,12,21,33,23,56,0.000333,0.08199,4,983.879103,54.65995,245.969776,71.548875,2,4
0,0,11,11,12,21,33,52,38,90,0.000333,0.151332,6,2723.972824,151.331824,453.995471,135.258216,2,4
0,0,7,7,9,14,23,34,22,56,0.000333,0.08444,4,1013.277878,56.293215,253.31947,81.832294,2,4
0,0,7,7,9,11,20,30,19,49,0.000333,0.070591,4,847.097907,47.060995,211.774477,66.583073,2,4
0,0,7,7,10,11,21,34,21,55,0.000333,0.080526,5,1207.887291,67.10485,241.577458,71.273029,2,4
0,0,7,7,10,11,21,34,21,55,0.000333,0.080526,5,1207.887291,67.10485,241.577458,71.273029,2,4
0,0,7,7,9,11,20,30,19,49,0.000333,0.070591,4,847.097907,47.060995,211.774477,66.583073,2,4
0,0,7,7,9,14,23,34,22,56,0.000333,0.08444,4,1013.277878,56.293215,253.31947,81.832294,2,4
0,0,7,7,10,15,25,31,23,54,0.000333,0.083589,5,1253.841171,69.657843,250.768234,91.82264,2,4
0,0,7,7,10,15,25,31,23,54,0.000333,0.083589,5,1253.841171,69.657843,250.768234,91.82264,2,4
0,0,7,7,9,14,23,34,22,56,0.000333,0.08444,4,1013.277878,56.293215,253.31947,81.832294,2,4
0,0,7,7,9,11,20,30,19,49,0.000333,0.070591,4,847.097907,47.060995,211.774477,66.583073,2,4
0,0,8,8,10,14,24,35,25,60,0.000333,0.091699,5,1375.48875,76.416042,275.09775,86.52225,2,4
0,0,11,11,13,22,35,54,38,92,0.000333,0.157298,6,2831.364225,157.298013,471.894038,146.213212,2,4
0,0,7,7,9,11,20,30,19,49,0.000333,0.070591,4,847.097907,47.060995,211.774477,66.583073,2,4
0,0,7,7,9,14,23,34,22,56,0.000333,0.08444,4,1013.277878,56.293215,253.31947,81.832294,2,4
0,0,8,8,10,12,22,35,22,57,0.000333,0.084729,5,1270.938011,70.607667,254.187602,76.238831,2,4
0,0,11,11,13,20,33,54,36,90,0.000333,0.151332,6,2723.972824,151.331824,453.995471,134.544278,2,4
0,0,7,7,9,11,20,30,19,49,0.000333,0.070591,4,847.097907,47.060995,211.774477,66.583073,2,4
0,0,7,7,9,14,23,34,22,56,0.000333,0.08444,4,1013.277878,56.293215,253.31947,81.832294,2,4
0,0,6,6,10,13,23,30,20,50,0.000333,0.075393,5,1130.890489,62.827249,226.178098,81.324997,2,4
0,0,6,6,10,12,22,30,19,49,0.000333,0.072837,5,1092.560747,60.697819,218.512149,76.238831,2,4
0,0,7,7,9,11,20,30,19,49,0.000333,0.070591,4,847.097907,47.060995,211.774477,66.583073,2,4
0,0,7,7,9,14,23,34,22,56,0.000333,0.08444,4,1013.277878,56.293215,253.31947,81.832294,2,4
0,0,9,9,9,17,26,34,30,64,0.000333,0.100276,4,1203.312568,66.850698,300.828142,98.016193,2,4
0,0,12,12,12,24,36,53,42,95,0.000333,0.163714,6,2946.857251,163.714292,491.142875,153.05865,2,4
0,0,7,7,9,11,20,30,19,49,0.000333,0.070591,4,847.097907,47.060995,211.774477,66.583073,2,4
0,0,7,7,9,14,23,34,22,56,0.000333,0.08444,4,1013.277878,56.293215,253.31947,81.832294,2,4
0,0,6,6,9,15,24,29,22,51,0.000333,0.077944,4,935.33235,51.962908,233.833088,87.132684,2,4
0,0,6,6,9,14,23,29,21,50,0.000333,0.075393,4,904.712391,50.2618,226.178098,81.832294,2,4
0,0,7,7,9,14,23,34,22,56,0.000333,0.08444,4,1013.277878,56.293215,253.31947,81.832294,2,4
0,0,7,7,9,11,20,30,19,49,0.000333,0.070591,4,847.097907,47.060995,211.774477,66.583073,2,4
0,0,6,6,9,15,24,29,22,51,0.000333,0.077944,4,935.33235,51.962908,233.833088,87.132684,2,4
0,0,6,6,9,14,23,29,21,50,0.000333,0.075393,4,904.712391,50.2618,226.178098,81.832294,2,4
0,0,7,7,9,14,23,34,22,56,0.000333,0.08444,4,1013.277878,56.293215,253.31947,81.832294,2,4
0,0,7,7,9,11,20,30,19,49,0.000333,0.070591,4,847.097907,47.060995,211.774477,66.583073,2,4
0,0,6,6,9,15,24,29,22,51,0.000333,0.077944,4,935.33235,51.962908,233.833088,87.132684,2,4
0,0,6,6,9,14,23,29,21,50,0.000333,0.075393,4,904.712391,50.2618,226.178098,81.832294,2,4
0,0,7,7,9,14,23,34,22,56,0.000333,0.08444,4,1013.277878,56.293215,253.31947,81.832294,2,4
0,0,7,7,9,11,20,30,19,49,0.000333,0.070591,4,847.097907,47.060995,211.774477,66.583073,2,4
0,0,6,6,9,15,24,29,22,51,0.000333,0.077944,4,935.33235,51.962908,233.833088,87.132684,2,4
0,0,6,6,9,14,23,29,21,50,0.000333,0.075393,4,904.712391,50.2618,226.178098,81.832294,2,4
0,0,7,7,9,14,23,34,22,56,0.000333,0.08444,4,1013.277878,56.293215,253.31947,81.832294,2,4
0,0,7,7,9,11,20,30,19,49,0.000333,0.070591,4,847.097907,47.060995,211.774477,66.583073,2,4
0,0,6,6,9,12,21,31,20,51,0.000333,0.074669,4,896.032754,49.779597,224.008189,71.548875,2,4
0,0,6,6,9,13,22,31,21,52,0.000333,0.077297,4,927.561777,51.53121,231.890444,76.635041,2,4
0,0,7,7,9,14,23,34,22,56,0.000333,0.08444,4,1013.277878,56.293215,253.31947,81.832294,2,4
0,0,7,7,9,11,20,30,19,49,0.000333,0.070591,4,847.097907,47.060995,211.774477,66.583073,2,4
0,0,7,7,9,16,25,33,25,58,0.000333,0.089781,4,1077.374636,59.854146,269.343659,92.529325,2,4
0,0,7,7,9,15,24,33,24,57,0.000333,0.087114,4,1045.37145,58.076192,261.342863,87.132684,2,4
0,0,7,7,9,11,20,30,19,49,0.000333,0.070591,4,847.097907,47.060995,211.774477,66.583073,2,4
0,0,7,7,9,14,23,34,22,56,0.000333,0.08444,4,1013.277878,56.293215,253.31947,81.832294,2,4
0,0,8,8,9,17,26,41,29,70,0.000333,0.109677,4,1316.123121,73.117951,329.03078,98.016193,2,4
0,0,8,8,9,16,25,41,28,69,0.000333,0.106809,4,1281.704308,71.205795,320.426077,92.529325,2,4
0,0,7,7,9,14,23,34,22,56,0.000333,0.08444,4,1013.277878,56.293215,253.31947,81.832294,2,4
0,0,7,7,9,11,20,30,19,49,0.000333,0.070591,4,847.097907,47.060995,211.774477,66.583073,2,4
0,0,6,6,9,15,24,29,22,51,0.000333,0.077944,4,935.33235,51.962908,233.833088,87.132684,2,4
0,0,6,6,9,14,23,29,21,50,0.000333,0.075393,4,904.712391,50.2618,226.178098,81.832294,2,4
0,0,6,6,11,12,23,31,19,50,0.000333,0.075393,5,1130.890489,62.827249,226.178098,81.073298,2,4
0,0,6,6,11,12,23,31,19,50,0.000333,0.075393,5,1130.890489,62.827249,226.178098,81.073298,2,4
0,0,9,9,12,16,28,47,30,77,0.000333,0.123389,6,2220.997974,123.388776,370.166329,107.01955,3,4
0,0,12,12,12,20,32,62,40,102,0.000333,0.17,12,6120,340,510,129.458112,3,4
0,0,10,10,12,17,29,51,33,84,0.000333,0.136023,6,2448.422422,136.023468,408.070404,112.506418,3,4
0,0,14,14,12,22,34,67,46,113,0.000333,0.191628,12,6898.599613,383.255534,574.883301,141.127046,3,4
0,0,7,7,9,11,20,31,19,50,0.000333,0.072032,4,864.385619,48.021423,216.096405,66.583073,2,4
0,0,10,10,9,15,24,46,29,75,0.000333,0.114624,4,1375.48875,76.416042,343.872188,87.132684,2,4
0,0,8,8,9,12,21,33,21,54,0.000333,0.079062,4,948.740563,52.707809,237.185141,71.548875,2,4
0,0,12,12,11,17,28,51,35,86,0.000333,0.137811,10,4134.325233,229.684735,413.432523,107.540616,2,4
0,0,7,7,9,11,20,31,19,50,0.000333,0.072032,4,864.385619,48.021423,216.096405,66.583073,2,4
0,0,10,10,9,15,24,46,29,75,0.000333,0.114624,4,1375.48875,76.416042,343.872188,87.132684,2,4
0,0,8,8,9,12,21,33,21,54,0.000333,0.079062,4,948.740563,52.707809,237.185141,71.548875,2,4
0,0,12,12,11,17,28,51,35,86,0.000333,0.137811,10,4134.325233,229.684735,413.432523,107.540616,2,4
0,0,7,7,9,14,23,34,22,56,0.000333,0.08444,4,1013.277878,56.293215,253.31947,81.832294,2,4
0,0,10,10,9,17,26,49,32,81,0.000333,0.126912,4,1522.942469,84.607915,380.735617,98.016193,2,4
0,0,8,8,9,15,24,36,24,60,0.000333,0.091699,4,1100.391,61.132833,275.09775,87.132684,2,4
0,0,12,12,11,19,30,54,38,92,0.000333,0.150478,10,4514.339348,250.79663,451.433935,118.764371,2,4
0,0,7,7,9,11,20,30,19,49,0.000333,0.070591,4,847.097907,47.060995,211.774477,66.583073,2,4
0,0,10,10,9,14,23,45,29,74,0.000333,0.111581,8,2677.948678,148.774927,334.743585,81.832294,2,4
0,0,8,8,9,12,21,32,21,53,0.000333,0.077598,4,931.171294,51.731739,232.792823,71.548875,2,4
0,0,12,12,11,16,27,50,35,85,0.000333,0.134722,10,4041.654377,224.536354,404.165438,102.053748,2,4
0,0,7,7,9,11,20,30,19,49,0.000333,0.070591,4,847.097907,47.060995,211.774477,66.583073,2,4
0,0,10,10,9,14,23,45,29,74,0.000333,0.111581,8,2677.948678,148.774927,334.743585,81.832294,2,4
0,0,8,8,9,12,21,32,21,53,0.000333,0.077598,4,931.171294,51.731739,232.792823,71.548875,2,4
0,0,12,12,11,16,27,50,35,85,0.000333,0.134722,10,4041.654377,224.536354,404.165438,102.053748,2,4
0,0,9,9,12,16,28,47,30,77,0.000333,0.123389,6,2220.997974,123.388776,370.166329,107.01955,3,4
0,0,12,12,12,20,32,62,40,102,0.000333,0.17,12,6120,340,510,129.458112,3,4
0,0,10,10,12,17,29,49,32,81,0.000333,0.131165,6,2360.978764,131.165487,393.496461,112.506418,3,4
0,0,14,14,12,22,34,67,46,113,0.000333,0.191628,12,6898.599613,383.255534,574.883301,141.127046,3,4
0,0,7,7,9,11,20,31,19,50,0.000333,0.072032,4,864.385619,48.021423,216.096405,66.583073,2,4
0,0,10,10,9,15,24,46,29,75,0.000333,0.114624,4,1375.48875,76.416042,343.872188,87.132684,2,4
0,0,8,8,9,12,21,33,21,54,0.000333,0.079062,4,948.740563,52.707809,237.185141,71.548875,2,4
0,0,12,12,11,17,28,51,35,86,0.000333,0.137811,10,4134.325233,229.684735,413.432523,107.540616,2,4
0,0,7,7,9,11,20,31,19,50,0.000333,0.072032,4,864.385619,48.021423,216.096405,66.583073,2,4
0,0,10,10,9,15,24,46,29,75,0.000333,0.114624,4,1375.48875,76.416042,343.872188,87.132684,2,4
0,0,8,8,9,12,21,33,21,54,0.000333,0.079062,4,948.740563,52.707809,237.185141,71.548875,2,4
0,0,12,12,11,17,28,51,35,86,0.000333,0.137811,10,4134.325233,229.684735,413.432523,107.540616,2,4
0,0,7,7,9,11,20,30,19,49,0.000333,0.070591,4,847.097907,47.060995,211.774477,66.583073,2,4
0,0,10,10,9,14,23,45,29,74,0.000333,0.111581,8,2677.948678,148.774927,334.743585,81.832294,2,4
0,0,8,8,9,12,21,32,21,53,0.000333,0.077598,4,931.171294,51.731739,232.792823,71.548875,2,4
0,0,12,12,11,16,27,50,35,85,0.000333,0.134722,10,4041.654377,224.536354,404.165438,102.053748,2,4
0,0,7,7,9,11,20,30,19,49,0.000333,0.070591,4,847.097907,47.060995,211.774477,66.583073,2,4
0,0,10,10,9,14,23,45,29,74,0.000333,0.111581,8,2677.948678,148.774927,334.743585,81.832294,2,4
0,0,8,8,9,12,21,32,21,53,0.000333,0.077598,4,931.171294,51.731739,232.792823,71.548875,2,4
0,0,12,12,11,16,27,50,35,85,0.000333,0.134722,10,4041.654377,224.536354,404.165438,102.053748,2,4
0,0,7,7,9,14,23,34,22,56,0.000333,0.08444,4,1013.277878,56.293215,253.31947,81.832294,2,4
0,0,10,10,9,17,26,49,32,81,0.000333,0.126912,4,1522.942469,84.607915,380.735617,98.016193,2,4
0,0,8,8,9,15,24,36,24,60,0.000333,0.091699,4,1100.391,61.132833,275.09775,87.132684,2,4
0,0,12,12,11,19,30,54,38,92,0.000333,0.150478,10,4514.339348,250.79663,451.433935,118.764371,2,4
0,0,7,7,9,11,20,31,19,50,0.000333,0.072032,4,864.385619,48.021423,216.096405,66.583073,2,4
0,0,10,10,9,15,24,46,29,75,0.000333,0.114624,4,1375.48875,76.416042,343.872188,87.132684,2,4
0,0,8,8,9,12,21,33,21,54,0.000333,0.079062,4,948.740563,52.707809,237.185141,71.548875,2,4
0,0,12,12,11,17,28,51,35,86,0.000333,0.137811,10,4134.325233,229.684735,413.432523,107.540616,2,4
0,0,9,9,12,16,28,47,30,77,0.000333,0.123389,6,2220.997974,123.388776,370.166329,107.01955,3,4
0,0,12,12,12,20,32,62,40,102,0.000333,0.17,12,6120,340,510,129.458112,3,4
0,0,10,10,12,17,29,49,32,81,0.000333,0.131165,6,2360.978764,131.165487,393.496461,112.506418,3,4
0,0,14,14,12,22,34,67,46,113,0.000333,0.191628,12,6898.599613,383.255534,574.883301,141.127046,3,4
0,0,7,7,9,11,20,31,19,50,0.000333,0.072032,4,864.385619,48.021423,216.096405,66.583073,2,4
0,0,10,10,9,15,24,46,29,75,0.000333,0.114624,4,1375.48875,76.416042,343.872188,87.132684,2,4
0,0,8,8,9,12,21,33,21,54,0.000333,0.079062,4,948.740563,52.707809,237.185141,71.548875,2,4
0,0,12,12,11,17,28,51,35,86,0.000333,0.137811,10,4134.325233,229.684735,413.432523,107.540616,2,4
0,0,7,7,9,11,20,30,19,49,0.000333,0.070591,4,847.097907,47.060995,211.774477,66.583073,2,4
0,0,10,10,9,14,23,45,29,74,0.000333,0.111581,8,2677.948678,148.774927,334.743585,81.832294,2,4
0,0,8,8,9,12,21,32,21,53,0.000333,0.077598,4,931.171294,51.731739,232.792823,71.548875,2,4
0,0,12,12,11,16,27,50,35,85,0.000333,0.134722,10,4041.654377,224.536354,404.165438,102.053748,2,4
0,0,7,7,9,11,20,30,19,49,0.000333,0.070591,4,847.097907,47.060995,211.774477,66.583073,2,4
0,0,10,10,9,14,23,45,29,74,0.000333,0.111581,8,2677.948678,148.774927,334.743585,81.832294,2,4
0,0,8,8,9,12,21,32,21,53,0.000333,0.077598,4,931.171294,51.731739,232.792823,71.548875,2,4
0,0,12,12,11,16,27,50,35,85,0.000333,0.134722,10,4041.654377,224.536354,404.165438,102.053748,2,4
0,0,7,7,9,14,23,34,22,56,0.000333,0.08444,4,1013.277878,56.293215,253.31947,81.832294,2,4
0,0,10,10,9,17,26,49,32,81,0.000333,0.126912,4,1522.942469,84.607915,380.735617,98.016193,2,4
0,0,8,8,9,15,24,36,24,60,0.000333,0.091699,4,1100.391,61.132833,275.09775,87.132684,2,4
0,0,12,12,11,19,30,54,38,92,0.000333,0.150478,10,4514.339348,250.79663,451.433935,118.764371,2,4
0,0,7,7,9,11,20,31,19,50,0.000333,0.072032,4,864.385619,48.021423,216.096405,66.583073,2,4
0,0,10,10,9,15,24,46,29,75,0.000333,0.114624,4,1375.48875,76.416042,343.872188,87.132684,2,4
0,0,8,8,9,12,21,33,21,54,0.000333,0.079062,4,948.740563,52.707809,237.185141,71.548875,2,4
0,0,12,12,11,17,28,51,35,86,0.000333,0.137811,10,4134.325233,229.684735,413.432523,107.540616,2,4
0,0,9,9,12,16,28,47,30,77,0.000333,0.123389,6,2220.997974,123.388776,370.166329,107.01955,3,4
0,0,12,12,12,20,32,62,40,102,0.000333,0.17,12,6120,340,510,129.458112,3,4
0,0,10,10,12,17,29,49,32,81,0.000333,0.131165,6,2360.978764,131.165487,393.496461,112.506418,3,4
0,0,14,14,12,22,34,67,46,113,0.000333,0.191628,12,6898.599613,383.255534,574.883301,141.127046,3,4
0,0,7,7,9,11,20,31,19,50,0.000333,0.072032,4,864.385619,48.021423,216.096405,66.583073,2,4
0,0,10,10,9,15,24,46,29,75,0.000333,0.114624,4,1375.48875,76.416042,343.872188,87.132684,2,4
0,0,8,8,9,12,21,33,21,54,0.000333,0.079062,4,948.740563,52.707809,237.185141,71.548875,2,4
0,0,12,12,11,17,28,51,35,86,0.000333,0.137811,10,4134.325233,229.684735,413.432523,107.540616,2,4
0,0,7,7,9,11,20,30,19,49,0.000333,0.070591,4,847.097907,47.060995,211.774477,66.583073,2,4
0,0,10,10,9,14,23,45,29,74,0.000333,0.111581,8,2677.948678,148.774927,334.743585,81.832294,2,4
0,0,8,8,9,12,21,32,21,53,0.000333,0.077598,4,931.171294,51.731739,232.792823,71.548875,2,4
0,0,12,12,11,16,27,50,35,85,0.000333,0.134722,10,4041.654377,224.536354,404.165438,102.053748,2,4
0,0,7,7,9,11,20,30,19,49,0.000333,0.070591,4,847.097907,47.060995,211.774477,66.583073,2,4
0,0,10,10,9,14,23,45,29,74,0.000333,0.111581,8,2677.948678,148.774927,334.743585,81.832294,2,4
0,0,8,8,9,12,21,32,21,53,0.000333,0.077598,4,931.171294,51.731739,232.792823,71.548875,2,4
0,0,12,12,11,16,27,50,35,85,0.000333,0.134722,10,4041.654377,224.536354,404.165438,102.053748,2,4
0,0,7,7,9,14,23,34,22,56,0.000333,0.08444,4,1013.277878,56.293215,253.31947,81.832294,2,4
0,0,10,10,9,17,26,49,32,81,0.000333,0.126912,4,1522.942469,84.607915,380.735617,98.016193,2,4
0,0,8,8,9,15,24,36,24,60,0.000333,0.091699,4,1100.391,61.132833,275.09775,87.132684,2,4
0,0,12,12,11,19,30,54,38,92,0.000333,0.150478,10,4514.339348,250.79663,451.433935,118.764371,2,4
0,0,7,7,9,11,20,31,19,50,0.000333,0.072032,4,864.385619,48.021423,216.096405,66.583073,2,4
0,0,10,10,9,15,24,46,29,75,0.000333,0.114624,4,1375.48875,76.416042,343.872188,87.132684,2,4
0,0,8,8,9,12,21,33,21,54,0.000333,0.079062,4,948.740563,52.707809,237.185141,71.548875,2,4
0,0,12,12,11,17,28,51,35,86,0.000333,0.137811,10,4134.325233,229.684735,413.432523,107.540616,2,4
0,0,9,9,12,16,28,47,30,77,0.000333,0.123389,6,2220.997974,123.388776,370.166329,107.01955,3,4
0,0,12,12,12,20,32,62,40,102,0.000333,0.17,12,6120,340,510,129.458112,3,4
0,0,10,10,12,17,29,49,32,81,0.000333,0.131165,6,2360.978764,131.165487,393.496461,112.506418,3,4
0,0,14,14,12,22,34,67,46,113,0.000333,0.191628,12,6898.599613,383.255534,574.883301,141.127046,3,4
0,0,7,7,9,11,20,31,19,50,0.000333,0.072032,4,864.385619,48.021423,216.096405,66.583073,2,4
0,0,10,10,9,15,24,46,29,75,0.000333,0.114624,4,1375.48875,76.416042,343.872188,87.132684,2,4
0,0,8,8,9,12,21,33,21,54,0.000333,0.079062,4,948.740563,52.707809,237.185141,71.548875,2,4
0,0,12,12,11,17,28,51,35,86,0.000333,0.137811,10,4134.325233,229.684735,413.432523,107.540616,2,4
0,0,7,7,9,11,20,30,19,49,0.000333,0.070591,4,847.097907,47.060995,211.774477,66.583073,2,4
0,0,10,10,9,14,23,45,29,74,0.000333,0.111581,8,2677.948678,148.774927,334.743585,81.832294,2,4
0,0,8,8,9,12,21,32,21,53,0.000333,0.077598,4,931.171294,51.731739,232.792823,71.548875,2,4
0,0,12,12,11,16,27,50,35,85,0.000333,0.134722,10,4041.654377,224.536354,404.165438,102.053748,2,4
0,0,7,7,9,11,20,30,19,49,0.000333,0.070591,4,847.097907,47.060995,211.774477,66.583073,2,4
0,0,10,10,9,14,23,45,29,74,0.000333,0.111581,8,2677.948678,148.774927,334.743585,81.832294,2,4
0,0,8,8,9,12,21,32,21,53,0.000333,0.077598,4,931.171294,51.731739,232.792823,71.548875,2,4
0,0,12,12,11,16,27,50,35,85,0.000333,0.134722,10,4041.654377,224.536354,404.165438,102.053748,2,4
0,0,7,7,9,14,23,34,22,56,0.000333,0.08444,4,1013.277878,56.293215,253.31947,81.832294,2,4
0,0,10,10,9,17,26,49,32,81,0.000333,0.126912,4,1522.942469,84.607915,380.735617,98.016193,2,4
0,0,8,8,9,15,24,36,24,60,0.000333,0.091699,4,1100.391,61.132833,275.09775,87.132684,2,4
0,0,12,12,11,19,30,54,38,92,0.000333,0.150478,10,4514.339348,250.79663,451.433935,118.764371,2,4
0,0,9,9,12,16,28,47,30,77,0.000333,0.123389,6,2220.997974,123.388776,370.166329,107.01955,3,4
0,0,12,12,12,20,32,62,40,102,0.000333,0.17,12,6120,340,510,129.458112,3,4
0,0,10,10,12,17,29,49,32,81,0.000333,0.131165,6,2360.978764,131.165487,393.496461,112.506418,3,4
0,0,14,14,12,22,34,67,46,113,0.000333,0.191628,12,6898.599613,383.255534,574.883301,141.127046,3,4
0,0,7,7,9,11,20,31,19,50,0.000333,0.072032,4,864.385619,48.021423,216.096405,66.583073,2,4
0,0,10,10,9,15,24,46,29,75,0.000333,0.114624,4,1375.48875,76.416042,343.872188,87.132684,2,4
0,0,8,8,9,12,21,33,21,54,0.000333,0.079062,4,948.740563,52.707809,237.185141,71.548875,2,4
0,0,12,12,11,17,28,51,35,86,0.000333,0.137811,10,4134.325233,229.684735,413.432523,107.540616,2,4
0,0,7,7,9,11,20,31,19,50,0.000333,0.072032,4,864.385619,48.021423,216.096405,66.583073,2,4
0,0,10,10,9,15,24,46,29,75,0.000333,0.114624,4,1375.48875,76.416042,343.872188,87.132684,2,4
0,0,8,8,9,12,21,33,21,54,0.000333,0.079062,4,948.740563,52.707809,237.185141,71.548875,2,4
0,0,12,12,11,17,28,51,35,86,0.000333,0.137811,10,4134.325233,229.684735,413.432523,107.540616,2,4
0,0,7,7,9,11,20,30,19,49,0.000333,0.070591,4,847.097907,47.060995,211.774477,66.583073,2,4
0,0,10,10,9,14,23,45,29,74,0.000333,0.111581,8,2677.948678,148.774927,334.743585,81.832294,2,4
0,0,8,8,9,12,21,32,21,53,0.000333,0.077598,4,931.171294,51.731739,232.792823,71.548875,2,4
0,0,12,12,11,16,27,50,35,85,0.000333,0.134722,10,4041.654377,224.536354,404.165438,102.053748,2,4
0,0,7,7,9,11,20,30,19,49,0.000333,0.070591,4,847.097907,47.060995,211.774477,66.583073,2,4
0,0,10,10,9,14,23,45,29,74,0.000333,0.111581,8,2677.948678,148.774927,334.743585,81.832294,2,4
0,0,8,8,9,12,21,32,21,53,0.000333,0.077598,4,931.171294,51.731739,232.792823,71.548875,2,4
0,0,12,12,11,16,27,50,35,85,0.000333,0.134722,10,4041.654377,224.536354,404.165438,102.053748,2,4
0,0,7,7,9,14,23,34,22,56,0.000333,0.08444,4,1013.277878,56.293215,253.31947,81.832294,2,4
0,0,10,10,9,17,26,49,32,81,0.000333,0.126912,4,1522.942469,84.607915,380.735617,98.016193,2,4
0,0,8,8,9,15,24,36,24,60,0.000333,0.091699,4,1100.391,61.132833,275.09775,87.132684,2,4
0,0,12,12,11,19,30,54,38,92,0.000333,0.150478,10,4514.339348,250.79663,451.433935,118.764371,2,4
0,0,9,9,12,16,28,47,30,77,0.000333,0.123389,6,2220.997974,123.388776,370.166329,107.01955,3,4
0,0,12,12,12,20,32,62,40,102,0.000333,0.17,12,6120,340,510,129.458112,3,4
0,0,10,10,12,17,29,49,32,81,0.000333,0.131165,6,2360.978764,131.165487,393.496461,112.506418,3,4
0,0,14,14,12,22,34,67,46,113,0.000333,0.191628,12,6898.599613,383.255534,574.883301,141.127046,3,4
0,0,7,7,9,11,20,31,19,50,0.000333,0.072032,4,864.385619,48.021423,216.096405,66.583073,2,4
0,0,10,10,9,15,24,46,29,75,0.000333,0.114624,4,1375.48875,76.416042,343.872188,87.132684,2,4
0,0,8,8,9,12,21,33,21,54,0.000333,0.079062,4,948.740563,52.707809,237.185141,71.548875,2,4
0,0,12,12,11,17,28,51,35,86,0.000333,0.137811,10,4134.325233,229.684735,413.432523,107.540616,2,4
0,0,7,7,9,11,20,31,19,50,0.000333,0.072032,4,864.385619,48.021423,216.096405,66.583073,2,4
0,0,10,10,9,15,24,46,29,75,0.000333,0.114624,4,1375.48875,76.416042,343.872188,87.132684,2,4
0,0,8,8,9,12,21,33,21,54,0.000333,0.079062,4,948.740563,52.707809,237.185141,71.548875,2,4
0,0,12,12,11,17,28,51,35,86,0.000333,0.137811,10,4134.325233,229.684735,413.432523,107.540616,2,4
0,0,7,7,9,11,20,30,19,49,0.000333,0.070591,4,847.097907,47.060995,211.774477,66.583073,2,4
0,0,10,10,9,14,23,45,29,74,0.000333,0.111581,8,2677.948678,148.774927,334.743585,81.832294,2,4
0,0,8,8,9,12,21,32,21,53,0.000333,0.077598,4,931.171294,51.731739,232.792823,71.548875,2,4
0,0,12,12,11,16,27,50,35,85,0.000333,0.134722,10,4041.654377,224.536354,404.165438,102.053748,2,4
0,0,7,7,9,11,20,30,19,49,0.000333,0.070591,4,847.097907,47.060995,211.774477,66.583073,2,4
0,0,10,10,9,14,23,45,29,74,0.000333,0.111581,8,2677.948678,148.774927,334.743585,81.832294,2,4
0,0,8,8,9,12,21,32,21,53,0.000333,0.077598,4,931.171294,51.731739,232.792823,71.548875,2,4
0,0,12,12,11,16,27,50,35,85,0.000333,0.134722,10,4041.654377,224.536354,404.165438,102.053748,2,4
0,0,7,7,9,14,23,34,22,56,0.000333,0.08444,4,1013.277878,56.293215,253.31947,81.832294,2,4
0,0,10,10,9,17,26,49,32,81,0.000333,0.126912,4,1522.942469,84.607915,380.735617,98.016193,2,4
0,0,8,8,9,15,24,36,24,60,0.000333,0.091699,4,1100.391,61.132833,275.09775,87.132684,2,4
0,0,12,12,11,19,30,54,38,92,0.000333,0.150478,10,4514.339348,250.79663,451.433935,118.764371,2,4
0,0,9,9,12,16,28,47,30,77,0.000333,0.123389,6,2220.997974,123.388776,370.166329,107.01955,3,4
0,0,12,12,12,20,32,62,40,102,0.000333,0.17,12,6120,340,510,129.458112,3,4
0,0,10,10,12,17,29,49,32,81,0.000333,0.131165,6,2360.978764,131.165487,393.496461,112.506418,3,4
0,0,14,14,12,22,34,67,46,113,0.000333,0.191628,12,6898.599613,383.255534,574.883301,141.127046,3,4
0,0,7,7,9,11,20,31,19,50,0.000333,0.072032,4,864.385619,48.021423,216.096405,66.583073,2,4
0,0,10,10,9,15,24,46,29,75,0.000333,0.114624,4,1375.48875,76.416042,343.872188,87.132684,2,4
0,0,8,8,9,12,21,33,21,54,0.000333,0.079062,4,948.740563,52.707809,237.185141,71.548875,2,4
0,0,12,12,11,17,28,51,35,86,0.000333,0.137811,10,4134.325233,229.684735,413.432523,107.540616,2,4
0,0,7,7,9,11,20,31,19,50,0.000333,0.072032,4,864.385619,48.021423,216.096405,66.583073,2,4
0,0,10,10,9,15,24,46,29,75,0.000333,0.114624,4,1375.48875,76.416042,343.872188,87.132684,2,4
0,0,8,8,9,12,21,33,21,54,0.000333,0.079062,4,948.740563,52.707809,237.185141,71.548875,2,4
0,0,12,12,11,17,28,51,35,86,0.000333,0.137811,10,4134.325233,229.684735,413.432523,107.540616,2,4
0,0,7,7,9,14,23,34,22,56,0.000333,0.08444,4,1013.277878,56.293215,253.31947,81.832294,2,4
0,0,10,10,9,17,26,49,32,81,0.000333,0.126912,4,1522.942469,84.607915,380.735617,98.016193,2,4
0,0,8,8,9,15,24,36,24,60,0.000333,0.091699,4,1100.391,61.132833,275.09775,87.132684,2,4
0,0,12,12,11,19,30,54,38,92,0.000333,0.150478,10,4514.339348,250.79663,451.433935,118.764371,2,4
0,0,7,7,9,11,20,30,19,49,0.000333,0.070591,4,847.097907,47.060995,211.774477,66.583073,2,4
0,0,10,10,9,14,23,45,29,74,0.000333,0.111581,8,2677.948678,148.774927,334.743585,81.832294,2,4
0,0,8,8,9,12,21,32,21,53,0.000333,0.077598,4,931.171294,51.731739,232.792823,71.548875,2,4
0,0,12,12,11,16,27,50,35,85,0.000333,0.134722,10,4041.654377,224.536354,404.165438,102.053748,2,4
0,0,7,7,9,11,20,30,19,49,0.000333,0.070591,4,847.097907,47.060995,211.774477,66.583073,2,4
0,0,10,10,9,14,23,45,29,74,0.000333,0.111581,8,2677.948678,148.774927,334.743585,81.832294,2,4
0,0,8,8,9,12,21,32,21,53,0.000333,0.077598,4,931.171294,51.731739,232.792823,71.548875,2,4
0,0,12,12,11,16,27,50,35,85,0.000333,0.134722,10,4041.654377,224.536354,404.165438,102.053748,2,4
0,0,7,7,9,10,19,31,19,50,0.000333,0.070799,4,849.585503,47.199195,212.396376,61.748606,2,4
0,0,10,10,9,14,23,46,29,75,0.000333,0.113089,8,2714.137174,150.785399,339.267147,81.832294,2,4
0,0,8,8,9,11,20,33,21,54,0.000333,0.077795,4,933.536468,51.863137,233.384117,66.583073,2,4
0,0,12,12,11,16,27,51,35,86,0.000333,0.136307,10,4089.203252,227.177958,408.920325,102.053748,2,4
0,0,7,7,9,10,19,31,19,50,0.000333,0.070799,4,849.585503,47.199195,212.396376,61.748606,2,4
0,0,10,10,9,14,23,46,29,75,0.000333,0.113089,8,2714.137174,150.785399,339.267147,81.832294,2,4
0,0,8,8,9,11,20,33,21,54,0.000333,0.077795,4,933.536468,51.863137,233.384117,66.583073,2,4
0,0,12,12,11,16,27,51,35,86,0.000333,0.136307,10,4089.203252,227.177958,408.920325,102.053748,2,4
0,0,10,10,12,17,29,49,32,81,0.000333,0.131165,6,2360.978764,131.165487,393.496461,112.506418,3,4
0,0,13,13,12,21,33,64,42,106,0.000333,0.178235,12,6416.46932,356.470518,534.705777,135.258216,3,4
0,0,11,11,12,18,30,51,34,85,0.000333,0.139029,6,2502.514204,139.028567,417.085701,118.0782,3,4
0,0,15,15,12,23,35,69,48,117,0.000333,0.200042,12,7201.513356,400.084075,600.126113,147.061475,3,4
0,0,7,7,9,11,20,30,19,49,0.000333,0.070591,4,847.097907,47.060995,211.774477,66.583073,2,4
0,0,10,10,9,14,23,45,29,74,0.000333,0.111581,8,2677.948678,148.774927,334.743585,81.832294,2,4
0,0,8,8,9,12,21,32,21,53,0.000333,0.077598,4,931.171294,51.731739,232.792823,71.548875,2,4
0,0,12,12,11,16,27,50,35,85,0.000333,0.134722,10,4041.654377,224.536354,404.165438,102.053748,2,4
0,0,7,7,9,11,20,30,19,49,0.000333,0.070591,4,847.097907,47.060995,211.774477,66.583073,2,4
0,0,10,10,9,14,23,45,29,74,0.000333,0.111581,8,2677.948678,148.774927,334.743585,81.832294,2,4
0,0,8,8,9,12,21,32,21,53,0.000333,0.077598,4,931.171294,51.731739,232.792823,71.548875,2,4
0,0,12,12,11,16,27,50,35,85,0.000333,0.134722,10,4041.654377,224.536354,404.165438,102.053748,2,4
0,0,7,7,9,14,23,34,22,56,0.000333,0.08444,4,1013.277878,56.293215,253.31947,81.832294,2,4
0,0,10,10,9,17,26,49,32,81,0.000333,0.126912,4,1522.942469,84.607915,380.735617,98.016193,2,4
0,0,8,8,9,15,24,36,24,60,0.000333,0.091699,4,1100.391,61.132833,275.09775,87.132684,2,4
0,0,12,12,11,19,30,54,38,92,0.000333,0.150478,10,4514.339348,250.79663,451.433935,118.764371,2,4
0,0,9,9,12,16,28,47,30,77,0.000333,0.123389,6,2220.997974,123.388776,370.166329,107.01955,3,4
0,0,12,12,12,20,32,62,40,102,0.000333,0.17,12,6120,340,510,129.458112,3,4
0,0,10,10,12,17,29,49,32,81,0.000333,0.131165,6,2360.978764,131.165487,393.496461,112.506418,3,4
0,0,14,14,12,22,34,67,46,113,0.000333,0.191628,12,6898.599613,383.255534,574.883301,141.127046,3,4
0,0,7,7,9,11,20,31,19,50,0.000333,0.072032,4,864.385619,48.021423,216.096405,66.583073,2,4
0,0,10,10,9,15,24,46,29,75,0.000333,0.114624,4,1375.48875,76.416042,343.872188,87.132684,2,4
0,0,8,8,9,12,21,33,21,54,0.000333,0.079062,4,948.740563,52.707809,237.185141,71.548875,2,4
0,0,12,12,11,17,28,51,35,86,0.000333,0.137811,10,4134.325233,229.684735,413.432523,107.540616,2,4
0,0,7,7,9,11,20,31,19,50,0.000333,0.072032,4,864.385619,48.021423,216.096405,66.583073,2,4
0,0,10,10,9,15,24,46,29,75,0.000333,0.114624,4,1375.48875,76.416042,343.872188,87.132684,2,4
0,0,8,8,9,12,21,33,21,54,0.000333,0.079062,4,948.740563,52.707809,237.185141,71.548875,2,4
0,0,12,12,11,17,28,51,35,86,0.000333,0.137811,10,4134.325233,229.684735,413.432523,107.540616,2,4
0,0,7,7,9,11,20,30,19,49,0.000333,0.070591,4,847.097907,47.060995,211.774477,66.583073,2,4
0,0,10,10,9,14,23,45,29,74,0.000333,0.111581,8,2677.948678,148.774927,334.743585,81.832294,2,4
0,0,8,8,9,12,21,32,21,53,0.000333,0.077598,4,931.171294,51.731739,232.792823,71.548875,2,4
0,0,12,12,11,16,27,50,35,85,0.000333,0.134722,10,4041.654377,224.536354,404.165438,102.053748,2,4
0,0,7,7,9,11,20,30,19,49,0.000333,0.070591,4,847.097907,47.060995,211.774477,66.583073,2,4
0,0,10,10,9,14,23,45,29,74,0.000333,0.111581,8,2677.948678,148.774927,334.743585,81.832294,2,4
0,0,8,8,9,12,21,32,21,53,0.000333,0.077598,4,931.171294,51.731739,232.792823,71.548875,2,4
0,0,12,12,11,16,27,50,35,85,0.000333,0.134722,10,4041.654377,224.536354,404.165438,102.053748,2,4
0,0,7,7,9,14,23,34,22,56,0.000333,0.08444,4,1013.277878,56.293215,253.31947,81.832294,2,4
0,0,10,10,9,17,26,49,32,81,0.000333,0.126912,4,1522.942469,84.607915,380.735617,98.016193,2,4
0,0,8,8,9,15,24,36,24,60,0.000333,0.091699,4,1100.391,61.132833,275.09775,87.132684,2,4
0,0,12,12,11,19,30,54,38,92,0.000333,0.150478,10,4514.339348,250.79663,451.433935,118.764371,2,4
0,0,9,9,12,16,28,47,30,77,0.000333,0.123389,6,2220.997974,123.388776,370.166329,107.01955,3,4
0,0,12,12,12,20,32,62,40,102,0.000333,0.17,12,6120,340,510,129.458112,3,4
0,0,10,10,12,17,29,49,32,81,0.000333,0.131165,6,2360.978764,131.165487,393.496461,112.506418,3,4
0,0,14,14,12,22,34,67,46,113,0.000333,0.191628,12,6898.599613,383.255534,574.883301,141.127046,3,4
0,0,7,7,9,11,20,31,19,50,0.000333,0.072032,4,864.385619,48.021423,216.096405,66.583073,2,4
0,0,10,10,9,15,24,46,29,75,0.000333,0.114624,4,1375.48875,76.416042,343.872188,87.132684,2,4
0,0,8,8,9,12,21,33,21,54,0.000333,0.079062,4,948.740563,52.707809,237.185141,71.548875,2,4
0,0,12,12,11,17,28,51,35,86,0.000333,0.137811,10,4134.325233,229.684735,413.432523,107.540616,2,4
0,0,7,7,9,11,20,31,19,50,0.000333,0.072032,4,864.385619,48.021423,216.096405,66.583073,2,4
0,0,10,10,9,15,24,46,29,75,0.000333,0.114624,4,1375.48875,76.416042,343.872188,87.132684,2,4
0,0,8,8,9,12,21,33,21,54,0.000333,0.079062,4,948.740563,52.707809,237.185141,71.548875,2,4
0,0,12,12,11,17,28,51,35,86,0.000333,0.137811,10,4134.325233,229.684735,413.432523,107.540616,2,4
0,0,7,7,9,11,20,30,19,49,0.000333,0.070591,4,847.097907,47.060995,211.774477,66.583073,2,4
0,0,10,10,9,14,23,45,29,74,0.000333,0.111581,8,2677.948678,148.774927,334.743585,81.832294,2,4
0,0,8,8,9,12,21,32,21,53,0.000333,0.077598,4,931.171294,51.731739,232.792823,71.548875,2,4
0,0,12,12,11,16,27,50,35,85,0.000333,0.134722,10,4041.654377,224.536354,404.165438,102.053748,2,4
0,0,7,7,9,14,23,34,22,56,0.000333,0.08444,4,1013.277878,56.293215,253.31947,81.832294,2,4
0,0,10,10,9,17,26,49,32,81,0.000333,0.126912,4,1522.942469,84.607915,380.735617,98.016193,2,4
0,0,8,8,9,15,24,36,24,60,0.000333,0.091699,4,1100.391,61.132833,275.09775,87.132684,2,4
0,0,12,12,11,19,30,54,38,92,0.000333,0.150478,10,4514.339348,250.79663,451.433935,118.764371,2,4
0,0,7,7,9,11,20,30,19,49,0.000333,0.070591,4,847.097907,47.060995,211.774477,66.583073,2,4
0,0,10,10,9,14,23,45,29,74,0.000333,0.111581,8,2677.948678,148.774927,334.743585,81.832294,2,4
0,0,8,8,9,12,21,32,21,53,0.000333,0.077598,4,931.171294,51.731739,232.792823,71.548875,2,4
0,0,12,12,11,16,27,50,35,85,0.000333,0.134722,10,4041.654377,224.536354,404.165438,102.053748,2,4
0,0,7,7,9,11,20,31,19,50,0.000333,0.072032,4,864.385619,48.021423,216.096405,66.583073,2,4
0,0,10,10,9,15,24,46,29,75,0.000333,0.114624,4,1375.48875,76.416042,343.872188,87.132684,2,4
0,0,8,8,9,12,21,33,21,54,0.000333,0.079062,4,948.740563,52.707809,237.185141,71.548875,2,4
0,0,12,12,11,17,28,51,35,86,0.000333,0.137811,10,4134.325233,229.684735,413.432523,107.540616,2,4
0,0,7,7,9,11,20,31,19,50,0.000333,0.072032,4,864.385619,48.021423,216.096405,66.583073,2,4
0,0,10,10,9,15,24,46,29,75,0.000333,0.114624,4,1375.48875,76.416042,343.872188,87.132684,2,4
0,0,8,8,9,12,21,33,21,54,0.000333,0.079062,4,948.740563,52.707809,237.185141,71.548875,2,4
0,0,12,12,11,17,28,51,35,86,0.000333,0.137811,10,4134.325233,229.684735,413.432523,107.540616,2,4
0,0,9,9,12,16,28,47,30,77,0.000333,0.123389,6,2220.997974,123.388776,370.166329,107.01955,3,4
0,0,12,12,12,20,32,62,40,102,0.000333,0.17,12,6120,340,510,129.458112,3,4
0,0,10,10,12,17,29,49,32,81,0.000333,0.131165,6,2360.978764,131.165487,393.496461,112.506418,3,4
0,0,14,14,12,22,34,67,46,113,0.000333,0.191628,12,6898.599613,383.255534,574.883301,141.127046,3,4
0,0,7,7,9,14,23,34,22,56,0.000333,0.08444,4,1013.277878,56.293215,253.31947,81.832294,2,4
0,0,10,10,9,17,26,49,32,81,0.000333,0.126912,4,1522.942469,84.607915,380.735617,98.016193,2,4
0,0,8,8,9,15,24,36,24,60,0.000333,0.091699,4,1100.391,61.132833,275.09775,87.132684,2,4
0,0,12,12,11,19,30,54,38,92,0.000333,0.150478,10,4514.339348,250.79663,451.433935,118.764371,2,4
0,0,7,7,9,11,20,30,19,49,0.000333,0.070591,4,847.097907,47.060995,211.774477,66.583073,2,4
0,0,10,10,9,14,23,45,29,74,0.000333,0.111581,8,2677.948678,148.774927,334.743585,81.832294,2,4
0,0,8,8,9,12,21,32,21,53,0.000333,0.077598,4,931.171294,51.731739,232.792823,71.548875,2,4
0,0,12,12,11,16,27,50,35,85,0.000333,0.134722,10,4041.654377,224.536354,404.165438,102.053748,2,4
0,0,9,9,12,16,28,47,30,77,0.000333,0.123389,6,2220.997974,123.388776,370.166329,107.01955,3,4
0,0,12,12,12,20,32,62,40,102,0.000333,0.17,12,6120,340,510,129.458112,3,4
0,0,10,10,12,17,29,49,32,81,0.000333,0.131165,6,2360.978764,131.165487,393.496461,112.506418,3,4
0,0,14,14,12,22,34,67,46,113,0.000333,0.191628,12,6898.599613,383.255534,574.883301,141.127046,3,4
0,0,9,9,12,16,28,47,30,77,0.000333,0.123389,6,2220.997974,123.388776,370.166329,107.01955,3,4
0,0,12,12,12,20,32,62,40,102,0.000333,0.17,12,6120,340,510,129.458112,3,4
0,0,10,10,12,17,29,49,32,81,0.000333,0.131165,6,2360.978764,131.165487,393.496461,112.506418,3,4
0,0,14,14,12,22,34,67,46,113,0.000333,0.191628,12,6898.599613,383.255534,574.883301,141.127046,3,4
0,0,7,7,9,14,23,34,22,56,0.000333,0.08444,4,1013.277878,56.293215,253.31947,81.832294,2,4
0,0,10,10,9,17,26,49,32,81,0.000333,0.126912,4,1522.942469,84.607915,380.735617,98.016193,2,4
0,0,8,8,9,15,24,36,24,60,0.000333,0.091699,4,1100.391,61.132833,275.09775,87.132684,2,4
0,0,12,12,11,19,30,54,38,92,0.000333,0.150478,10,4514.339348,250.79663,451.433935,118.764371,2,4
0,0,7,7,9,11,20,30,19,49,0.000333,0.070591,4,847.097907,47.060995,211.774477,66.583073,2,4
0,0,10,10,9,14,23,45,29,74,0.000333,0.111581,8,2677.948678,148.774927,334.743585,81.832294,2,4
0,0,8,8,9,12,21,32,21,53,0.000333,0.077598,4,931.171294,51.731739,232.792823,71.548875,2,4
0,0,12,12,11,16,27,50,35,85,0.000333,0.134722,10,4041.654377,224.536354,404.165438,102.053748,2,4
0,0,9,9,12,16,28,47,30,77,0.000333,0.123389,6,2220.997974,123.388776,370.166329,107.01955,3,4
0,0,12,12,12,20,32,62,40,102,0.000333,0.17,12,6120,340,510,129.458112,3,4
0,0,10,10,12,17,29,49,32,81,0.000333,0.131165,6,2360.978764,131.165487,393.496461,112.506418,3,4
0,0,14,14,12,22,34,67,46,113,0.000333,0.191628,12,6898.599613,383.255534,574.883301,141.127046,3,4
0,0,9,9,12,16,28,47,30,77,0.000333,0.123389,6,2220.997974,123.388776,370.166329,107.01955,3,4
0,0,12,12,12,20,32,62,40,102,0.000333,0.17,12,6120,340,510,129.458112,3,4
0,0,10,10,12,17,29,49,32,81,0.000333,0.131165,6,2360.978764,131.165487,393.496461,112.506418,3,4
0,0,14,14,12,22,34,67,46,113,0.000333,0.191628,12,6898.599613,383.255534,574.883301,141.127046,3,4
0,0,7,7,9,11,20,30,19,49,0.000333,0.070591,4,847.097907,47.060995,211.774477,66.583073,2,4
0,0,10,10,9,14,23,45,29,74,0.000333,0.111581,8,2677.948678,148.774927,334.743585,81.832294,2,4
0,0,8,8,9,12,21,32,21,53,0.000333,0.077598,4,931.171294,51.731739,232.792823,71.548875,2,4
0,0,12,12,11,16,27,50,35,85,0.000333,0.134722,10,4041.654377,224.536354,404.165438,102.053748,2,4
0,0,7,7,9,14,23,34,22,56,0.000333,0.08444,4,1013.277878,56.293215,253.31947,81.832294,2,4
0,0,10,10,9,17,26,49,32,81,0.000333,0.126912,4,1522.942469,84.607915,380.735617,98.016193,2,4
0,0,8,8,9,15,24,36,24,60,0.000333,0.091699,4,1100.391,61.132833,275.09775,87.132684,2,4
0,0,12,12,11,19,30,54,38,92,0.000333,0.150478,10,4514.339348,250.79663,451.433935,118.764371,2,4
0,0,9,9,12,16,28,47,30,77,0.000333,0.123389,6,2220.997974,123.388776,370.166329,107.01955,3,4
0,0,12,12,12,20,32,62,40,102,0.000333,0.17,12,6120,340,510,129.458112,3,4
0,0,10,10,12,17,29,49,32,81,0.000333,0.131165,6,2360.978764,131.165487,393.496461,112.506418,3,4
0,0,14,14,12,22,34,67,46,113,0.000333,0.191628,12,6898.599613,383.255534,574.883301,141.127046,3,4
0,0,9,9,12,16,28,47,30,77,0.000333,0.123389,6,2220.997974,123.388776,370.166329,107.01955,3,4
0,0,12,12,12,20,32,62,40,102,0.000333,0.17,12,6120,340,510,129.458112,3,4
0,0,10,10,12,17,29,49,32,81,0.000333,0.131165,6,2360.978764,131.165487,393.496461,112.506418,3,4
0,0,14,14,12,22,34,67,46,113,0.000333,0.191628,12,6898.599613,383.255534,574.883301,141.127046,3,4
0,0,7,7,9,11,20,30,19,49,0.000333,0.070591,4,847.097907,47.060995,211.774477,66.583073,2,4
0,0,10,10,9,14,23,45,29,74,0.000333,0.111581,8,2677.948678,148.774927,334.743585,81.832294,2,4
0,0,8,8,9,12,21,32,21,53,0.000333,0.077598,4,931.171294,51.731739,232.792823,71.548875,2,4
0,0,12,12,11,16,27,50,35,85,0.000333,0.134722,10,4041.654377,224.536354,404.165438,102.053748,2,4
0,0,7,7,9,14,23,34,22,56,0.000333,0.08444,4,1013.277878,56.293215,253.31947,81.832294,2,4
0,0,10,10,9,17,26,49,32,81,0.000333,0.126912,4,1522.942469,84.607915,380.735617,98.016193,2,4
0,0,8,8,9,15,24,36,24,60,0.000333,0.091699,4,1100.391,61.132833,275.09775,87.132684,2,4
0,0,12,12,11,19,30,54,38,92,0.000333,0.150478,10,4514.339348,250.79663,451.433935,118.764371,2,4
0,0,8,8,10,14,24,35,25,60,0.000333,0.091699,5,1375.48875,76.416042,275.09775,86.52225,2,4
0,0,11,11,10,16,26,50,35,85,0.000333,0.133179,10,3995.37376,221.965209,399.537376,97.219281,2,4
0,0,9,9,10,15,25,37,27,64,0.000333,0.099069,5,1486.033981,82.557443,297.206796,91.82264,2,4
0,0,13,13,12,18,30,55,41,96,0.000333,0.15702,12,5652.737966,314.040998,471.061497,118.0782,2,4
0,0,11,11,13,19,32,53,36,89,0.000333,0.148333,6,2670,148.333333,445,128.816339,3,4
0,0,14,14,13,21,34,68,46,114,0.000333,0.193324,12,6959.649167,386.647176,579.970764,140.344382,3,4
0,0,12,12,13,20,33,55,38,93,0.000333,0.156376,6,2814.771919,156.376218,469.128653,134.544278,3,4
0,0,16,16,13,23,36,73,52,125,0.000333,0.215414,12,7754.887502,430.827083,646.240625,152.147641,3,4
0,0,7,7,9,11,20,30,19,49,0.000333,0.070591,4,847.097907,47.060995,211.774477,66.583073,2,4
0,0,10,10,9,14,23,45,29,74,0.000333,0.111581,8,2677.948678,148.774927,334.743585,81.832294,2,4
0,0,8,8,9,12,21,32,21,53,0.000333,0.077598,4,931.171294,51.731739,232.792823,71.548875,2,4
0,0,12,12,11,16,27,50,35,85,0.000333,0.134722,10,4041.654377,224.536354,404.165438,102.053748,2,4
0,0,7,7,9,14,23,34,22,56,0.000333,0.08444,4,1013.277878,56.293215,253.31947,81.832294,2,4
0,0,10,10,9,17,26,49,32,81,0.000333,0.126912,4,1522.942469,84.607915,380.735617,98.016193,2,4
0,0,8,8,9,15,24,36,24,60,0.000333,0.091699,4,1100.391,61.132833,275.09775,87.132684,2,4
0,0,12,12,11,19,30,54,38,92,0.000333,0.150478,10,4514.339348,250.79663,451.433935,118.764371,2,4
0,0,8,8,9,16,25,34,29,63,0.000333,0.097521,4,1170.25176,65.013987,292.56294,92.529325,2,4
0,0,11,11,9,18,27,49,39,88,0.000333,0.139477,8,3347.440802,185.968933,418.4301,103.587975,2,4
0,0,9,9,9,17,26,36,31,67,0.000333,0.104976,4,1259.717844,69.984325,314.929461,98.016193,2,4
0,0,13,13,11,20,31,54,45,99,0.000333,0.163488,10,4904.654347,272.480797,490.465435,124.49231,2,4
0,0,6,6,9,14,23,29,21,50,0.000333,0.075393,4,904.712391,50.2618,226.178098,81.832294,2,4
0,0,9,9,9,16,25,44,31,75,0.000333,0.116096,4,1393.156857,77.397603,348.289214,92.529325,2,4
0,0,7,7,9,15,24,31,23,54,0.000333,0.082529,4,990.3519,55.01955,247.587975,87.132684,2,4
0,0,11,11,11,18,29,49,37,86,0.000333,0.139262,10,4177.863656,232.103536,417.786366,113.112398,2,4
0,0,7,7,9,14,23,34,22,56,0.000333,0.08444,4,1013.277878,56.293215,253.31947,81.832294,2,4
0,0,10,10,9,17,26,49,32,81,0.000333,0.126912,4,1522.942469,84.607915,380.735617,98.016193,2,4
0,0,8,8,9,15,24,36,24,60,0.000333,0.091699,4,1100.391,61.132833,275.09775,87.132684,2,4
0,0,12,12,11,19,30,54,38,92,0.000333,0.150478,10,4514.339348,250.79663,451.433935,118.764371,2,4
0,0,7,7,9,11,20,30,19,49,0.000333,0.070591,4,847.097907,47.060995,211.774477,66.583073,2,4
0,0,10,10,9,14,23,45,29,74,0.000333,0.111581,8,2677.948678,148.774927,334.743585,81.832294,2,4
0,0,8,8,9,12,21,32,21,53,0.000333,0.077598,4,931.171294,51.731739,232.792823,71.548875,2,4
0,0,12,12,11,16,27,50,35,85,0.000333,0.134722,10,4041.654377,224.536354,404.165438,102.053748,2,4
0,0,11,11,12,18,30,51,36,87,0.000333,0.1423,12,5122.793782,284.599655,426.899482,118.0782,3,4
0,0,14,14,12,21,33,66,46,112,0.000333,0.188324,12,6779.665696,376.648094,564.972141,135.258216,3,4
0,0,12,12,12,19,31,53,38,91,0.000333,0.150277,12,5409.982371,300.554576,450.831864,123.730173,3,4
0,0,16,16,12,23,35,71,52,123,0.000333,0.210301,12,7570.821733,420.601207,630.901811,147.061475,3,4
0,0,8,8,9,12,21,33,23,56,0.000333,0.08199,4,983.879103,54.65995,245.969776,71.548875,2,4
0,0,11,11,9,15,24,48,33,81,0.000333,0.123794,8,2971.0557,165.05865,371.381963,87.132684,2,4
0,0,9,9,9,13,22,35,25,60,0.000333,0.089189,4,1070.263588,59.459088,267.565897,76.635041,2,4
0,0,13,13,11,17,28,53,39,92,0.000333,0.147426,10,4422.766528,245.709252,442.276653,107.540616,2,4
0,0,7,7,9,11,20,30,19,49,0.000333,0.070591,4,847.097907,47.060995,211.774477,66.583073,2,4
0,0,10,10,9,14,23,45,29,74,0.000333,0.111581,8,2677.948678,148.774927,334.743585,81.832294,2,4
0,0,8,8,9,12,21,32,21,53,0.000333,0.077598,4,931.171294,51.731739,232.792823,71.548875,2,4
0,0,12,12,11,16,27,50,35,85,0.000333,0.134722,10,4041.654377,224.536354,404.165438,102.053748,2,4
0,0,7,7,9,14,23,34,22,56,0.000333,0.08444,4,1013.277878,56.293215,253.31947,81.832294,2,4
0,0,10,10,9,17,26,49,32,81,0.000333,0.126912,4,1522.942469,84.607915,380.735617,98.016193,2,4
0,0,8,8,9,15,24,36,24,60,0.000333,0.091699,4,1100.391,61.132833,275.09775,87.132684,2,4
0,0,12,12,11,19,30,54,38,92,0.000333,0.150478,10,4514.339348,250.79663,451.433935,118.764371,2,4
0,0,7,7,10,11,21,34,21,55,0.000333,0.080526,5,1207.887291,67.10485,241.577458,71.273029,2,4
0,0,10,10,10,14,24,49,31,80,0.000333,0.122266,10,3667.970001,203.776111,366.797,86.52225,2,4
0,0,8,8,10,12,22,36,23,59,0.000333,0.087702,5,1315.532327,73.085129,263.106465,76.238831,2,4
0,0,12,12,12,16,28,54,37,91,0.000333,0.145823,12,5249.631575,291.646199,437.469298,107.01955,2,4
0,0,7,7,10,11,21,34,21,55,0.000333,0.080526,5,1207.887291,67.10485,241.577458,71.273029,2,4
0,0,10,10,10,14,24,49,31,80,0.000333,0.122266,10,3667.970001,203.776111,366.797,86.52225,2,4
0,0,8,8,10,12,22,36,23,59,0.000333,0.087702,5,1315.532327,73.085129,263.106465,76.238831,2,4
0,0,12,12,12,16,28,54,37,91,0.000333,0.145823,12,5249.631575,291.646199,437.469298,107.01955,2,4
0,0,7,7,9,11,20,30,19,49,0.000333,0.070591,4,847.097907,47.060995,211.774477,66.583073,2,4
0,0,10,10,9,14,23,45,29,74,0.000333,0.111581,8,2677.948678,148.774927,334.743585,81.832294,2,4
0,0,8,8,9,12,21,32,21,53,0.000333,0.077598,4,931.171294,51.731739,232.792823,71.548875,2,4
0,0,12,12,11,16,27,50,35,85,0.000333,0.134722,10,4041.654377,224.536354,404.165438,102.053748,2,4
0,0,7,7,9,14,23,34,22,56,0.000333,0.08444,4,1013.277878,56.293215,253.31947,81.832294,2,4
0,0,10,10,9,17,26,49,32,81,0.000333,0.126912,4,1522.942469,84.607915,380.735617,98.016193,2,4
0,0,8,8,9,15,24,36,24,60,0.000333,0.091699,4,1100.391,61.132833,275.09775,87.132684,2,4
0,0,12,12,11,19,30,54,38,92,0.000333,0.150478,10,4514.339348,250.79663,451.433935,118.764371,2,4
0,0,7,7,10,15,25,31,23,54,0.000333,0.083589,5,1253.841171,69.657843,250.768234,91.82264,2,4
0,0,10,10,10,18,28,46,33,79,0.000333,0.126594,5,1898.905194,105.494733,379.781039,108.277931,2,4
0,0,8,8,10,16,26,33,25,58,0.000333,0.090875,5,1363.127518,75.729307,272.625504,97.219281,2,4
0,0,12,12,12,20,32,51,39,90,0.000333,0.15,6,2700,150,450,129.458112,2,4
0,0,7,7,10,15,25,31,23,54,0.000333,0.083589,5,1253.841171,69.657843,250.768234,91.82264,2,4
0,0,10,10,10,18,28,46,33,79,0.000333,0.126594,5,1898.905194,105.494733,379.781039,108.277931,2,4
0,0,8,8,10,16,26,33,25,58,0.000333,0.090875,5,1363.127518,75.729307,272.625504,97.219281,2,4
0,0,12,12,12,20,32,51,39,90,0.000333,0.15,6,2700,150,450,129.458112,2,4
0,0,7,7,9,11,20,30,19,49,0.000333,0.070591,4,847.097907,47.060995,211.774477,66.583073,2,4
0,0,10,10,9,14,23,45,29,74,0.000333,0.111581,8,2677.948678,148.774927,334.743585,81.832294,2,4
0,0,8,8,9,12,21,32,21,53,0.000333,0.077598,4,931.171294,51.731739,232.792823,71.548875,2,4
0,0,12,12,11,16,27,50,35,85,0.000333,0.134722,10,4041.654377,224.536354,404.165438,102.053748,2,4
0,0,7,7,9,14,23,34,22,56,0.000333,0.08444,4,1013.277878,56.293215,253.31947,81.832294,2,4
0,0,10,10,9,17,26,49,32,81,0.000333,0.126912,4,1522.942469,84.607915,380.735617,98.016193,2,4
0,0,8,8,9,15,24,36,24,60,0.000333,0.091699,4,1100.391,61.132833,275.09775,87.132684,2,4
0,0,12,12,11,19,30,54,38,92,0.000333,0.150478,10,4514.339348,250.79663,451.433935,118.764371,2,4
0,0,8,8,10,14,24,35,25,60,0.000333,0.091699,5,1375.48875,76.416042,275.09775,86.52225,2,4
0,0,9,9,10,15,25,45,30,75,0.000333,0.116096,10,3482.892142,193.494008,348.289214,91.82264,2,4
0,0,9,9,10,15,25,37,27,64,0.000333,0.099069,5,1486.033981,82.557443,297.206796,91.82264,2,4
0,0,11,11,11,17,28,49,35,84,0.000333,0.134606,10,4038.178135,224.34323,403.817813,107.540616,2,4
0,0,11,11,13,19,32,53,36,89,0.000333,0.148333,6,2670,148.333333,445,128.816339,3,4
0,0,12,12,13,20,33,63,40,103,0.000333,0.173191,12,6234.871132,346.38173,519.572594,134.544278,3,4
0,0,12,12,13,20,33,55,38,93,0.000333,0.156376,6,2814.771919,156.376218,469.128653,134.544278,3,4
0,0,14,14,12,22,34,67,46,113,0.000333,0.191628,12,6898.599613,383.255534,574.883301,141.127046,3,4
0,0,7,7,9,14,23,34,22,56,0.000333,0.08444,4,1013.277878,56.293215,253.31947,81.832294,2,4
0,0,10,10,9,17,26,49,32,81,0.000333,0.126912,4,1522.942469,84.607915,380.735617,98.016193,2,4
0,0,8,8,9,15,24,36,24,60,0.000333,0.091699,4,1100.391,61.132833,275.09775,87.132684,2,4
0,0,12,12,11,19,30,54,38,92,0.000333,0.150478,10,4514.339348,250.79663,451.433935,118.764371,2,4
0,0,7,7,9,11,20,30,19,49,0.000333,0.070591,4,847.097907,47.060995,211.774477,66.583073,2,4
0,0,10,10,9,14,23,45,29,74,0.000333,0.111581,8,2677.948678,148.774927,334.743585,81.832294,2,4
0,0,8,8,9,12,21,32,21,53,0.000333,0.077598,4,931.171294,51.731739,232.792823,71.548875,2,4
0,0,12,12,11,16,27,50,35,85,0.000333,0.134722,10,4041.654377,224.536354,404.165438,102.053748,2,4
0,0,19,19,14,18,32,91,59,150,0.000333,0.25,21,15750,875,750,128.361619,4,4
0,0,22,22,14,20,34,106,69,175,0.000333,0.296769,21,18696.42594,1038.69033,890.305997,139.741531,4,4
0,0,20,20,14,19,33,93,61,154,0.000333,0.258946,21,16313.57058,906.309477,776.836694,134.013592,4,4
0,0,24,24,14,22,36,111,75,186,0.000333,0.320535,21,20193.72706,1121.873725,961.60605,151.410465,4,4
0,0,8,8,10,12,22,35,22,57,0.000333,0.084729,5,1270.938011,70.607667,254.187602,76.238831,2,4
0,0,11,11,10,16,26,50,32,82,0.000333,0.128479,10,3854.360569,214.131143,385.436057,97.219281,2,4
0,0,9,9,10,13,23,37,24,61,0.000333,0.091979,5,1379.686397,76.649244,275.937279,81.324997,2,4
0,0,13,13,12,18,30,55,38,93,0.000333,0.152114,12,5476.089905,304.227217,456.340825,118.0782,2,4
0,0,7,7,9,11,20,30,19,49,0.000333,0.070591,4,847.097907,47.060995,211.774477,66.583073,2,4
0,0,10,10,9,14,23,45,29,74,0.000333,0.111581,8,2677.948678,148.774927,334.743585,81.832294,2,4
0,0,8,8,9,12,21,32,21,53,0.000333,0.077598,4,931.171294,51.731739,232.792823,71.548875,2,4
0,0,12,12,11,16,27,50,35,85,0.000333,0.134722,10,4041.654377,224.536354,404.165438,102.053748,2,4
0,0,7,7,9,14,23,34,22,56,0.000333,0.08444,4,1013.277878,56.293215,253.31947,81.832294,2,4
0,0,10,10,9,17,26,49,32,81,0.000333,0.126912,4,1522.942469,84.607915,380.735617,98.016193,2,4
0,0,8,8,9,15,24,36,24,60,0.000333,0.091699,4,1100.391,61.132833,275.09775,87.132684,2,4
0,0,12,12,11,19,30,54,38,92,0.000333,0.150478,10,4514.339348,250.79663,451.433935,118.764371,2,4
0,0,6,6,10,13,23,30,20,50,0.000333,0.075393,5,1130.890489,62.827249,226.178098,81.324997,2,4
0,0,7,7,10,14,24,32,22,54,0.000333,0.082529,5,1237.939875,68.774438,247.587975,86.52225,2,4
0,0,6,6,10,12,22,30,19,49,0.000333,0.072837,5,1092.560747,60.697819,218.512149,76.238831,2,4
0,0,7,7,10,13,23,32,21,53,0.000333,0.079916,5,1198.743918,66.596884,239.748784,81.324997,2,4
0,0,7,7,9,11,20,30,19,49,0.000333,0.070591,4,847.097907,47.060995,211.774477,66.583073,2,4
0,0,10,10,9,14,23,45,29,74,0.000333,0.111581,8,2677.948678,148.774927,334.743585,81.832294,2,4
0,0,8,8,9,12,21,32,21,53,0.000333,0.077598,4,931.171294,51.731739,232.792823,71.548875,2,4
0,0,12,12,11,16,27,50,35,85,0.000333,0.134722,10,4041.654377,224.536354,404.165438,102.053748,2,4
0,0,7,7,9,14,23,34,22,56,0.000333,0.08444,4,1013.277878,56.293215,253.31947,81.832294,2,4
0,0,10,10,9,17,26,49,32,81,0.000333,0.126912,4,1522.942469,84.607915,380.735617,98.016193,2,4
0,0,8,8,9,15,24,36,24,60,0.000333,0.091699,4,1100.391,61.132833,275.09775,87.132684,2,4
0,0,12,12,11,19,30,54,38,92,0.000333,0.150478,10,4514.339348,250.79663,451.433935,118.764371,2,4
0,0,12,12,12,21,33,52,40,92,0.000333,0.154695,6,2784.505554,154.694753,464.084259,135.258216,3,4
0,0,15,15,12,24,36,67,50,117,0.000333,0.201627,12,7258.574702,403.25415,604.881225,153.05865,3,4
0,0,13,13,12,22,34,54,42,96,0.000333,0.162799,6,2930.378597,162.798811,488.396433,141.127046,3,4
0,0,17,17,12,26,38,72,56,128,0.000333,0.223912,12,8060.816661,447.823148,671.734722,165.230983,3,4
0,0,9,9,9,17,26,34,30,64,0.000333,0.100276,4,1203.312568,66.850698,300.828142,98.016193,2,4
0,0,12,12,9,20,29,49,40,89,0.000333,0.14412,8,3458.882469,192.160137,432.360309,114.967887,2,4
0,0,10,10,9,18,27,36,32,68,0.000333,0.107777,4,1293.329401,71.851633,323.33235,103.587975,2,4
0,0,14,14,11,22,33,54,46,100,0.000333,0.168146,10,5044.394119,280.244118,504.439412,136.161243,2,4
0,0,7,7,9,14,23,34,22,56,0.000333,0.08444,4,1013.277878,56.293215,253.31947,81.832294,2,4
0,0,10,10,9,17,26,49,32,81,0.000333,0.126912,4,1522.942469,84.607915,380.735617,98.016193,2,4
0,0,8,8,9,15,24,36,24,60,0.000333,0.091699,4,1100.391,61.132833,275.09775,87.132684,2,4
0,0,12,12,11,19,30,54,38,92,0.000333,0.150478,10,4514.339348,250.79663,451.433935,118.764371,2,4
0,0,7,7,9,11,20,30,19,49,0.000333,0.070591,4,847.097907,47.060995,211.774477,66.583073,2,4
0,0,10,10,9,14,23,45,29,74,0.000333,0.111581,8,2677.948678,148.774927,334.743585,81.832294,2,4
0,0,8,8,9,12,21,32,21,53,0.000333,0.077598,4,931.171294,51.731739,232.792823,71.548875,2,4
0,0,12,12,11,16,27,50,35,85,0.000333,0.134722,10,4041.654377,224.536354,404.165438,102.053748,2,4
0,0,6,6,9,15,24,29,22,51,0.000333,0.077944,4,935.33235,51.962908,233.833088,87.132684,2,4
0,0,9,9,9,17,26,44,32,76,0.000333,0.119078,4,1428.933674,79.385204,357.233419,98.016193,2,4
0,0,7,7,9,16,25,31,24,55,0.000333,0.085137,4,1021.648362,56.758242,255.41209,92.529325,2,4
0,0,11,11,11,19,30,49,38,87,0.000333,0.1423,10,4268.994818,237.166379,426.899482,118.764371,2,4
0,0,6,6,9,14,23,29,21,50,0.000333,0.075393,4,904.712391,50.2618,226.178098,81.832294,2,4
0,0,9,9,9,16,25,44,31,75,0.000333,0.116096,4,1393.156857,77.397603,348.289214,92.529325,2,4
0,0,7,7,9,15,24,31,23,54,0.000333,0.082529,4,990.3519,55.01955,247.587975,87.132684,2,4
0,0,11,11,11,18,29,49,37,86,0.000333,0.139262,10,4177.863656,232.103536,417.786366,113.112398,2,4
0,0,7,7,9,14,23,34,22,56,0.000333,0.08444,4,1013.277878,56.293215,253.31947,81.832294,2,4
0,0,10,10,9,17,26,49,32,81,0.000333,0.126912,4,1522.942469,84.607915,380.735617,98.016193,2,4
0,0,8,8,9,15,24,36,24,60,0.000333,0.091699,4,1100.391,61.132833,275.09775,87.132684,2,4
0,0,12,12,11,19,30,54,38,92,0.000333,0.150478,10,4514.339348,250.79663,451.433935,118.764371,2,4
0,0,7,7,9,11,20,30,19,49,0.000333,0.070591,4,847.097907,47.060995,211.774477,66.583073,2,4
0,0,10,10,9,14,23,45,29,74,0.000333,0.111581,8,2677.948678,148.774927,334.743585,81.832294,2,4
0,0,8,8,9,12,21,32,21,53,0.000333,0.077598,4,931.171294,51.731739,232.792823,71.548875,2,4
0,0,12,12,11,16,27,50,35,85,0.000333,0.134722,10,4041.654377,224.536354,404.165438,102.053748,2,4
0,0,6,6,9,15,24,29,22,51,0.000333,0.077944,4,935.33235,51.962908,233.833088,87.132684,2,4
0,0,9,9,9,17,26,44,32,76,0.000333,0.119078,4,1428.933674,79.385204,357.233419,98.016193,2,4
0,0,7,7,9,16,25,31,24,55,0.000333,0.085137,4,1021.648362,56.758242,255.41209,92.529325,2,4
0,0,11,11,11,19,30,49,38,87,0.000333,0.1423,10,4268.994818,237.166379,426.899482,118.764371,2,4
0,0,6,6,9,14,23,29,21,50,0.000333,0.075393,4,904.712391,50.2618,226.178098,81.832294,2,4
0,0,9,9,9,16,25,44,31,75,0.000333,0.116096,4,1393.156857,77.397603,348.289214,92.529325,2,4
0,0,7,7,9,15,24,31,23,54,0.000333,0.082529,4,990.3519,55.01955,247.587975,87.132684,2,4
0,0,11,11,11,18,29,49,37,86,0.000333,0.139262,10,4177.863656,232.103536,417.786366,113.112398,2,4
0,0,7,7,9,14,23,34,22,56,0.000333,0.08444,4,1013.277878,56.293215,253.31947,81.832294,2,4
0,0,10,10,9,17,26,49,32,81,0.000333,0.126912,4,1522.942469,84.607915,380.735617,98.016193,2,4
0,0,8,8,9,15,24,36,24,60,0.000333,0.091699,4,1100.391,61.132833,275.09775,87.132684,2,4
0,0,12,12,11,19,30,54,38,92,0.000333,0.150478,10,4514.339348,250.79663,451.433935,118.764371,2,4
0,0,7,7,9,11,20,30,19,49,0.000333,0.070591,4,847.097907,47.060995,211.774477,66.583073,2,4
0,0,10,10,9,14,23,45,29,74,0.000333,0.111581,8,2677.948678,148.774927,334.743585,81.832294,2,4
0,0,8,8,9,12,21,32,21,53,0.000333,0.077598,4,931.171294,51.731739,232.792823,71.548875,2,4
0,0,12,12,11,16,27,50,35,85,0.000333,0.134722,10,4041.654377,224.536354,404.165438,102.053748,2,4
0,0,6,6,9,15,24,29,22,51,0.000333,0.077944,4,935.33235,51.962908,233.833088,87.132684,2,4
0,0,9,9,9,17,26,44,32,76,0.000333,0.119078,4,1428.933674,79.385204,357.233419,98.016193,2,4
0,0,7,7,9,16,25,31,24,55,0.000333,0.085137,4,1021.648362,56.758242,255.41209,92.529325,2,4
0,0,11,11,11,19,30,49,38,87,0.000333,0.1423,10,4268.994818,237.166379,426.899482,118.764371,2,4
0,0,6,6,9,14,23,29,21,50,0.000333,0.075393,4,904.712391,50.2618,226.178098,81.832294,2,4
0,0,9,9,9,16,25,44,31,75,0.000333,0.116096,4,1393.156857,77.397603,348.289214,92.529325,2,4
0,0,7,7,9,15,24,31,23,54,0.000333,0.082529,4,990.3519,55.01955,247.587975,87.132684,2,4
0,0,11,11,11,18,29,49,37,86,0.000333,0.139262,10,4177.863656,232.103536,417.786366,113.112398,2,4
0,0,7,7,9,14,23,34,22,56,0.000333,0.08444,4,1013.277878,56.293215,253.31947,81.832294,2,4
0,0,10,10,9,17,26,49,32,81,0.000333,0.126912,4,1522.942469,84.607915,380.735617,98.016193,2,4
0,0,8,8,9,15,24,36,24,60,0.000333,0.091699,4,1100.391,61.132833,275.09775,87.132684,2,4
0,0,12,12,11,19,30,54,38,92,0.000333,0.150478,10,4514.339348,250.79663,451.433935,118.764371,2,4
0,0,7,7,9,11,20,30,19,49,0.000333,0.070591,4,847.097907,47.060995,211.774477,66.583073,2,4
0,0,10,10,9,14,23,45,29,74,0.000333,0.111581,8,2677.948678,148.774927,334.743585,81.832294,2,4
0,0,8,8,9,12,21,32,21,53,0.000333,0.077598,4,931.171294,51.731739,232.792823,71.548875,2,4
0,0,12,12,11,16,27,50,35,85,0.000333,0.134722,10,4041.654377,224.536354,404.165438,102.053748,2,4
0,0,6,6,9,15,24,29,22,51,0.000333,0.077944,4,935.33235,51.962908,233.833088,87.132684,2,4
0,0,9,9,9,17,26,44,32,76,0.000333,0.119078,4,1428.933674,79.385204,357.233419,98.016193,2,4
0,0,7,7,9,16,25,31,24,55,0.000333,0.085137,4,1021.648362,56.758242,255.41209,92.529325,2,4
0,0,11,11,11,19,30,49,38,87,0.000333,0.1423,10,4268.994818,237.166379,426.899482,118.764371,2,4
0,0,6,6,9,14,23,29,21,50,0.000333,0.075393,4,904.712391,50.2618,226.178098,81.832294,2,4
0,0,9,9,9,16,25,44,31,75,0.000333,0.116096,4,1393.156857,77.397603,348.289214,92.529325,2,4
0,0,7,7,9,15,24,31,23,54,0.000333,0.082529,4,990.3519,55.01955,247.587975,87.132684,2,4
0,0,11,11,11,18,29,49,37,86,0.000333,0.139262,10,4177.863656,232.103536,417.786366,113.112398,2,4
0,0,7,7,9,14,23,34,22,56,0.000333,0.08444,4,1013.277878,56.293215,253.31947,81.832294,2,4
0,0,10,10,9,17,26,49,32,81,0.000333,0.126912,4,1522.942469,84.607915,380.735617,98.016193,2,4
0,0,8,8,9,15,24,36,24,60,0.000333,0.091699,4,1100.391,61.132833,275.09775,87.132684,2,4
0,0,12,12,11,19,30,54,38,92,0.000333,0.150478,10,4514.339348,250.79663,451.433935,118.764371,2,4
0,0,7,7,9,11,20,30,19,49,0.000333,0.070591,4,847.097907,47.060995,211.774477,66.583073,2,4
0,0,10,10,9,14,23,45,29,74,0.000333,0.111581,8,2677.948678,148.774927,334.743585,81.832294,2,4
0,0,8,8,9,12,21,32,21,53,0.000333,0.077598,4,931.171294,51.731739,232.792823,71.548875,2,4
0,0,12,12,11,16,27,50,35,85,0.000333,0.134722,10,4041.654377,224.536354,404.165438,102.053748,2,4
0,0,6,6,9,13,22,31,21,52,0.000333,0.077297,4,927.561777,51.53121,231.890444,76.635041,2,4
0,0,9,9,9,17,26,46,31,77,0.000333,0.120645,4,1447.735433,80.429746,361.933858,98.016193,2,4
0,0,7,7,9,14,23,33,23,56,0.000333,0.08444,4,1013.277878,56.293215,253.31947,81.832294,2,4
0,0,11,11,11,19,30,51,37,88,0.000333,0.143935,5,2159.031862,119.946215,431.806372,118.764371,2,4
0,0,6,6,9,12,21,31,20,51,0.000333,0.074669,4,896.032754,49.779597,224.008189,71.548875,2,4
0,0,9,9,9,16,25,46,30,76,0.000333,0.117644,4,1411.732282,78.429571,352.93307,92.529325,2,4
0,0,7,7,9,13,22,33,22,55,0.000333,0.081756,4,981.074956,54.504164,245.268739,76.635041,2,4
0,0,11,11,11,18,29,51,36,87,0.000333,0.140881,10,4226.443466,234.802415,422.644347,113.112398,2,4
0,0,7,7,9,14,23,34,22,56,0.000333,0.08444,4,1013.277878,56.293215,253.31947,81.832294,2,4
0,0,10,10,9,17,26,49,32,81,0.000333,0.126912,4,1522.942469,84.607915,380.735617,98.016193,2,4
0,0,8,8,9,15,24,36,24,60,0.000333,0.091699,4,1100.391,61.132833,275.09775,87.132684,2,4
0,0,12,12,11,19,30,54,38,92,0.000333,0.150478,10,4514.339348,250.79663,451.433935,118.764371,2,4
0,0,7,7,9,11,20,30,19,49,0.000333,0.070591,4,847.097907,47.060995,211.774477,66.583073,2,4
0,0,10,10,9,14,23,45,29,74,0.000333,0.111581,8,2677.948678,148.774927,334.743585,81.832294,2,4
0,0,8,8,9,12,21,32,21,53,0.000333,0.077598,4,931.171294,51.731739,232.792823,71.548875,2,4
0,0,12,12,11,16,27,50,35,85,0.000333,0.134722,10,4041.654377,224.536354,404.165438,102.053748,2,4
0,0,7,7,9,15,24,33,24,57,0.000333,0.087114,4,1045.37145,58.076192,261.342863,87.132684,2,4
0,0,10,10,9,17,26,48,34,82,0.000333,0.128479,8,3083.488455,171.304914,385.436057,98.016193,2,4
0,0,8,8,9,16,25,35,26,61,0.000333,0.094425,4,1133.10091,62.950051,283.275228,92.529325,2,4
0,0,12,12,11,19,30,53,40,93,0.000333,0.152114,10,4563.408254,253.522681,456.340825,118.764371,2,4
0,0,7,7,9,16,25,33,25,58,0.000333,0.089781,4,1077.374636,59.854146,269.343659,92.529325,2,4
0,0,10,10,9,18,27,48,35,83,0.000333,0.131552,4,1578.622651,87.701258,394.655663,103.587975,2,4
0,0,8,8,9,17,26,35,27,62,0.000333,0.097142,4,1165.70905,64.761614,291.427263,98.016193,2,4
0,0,12,12,11,20,31,53,41,94,0.000333,0.155231,10,4656.944532,258.719141,465.694453,124.49231,2,4
0,0,7,7,9,14,23,34,22,56,0.000333,0.08444,4,1013.277878,56.293215,253.31947,81.832294,2,4
0,0,10,10,9,17,26,49,32,81,0.000333,0.126912,4,1522.942469,84.607915,380.735617,98.016193,2,4
0,0,8,8,9,15,24,36,24,60,0.000333,0.091699,4,1100.391,61.132833,275.09775,87.132684,2,4
0,0,12,12,11,19,30,54,38,92,0.000333,0.150478,10,4514.339348,250.79663,451.433935,118.764371,2,4
0,0,7,7,9,11,20,30,19,49,0.000333,0.070591,4,847.097907,47.060995,211.774477,66.583073,2,4
0,0,10,10,9,14,23,45,29,74,0.000333,0.111581,8,2677.948678,148.774927,334.743585,81.832294,2,4
0,0,8,8,9,12,21,32,21,53,0.000333,0.077598,4,931.171294,51.731739,232.792823,71.548875,2,4
0,0,12,12,11,16,27,50,35,85,0.000333,0.134722,10,4041.654377,224.536354,404.165438,102.053748,2,4
0,0,8,8,9,16,25,41,28,69,0.000333,0.106809,4,1281.704308,71.205795,320.426077,92.529325,2,4
0,0,11,11,9,18,27,56,38,94,0.000333,0.148986,8,3575.675402,198.648633,446.959425,103.587975,2,4
0,0,9,9,9,17,26,43,30,73,0.000333,0.114377,4,1372.528398,76.251578,343.132099,98.016193,2,4
0,0,13,13,11,20,31,61,44,105,0.000333,0.173397,10,5201.906126,288.994785,520.190613,124.49231,2,4
0,0,8,8,9,17,26,41,29,70,0.000333,0.109677,4,1316.123121,73.117951,329.03078,98.016193,2,4
0,0,11,11,9,19,28,56,39,95,0.000333,0.152233,8,3653.589741,202.977208,456.698718,109.239948,2,4
0,0,9,9,9,18,27,43,31,74,0.000333,0.117287,4,1407.446701,78.191483,351.861675,103.587975,2,4
0,0,13,13,11,21,32,61,45,106,0.000333,0.176667,10,5300,294.444444,530,130.292414,2,4
0,0,7,7,9,14,23,34,22,56,0.000333,0.08444,4,1013.277878,56.293215,253.31947,81.832294,2,4
0,0,10,10,9,17,26,49,32,81,0.000333,0.126912,4,1522.942469,84.607915,380.735617,98.016193,2,4
0,0,8,8,9,15,24,36,24,60,0.000333,0.091699,4,1100.391,61.132833,275.09775,87.132684,2,4
0,0,12,12,11,19,30,54,38,92,0.000333,0.150478,10,4514.339348,250.79663,451.433935,118.764371,2,4
0,0,7,7,9,11,20,30,19,49,0.000333,0.070591,4,847.097907,47.060995,211.774477,66.583073,2,4
0,0,10,10,9,14,23,45,29,74,0.000333,0.111581,8,2677.948678,148.774927,334.743585,81.832294,2,4
0,0,8,8,9,12,21,32,21,53,0.000333,0.077598,4,931.171294,51.731739,232.792823,71.548875,2,4
0,0,12,12,11,16,27,50,35,85,0.000333,0.134722,10,4041.654377,224.536354,404.165438,102.053748,2,4
0,0,6,6,9,15,24,29,22,51,0.000333,0.077944,4,935.33235,51.962908,233.833088,87.132684,2,4
0,0,9,9,9,17,26,44,32,76,0.000333,0.119078,4,1428.933674,79.385204,357.233419,98.016193,2,4
0,0,7,7,9,16,25,31,24,55,0.000333,0.085137,4,1021.648362,56.758242,255.41209,92.529325,2,4
0,0,11,11,11,19,30,49,38,87,0.000333,0.1423,10,4268.994818,237.166379,426.899482,118.764371,2,4
0,0,6,6,9,14,23,29,21,50,0.000333,0.075393,4,904.712391,50.2618,226.178098,81.832294,2,4
0,0,9,9,9,16,25,44,31,75,0.000333,0.116096,4,1393.156857,77.397603,348.289214,92.529325,2,4
0,0,7,7,9,15,24,31,23,54,0.000333,0.082529,4,990.3519,55.01955,247.587975,87.132684,2,4
0,0,11,11,11,18,29,49,37,86,0.000333,0.139262,10,4177.863656,232.103536,417.786366,113.112398,2,4
0,0,6,6,11,12,23,31,19,50,0.000333,0.075393,5,1130.890489,62.827249,226.178098,81.073298,2,4
0,0,9,9,11,15,26,46,29,75,0.000333,0.117511,5,1762.664894,97.925827,352.532979,96.657107,2,4
0,0,7,7,11,13,24,33,21,54,0.000333,0.082529,5,1237.939875,68.774438,247.587975,86.159464,2,4
0,0,11,11,11,15,26,51,35,86,0.000333,0.134746,10,4042.378158,224.576564,404.237816,96.657107,2,4
0,0,6,6,11,12,23,31,19,50,0.000333,0.075393,5,1130.890489,62.827249,226.178098,81.073298,2,4
0,0,9,9,11,15,26,46,29,75,0.000333,0.117511,5,1762.664894,97.925827,352.532979,96.657107,2,4
0,0,7,7,11,13,24,33,21,54,0.000333,0.082529,5,1237.939875,68.774438,247.587975,86.159464,2,4
0,0,11,11,11,15,26,51,35,86,0.000333,0.134746,10,4042.378158,224.576564,404.237816,96.657107,2,4
0,0,7,7,11,16,27,35,25,60,0.000333,0.095098,5,1426.466251,79.248125,285.29325,102.053748,2,4
0,0,10,10,11,18,29,50,35,85,0.000333,0.137643,5,2064.641923,114.702329,412.928385,113.112398,2,4
0,0,8,8,11,17,28,37,27,64,0.000333,0.102557,5,1538.353575,85.464088,307.670715,107.540616,2,4
0,0,12,12,11,18,29,55,41,96,0.000333,0.155455,10,4663.661755,259.09232,466.366176,113.112398,2,4
0,0,7,7,11,17,28,35,26,61,0.000333,0.09775,5,1466.243251,81.457958,293.24865,107.540616,2,4
0,0,10,10,11,19,30,50,36,86,0.000333,0.140664,5,2109.962956,117.220164,421.992591,118.764371,2,4
0,0,8,8,11,18,29,37,28,65,0.000333,0.105256,5,1578.843823,87.713546,315.768765,113.112398,2,4
0,0,12,12,11,19,30,55,42,97,0.000333,0.158656,10,4759.683878,264.426882,475.968388,118.764371,2,4
0,0,7,7,9,14,23,34,22,56,0.000333,0.08444,4,1013.277878,56.293215,253.31947,81.832294,2,4
0,0,10,10,9,17,26,49,32,81,0.000333,0.126912,4,1522.942469,84.607915,380.735617,98.016193,2,4
0,0,8,8,9,15,24,36,24,60,0.000333,0.091699,4,1100.391,61.132833,275.09775,87.132684,2,4
0,0,12,12,11,19,30,54,38,92,0.000333,0.150478,10,4514.339348,250.79663,451.433935,118.764371,2,4
0,0,7,7,9,11,20,30,19,49,0.000333,0.070591,4,847.097907,47.060995,211.774477,66.583073,2,4
0,0,10,10,9,14,23,45,29,74,0.000333,0.111581,8,2677.948678,148.774927,334.743585,81.832294,2,4
0,0,8,8,9,12,21,32,21,53,0.000333,0.077598,4,931.171294,51.731739,232.792823,71.548875,2,4
0,0,12,12,11,16,27,50,35,85,0.000333,0.134722,10,4041.654377,224.536354,404.165438,102.053748,2,4
0,0,7,7,10,17,27,32,27,59,0.000333,0.093513,5,1402.691813,77.927323,280.538363,102.706149,2,4
0,0,8,8,10,18,28,34,29,63,0.000333,0.100954,5,1514.3168,84.128711,302.86336,108.277931,2,4
0,0,7,7,10,18,28,32,28,60,0.000333,0.096147,5,1442.206477,80.122582,288.441295,108.277931,2,4
0,0,10,10,10,20,30,47,38,85,0.000333,0.139029,5,2085.428503,115.857139,417.085701,119.657843,2,4
0,0,8,8,10,19,29,34,30,64,0.000333,0.103637,5,1554.553918,86.364107,310.910784,113.929904,2,4
0,0,7,7,9,11,20,30,19,49,0.000333,0.070591,4,847.097907,47.060995,211.774477,66.583073,2,4
0,0,10,10,9,14,23,45,29,74,0.000333,0.111581,8,2677.948678,148.774927,334.743585,81.832294,2,4
0,0,8,8,9,12,21,32,21,53,0.000333,0.077598,4,931.171294,51.731739,232.792823,71.548875,2,4
0,0,12,12,11,16,27,50,35,85,0.000333,0.134722,10,4041.654377,224.536354,404.165438,102.053748,2,4
0,0,6,6,11,15,26,31,22,53,0.000333,0.083041,5,1245.616525,69.200918,249.123305,96.657107,2,4
0,0,9,9,11,17,28,46,32,78,0.000333,0.124991,5,1874.86842,104.159357,374.973684,107.540616,2,4
0,0,7,7,11,16,27,33,24,57,0.000333,0.090343,5,1355.142938,75.285719,271.028588,102.053748,2,4
0,0,11,11,13,19,32,51,38,89,0.000333,0.148333,12,5340,296.666667,445,128.816339,2,4
0,0,7,7,9,11,20,30,19,49,0.000333,0.070591,4,847.097907,47.060995,211.774477,66.583073,2,4
0,0,10,10,9,14,23,45,29,74,0.000333,0.111581,8,2677.948678,148.774927,334.743585,81.832294,2,4
0,0,8,8,9,12,21,32,21,53,0.000333,0.077598,4,931.171294,51.731739,232.792823,71.548875,2,4
0,0,12,12,11,16,27,50,35,85,0.000333,0.134722,10,4041.654377,224.536354,404.165438,102.053748,2,4
0,0,6,6,10,15,25,30,22,52,0.000333,0.080494,5,1207.402609,67.077923,241.480522,91.82264,2,4
0,0,9,9,10,17,27,45,32,77,0.000333,0.122042,5,1830.631688,101.70176,366.126338,102.706149,2,4
0,0,7,7,10,16,26,32,24,56,0.000333,0.087742,5,1316.123121,73.117951,263.224624,97.219281,2,4
0,0,11,11,12,19,31,50,38,88,0.000333,0.145323,12,5231.631304,290.646184,435.969275,123.730173,2,4
0,0,7,7,9,14,23,34,22,56,0.000333,0.08444,4,1013.277878,56.293215,253.31947,81.832294,2,4
0,0,10,10,9,17,26,49,32,81,0.000333,0.126912,4,1522.942469,84.607915,380.735617,98.016193,2,4
0,0,8,8,9,15,24,36,24,60,0.000333,0.091699,4,1100.391,61.132833,275.09775,87.132684,2,4
0,0,12,12,11,19,30,54,38,92,0.000333,0.150478,10,4514.339348,250.79663,451.433935,118.764371,2,4
0,0,7,7,9,11,20,30,19,49,0.000333,0.070591,4,847.097907,47.060995,211.774477,66.583073,2,4
0,0,10,10,9,14,23,45,29,74,0.000333,0.111581,8,2677.948678,148.774927,334.743585,81.832294,2,4
0,0,8,8,9,12,21,32,21,53,0.000333,0.077598,4,931.171294,51.731739,232.792823,71.548875,2,4
0,0,12,12,11,16,27,50,35,85,0.000333,0.134722,10,4041.654377,224.536354,404.165438,102.053748,2,4
0,0,7,7,11,12,23,36,20,56,0.000333,0.08444,5,1266.597348,70.366519,253.31947,81.073298,2,4
0,0,10,10,11,16,27,51,30,81,0.000333,0.128382,5,1925.729438,106.984969,385.145888,102.053748,2,4
0,0,8,8,11,13,24,38,22,60,0.000333,0.091699,5,1375.48875,76.416042,275.09775,86.159464,2,4
0,0,12,12,13,18,31,56,36,92,0.000333,0.151929,12,5469.432727,303.857374,455.786061,123.164366,2,4
0,0,6,6,9,10,19,29,17,46,0.000333,0.065135,4,781.618662,43.423259,195.404666,61.748606,2,4
0,0,9,9,9,14,23,44,27,71,0.000333,0.107058,4,1284.691596,71.371755,321.172899,81.832294,2,4
0,0,7,7,9,11,20,31,19,50,0.000333,0.072032,4,864.385619,48.021423,216.096405,66.583073,2,4
0,0,11,11,11,16,27,49,33,82,0.000333,0.129967,10,3899.007752,216.611542,389.900775,102.053748,2,4
0,0,7,7,9,11,20,30,19,49,0.000333,0.070591,4,847.097907,47.060995,211.774477,66.583073,2,4
0,0,10,10,9,14,23,45,29,74,0.000333,0.111581,8,2677.948678,148.774927,334.743585,81.832294,2,4
0,0,8,8,9,12,21,32,21,53,0.000333,0.077598,4,931.171294,51.731739,232.792823,71.548875,2,4
0,0,12,12,11,16,27,50,35,85,0.000333,0.134722,10,4041.654377,224.536354,404.165438,102.053748,2,4
0,0,7,7,9,11,20,30,19,49,0.000333,0.070591,4,847.097907,47.060995,211.774477,66.583073,2,4
0,0,10,10,9,14,23,45,29,74,0.000333,0.111581,8,2677.948678,148.774927,334.743585,81.832294,2,4
0,0,8,8,9,12,21,32,21,53,0.000333,0.077598,4,931.171294,51.731739,232.792823,71.548875,2,4
0,0,12,12,11,16,27,50,35,85,0.000333,0.134722,10,4041.654377,224.536354,404.165438,102.053748,2,4
0,0,7,7,9,14,23,34,22,56,0.000333,0.08444,4,1013.277878,56.293215,253.31947,81.832294,2,4
0,0,10,10,9,17,26,49,32,81,0.000333,0.126912,4,1522.942469,84.607915,380.735617,98.016193,2,4
0,0,8,8,9,15,24,36,24,60,0.000333,0.091699,4,1100.391,61.132833,275.09775,87.132684,2,4
0,0,12,12,11,19,30,54,38,92,0.000333,0.150478,10,4514.339348,250.79663,451.433935,118.764371,2,4
0,0,7,7,9,11,20,31,19,50,0.000333,0.072032,4,864.385619,48.021423,216.096405,66.583073,2,4
0,0,10,10,9,15,24,46,29,75,0.000333,0.114624,4,1375.48875,76.416042,343.872188,87.132684,2,4
0,0,8,8,9,12,21,33,21,54,0.000333,0.079062,4,948.740563,52.707809,237.185141,71.548875,2,4
0,0,12,12,11,17,28,51,35,86,0.000333,0.137811,10,4134.325233,229.684735,413.432523,107.540616,2,4
0,0,7,7,11,12,23,36,20,56,0.000333,0.08444,5,1266.597348,70.366519,253.31947,81.073298,2,4
0,0,10,10,11,16,27,51,30,81,0.000333,0.128382,5,1925.729438,106.984969,385.145888,102.053748,2,4
0,0,8,8,11,13,24,38,22,60,0.000333,0.091699,5,1375.48875,76.416042,275.09775,86.159464,2,4
0,0,12,12,13,18,31,56,36,92,0.000333,0.151929,12,5469.432727,303.857374,455.786061,123.164366,2,4
0,0,7,7,9,11,20,31,19,50,0.000333,0.072032,4,864.385619,48.021423,216.096405,66.583073,2,4
0,0,10,10,9,15,24,46,29,75,0.000333,0.114624,4,1375.48875,76.416042,343.872188,87.132684,2,4
0,0,8,8,9,12,21,33,21,54,0.000333,0.079062,4,948.740563,52.707809,237.185141,71.548875,2,4
0,0,12,12,11,17,28,51,35,86,0.000333,0.137811,10,4134.325233,229.684735,413.432523,107.540616,2,4
0,0,7,7,9,11,20,30,19,49,0.000333,0.070591,4,847.097907,47.060995,211.774477,66.583073,2,4
0,0,10,10,9,14,23,45,29,74,0.000333,0.111581,8,2677.948678,148.774927,334.743585,81.832294,2,4
0,0,8,8,9,12,21,32,21,53,0.000333,0.077598,4,931.171294,51.731739,232.792823,71.548875,2,4
0,0,12,12,11,16,27,50,35,85,0.000333,0.134722,10,4041.654377,224.536354,404.165438,102.053748,2,4
0,0,7,7,9,11,20,30,19,49,0.000333,0.070591,4,847.097907,47.060995,211.774477,66.583073,2,4
0,0,10,10,9,14,23,45,29,74,0.000333,0.111581,8,2677.948678,148.774927,334.743585,81.832294,2,4
0,0,8,8,9,12,21,32,21,53,0.000333,0.077598,4,931.171294,51.731739,232.792823,71.548875,2,4
0,0,12,12,11,16,27,50,35,85,0.000333,0.134722,10,4041.654377,224.536354,404.165438,102.053748,2,4
0,0,7,7,9,14,23,34,22,56,0.000333,0.08444,4,1013.277878,56.293215,253.31947,81.832294,2,4
0,0,10,10,9,17,26,49,32,81,0.000333,0.126912,4,1522.942469,84.607915,380.735617,98.016193,2,4
0,0,8,8,9,15,24,36,24,60,0.000333,0.091699,4,1100.391,61.132833,275.09775,87.132684,2,4
0,0,12,12,11,19,30,54,38,92,0.000333,0.150478,10,4514.339348,250.79663,451.433935,118.764371,2,4
0,0,7,7,9,11,20,31,19,50,0.000333,0.072032,4,864.385619,48.021423,216.096405,66.583073,2,4
0,0,10,10,9,15,24,46,29,75,0.000333,0.114624,4,1375.48875,76.416042,343.872188,87.132684,2,4
0,0,8,8,9,12,21,33,21,54,0.000333,0.079062,4,948.740563,52.707809,237.185141,71.548875,2,4
0,0,12,12,11,17,28,51,35,86,0.000333,0.137811,10,4134.325233,229.684735,413.432523,107.540616,2,4
0,0,7,7,11,12,23,36,20,56,0.000333,0.08444,5,1266.597348,70.366519,253.31947,81.073298,2,4
0,0,10,10,11,16,27,51,30,81,0.000333,0.128382,5,1925.729438,106.984969,385.145888,102.053748,2,4
0,0,8,8,11,13,24,38,22,60,0.000333,0.091699,5,1375.48875,76.416042,275.09775,86.159464,2,4
0,0,12,12,13,18,31,56,36,92,0.000333,0.151929,12,5469.432727,303.857374,455.786061,123.164366,2,4
0,0,7,7,9,11,20,31,19,50,0.000333,0.072032,4,864.385619,48.021423,216.096405,66.583073,2,4
0,0,10,10,9,15,24,46,29,75,0.000333,0.114624,4,1375.48875,76.416042,343.872188,87.132684,2,4
0,0,8,8,9,12,21,33,21,54,0.000333,0.079062,4,948.740563,52.707809,237.185141,71.548875,2,4
0,0,12,12,11,17,28,51,35,86,0.000333,0.137811,10,4134.325233,229.684735,413.432523,107.540616,2,4
0,0,7,7,9,14,23,34,22,56,0.000333,0.08444,4,1013.277878,56.293215,253.31947,81.832294,2,4
0,0,10,10,9,17,26,49,32,81,0.000333,0.126912,4,1522.942469,84.607915,380.735617,98.016193,2,4
0,0,8,8,9,15,24,36,24,60,0.000333,0.091699,4,1100.391,61.132833,275.09775,87.132684,2,4
0,0,12,12,11,19,30,54,38,92,0.000333,0.150478,10,4514.339348,250.79663,451.433935,118.764371,2,4
0,0,7,7,9,11,20,30,19,49,0.000333,0.070591,4,847.097907,47.060995,211.774477,66.583073,2,4
0,0,10,10,9,14,23,45,29,74,0.000333,0.111581,8,2677.948678,148.774927,334.743585,81.832294,2,4
0,0,8,8,9,12,21,32,21,53,0.000333,0.077598,4,931.171294,51.731739,232.792823,71.548875,2,4
0,0,12,12,11,16,27,50,35,85,0.000333,0.134722,10,4041.654377,224.536354,404.165438,102.053748,2,4
0,0,7,7,9,11,20,30,19,49,0.000333,0.070591,4,847.097907,47.060995,211.774477,66.583073,2,4
0,0,10,10,9,14,23,45,29,74,0.000333,0.111581,8,2677.948678,148.774927,334.743585,81.832294,2,4
0,0,8,8,9,12,21,32,21,53,0.000333,0.077598,4,931.171294,51.731739,232.792823,71.548875,2,4
0,0,12,12,11,16,27,50,35,85,0.000333,0.134722,10,4041.654377,224.536354,404.165438,102.053748,2,4
0,0,7,7,11,12,23,36,20,56,0.000333,0.08444,5,1266.597348,70.366519,253.31947,81.073298,2,4
0,0,10,10,11,16,27,51,30,81,0.000333,0.128382,5,1925.729438,106.984969,385.145888,102.053748,2,4
0,0,8,8,11,13,24,38,22,60,0.000333,0.091699,5,1375.48875,76.416042,275.09775,86.159464,2,4
0,0,12,12,13,18,31,56,36,92,0.000333,0.151929,12,5469.432727,303.857374,455.786061,123.164366,2,4
0,0,7,7,9,11,20,31,19,50,0.000333,0.072032,4,864.385619,48.021423,216.096405,66.583073,2,4
0,0,10,10,9,15,24,46,29,75,0.000333,0.114624,4,1375.48875,76.416042,343.872188,87.132684,2,4
0,0,8,8,9,12,21,33,21,54,0.000333,0.079062,4,948.740563,52.707809,237.185141,71.548875,2,4
0,0,12,12,11,17,28,51,35,86,0.000333,0.137811,10,4134.325233,229.684735,413.432523,107.540616,2,4
0,0,7,7,9,11,20,31,19,50,0.000333,0.072032,4,864.385619,48.021423,216.096405,66.583073,2,4
0,0,10,10,9,15,24,46,29,75,0.000333,0.114624,4,1375.48875,76.416042,343.872188,87.132684,2,4
0,0,8,8,9,12,21,33,21,54,0.000333,0.079062,4,948.740563,52.707809,237.185141,71.548875,2,4
0,0,12,12,11,17,28,51,35,86,0.000333,0.137811,10,4134.325233,229.684735,413.432523,107.540616,2,4
0,0,7,7,9,14,23,34,22,56,0.000333,0.08444,4,1013.277878,56.293215,253.31947,81.832294,2,4
0,0,10,10,9,17,26,49,32,81,0.000333,0.126912,4,1522.942469,84.607915,380.735617,98.016193,2,4
0,0,8,8,9,15,24,36,24,60,0.000333,0.091699,4,1100.391,61.132833,275.09775,87.132684,2,4
0,0,12,12,11,19,30,54,38,92,0.000333,0.150478,10,4514.339348,250.79663,451.433935,118.764371,2,4
0,0,7,7,9,11,20,30,19,49,0.000333,0.070591,4,847.097907,47.060995,211.774477,66.583073,2,4
0,0,10,10,9,14,23,45,29,74,0.000333,0.111581,8,2677.948678,148.774927,334.743585,81.832294,2,4
0,0,8,8,9,12,21,32,21,53,0.000333,0.077598,4,931.171294,51.731739,232.792823,71.548875,2,4
0,0,12,12,11,16,27,50,35,85,0.000333,0.134722,10,4041.654377,224.536354,404.165438,102.053748,2,4
0,0,7,7,9,11,20,30,19,49,0.000333,0.070591,4,847.097907,47.060995,211.774477,66.583073,2,4
0,0,10,10,9,14,23,45,29,74,0.000333,0.111581,8,2677.948678,148.774927,334.743585,81.832294,2,4
0,0,8,8,9,12,21,32,21,53,0.000333,0.077598,4,931.171294,51.731739,232.792823,71.548875,2,4
0,0,12,12,11,16,27,50,35,85,0.000333,0.134722,10,4041.654377,224.536354,404.165438,102.053748,2,4
0,0,7,7,11,12,23,36,20,56,0.000333,0.08444,5,1266.597348,70.366519,253.31947,81.073298,2,4
0,0,10,10,11,16,27,51,30,81,0.000333,0.128382,5,1925.729438,106.984969,385.145888,102.053748,2,4
0,0,8,8,11,13,24,38,22,60,0.000333,0.091699,5,1375.48875,76.416042,275.09775,86.159464,2,4
0,0,12,12,13,18,31,56,36,92,0.000333,0.151929,12,5469.432727,303.857374,455.786061,123.164366,2,4
0,0,7,7,9,11,20,31,19,50,0.000333,0.072032,4,864.385619,48.021423,216.096405,66.583073,2,4
0,0,10,10,9,15,24,46,29,75,0.000333,0.114624,4,1375.48875,76.416042,343.872188,87.132684,2,4
0,0,8,8,9,12,21,33,21,54,0.000333,0.079062,4,948.740563,52.707809,237.185141,71.548875,2,4
0,0,12,12,11,17,28,51,35,86,0.000333,0.137811,10,4134.325233,229.684735,413.432523,107.540616,2,4
0,0,7,7,9,11,20,31,19,50,0.000333,0.072032,4,864.385619,48.021423,216.096405,66.583073,2,4
0,0,10,10,9,15,24,46,29,75,0.000333,0.114624,4,1375.48875,76.416042,343.872188,87.132684,2,4
0,0,8,8,9,12,21,33,21,54,0.000333,0.079062,4,948.740563,52.707809,237.185141,71.548875,2,4
0,0,12,12,11,17,28,51,35,86,0.000333,0.137811,10,4134.325233,229.684735,413.432523,107.540616,2,4
0,0,7,7,9,11,20,30,19,49,0.000333,0.070591,4,847.097907,47.060995,211.774477,66.583073,2,4
0,0,10,10,9,14,23,45,29,74,0.000333,0.111581,8,2677.948678,148.774927,334.743585,81.832294,2,4
0,0,8,8,9,12,21,32,21,53,0.000333,0.077598,4,931.171294,51.731739,232.792823,71.548875,2,4
0,0,12,12,11,16,27,50,35,85,0.000333,0.134722,10,4041.654377,224.536354,404.165438,102.053748,2,4
0,0,7,7,9,11,20,30,19,49,0.000333,0.070591,4,847.097907,47.060995,211.774477,66.583073,2,4
0,0,10,10,9,14,23,45,29,74,0.000333,0.111581,8,2677.948678,148.774927,334.743585,81.832294,2,4
0,0,8,8,9,12,21,32,21,53,0.000333,0.077598,4,931.171294,51.731739,232.792823,71.548875,2,4
0,0,12,12,11,16,27,50,35,85,0.000333,0.134722,10,4041.654377,224.536354,404.165438,102.053748,2,4
0,0,7,7,9,14,23,34,22,56,0.000333,0.08444,4,1013.277878,56.293215,253.31947,81.832294,2,4
0,0,10,10,9,17,26,49,32,81,0.000333,0.126912,4,1522.942469,84.607915,380.735617,98.016193,2,4
0,0,8,8,9,15,24,36,24,60,0.000333,0.091699,4,1100.391,61.132833,275.09775,87.132684,2,4
0,0,12,12,11,19,30,54,38,92,0.000333,0.150478,10,4514.339348,250.79663,451.433935,118.764371,2,4
0,0,7,7,9,11,20,31,19,50,0.000333,0.072032,4,864.385619,48.021423,216.096405,66.583073,2,4
0,0,10,10,9,15,24,46,29,75,0.000333,0.114624,4,1375.48875,76.416042,343.872188,87.132684,2,4
0,0,8,8,9,12,21,33,21,54,0.000333,0.079062,4,948.740563,52.707809,237.185141,71.548875,2,4
0,0,12,12,11,17,28,51,35,86,0.000333,0.137811,10,4134.325233,229.684735,413.432523,107.540616,2,4
0,0,7,7,11,12,23,36,20,56,0.000333,0.08444,5,1266.597348,70.366519,253.31947,81.073298,2,4
0,0,10,10,11,16,27,51,30,81,0.000333,0.128382,5,1925.729438,106.984969,385.145888,102.053748,2,4
0,0,8,8,11,13,24,38,22,60,0.000333,0.091699,5,1375.48875,76.416042,275.09775,86.159464,2,4
0,0,12,12,13,18,31,56,36,92,0.000333,0.151929,12,5469.432727,303.857374,455.786061,123.164366,2,4
0,0,7,7,9,11,20,31,19,50,0.000333,0.072032,4,864.385619,48.021423,216.096405,66.583073,2,4
0,0,10,10,9,15,24,46,29,75,0.000333,0.114624,4,1375.48875,76.416042,343.872188,87.132684,2,4
0,0,8,8,9,12,21,33,21,54,0.000333,0.079062,4,948.740563,52.707809,237.185141,71.548875,2,4
0,0,12,12,11,17,28,51,35,86,0.000333,0.137811,10,4134.325233,229.684735,413.432523,107.540616,2,4
0,0,7,7,9,11,20,30,19,49,0.000333,0.070591,4,847.097907,47.060995,211.774477,66.583073,2,4
0,0,10,10,9,14,23,45,29,74,0.000333,0.111581,8,2677.948678,148.774927,334.743585,81.832294,2,4
0,0,8,8,9,12,21,32,21,53,0.000333,0.077598,4,931.171294,51.731739,232.792823,71.548875,2,4
0,0,12,12,11,16,27,50,35,85,0.000333,0.134722,10,4041.654377,224.536354,404.165438,102.053748,2,4
0,0,7,7,9,11,20,30,19,49,0.000333,0.070591,4,847.097907,47.060995,211.774477,66.583073,2,4
0,0,10,10,9,14,23,45,29,74,0.000333,0.111581,8,2677.948678,148.774927,334.743585,81.832294,2,4
0,0,8,8,9,12,21,32,21,53,0.000333,0.077598,4,931.171294,51.731739,232.792823,71.548875,2,4
0,0,12,12,11,16,27,50,35,85,0.000333,0.134722,10,4041.654377,224.536354,404.165438,102.053748,2,4
0,0,7,7,9,14,23,34,22,56,0.000333,0.08444,4,1013.277878,56.293215,253.31947,81.832294,2,4
0,0,10,10,9,17,26,49,32,81,0.000333,0.126912,4,1522.942469,84.607915,380.735617,98.016193,2,4
0,0,8,8,9,15,24,36,24,60,0.000333,0.091699,4,1100.391,61.132833,275.09775,87.132684,2,4
0,0,12,12,11,19,30,54,38,92,0.000333,0.150478,10,4514.339348,250.79663,451.433935,118.764371,2,4
0,0,7,7,9,11,20,31,19,50,0.000333,0.072032,4,864.385619,48.021423,216.096405,66.583073,2,4
0,0,10,10,9,15,24,46,29,75,0.000333,0.114624,4,1375.48875,76.416042,343.872188,87.132684,2,4
0,0,8,8,9,12,21,33,21,54,0.000333,0.079062,4,948.740563,52.707809,237.185141,71.548875,2,4
0,0,12,12,11,17,28,51,35,86,0.000333,0.137811,10,4134.325233,229.684735,413.432523,107.540616,2,4
0,0,7,7,11,12,23,36,20,56,0.000333,0.08444,5,1266.597348,70.366519,253.31947,81.073298,2,4
0,0,10,10,11,16,27,51,30,81,0.000333,0.128382,5,1925.729438,106.984969,385.145888,102.053748,2,4
0,0,8,8,11,13,24,38,22,60,0.000333,0.091699,5,1375.48875,76.416042,275.09775,86.159464,2,4
0,0,12,12,13,18,31,56,36,92,0.000333,0.151929,12,5469.432727,303.857374,455.786061,123.164366,2,4
0,0,7,7,9,11,20,31,19,50,0.000333,0.072032,4,864.385619,48.021423,216.096405,66.583073,2,4
0,0,10,10,9,15,24,46,29,75,0.000333,0.114624,4,1375.48875,76.416042,343.872188,87.132684,2,4
0,0,8,8,9,12,21,33,21,54,0.000333,0.079062,4,948.740563,52.707809,237.185141,71.548875,2,4
0,0,12,12,11,17,28,51,35,86,0.000333,0.137811,10,4134.325233,229.684735,413.432523,107.540616,2,4
0,0,7,7,9,11,20,30,19,49,0.000333,0.070591,4,847.097907,47.060995,211.774477,66.583073,2,4
0,0,10,10,9,14,23,45,29,74,0.000333,0.111581,8,2677.948678,148.774927,334.743585,81.832294,2,4
0,0,8,8,9,12,21,32,21,53,0.000333,0.077598,4,931.171294,51.731739,232.792823,71.548875,2,4
0,0,12,12,11,16,27,50,35,85,0.000333,0.134722,10,4041.654377,224.536354,404.165438,102.053748,2,4
0,0,7,7,9,11,20,30,19,49,0.000333,0.070591,4,847.097907,47.060995,211.774477,66.583073,2,4
0,0,10,10,9,14,23,45,29,74,0.000333,0.111581,8,2677.948678,148.774927,334.743585,81.832294,2,4
0,0,8,8,9,12,21,32,21,53,0.000333,0.077598,4,931.171294,51.731739,232.792823,71.548875,2,4
0,0,12,12,11,16,27,50,35,85,0.000333,0.134722,10,4041.654377,224.536354,404.165438,102.053748,2,4
0,0,7,7,9,14,23,34,22,56,0.000333,0.08444,4,1013.277878,56.293215,253.31947,81.832294,2,4
0,0,10,10,9,17,26,49,32,81,0.000333,0.126912,4,1522.942469,84.607915,380.735617,98.016193,2,4
0,0,8,8,9,15,24,36,24,60,0.000333,0.091699,4,1100.391,61.132833,275.09775,87.132684,2,4
0,0,12,12,11,19,30,54,38,92,0.000333,0.150478,10,4514.339348,250.79663,451.433935,118.764371,2,4
0,0,7,7,9,11,20,31,19,50,0.000333,0.072032,4,864.385619,48.021423,216.096405,66.583073,2,4
0,0,10,10,9,15,24,46,29,75,0.000333,0.114624,4,1375.48875,76.416042,343.872188,87.132684,2,4
0,0,8,8,9,12,21,33,21,54,0.000333,0.079062,4,948.740563,52.707809,237.185141,71.548875,2,4
0,0,12,12,11,17,28,51,35,86,0.000333,0.137811,10,4134.325233,229.684735,413.432523,107.540616,2,4
0,0,7,7,11,12,23,36,20,56,0.000333,0.08444,5,1266.597348,70.366519,253.31947,81.073298,2,4
0,0,10,10,11,16,27,51,30,81,0.000333,0.128382,5,1925.729438,106.984969,385.145888,102.053748,2,4
0,0,8,8,11,13,24,38,22,60,0.000333,0.091699,5,1375.48875,76.416042,275.09775,86.159464,2,4
0,0,12,12,13,18,31,56,36,92,0.000333,0.151929,12,5469.432727,303.857374,455.786061,123.164366,2,4
0,0,7,7,9,11,20,31,19,50,0.000333,0.072032,4,864.385619,48.021423,216.096405,66.583073,2,4
0,0,10,10,9,15,24,46,29,75,0.000333,0.114624,4,1375.48875,76.416042,343.872188,87.132684,2,4
0,0,8,8,9,12,21,33,21,54,0.000333,0.079062,4,948.740563,52.707809,237.185141,71.548875,2,4
0,0,12,12,11,17,28,51,35,86,0.000333,0.137811,10,4134.325233,229.684735,413.432523,107.540616,2,4
0,0,7,7,9,11,20,30,19,49,0.000333,0.070591,4,847.097907,47.060995,211.774477,66.583073,2,4
0,0,10,10,9,14,23,45,29,74,0.000333,0.111581,8,2677.948678,148.774927,334.743585,81.832294,2,4
0,0,8,8,9,12,21,32,21,53,0.000333,0.077598,4,931.171294,51.731739,232.792823,71.548875,2,4
0,0,12,12,11,16,27,50,35,85,0.000333,0.134722,10,4041.654377,224.536354,404.165438,102.053748,2,4
0,0,7,7,9,11,20,30,19,49,0.000333,0.070591,4,847.097907,47.060995,211.774477,66.583073,2,4
0,0,10,10,9,14,23,45,29,74,0.000333,0.111581,8,2677.948678,148.774927,334.743585,81.832294,2,4
0,0,8,8,9,12,21,32,21,53,0.000333,0.077598,4,931.171294,51.731739,232.792823,71.548875,2,4
0,0,12,12,11,16,27,50,35,85,0.000333,0.134722,10,4041.654377,224.536354,404.165438,102.053748,2,4
0,0,7,7,9,14,23,34,22,56,0.000333,0.08444,4,1013.277878,56.293215,253.31947,81.832294,2,4
0,0,10,10,9,17,26,49,32,81,0.000333,0.126912,4,1522.942469,84.607915,380.735617,98.016193,2,4
0,0,8,8,9,15,24,36,24,60,0.000333,0.091699,4,1100.391,61.132833,275.09775,87.132684,2,4
0,0,12,12,11,19,30,54,38,92,0.000333,0.150478,10,4514.339348,250.79663,451.433935,118.764371,2,4
0,0,7,7,9,11,20,31,19,50,0.000333,0.072032,4,864.385619,48.021423,216.096405,66.583073,2,4
0,0,10,10,9,15,24,46,29,75,0.000333,0.114624,4,1375.48875,76.416042,343.872188,87.132684,2,4
0,0,8,8,9,12,21,33,21,54,0.000333,0.079062,4,948.740563,52.707809,237.185141,71.548875,2,4
0,0,12,12,11,17,28,51,35,86,0.000333,0.137811,10,4134.325233,229.684735,413.432523,107.540616,2,4
0,0,7,7,11,12,23,36,20,56,0.000333,0.08444,5,1266.597348,70.366519,253.31947,81.073298,2,4
0,0,10,10,11,16,27,51,30,81,0.000333,0.128382,5,1925.729438,106.984969,385.145888,102.053748,2,4
0,0,8,8,11,13,24,38,22,60,0.000333,0.091699,5,1375.48875,76.416042,275.09775,86.159464,2,4
0,0,12,12,13,18,31,56,36,92,0.000333,0.151929,12,5469.432727,303.857374,455.786061,123.164366,2,4
0,0,7,7,9,11,20,31,19,50,0.000333,0.072032,4,864.385619,48.021423,216.096405,66.583073,2,4
0,0,10,10,9,15,24,46,29,75,0.000333,0.114624,4,1375.48875,76.416042,343.872188,87.132684,2,4
0,0,8,8,9,12,21,33,21,54,0.000333,0.079062,4,948.740563,52.707809,237.185141,71.548875,2,4
0,0,12,12,11,17,28,51,35,86,0.000333,0.137811,10,4134.325233,229.684735,413.432523,107.540616,2,4
0,0,7,7,9,11,20,30,19,49,0.000333,0.070591,4,847.097907,47.060995,211.774477,66.583073,2,4
0,0,10,10,9,14,23,45,29,74,0.000333,0.111581,8,2677.948678,148.774927,334.743585,81.832294,2,4
0,0,8,8,9,12,21,32,21,53,0.000333,0.077598,4,931.171294,51.731739,232.792823,71.548875,2,4
0,0,12,12,11,16,27,50,35,85,0.000333,0.134722,10,4041.654377,224.536354,404.165438,102.053748,2,4
0,0,7,7,9,11,20,30,19,49,0.000333,0.070591,4,847.097907,47.060995,211.774477,66.583073,2,4
0,0,10,10,9,14,23,45,29,74,0.000333,0.111581,8,2677.948678,148.774927,334.743585,81.832294,2,4
0,0,8,8,9,12,21,32,21,53,0.000333,0.077598,4,931.171294,51.731739,232.792823,71.548875,2,4
0,0,12,12,11,16,27,50,35,85,0.000333,0.134722,10,4041.654377,224.536354,404.165438,102.053748,2,4
0,0,7,7,9,14,23,34,22,56,0.000333,0.08444,4,1013.277878,56.293215,253.31947,81.832294,2,4
0,0,10,10,9,17,26,49,32,81,0.000333,0.126912,4,1522.942469,84.607915,380.735617,98.016193,2,4
0,0,8,8,9,15,24,36,24,60,0.000333,0.091699,4,1100.391,61.132833,275.09775,87.132684,2,4
0,0,12,12,11,19,30,54,38,92,0.000333,0.150478,10,4514.339348,250.79663,451.433935,118.764371,2,4
0,0,7,7,9,11,20,31,19,50,0.000333,0.072032,4,864.385619,48.021423,216.096405,66.583073,2,4
0,0,10,10,9,15,24,46,29,75,0.000333,0.114624,4,1375.48875,76.416042,343.872188,87.132684,2,4
0,0,8,8,9,12,21,33,21,54,0.000333,0.079062,4,948.740563,52.707809,237.185141,71.548875,2,4
0,0,12,12,11,17,28,51,35,86,0.000333,0.137811,10,4134.325233,229.684735,413.432523,107.540616,2,4
0,0,7,7,11,12,23,36,20,56,0.000333,0.08444,5,1266.597348,70.366519,253.31947,81.073298,2,4
0,0,10,10,11,16,27,51,30,81,0.000333,0.128382,5,1925.729438,106.984969,385.145888,102.053748,2,4
0,0,8,8,11,13,24,38,22,60,0.000333,0.091699,5,1375.48875,76.416042,275.09775,86.159464,2,4
0,0,12,12,13,18,31,56,36,92,0.000333,0.151929,12,5469.432727,303.857374,455.786061,123.164366,2,4
0,0,7,7,9,11,20,31,19,50,0.000333,0.072032,4,864.385619,48.021423,216.096405,66.583073,2,4
0,0,10,10,9,15,24,46,29,75,0.000333,0.114624,4,1375.48875,76.416042,343.872188,87.132684,2,4
0,0,8,8,9,12,21,33,21,54,0.000333,0.079062,4,948.740563,52.707809,237.185141,71.548875,2,4
0,0,12,12,11,17,28,51,35,86,0.000333,0.137811,10,4134.325233,229.684735,413.432523,107.540616,2,4
0,0,7,7,9,11,20,30,19,49,0.000333,0.070591,4,847.097907,47.060995,211.774477,66.583073,2,4
0,0,10,10,9,14,23,45,29,74,0.000333,0.111581,8,2677.948678,148.774927,334.743585,81.832294,2,4
0,0,8,8,9,12,21,32,21,53,0.000333,0.077598,4,931.171294,51.731739,232.792823,71.548875,2,4
0,0,12,12,11,16,27,50,35,85,0.000333,0.134722,10,4041.654377,224.536354,404.165438,102.053748,2,4
0,0,7,7,9,11,20,30,19,49,0.000333,0.070591,4,847.097907,47.060995,211.774477,66.583073,2,4
0,0,10,10,9,14,23,45,29,74,0.000333,0.111581,8,2677.948678,148.774927,334.743585,81.832294,2,4
0,0,8,8,9,12,21,32,21,53,0.000333,0.077598,4,931.171294,51.731739,232.792823,71.548875,2,4
0,0,12,12,11,16,27,50,35,85,0.000333,0.134722,10,4041.654377,224.536354,404.165438,102.053748,2,4
0,0,7,7,9,14,23,34,22,56,0.000333,0.08444,4,1013.277878,56.293215,253.31947,81.832294,2,4
0,0,10,10,9,17,26,49,32,81,0.000333,0.126912,4,1522.942469,84.607915,380.735617,98.016193,2,4
0,0,8,8,9,15,24,36,24,60,0.000333,0.091699,4,1100.391,61.132833,275.09775,87.132684,2,4
0,0,12,12,11,19,30,54,38,92,0.000333,0.150478,10,4514.339348,250.79663,451.433935,118.764371,2,4
0,0,7,7,9,11,20,31,19,50,0.000333,0.072032,4,864.385619,48.021423,216.096405,66.583073,2,4
0,0,10,10,9,15,24,46,29,75,0.000333,0.114624,4,1375.48875,76.416042,343.872188,87.132684,2,4
0,0,8,8,9,12,21,33,21,54,0.000333,0.079062,4,948.740563,52.707809,237.185141,71.548875,2,4
0,0,12,12,11,17,28,51,35,86,0.000333,0.137811,10,4134.325233,229.684735,413.432523,107.540616,2,4
0,0,7,7,11,12,23,36,20,56,0.000333,0.08444,5,1266.597348,70.366519,253.31947,81.073298,2,4
0,0,10,10,11,16,27,51,30,81,0.000333,0.128382,5,1925.729438,106.984969,385.145888,102.053748,2,4
0,0,8,8,11,13,24,38,22,60,0.000333,0.091699,5,1375.48875,76.416042,275.09775,86.159464,2,4
0,0,12,12,13,18,31,56,36,92,0.000333,0.151929,12,5469.432727,303.857374,455.786061,123.164366,2,4
0,0,7,7,9,11,20,31,19,50,0.000333,0.072032,4,864.385619,48.021423,216.096405,66.583073,2,4
0,0,10,10,9,15,24,46,29,75,0.000333,0.114624,4,1375.48875,76.416042,343.872188,87.132684,2,4
0,0,8,8,9,12,21,33,21,54,0.000333,0.079062,4,948.740563,52.707809,237.185141,71.548875,2,4
0,0,12,12,11,17,28,51,35,86,0.000333,0.137811,10,4134.325233,229.684735,413.432523,107.540616,2,4
0,0,7,7,9,11,20,30,19,49,0.000333,0.070591,4,847.097907,47.060995,211.774477,66.583073,2,4
0,0,10,10,9,14,23,45,29,74,0.000333,0.111581,8,2677.948678,148.774927,334.743585,81.832294,2,4
0,0,8,8,9,12,21,32,21,53,0.000333,0.077598,4,931.171294,51.731739,232.792823,71.548875,2,4
0,0,12,12,11,16,27,50,35,85,0.000333,0.134722,10,4041.654377,224.536354,404.165438,102.053748,2,4
0,0,7,7,9,14,23,34,22,56,0.000333,0.08444,4,1013.277878,56.293215,253.31947,81.832294,2,4
0,0,10,10,9,17,26,49,32,81,0.000333,0.126912,4,1522.942469,84.607915,380.735617,98.016193,2,4
0,0,8,8,9,15,24,36,24,60,0.000333,0.091699,4,1100.391,61.132833,275.09775,87.132684,2,4
0,0,12,12,11,19,30,54,38,92,0.000333,0.150478,10,4514.339348,250.79663,451.433935,118.764371,2,4
0,0,7,7,9,11,20,30,19,49,0.000333,0.070591,4,847.097907,47.060995,211.774477,66.583073,2,4
0,0,10,10,9,14,23,45,29,74,0.000333,0.111581,8,2677.948678,148.774927,334.743585,81.832294,2,4
0,0,8,8,9,12,21,32,21,53,0.000333,0.077598,4,931.171294,51.731739,232.792823,71.548875,2,4
0,0,12,12,11,16,27,50,35,85,0.000333,0.134722,10,4041.654377,224.536354,404.165438,102.053748,2,4
0,0,8,8,11,13,24,38,22,60,0.000333,0.091699,5,1375.48875,76.416042,275.09775,86.159464,2,4
0,0,11,11,11,17,28,53,32,85,0.000333,0.136208,5,2043.125842,113.506991,408.625168,107.540616,2,4
0,0,9,9,11,14,25,40,24,64,0.000333,0.099069,5,1486.033981,82.557443,297.206796,91.356717,2,4
0,0,13,13,13,19,32,58,38,96,0.000333,0.16,12,5760,320,480,128.816339,2,4
0,0,7,7,9,10,19,31,19,50,0.000333,0.070799,4,849.585503,47.199195,212.396376,61.748606,2,4
0,0,10,10,9,14,23,46,29,75,0.000333,0.113089,8,2714.137174,150.785399,339.267147,81.832294,2,4
0,0,8,8,9,11,20,33,21,54,0.000333,0.077795,4,933.536468,51.863137,233.384117,66.583073,2,4
0,0,12,12,11,16,27,51,35,86,0.000333,0.136307,10,4089.203252,227.177958,408.920325,102.053748,2,4
0,0,7,7,9,10,19,31,19,50,0.000333,0.070799,4,849.585503,47.199195,212.396376,61.748606,2,4
0,0,10,10,9,14,23,46,29,75,0.000333,0.113089,8,2714.137174,150.785399,339.267147,81.832294,2,4
0,0,8,8,9,11,20,33,21,54,0.000333,0.077795,4,933.536468,51.863137,233.384117,66.583073,2,4
0,0,12,12,11,16,27,51,35,86,0.000333,0.136307,10,4089.203252,227.177958,408.920325,102.053748,2,4
0,0,7,7,9,11,20,30,19,49,0.000333,0.070591,4,847.097907,47.060995,211.774477,66.583073,2,4
0,0,10,10,9,14,23,45,29,74,0.000333,0.111581,8,2677.948678,148.774927,334.743585,81.832294,2,4
0,0,8,8,9,12,21,32,21,53,0.000333,0.077598,4,931.171294,51.731739,232.792823,71.548875,2,4
0,0,12,12,11,16,27,50,35,85,0.000333,0.134722,10,4041.654377,224.536354,404.165438,102.053748,2,4
0,0,7,7,9,11,20,30,19,49,0.000333,0.070591,4,847.097907,47.060995,211.774477,66.583073,2,4
0,0,10,10,9,14,23,45,29,74,0.000333,0.111581,8,2677.948678,148.774927,334.743585,81.832294,2,4
0,0,8,8,9,12,21,32,21,53,0.000333,0.077598,4,931.171294,51.731739,232.792823,71.548875,2,4
0,0,12,12,11,16,27,50,35,85,0.000333,0.134722,10,4041.654377,224.536354,404.165438,102.053748,2,4
0,0,7,7,9,14,23,34,22,56,0.000333,0.08444,4,1013.277878,56.293215,253.31947,81.832294,2,4
0,0,10,10,9,17,26,49,32,81,0.000333,0.126912,4,1522.942469,84.607915,380.735617,98.016193,2,4
0,0,8,8,9,15,24,36,24,60,0.000333,0.091699,4,1100.391,61.132833,275.09775,87.132684,2,4
0,0,12,12,11,19,30,54,38,92,0.000333,0.150478,10,4514.339348,250.79663,451.433935,118.764371,2,4
0,0,7,7,9,11,20,31,19,50,0.000333,0.072032,4,864.385619,48.021423,216.096405,66.583073,2,4
0,0,10,10,9,15,24,46,29,75,0.000333,0.114624,4,1375.48875,76.416042,343.872188,87.132684,2,4
0,0,8,8,9,12,21,33,21,54,0.000333,0.079062,4,948.740563,52.707809,237.185141,71.548875,2,4
0,0,12,12,11,17,28,51,35,86,0.000333,0.137811,10,4134.325233,229.684735,413.432523,107.540616,2,4
0,0,7,7,11,12,23,36,20,56,0.000333,0.08444,5,1266.597348,70.366519,253.31947,81.073298,2,4
0,0,10,10,11,16,27,51,30,81,0.000333,0.128382,5,1925.729438,106.984969,385.145888,102.053748,2,4
0,0,8,8,11,13,24,38,22,60,0.000333,0.091699,5,1375.48875,76.416042,275.09775,86.159464,2,4
0,0,12,12,13,18,31,56,36,92,0.000333,0.151929,12,5469.432727,303.857374,455.786061,123.164366,2,4
0,0,7,7,9,11,20,31,19,50,0.000333,0.072032,4,864.385619,48.021423,216.096405,66.583073,2,4
0,0,10,10,9,15,24,46,29,75,0.000333,0.114624,4,1375.48875,76.416042,343.872188,87.132684,2,4
0,0,8,8,9,12,21,33,21,54,0.000333,0.079062,4,948.740563,52.707809,237.185141,71.548875,2,4
0,0,12,12,11,17,28,51,35,86,0.000333,0.137811,10,4134.325233,229.684735,413.432523,107.540616,2,4
0,0,7,7,9,11,20,30,19,49,0.000333,0.070591,4,847.097907,47.060995,211.774477,66.583073,2,4
0,0,10,10,9,14,23,45,29,74,0.000333,0.111581,8,2677.948678,148.774927,334.743585,81.832294,2,4
0,0,8,8,9,12,21,32,21,53,0.000333,0.077598,4,931.171294,51.731739,232.792823,71.548875,2,4
0,0,12,12,11,16,27,50,35,85,0.000333,0.134722,10,4041.654377,224.536354,404.165438,102.053748,2,4
0,0,7,7,9,11,20,30,19,49,0.000333,0.070591,4,847.097907,47.060995,211.774477,66.583073,2,4
0,0,10,10,9,14,23,45,29,74,0.000333,0.111581,8,2677.948678,148.774927,334.743585,81.832294,2,4
0,0,8,8,9,12,21,32,21,53,0.000333,0.077598,4,931.171294,51.731739,232.792823,71.548875,2,4
0,0,12,12,11,16,27,50,35,85,0.000333,0.134722,10,4041.654377,224.536354,404.165438,102.053748,2,4
0,0,7,7,9,14,23,34,22,56,0.000333,0.08444,4,1013.277878,56.293215,253.31947,81.832294,2,4
0,0,10,10,9,17,26,49,32,81,0.000333,0.126912,4,1522.942469,84.607915,380.735617,98.016193,2,4
0,0,8,8,9,15,24,36,24,60,0.000333,0.091699,4,1100.391,61.132833,275.09775,87.132684,2,4
0,0,12,12,11,19,30,54,38,92,0.000333,0.150478,10,4514.339348,250.79663,451.433935,118.764371,2,4
0,0,7,7,9,11,20,31,19,50,0.000333,0.072032,4,864.385619,48.021423,216.096405,66.583073,2,4
0,0,10,10,9,15,24,46,29,75,0.000333,0.114624,4,1375.48875,76.416042,343.872188,87.132684,2,4
0,0,8,8,9,12,21,33,21,54,0.000333,0.079062,4,948.740563,52.707809,237.185141,71.548875,2,4
0,0,12,12,11,17,28,51,35,86,0.000333,0.137811,10,4134.325233,229.684735,413.432523,107.540616,2,4
0,0,7,7,11,12,23,36,20,56,0.000333,0.08444,5,1266.597348,70.366519,253.31947,81.073298,2,4
0,0,10,10,11,16,27,51,30,81,0.000333,0.128382,5,1925.729438,106.984969,385.145888,102.053748,2,4
0,0,8,8,11,13,24,38,22,60,0.000333,0.091699,5,1375.48875,76.416042,275.09775,86.159464,2,4
0,0,12,12,13,18,31,56,36,92,0.000333,0.151929,12,5469.432727,303.857374,455.786061,123.164366,2,4
0,0,7,7,9,11,20,31,19,50,0.000333,0.072032,4,864.385619,48.021423,216.096405,66.583073,2,4
0,0,10,10,9,15,24,46,29,75,0.000333,0.114624,4,1375.48875,76.416042,343.872188,87.132684,2,4
0,0,8,8,9,12,21,33,21,54,0.000333,0.079062,4,948.740563,52.707809,237.185141,71.548875,2,4
0,0,12,12,11,17,28,51,35,86,0.000333,0.137811,10,4134.325233,229.684735,413.432523,107.540616,2,4
0,0,7,7,9,11,20,30,19,49,0.000333,0.070591,4,847.097907,47.060995,211.774477,66.583073,2,4
0,0,10,10,9,14,23,45,29,74,0.000333,0.111581,8,2677.948678,148.774927,334.743585,81.832294,2,4
0,0,8,8,9,12,21,32,21,53,0.000333,0.077598,4,931.171294,51.731739,232.792823,71.548875,2,4
0,0,12,12,11,16,27,50,35,85,0.000333,0.134722,10,4041.654377,224.536354,404.165438,102.053748,2,4
0,0,7,7,9,14,23,34,22,56,0.000333,0.08444,4,1013.277878,56.293215,253.31947,81.832294,2,4
0,0,10,10,9,17,26,49,32,81,0.000333,0.126912,4,1522.942469,84.607915,380.735617,98.016193,2,4
0,0,8,8,9,15,24,36,24,60,0.000333,0.091699,4,1100.391,61.132833,275.09775,87.132684,2,4
0,0,12,12,11,19,30,54,38,92,0.000333,0.150478,10,4514.339348,250.79663,451.433935,118.764371,2,4
0,0,7,7,9,11,20,30,19,49,0.000333,0.070591,4,847.097907,47.060995,211.774477,66.583073,2,4
0,0,10,10,9,14,23,45,29,74,0.000333,0.111581,8,2677.948678,148.774927,334.743585,81.832294,2,4
0,0,8,8,9,12,21,32,21,53,0.000333,0.077598,4,931.171294,51.731739,232.792823,71.548875,2,4
0,0,12,12,11,16,27,50,35,85,0.000333,0.134722,10,4041.654377,224.536354,404.165438,102.053748,2,4
0,0,7,7,9,11,20,31,19,50,0.000333,0.072032,4,864.385619,48.021423,216.096405,66.583073,2,4
0,0,10,10,9,15,24,46,29,75,0.000333,0.114624,4,1375.48875,76.416042,343.872188,87.132684,2,4
0,0,8,8,9,12,21,33,21,54,0.000333,0.079062,4,948.740563,52.707809,237.185141,71.548875,2,4
0,0,12,12,11,17,28,51,35,86,0.000333,0.137811,10,4134.325233,229.684735,413.432523,107.540616,2,4
0,0,7,7,9,11,20,31,19,50,0.000333,0.072032,4,864.385619,48.021423,216.096405,66.583073,2,4
0,0,10,10,9,15,24,46,29,75,0.000333,0.114624,4,1375.48875,76.416042,343.872188,87.132684,2,4
0,0,8,8,9,12,21,33,21,54,0.000333,0.079062,4,948.740563,52.707809,237.185141,71.548875,2,4
0,0,12,12,11,17,28,51,35,86,0.000333,0.137811,10,4134.325233,229.684735,413.432523,107.540616,2,4
0,0,7,7,11,12,23,36,20,56,0.000333,0.08444,5,1266.597348,70.366519,253.31947,81.073298,2,4
0,0,10,10,11,16,27,51,30,81,0.000333,0.128382,5,1925.729438,106.984969,385.145888,102.053748,2,4
0,0,8,8,11,13,24,38,22,60,0.000333,0.091699,5,1375.48875,76.416042,275.09775,86.159464,2,4
0,0,12,12,13,18,31,56,36,92,0.000333,0.151929,12,5469.432727,303.857374,455.786061,123.164366,2,4
0,0,7,7,9,11,20,30,19,49,0.000333,0.070591,4,847.097907,47.060995,211.774477,66.583073,2,4
0,0,10,10,9,14,23,45,29,74,0.000333,0.111581,8,2677.948678,148.774927,334.743585,81.832294,2,4
0,0,8,8,9,12,21,32,21,53,0.000333,0.077598,4,931.171294,51.731739,232.792823,71.548875,2,4
0,0,12,12,11,16,27,50,35,85,0.000333,0.134722,10,4041.654377,224.536354,404.165438,102.053748,2,4
0,0,7,7,9,14,23,34,22,56,0.000333,0.08444,4,1013.277878,56.293215,253.31947,81.832294,2,4
0,0,10,10,9,17,26,49,32,81,0.000333,0.126912,4,1522.942469,84.607915,380.735617,98.016193,2,4
0,0,8,8,9,15,24,36,24,60,0.000333,0.091699,4,1100.391,61.132833,275.09775,87.132684,2,4
0,0,12,12,11,19,30,54,38,92,0.000333,0.150478,10,4514.339348,250.79663,451.433935,118.764371,2,4
0,0,7,7,11,12,23,36,20,56,0.000333,0.08444,5,1266.597348,70.366519,253.31947,81.073298,2,4
0,0,10,10,11,16,27,51,30,81,0.000333,0.128382,5,1925.729438,106.984969,385.145888,102.053748,2,4
0,0,8,8,11,13,24,38,22,60,0.000333,0.091699,5,1375.48875,76.416042,275.09775,86.159464,2,4
0,0,12,12,13,18,31,56,36,92,0.000333,0.151929,12,5469.432727,303.857374,455.786061,123.164366,2,4
0,0,7,7,11,12,23,36,20,56,0.000333,0.08444,5,1266.597348,70.366519,253.31947,81.073298,2,4
0,0,10,10,11,16,27,51,30,81,0.000333,0.128382,5,1925.729438,106.984969,385.145888,102.053748,2,4
0,0,8,8,11,13,24,38,22,60,0.000333,0.091699,5,1375.48875,76.416042,275.09775,86.159464,2,4
0,0,12,12,13,18,31,56,36,92,0.000333,0.151929,12,5469.432727,303.857374,455.786061,123.164366,2,4
0,0,7,7,9,14,23,34,22,56,0.000333,0.08444,4,1013.277878,56.293215,253.31947,81.832294,2,4
0,0,10,10,9,17,26,49,32,81,0.000333,0.126912,4,1522.942469,84.607915,380.735617,98.016193,2,4
0,0,8,8,9,15,24,36,24,60,0.000333,0.091699,4,1100.391,61.132833,275.09775,87.132684,2,4
0,0,12,12,11,19,30,54,38,92,0.000333,0.150478,10,4514.339348,250.79663,451.433935,118.764371,2,4
0,0,7,7,9,11,20,30,19,49,0.000333,0.070591,4,847.097907,47.060995,211.774477,66.583073,2,4
0,0,10,10,9,14,23,45,29,74,0.000333,0.111581,8,2677.948678,148.774927,334.743585,81.832294,2,4
0,0,8,8,9,12,21,32,21,53,0.000333,0.077598,4,931.171294,51.731739,232.792823,71.548875,2,4
0,0,12,12,11,16,27,50,35,85,0.000333,0.134722,10,4041.654377,224.536354,404.165438,102.053748,2,4
0,0,7,7,11,12,23,36,20,56,0.000333,0.08444,5,1266.597348,70.366519,253.31947,81.073298,2,4
0,0,10,10,11,16,27,51,30,81,0.000333,0.128382,5,1925.729438,106.984969,385.145888,102.053748,2,4
0,0,8,8,11,13,24,38,22,60,0.000333,0.091699,5,1375.48875,76.416042,275.09775,86.159464,2,4
0,0,12,12,13,18,31,56,36,92,0.000333,0.151929,12,5469.432727,303.857374,455.786061,123.164366,2,4
0,0,7,7,11,12,23,36,20,56,0.000333,0.08444,5,1266.597348,70.366519,253.31947,81.073298,2,4
0,0,10,10,11,16,27,51,30,81,0.000333,0.128382,5,1925.729438,106.984969,385.145888,102.053748,2,4
0,0,8,8,11,13,24,38,22,60,0.000333,0.091699,5,1375.48875,76.416042,275.09775,86.159464,2,4
0,0,12,12,13,18,31,56,36,92,0.000333,0.151929,12,5469.432727,303.857374,455.786061,123.164366,2,4
0,0,7,7,9,11,20,30,19,49,0.000333,0.070591,4,847.097907,47.060995,211.774477,66.583073,2,4
0,0,10,10,9,14,23,45,29,74,0.000333,0.111581,8,2677.948678,148.774927,334.743585,81.832294,2,4
0,0,8,8,9,12,21,32,21,53,0.000333,0.077598,4,931.171294,51.731739,232.792823,71.548875,2,4
0,0,12,12,11,16,27,50,35,85,0.000333,0.134722,10,4041.654377,224.536354,404.165438,102.053748,2,4
0,0,7,7,9,14,23,34,22,56,0.000333,0.08444,4,1013.277878,56.293215,253.31947,81.832294,2,4
0,0,10,10,9,17,26,49,32,81,0.000333,0.126912,4,1522.942469,84.607915,380.735617,98.016193,2,4
0,0,8,8,9,15,24,36,24,60,0.000333,0.091699,4,1100.391,61.132833,275.09775,87.132684,2,4
0,0,12,12,11,19,30,54,38,92,0.000333,0.150478,10,4514.339348,250.79663,451.433935,118.764371,2,4
0,0,7,7,11,12,23,36,20,56,0.000333,0.08444,5,1266.597348,70.366519,253.31947,81.073298,2,4
0,0,10,10,11,16,27,51,30,81,0.000333,0.128382,5,1925.729438,106.984969,385.145888,102.053748,2,4
0,0,8,8,11,13,24,38,22,60,0.000333,0.091699,5,1375.48875,76.416042,275.09775,86.159464,2,4
0,0,12,12,13,18,31,56,36,92,0.000333,0.151929,12,5469.432727,303.857374,455.786061,123.164366,2,4
0,0,7,7,11,12,23,36,20,56,0.000333,0.08444,5,1266.597348,70.366519,253.31947,81.073298,2,4
0,0,10,10,11,16,27,51,30,81,0.000333,0.128382,5,1925.729438,106.984969,385.145888,102.053748,2,4
0,0,8,8,11,13,24,38,22,60,0.000333,0.091699,5,1375.48875,76.416042,275.09775,86.159464,2,4
0,0,12,12,13,18,31,56,36,92,0.000333,0.151929,12,5469.432727,303.857374,455.786061,123.164366,2,4
0,0,7,7,9,14,23,34,22,56,0.000333,0.08444,4,1013.277878,56.293215,253.31947,81.832294,2,4
0,0,10,10,9,17,26,49,32,81,0.000333,0.126912,4,1522.942469,84.607915,380.735617,98.016193,2,4
0,0,8,8,9,15,24,36,24,60,0.000333,0.091699,4,1100.391,61.132833,275.09775,87.132684,2,4
0,0,12,12,11,19,30,54,38,92,0.000333,0.150478,10,4514.339348,250.79663,451.433935,118.764371,2,4
0,0,7,7,9,11,20,30,19,49,0.000333,0.070591,4,847.097907,47.060995,211.774477,66.583073,2,4
0,0,10,10,9,14,23,45,29,74,0.000333,0.111581,8,2677.948678,148.774927,334.743585,81.832294,2,4
0,0,8,8,9,12,21,32,21,53,0.000333,0.077598,4,931.171294,51.731739,232.792823,71.548875,2,4
0,0,12,12,11,16,27,50,35,85,0.000333,0.134722,10,4041.654377,224.536354,404.165438,102.053748,2,4
0,0,9,9,12,15,27,42,26,68,0.000333,0.107777,6,1939.994101,107.77745,323.33235,101.622909,2,4
0,0,10,10,12,16,28,52,30,82,0.000333,0.131401,6,2365.218622,131.401035,394.203104,107.01955,2,4
0,0,10,10,12,16,28,44,28,72,0.000333,0.115377,6,2076.777326,115.376518,346.129554,107.01955,2,4
0,0,12,12,14,18,32,57,36,93,0.000333,0.155,14,6510,361.666667,465,128.361619,2,4
0,0,8,8,10,14,24,35,25,60,0.000333,0.091699,5,1375.48875,76.416042,275.09775,86.52225,2,4
0,0,9,9,10,15,25,45,30,75,0.000333,0.116096,10,3482.892142,193.494008,348.289214,91.82264,2,4
0,0,9,9,10,15,25,37,27,64,0.000333,0.099069,5,1486.033981,82.557443,297.206796,91.82264,2,4
0,0,11,11,12,17,29,50,35,85,0.000333,0.137643,12,4955.140615,275.28559,412.928385,112.506418,2,4
0,0,7,7,9,14,23,34,22,56,0.000333,0.08444,4,1013.277878,56.293215,253.31947,81.832294,2,4
0,0,10,10,9,17,26,49,32,81,0.000333,0.126912,4,1522.942469,84.607915,380.735617,98.016193,2,4
0,0,8,8,9,15,24,36,24,60,0.000333,0.091699,4,1100.391,61.132833,275.09775,87.132684,2,4
0,0,12,12,11,19,30,54,38,92,0.000333,0.150478,10,4514.339348,250.79663,451.433935,118.764371,2,4
0,0,7,7,9,11,20,30,19,49,0.000333,0.070591,4,847.097907,47.060995,211.774477,66.583073,2,4
0,0,10,10,9,14,23,45,29,74,0.000333,0.111581,8,2677.948678,148.774927,334.743585,81.832294,2,4
0,0,8,8,9,12,21,32,21,53,0.000333,0.077598,4,931.171294,51.731739,232.792823,71.548875,2,4
0,0,12,12,11,16,27,50,35,85,0.000333,0.134722,10,4041.654377,224.536354,404.165438,102.053748,2,4
0,0,8,8,9,16,25,34,29,63,0.000333,0.097521,4,1170.25176,65.013987,292.56294,92.529325,2,4
0,0,11,11,9,18,27,49,39,88,0.000333,0.139477,8,3347.440802,185.968933,418.4301,103.587975,2,4
0,0,9,9,9,17,26,36,31,67,0.000333,0.104976,4,1259.717844,69.984325,314.929461,98.016193,2,4
0,0,13,13,11,20,31,54,45,99,0.000333,0.163488,10,4904.654347,272.480797,490.465435,124.49231,2,4
0,0,6,6,9,14,23,29,21,50,0.000333,0.075393,4,904.712391,50.2618,226.178098,81.832294,2,4
0,0,9,9,9,16,25,44,31,75,0.000333,0.116096,4,1393.156857,77.397603,348.289214,92.529325,2,4
0,0,7,7,9,15,24,31,23,54,0.000333,0.082529,4,990.3519,55.01955,247.587975,87.132684,2,4
0,0,11,11,11,18,29,49,37,86,0.000333,0.139262,10,4177.863656,232.103536,417.786366,113.112398,2,4
0,0,7,7,9,14,23,34,22,56,0.000333,0.08444,4,1013.277878,56.293215,253.31947,81.832294,2,4
0,0,10,10,9,17,26,49,32,81,0.000333,0.126912,4,1522.942469,84.607915,380.735617,98.016193,2,4
0,0,8,8,9,15,24,36,24,60,0.000333,0.091699,4,1100.391,61.132833,275.09775,87.132684,2,4
0,0,12,12,11,19,30,54,38,92,0.000333,0.150478,10,4514.339348,250.79663,451.433935,118.764371,2,4
0,0,7,7,9,11,20,30,19,49,0.000333,0.070591,4,847.097907,47.060995,211.774477,66.583073,2,4
0,0,10,10,9,14,23,45,29,74,0.000333,0.111581,8,2677.948678,148.774927,334.743585,81.832294,2,4
0,0,8,8,9,12,21,32,21,53,0.000333,0.077598,4,931.171294,51.731739,232.792823,71.548875,2,4
0,0,12,12,11,16,27,50,35,85,0.000333,0.134722,10,4041.654377,224.536354,404.165438,102.053748,2,4
0,0,9,9,11,14,25,40,26,66,0.000333,0.102165,5,1532.472543,85.137363,306.494509,91.356717,2,4
0,0,12,12,11,17,28,55,36,91,0.000333,0.145823,10,4374.692979,243.038499,437.469298,107.540616,2,4
0,0,10,10,11,15,26,42,28,70,0.000333,0.109677,5,1645.153901,91.397439,329.03078,96.657107,2,4
0,0,14,14,13,19,32,60,42,102,0.000333,0.17,12,6120,340,510,128.816339,2,4
0,0,8,8,9,12,21,33,23,56,0.000333,0.08199,4,983.879103,54.65995,245.969776,71.548875,2,4
0,0,11,11,9,15,24,48,33,81,0.000333,0.123794,8,2971.0557,165.05865,371.381963,87.132684,2,4
0,0,9,9,9,13,22,35,25,60,0.000333,0.089189,4,1070.263588,59.459088,267.565897,76.635041,2,4
0,0,13,13,11,17,28,53,39,92,0.000333,0.147426,10,4422.766528,245.709252,442.276653,107.540616,2,4
0,0,7,7,9,14,23,34,22,56,0.000333,0.08444,4,1013.277878,56.293215,253.31947,81.832294,2,4
0,0,10,10,9,17,26,49,32,81,0.000333,0.126912,4,1522.942469,84.607915,380.735617,98.016193,2,4
0,0,8,8,9,15,24,36,24,60,0.000333,0.091699,4,1100.391,61.132833,275.09775,87.132684,2,4
0,0,12,12,11,19,30,54,38,92,0.000333,0.150478,10,4514.339348,250.79663,451.433935,118.764371,2,4
0,0,7,7,9,11,20,30,19,49,0.000333,0.070591,4,847.097907,47.060995,211.774477,66.583073,2,4
0,0,10,10,9,14,23,45,29,74,0.000333,0.111581,8,2677.948678,148.774927,334.743585,81.832294,2,4
0,0,8,8,9,12,21,32,21,53,0.000333,0.077598,4,931.171294,51.731739,232.792823,71.548875,2,4
0,0,12,12,11,16,27,50,35,85,0.000333,0.134722,10,4041.654377,224.536354,404.165438,102.053748,2,4
0,0,7,7,10,11,21,34,21,55,0.000333,0.080526,5,1207.887291,67.10485,241.577458,71.273029,2,4
0,0,10,10,10,14,24,49,31,80,0.000333,0.122266,10,3667.970001,203.776111,366.797,86.52225,2,4
0,0,8,8,10,12,22,36,23,59,0.000333,0.087702,5,1315.532327,73.085129,263.106465,76.238831,2,4
0,0,7,7,10,11,21,34,21,55,0.000333,0.080526,5,1207.887291,67.10485,241.577458,71.273029,2,4
0,0,10,10,10,14,24,49,31,80,0.000333,0.122266,10,3667.970001,203.776111,366.797,86.52225,2,4
0,0,8,8,10,12,22,36,23,59,0.000333,0.087702,5,1315.532327,73.085129,263.106465,76.238831,2,4
0,0,7,7,9,11,20,30,19,49,0.000333,0.070591,4,847.097907,47.060995,211.774477,66.583073,2,4
0,0,10,10,9,14,23,45,29,74,0.000333,0.111581,8,2677.948678,148.774927,334.743585,81.832294,2,4
0,0,8,8,9,12,21,32,21,53,0.000333,0.077598,4,931.171294,51.731739,232.792823,71.548875,2,4
0,0,12,12,11,16,27,50,35,85,0.000333,0.134722,10,4041.654377,224.536354,404.165438,102.053748,2,4
0,0,7,7,9,14,23,34,22,56,0.000333,0.08444,4,1013.277878,56.293215,253.31947,81.832294,2,4
0,0,10,10,9,17,26,49,32,81,0.000333,0.126912,4,1522.942469,84.607915,380.735617,98.016193,2,4
0,0,8,8,9,15,24,36,24,60,0.000333,0.091699,4,1100.391,61.132833,275.09775,87.132684,2,4
0,0,12,12,11,19,30,54,38,92,0.000333,0.150478,10,4514.339348,250.79663,451.433935,118.764371,2,4
0,0,7,7,10,15,25,31,23,54,0.000333,0.083589,5,1253.841171,69.657843,250.768234,91.82264,2,4
0,0,10,10,10,18,28,46,33,79,0.000333,0.126594,5,1898.905194,105.494733,379.781039,108.277931,2,4
0,0,8,8,10,16,26,33,25,58,0.000333,0.090875,5,1363.127518,75.729307,272.625504,97.219281,2,4
0,0,7,7,10,15,25,31,23,54,0.000333,0.083589,5,1253.841171,69.657843,250.768234,91.82264,2,4
0,0,10,10,10,18,28,46,33,79,0.000333,0.126594,5,1898.905194,105.494733,379.781039,108.277931,2,4
0,0,8,8,10,16,26,33,25,58,0.000333,0.090875,5,1363.127518,75.729307,272.625504,97.219281,2,4
0,0,7,7,9,11,20,30,19,49,0.000333,0.070591,4,847.097907,47.060995,211.774477,66.583073,2,4
0,0,10,10,9,14,23,45,29,74,0.000333,0.111581,8,2677.948678,148.774927,334.743585,81.832294,2,4
0,0,8,8,9,12,21,32,21,53,0.000333,0.077598,4,931.171294,51.731739,232.792823,71.548875,2,4
0,0,12,12,11,16,27,50,35,85,0.000333,0.134722,10,4041.654377,224.536354,404.165438,102.053748,2,4
0,0,7,7,9,14,23,34,22,56,0.000333,0.08444,4,1013.277878,56.293215,253.31947,81.832294,2,4
0,0,10,10,9,17,26,49,32,81,0.000333,0.126912,4,1522.942469,84.607915,380.735617,98.016193,2,4
0,0,8,8,9,15,24,36,24,60,0.000333,0.091699,4,1100.391,61.132833,275.09775,87.132684,2,4
0,0,12,12,11,19,30,54,38,92,0.000333,0.150478,10,4514.339348,250.79663,451.433935,118.764371,2,4
0,0,9,9,12,15,27,42,26,68,0.000333,0.107777,6,1939.994101,107.77745,323.33235,101.622909,2,4
0,0,10,10,12,16,28,52,30,82,0.000333,0.131401,6,2365.218622,131.401035,394.203104,107.01955,2,4
0,0,10,10,12,16,28,44,28,72,0.000333,0.115377,6,2076.777326,115.376518,346.129554,107.01955,2,4
0,0,12,12,14,18,32,57,36,93,0.000333,0.155,14,6510,361.666667,465,128.361619,2,4
0,0,8,8,10,14,24,35,25,60,0.000333,0.091699,5,1375.48875,76.416042,275.09775,86.52225,2,4
0,0,9,9,10,15,25,45,30,75,0.000333,0.116096,10,3482.892142,193.494008,348.289214,91.82264,2,4
0,0,9,9,10,15,25,37,27,64,0.000333,0.099069,5,1486.033981,82.557443,297.206796,91.82264,2,4
0,0,12,12,12,17,29,52,40,92,0.000333,0.148978,12,5363.211019,297.956168,446.934252,112.506418,2,4
0,0,7,7,9,11,20,30,19,49,0.000333,0.070591,4,847.097907,47.060995,211.774477,66.583073,2,4
0,0,10,10,9,14,23,45,29,74,0.000333,0.111581,8,2677.948678,148.774927,334.743585,81.832294,2,4
0,0,8,8,9,12,21,32,21,53,0.000333,0.077598,4,931.171294,51.731739,232.792823,71.548875,2,4
0,0,12,12,11,16,27,50,35,85,0.000333,0.134722,10,4041.654377,224.536354,404.165438,102.053748,2,4
0,0,7,7,9,14,23,34,22,56,0.000333,0.08444,4,1013.277878,56.293215,253.31947,81.832294,2,4
0,0,10,10,9,17,26,49,32,81,0.000333,0.126912,4,1522.942469,84.607915,380.735617,98.016193,2,4
0,0,8,8,9,15,24,36,24,60,0.000333,0.091699,4,1100.391,61.132833,275.09775,87.132684,2,4
0,0,12,12,11,19,30,54,38,92,0.000333,0.150478,10,4514.339348,250.79663,451.433935,118.764371,2,4
0,0,16,16,13,14,27,72,44,116,0.000333,0.183856,18,9928.205105,551.56695,551.56695,101.408685,2,4
0,0,19,19,13,16,29,87,54,141,0.000333,0.228325,18,12329.55577,684.97532,684.97532,112.105716,2,4
0,0,17,17,13,15,28,74,46,120,0.000333,0.192294,18,10383.88663,576.882591,576.882591,106.709075,2,4
0,0,21,21,15,18,33,92,60,152,0.000333,0.255583,21,16101.70603,894.539224,766.747906,133.662009,2,4
0,0,8,8,10,12,22,35,22,57,0.000333,0.084729,5,1270.938011,70.607667,254.187602,76.238831,2,4
0,0,11,11,10,16,26,50,32,82,0.000333,0.128479,10,3854.360569,214.131143,385.436057,97.219281,2,4
0,0,9,9,10,13,23,37,24,61,0.000333,0.091979,5,1379.686397,76.649244,275.937279,81.324997,2,4
0,0,13,13,12,18,30,55,38,93,0.000333,0.152114,12,5476.089905,304.227217,456.340825,118.0782,2,4
0,0,7,7,9,14,23,34,22,56,0.000333,0.08444,4,1013.277878,56.293215,253.31947,81.832294,2,4
0,0,10,10,9,17,26,49,32,81,0.000333,0.126912,4,1522.942469,84.607915,380.735617,98.016193,2,4
0,0,8,8,9,15,24,36,24,60,0.000333,0.091699,4,1100.391,61.132833,275.09775,87.132684,2,4
0,0,12,12,11,19,30,54,38,92,0.000333,0.150478,10,4514.339348,250.79663,451.433935,118.764371,2,4
0,0,7,7,9,11,20,30,19,49,0.000333,0.070591,4,847.097907,47.060995,211.774477,66.583073,2,4
0,0,10,10,9,14,23,45,29,74,0.000333,0.111581,8,2677.948678,148.774927,334.743585,81.832294,2,4
0,0,8,8,9,12,21,32,21,53,0.000333,0.077598,4,931.171294,51.731739,232.792823,71.548875,2,4
0,0,12,12,11,16,27,50,35,85,0.000333,0.134722,10,4041.654377,224.536354,404.165438,102.053748,2,4
0,0,6,6,10,12,22,30,19,49,0.000333,0.072837,5,1092.560747,60.697819,218.512149,76.238831,2,4
0,0,7,7,10,13,23,32,21,53,0.000333,0.079916,5,1198.743918,66.596884,239.748784,81.324997,2,4
0,0,6,6,10,13,23,30,20,50,0.000333,0.075393,5,1130.890489,62.827249,226.178098,81.324997,2,4
0,0,7,7,10,14,24,32,22,54,0.000333,0.082529,5,1237.939875,68.774438,247.587975,86.52225,2,4
0,0,7,7,9,14,23,34,22,56,0.000333,0.08444,4,1013.277878,56.293215,253.31947,81.832294,2,4
0,0,10,10,9,17,26,49,32,81,0.000333,0.126912,4,1522.942469,84.607915,380.735617,98.016193,2,4
0,0,8,8,9,15,24,36,24,60,0.000333,0.091699,4,1100.391,61.132833,275.09775,87.132684,2,4
0,0,12,12,11,19,30,54,38,92,0.000333,0.150478,10,4514.339348,250.79663,451.433935,118.764371,2,4
0,0,7,7,9,11,20,30,19,49,0.000333,0.070591,4,847.097907,47.060995,211.774477,66.583073,2,4
0,0,10,10,9,14,23,45,29,74,0.000333,0.111581,8,2677.948678,148.774927,334.743585,81.832294,2,4
0,0,8,8,9,12,21,32,21,53,0.000333,0.077598,4,931.171294,51.731739,232.792823,71.548875,2,4
0,0,12,12,11,16,27,50,35,85,0.000333,0.134722,10,4041.654377,224.536354,404.165438,102.053748,2,4
0,0,10,10,11,17,28,41,30,71,0.000333,0.113774,5,1706.610997,94.811722,341.322199,107.540616,2,4
0,0,13,13,11,20,31,56,40,96,0.000333,0.158534,10,4756.028458,264.223803,475.602846,124.49231,2,4
0,0,11,11,11,18,29,43,32,75,0.000333,0.12145,5,1821.742873,101.207937,364.348575,113.112398,2,4
0,0,15,15,13,22,35,61,46,107,0.000333,0.182944,12,6585.999394,365.888855,548.833283,146.213212,2,4
0,0,9,9,9,17,26,34,30,64,0.000333,0.100276,4,1203.312568,66.850698,300.828142,98.016193,2,4
0,0,12,12,9,20,29,49,40,89,0.000333,0.14412,8,3458.882469,192.160137,432.360309,114.967887,2,4
0,0,10,10,9,18,27,36,32,68,0.000333,0.107777,4,1293.329401,71.851633,323.33235,103.587975,2,4
0,0,14,14,11,22,33,54,46,100,0.000333,0.168146,10,5044.394119,280.244118,504.439412,136.161243,2,4
0,0,7,7,9,11,20,30,19,49,0.000333,0.070591,4,847.097907,47.060995,211.774477,66.583073,2,4
0,0,10,10,9,14,23,45,29,74,0.000333,0.111581,8,2677.948678,148.774927,334.743585,81.832294,2,4
0,0,8,8,9,12,21,32,21,53,0.000333,0.077598,4,931.171294,51.731739,232.792823,71.548875,2,4
0,0,12,12,11,16,27,50,35,85,0.000333,0.134722,10,4041.654377,224.536354,404.165438,102.053748,2,4
0,0,7,7,9,14,23,34,22,56,0.000333,0.08444,4,1013.277878,56.293215,253.31947,81.832294,2,4
0,0,10,10,9,17,26,49,32,81,0.000333,0.126912,4,1522.942469,84.607915,380.735617,98.016193,2,4
0,0,8,8,9,15,24,36,24,60,0.000333,0.091699,4,1100.391,61.132833,275.09775,87.132684,2,4
0,0,12,12,11,19,30,54,38,92,0.000333,0.150478,10,4514.339348,250.79663,451.433935,118.764371,2,4
0,0,6,6,9,15,24,29,22,51,0.000333,0.077944,4,935.33235,51.962908,233.833088,87.132684,2,4
0,0,9,9,9,17,26,44,32,76,0.000333,0.119078,4,1428.933674,79.385204,357.233419,98.016193,2,4
0,0,7,7,9,16,25,31,24,55,0.000333,0.085137,4,1021.648362,56.758242,255.41209,92.529325,2,4
0,0,11,11,11,19,30,49,38,87,0.000333,0.1423,10,4268.994818,237.166379,426.899482,118.764371,2,4
0,0,6,6,9,14,23,29,21,50,0.000333,0.075393,4,904.712391,50.2618,226.178098,81.832294,2,4
0,0,9,9,9,16,25,44,31,75,0.000333,0.116096,4,1393.156857,77.397603,348.289214,92.529325,2,4
0,0,7,7,9,15,24,31,23,54,0.000333,0.082529,4,990.3519,55.01955,247.587975,87.132684,2,4
0,0,11,11,11,18,29,49,37,86,0.000333,0.139262,10,4177.863656,232.103536,417.786366,113.112398,2,4
0,0,7,7,9,14,23,34,22,56,0.000333,0.08444,4,1013.277878,56.293215,253.31947,81.832294,2,4
0,0,10,10,9,17,26,49,32,81,0.000333,0.126912,4,1522.942469,84.607915,380.735617,98.016193,2,4
0,0,8,8,9,15,24,36,24,60,0.000333,0.091699,4,1100.391,61.132833,275.09775,87.132684,2,4
0,0,12,12,11,19,30,54,38,92,0.000333,0.150478,10,4514.339348,250.79663,451.433935,118.764371,2,4
0,0,7,7,9,11,20,30,19,49,0.000333,0.070591,4,847.097907,47.060995,211.774477,66.583073,2,4
0,0,10,10,9,14,23,45,29,74,0.000333,0.111581,8,2677.948678,148.774927,334.743585,81.832294,2,4
0,0,8,8,9,12,21,32,21,53,0.000333,0.077598,4,931.171294,51.731739,232.792823,71.548875,2,4
0,0,12,12,11,16,27,50,35,85,0.000333,0.134722,10,4041.654377,224.536354,404.165438,102.053748,2,4
0,0,6,6,9,15,24,29,22,51,0.000333,0.077944,4,935.33235,51.962908,233.833088,87.132684,2,4
0,0,9,9,9,17,26,44,32,76,0.000333,0.119078,4,1428.933674,79.385204,357.233419,98.016193,2,4
0,0,7,7,9,16,25,31,24,55,0.000333,0.085137,4,1021.648362,56.758242,255.41209,92.529325,2,4
0,0,11,11,11,19,30,49,38,87,0.000333,0.1423,10,4268.994818,237.166379,426.899482,118.764371,2,4
0,0,6,6,9,14,23,29,21,50,0.000333,0.075393,4,904.712391,50.2618,226.178098,81.832294,2,4
0,0,9,9,9,16,25,44,31,75,0.000333,0.116096,4,1393.156857,77.397603,348.289214,92.529325,2,4
0,0,7,7,9,15,24,31,23,54,0.000333,0.082529,4,990.3519,55.01955,247.587975,87.132684,2,4
0,0,11,11,11,18,29,49,37,86,0.000333,0.139262,10,4177.863656,232.103536,417.786366,113.112398,2,4
0,0,7,7,9,14,23,34,22,56,0.000333,0.08444,4,1013.277878,56.293215,253.31947,81.832294,2,4
0,0,10,10,9,17,26,49,32,81,0.000333,0.126912,4,1522.942469,84.607915,380.735617,98.016193,2,4
0,0,8,8,9,15,24,36,24,60,0.000333,0.091699,4,1100.391,61.132833,275.09775,87.132684,2,4
0,0,12,12,11,19,30,54,38,92,0.000333,0.150478,10,4514.339348,250.79663,451.433935,118.764371,2,4
0,0,7,7,9,11,20,30,19,49,0.000333,0.070591,4,847.097907,47.060995,211.774477,66.583073,2,4
0,0,10,10,9,14,23,45,29,74,0.000333,0.111581,8,2677.948678,148.774927,334.743585,81.832294,2,4
0,0,8,8,9,12,21,32,21,53,0.000333,0.077598,4,931.171294,51.731739,232.792823,71.548875,2,4
0,0,12,12,11,16,27,50,35,85,0.000333,0.134722,10,4041.654377,224.536354,404.165438,102.053748,2,4
0,0,6,6,9,14,23,29,21,50,0.000333,0.075393,4,904.712391,50.2618,226.178098,81.832294,2,4
0,0,9,9,9,16,25,44,31,75,0.000333,0.116096,4,1393.156857,77.397603,348.289214,92.529325,2,4
0,0,7,7,9,15,24,31,23,54,0.000333,0.082529,4,990.3519,55.01955,247.587975,87.132684,2,4
0,0,11,11,11,18,29,49,37,86,0.000333,0.139262,10,4177.863656,232.103536,417.786366,113.112398,2,4
0,0,6,6,9,15,24,29,22,51,0.000333,0.077944,4,935.33235,51.962908,233.833088,87.132684,2,4
0,0,9,9,9,17,26,44,32,76,0.000333,0.119078,4,1428.933674,79.385204,357.233419,98.016193,2,4
0,0,7,7,9,16,25,31,24,55,0.000333,0.085137,4,1021.648362,56.758242,255.41209,92.529325,2,4
0,0,11,11,11,19,30,49,38,87,0.000333,0.1423,10,4268.994818,237.166379,426.899482,118.764371,2,4
0,0,7,7,9,14,23,34,22,56,0.000333,0.08444,4,1013.277878,56.293215,253.31947,81.832294,2,4
0,0,10,10,9,17,26,49,32,81,0.000333,0.126912,4,1522.942469,84.607915,380.735617,98.016193,2,4
0,0,8,8,9,15,24,36,24,60,0.000333,0.091699,4,1100.391,61.132833,275.09775,87.132684,2,4
0,0,12,12,11,19,30,54,38,92,0.000333,0.150478,10,4514.339348,250.79663,451.433935,118.764371,2,4
0,0,7,7,9,11,20,30,19,49,0.000333,0.070591,4,847.097907,47.060995,211.774477,66.583073,2,4
0,0,10,10,9,14,23,45,29,74,0.000333,0.111581,8,2677.948678,148.774927,334.743585,81.832294,2,4
0,0,8,8,9,12,21,32,21,53,0.000333,0.077598,4,931.171294,51.731739,232.792823,71.548875,2,4
0,0,12,12,11,16,27,50,35,85,0.000333,0.134722,10,4041.654377,224.536354,404.165438,102.053748,2,4
0,0,6,6,9,15,24,29,22,51,0.000333,0.077944,4,935.33235,51.962908,233.833088,87.132684,2,4
0,0,9,9,9,17,26,44,32,76,0.000333,0.119078,4,1428.933674,79.385204,357.233419,98.016193,2,4
0,0,7,7,9,16,25,31,24,55,0.000333,0.085137,4,1021.648362,56.758242,255.41209,92.529325,2,4
0,0,11,11,11,19,30,49,38,87,0.000333,0.1423,10,4268.994818,237.166379,426.899482,118.764371,2,4
0,0,6,6,9,14,23,29,21,50,0.000333,0.075393,4,904.712391,50.2618,226.178098,81.832294,2,4
0,0,9,9,9,16,25,44,31,75,0.000333,0.116096,4,1393.156857,77.397603,348.289214,92.529325,2,4
0,0,7,7,9,15,24,31,23,54,0.000333,0.082529,4,990.3519,55.01955,247.587975,87.132684,2,4
0,0,11,11,11,18,29,49,37,86,0.000333,0.139262,10,4177.863656,232.103536,417.786366,113.112398,2,4
0,0,7,7,9,11,20,30,19,49,0.000333,0.070591,4,847.097907,47.060995,211.774477,66.583073,2,4
0,0,10,10,9,14,23,45,29,74,0.000333,0.111581,8,2677.948678,148.774927,334.743585,81.832294,2,4
0,0,8,8,9,12,21,32,21,53,0.000333,0.077598,4,931.171294,51.731739,232.792823,71.548875,2,4
0,0,12,12,11,16,27,50,35,85,0.000333,0.134722,10,4041.654377,224.536354,404.165438,102.053748,2,4
0,0,7,7,9,14,23,34,22,56,0.000333,0.08444,4,1013.277878,56.293215,253.31947,81.832294,2,4
0,0,10,10,9,17,26,49,32,81,0.000333,0.126912,4,1522.942469,84.607915,380.735617,98.016193,2,4
0,0,8,8,9,15,24,36,24,60,0.000333,0.091699,4,1100.391,61.132833,275.09775,87.132684,2,4
0,0,12,12,11,19,30,54,38,92,0.000333,0.150478,10,4514.339348,250.79663,451.433935,118.764371,2,4
0,0,6,6,9,13,22,31,21,52,0.000333,0.077297,4,927.561777,51.53121,231.890444,76.635041,2,4
0,0,9,9,9,17,26,46,31,77,0.000333,0.120645,4,1447.735433,80.429746,361.933858,98.016193,2,4
0,0,7,7,9,14,23,33,23,56,0.000333,0.08444,4,1013.277878,56.293215,253.31947,81.832294,2,4
0,0,11,11,11,19,30,51,37,88,0.000333,0.143935,5,2159.031862,119.946215,431.806372,118.764371,2,4
0,0,6,6,9,12,21,31,20,51,0.000333,0.074669,4,896.032754,49.779597,224.008189,71.548875,2,4
0,0,9,9,9,16,25,46,30,76,0.000333,0.117644,4,1411.732282,78.429571,352.93307,92.529325,2,4
0,0,7,7,9,13,22,33,22,55,0.000333,0.081756,4,981.074956,54.504164,245.268739,76.635041,2,4
0,0,11,11,11,18,29,51,36,87,0.000333,0.140881,10,4226.443466,234.802415,422.644347,113.112398,2,4
0,0,7,7,9,14,23,34,22,56,0.000333,0.08444,4,1013.277878,56.293215,253.31947,81.832294,2,4
0,0,10,10,9,17,26,49,32,81,0.000333,0.126912,4,1522.942469,84.607915,380.735617,98.016193,2,4
0,0,8,8,9,15,24,36,24,60,0.000333,0.091699,4,1100.391,61.132833,275.09775,87.132684,2,4
0,0,12,12,11,19,30,54,38,92,0.000333,0.150478,10,4514.339348,250.79663,451.433935,118.764371,2,4
0,0,7,7,9,11,20,30,19,49,0.000333,0.070591,4,847.097907,47.060995,211.774477,66.583073,2,4
0,0,10,10,9,14,23,45,29,74,0.000333,0.111581,8,2677.948678,148.774927,334.743585,81.832294,2,4
0,0,8,8,9,12,21,32,21,53,0.000333,0.077598,4,931.171294,51.731739,232.792823,71.548875,2,4
0,0,12,12,11,16,27,50,35,85,0.000333,0.134722,10,4041.654377,224.536354,404.165438,102.053748,2,4
0,0,7,7,9,16,25,33,25,58,0.000333,0.089781,4,1077.374636,59.854146,269.343659,92.529325,2,4
0,0,10,10,9,18,27,48,35,83,0.000333,0.131552,4,1578.622651,87.701258,394.655663,103.587975,2,4
0,0,8,8,9,17,26,35,27,62,0.000333,0.097142,4,1165.70905,64.761614,291.427263,98.016193,2,4
0,0,12,12,11,20,31,53,41,94,0.000333,0.155231,10,4656.944532,258.719141,465.694453,124.49231,2,4
0,0,7,7,9,15,24,33,24,57,0.000333,0.087114,4,1045.37145,58.076192,261.342863,87.132684,2,4
0,0,10,10,9,17,26,48,34,82,0.000333,0.128479,8,3083.488455,171.304914,385.436057,98.016193,2,4
0,0,8,8,9,16,25,35,26,61,0.000333,0.094425,4,1133.10091,62.950051,283.275228,92.529325,2,4
0,0,12,12,11,19,30,53,40,93,0.000333,0.152114,10,4563.408254,253.522681,456.340825,118.764371,2,4
0,0,7,7,9,11,20,30,19,49,0.000333,0.070591,4,847.097907,47.060995,211.774477,66.583073,2,4
0,0,10,10,9,14,23,45,29,74,0.000333,0.111581,8,2677.948678,148.774927,334.743585,81.832294,2,4
0,0,8,8,9,12,21,32,21,53,0.000333,0.077598,4,931.171294,51.731739,232.792823,71.548875,2,4
0,0,12,12,11,16,27,50,35,85,0.000333,0.134722,10,4041.654377,224.536354,404.165438,102.053748,2,4
0,0,7,7,9,14,23,34,22,56,0.000333,0.08444,4,1013.277878,56.293215,253.31947,81.832294,2,4
0,0,10,10,9,17,26,49,32,81,0.000333,0.126912,4,1522.942469,84.607915,380.735617,98.016193,2,4
0,0,8,8,9,15,24,36,24,60,0.000333,0.091699,4,1100.391,61.132833,275.09775,87.132684,2,4
0,0,12,12,11,19,30,54,38,92,0.000333,0.150478,10,4514.339348,250.79663,451.433935,118.764371,2,4
0,0,8,8,9,17,26,41,29,70,0.000333,0.109677,4,1316.123121,73.117951,329.03078,98.016193,2,4
0,0,9,9,9,18,27,43,31,74,0.000333,0.117287,4,1407.446701,78.191483,351.861675,103.587975,2,4
0,0,8,8,9,16,25,41,28,69,0.000333,0.106809,4,1281.704308,71.205795,320.426077,92.529325,2,4
0,0,9,9,9,17,26,43,30,73,0.000333,0.114377,4,1372.528398,76.251578,343.132099,98.016193,2,4
0,0,7,7,9,14,23,34,22,56,0.000333,0.08444,4,1013.277878,56.293215,253.31947,81.832294,2,4
0,0,10,10,9,17,26,49,32,81,0.000333,0.126912,4,1522.942469,84.607915,380.735617,98.016193,2,4
0,0,8,8,9,15,24,36,24,60,0.000333,0.091699,4,1100.391,61.132833,275.09775,87.132684,2,4
0,0,12,12,11,19,30,54,38,92,0.000333,0.150478,10,4514.339348,250.79663,451.433935,118.764371,2,4
0,0,7,7,9,11,20,30,19,49,0.000333,0.070591,4,847.097907,47.060995,211.774477,66.583073,2,4
0,0,10,10,9,14,23,45,29,74,0.000333,0.111581,8,2677.948678,148.774927,334.743585,81.832294,2,4
0,0,8,8,9,12,21,32,21,53,0.000333,0.077598,4,931.171294,51.731739,232.792823,71.548875,2,4
0,0,12,12,11,16,27,50,35,85,0.000333,0.134722,10,4041.654377,224.536354,404.165438,102.053748,2,4
0,0,6,6,9,15,24,29,22,51,0.000333,0.077944,4,935.33235,51.962908,233.833088,87.132684,2,4
0,0,9,9,9,17,26,44,32,76,0.000333,0.119078,4,1428.933674,79.385204,357.233419,98.016193,2,4
0,0,7,7,9,16,25,31,24,55,0.000333,0.085137,4,1021.648362,56.758242,255.41209,92.529325,2,4
0,0,11,11,11,19,30,49,38,87,0.000333,0.1423,10,4268.994818,237.166379,426.899482,118.764371,2,4
0,0,6,6,9,14,23,29,21,50,0.000333,0.075393,4,904.712391,50.2618,226.178098,81.832294,2,4
0,0,9,9,9,16,25,44,31,75,0.000333,0.116096,4,1393.156857,77.397603,348.289214,92.529325,2,4
0,0,7,7,9,15,24,31,23,54,0.000333,0.082529,4,990.3519,55.01955,247.587975,87.132684,2,4
0,0,11,11,11,18,29,49,37,86,0.000333,0.139262,10,4177.863656,232.103536,417.786366,113.112398,2,4
0,0,6,6,11,12,23,31,19,50,0.000333,0.075393,5,1130.890489,62.827249,226.178098,81.073298,2,4
0,0,9,9,11,15,26,46,29,75,0.000333,0.117511,5,1762.664894,97.925827,352.532979,96.657107,2,4
0,0,7,7,11,13,24,33,21,54,0.000333,0.082529,5,1237.939875,68.774438,247.587975,86.159464,2,4
0,0,11,11,11,15,26,51,35,86,0.000333,0.134746,10,4042.378158,224.576564,404.237816,96.657107,2,4
0,0,6,6,11,12,23,31,19,50,0.000333,0.075393,5,1130.890489,62.827249,226.178098,81.073298,2,4
0,0,9,9,11,15,26,46,29,75,0.000333,0.117511,5,1762.664894,97.925827,352.532979,96.657107,2,4
0,0,7,7,11,13,24,33,21,54,0.000333,0.082529,5,1237.939875,68.774438,247.587975,86.159464,2,4
0,0,11,11,11,15,26,51,35,86,0.000333,0.134746,10,4042.378158,224.576564,404.237816,96.657107,2,4
0,0,7,7,11,17,28,35,26,61,0.000333,0.09775,5,1466.243251,81.457958,293.24865,107.540616,2,4
0,0,10,10,11,19,30,50,36,86,0.000333,0.140664,5,2109.962956,117.220164,421.992591,118.764371,2,4
0,0,8,8,11,18,29,37,28,65,0.000333,0.105256,5,1578.843823,87.713546,315.768765,113.112398,2,4
0,0,7,7,11,16,27,35,25,60,0.000333,0.095098,5,1426.466251,79.248125,285.29325,102.053748,2,4
0,0,10,10,11,18,29,50,35,85,0.000333,0.137643,5,2064.641923,114.702329,412.928385,113.112398,2,4
0,0,8,8,11,17,28,37,27,64,0.000333,0.102557,5,1538.353575,85.464088,307.670715,107.540616,2,4
0,0,7,7,9,14,23,34,22,56,0.000333,0.08444,4,1013.277878,56.293215,253.31947,81.832294,2,4
0,0,10,10,9,17,26,49,32,81,0.000333,0.126912,4,1522.942469,84.607915,380.735617,98.016193,2,4
0,0,8,8,9,15,24,36,24,60,0.000333,0.091699,4,1100.391,61.132833,275.09775,87.132684,2,4
0,0,12,12,11,19,30,54,38,92,0.000333,0.150478,10,4514.339348,250.79663,451.433935,118.764371,2,4
0,0,7,7,9,11,20,30,19,49,0.000333,0.070591,4,847.097907,47.060995,211.774477,66.583073,2,4
0,0,10,10,9,14,23,45,29,74,0.000333,0.111581,8,2677.948678,148.774927,334.743585,81.832294,2,4
0,0,8,8,9,12,21,32,21,53,0.000333,0.077598,4,931.171294,51.731739,232.792823,71.548875,2,4
0,0,12,12,11,16,27,50,35,85,0.000333,0.134722,10,4041.654377,224.536354,404.165438,102.053748,2,4
0,0,7,7,10,18,28,32,28,60,0.000333,0.096147,5,1442.206477,80.122582,288.441295,108.277931,2,4
0,0,10,10,10,20,30,47,38,85,0.000333,0.139029,5,2085.428503,115.857139,417.085701,119.657843,2,4
0,0,8,8,10,19,29,34,30,64,0.000333,0.103637,5,1554.553918,86.364107,310.910784,113.929904,2,4
0,0,7,7,10,17,27,32,27,59,0.000333,0.093513,5,1402.691813,77.927323,280.538363,102.706149,2,4
0,0,10,10,10,19,29,47,37,84,0.000333,0.136023,5,2040.352018,113.35289,408.070404,113.929904,2,4
0,0,8,8,10,18,28,34,29,63,0.000333,0.100954,5,1514.3168,84.128711,302.86336,108.277931,2,4
0,0,7,7,9,11,20,30,19,49,0.000333,0.070591,4,847.097907,47.060995,211.774477,66.583073,2,4
0,0,10,10,9,14,23,45,29,74,0.000333,0.111581,8,2677.948678,148.774927,334.743585,81.832294,2,4
0,0,8,8,9,12,21,32,21,53,0.000333,0.077598,4,931.171294,51.731739,232.792823,71.548875,2,4
0,0,12,12,11,16,27,50,35,85,0.000333,0.134722,10,4041.654377,224.536354,404.165438,102.053748,2,4
0,0,7,7,9,14,23,34,22,56,0.000333,0.08444,4,1013.277878,56.293215,253.31947,81.832294,2,4
0,0,10,10,9,17,26,49,32,81,0.000333,0.126912,4,1522.942469,84.607915,380.735617,98.016193,2,4
0,0,8,8,9,15,24,36,24,60,0.000333,0.091699,4,1100.391,61.132833,275.09775,87.132684,2,4
0,0,12,12,11,19,30,54,38,92,0.000333,0.150478,10,4514.339348,250.79663,451.433935,118.764371,2,4
0,0,6,6,9,14,23,29,21,50,0.000333,0.075393,4,904.712391,50.2618,226.178098,81.832294,2,4
0,0,9,9,9,17,26,44,31,75,0.000333,0.117511,4,1410.131915,78.340662,352.532979,98.016193,2,4
0,0,7,7,9,15,24,31,23,54,0.000333,0.082529,4,990.3519,55.01955,247.587975,87.132684,2,4
0,0,11,11,11,19,30,49,37,86,0.000333,0.140664,5,2109.962956,117.220164,421.992591,118.764371,2,4
0,0,6,6,9,13,22,29,20,49,0.000333,0.072837,4,874.048597,48.558255,218.512149,76.635041,2,4
0,0,9,9,9,16,25,44,30,74,0.000333,0.114548,4,1374.581432,76.365635,343.645358,92.529325,2,4
0,0,7,7,9,14,23,31,22,53,0.000333,0.079916,4,958.995135,53.277507,239.748784,81.832294,2,4
0,0,11,11,11,18,29,49,36,85,0.000333,0.137643,10,4129.283846,229.404658,412.928385,113.112398,2,4
0,0,7,7,9,11,20,30,19,49,0.000333,0.070591,4,847.097907,47.060995,211.774477,66.583073,2,4
0,0,10,10,9,14,23,45,29,74,0.000333,0.111581,8,2677.948678,148.774927,334.743585,81.832294,2,4
0,0,8,8,9,12,21,32,21,53,0.000333,0.077598,4,931.171294,51.731739,232.792823,71.548875,2,4
0,0,12,12,11,16,27,50,35,85,0.000333,0.134722,10,4041.654377,224.536354,404.165438,102.053748,2,4
0,0,6,6,11,15,26,31,22,53,0.000333,0.083041,5,1245.616525,69.200918,249.123305,96.657107,2,4
0,0,9,9,11,17,28,46,32,78,0.000333,0.124991,5,1874.86842,104.159357,374.973684,107.540616,2,4
0,0,7,7,11,16,27,33,24,57,0.000333,0.090343,5,1355.142938,75.285719,271.028588,102.053748,2,4
0,0,11,11,13,19,32,51,38,89,0.000333,0.148333,12,5340,296.666667,445,128.816339,2,4
0,0,7,7,9,11,20,30,19,49,0.000333,0.070591,4,847.097907,47.060995,211.774477,66.583073,2,4
0,0,10,10,9,14,23,45,29,74,0.000333,0.111581,8,2677.948678,148.774927,334.743585,81.832294,2,4
0,0,8,8,9,12,21,32,21,53,0.000333,0.077598,4,931.171294,51.731739,232.792823,71.548875,2,4
0,0,12,12,11,16,27,50,35,85,0.000333,0.134722,10,4041.654377,224.536354,404.165438,102.053748,2,4
0,0,6,6,10,16,26,30,23,53,0.000333,0.083041,5,1245.616525,69.200918,249.123305,97.219281,2,4
0,0,9,9,10,18,28,45,33,78,0.000333,0.124991,5,1874.86842,104.159357,374.973684,108.277931,2,4
0,0,7,7,10,17,27,32,25,57,0.000333,0.090343,5,1355.142938,75.285719,271.028588,102.706149,2,4
0,0,11,11,12,20,32,50,39,89,0.000333,0.148333,6,2670,148.333333,445,129.458112,2,4
0,0,7,7,9,11,20,30,19,49,0.000333,0.070591,4,847.097907,47.060995,211.774477,66.583073,2,4
0,0,10,10,9,14,23,45,29,74,0.000333,0.111581,8,2677.948678,148.774927,334.743585,81.832294,2,4
0,0,8,8,9,12,21,32,21,53,0.000333,0.077598,4,931.171294,51.731739,232.792823,71.548875,2,4
0,0,12,12,11,16,27,50,35,85,0.000333,0.134722,10,4041.654377,224.536354,404.165438,102.053748,2,4
0,0,7,7,9,14,23,34,22,56,0.000333,0.08444,4,1013.277878,56.293215,253.31947,81.832294,2,4
0,0,10,10,9,17,26,49,32,81,0.000333,0.126912,4,1522.942469,84.607915,380.735617,98.016193,2,4
0,0,8,8,9,15,24,36,24,60,0.000333,0.091699,4,1100.391,61.132833,275.09775,87.132684,2,4
0,0,12,12,11,19,30,54,38,92,0.000333,0.150478,10,4514.339348,250.79663,451.433935,118.764371,2,4
0,0,6,6,9,10,19,29,17,46,0.000333,0.065135,4,781.618662,43.423259,195.404666,61.748606,2,4
0,0,9,9,9,14,23,44,27,71,0.000333,0.107058,4,1284.691596,71.371755,321.172899,81.832294,2,4
0,0,7,7,9,11,20,31,19,50,0.000333,0.072032,4,864.385619,48.021423,216.096405,66.583073,2,4
0,0,11,11,11,16,27,49,33,82,0.000333,0.129967,10,3899.007752,216.611542,389.900775,102.053748,2,4
0,0,9,9,12,18,30,48,32,80,0.000333,0.13085,6,2355.307486,130.850416,392.551248,118.0782,2,4
0,0,12,12,12,22,34,63,42,105,0.000333,0.178061,6,3205.10159,178.061199,534.183598,141.127046,2,4
0,0,10,10,12,19,31,50,34,84,0.000333,0.138717,6,2496.91494,138.717497,416.15249,123.730173,2,4
0,0,14,14,12,24,36,68,48,116,0.000333,0.199904,12,7196.535602,399.807533,599.7113,153.05865,2,4
0,0,7,7,9,11,20,30,19,49,0.000333,0.070591,4,847.097907,47.060995,211.774477,66.583073,2,4
0,0,10,10,9,14,23,45,29,74,0.000333,0.111581,8,2677.948678,148.774927,334.743585,81.832294,2,4
0,0,8,8,9,12,21,32,21,53,0.000333,0.077598,4,931.171294,51.731739,232.792823,71.548875,2,4
0,0,12,12,11,16,27,50,35,85,0.000333,0.134722,10,4041.654377,224.536354,404.165438,102.053748,2,4
0,0,7,7,9,14,23,34,22,56,0.000333,0.08444,4,1013.277878,56.293215,253.31947,81.832294,2,4
0,0,10,10,9,17,26,49,32,81,0.000333,0.126912,4,1522.942469,84.607915,380.735617,98.016193,2,4
0,0,8,8,9,15,24,36,24,60,0.000333,0.091699,4,1100.391,61.132833,275.09775,87.132684,2,4
0,0,12,12,11,19,30,54,38,92,0.000333,0.150478,10,4514.339348,250.79663,451.433935,118.764371,2,4
0,0,7,7,9,11,20,30,19,49,0.000333,0.070591,4,847.097907,47.060995,211.774477,66.583073,2,4
0,0,10,10,9,14,23,45,29,74,0.000333,0.111581,8,2677.948678,148.774927,334.743585,81.832294,2,4
0,0,8,8,9,12,21,32,21,53,0.000333,0.077598,4,931.171294,51.731739,232.792823,71.548875,2,4
0,0,12,12,11,16,27,50,35,85,0.000333,0.134722,10,4041.654377,224.536354,404.165438,102.053748,2,4
0,0,7,7,9,11,20,31,19,50,0.000333,0.072032,4,864.385619,48.021423,216.096405,66.583073,2,4
0,0,10,10,9,15,24,46,29,75,0.000333,0.114624,4,1375.48875,76.416042,343.872188,87.132684,2,4
0,0,8,8,9,12,21,33,21,54,0.000333,0.079062,4,948.740563,52.707809,237.185141,71.548875,2,4
0,0,12,12,11,17,28,51,35,86,0.000333,0.137811,10,4134.325233,229.684735,413.432523,107.540616,2,4
0,0,7,7,9,11,20,31,19,50,0.000333,0.072032,4,864.385619,48.021423,216.096405,66.583073,2,4
0,0,10,10,9,15,24,46,29,75,0.000333,0.114624,4,1375.48875,76.416042,343.872188,87.132684,2,4
0,0,8,8,9,12,21,33,21,54,0.000333,0.079062,4,948.740563,52.707809,237.185141,71.548875,2,4
0,0,12,12,11,17,28,51,35,86,0.000333,0.137811,10,4134.325233,229.684735,413.432523,107.540616,2,4
0,0,8,8,11,14,25,39,24,63,0.000333,0.097521,5,1462.8147,81.267483,292.56294,91.356717,2,4
0,0,11,11,11,18,29,54,34,88,0.000333,0.142501,5,2137.511638,118.750647,427.502328,113.112398,2,4
0,0,9,9,11,15,26,41,26,67,0.000333,0.104976,5,1574.647306,87.480406,314.929461,96.657107,2,4
0,0,13,13,11,20,31,59,40,99,0.000333,0.163488,10,4904.654347,272.480797,490.465435,124.49231,2,4
0,0,7,7,9,11,20,30,19,49,0.000333,0.070591,4,847.097907,47.060995,211.774477,66.583073,2,4
0,0,10,10,9,14,23,45,29,74,0.000333,0.111581,8,2677.948678,148.774927,334.743585,81.832294,2,4
0,0,8,8,9,12,21,32,21,53,0.000333,0.077598,4,931.171294,51.731739,232.792823,71.548875,2,4
0,0,12,12,11,16,27,50,35,85,0.000333,0.134722,10,4041.654377,224.536354,404.165438,102.053748,2,4
0,0,7,7,9,14,23,34,22,56,0.000333,0.08444,4,1013.277878,56.293215,253.31947,81.832294,2,4
0,0,10,10,9,17,26,49,32,81,0.000333,0.126912,4,1522.942469,84.607915,380.735617,98.016193,2,4
0,0,8,8,9,15,24,36,24,60,0.000333,0.091699,4,1100.391,61.132833,275.09775,87.132684,2,4
0,0,12,12,11,19,30,54,38,92,0.000333,0.150478,10,4514.339348,250.79663,451.433935,118.764371,2,4
0,0,7,7,9,11,20,30,19,49,0.000333,0.070591,4,847.097907,47.060995,211.774477,66.583073,2,4
0,0,10,10,9,14,23,45,29,74,0.000333,0.111581,8,2677.948678,148.774927,334.743585,81.832294,2,4
0,0,8,8,9,12,21,32,21,53,0.000333,0.077598,4,931.171294,51.731739,232.792823,71.548875,2,4
0,0,12,12,11,16,27,50,35,85,0.000333,0.134722,10,4041.654377,224.536354,404.165438,102.053748,2,4
0,0,7,7,9,11,20,31,19,50,0.000333,0.072032,4,864.385619,48.021423,216.096405,66.583073,2,4
0,0,10,10,9,15,24,46,29,75,0.000333,0.114624,4,1375.48875,76.416042,343.872188,87.132684,2,4
0,0,8,8,9,12,21,33,21,54,0.000333,0.079062,4,948.740563,52.707809,237.185141,71.548875,2,4
0,0,12,12,11,17,28,51,35,86,0.000333,0.137811,10,4134.325233,229.684735,413.432523,107.540616,2,4
0,0,7,7,9,11,20,31,19,50,0.000333,0.072032,4,864.385619,48.021423,216.096405,66.583073,2,4
0,0,10,10,9,15,24,46,29,75,0.000333,0.114624,4,1375.48875,76.416042,343.872188,87.132684,2,4
0,0,8,8,9,12,21,33,21,54,0.000333,0.079062,4,948.740563,52.707809,237.185141,71.548875,2,4
0,0,12,12,11,17,28,51,35,86,0.000333,0.137811,10,4134.325233,229.684735,413.432523,107.540616,2,4
0,0,8,8,11,14,25,39,24,63,0.000333,0.097521,5,1462.8147,81.267483,292.56294,91.356717,2,4
0,0,11,11,11,18,29,54,34,88,0.000333,0.142501,5,2137.511638,118.750647,427.502328,113.112398,2,4
0,0,9,9,11,15,26,41,26,67,0.000333,0.104976,5,1574.647306,87.480406,314.929461,96.657107,2,4
0,0,13,13,11,20,31,59,40,99,0.000333,0.163488,10,4904.654347,272.480797,490.465435,124.49231,2,4
0,0,7,7,9,11,20,30,19,49,0.000333,0.070591,4,847.097907,47.060995,211.774477,66.583073,2,4
0,0,10,10,9,14,23,45,29,74,0.000333,0.111581,8,2677.948678,148.774927,334.743585,81.832294,2,4
0,0,8,8,9,12,21,32,21,53,0.000333,0.077598,4,931.171294,51.731739,232.792823,71.548875,2,4
0,0,12,12,11,16,27,50,35,85,0.000333,0.134722,10,4041.654377,224.536354,404.165438,102.053748,2,4
0,0,7,7,9,11,20,30,19,49,0.000333,0.070591,4,847.097907,47.060995,211.774477,66.583073,2,4
0,0,10,10,9,14,23,45,29,74,0.000333,0.111581,8,2677.948678,148.774927,334.743585,81.832294,2,4
0,0,8,8,9,12,21,32,21,53,0.000333,0.077598,4,931.171294,51.731739,232.792823,71.548875,2,4
0,0,12,12,11,16,27,50,35,85,0.000333,0.134722,10,4041.654377,224.536354,404.165438,102.053748,2,4
0,0,7,7,9,14,23,34,22,56,0.000333,0.08444,4,1013.277878,56.293215,253.31947,81.832294,2,4
0,0,10,10,9,17,26,49,32,81,0.000333,0.126912,4,1522.942469,84.607915,380.735617,98.016193,2,4
0,0,8,8,9,15,24,36,24,60,0.000333,0.091699,4,1100.391,61.132833,275.09775,87.132684,2,4
0,0,12,12,11,19,30,54,38,92,0.000333,0.150478,10,4514.339348,250.79663,451.433935,118.764371,2,4
0,0,7,7,9,11,20,31,19,50,0.000333,0.072032,4,864.385619,48.021423,216.096405,66.583073,2,4
0,0,10,10,9,15,24,46,29,75,0.000333,0.114624,4,1375.48875,76.416042,343.872188,87.132684,2,4
0,0,8,8,9,12,21,33,21,54,0.000333,0.079062,4,948.740563,52.707809,237.185141,71.548875,2,4
0,0,12,12,11,17,28,51,35,86,0.000333,0.137811,10,4134.325233,229.684735,413.432523,107.540616,2,4
0,0,8,8,11,14,25,39,24,63,0.000333,0.097521,5,1462.8147,81.267483,292.56294,91.356717,2,4
0,0,11,11,11,18,29,54,34,88,0.000333,0.142501,5,2137.511638,118.750647,427.502328,113.112398,2,4
0,0,9,9,11,15,26,41,26,67,0.000333,0.104976,5,1574.647306,87.480406,314.929461,96.657107,2,4
0,0,13,13,11,20,31,59,40,99,0.000333,0.163488,10,4904.654347,272.480797,490.465435,124.49231,2,4
0,0,7,7,9,11,20,31,19,50,0.000333,0.072032,4,864.385619,48.021423,216.096405,66.583073,2,4
0,0,10,10,9,15,24,46,29,75,0.000333,0.114624,4,1375.48875,76.416042,343.872188,87.132684,2,4
0,0,8,8,9,12,21,33,21,54,0.000333,0.079062,4,948.740563,52.707809,237.185141,71.548875,2,4
0,0,12,12,11,17,28,51,35,86,0.000333,0.137811,10,4134.325233,229.684735,413.432523,107.540616,2,4
0,0,7,7,9,11,20,30,19,49,0.000333,0.070591,4,847.097907,47.060995,211.774477,66.583073,2,4
0,0,10,10,9,14,23,45,29,74,0.000333,0.111581,8,2677.948678,148.774927,334.743585,81.832294,2,4
0,0,8,8,9,12,21,32,21,53,0.000333,0.077598,4,931.171294,51.731739,232.792823,71.548875,2,4
0,0,12,12,11,16,27,50,35,85,0.000333,0.134722,10,4041.654377,224.536354,404.165438,102.053748,2,4
0,0,7,7,9,11,20,30,19,49,0.000333,0.070591,4,847.097907,47.060995,211.774477,66.583073,2,4
0,0,10,10,9,14,23,45,29,74,0.000333,0.111581,8,2677.948678,148.774927,334.743585,81.832294,2,4
0,0,8,8,9,12,21,32,21,53,0.000333,0.077598,4,931.171294,51.731739,232.792823,71.548875,2,4
0,0,12,12,11,16,27,50,35,85,0.000333,0.134722,10,4041.654377,224.536354,404.165438,102.053748,2,4
0,0,7,7,9,14,23,34,22,56,0.000333,0.08444,4,1013.277878,56.293215,253.31947,81.832294,2,4
0,0,10,10,9,17,26,49,32,81,0.000333,0.126912,4,1522.942469,84.607915,380.735617,98.016193,2,4
0,0,8,8,9,15,24,36,24,60,0.000333,0.091699,4,1100.391,61.132833,275.09775,87.132684,2,4
0,0,12,12,11,19,30,54,38,92,0.000333,0.150478,10,4514.339348,250.79663,451.433935,118.764371,2,4
0,0,7,7,9,11,20,31,19,50,0.000333,0.072032,4,864.385619,48.021423,216.096405,66.583073,2,4
0,0,10,10,9,15,24,46,29,75,0.000333,0.114624,4,1375.48875,76.416042,343.872188,87.132684,2,4
0,0,8,8,9,12,21,33,21,54,0.000333,0.079062,4,948.740563,52.707809,237.185141,71.548875,2,4
0,0,12,12,11,17,28,51,35,86,0.000333,0.137811,10,4134.325233,229.684735,413.432523,107.540616,2,4
0,0,8,8,11,14,25,39,24,63,0.000333,0.097521,5,1462.8147,81.267483,292.56294,91.356717,2,4
0,0,11,11,11,18,29,54,34,88,0.000333,0.142501,5,2137.511638,118.750647,427.502328,113.112398,2,4
0,0,9,9,11,15,26,41,26,67,0.000333,0.104976,5,1574.647306,87.480406,314.929461,96.657107,2,4
0,0,13,13,11,20,31,59,40,99,0.000333,0.163488,10,4904.654347,272.480797,490.465435,124.49231,2,4
0,0,7,7,9,11,20,31,19,50,0.000333,0.072032,4,864.385619,48.021423,216.096405,66.583073,2,4
0,0,10,10,9,15,24,46,29,75,0.000333,0.114624,4,1375.48875,76.416042,343.872188,87.132684,2,4
0,0,8,8,9,12,21,33,21,54,0.000333,0.079062,4,948.740563,52.707809,237.185141,71.548875,2,4
0,0,12,12,11,17,28,51,35,86,0.000333,0.137811,10,4134.325233,229.684735,413.432523,107.540616,2,4
0,0,7,7,9,14,23,34,22,56,0.000333,0.08444,4,1013.277878,56.293215,253.31947,81.832294,2,4
0,0,10,10,9,17,26,49,32,81,0.000333,0.126912,4,1522.942469,84.607915,380.735617,98.016193,2,4
0,0,8,8,9,15,24,36,24,60,0.000333,0.091699,4,1100.391,61.132833,275.09775,87.132684,2,4
0,0,12,12,11,19,30,54,38,92,0.000333,0.150478,10,4514.339348,250.79663,451.433935,118.764371,2,4
0,0,7,7,9,11,20,30,19,49,0.000333,0.070591,4,847.097907,47.060995,211.774477,66.583073,2,4
0,0,10,10,9,14,23,45,29,74,0.000333,0.111581,8,2677.948678,148.774927,334.743585,81.832294,2,4
0,0,8,8,9,12,21,32,21,53,0.000333,0.077598,4,931.171294,51.731739,232.792823,71.548875,2,4
0,0,12,12,11,16,27,50,35,85,0.000333,0.134722,10,4041.654377,224.536354,404.165438,102.053748,2,4
0,0,7,7,9,11,20,30,19,49,0.000333,0.070591,4,847.097907,47.060995,211.774477,66.583073,2,4
0,0,10,10,9,14,23,45,29,74,0.000333,0.111581,8,2677.948678,148.774927,334.743585,81.832294,2,4
0,0,8,8,9,12,21,32,21,53,0.000333,0.077598,4,931.171294,51.731739,232.792823,71.548875,2,4
0,0,12,12,11,16,27,50,35,85,0.000333,0.134722,10,4041.654377,224.536354,404.165438,102.053748,2,4
0,0,8,8,11,14,25,39,24,63,0.000333,0.097521,5,1462.8147,81.267483,292.56294,91.356717,2,4
0,0,11,11,11,18,29,54,34,88,0.000333,0.142501,5,2137.511638,118.750647,427.502328,113.112398,2,4
0,0,9,9,11,15,26,41,26,67,0.000333,0.104976,5,1574.647306,87.480406,314.929461,96.657107,2,4
0,0,13,13,11,20,31,59,40,99,0.000333,0.163488,10,4904.654347,272.480797,490.465435,124.49231,2,4
0,0,7,7,9,11,20,31,19,50,0.000333,0.072032,4,864.385619,48.021423,216.096405,66.583073,2,4
0,0,10,10,9,15,24,46,29,75,0.000333,0.114624,4,1375.48875,76.416042,343.872188,87.132684,2,4
0,0,8,8,9,12,21,33,21,54,0.000333,0.079062,4,948.740563,52.707809,237.185141,71.548875,2,4
0,0,12,12,11,17,28,51,35,86,0.000333,0.137811,10,4134.325233,229.684735,413.432523,107.540616,2,4
0,0,7,7,9,11,20,31,19,50,0.000333,0.072032,4,864.385619,48.021423,216.096405,66.583073,2,4
0,0,10,10,9,15,24,46,29,75,0.000333,0.114624,4,1375.48875,76.416042,343.872188,87.132684,2,4
0,0,8,8,9,12,21,33,21,54,0.000333,0.079062,4,948.740563,52.707809,237.185141,71.548875,2,4
0,0,12,12,11,17,28,51,35,86,0.000333,0.137811,10,4134.325233,229.684735,413.432523,107.540616,2,4
0,0,7,7,9,14,23,34,22,56,0.000333,0.08444,4,1013.277878,56.293215,253.31947,81.832294,2,4
0,0,10,10,9,17,26,49,32,81,0.000333,0.126912,4,1522.942469,84.607915,380.735617,98.016193,2,4
0,0,8,8,9,15,24,36,24,60,0.000333,0.091699,4,1100.391,61.132833,275.09775,87.132684,2,4
0,0,12,12,11,19,30,54,38,92,0.000333,0.150478,10,4514.339348,250.79663,451.433935,118.764371,2,4
0,0,7,7,9,11,20,30,19,49,0.000333,0.070591,4,847.097907,47.060995,211.774477,66.583073,2,4
0,0,10,10,9,14,23,45,29,74,0.000333,0.111581,8,2677.948678,148.774927,334.743585,81.832294,2,4
0,0,8,8,9,12,21,32,21,53,0.000333,0.077598,4,931.171294,51.731739,232.792823,71.548875,2,4
0,0,12,12,11,16,27,50,35,85,0.000333,0.134722,10,4041.654377,224.536354,404.165438,102.053748,2,4
0,0,7,7,9,11,20,30,19,49,0.000333,0.070591,4,847.097907,47.060995,211.774477,66.583073,2,4
0,0,10,10,9,14,23,45,29,74,0.000333,0.111581,8,2677.948678,148.774927,334.743585,81.832294,2,4
0,0,8,8,9,12,21,32,21,53,0.000333,0.077598,4,931.171294,51.731739,232.792823,71.548875,2,4
0,0,12,12,11,16,27,50,35,85,0.000333,0.134722,10,4041.654377,224.536354,404.165438,102.053748,2,4
0,0,8,8,11,14,25,39,24,63,0.000333,0.097521,5,1462.8147,81.267483,292.56294,91.356717,2,4
0,0,11,11,11,18,29,54,34,88,0.000333,0.142501,5,2137.511638,118.750647,427.502328,113.112398,2,4
0,0,9,9,11,15,26,41,26,67,0.000333,0.104976,5,1574.647306,87.480406,314.929461,96.657107,2,4
0,0,13,13,11,20,31,59,40,99,0.000333,0.163488,10,4904.654347,272.480797,490.465435,124.49231,2,4
0,0,7,7,9,11,20,31,19,50,0.000333,0.072032,4,864.385619,48.021423,216.096405,66.583073,2,4
0,0,10,10,9,15,24,46,29,75,0.000333,0.114624,4,1375.48875,76.416042,343.872188,87.132684,2,4
0,0,8,8,9,12,21,33,21,54,0.000333,0.079062,4,948.740563,52.707809,237.185141,71.548875,2,4
0,0,12,12,11,17,28,51,35,86,0.000333,0.137811,10,4134.325233,229.684735,413.432523,107.540616,2,4
0,0,7,7,9,11,20,31,19,50,0.000333,0.072032,4,864.385619,48.021423,216.096405,66.583073,2,4
0,0,10,10,9,15,24,46,29,75,0.000333,0.114624,4,1375.48875,76.416042,343.872188,87.132684,2,4
0,0,8,8,9,12,21,33,21,54,0.000333,0.079062,4,948.740563,52.707809,237.185141,71.548875,2,4
0,0,12,12,11,17,28,51,35,86,0.000333,0.137811,10,4134.325233,229.684735,413.432523,107.540616,2,4
0,0,7,7,9,14,23,34,22,56,0.000333,0.08444,4,1013.277878,56.293215,253.31947,81.832294,2,4
0,0,10,10,9,17,26,49,32,81,0.000333,0.126912,4,1522.942469,84.607915,380.735617,98.016193,2,4
0,0,8,8,9,15,24,36,24,60,0.000333,0.091699,4,1100.391,61.132833,275.09775,87.132684,2,4
0,0,12,12,11,19,30,54,38,92,0.000333,0.150478,10,4514.339348,250.79663,451.433935,118.764371,2,4
0,0,7,7,9,11,20,30,19,49,0.000333,0.070591,4,847.097907,47.060995,211.774477,66.583073,2,4
0,0,10,10,9,14,23,45,29,74,0.000333,0.111581,8,2677.948678,148.774927,334.743585,81.832294,2,4
0,0,8,8,9,12,21,32,21,53,0.000333,0.077598,4,931.171294,51.731739,232.792823,71.548875,2,4
0,0,12,12,11,16,27,50,35,85,0.000333,0.134722,10,4041.654377,224.536354,404.165438,102.053748,2,4
0,0,7,7,9,11,20,30,19,49,0.000333,0.070591,4,847.097907,47.060995,211.774477,66.583073,2,4
0,0,10,10,9,14,23,45,29,74,0.000333,0.111581,8,2677.948678,148.774927,334.743585,81.832294,2,4
0,0,8,8,9,12,21,32,21,53,0.000333,0.077598,4,931.171294,51.731739,232.792823,71.548875,2,4
0,0,12,12,11,16,27,50,35,85,0.000333,0.134722,10,4041.654377,224.536354,404.165438,102.053748,2,4
0,0,8,8,11,14,25,39,24,63,0.000333,0.097521,5,1462.8147,81.267483,292.56294,91.356717,2,4
0,0,11,11,11,18,29,54,34,88,0.000333,0.142501,5,2137.511638,118.750647,427.502328,113.112398,2,4
0,0,9,9,11,15,26,41,26,67,0.000333,0.104976,5,1574.647306,87.480406,314.929461,96.657107,2,4
0,0,13,13,11,20,31,59,40,99,0.000333,0.163488,10,4904.654347,272.480797,490.465435,124.49231,2,4
0,0,7,7,9,11,20,31,19,50,0.000333,0.072032,4,864.385619,48.021423,216.096405,66.583073,2,4
0,0,10,10,9,15,24,46,29,75,0.000333,0.114624,4,1375.48875,76.416042,343.872188,87.132684,2,4
0,0,8,8,9,12,21,33,21,54,0.000333,0.079062,4,948.740563,52.707809,237.185141,71.548875,2,4
0,0,12,12,11,17,28,51,35,86,0.000333,0.137811,10,4134.325233,229.684735,413.432523,107.540616,2,4
0,0,7,7,9,11,20,31,19,50,0.000333,0.072032,4,864.385619,48.021423,216.096405,66.583073,2,4
0,0,10,10,9,15,24,46,29,75,0.000333,0.114624,4,1375.48875,76.416042,343.872188,87.132684,2,4
0,0,8,8,9,12,21,33,21,54,0.000333,0.079062,4,948.740563,52.707809,237.185141,71.548875,2,4
0,0,12,12,11,17,28,51,35,86,0.000333,0.137811,10,4134.325233,229.684735,413.432523,107.540616,2,4
0,0,7,7,9,11,20,30,19,49,0.000333,0.070591,4,847.097907,47.060995,211.774477,66.583073,2,4
0,0,10,10,9,14,23,45,29,74,0.000333,0.111581,8,2677.948678,148.774927,334.743585,81.832294,2,4
0,0,8,8,9,12,21,32,21,53,0.000333,0.077598,4,931.171294,51.731739,232.792823,71.548875,2,4
0,0,12,12,11,16,27,50,35,85,0.000333,0.134722,10,4041.654377,224.536354,404.165438,102.053748,2,4
0,0,7,7,9,14,23,34,22,56,0.000333,0.08444,4,1013.277878,56.293215,253.31947,81.832294,2,4
0,0,10,10,9,17,26,49,32,81,0.000333,0.126912,4,1522.942469,84.607915,380.735617,98.016193,2,4
0,0,8,8,9,15,24,36,24,60,0.000333,0.091699,4,1100.391,61.132833,275.09775,87.132684,2,4
0,0,12,12,11,19,30,54,38,92,0.000333,0.150478,10,4514.339348,250.79663,451.433935,118.764371,2,4
0,0,7,7,9,11,20,30,19,49,0.000333,0.070591,4,847.097907,47.060995,211.774477,66.583073,2,4
0,0,10,10,9,14,23,45,29,74,0.000333,0.111581,8,2677.948678,148.774927,334.743585,81.832294,2,4
0,0,8,8,9,12,21,32,21,53,0.000333,0.077598,4,931.171294,51.731739,232.792823,71.548875,2,4
0,0,12,12,11,16,27,50,35,85,0.000333,0.134722,10,4041.654377,224.536354,404.165438,102.053748,2,4
0,0,7,7,9,11,20,31,19,50,0.000333,0.072032,4,864.385619,48.021423,216.096405,66.583073,2,4
0,0,10,10,9,15,24,46,29,75,0.000333,0.114624,4,1375.48875,76.416042,343.872188,87.132684,2,4
0,0,8,8,9,12,21,33,21,54,0.000333,0.079062,4,948.740563,52.707809,237.185141,71.548875,2,4
0,0,12,12,11,17,28,51,35,86,0.000333,0.137811,10,4134.325233,229.684735,413.432523,107.540616,2,4
0,0,7,7,9,11,20,31,19,50,0.000333,0.072032,4,864.385619,48.021423,216.096405,66.583073,2,4
0,0,10,10,9,15,24,46,29,75,0.000333,0.114624,4,1375.48875,76.416042,343.872188,87.132684,2,4
0,0,8,8,9,12,21,33,21,54,0.000333,0.079062,4,948.740563,52.707809,237.185141,71.548875,2,4
0,0,12,12,11,17,28,51,35,86,0.000333,0.137811,10,4134.325233,229.684735,413.432523,107.540616,2,4
0,0,8,8,11,14,25,39,24,63,0.000333,0.097521,5,1462.8147,81.267483,292.56294,91.356717,2,4
0,0,11,11,11,18,29,54,34,88,0.000333,0.142501,5,2137.511638,118.750647,427.502328,113.112398,2,4
0,0,9,9,11,15,26,41,26,67,0.000333,0.104976,5,1574.647306,87.480406,314.929461,96.657107,2,4
0,0,13,13,11,20,31,59,40,99,0.000333,0.163488,10,4904.654347,272.480797,490.465435,124.49231,2,4
0,0,7,7,9,11,20,30,19,49,0.000333,0.070591,4,847.097907,47.060995,211.774477,66.583073,2,4
0,0,10,10,9,14,23,45,29,74,0.000333,0.111581,8,2677.948678,148.774927,334.743585,81.832294,2,4
0,0,8,8,9,12,21,32,21,53,0.000333,0.077598,4,931.171294,51.731739,232.792823,71.548875,2,4
0,0,12,12,11,16,27,50,35,85,0.000333,0.134722,10,4041.654377,224.536354,404.165438,102.053748,2,4
0,0,7,7,9,14,23,34,22,56,0.000333,0.08444,4,1013.277878,56.293215,253.31947,81.832294,2,4
0,0,10,10,9,17,26,49,32,81,0.000333,0.126912,4,1522.942469,84.607915,380.735617,98.016193,2,4
0,0,8,8,9,15,24,36,24,60,0.000333,0.091699,4,1100.391,61.132833,275.09775,87.132684,2,4
0,0,12,12,11,19,30,54,38,92,0.000333,0.150478,10,4514.339348,250.79663,451.433935,118.764371,2,4
0,0,7,7,9,11,20,30,19,49,0.000333,0.070591,4,847.097907,47.060995,211.774477,66.583073,2,4
0,0,10,10,9,14,23,45,29,74,0.000333,0.111581,8,2677.948678,148.774927,334.743585,81.832294,2,4
0,0,8,8,9,12,21,32,21,53,0.000333,0.077598,4,931.171294,51.731739,232.792823,71.548875,2,4
0,0,12,12,11,16,27,50,35,85,0.000333,0.134722,10,4041.654377,224.536354,404.165438,102.053748,2,4
0,0,7,7,9,11,20,31,19,50,0.000333,0.072032,4,864.385619,48.021423,216.096405,66.583073,2,4
0,0,10,10,9,15,24,46,29,75,0.000333,0.114624,4,1375.48875,76.416042,343.872188,87.132684,2,4
0,0,8,8,9,12,21,33,21,54,0.000333,0.079062,4,948.740563,52.707809,237.185141,71.548875,2,4
0,0,12,12,11,17,28,51,35,86,0.000333,0.137811,10,4134.325233,229.684735,413.432523,107.540616,2,4
0,0,7,7,9,11,20,31,19,50,0.000333,0.072032,4,864.385619,48.021423,216.096405,66.583073,2,4
0,0,10,10,9,15,24,46,29,75,0.000333,0.114624,4,1375.48875,76.416042,343.872188,87.132684,2,4
0,0,8,8,9,12,21,33,21,54,0.000333,0.079062,4,948.740563,52.707809,237.185141,71.548875,2,4
0,0,12,12,11,17,28,51,35,86,0.000333,0.137811,10,4134.325233,229.684735,413.432523,107.540616,2,4
0,0,8,8,11,14,25,39,24,63,0.000333,0.097521,5,1462.8147,81.267483,292.56294,91.356717,2,4
0,0,11,11,11,18,29,54,34,88,0.000333,0.142501,5,2137.511638,118.750647,427.502328,113.112398,2,4
0,0,9,9,11,15,26,41,26,67,0.000333,0.104976,5,1574.647306,87.480406,314.929461,96.657107,2,4
0,0,13,13,11,20,31,59,40,99,0.000333,0.163488,10,4904.654347,272.480797,490.465435,124.49231,2,4
0,0,7,7,9,11,20,30,19,49,0.000333,0.070591,4,847.097907,47.060995,211.774477,66.583073,2,4
0,0,10,10,9,14,23,45,29,74,0.000333,0.111581,8,2677.948678,148.774927,334.743585,81.832294,2,4
0,0,8,8,9,12,21,32,21,53,0.000333,0.077598,4,931.171294,51.731739,232.792823,71.548875,2,4
0,0,12,12,11,16,27,50,35,85,0.000333,0.134722,10,4041.654377,224.536354,404.165438,102.053748,2,4
0,0,7,7,9,14,23,34,22,56,0.000333,0.08444,4,1013.277878,56.293215,253.31947,81.832294,2,4
0,0,10,10,9,17,26,49,32,81,0.000333,0.126912,4,1522.942469,84.607915,380.735617,98.016193,2,4
0,0,8,8,9,15,24,36,24,60,0.000333,0.091699,4,1100.391,61.132833,275.09775,87.132684,2,4
0,0,12,12,11,19,30,54,38,92,0.000333,0.150478,10,4514.339348,250.79663,451.433935,118.764371,2,4
0,0,7,7,9,11,20,30,19,49,0.000333,0.070591,4,847.097907,47.060995,211.774477,66.583073,2,4
0,0,10,10,9,14,23,45,29,74,0.000333,0.111581,8,2677.948678,148.774927,334.743585,81.832294,2,4
0,0,8,8,9,12,21,32,21,53,0.000333,0.077598,4,931.171294,51.731739,232.792823,71.548875,2,4
0,0,12,12,11,16,27,50,35,85,0.000333,0.134722,10,4041.654377,224.536354,404.165438,102.053748,2,4
0,0,7,7,9,11,20,31,19,50,0.000333,0.072032,4,864.385619,48.021423,216.096405,66.583073,2,4
0,0,10,10,9,15,24,46,29,75,0.000333,0.114624,4,1375.48875,76.416042,343.872188,87.132684,2,4
0,0,8,8,9,12,21,33,21,54,0.000333,0.079062,4,948.740563,52.707809,237.185141,71.548875,2,4
0,0,12,12,11,17,28,51,35,86,0.000333,0.137811,10,4134.325233,229.684735,413.432523,107.540616,2,4
0,0,7,7,9,11,20,31,19,50,0.000333,0.072032,4,864.385619,48.021423,216.096405,66.583073,2,4
0,0,10,10,9,15,24,46,29,75,0.000333,0.114624,4,1375.48875,76.416042,343.872188,87.132684,2,4
0,0,8,8,9,12,21,33,21,54,0.000333,0.079062,4,948.740563,52.707809,237.185141,71.548875,2,4
0,0,12,12,11,17,28,51,35,86,0.000333,0.137811,10,4134.325233,229.684735,413.432523,107.540616,2,4
0,0,8,8,11,14,25,39,24,63,0.000333,0.097521,5,1462.8147,81.267483,292.56294,91.356717,2,4
0,0,11,11,11,18,29,54,34,88,0.000333,0.142501,5,2137.511638,118.750647,427.502328,113.112398,2,4
0,0,9,9,11,15,26,41,26,67,0.000333,0.104976,5,1574.647306,87.480406,314.929461,96.657107,2,4
0,0,13,13,11,20,31,59,40,99,0.000333,0.163488,10,4904.654347,272.480797,490.465435,124.49231,2,4
0,0,7,7,9,14,23,34,22,56,0.000333,0.08444,4,1013.277878,56.293215,253.31947,81.832294,2,4
0,0,10,10,9,17,26,49,32,81,0.000333,0.126912,4,1522.942469,84.607915,380.735617,98.016193,2,4
0,0,8,8,9,15,24,36,24,60,0.000333,0.091699,4,1100.391,61.132833,275.09775,87.132684,2,4
0,0,12,12,11,19,30,54,38,92,0.000333,0.150478,10,4514.339348,250.79663,451.433935,118.764371,2,4
0,0,7,7,9,11,20,30,19,49,0.000333,0.070591,4,847.097907,47.060995,211.774477,66.583073,2,4
0,0,10,10,9,14,23,45,29,74,0.000333,0.111581,8,2677.948678,148.774927,334.743585,81.832294,2,4
0,0,8,8,9,12,21,32,21,53,0.000333,0.077598,4,931.171294,51.731739,232.792823,71.548875,2,4
0,0,12,12,11,16,27,50,35,85,0.000333,0.134722,10,4041.654377,224.536354,404.165438,102.053748,2,4
0,0,7,7,9,11,20,30,19,49,0.000333,0.070591,4,847.097907,47.060995,211.774477,66.583073,2,4
0,0,10,10,9,14,23,45,29,74,0.000333,0.111581,8,2677.948678,148.774927,334.743585,81.832294,2,4
0,0,8,8,9,12,21,32,21,53,0.000333,0.077598,4,931.171294,51.731739,232.792823,71.548875,2,4
0,0,12,12,11,16,27,50,35,85,0.000333,0.134722,10,4041.654377,224.536354,404.165438,102.053748,2,4
0,0,7,7,9,10,19,31,19,50,0.000333,0.070799,4,849.585503,47.199195,212.396376,61.748606,2,4
0,0,10,10,9,14,23,46,29,75,0.000333,0.113089,8,2714.137174,150.785399,339.267147,81.832294,2,4
0,0,8,8,9,11,20,33,21,54,0.000333,0.077795,4,933.536468,51.863137,233.384117,66.583073,2,4
0,0,12,12,11,16,27,51,35,86,0.000333,0.136307,10,4089.203252,227.177958,408.920325,102.053748,2,4
0,0,7,7,9,10,19,31,19,50,0.000333,0.070799,4,849.585503,47.199195,212.396376,61.748606,2,4
0,0,10,10,9,14,23,46,29,75,0.000333,0.113089,8,2714.137174,150.785399,339.267147,81.832294,2,4
0,0,8,8,9,11,20,33,21,54,0.000333,0.077795,4,933.536468,51.863137,233.384117,66.583073,2,4
0,0,12,12,11,16,27,51,35,86,0.000333,0.136307,10,4089.203252,227.177958,408.920325,102.053748,2,4
0,0,10,10,12,19,31,50,34,84,0.000333,0.138717,6,2496.91494,138.717497,416.15249,123.730173,2,4
0,0,13,13,12,23,35,65,44,109,0.000333,0.186364,6,3354.551093,186.36395,559.091849,147.061475,2,4
0,0,11,11,12,20,32,52,36,88,0.000333,0.146667,6,2640,146.666667,440,129.458112,2,4
0,0,15,15,12,25,37,70,50,120,0.000333,0.208378,12,7501.612847,416.756269,625.134404,159.115955,2,4
0,0,7,7,9,11,20,30,19,49,0.000333,0.070591,4,847.097907,47.060995,211.774477,66.583073,2,4
0,0,10,10,9,14,23,45,29,74,0.000333,0.111581,8,2677.948678,148.774927,334.743585,81.832294,2,4
0,0,8,8,9,12,21,32,21,53,0.000333,0.077598,4,931.171294,51.731739,232.792823,71.548875,2,4
0,0,12,12,11,16,27,50,35,85,0.000333,0.134722,10,4041.654377,224.536354,404.165438,102.053748,2,4
0,0,7,7,9,14,23,34,22,56,0.000333,0.08444,4,1013.277878,56.293215,253.31947,81.832294,2,4
0,0,10,10,9,17,26,49,32,81,0.000333,0.126912,4,1522.942469,84.607915,380.735617,98.016193,2,4
0,0,8,8,9,15,24,36,24,60,0.000333,0.091699,4,1100.391,61.132833,275.09775,87.132684,2,4
0,0,12,12,11,19,30,54,38,92,0.000333,0.150478,10,4514.339348,250.79663,451.433935,118.764371,2,4
0,0,7,7,9,11,20,30,19,49,0.000333,0.070591,4,847.097907,47.060995,211.774477,66.583073,2,4
0,0,10,10,9,14,23,45,29,74,0.000333,0.111581,8,2677.948678,148.774927,334.743585,81.832294,2,4
0,0,8,8,9,12,21,32,21,53,0.000333,0.077598,4,931.171294,51.731739,232.792823,71.548875,2,4
0,0,12,12,11,16,27,50,35,85,0.000333,0.134722,10,4041.654377,224.536354,404.165438,102.053748,2,4
0,0,7,7,9,11,20,31,19,50,0.000333,0.072032,4,864.385619,48.021423,216.096405,66.583073,2,4
0,0,10,10,9,15,24,46,29,75,0.000333,0.114624,4,1375.48875,76.416042,343.872188,87.132684,2,4
0,0,8,8,9,12,21,33,21,54,0.000333,0.079062,4,948.740563,52.707809,237.185141,71.548875,2,4
0,0,12,12,11,17,28,51,35,86,0.000333,0.137811,10,4134.325233,229.684735,413.432523,107.540616,2,4
0,0,7,7,9,11,20,31,19,50,0.000333,0.072032,4,864.385619,48.021423,216.096405,66.583073,2,4
0,0,10,10,9,15,24,46,29,75,0.000333,0.114624,4,1375.48875,76.416042,343.872188,87.132684,2,4
0,0,8,8,9,12,21,33,21,54,0.000333,0.079062,4,948.740563,52.707809,237.185141,71.548875,2,4
0,0,12,12,11,17,28,51,35,86,0.000333,0.137811,10,4134.325233,229.684735,413.432523,107.540616,2,4
0,0,8,8,11,14,25,39,24,63,0.000333,0.097521,5,1462.8147,81.267483,292.56294,91.356717,2,4
0,0,11,11,11,18,29,54,34,88,0.000333,0.142501,5,2137.511638,118.750647,427.502328,113.112398,2,4
0,0,9,9,11,15,26,41,26,67,0.000333,0.104976,5,1574.647306,87.480406,314.929461,96.657107,2,4
0,0,13,13,11,20,31,59,40,99,0.000333,0.163488,10,4904.654347,272.480797,490.465435,124.49231,2,4
0,0,7,7,9,11,20,30,19,49,0.000333,0.070591,4,847.097907,47.060995,211.774477,66.583073,2,4
0,0,10,10,9,14,23,45,29,74,0.000333,0.111581,8,2677.948678,148.774927,334.743585,81.832294,2,4
0,0,8,8,9,12,21,32,21,53,0.000333,0.077598,4,931.171294,51.731739,232.792823,71.548875,2,4
0,0,12,12,11,16,27,50,35,85,0.000333,0.134722,10,4041.654377,224.536354,404.165438,102.053748,2,4
0,0,7,7,9,14,23,34,22,56,0.000333,0.08444,4,1013.277878,56.293215,253.31947,81.832294,2,4
0,0,10,10,9,17,26,49,32,81,0.000333,0.126912,4,1522.942469,84.607915,380.735617,98.016193,2,4
0,0,8,8,9,15,24,36,24,60,0.000333,0.091699,4,1100.391,61.132833,275.09775,87.132684,2,4
0,0,12,12,11,19,30,54,38,92,0.000333,0.150478,10,4514.339348,250.79663,451.433935,118.764371,2,4
0,0,7,7,9,11,20,30,19,49,0.000333,0.070591,4,847.097907,47.060995,211.774477,66.583073,2,4
0,0,10,10,9,14,23,45,29,74,0.000333,0.111581,8,2677.948678,148.774927,334.743585,81.832294,2,4
0,0,8,8,9,12,21,32,21,53,0.000333,0.077598,4,931.171294,51.731739,232.792823,71.548875,2,4
0,0,12,12,11,16,27,50,35,85,0.000333,0.134722,10,4041.654377,224.536354,404.165438,102.053748,2,4
0,0,7,7,9,11,20,31,19,50,0.000333,0.072032,4,864.385619,48.021423,216.096405,66.583073,2,4
0,0,10,10,9,15,24,46,29,75,0.000333,0.114624,4,1375.48875,76.416042,343.872188,87.132684,2,4
0,0,8,8,9,12,21,33,21,54,0.000333,0.079062,4,948.740563,52.707809,237.185141,71.548875,2,4
0,0,12,12,11,17,28,51,35,86,0.000333,0.137811,10,4134.325233,229.684735,413.432523,107.540616,2,4
0,0,7,7,9,11,20,31,19,50,0.000333,0.072032,4,864.385619,48.021423,216.096405,66.583073,2,4
0,0,10,10,9,15,24,46,29,75,0.000333,0.114624,4,1375.48875,76.416042,343.872188,87.132684,2,4
0,0,8,8,9,12,21,33,21,54,0.000333,0.079062,4,948.740563,52.707809,237.185141,71.548875,2,4
0,0,12,12,11,17,28,51,35,86,0.000333,0.137811,10,4134.325233,229.684735,413.432523,107.540616,2,4
0,0,8,8,11,14,25,39,24,63,0.000333,0.097521,5,1462.8147,81.267483,292.56294,91.356717,2,4
0,0,11,11,11,18,29,54,34,88,0.000333,0.142501,5,2137.511638,118.750647,427.502328,113.112398,2,4
0,0,9,9,11,15,26,41,26,67,0.000333,0.104976,5,1574.647306,87.480406,314.929461,96.657107,2,4
0,0,13,13,11,20,31,59,40,99,0.000333,0.163488,10,4904.654347,272.480797,490.465435,124.49231,2,4
0,0,7,7,9,11,20,30,19,49,0.000333,0.070591,4,847.097907,47.060995,211.774477,66.583073,2,4
0,0,10,10,9,14,23,45,29,74,0.000333,0.111581,8,2677.948678,148.774927,334.743585,81.832294,2,4
0,0,8,8,9,12,21,32,21,53,0.000333,0.077598,4,931.171294,51.731739,232.792823,71.548875,2,4
0,0,12,12,11,16,27,50,35,85,0.000333,0.134722,10,4041.654377,224.536354,404.165438,102.053748,2,4
0,0,7,7,9,11,20,30,19,49,0.000333,0.070591,4,847.097907,47.060995,211.774477,66.583073,2,4
0,0,10,10,9,14,23,45,29,74,0.000333,0.111581,8,2677.948678,148.774927,334.743585,81.832294,2,4
0,0,8,8,9,12,21,32,21,53,0.000333,0.077598,4,931.171294,51.731739,232.792823,71.548875,2,4
0,0,12,12,11,16,27,50,35,85,0.000333,0.134722,10,4041.654377,224.536354,404.165438,102.053748,2,4
0,0,7,7,9,14,23,34,22,56,0.000333,0.08444,4,1013.277878,56.293215,253.31947,81.832294,2,4
0,0,10,10,9,17,26,49,32,81,0.000333,0.126912,4,1522.942469,84.607915,380.735617,98.016193,2,4
0,0,8,8,9,15,24,36,24,60,0.000333,0.091699,4,1100.391,61.132833,275.09775,87.132684,2,4
0,0,12,12,11,19,30,54,38,92,0.000333,0.150478,10,4514.339348,250.79663,451.433935,118.764371,2,4
0,0,8,8,11,14,25,39,24,63,0.000333,0.097521,5,1462.8147,81.267483,292.56294,91.356717,2,4
0,0,11,11,11,18,29,54,34,88,0.000333,0.142501,5,2137.511638,118.750647,427.502328,113.112398,2,4
0,0,9,9,11,15,26,41,26,67,0.000333,0.104976,5,1574.647306,87.480406,314.929461,96.657107,2,4
0,0,13,13,11,20,31,59,40,99,0.000333,0.163488,10,4904.654347,272.480797,490.465435,124.49231,2,4
0,0,7,7,9,11,20,31,19,50,0.000333,0.072032,4,864.385619,48.021423,216.096405,66.583073,2,4
0,0,10,10,9,15,24,46,29,75,0.000333,0.114624,4,1375.48875,76.416042,343.872188,87.132684,2,4
0,0,8,8,9,12,21,33,21,54,0.000333,0.079062,4,948.740563,52.707809,237.185141,71.548875,2,4
0,0,12,12,11,17,28,51,35,86,0.000333,0.137811,10,4134.325233,229.684735,413.432523,107.540616,2,4
0,0,7,7,9,11,20,31,19,50,0.000333,0.072032,4,864.385619,48.021423,216.096405,66.583073,2,4
0,0,10,10,9,15,24,46,29,75,0.000333,0.114624,4,1375.48875,76.416042,343.872188,87.132684,2,4
0,0,8,8,9,12,21,33,21,54,0.000333,0.079062,4,948.740563,52.707809,237.185141,71.548875,2,4
0,0,12,12,11,17,28,51,35,86,0.000333,0.137811,10,4134.325233,229.684735,413.432523,107.540616,2,4
0,0,7,7,9,14,23,34,22,56,0.000333,0.08444,4,1013.277878,56.293215,253.31947,81.832294,2,4
0,0,10,10,9,17,26,49,32,81,0.000333,0.126912,4,1522.942469,84.607915,380.735617,98.016193,2,4
0,0,8,8,9,15,24,36,24,60,0.000333,0.091699,4,1100.391,61.132833,275.09775,87.132684,2,4
0,0,12,12,11,19,30,54,38,92,0.000333,0.150478,10,4514.339348,250.79663,451.433935,118.764371,2,4
0,0,7,7,9,11,20,30,19,49,0.000333,0.070591,4,847.097907,47.060995,211.774477,66.583073,2,4
0,0,10,10,9,14,23,45,29,74,0.000333,0.111581,8,2677.948678,148.774927,334.743585,81.832294,2,4
0,0,8,8,9,12,21,32,21,53,0.000333,0.077598,4,931.171294,51.731739,232.792823,71.548875,2,4
0,0,12,12,11,16,27,50,35,85,0.000333,0.134722,10,4041.654377,224.536354,404.165438,102.053748,2,4
0,0,8,8,11,14,25,39,24,63,0.000333,0.097521,5,1462.8147,81.267483,292.56294,91.356717,2,4
0,0,11,11,11,18,29,54,34,88,0.000333,0.142501,5,2137.511638,118.750647,427.502328,113.112398,2,4
0,0,9,9,11,15,26,41,26,67,0.000333,0.104976,5,1574.647306,87.480406,314.929461,96.657107,2,4
0,0,13,13,11,20,31,59,40,99,0.000333,0.163488,10,4904.654347,272.480797,490.465435,124.49231,2,4
0,0,8,8,11,14,25,39,24,63,0.000333,0.097521,5,1462.8147,81.267483,292.56294,91.356717,2,4
0,0,11,11,11,18,29,54,34,88,0.000333,0.142501,5,2137.511638,118.750647,427.502328,113.112398,2,4
0,0,9,9,11,15,26,41,26,67,0.000333,0.104976,5,1574.647306,87.480406,314.929461,96.657107,2,4
0,0,13,13,11,20,31,59,40,99,0.000333,0.163488,10,4904.654347,272.480797,490.465435,124.49231,2,4
0,0,7,7,9,11,20,30,19,49,0.000333,0.070591,4,847.097907,47.060995,211.774477,66.583073,2,4
0,0,10,10,9,14,23,45,29,74,0.000333,0.111581,8,2677.948678,148.774927,334.743585,81.832294,2,4
0,0,8,8,9,12,21,32,21,53,0.000333,0.077598,4,931.171294,51.731739,232.792823,71.548875,2,4
0,0,12,12,11,16,27,50,35,85,0.000333,0.134722,10,4041.654377,224.536354,404.165438,102.053748,2,4
0,0,7,7,9,14,23,34,22,56,0.000333,0.08444,4,1013.277878,56.293215,253.31947,81.832294,2,4
0,0,10,10,9,17,26,49,32,81,0.000333,0.126912,4,1522.942469,84.607915,380.735617,98.016193,2,4
0,0,8,8,9,15,24,36,24,60,0.000333,0.091699,4,1100.391,61.132833,275.09775,87.132684,2,4
0,0,12,12,11,19,30,54,38,92,0.000333,0.150478,10,4514.339348,250.79663,451.433935,118.764371,2,4
0,0,8,8,11,14,25,39,24,63,0.000333,0.097521,5,1462.8147,81.267483,292.56294,91.356717,2,4
0,0,11,11,11,18,29,54,34,88,0.000333,0.142501,5,2137.511638,118.750647,427.502328,113.112398,2,4
0,0,9,9,11,15,26,41,26,67,0.000333,0.104976,5,1574.647306,87.480406,314.929461,96.657107,2,4
0,0,13,13,11,20,31,59,40,99,0.000333,0.163488,10,4904.654347,272.480797,490.465435,124.49231,2,4
0,0,8,8,11,14,25,39,24,63,0.000333,0.097521,5,1462.8147,81.267483,292.56294,91.356717,2,4
0,0,11,11,11,18,29,54,34,88,0.000333,0.142501,5,2137.511638,118.750647,427.502328,113.112398,2,4
0,0,9,9,11,15,26,41,26,67,0.000333,0.104976,5,1574.647306,87.480406,314.929461,96.657107,2,4
0,0,13,13,11,20,31,59,40,99,0.000333,0.163488,10,4904.654347,272.480797,490.465435,124.49231,2,4
0,0,7,7,9,11,20,30,19,49,0.000333,0.070591,4,847.097907,47.060995,211.774477,66.583073,2,4
0,0,10,10,9,14,23,45,29,74,0.000333,0.111581,8,2677.948678,148.774927,334.743585,81.832294,2,4
0,0,8,8,9,12,21,32,21,53,0.000333,0.077598,4,931.171294,51.731739,232.792823,71.548875,2,4
0,0,12,12,11,16,27,50,35,85,0.000333,0.134722,10,4041.654377,224.536354,404.165438,102.053748,2,4
0,0,7,7,9,14,23,34,22,56,0.000333,0.08444,4,1013.277878,56.293215,253.31947,81.832294,2,4
0,0,10,10,9,17,26,49,32,81,0.000333,0.126912,4,1522.942469,84.607915,380.735617,98.016193,2,4
0,0,8,8,9,15,24,36,24,60,0.000333,0.091699,4,1100.391,61.132833,275.09775,87.132684,2,4
0,0,12,12,11,19,30,54,38,92,0.000333,0.150478,10,4514.339348,250.79663,451.433935,118.764371,2,4
0,0,9,9,12,18,30,48,32,80,0.000333,0.13085,6,2355.307486,130.850416,392.551248,118.0782,2,4
0,0,12,12,12,22,34,63,42,105,0.000333,0.178061,6,3205.10159,178.061199,534.183598,141.127046,2,4
0,0,10,10,12,19,31,50,34,84,0.000333,0.138717,6,2496.91494,138.717497,416.15249,123.730173,2,4
0,0,14,14,12,24,36,68,48,116,0.000333,0.199904,12,7196.535602,399.807533,599.7113,153.05865,2,4
0,0,9,9,12,18,30,48,32,80,0.000333,0.13085,6,2355.307486,130.850416,392.551248,118.0782,2,4
0,0,12,12,12,22,34,63,42,105,0.000333,0.178061,6,3205.10159,178.061199,534.183598,141.127046,2,4
0,0,10,10,12,19,31,50,34,84,0.000333,0.138717,6,2496.91494,138.717497,416.15249,123.730173,2,4
0,0,14,14,12,24,36,68,48,116,0.000333,0.199904,12,7196.535602,399.807533,599.7113,153.05865,2,4
0,0,7,7,9,14,23,34,22,56,0.000333,0.08444,4,1013.277878,56.293215,253.31947,81.832294,2,4
0,0,10,10,9,17,26,49,32,81,0.000333,0.126912,4,1522.942469,84.607915,380.735617,98.016193,2,4
0,0,8,8,9,15,24,36,24,60,0.000333,0.091699,4,1100.391,61.132833,275.09775,87.132684,2,4
0,0,12,12,11,19,30,54,38,92,0.000333,0.150478,10,4514.339348,250.79663,451.433935,118.764371,2,4
0,0,7,7,9,11,20,30,19,49,0.000333,0.070591,4,847.097907,47.060995,211.774477,66.583073,2,4
0,0,10,10,9,14,23,45,29,74,0.000333,0.111581,8,2677.948678,148.774927,334.743585,81.832294,2,4
0,0,8,8,9,12,21,32,21,53,0.000333,0.077598,4,931.171294,51.731739,232.792823,71.548875,2,4
0,0,12,12,11,16,27,50,35,85,0.000333,0.134722,10,4041.654377,224.536354,404.165438,102.053748,2,4
0,0,8,8,10,14,24,35,25,60,0.000333,0.091699,5,1375.48875,76.416042,275.09775,86.52225,2,4
0,0,11,11,13,21,34,54,38,92,0.000333,0.156016,6,2808.279488,156.015527,468.046581,140.344382,2,4
0,0,7,7,9,14,23,34,22,56,0.000333,0.08444,4,1013.277878,56.293215,253.31947,81.832294,2,4
0,0,7,7,9,11,20,30,19,49,0.000333,0.070591,4,847.097907,47.060995,211.774477,66.583073,2,4
0,0,6,6,9,14,23,29,21,50,0.000333,0.075393,4,904.712391,50.2618,226.178098,81.832294,2,4
0,0,8,8,9,16,25,34,29,63,0.000333,0.097521,4,1170.25176,65.013987,292.56294,92.529325,2,4
0,0,7,7,9,11,20,30,19,49,0.000333,0.070591,4,847.097907,47.060995,211.774477,66.583073,2,4
0,0,7,7,9,14,23,34,22,56,0.000333,0.08444,4,1013.277878,56.293215,253.31947,81.832294,2,4
0,0,8,8,9,12,21,33,23,56,0.000333,0.08199,4,983.879103,54.65995,245.969776,71.548875,2,4
0,0,11,11,12,20,32,52,38,90,0.000333,0.15,6,2700,150,450,129.458112,2,4
0,0,7,7,9,14,23,34,22,56,0.000333,0.08444,4,1013.277878,56.293215,253.31947,81.832294,2,4
0,0,7,7,9,11,20,30,19,49,0.000333,0.070591,4,847.097907,47.060995,211.774477,66.583073,2,4
0,0,7,7,10,11,21,34,21,55,0.000333,0.080526,5,1207.887291,67.10485,241.577458,71.273029,2,4
0,0,7,7,10,11,21,34,21,55,0.000333,0.080526,5,1207.887291,67.10485,241.577458,71.273029,2,4
0,0,7,7,9,11,20,30,19,49,0.000333,0.070591,4,847.097907,47.060995,211.774477,66.583073,2,4
0,0,7,7,9,14,23,34,22,56,0.000333,0.08444,4,1013.277878,56.293215,253.31947,81.832294,2,4
0,0,7,7,10,15,25,31,23,54,0.000333,0.083589,5,1253.841171,69.657843,250.768234,91.82264,2,4
0,0,7,7,10,15,25,31,23,54,0.000333,0.083589,5,1253.841171,69.657843,250.768234,91.82264,2,4
0,0,7,7,9,11,20,30,19,49,0.000333,0.070591,4,847.097907,47.060995,211.774477,66.583073,2,4
0,0,7,7,9,14,23,34,22,56,0.000333,0.08444,4,1013.277878,56.293215,253.31947,81.832294,2,4
0,0,8,8,10,14,24,35,25,60,0.000333,0.091699,5,1375.48875,76.416042,275.09775,86.52225,2,4
0,0,11,11,13,21,34,54,38,92,0.000333,0.156016,6,2808.279488,156.015527,468.046581,140.344382,2,4
0,0,7,7,9,14,23,34,22,56,0.000333,0.08444,4,1013.277878,56.293215,253.31947,81.832294,2,4
0,0,7,7,9,11,20,30,19,49,0.000333,0.070591,4,847.097907,47.060995,211.774477,66.583073,2,4
0,0,8,8,10,12,22,35,22,57,0.000333,0.084729,5,1270.938011,70.607667,254.187602,76.238831,2,4
0,0,11,11,13,19,32,54,36,90,0.000333,0.15,6,2700,150,450,128.816339,2,4
0,0,7,7,9,14,23,34,22,56,0.000333,0.08444,4,1013.277878,56.293215,253.31947,81.832294,2,4
0,0,7,7,9,11,20,30,19,49,0.000333,0.070591,4,847.097907,47.060995,211.774477,66.583073,2,4
0,0,6,6,10,13,23,30,20,50,0.000333,0.075393,5,1130.890489,62.827249,226.178098,81.324997,2,4
0,0,6,6,10,12,22,30,19,49,0.000333,0.072837,5,1092.560747,60.697819,218.512149,76.238831,2,4
0,0,7,7,9,11,20,30,19,49,0.000333,0.070591,4,847.097907,47.060995,211.774477,66.583073,2,4
0,0,7,7,9,14,23,34,22,56,0.000333,0.08444,4,1013.277878,56.293215,253.31947,81.832294,2,4
0,0,9,9,9,17,26,34,30,64,0.000333,0.100276,4,1203.312568,66.850698,300.828142,98.016193,2,4
0,0,12,12,12,23,35,53,42,95,0.000333,0.162427,6,2923.69132,162.427296,487.281887,147.061475,2,4
0,0,7,7,9,14,23,34,22,56,0.000333,0.08444,4,1013.277878,56.293215,253.31947,81.832294,2,4
0,0,7,7,9,11,20,30,19,49,0.000333,0.070591,4,847.097907,47.060995,211.774477,66.583073,2,4
0,0,6,6,9,15,24,29,22,51,0.000333,0.077944,4,935.33235,51.962908,233.833088,87.132684,2,4
0,0,6,6,9,14,23,29,21,50,0.000333,0.075393,4,904.712391,50.2618,226.178098,81.832294,2,4
0,0,7,7,9,14,23,34,22,56,0.000333,0.08444,4,1013.277878,56.293215,253.31947,81.832294,2,4
0,0,7,7,9,11,20,30,19,49,0.000333,0.070591,4,847.097907,47.060995,211.774477,66.583073,2,4
0,0,6,6,9,15,24,29,22,51,0.000333,0.077944,4,935.33235,51.962908,233.833088,87.132684,2,4
0,0,6,6,9,14,23,29,21,50,0.000333,0.075393,4,904.712391,50.2618,226.178098,81.832294,2,4
0,0,7,7,9,14,23,34,22,56,0.000333,0.08444,4,1013.277878,56.293215,253.31947,81.832294,2,4
0,0,7,7,9,11,20,30,19,49,0.000333,0.070591,4,847.097907,47.060995,211.774477,66.583073,2,4
0,0,6,6,9,15,24,29,22,51,0.000333,0.077944,4,935.33235,51.962908,233.833088,87.132684,2,4
0,0,6,6,9,14,23,29,21,50,0.000333,0.075393,4,904.712391,50.2618,226.178098,81.832294,2,4
0,0,7,7,9,14,23,34,22,56,0.000333,0.08444,4,1013.277878,56.293215,253.31947,81.832294,2,4
0,0,7,7,9,11,20,30,19,49,0.000333,0.070591,4,847.097907,47.060995,211.774477,66.583073,2,4
0,0,6,6,9,15,24,29,22,51,0.000333,0.077944,4,935.33235,51.962908,233.833088,87.132684,2,4
0,0,6,6,9,14,23,29,21,50,0.000333,0.075393,4,904.712391,50.2618,226.178098,81.832294,2,4
0,0,7,7,9,14,23,34,22,56,0.000333,0.08444,4,1013.277878,56.293215,253.31947,81.832294,2,4
0,0,7,7,9,11,20,30,19,49,0.000333,0.070591,4,847.097907,47.060995,211.774477,66.583073,2,4
0,0,6,6,9,12,21,31,20,51,0.000333,0.074669,4,896.032754,49.779597,224.008189,71.548875,2,4
0,0,6,6,9,13,22,31,21,52,0.000333,0.077297,4,927.561777,51.53121,231.890444,76.635041,2,4
0,0,7,7,9,14,23,34,22,56,0.000333,0.08444,4,1013.277878,56.293215,253.31947,81.832294,2,4
0,0,7,7,9,11,20,30,19,49,0.000333,0.070591,4,847.097907,47.060995,211.774477,66.583073,2,4
0,0,7,7,9,15,24,33,24,57,0.000333,0.087114,4,1045.37145,58.076192,261.342863,87.132684,2,4
0,0,7,7,9,16,25,33,25,58,0.000333,0.089781,4,1077.374636,59.854146,269.343659,92.529325,2,4
0,0,7,7,9,14,23,34,22,56,0.000333,0.08444,4,1013.277878,56.293215,253.31947,81.832294,2,4
0,0,7,7,9,11,20,30,19,49,0.000333,0.070591,4,847.097907,47.060995,211.774477,66.583073,2,4
0,0,8,8,9,16,25,41,28,69,0.000333,0.106809,4,1281.704308,71.205795,320.426077,92.529325,2,4
0,0,8,8,9,17,26,41,29,70,0.000333,0.109677,4,1316.123121,73.117951,329.03078,98.016193,2,4
0,0,7,7,9,14,23,34,22,56,0.000333,0.08444,4,1013.277878,56.293215,253.31947,81.832294,2,4
0,0,7,7,9,11,20,30,19,49,0.000333,0.070591,4,847.097907,47.060995,211.774477,66.583073,2,4
0,0,6,6,9,15,24,29,22,51,0.000333,0.077944,4,935.33235,51.962908,233.833088,87.132684,2,4
0,0,6,6,9,14,23,29,21,50,0.000333,0.075393,4,904.712391,50.2618,226.178098,81.832294,2,4
0,0,6,6,11,12,23,31,19,50,0.000333,0.075393,5,1130.890489,62.827249,226.178098,81.073298,2,4
0,0,6,6,11,12,23,31,19,50,0.000333,0.075393,5,1130.890489,62.827249,226.178098,81.073298,2,4
0,0,7,7,11,16,27,35,25,60,0.000333,0.095098,5,1426.466251,79.248125,285.29325,102.053748,2,4
0,0,7,7,11,17,28,35,26,61,0.000333,0.09775,5,1466.243251,81.457958,293.24865,107.540616,2,4
0,0,7,7,9,14,23,34,22,56,0.000333,0.08444,4,1013.277878,56.293215,253.31947,81.832294,2,4
0,0,7,7,9,11,20,30,19,49,0.000333,0.070591,4,847.097907,47.060995,211.774477,66.583073,2,4
0,0,7,7,10,17,27,32,27,59,0.000333,0.093513,5,1402.691813,77.927323,280.538363,102.706149,2,4
0,0,7,7,10,18,28,32,28,60,0.000333,0.096147,5,1442.206477,80.122582,288.441295,108.277931,2,4
0,0,7,7,9,14,23,34,22,56,0.000333,0.08444,4,1013.277878,56.293215,253.31947,81.832294,2,4
0,0,7,7,9,11,20,30,19,49,0.000333,0.070591,4,847.097907,47.060995,211.774477,66.583073,2,4
0,0,6,6,9,13,22,29,20,49,0.000333,0.072837,4,874.048597,48.558255,218.512149,76.635041,2,4
0,0,6,6,9,14,23,29,21,50,0.000333,0.075393,4,904.712391,50.2618,226.178098,81.832294,2,4
0,0,7,7,9,11,20,30,19,49,0.000333,0.070591,4,847.097907,47.060995,211.774477,66.583073,2,4
0,0,6,6,11,16,27,31,23,54,0.000333,0.085588,5,1283.819626,71.323313,256.763925,102.053748,2,4
0,0,7,7,9,11,20,30,19,49,0.000333,0.070591,4,847.097907,47.060995,211.774477,66.583073,2,4
0,0,6,6,10,16,26,30,23,53,0.000333,0.083041,5,1245.616525,69.200918,249.123305,97.219281,2,4
0,0,7,7,9,14,23,34,22,56,0.000333,0.08444,4,1013.277878,56.293215,253.31947,81.832294,2,4
0,0,7,7,9,11,20,30,19,49,0.000333,0.070591,4,847.097907,47.060995,211.774477,66.583073,2,4
0,0,6,6,9,10,19,29,17,46,0.000333,0.065135,4,781.618662,43.423259,195.404666,61.748606,2,4
0,0,6,6,9,10,19,29,17,46,0.000333,0.065135,4,781.618662,43.423259,195.404666,61.748606,2,4
0,0,7,7,9,11,20,30,19,49,0.000333,0.070591,4,847.097907,47.060995,211.774477,66.583073,2,4
0,0,7,7,9,11,20,30,19,49,0.000333,0.070591,4,847.097907,47.060995,211.774477,66.583073,2,4
0,0,7,7,9,14,23,34,22,56,0.000333,0.08444,4,1013.277878,56.293215,253.31947,81.832294,2,4
0,0,7,7,9,11,20,31,19,50,0.000333,0.072032,4,864.385619,48.021423,216.096405,66.583073,2,4
0,0,7,7,9,11,20,31,19,50,0.000333,0.072032,4,864.385619,48.021423,216.096405,66.583073,2,4
0,0,7,7,9,11,20,31,19,50,0.000333,0.072032,4,864.385619,48.021423,216.096405,66.583073,2,4
0,0,7,7,9,11,20,30,19,49,0.000333,0.070591,4,847.097907,47.060995,211.774477,66.583073,2,4
0,0,7,7,9,11,20,30,19,49,0.000333,0.070591,4,847.097907,47.060995,211.774477,66.583073,2,4
0,0,7,7,9,14,23,34,22,56,0.000333,0.08444,4,1013.277878,56.293215,253.31947,81.832294,2,4
0,0,7,7,9,11,20,31,19,50,0.000333,0.072032,4,864.385619,48.021423,216.096405,66.583073,2,4
0,0,7,7,9,11,20,31,19,50,0.000333,0.072032,4,864.385619,48.021423,216.096405,66.583073,2,4
0,0,7,7,9,11,20,31,19,50,0.000333,0.072032,4,864.385619,48.021423,216.096405,66.583073,2,4
0,0,7,7,9,14,23,34,22,56,0.000333,0.08444,4,1013.277878,56.293215,253.31947,81.832294,2,4
0,0,7,7,9,11,20,30,19,49,0.000333,0.070591,4,847.097907,47.060995,211.774477,66.583073,2,4
0,0,7,7,9,11,20,30,19,49,0.000333,0.070591,4,847.097907,47.060995,211.774477,66.583073,2,4
0,0,7,7,9,11,20,31,19,50,0.000333,0.072032,4,864.385619,48.021423,216.096405,66.583073,2,4
0,0,7,7,9,11,20,31,19,50,0.000333,0.072032,4,864.385619,48.021423,216.096405,66.583073,2,4
0,0,7,7,9,11,20,31,19,50,0.000333,0.072032,4,864.385619,48.021423,216.096405,66.583073,2,4
0,0,7,7,9,14,23,34,22,56,0.000333,0.08444,4,1013.277878,56.293215,253.31947,81.832294,2,4
0,0,7,7,9,11,20,30,19,49,0.000333,0.070591,4,847.097907,47.060995,211.774477,66.583073,2,4
0,0,7,7,9,11,20,30,19,49,0.000333,0.070591,4,847.097907,47.060995,211.774477,66.583073,2,4
0,0,7,7,9,11,20,31,19,50,0.000333,0.072032,4,864.385619,48.021423,216.096405,66.583073,2,4
0,0,7,7,9,11,20,31,19,50,0.000333,0.072032,4,864.385619,48.021423,216.096405,66.583073,2,4
0,0,7,7,9,11,20,31,19,50,0.000333,0.072032,4,864.385619,48.021423,216.096405,66.583073,2,4
0,0,7,7,9,11,20,30,19,49,0.000333,0.070591,4,847.097907,47.060995,211.774477,66.583073,2,4
0,0,7,7,9,11,20,30,19,49,0.000333,0.070591,4,847.097907,47.060995,211.774477,66.583073,2,4
0,0,7,7,9,14,23,34,22,56,0.000333,0.08444,4,1013.277878,56.293215,253.31947,81.832294,2,4
0,0,7,7,9,11,20,31,19,50,0.000333,0.072032,4,864.385619,48.021423,216.096405,66.583073,2,4
0,0,7,7,9,11,20,31,19,50,0.000333,0.072032,4,864.385619,48.021423,216.096405,66.583073,2,4
0,0,7,7,9,11,20,31,19,50,0.000333,0.072032,4,864.385619,48.021423,216.096405,66.583073,2,4
0,0,7,7,9,11,20,30,19,49,0.000333,0.070591,4,847.097907,47.060995,211.774477,66.583073,2,4
0,0,7,7,9,11,20,30,19,49,0.000333,0.070591,4,847.097907,47.060995,211.774477,66.583073,2,4
0,0,7,7,9,14,23,34,22,56,0.000333,0.08444,4,1013.277878,56.293215,253.31947,81.832294,2,4
0,0,7,7,9,11,20,31,19,50,0.000333,0.072032,4,864.385619,48.021423,216.096405,66.583073,2,4
0,0,7,7,9,11,20,31,19,50,0.000333,0.072032,4,864.385619,48.021423,216.096405,66.583073,2,4
0,0,7,7,9,11,20,31,19,50,0.000333,0.072032,4,864.385619,48.021423,216.096405,66.583073,2,4
0,0,7,7,9,11,20,30,19,49,0.000333,0.070591,4,847.097907,47.060995,211.774477,66.583073,2,4
0,0,7,7,9,11,20,30,19,49,0.000333,0.070591,4,847.097907,47.060995,211.774477,66.583073,2,4
0,0,7,7,9,14,23,34,22,56,0.000333,0.08444,4,1013.277878,56.293215,253.31947,81.832294,2,4
0,0,7,7,9,11,20,31,19,50,0.000333,0.072032,4,864.385619,48.021423,216.096405,66.583073,2,4
0,0,7,7,9,11,20,31,19,50,0.000333,0.072032,4,864.385619,48.021423,216.096405,66.583073,2,4
0,0,7,7,9,11,20,31,19,50,0.000333,0.072032,4,864.385619,48.021423,216.096405,66.583073,2,4
0,0,7,7,9,11,20,30,19,49,0.000333,0.070591,4,847.097907,47.060995,211.774477,66.583073,2,4
0,0,7,7,9,11,20,30,19,49,0.000333,0.070591,4,847.097907,47.060995,211.774477,66.583073,2,4
0,0,7,7,9,14,23,34,22,56,0.000333,0.08444,4,1013.277878,56.293215,253.31947,81.832294,2,4
0,0,7,7,9,11,20,31,19,50,0.000333,0.072032,4,864.385619,48.021423,216.096405,66.583073,2,4
0,0,7,7,9,11,20,31,19,50,0.000333,0.072032,4,864.385619,48.021423,216.096405,66.583073,2,4
0,0,7,7,9,11,20,31,19,50,0.000333,0.072032,4,864.385619,48.021423,216.096405,66.583073,2,4
0,0,7,7,9,11,20,30,19,49,0.000333,0.070591,4,847.097907,47.060995,211.774477,66.583073,2,4
0,0,7,7,9,11,20,30,19,49,0.000333,0.070591,4,847.097907,47.060995,211.774477,66.583073,2,4
0,0,7,7,9,14,23,34,22,56,0.000333,0.08444,4,1013.277878,56.293215,253.31947,81.832294,2,4
0,0,7,7,9,11,20,31,19,50,0.000333,0.072032,4,864.385619,48.021423,216.096405,66.583073,2,4
0,0,7,7,9,11,20,31,19,50,0.000333,0.072032,4,864.385619,48.021423,216.096405,66.583073,2,4
0,0,7,7,9,11,20,31,19,50,0.000333,0.072032,4,864.385619,48.021423,216.096405,66.583073,2,4
0,0,7,7,9,11,20,30,19,49,0.000333,0.070591,4,847.097907,47.060995,211.774477,66.583073,2,4
0,0,7,7,9,11,20,30,19,49,0.000333,0.070591,4,847.097907,47.060995,211.774477,66.583073,2,4
0,0,7,7,9,14,23,34,22,56,0.000333,0.08444,4,1013.277878,56.293215,253.31947,81.832294,2,4
0,0,7,7,9,11,20,31,19,50,0.000333,0.072032,4,864.385619,48.021423,216.096405,66.583073,2,4
0,0,7,7,9,11,20,31,19,50,0.000333,0.072032,4,864.385619,48.021423,216.096405,66.583073,2,4
0,0,7,7,9,11,20,31,19,50,0.000333,0.072032,4,864.385619,48.021423,216.096405,66.583073,2,4
0,0,7,7,9,11,20,30,19,49,0.000333,0.070591,4,847.097907,47.060995,211.774477,66.583073,2,4
0,0,7,7,9,14,23,34,22,56,0.000333,0.08444,4,1013.277878,56.293215,253.31947,81.832294,2,4
0,0,7,7,9,11,20,30,19,49,0.000333,0.070591,4,847.097907,47.060995,211.774477,66.583073,2,4
0,0,7,7,9,10,19,31,19,50,0.000333,0.070799,4,849.585503,47.199195,212.396376,61.748606,2,4
0,0,7,7,9,11,20,31,19,50,0.000333,0.072032,4,864.385619,48.021423,216.096405,66.583073,2,4
0,0,7,7,9,10,19,31,19,50,0.000333,0.070799,4,849.585503,47.199195,212.396376,61.748606,2,4
0,0,7,7,9,11,20,30,19,49,0.000333,0.070591,4,847.097907,47.060995,211.774477,66.583073,2,4
0,0,7,7,9,11,20,30,19,49,0.000333,0.070591,4,847.097907,47.060995,211.774477,66.583073,2,4
0,0,7,7,9,14,23,34,22,56,0.000333,0.08444,4,1013.277878,56.293215,253.31947,81.832294,2,4
0,0,7,7,9,11,20,31,19,50,0.000333,0.072032,4,864.385619,48.021423,216.096405,66.583073,2,4
0,0,7,7,9,11,20,31,19,50,0.000333,0.072032,4,864.385619,48.021423,216.096405,66.583073,2,4
0,0,7,7,9,11,20,31,19,50,0.000333,0.072032,4,864.385619,48.021423,216.096405,66.583073,2,4
0,0,7,7,9,11,20,30,19,49,0.000333,0.070591,4,847.097907,47.060995,211.774477,66.583073,2,4
0,0,7,7,9,11,20,30,19,49,0.000333,0.070591,4,847.097907,47.060995,211.774477,66.583073,2,4
0,0,7,7,9,14,23,34,22,56,0.000333,0.08444,4,1013.277878,56.293215,253.31947,81.832294,2,4
0,0,7,7,9,11,20,31,19,50,0.000333,0.072032,4,864.385619,48.021423,216.096405,66.583073,2,4
0,0,7,7,9,11,20,31,19,50,0.000333,0.072032,4,864.385619,48.021423,216.096405,66.583073,2,4
0,0,7,7,9,11,20,31,19,50,0.000333,0.072032,4,864.385619,48.021423,216.096405,66.583073,2,4
0,0,7,7,9,11,20,30,19,49,0.000333,0.070591,4,847.097907,47.060995,211.774477,66.583073,2,4
0,0,7,7,9,14,23,34,22,56,0.000333,0.08444,4,1013.277878,56.293215,253.31947,81.832294,2,4
0,0,7,7,9,11,20,30,19,49,0.000333,0.070591,4,847.097907,47.060995,211.774477,66.583073,2,4
0,0,7,7,9,11,20,31,19,50,0.000333,0.072032,4,864.385619,48.021423,216.096405,66.583073,2,4
0,0,7,7,9,11,20,31,19,50,0.000333,0.072032,4,864.385619,48.021423,216.096405,66.583073,2,4
0,0,7,7,9,11,20,31,19,50,0.000333,0.072032,4,864.385619,48.021423,216.096405,66.583073,2,4
0,0,7,7,9,11,20,30,19,49,0.000333,0.070591,4,847.097907,47.060995,211.774477,66.583073,2,4
0,0,7,7,9,14,23,34,22,56,0.000333,0.08444,4,1013.277878,56.293215,253.31947,81.832294,2,4
0,0,7,7,9,11,20,31,19,50,0.000333,0.072032,4,864.385619,48.021423,216.096405,66.583073,2,4
0,0,7,7,9,11,20,31,19,50,0.000333,0.072032,4,864.385619,48.021423,216.096405,66.583073,2,4
0,0,7,7,9,14,23,34,22,56,0.000333,0.08444,4,1013.277878,56.293215,253.31947,81.832294,2,4
0,0,7,7,9,11,20,30,19,49,0.000333,0.070591,4,847.097907,47.060995,211.774477,66.583073,2,4
0,0,7,7,9,11,20,31,19,50,0.000333,0.072032,4,864.385619,48.021423,216.096405,66.583073,2,4
0,0,7,7,9,11,20,31,19,50,0.000333,0.072032,4,864.385619,48.021423,216.096405,66.583073,2,4
0,0,7,7,9,11,20,30,19,49,0.000333,0.070591,4,847.097907,47.060995,211.774477,66.583073,2,4
0,0,7,7,9,14,23,34,22,56,0.000333,0.08444,4,1013.277878,56.293215,253.31947,81.832294,2,4
0,0,6,6,9,10,19,29,17,46,0.000333,0.065135,4,781.618662,43.423259,195.404666,61.748606,2,4
0,0,6,6,9,10,19,29,17,46,0.000333,0.065135,4,781.618662,43.423259,195.404666,61.748606,2,4
0,0,7,7,9,14,23,34,22,56,0.000333,0.08444,4,1013.277878,56.293215,253.31947,81.832294,2,4
0,0,7,7,9,11,20,30,19,49,0.000333,0.070591,4,847.097907,47.060995,211.774477,66.583073,2,4
0,0,8,8,10,14,24,35,25,60,0.000333,0.091699,5,1375.48875,76.416042,275.09775,86.52225,2,4
0,0,8,8,10,13,23,35,23,58,0.000333,0.087456,5,1311.832967,72.879609,262.366593,81.324997,2,4
0,0,7,7,9,14,23,34,22,56,0.000333,0.08444,4,1013.277878,56.293215,253.31947,81.832294,2,4
0,0,7,7,9,11,20,30,19,49,0.000333,0.070591,4,847.097907,47.060995,211.774477,66.583073,2,4
0,0,8,8,9,16,25,34,29,63,0.000333,0.097521,4,1170.25176,65.013987,292.56294,92.529325,2,4
0,0,6,6,9,14,23,29,21,50,0.000333,0.075393,4,904.712391,50.2618,226.178098,81.832294,2,4
0,0,7,7,9,14,23,34,22,56,0.000333,0.08444,4,1013.277878,56.293215,253.31947,81.832294,2,4
0,0,7,7,9,11,20,30,19,49,0.000333,0.070591,4,847.097907,47.060995,211.774477,66.583073,2,4
0,0,8,8,9,12,21,33,23,56,0.000333,0.08199,4,983.879103,54.65995,245.969776,71.548875,2,4
0,0,8,8,9,12,21,33,23,56,0.000333,0.08199,4,983.879103,54.65995,245.969776,71.548875,2,4
0,0,7,7,9,14,23,34,22,56,0.000333,0.08444,4,1013.277878,56.293215,253.31947,81.832294,2,4
0,0,7,7,9,11,20,30,19,49,0.000333,0.070591,4,847.097907,47.060995,211.774477,66.583073,2,4
0,0,7,7,10,11,21,34,21,55,0.000333,0.080526,5,1207.887291,67.10485,241.577458,71.273029,2,4
0,0,7,7,10,11,21,34,21,55,0.000333,0.080526,5,1207.887291,67.10485,241.577458,71.273029,2,4
0,0,7,7,9,11,20,30,19,49,0.000333,0.070591,4,847.097907,47.060995,211.774477,66.583073,2,4
0,0,7,7,9,14,23,34,22,56,0.000333,0.08444,4,1013.277878,56.293215,253.31947,81.832294,2,4
0,0,7,7,10,15,25,31,23,54,0.000333,0.083589,5,1253.841171,69.657843,250.768234,91.82264,2,4
0,0,7,7,10,15,25,31,23,54,0.000333,0.083589,5,1253.841171,69.657843,250.768234,91.82264,2,4
0,0,7,7,9,11,20,30,19,49,0.000333,0.070591,4,847.097907,47.060995,211.774477,66.583073,2,4
0,0,7,7,9,14,23,34,22,56,0.000333,0.08444,4,1013.277878,56.293215,253.31947,81.832294,2,4
0,0,8,8,10,13,23,35,23,58,0.000333,0.087456,5,1311.832967,72.879609,262.366593,81.324997,2,4
0,0,8,8,10,14,24,35,25,60,0.000333,0.091699,5,1375.48875,76.416042,275.09775,86.52225,2,4
0,0,7,7,9,11,20,30,19,49,0.000333,0.070591,4,847.097907,47.060995,211.774477,66.583073,2,4
0,0,7,7,9,14,23,34,22,56,0.000333,0.08444,4,1013.277878,56.293215,253.31947,81.832294,2,4
0,0,8,8,10,11,21,35,21,56,0.000333,0.08199,5,1229.848878,68.324938,245.969776,71.273029,2,4
0,0,8,8,10,12,22,35,22,57,0.000333,0.084729,5,1270.938011,70.607667,254.187602,76.238831,2,4
0,0,7,7,9,14,23,34,22,56,0.000333,0.08444,4,1013.277878,56.293215,253.31947,81.832294,2,4
0,0,7,7,9,11,20,30,19,49,0.000333,0.070591,4,847.097907,47.060995,211.774477,66.583073,2,4
0,0,6,6,10,12,22,30,19,49,0.000333,0.072837,5,1092.560747,60.697819,218.512149,76.238831,2,4
0,0,6,6,10,13,23,30,20,50,0.000333,0.075393,5,1130.890489,62.827249,226.178098,81.324997,2,4
0,0,7,7,9,14,23,34,22,56,0.000333,0.08444,4,1013.277878,56.293215,253.31947,81.832294,2,4
0,0,7,7,9,11,20,30,19,49,0.000333,0.070591,4,847.097907,47.060995,211.774477,66.583073,2,4
0,0,9,9,9,15,24,34,27,61,0.000333,0.093228,4,1118.73085,62.151714,279.682713,87.132684,2,4
0,0,9,9,9,17,26,34,30,64,0.000333,0.100276,4,1203.312568,66.850698,300.828142,98.016193,2,4
0,0,7,7,9,11,20,30,19,49,0.000333,0.070591,4,847.097907,47.060995,211.774477,66.583073,2,4
0,0,7,7,9,14,23,34,22,56,0.000333,0.08444,4,1013.277878,56.293215,253.31947,81.832294,2,4
0,0,6,6,9,15,24,29,22,51,0.000333,0.077944,4,935.33235,51.962908,233.833088,87.132684,2,4
0,0,6,6,9,14,23,29,21,50,0.000333,0.075393,4,904.712391,50.2618,226.178098,81.832294,2,4
0,0,7,7,9,14,23,34,22,56,0.000333,0.08444,4,1013.277878,56.293215,253.31947,81.832294,2,4
0,0,7,7,9,11,20,30,19,49,0.000333,0.070591,4,847.097907,47.060995,211.774477,66.583073,2,4
0,0,6,6,9,15,24,29,22,51,0.000333,0.077944,4,935.33235,51.962908,233.833088,87.132684,2,4
0,0,6,6,9,14,23,29,21,50,0.000333,0.075393,4,904.712391,50.2618,226.178098,81.832294,2,4
0,0,7,7,9,14,23,34,22,56,0.000333,0.08444,4,1013.277878,56.293215,253.31947,81.832294,2,4
0,0,7,7,9,11,20,30,19,49,0.000333,0.070591,4,847.097907,47.060995,211.774477,66.583073,2,4
0,0,6,6,9,14,23,29,21,50,0.000333,0.075393,4,904.712391,50.2618,226.178098,81.832294,2,4
0,0,6,6,9,15,24,29,22,51,0.000333,0.077944,4,935.33235,51.962908,233.833088,87.132684,2,4
0,0,7,7,9,14,23,34,22,56,0.000333,0.08444,4,1013.277878,56.293215,253.31947,81.832294,2,4
0,0,7,7,9,11,20,30,19,49,0.000333,0.070591,4,847.097907,47.060995,211.774477,66.583073,2,4
0,0,6,6,9,15,24,29,22,51,0.000333,0.077944,4,935.33235,51.962908,233.833088,87.132684,2,4
0,0,6,6,9,14,23,29,21,50,0.000333,0.075393,4,904.712391,50.2618,226.178098,81.832294,2,4
0,0,7,7,9,11,20,30,19,49,0.000333,0.070591,4,847.097907,47.060995,211.774477,66.583073,2,4
0,0,7,7,9,14,23,34,22,56,0.000333,0.08444,4,1013.277878,56.293215,253.31947,81.832294,2,4
0,0,6,6,9,13,22,31,21,52,0.000333,0.077297,4,927.561777,51.53121,231.890444,76.635041,2,4
0,0,6,6,9,12,21,31,20,51,0.000333,0.074669,4,896.032754,49.779597,224.008189,71.548875,2,4
0,0,7,7,9,14,23,34,22,56,0.000333,0.08444,4,1013.277878,56.293215,253.31947,81.832294,2,4
0,0,7,7,9,11,20,30,19,49,0.000333,0.070591,4,847.097907,47.060995,211.774477,66.583073,2,4
0,0,7,7,9,16,25,33,25,58,0.000333,0.089781,4,1077.374636,59.854146,269.343659,92.529325,2,4
0,0,7,7,9,15,24,33,24,57,0.000333,0.087114,4,1045.37145,58.076192,261.342863,87.132684,2,4
0,0,7,7,9,11,20,30,19,49,0.000333,0.070591,4,847.097907,47.060995,211.774477,66.583073,2,4
0,0,7,7,9,14,23,34,22,56,0.000333,0.08444,4,1013.277878,56.293215,253.31947,81.832294,2,4
0,0,8,8,9,17,26,41,29,70,0.000333,0.109677,4,1316.123121,73.117951,329.03078,98.016193,2,4
0,0,8,8,9,16,25,41,28,69,0.000333,0.106809,4,1281.704308,71.205795,320.426077,92.529325,2,4
0,0,6,6,11,12,23,31,19,50,0.000333,0.075393,5,1130.890489,62.827249,226.178098,81.073298,2,4
0,0,6,6,11,12,23,31,19,50,0.000333,0.075393,5,1130.890489,62.827249,226.178098,81.073298,2,4
0,0,6,6,9,15,24,29,22,51,0.000333,0.077944,4,935.33235,51.962908,233.833088,87.132684,2,4
0,0,6,6,9,14,23,29,21,50,0.000333,0.075393,4,904.712391,50.2618,226.178098,81.832294,2,4
0,0,6,6,11,12,23,31,19,50,0.000333,0.075393,5,1130.890489,62.827249,226.178098,81.073298,2,4
0,0,6,6,11,12,23,31,19,50,0.000333,0.075393,5,1130.890489,62.827249,226.178098,81.073298,2,4
0,0,7,7,11,17,28,35,26,61,0.000333,0.09775,5,1466.243251,81.457958,293.24865,107.540616,2,4
0,0,7,7,11,16,27,35,25,60,0.000333,0.095098,5,1426.466251,79.248125,285.29325,102.053748,2,4
0,0,7,7,9,14,23,34,22,56,0.000333,0.08444,4,1013.277878,56.293215,253.31947,81.832294,2,4
0,0,7,7,9,11,20,30,19,49,0.000333,0.070591,4,847.097907,47.060995,211.774477,66.583073,2,4
0,0,7,7,10,18,28,32,28,60,0.000333,0.096147,5,1442.206477,80.122582,288.441295,108.277931,2,4
0,0,7,7,10,17,27,32,27,59,0.000333,0.093513,5,1402.691813,77.927323,280.538363,102.706149,2,4
0,0,7,7,9,11,20,30,19,49,0.000333,0.070591,4,847.097907,47.060995,211.774477,66.583073,2,4
0,0,7,7,9,14,23,34,22,56,0.000333,0.08444,4,1013.277878,56.293215,253.31947,81.832294,2,4
0,0,6,6,9,14,23,29,21,50,0.000333,0.075393,4,904.712391,50.2618,226.178098,81.832294,2,4
0,0,6,6,9,13,22,29,20,49,0.000333,0.072837,4,874.048597,48.558255,218.512149,76.635041,2,4
0,0,7,7,9,11,20,30,19,49,0.000333,0.070591,4,847.097907,47.060995,211.774477,66.583073,2,4
0,0,6,6,11,15,26,31,22,53,0.000333,0.083041,5,1245.616525,69.200918,249.123305,96.657107,2,4
0,0,7,7,9,11,20,30,19,49,0.000333,0.070591,4,847.097907,47.060995,211.774477,66.583073,2,4
0,0,6,6,10,15,25,30,22,52,0.000333,0.080494,5,1207.402609,67.077923,241.480522,91.82264,2,4
0,0,7,7,9,14,23,34,22,56,0.000333,0.08444,4,1013.277878,56.293215,253.31947,81.832294,2,4
0,0,7,7,9,11,20,30,19,49,0.000333,0.070591,4,847.097907,47.060995,211.774477,66.583073,2,4
0,0,9,9,12,19,31,48,32,80,0.000333,0.132112,6,2378.014229,132.111902,396.335705,123.730173,2,4
0,0,6,6,9,10,19,29,17,46,0.000333,0.065135,4,781.618662,43.423259,195.404666,61.748606,2,4
0,0,7,7,9,11,20,30,19,49,0.000333,0.070591,4,847.097907,47.060995,211.774477,66.583073,2,4
0,0,7,7,9,14,23,34,22,56,0.000333,0.08444,4,1013.277878,56.293215,253.31947,81.832294,2,4
0,0,7,7,9,11,20,30,19,49,0.000333,0.070591,4,847.097907,47.060995,211.774477,66.583073,2,4
0,0,7,7,9,11,20,31,19,50,0.000333,0.072032,4,864.385619,48.021423,216.096405,66.583073,2,4
0,0,7,7,9,11,20,31,19,50,0.000333,0.072032,4,864.385619,48.021423,216.096405,66.583073,2,4
0,0,8,8,11,14,25,39,24,63,0.000333,0.097521,5,1462.8147,81.267483,292.56294,91.356717,2,4
0,0,7,7,9,11,20,30,19,49,0.000333,0.070591,4,847.097907,47.060995,211.774477,66.583073,2,4
0,0,7,7,9,14,23,34,22,56,0.000333,0.08444,4,1013.277878,56.293215,253.31947,81.832294,2,4
0,0,7,7,9,11,20,30,19,49,0.000333,0.070591,4,847.097907,47.060995,211.774477,66.583073,2,4
0,0,7,7,9,11,20,31,19,50,0.000333,0.072032,4,864.385619,48.021423,216.096405,66.583073,2,4
0,0,7,7,9,11,20,31,19,50,0.000333,0.072032,4,864.385619,48.021423,216.096405,66.583073,2,4
0,0,8,8,11,14,25,39,24,63,0.000333,0.097521,5,1462.8147,81.267483,292.56294,91.356717,2,4
0,0,7,7,9,11,20,30,19,49,0.000333,0.070591,4,847.097907,47.060995,211.774477,66.583073,2,4
0,0,7,7,9,11,20,30,19,49,0.000333,0.070591,4,847.097907,47.060995,211.774477,66.583073,2,4
0,0,7,7,9,14,23,34,22,56,0.000333,0.08444,4,1013.277878,56.293215,253.31947,81.832294,2,4
0,0,8,8,11,14,25,39,24,63,0.000333,0.097521,5,1462.8147,81.267483,292.56294,91.356717,2,4
0,0,7,7,9,11,20,31,19,50,0.000333,0.072032,4,864.385619,48.021423,216.096405,66.583073,2,4
0,0,7,7,9,11,20,31,19,50,0.000333,0.072032,4,864.385619,48.021423,216.096405,66.583073,2,4
0,0,7,7,9,11,20,30,19,49,0.000333,0.070591,4,847.097907,47.060995,211.774477,66.583073,2,4
0,0,7,7,9,11,20,30,19,49,0.000333,0.070591,4,847.097907,47.060995,211.774477,66.583073,2,4
0,0,7,7,9,14,23,34,22,56,0.000333,0.08444,4,1013.277878,56.293215,253.31947,81.832294,2,4
0,0,8,8,11,14,25,39,24,63,0.000333,0.097521,5,1462.8147,81.267483,292.56294,91.356717,2,4
0,0,7,7,9,11,20,31,19,50,0.000333,0.072032,4,864.385619,48.021423,216.096405,66.583073,2,4
0,0,7,7,9,11,20,31,19,50,0.000333,0.072032,4,864.385619,48.021423,216.096405,66.583073,2,4
0,0,7,7,9,14,23,34,22,56,0.000333,0.08444,4,1013.277878,56.293215,253.31947,81.832294,2,4
0,0,7,7,9,11,20,30,19,49,0.000333,0.070591,4,847.097907,47.060995,211.774477,66.583073,2,4
0,0,7,7,9,11,20,30,19,49,0.000333,0.070591,4,847.097907,47.060995,211.774477,66.583073,2,4
0,0,7,7,9,11,20,31,19,50,0.000333,0.072032,4,864.385619,48.021423,216.096405,66.583073,2,4
0,0,7,7,9,11,20,31,19,50,0.000333,0.072032,4,864.385619,48.021423,216.096405,66.583073,2,4
0,0,8,8,11,14,25,39,24,63,0.000333,0.097521,5,1462.8147,81.267483,292.56294,91.356717,2,4
0,0,7,7,9,14,23,34,22,56,0.000333,0.08444,4,1013.277878,56.293215,253.31947,81.832294,2,4
0,0,7,7,9,11,20,30,19,49,0.000333,0.070591,4,847.097907,47.060995,211.774477,66.583073,2,4
0,0,7,7,9,11,20,30,19,49,0.000333,0.070591,4,847.097907,47.060995,211.774477,66.583073,2,4
0,0,7,7,9,11,20,31,19,50,0.000333,0.072032,4,864.385619,48.021423,216.096405,66.583073,2,4
0,0,7,7,9,11,20,31,19,50,0.000333,0.072032,4,864.385619,48.021423,216.096405,66.583073,2,4
0,0,8,8,11,14,25,39,24,63,0.000333,0.097521,5,1462.8147,81.267483,292.56294,91.356717,2,4
0,0,7,7,9,11,20,30,19,49,0.000333,0.070591,4,847.097907,47.060995,211.774477,66.583073,2,4
0,0,7,7,9,11,20,30,19,49,0.000333,0.070591,4,847.097907,47.060995,211.774477,66.583073,2,4
0,0,7,7,9,14,23,34,22,56,0.000333,0.08444,4,1013.277878,56.293215,253.31947,81.832294,2,4
0,0,7,7,9,11,20,31,19,50,0.000333,0.072032,4,864.385619,48.021423,216.096405,66.583073,2,4
0,0,8,8,11,14,25,39,24,63,0.000333,0.097521,5,1462.8147,81.267483,292.56294,91.356717,2,4
0,0,7,7,9,11,20,31,19,50,0.000333,0.072032,4,864.385619,48.021423,216.096405,66.583073,2,4
0,0,7,7,9,11,20,30,19,49,0.000333,0.070591,4,847.097907,47.060995,211.774477,66.583073,2,4
0,0,7,7,9,14,23,34,22,56,0.000333,0.08444,4,1013.277878,56.293215,253.31947,81.832294,2,4
0,0,7,7,9,11,20,30,19,49,0.000333,0.070591,4,847.097907,47.060995,211.774477,66.583073,2,4
0,0,7,7,9,11,20,31,19,50,0.000333,0.072032,4,864.385619,48.021423,216.096405,66.583073,2,4
0,0,7,7,9,11,20,31,19,50,0.000333,0.072032,4,864.385619,48.021423,216.096405,66.583073,2,4
0,0,8,8,11,14,25,39,24,63,0.000333,0.097521,5,1462.8147,81.267483,292.56294,91.356717,2,4
0,0,7,7,9,11,20,30,19,49,0.000333,0.070591,4,847.097907,47.060995,211.774477,66.583073,2,4
0,0,7,7,9,14,23,34,22,56,0.000333,0.08444,4,1013.277878,56.293215,253.31947,81.832294,2,4
0,0,7,7,9,11,20,30,19,49,0.000333,0.070591,4,847.097907,47.060995,211.774477,66.583073,2,4
0,0,7,7,9,11,20,31,19,50,0.000333,0.072032,4,864.385619,48.021423,216.096405,66.583073,2,4
0,0,7,7,9,11,20,31,19,50,0.000333,0.072032,4,864.385619,48.021423,216.096405,66.583073,2,4
0,0,8,8,11,14,25,39,24,63,0.000333,0.097521,5,1462.8147,81.267483,292.56294,91.356717,2,4
0,0,7,7,9,11,20,30,19,49,0.000333,0.070591,4,847.097907,47.060995,211.774477,66.583073,2,4
0,0,7,7,9,14,23,34,22,56,0.000333,0.08444,4,1013.277878,56.293215,253.31947,81.832294,2,4
0,0,7,7,9,11,20,30,19,49,0.000333,0.070591,4,847.097907,47.060995,211.774477,66.583073,2,4
0,0,7,7,9,11,20,31,19,50,0.000333,0.072032,4,864.385619,48.021423,216.096405,66.583073,2,4
0,0,7,7,9,11,20,31,19,50,0.000333,0.072032,4,864.385619,48.021423,216.096405,66.583073,2,4
0,0,8,8,11,14,25,39,24,63,0.000333,0.097521,5,1462.8147,81.267483,292.56294,91.356717,2,4
0,0,7,7,9,11,20,30,19,49,0.000333,0.070591,4,847.097907,47.060995,211.774477,66.583073,2,4
0,0,7,7,9,14,23,34,22,56,0.000333,0.08444,4,1013.277878,56.293215,253.31947,81.832294,2,4
0,0,7,7,9,11,20,30,19,49,0.000333,0.070591,4,847.097907,47.060995,211.774477,66.583073,2,4
0,0,7,7,9,10,19,31,19,50,0.000333,0.070799,4,849.585503,47.199195,212.396376,61.748606,2,4
0,0,7,7,9,10,19,31,19,50,0.000333,0.070799,4,849.585503,47.199195,212.396376,61.748606,2,4
0,0,10,10,12,20,32,50,34,84,0.000333,0.14,6,2520,140,420,129.458112,2,4
0,0,7,7,9,11,20,30,19,49,0.000333,0.070591,4,847.097907,47.060995,211.774477,66.583073,2,4
0,0,7,7,9,14,23,34,22,56,0.000333,0.08444,4,1013.277878,56.293215,253.31947,81.832294,2,4
0,0,7,7,9,11,20,30,19,49,0.000333,0.070591,4,847.097907,47.060995,211.774477,66.583073,2,4
0,0,7,7,9,11,20,31,19,50,0.000333,0.072032,4,864.385619,48.021423,216.096405,66.583073,2,4
0,0,7,7,9,11,20,31,19,50,0.000333,0.072032,4,864.385619,48.021423,216.096405,66.583073,2,4
0,0,8,8,11,14,25,39,24,63,0.000333,0.097521,5,1462.8147,81.267483,292.56294,91.356717,2,4
0,0,7,7,9,11,20,30,19,49,0.000333,0.070591,4,847.097907,47.060995,211.774477,66.583073,2,4
0,0,7,7,9,14,23,34,22,56,0.000333,0.08444,4,1013.277878,56.293215,253.31947,81.832294,2,4
0,0,7,7,9,11,20,30,19,49,0.000333,0.070591,4,847.097907,47.060995,211.774477,66.583073,2,4
0,0,7,7,9,11,20,31,19,50,0.000333,0.072032,4,864.385619,48.021423,216.096405,66.583073,2,4
0,0,7,7,9,11,20,31,19,50,0.000333,0.072032,4,864.385619,48.021423,216.096405,66.583073,2,4
0,0,8,8,11,14,25,39,24,63,0.000333,0.097521,5,1462.8147,81.267483,292.56294,91.356717,2,4
0,0,7,7,9,11,20,30,19,49,0.000333,0.070591,4,847.097907,47.060995,211.774477,66.583073,2,4
0,0,7,7,9,14,23,34,22,56,0.000333,0.08444,4,1013.277878,56.293215,253.31947,81.832294,2,4
0,0,7,7,9,11,20,30,19,49,0.000333,0.070591,4,847.097907,47.060995,211.774477,66.583073,2,4
0,0,8,8,11,14,25,39,24,63,0.000333,0.097521,5,1462.8147,81.267483,292.56294,91.356717,2,4
0,0,7,7,9,11,20,31,19,50,0.000333,0.072032,4,864.385619,48.021423,216.096405,66.583073,2,4
0,0,7,7,9,11,20,31,19,50,0.000333,0.072032,4,864.385619,48.021423,216.096405,66.583073,2,4
0,0,7,7,9,11,20,30,19,49,0.000333,0.070591,4,847.097907,47.060995,211.774477,66.583073,2,4
0,0,7,7,9,14,23,34,22,56,0.000333,0.08444,4,1013.277878,56.293215,253.31947,81.832294,2,4
0,0,8,8,11,14,25,39,24,63,0.000333,0.097521,5,1462.8147,81.267483,292.56294,91.356717,2,4
0,0,8,8,11,14,25,39,24,63,0.000333,0.097521,5,1462.8147,81.267483,292.56294,91.356717,2,4
0,0,7,7,9,11,20,30,19,49,0.000333,0.070591,4,847.097907,47.060995,211.774477,66.583073,2,4
0,0,7,7,9,14,23,34,22,56,0.000333,0.08444,4,1013.277878,56.293215,253.31947,81.832294,2,4
0,0,8,8,11,14,25,39,24,63,0.000333,0.097521,5,1462.8147,81.267483,292.56294,91.356717,2,4
0,0,8,8,11,14,25,39,24,63,0.000333,0.097521,5,1462.8147,81.267483,292.56294,91.356717,2,4
0,0,7,7,9,14,23,34,22,56,0.000333,0.08444,4,1013.277878,56.293215,253.31947,81.832294,2,4
0,0,7,7,9,11,20,30,19,49,0.000333,0.070591,4,847.097907,47.060995,211.774477,66.583073,2,4
0,0,9,9,12,19,31,48,32,80,0.000333,0.132112,6,2378.014229,132.111902,396.335705,123.730173,2,4
0,0,9,9,12,19,31,48,32,80,0.000333,0.132112,6,2378.014229,132.111902,396.335705,123.730173,2,4
0,0,7,7,9,14,23,34,22,56,0.000333,0.08444,4,1013.277878,56.293215,253.31947,81.832294,2,4
0,0,7,7,9,11,20,30,19,49,0.000333,0.070591,4,847.097907,47.060995,211.774477,66.583073,2,4
0,0,8,8,10,14,24,35,25,60,0.000333,0.091699,5,1375.48875,76.416042,275.09775,86.52225,2,4
0,0,11,11,13,22,35,54,38,92,0.000333,0.157298,6,2831.364225,157.298013,471.894038,146.213212,2,4
0,0,7,7,9,14,23,34,22,56,0.000333,0.08444,4,1013.277878,56.293215,253.31947,81.832294,2,4
0,0,7,7,9,11,20,30,19,49,0.000333,0.070591,4,847.097907,47.060995,211.774477,66.583073,2,4
0,0,8,8,9,16,25,34,29,63,0.000333,0.097521,4,1170.25176,65.013987,292.56294,92.529325,2,4
0,0,6,6,9,14,23,29,21,50,0.000333,0.075393,4,904.712391,50.2618,226.178098,81.832294,2,4
0,0,7,7,9,11,20,30,19,49,0.000333,0.070591,4,847.097907,47.060995,211.774477,66.583073,2,4
0,0,7,7,9,14,23,34,22,56,0.000333,0.08444,4,1013.277878,56.293215,253.31947,81.832294,2,4
0,0,8,8,9,12,21,33,23,56,0.000333,0.08199,4,983.879103,54.65995,245.969776,71.548875,2,4
0,0,11,11,12,21,33,52,38,90,0.000333,0.151332,6,2723.972824,151.331824,453.995471,135.258216,2,4
0,0,7,7,9,14,23,34,22,56,0.000333,0.08444,4,1013.277878,56.293215,253.31947,81.832294,2,4
0,0,7,7,9,11,20,30,19,49,0.000333,0.070591,4,847.097907,47.060995,211.774477,66.583073,2,4
0,0,7,7,10,11,21,34,21,55,0.000333,0.080526,5,1207.887291,67.10485,241.577458,71.273029,2,4
0,0,7,7,10,11,21,34,21,55,0.000333,0.080526,5,1207.887291,67.10485,241.577458,71.273029,2,4
0,0,7,7,9,11,20,30,19,49,0.000333,0.070591,4,847.097907,47.060995,211.774477,66.583073,2,4
0,0,7,7,9,14,23,34,22,56,0.000333,0.08444,4,1013.277878,56.293215,253.31947,81.832294,2,4
0,0,7,7,10,15,25,31,23,54,0.000333,0.083589,5,1253.841171,69.657843,250.768234,91.82264,2,4
0,0,7,7,10,15,25,31,23,54,0.000333,0.083589,5,1253.841171,69.657843,250.768234,91.82264,2,4
0,0,7,7,9,14,23,34,22,56,0.000333,0.08444,4,1013.277878,56.293215,253.31947,81.832294,2,4
0,0,7,7,9,11,20,30,19,49,0.000333,0.070591,4,847.097907,47.060995,211.774477,66.583073,2,4
0,0,8,8,10,14,24,35,25,60,0.000333,0.091699,5,1375.48875,76.416042,275.09775,86.52225,2,4
0,0,11,11,13,22,35,54,38,92,0.000333,0.157298,6,2831.364225,157.298013,471.894038,146.213212,2,4
0,0,7,7,9,11,20,30,19,49,0.000333,0.070591,4,847.097907,47.060995,211.774477,66.583073,2,4
0,0,7,7,9,14,23,34,22,56,0.000333,0.08444,4,1013.277878,56.293215,253.31947,81.832294,2,4
0,0,8,8,10,12,22,35,22,57,0.000333,0.084729,5,1270.938011,70.607667,254.187602,76.238831,2,4
0,0,11,11,13,20,33,54,36,90,0.000333,0.151332,6,2723.972824,151.331824,453.995471,134.544278,2,4
0,0,7,7,9,11,20,30,19,49,0.000333,0.070591,4,847.097907,47.060995,211.774477,66.583073,2,4
0,0,7,7,9,14,23,34,22,56,0.000333,0.08444,4,1013.277878,56.293215,253.31947,81.832294,2,4
0,0,6,6,10,13,23,30,20,50,0.000333,0.075393,5,1130.890489,62.827249,226.178098,81.324997,2,4
0,0,6,6,10,12,22,30,19,49,0.000333,0.072837,5,1092.560747,60.697819,218.512149,76.238831,2,4
0,0,7,7,9,11,20,30,19,49,0.000333,0.070591,4,847.097907,47.060995,211.774477,66.583073,2,4
0,0,7,7,9,14,23,34,22,56,0.000333,0.08444,4,1013.277878,56.293215,253.31947,81.832294,2,4
0,0,9,9,9,17,26,34,30,64,0.000333,0.100276,4,1203.312568,66.850698,300.828142,98.016193,2,4
0,0,12,12,12,24,36,53,42,95,0.000333,0.163714,6,2946.857251,163.714292,491.142875,153.05865,2,4
0,0,7,7,9,11,20,30,19,49,0.000333,0.070591,4,847.097907,47.060995,211.774477,66.583073,2,4
0,0,7,7,9,14,23,34,22,56,0.000333,0.08444,4,1013.277878,56.293215,253.31947,81.832294,2,4
0,0,6,6,9,15,24,29,22,51,0.000333,0.077944,4,935.33235,51.962908,233.833088,87.132684,2,4
0,0,6,6,9,14,23,29,21,50,0.000333,0.075393,4,904.712391,50.2618,226.178098,81.832294,2,4
0,0,7,7,9,14,23,34,22,56,0.000333,0.08444,4,1013.277878,56.293215,253.31947,81.832294,2,4
0,0,7,7,9,11,20,30,19,49,0.000333,0.070591,4,847.097907,47.060995,211.774477,66.583073,2,4
0,0,6,6,9,15,24,29,22,51,0.000333,0.077944,4,935.33235,51.962908,233.833088,87.132684,2,4
0,0,6,6,9,14,23,29,21,50,0.000333,0.075393,4,904.712391,50.2618,226.178098,81.832294,2,4
0,0,7,7,9,14,23,34,22,56,0.000333,0.08444,4,1013.277878,56.293215,253.31947,81.832294,2,4
0,0,7,7,9,11,20,30,19,49,0.000333,0.070591,4,847.097907,47.060995,211.774477,66.583073,2,4
0,0,6,6,9,15,24,29,22,51,0.000333,0.077944,4,935.33235,51.962908,233.833088,87.132684,2,4
0,0,6,6,9,14,23,29,21,50,0.000333,0.075393,4,904.712391,50.2618,226.178098,81.832294,2,4
0,0,7,7,9,14,23,34,22,56,0.000333,0.08444,4,1013.277878,56.293215,253.31947,81.832294,2,4
0,0,7,7,9,11,20,30,19,49,0.000333,0.070591,4,847.097907,47.060995,211.774477,66.583073,2,4
0,0,6,6,9,15,24,29,22,51,0.000333,0.077944,4,935.33235,51.962908,233.833088,87.132684,2,4
0,0,6,6,9,14,23,29,21,50,0.000333,0.075393,4,904.712391,50.2618,226.178098,81.832294,2,4
0,0,7,7,9,14,23,34,22,56,0.000333,0.08444,4,1013.277878,56.293215,253.31947,81.832294,2,4
0,0,7,7,9,11,20,30,19,49,0.000333,0.070591,4,847.097907,47.060995,211.774477,66.583073,2,4
0,0,6,6,9,12,21,31,20,51,0.000333,0.074669,4,896.032754,49.779597,224.008189,71.548875,2,4
0,0,6,6,9,13,22,31,21,52,0.000333,0.077297,4,927.561777,51.53121,231.890444,76.635041,2,4
0,0,7,7,9,14,23,34,22,56,0.000333,0.08444,4,1013.277878,56.293215,253.31947,81.832294,2,4
0,0,7,7,9,11,20,30,19,49,0.000333,0.070591,4,847.097907,47.060995,211.774477,66.583073,2,4
0,0,7,7,9,16,25,33,25,58,0.000333,0.089781,4,1077.374636,59.854146,269.343659,92.529325,2,4
0,0,7,7,9,15,24,33,24,57,0.000333,0.087114,4,1045.37145,58.076192,261.342863,87.132684,2,4
0,0,7,7,9,11,20,30,19,49,0.000333,0.070591,4,847.097907,47.060995,211.774477,66.583073,2,4
0,0,7,7,9,14,23,34,22,56,0.000333,0.08444,4,1013.277878,56.293215,253.31947,81.832294,2,4
0,0,8,8,9,17,26,41,29,70,0.000333,0.109677,4,1316.123121,73.117951,329.03078,98.016193,2,4
0,0,8,8,9,16,25,41,28,69,0.000333,0.106809,4,1281.704308,71.205795,320.426077,92.529325,2,4
0,0,7,7,9,14,23,34,22,56,0.000333,0.08444,4,1013.277878,56.293215,253.31947,81.832294,2,4
0,0,7,7,9,11,20,30,19,49,0.000333,0.070591,4,847.097907,47.060995,211.774477,66.583073,2,4
0,0,6,6,9,15,24,29,22,51,0.000333,0.077944,4,935.33235,51.962908,233.833088,87.132684,2,4
0,0,6,6,9,14,23,29,21,50,0.000333,0.075393,4,904.712391,50.2618,226.178098,81.832294,2,4
0,0,6,6,11,12,23,31,19,50,0.000333,0.075393,5,1130.890489,62.827249,226.178098,81.073298,2,4
0,0,6,6,11,12,23,31,19,50,0.000333,0.075393,5,1130.890489,62.827249,226.178098,81.073298,2,4
0,0,7,7,11,17,28,35,26,61,0.000333,0.09775,5,1466.243251,81.457958,293.24865,107.540616,2,4
0,0,7,7,11,16,27,35,25,60,0.000333,0.095098,5,1426.466251,79.248125,285.29325,102.053748,2,4
0,0,7,7,9,14,23,34,22,56,0.000333,0.08444,4,1013.277878,56.293215,253.31947,81.832294,2,4
0,0,7,7,9,11,20,30,19,49,0.000333,0.070591,4,847.097907,47.060995,211.774477,66.583073,2,4
0,0,7,7,10,18,28,32,28,60,0.000333,0.096147,5,1442.206477,80.122582,288.441295,108.277931,2,4
0,0,7,7,10,17,27,32,27,59,0.000333,0.093513,5,1402.691813,77.927323,280.538363,102.706149,2,4
0,0,7,7,9,11,20,30,19,49,0.000333,0.070591,4,847.097907,47.060995,211.774477,66.583073,2,4
0,0,7,7,9,14,23,34,22,56,0.000333,0.08444,4,1013.277878,56.293215,253.31947,81.832294,2,4
0,0,6,6,9,14,23,29,21,50,0.000333,0.075393,4,904.712391,50.2618,226.178098,81.832294,2,4
0,0,6,6,9,13,22,29,20,49,0.000333,0.072837,4,874.048597,48.558255,218.512149,76.635041,2,4
0,0,7,7,9,11,20,30,19,49,0.000333,0.070591,4,847.097907,47.060995,211.774477,66.583073,2,4
0,0,6,6,11,15,26,31,22,53,0.000333,0.083041,5,1245.616525,69.200918,249.123305,96.657107,2,4
0,0,7,7,9,11,20,30,19,49,0.000333,0.070591,4,847.097907,47.060995,211.774477,66.583073,2,4
0,0,6,6,10,15,25,30,22,52,0.000333,0.080494,5,1207.402609,67.077923,241.480522,91.82264,2,4
0,0,7,7,9,11,20,30,19,49,0.000333,0.070591,4,847.097907,47.060995,211.774477,66.583073,2,4
0,0,7,7,9,14,23,34,22,56,0.000333,0.08444,4,1013.277878,56.293215,253.31947,81.832294,2,4
0,0,9,9,12,17,29,47,30,77,0.000333,0.124688,6,2244.38722,124.688179,374.064537,112.506418,3,4
0,0,6,6,9,10,19,29,17,46,0.000333,0.065135,4,781.618662,43.423259,195.404666,61.748606,2,4
0,0,7,7,9,11,20,30,19,49,0.000333,0.070591,4,847.097907,47.060995,211.774477,66.583073,2,4
0,0,7,7,9,11,20,30,19,49,0.000333,0.070591,4,847.097907,47.060995,211.774477,66.583073,2,4
0,0,7,7,9,14,23,34,22,56,0.000333,0.08444,4,1013.277878,56.293215,253.31947,81.832294,2,4
0,0,9,9,12,17,29,47,30,77,0.000333,0.124688,6,2244.38722,124.688179,374.064537,112.506418,3,4
0,0,7,7,9,11,20,31,19,50,0.000333,0.072032,4,864.385619,48.021423,216.096405,66.583073,2,4
0,0,7,7,9,11,20,31,19,50,0.000333,0.072032,4,864.385619,48.021423,216.096405,66.583073,2,4
0,0,7,7,9,11,20,30,19,49,0.000333,0.070591,4,847.097907,47.060995,211.774477,66.583073,2,4
0,0,7,7,9,11,20,30,19,49,0.000333,0.070591,4,847.097907,47.060995,211.774477,66.583073,2,4
0,0,7,7,9,14,23,34,22,56,0.000333,0.08444,4,1013.277878,56.293215,253.31947,81.832294,2,4
0,0,9,9,12,17,29,47,30,77,0.000333,0.124688,6,2244.38722,124.688179,374.064537,112.506418,3,4
0,0,7,7,9,11,20,31,19,50,0.000333,0.072032,4,864.385619,48.021423,216.096405,66.583073,2,4
0,0,7,7,9,11,20,31,19,50,0.000333,0.072032,4,864.385619,48.021423,216.096405,66.583073,2,4
0,0,7,7,9,14,23,34,22,56,0.000333,0.08444,4,1013.277878,56.293215,253.31947,81.832294,2,4
0,0,7,7,9,11,20,30,19,49,0.000333,0.070591,4,847.097907,47.060995,211.774477,66.583073,2,4
0,0,7,7,9,11,20,30,19,49,0.000333,0.070591,4,847.097907,47.060995,211.774477,66.583073,2,4
0,0,9,9,12,17,29,47,30,77,0.000333,0.124688,6,2244.38722,124.688179,374.064537,112.506418,3,4
0,0,7,7,9,11,20,31,19,50,0.000333,0.072032,4,864.385619,48.021423,216.096405,66.583073,2,4
0,0,7,7,9,11,20,31,19,50,0.000333,0.072032,4,864.385619,48.021423,216.096405,66.583073,2,4
0,0,7,7,9,14,23,34,22,56,0.000333,0.08444,4,1013.277878,56.293215,253.31947,81.832294,2,4
0,0,7,7,9,11,20,30,19,49,0.000333,0.070591,4,847.097907,47.060995,211.774477,66.583073,2,4
0,0,7,7,9,11,20,30,19,49,0.000333,0.070591,4,847.097907,47.060995,211.774477,66.583073,2,4
0,0,9,9,12,17,29,47,30,77,0.000333,0.124688,6,2244.38722,124.688179,374.064537,112.506418,3,4
0,0,7,7,9,11,20,31,19,50,0.000333,0.072032,4,864.385619,48.021423,216.096405,66.583073,2,4
0,0,7,7,9,11,20,31,19,50,0.000333,0.072032,4,864.385619,48.021423,216.096405,66.583073,2,4
0,0,7,7,9,11,20,30,19,49,0.000333,0.070591,4,847.097907,47.060995,211.774477,66.583073,2,4
0,0,7,7,9,11,20,30,19,49,0.000333,0.070591,4,847.097907,47.060995,211.774477,66.583073,2,4
0,0,7,7,9,14,23,34,22,56,0.000333,0.08444,4,1013.277878,56.293215,253.31947,81.832294,2,4
0,0,7,7,9,11,20,31,19,50,0.000333,0.072032,4,864.385619,48.021423,216.096405,66.583073,2,4
0,0,9,9,12,17,29,47,30,77,0.000333,0.124688,6,2244.38722,124.688179,374.064537,112.506418,3,4
0,0,7,7,9,11,20,31,19,50,0.000333,0.072032,4,864.385619,48.021423,216.096405,66.583073,2,4
0,0,7,7,9,11,20,30,19,49,0.000333,0.070591,4,847.097907,47.060995,211.774477,66.583073,2,4
0,0,7,7,9,11,20,30,19,49,0.000333,0.070591,4,847.097907,47.060995,211.774477,66.583073,2,4
0,0,7,7,9,14,23,34,22,56,0.000333,0.08444,4,1013.277878,56.293215,253.31947,81.832294,2,4
0,0,7,7,9,11,20,31,19,50,0.000333,0.072032,4,864.385619,48.021423,216.096405,66.583073,2,4
0,0,9,9,12,17,29,47,30,77,0.000333,0.124688,6,2244.38722,124.688179,374.064537,112.506418,3,4
0,0,7,7,9,11,20,31,19,50,0.000333,0.072032,4,864.385619,48.021423,216.096405,66.583073,2,4
0,0,7,7,9,11,20,30,19,49,0.000333,0.070591,4,847.097907,47.060995,211.774477,66.583073,2,4
0,0,7,7,9,11,20,30,19,49,0.000333,0.070591,4,847.097907,47.060995,211.774477,66.583073,2,4
0,0,7,7,9,14,23,34,22,56,0.000333,0.08444,4,1013.277878,56.293215,253.31947,81.832294,2,4
0,0,7,7,9,11,20,31,19,50,0.000333,0.072032,4,864.385619,48.021423,216.096405,66.583073,2,4
0,0,9,9,12,17,29,47,30,77,0.000333,0.124688,6,2244.38722,124.688179,374.064537,112.506418,3,4
0,0,7,7,9,11,20,31,19,50,0.000333,0.072032,4,864.385619,48.021423,216.096405,66.583073,2,4
0,0,7,7,9,11,20,30,19,49,0.000333,0.070591,4,847.097907,47.060995,211.774477,66.583073,2,4
0,0,7,7,9,11,20,30,19,49,0.000333,0.070591,4,847.097907,47.060995,211.774477,66.583073,2,4
0,0,7,7,9,14,23,34,22,56,0.000333,0.08444,4,1013.277878,56.293215,253.31947,81.832294,2,4
0,0,9,9,12,17,29,47,30,77,0.000333,0.124688,6,2244.38722,124.688179,374.064537,112.506418,3,4
0,0,7,7,9,11,20,31,19,50,0.000333,0.072032,4,864.385619,48.021423,216.096405,66.583073,2,4
0,0,7,7,9,11,20,31,19,50,0.000333,0.072032,4,864.385619,48.021423,216.096405,66.583073,2,4
0,0,7,7,9,11,20,30,19,49,0.000333,0.070591,4,847.097907,47.060995,211.774477,66.583073,2,4
0,0,7,7,9,11,20,30,19,49,0.000333,0.070591,4,847.097907,47.060995,211.774477,66.583073,2,4
0,0,7,7,9,14,23,34,22,56,0.000333,0.08444,4,1013.277878,56.293215,253.31947,81.832294,2,4
0,0,9,9,12,17,29,47,30,77,0.000333,0.124688,6,2244.38722,124.688179,374.064537,112.506418,3,4
0,0,7,7,9,11,20,31,19,50,0.000333,0.072032,4,864.385619,48.021423,216.096405,66.583073,2,4
0,0,7,7,9,11,20,31,19,50,0.000333,0.072032,4,864.385619,48.021423,216.096405,66.583073,2,4
0,0,7,7,9,11,20,30,19,49,0.000333,0.070591,4,847.097907,47.060995,211.774477,66.583073,2,4
0,0,7,7,9,11,20,30,19,49,0.000333,0.070591,4,847.097907,47.060995,211.774477,66.583073,2,4
0,0,7,7,9,14,23,34,22,56,0.000333,0.08444,4,1013.277878,56.293215,253.31947,81.832294,2,4
0,0,9,9,12,17,29,47,30,77,0.000333,0.124688,6,2244.38722,124.688179,374.064537,112.506418,3,4
0,0,7,7,9,11,20,31,19,50,0.000333,0.072032,4,864.385619,48.021423,216.096405,66.583073,2,4
0,0,7,7,9,11,20,31,19,50,0.000333,0.072032,4,864.385619,48.021423,216.096405,66.583073,2,4
0,0,7,7,9,11,20,30,19,49,0.000333,0.070591,4,847.097907,47.060995,211.774477,66.583073,2,4
0,0,7,7,9,14,23,34,22,56,0.000333,0.08444,4,1013.277878,56.293215,253.31947,81.832294,2,4
0,0,7,7,9,11,20,30,19,49,0.000333,0.070591,4,847.097907,47.060995,211.774477,66.583073,2,4
0,0,7,7,9,10,19,31,19,50,0.000333,0.070799,4,849.585503,47.199195,212.396376,61.748606,2,4
0,0,7,7,9,10,19,31,19,50,0.000333,0.070799,4,849.585503,47.199195,212.396376,61.748606,2,4
0,0,10,10,12,18,30,49,32,81,0.000333,0.132486,6,2384.748829,132.486046,397.458138,118.0782,3,4
0,0,7,7,9,11,20,30,19,49,0.000333,0.070591,4,847.097907,47.060995,211.774477,66.583073,2,4
0,0,7,7,9,11,20,30,19,49,0.000333,0.070591,4,847.097907,47.060995,211.774477,66.583073,2,4
0,0,7,7,9,14,23,34,22,56,0.000333,0.08444,4,1013.277878,56.293215,253.31947,81.832294,2,4
0,0,9,9,12,17,29,47,30,77,0.000333,0.124688,6,2244.38722,124.688179,374.064537,112.506418,3,4
0,0,7,7,9,11,20,31,19,50,0.000333,0.072032,4,864.385619,48.021423,216.096405,66.583073,2,4
0,0,7,7,9,11,20,31,19,50,0.000333,0.072032,4,864.385619,48.021423,216.096405,66.583073,2,4
0,0,7,7,9,11,20,30,19,49,0.000333,0.070591,4,847.097907,47.060995,211.774477,66.583073,2,4
0,0,7,7,9,11,20,30,19,49,0.000333,0.070591,4,847.097907,47.060995,211.774477,66.583073,2,4
0,0,7,7,9,14,23,34,22,56,0.000333,0.08444,4,1013.277878,56.293215,253.31947,81.832294,2,4
0,0,9,9,12,17,29,47,30,77,0.000333,0.124688,6,2244.38722,124.688179,374.064537,112.506418,3,4
0,0,7,7,9,11,20,31,19,50,0.000333,0.072032,4,864.385619,48.021423,216.096405,66.583073,2,4
0,0,7,7,9,11,20,31,19,50,0.000333,0.072032,4,864.385619,48.021423,216.096405,66.583073,2,4
0,0,7,7,9,11,20,30,19,49,0.000333,0.070591,4,847.097907,47.060995,211.774477,66.583073,2,4
0,0,7,7,9,14,23,34,22,56,0.000333,0.08444,4,1013.277878,56.293215,253.31947,81.832294,2,4
0,0,7,7,9,11,20,30,19,49,0.000333,0.070591,4,847.097907,47.060995,211.774477,66.583073,2,4
0,0,7,7,9,11,20,31,19,50,0.000333,0.072032,4,864.385619,48.021423,216.096405,66.583073,2,4
0,0,7,7,9,11,20,31,19,50,0.000333,0.072032,4,864.385619,48.021423,216.096405,66.583073,2,4
0,0,9,9,12,17,29,47,30,77,0.000333,0.124688,6,2244.38722,124.688179,374.064537,112.506418,3,4
0,0,7,7,9,14,23,34,22,56,0.000333,0.08444,4,1013.277878,56.293215,253.31947,81.832294,2,4
0,0,7,7,9,11,20,30,19,49,0.000333,0.070591,4,847.097907,47.060995,211.774477,66.583073,2,4
0,0,9,9,12,17,29,47,30,77,0.000333,0.124688,6,2244.38722,124.688179,374.064537,112.506418,3,4
0,0,9,9,12,17,29,47,30,77,0.000333,0.124688,6,2244.38722,124.688179,374.064537,112.506418,3,4
0,0,7,7,9,14,23,34,22,56,0.000333,0.08444,4,1013.277878,56.293215,253.31947,81.832294,2,4
0,0,7,7,9,11,20,30,19,49,0.000333,0.070591,4,847.097907,47.060995,211.774477,66.583073,2,4
0,0,9,9,12,17,29,47,30,77,0.000333,0.124688,6,2244.38722,124.688179,374.064537,112.506418,3,4
0,0,9,9,12,17,29,47,30,77,0.000333,0.124688,6,2244.38722,124.688179,374.064537,112.506418,3,4
0,0,7,7,9,11,20,30,19,49,0.000333,0.070591,4,847.097907,47.060995,211.774477,66.583073,2,4
0,0,7,7,9,14,23,34,22,56,0.000333,0.08444,4,1013.277878,56.293215,253.31947,81.832294,2,4
0,0,9,9,12,17,29,47,30,77,0.000333,0.124688,6,2244.38722,124.688179,374.064537,112.506418,3,4
0,0,9,9,12,17,29,47,30,77,0.000333,0.124688,6,2244.38722,124.688179,374.064537,112.506418,3,4
0,0,7,7,9,11,20,30,19,49,0.000333,0.070591,4,847.097907,47.060995,211.774477,66.583073,2,4
0,0,7,7,9,14,23,34,22,56,0.000333,0.08444,4,1013.277878,56.293215,253.31947,81.832294,2,4
0,0,8,8,10,14,24,35,25,60,0.000333,0.091699,5,1375.48875,76.416042,275.09775,86.52225,2,4
0,0,11,11,13,20,33,53,36,89,0.000333,0.14965,6,2693.70646,149.650359,448.951077,134.544278,3,4
0,0,7,7,9,11,20,30,19,49,0.000333,0.070591,4,847.097907,47.060995,211.774477,66.583073,2,4
0,0,7,7,9,14,23,34,22,56,0.000333,0.08444,4,1013.277878,56.293215,253.31947,81.832294,2,4
0,0,8,8,9,16,25,34,29,63,0.000333,0.097521,4,1170.25176,65.013987,292.56294,92.529325,2,4
0,0,6,6,9,14,23,29,21,50,0.000333,0.075393,4,904.712391,50.2618,226.178098,81.832294,2,4
0,0,7,7,9,14,23,34,22,56,0.000333,0.08444,4,1013.277878,56.293215,253.31947,81.832294,2,4
0,0,7,7,9,11,20,30,19,49,0.000333,0.070591,4,847.097907,47.060995,211.774477,66.583073,2,4
0,0,11,11,12,19,31,51,36,87,0.000333,0.143672,6,2586.090474,143.671693,431.015079,123.730173,3,4
0,0,8,8,9,12,21,33,23,56,0.000333,0.08199,4,983.879103,54.65995,245.969776,71.548875,2,4
0,0,7,7,9,11,20,30,19,49,0.000333,0.070591,4,847.097907,47.060995,211.774477,66.583073,2,4
0,0,7,7,9,14,23,34,22,56,0.000333,0.08444,4,1013.277878,56.293215,253.31947,81.832294,2,4
0,0,7,7,10,11,21,34,21,55,0.000333,0.080526,5,1207.887291,67.10485,241.577458,71.273029,2,4
0,0,7,7,10,11,21,34,21,55,0.000333,0.080526,5,1207.887291,67.10485,241.577458,71.273029,2,4
0,0,7,7,9,11,20,30,19,49,0.000333,0.070591,4,847.097907,47.060995,211.774477,66.583073,2,4
0,0,7,7,9,14,23,34,22,56,0.000333,0.08444,4,1013.277878,56.293215,253.31947,81.832294,2,4
0,0,7,7,10,15,25,31,23,54,0.000333,0.083589,5,1253.841171,69.657843,250.768234,91.82264,2,4
0,0,7,7,10,15,25,31,23,54,0.000333,0.083589,5,1253.841171,69.657843,250.768234,91.82264,2,4
0,0,7,7,9,11,20,30,19,49,0.000333,0.070591,4,847.097907,47.060995,211.774477,66.583073,2,4
0,0,7,7,9,14,23,34,22,56,0.000333,0.08444,4,1013.277878,56.293215,253.31947,81.832294,2,4
0,0,8,8,10,14,24,35,25,60,0.000333,0.091699,5,1375.48875,76.416042,275.09775,86.52225,2,4
0,0,11,11,13,20,33,53,36,89,0.000333,0.14965,6,2693.70646,149.650359,448.951077,134.544278,3,4
0,0,7,7,9,14,23,34,22,56,0.000333,0.08444,4,1013.277878,56.293215,253.31947,81.832294,2,4
0,0,7,7,9,11,20,30,19,49,0.000333,0.070591,4,847.097907,47.060995,211.774477,66.583073,2,4
0,0,19,19,14,19,33,91,59,150,0.000333,0.25222,21,15889.84148,882.768971,756.659118,134.013592,4,4
0,0,8,8,10,12,22,35,22,57,0.000333,0.084729,5,1270.938011,70.607667,254.187602,76.238831,2,4
0,0,7,7,9,11,20,30,19,49,0.000333,0.070591,4,847.097907,47.060995,211.774477,66.583073,2,4
0,0,7,7,9,14,23,34,22,56,0.000333,0.08444,4,1013.277878,56.293215,253.31947,81.832294,2,4
0,0,6,6,10,13,23,30,20,50,0.000333,0.075393,5,1130.890489,62.827249,226.178098,81.324997,2,4
0,0,6,6,10,12,22,30,19,49,0.000333,0.072837,5,1092.560747,60.697819,218.512149,76.238831,2,4
0,0,7,7,9,11,20,30,19,49,0.000333,0.070591,4,847.097907,47.060995,211.774477,66.583073,2,4
0,0,7,7,9,14,23,34,22,56,0.000333,0.08444,4,1013.277878,56.293215,253.31947,81.832294,2,4
0,0,12,12,12,22,34,52,40,92,0.000333,0.156016,6,2808.279488,156.015527,468.046581,141.127046,3,4
0,0,9,9,9,17,26,34,30,64,0.000333,0.100276,4,1203.312568,66.850698,300.828142,98.016193,2,4
0,0,7,7,9,14,23,34,22,56,0.000333,0.08444,4,1013.277878,56.293215,253.31947,81.832294,2,4
0,0,7,7,9,11,20,30,19,49,0.000333,0.070591,4,847.097907,47.060995,211.774477,66.583073,2,4
0,0,6,6,9,15,24,29,22,51,0.000333,0.077944,4,935.33235,51.962908,233.833088,87.132684,2,4
0,0,6,6,9,14,23,29,21,50,0.000333,0.075393,4,904.712391,50.2618,226.178098,81.832294,2,4
0,0,7,7,9,14,23,34,22,56,0.000333,0.08444,4,1013.277878,56.293215,253.31947,81.832294,2,4
0,0,7,7,9,11,20,30,19,49,0.000333,0.070591,4,847.097907,47.060995,211.774477,66.583073,2,4
0,0,6,6,9,15,24,29,22,51,0.000333,0.077944,4,935.33235,51.962908,233.833088,87.132684,2,4
0,0,6,6,9,14,23,29,21,50,0.000333,0.075393,4,904.712391,50.2618,226.178098,81.832294,2,4
0,0,7,7,9,14,23,34,22,56,0.000333,0.08444,4,1013.277878,56.293215,253.31947,81.832294,2,4
0,0,7,7,9,11,20,30,19,49,0.000333,0.070591,4,847.097907,47.060995,211.774477,66.583073,2,4
0,0,6,6,9,15,24,29,22,51,0.000333,0.077944,4,935.33235,51.962908,233.833088,87.132684,2,4
0,0,6,6,9,14,23,29,21,50,0.000333,0.075393,4,904.712391,50.2618,226.178098,81.832294,2,4
0,0,7,7,9,14,23,34,22,56,0.000333,0.08444,4,1013.277878,56.293215,253.31947,81.832294,2,4
0,0,7,7,9,11,20,30,19,49,0.000333,0.070591,4,847.097907,47.060995,211.774477,66.583073,2,4
0,0,6,6,9,15,24,29,22,51,0.000333,0.077944,4,935.33235,51.962908,233.833088,87.132684,2,4
0,0,6,6,9,14,23,29,21,50,0.000333,0.075393,4,904.712391,50.2618,226.178098,81.832294,2,4
0,0,7,7,9,14,23,34,22,56,0.000333,0.08444,4,1013.277878,56.293215,253.31947,81.832294,2,4
0,0,7,7,9,11,20,30,19,49,0.000333,0.070591,4,847.097907,47.060995,211.774477,66.583073,2,4
0,0,6,6,9,13,22,31,21,52,0.000333,0.077297,4,927.561777,51.53121,231.890444,76.635041,2,4
0,0,6,6,9,12,21,31,20,51,0.000333,0.074669,4,896.032754,49.779597,224.008189,71.548875,2,4
0,0,7,7,9,14,23,34,22,56,0.000333,0.08444,4,1013.277878,56.293215,253.31947,81.832294,2,4
0,0,7,7,9,11,20,30,19,49,0.000333,0.070591,4,847.097907,47.060995,211.774477,66.583073,2,4
0,0,7,7,9,15,24,33,24,57,0.000333,0.087114,4,1045.37145,58.076192,261.342863,87.132684,2,4
0,0,7,7,9,16,25,33,25,58,0.000333,0.089781,4,1077.374636,59.854146,269.343659,92.529325,2,4
0,0,7,7,9,14,23,34,22,56,0.000333,0.08444,4,1013.277878,56.293215,253.31947,81.832294,2,4
0,0,7,7,9,11,20,30,19,49,0.000333,0.070591,4,847.097907,47.060995,211.774477,66.583073,2,4
0,0,8,8,9,16,25,41,28,69,0.000333,0.106809,4,1281.704308,71.205795,320.426077,92.529325,2,4
0,0,8,8,9,17,26,41,29,70,0.000333,0.109677,4,1316.123121,73.117951,329.03078,98.016193,2,4
0,0,7,7,9,14,23,34,22,56,0.000333,0.08444,4,1013.277878,56.293215,253.31947,81.832294,2,4
0,0,7,7,9,11,20,30,19,49,0.000333,0.070591,4,847.097907,47.060995,211.774477,66.583073,2,4
0,0,6,6,9,15,24,29,22,51,0.000333,0.077944,4,935.33235,51.962908,233.833088,87.132684,2,4
0,0,6,6,9,14,23,29,21,50,0.000333,0.075393,4,904.712391,50.2618,226.178098,81.832294,2,4
0,0,7,7,9,14,23,34,22,56,0.000333,0.08444,4,1013.277878,56.293215,253.31947,81.832294,2,4
0,0,7,7,9,11,20,30,19,49,0.000333,0.070591,4,847.097907,47.060995,211.774477,66.583073,2,4
0,0,7,7,11,16,27,35,25,60,0.000333,0.095098,5,1426.466251,79.248125,285.29325,102.053748,2,4
0,0,7,7,11,17,28,35,26,61,0.000333,0.09775,5,1466.243251,81.457958,293.24865,107.540616,2,4
0,0,7,7,9,14,23,34,22,56,0.000333,0.08444,4,1013.277878,56.293215,253.31947,81.832294,2,4
0,0,7,7,9,11,20,30,19,49,0.000333,0.070591,4,847.097907,47.060995,211.774477,66.583073,2,4
0,0,7,7,10,17,27,32,27,59,0.000333,0.093513,5,1402.691813,77.927323,280.538363,102.706149,2,4
0,0,7,7,10,18,28,32,28,60,0.000333,0.096147,5,1442.206477,80.122582,288.441295,108.277931,2,4
0,0,7,7,9,14,23,34,22,56,0.000333,0.08444,4,1013.277878,56.293215,253.31947,81.832294,2,4
0,0,7,7,9,11,20,30,19,49,0.000333,0.070591,4,847.097907,47.060995,211.774477,66.583073,2,4
0,0,6,6,9,13,22,29,20,49,0.000333,0.072837,4,874.048597,48.558255,218.512149,76.635041,2,4
0,0,6,6,9,14,23,29,21,50,0.000333,0.075393,4,904.712391,50.2618,226.178098,81.832294,2,4
0,0,7,7,9,11,20,30,19,49,0.000333,0.070591,4,847.097907,47.060995,211.774477,66.583073,2,4
0,0,6,6,11,15,26,31,22,53,0.000333,0.083041,5,1245.616525,69.200918,249.123305,96.657107,2,4
0,0,7,7,9,11,20,30,19,49,0.000333,0.070591,4,847.097907,47.060995,211.774477,66.583073,2,4
0,0,6,6,10,15,25,30,22,52,0.000333,0.080494,5,1207.402609,67.077923,241.480522,91.82264,2,4
0,0,7,7,9,14,23,34,22,56,0.000333,0.08444,4,1013.277878,56.293215,253.31947,81.832294,2,4
0,0,7,7,9,11,20,30,19,49,0.000333,0.070591,4,847.097907,47.060995,211.774477,66.583073,2,4
0,0,7,7,11,12,23,36,20,56,0.000333,0.08444,5,1266.597348,70.366519,253.31947,81.073298,2,4
0,0,6,6,9,10,19,29,17,46,0.000333,0.065135,4,781.618662,43.423259,195.404666,61.748606,2,4
0,0,7,7,9,11,20,30,19,49,0.000333,0.070591,4,847.097907,47.060995,211.774477,66.583073,2,4
0,0,7,7,9,11,20,30,19,49,0.000333,0.070591,4,847.097907,47.060995,211.774477,66.583073,2,4
0,0,7,7,9,14,23,34,22,56,0.000333,0.08444,4,1013.277878,56.293215,253.31947,81.832294,2,4
0,0,7,7,9,11,20,31,19,50,0.000333,0.072032,4,864.385619,48.021423,216.096405,66.583073,2,4
0,0,7,7,11,12,23,36,20,56,0.000333,0.08444,5,1266.597348,70.366519,253.31947,81.073298,2,4
0,0,7,7,9,11,20,31,19,50,0.000333,0.072032,4,864.385619,48.021423,216.096405,66.583073,2,4
0,0,7,7,9,11,20,30,19,49,0.000333,0.070591,4,847.097907,47.060995,211.774477,66.583073,2,4
0,0,7,7,9,11,20,30,19,49,0.000333,0.070591,4,847.097907,47.060995,211.774477,66.583073,2,4
0,0,7,7,9,14,23,34,22,56,0.000333,0.08444,4,1013.277878,56.293215,253.31947,81.832294,2,4
0,0,7,7,9,11,20,31,19,50,0.000333,0.072032,4,864.385619,48.021423,216.096405,66.583073,2,4
0,0,7,7,11,12,23,36,20,56,0.000333,0.08444,5,1266.597348,70.366519,253.31947,81.073298,2,4
0,0,7,7,9,11,20,31,19,50,0.000333,0.072032,4,864.385619,48.021423,216.096405,66.583073,2,4
0,0,7,7,9,14,23,34,22,56,0.000333,0.08444,4,1013.277878,56.293215,253.31947,81.832294,2,4
0,0,7,7,9,11,20,30,19,49,0.000333,0.070591,4,847.097907,47.060995,211.774477,66.583073,2,4
0,0,7,7,9,11,20,30,19,49,0.000333,0.070591,4,847.097907,47.060995,211.774477,66.583073,2,4
0,0,7,7,11,12,23,36,20,56,0.000333,0.08444,5,1266.597348,70.366519,253.31947,81.073298,2,4
0,0,7,7,9,11,20,31,19,50,0.000333,0.072032,4,864.385619,48.021423,216.096405,66.583073,2,4
0,0,7,7,9,11,20,31,19,50,0.000333,0.072032,4,864.385619,48.021423,216.096405,66.583073,2,4
0,0,7,7,9,14,23,34,22,56,0.000333,0.08444,4,1013.277878,56.293215,253.31947,81.832294,2,4
0,0,7,7,9,11,20,30,19,49,0.000333,0.070591,4,847.097907,47.060995,211.774477,66.583073,2,4
0,0,7,7,9,11,20,30,19,49,0.000333,0.070591,4,847.097907,47.060995,211.774477,66.583073,2,4
0,0,7,7,11,12,23,36,20,56,0.000333,0.08444,5,1266.597348,70.366519,253.31947,81.073298,2,4
0,0,7,7,9,11,20,31,19,50,0.000333,0.072032,4,864.385619,48.021423,216.096405,66.583073,2,4
0,0,7,7,9,11,20,31,19,50,0.000333,0.072032,4,864.385619,48.021423,216.096405,66.583073,2,4
0,0,7,7,9,11,20,30,19,49,0.000333,0.070591,4,847.097907,47.060995,211.774477,66.583073,2,4
0,0,7,7,9,11,20,30,19,49,0.000333,0.070591,4,847.097907,47.060995,211.774477,66.583073,2,4
0,0,7,7,9,14,23,34,22,56,0.000333,0.08444,4,1013.277878,56.293215,253.31947,81.832294,2,4
0,0,7,7,9,11,20,31,19,50,0.000333,0.072032,4,864.385619,48.021423,216.096405,66.583073,2,4
0,0,7,7,11,12,23,36,20,56,0.000333,0.08444,5,1266.597348,70.366519,253.31947,81.073298,2,4
0,0,7,7,9,11,20,31,19,50,0.000333,0.072032,4,864.385619,48.021423,216.096405,66.583073,2,4
0,0,7,7,9,11,20,30,19,49,0.000333,0.070591,4,847.097907,47.060995,211.774477,66.583073,2,4
0,0,7,7,9,11,20,30,19,49,0.000333,0.070591,4,847.097907,47.060995,211.774477,66.583073,2,4
0,0,7,7,9,14,23,34,22,56,0.000333,0.08444,4,1013.277878,56.293215,253.31947,81.832294,2,4
0,0,7,7,9,11,20,31,19,50,0.000333,0.072032,4,864.385619,48.021423,216.096405,66.583073,2,4
0,0,7,7,11,12,23,36,20,56,0.000333,0.08444,5,1266.597348,70.366519,253.31947,81.073298,2,4
0,0,7,7,9,11,20,31,19,50,0.000333,0.072032,4,864.385619,48.021423,216.096405,66.583073,2,4
0,0,7,7,9,11,20,30,19,49,0.000333,0.070591,4,847.097907,47.060995,211.774477,66.583073,2,4
0,0,7,7,9,11,20,30,19,49,0.000333,0.070591,4,847.097907,47.060995,211.774477,66.583073,2,4
0,0,7,7,9,14,23,34,22,56,0.000333,0.08444,4,1013.277878,56.293215,253.31947,81.832294,2,4
0,0,7,7,9,11,20,31,19,50,0.000333,0.072032,4,864.385619,48.021423,216.096405,66.583073,2,4
0,0,7,7,11,12,23,36,20,56,0.000333,0.08444,5,1266.597348,70.366519,253.31947,81.073298,2,4
0,0,7,7,9,11,20,31,19,50,0.000333,0.072032,4,864.385619,48.021423,216.096405,66.583073,2,4
0,0,7,7,9,11,20,30,19,49,0.000333,0.070591,4,847.097907,47.060995,211.774477,66.583073,2,4
0,0,7,7,9,11,20,30,19,49,0.000333,0.070591,4,847.097907,47.060995,211.774477,66.583073,2,4
0,0,7,7,9,14,23,34,22,56,0.000333,0.08444,4,1013.277878,56.293215,253.31947,81.832294,2,4
0,0,7,7,9,11,20,31,19,50,0.000333,0.072032,4,864.385619,48.021423,216.096405,66.583073,2,4
0,0,7,7,11,12,23,36,20,56,0.000333,0.08444,5,1266.597348,70.366519,253.31947,81.073298,2,4
0,0,7,7,9,11,20,31,19,50,0.000333,0.072032,4,864.385619,48.021423,216.096405,66.583073,2,4
0,0,7,7,9,11,20,30,19,49,0.000333,0.070591,4,847.097907,47.060995,211.774477,66.583073,2,4
0,0,7,7,9,11,20,30,19,49,0.000333,0.070591,4,847.097907,47.060995,211.774477,66.583073,2,4
0,0,7,7,9,14,23,34,22,56,0.000333,0.08444,4,1013.277878,56.293215,253.31947,81.832294,2,4
0,0,7,7,9,11,20,31,19,50,0.000333,0.072032,4,864.385619,48.021423,216.096405,66.583073,2,4
0,0,7,7,11,12,23,36,20,56,0.000333,0.08444,5,1266.597348,70.366519,253.31947,81.073298,2,4
0,0,7,7,9,11,20,31,19,50,0.000333,0.072032,4,864.385619,48.021423,216.096405,66.583073,2,4
0,0,7,7,9,11,20,30,19,49,0.000333,0.070591,4,847.097907,47.060995,211.774477,66.583073,2,4
0,0,7,7,9,11,20,30,19,49,0.000333,0.070591,4,847.097907,47.060995,211.774477,66.583073,2,4
0,0,7,7,9,14,23,34,22,56,0.000333,0.08444,4,1013.277878,56.293215,253.31947,81.832294,2,4
0,0,7,7,9,11,20,31,19,50,0.000333,0.072032,4,864.385619,48.021423,216.096405,66.583073,2,4
0,0,7,7,11,12,23,36,20,56,0.000333,0.08444,5,1266.597348,70.366519,253.31947,81.073298,2,4
0,0,7,7,9,11,20,31,19,50,0.000333,0.072032,4,864.385619,48.021423,216.096405,66.583073,2,4
0,0,7,7,9,11,20,30,19,49,0.000333,0.070591,4,847.097907,47.060995,211.774477,66.583073,2,4
0,0,7,7,9,14,23,34,22,56,0.000333,0.08444,4,1013.277878,56.293215,253.31947,81.832294,2,4
0,0,7,7,9,11,20,30,19,49,0.000333,0.070591,4,847.097907,47.060995,211.774477,66.583073,2,4
0,0,8,8,11,13,24,38,22,60,0.000333,0.091699,5,1375.48875,76.416042,275.09775,86.159464,2,4
0,0,7,7,9,10,19,31,19,50,0.000333,0.070799,4,849.585503,47.199195,212.396376,61.748606,2,4
0,0,7,7,9,10,19,31,19,50,0.000333,0.070799,4,849.585503,47.199195,212.396376,61.748606,2,4
0,0,7,7,9,11,20,30,19,49,0.000333,0.070591,4,847.097907,47.060995,211.774477,66.583073,2,4
0,0,7,7,9,11,20,30,19,49,0.000333,0.070591,4,847.097907,47.060995,211.774477,66.583073,2,4
0,0,7,7,9,14,23,34,22,56,0.000333,0.08444,4,1013.277878,56.293215,253.31947,81.832294,2,4
0,0,7,7,9,11,20,31,19,50,0.000333,0.072032,4,864.385619,48.021423,216.096405,66.583073,2,4
0,0,7,7,11,12,23,36,20,56,0.000333,0.08444,5,1266.597348,70.366519,253.31947,81.073298,2,4
0,0,7,7,9,11,20,31,19,50,0.000333,0.072032,4,864.385619,48.021423,216.096405,66.583073,2,4
0,0,7,7,9,11,20,30,19,49,0.000333,0.070591,4,847.097907,47.060995,211.774477,66.583073,2,4
0,0,7,7,9,11,20,30,19,49,0.000333,0.070591,4,847.097907,47.060995,211.774477,66.583073,2,4
0,0,7,7,9,14,23,34,22,56,0.000333,0.08444,4,1013.277878,56.293215,253.31947,81.832294,2,4
0,0,7,7,9,11,20,31,19,50,0.000333,0.072032,4,864.385619,48.021423,216.096405,66.583073,2,4
0,0,7,7,11,12,23,36,20,56,0.000333,0.08444,5,1266.597348,70.366519,253.31947,81.073298,2,4
0,0,7,7,9,11,20,31,19,50,0.000333,0.072032,4,864.385619,48.021423,216.096405,66.583073,2,4
0,0,7,7,9,11,20,30,19,49,0.000333,0.070591,4,847.097907,47.060995,211.774477,66.583073,2,4
0,0,7,7,9,14,23,34,22,56,0.000333,0.08444,4,1013.277878,56.293215,253.31947,81.832294,2,4
0,0,7,7,9,11,20,30,19,49,0.000333,0.070591,4,847.097907,47.060995,211.774477,66.583073,2,4
0,0,7,7,9,11,20,31,19,50,0.000333,0.072032,4,864.385619,48.021423,216.096405,66.583073,2,4
0,0,7,7,9,11,20,31,19,50,0.000333,0.072032,4,864.385619,48.021423,216.096405,66.583073,2,4
0,0,7,7,11,12,23,36,20,56,0.000333,0.08444,5,1266.597348,70.366519,253.31947,81.073298,2,4
0,0,7,7,9,11,20,30,19,49,0.000333,0.070591,4,847.097907,47.060995,211.774477,66.583073,2,4
0,0,7,7,9,14,23,34,22,56,0.000333,0.08444,4,1013.277878,56.293215,253.31947,81.832294,2,4
0,0,7,7,11,12,23,36,20,56,0.000333,0.08444,5,1266.597348,70.366519,253.31947,81.073298,2,4
0,0,7,7,11,12,23,36,20,56,0.000333,0.08444,5,1266.597348,70.366519,253.31947,81.073298,2,4
0,0,7,7,9,14,23,34,22,56,0.000333,0.08444,4,1013.277878,56.293215,253.31947,81.832294,2,4
0,0,7,7,9,11,20,30,19,49,0.000333,0.070591,4,847.097907,47.060995,211.774477,66.583073,2,4
0,0,7,7,11,12,23,36,20,56,0.000333,0.08444,5,1266.597348,70.366519,253.31947,81.073298,2,4
0,0,7,7,11,12,23,36,20,56,0.000333,0.08444,5,1266.597348,70.366519,253.31947,81.073298,2,4
0,0,7,7,9,11,20,30,19,49,0.000333,0.070591,4,847.097907,47.060995,211.774477,66.583073,2,4
0,0,7,7,9,14,23,34,22,56,0.000333,0.08444,4,1013.277878,56.293215,253.31947,81.832294,2,4
0,0,7,7,11,12,23,36,20,56,0.000333,0.08444,5,1266.597348,70.366519,253.31947,81.073298,2,4
0,0,7,7,11,12,23,36,20,56,0.000333,0.08444,5,1266.597348,70.366519,253.31947,81.073298,2,4
0,0,7,7,9,14,23,34,22,56,0.000333,0.08444,4,1013.277878,56.293215,253.31947,81.832294,2,4
0,0,7,7,9,11,20,30,19,49,0.000333,0.070591,4,847.097907,47.060995,211.774477,66.583073,2,4
0,0,9,9,12,15,27,42,26,68,0.000333,0.107777,6,1939.994101,107.77745,323.33235,101.622909,2,4
0,0,8,8,10,14,24,35,25,60,0.000333,0.091699,5,1375.48875,76.416042,275.09775,86.52225,2,4
0,0,7,7,9,14,23,34,22,56,0.000333,0.08444,4,1013.277878,56.293215,253.31947,81.832294,2,4
0,0,7,7,9,11,20,30,19,49,0.000333,0.070591,4,847.097907,47.060995,211.774477,66.583073,2,4
0,0,8,8,9,16,25,34,29,63,0.000333,0.097521,4,1170.25176,65.013987,292.56294,92.529325,2,4
0,0,6,6,9,14,23,29,21,50,0.000333,0.075393,4,904.712391,50.2618,226.178098,81.832294,2,4
0,0,7,7,9,14,23,34,22,56,0.000333,0.08444,4,1013.277878,56.293215,253.31947,81.832294,2,4
0,0,7,7,9,11,20,30,19,49,0.000333,0.070591,4,847.097907,47.060995,211.774477,66.583073,2,4
0,0,9,9,11,14,25,40,26,66,0.000333,0.102165,5,1532.472543,85.137363,306.494509,91.356717,2,4
0,0,8,8,9,12,21,33,23,56,0.000333,0.08199,4,983.879103,54.65995,245.969776,71.548875,2,4
0,0,7,7,9,14,23,34,22,56,0.000333,0.08444,4,1013.277878,56.293215,253.31947,81.832294,2,4
0,0,7,7,9,11,20,30,19,49,0.000333,0.070591,4,847.097907,47.060995,211.774477,66.583073,2,4
0,0,7,7,10,11,21,34,21,55,0.000333,0.080526,5,1207.887291,67.10485,241.577458,71.273029,2,4
0,0,7,7,10,11,21,34,21,55,0.000333,0.080526,5,1207.887291,67.10485,241.577458,71.273029,2,4
0,0,7,7,9,11,20,30,19,49,0.000333,0.070591,4,847.097907,47.060995,211.774477,66.583073,2,4
0,0,7,7,9,14,23,34,22,56,0.000333,0.08444,4,1013.277878,56.293215,253.31947,81.832294,2,4
0,0,7,7,10,15,25,31,23,54,0.000333,0.083589,5,1253.841171,69.657843,250.768234,91.82264,2,4
0,0,7,7,10,15,25,31,23,54,0.000333,0.083589,5,1253.841171,69.657843,250.768234,91.82264,2,4
0,0,7,7,9,11,20,30,19,49,0.000333,0.070591,4,847.097907,47.060995,211.774477,66.583073,2,4
0,0,7,7,9,14,23,34,22,56,0.000333,0.08444,4,1013.277878,56.293215,253.31947,81.832294,2,4
0,0,9,9,12,15,27,42,26,68,0.000333,0.107777,6,1939.994101,107.77745,323.33235,101.622909,2,4
0,0,8,8,10,14,24,35,25,60,0.000333,0.091699,5,1375.48875,76.416042,275.09775,86.52225,2,4
0,0,7,7,9,11,20,30,19,49,0.000333,0.070591,4,847.097907,47.060995,211.774477,66.583073,2,4
0,0,7,7,9,14,23,34,22,56,0.000333,0.08444,4,1013.277878,56.293215,253.31947,81.832294,2,4
0,0,16,16,13,14,27,72,44,116,0.000333,0.183856,18,9928.205105,551.56695,551.56695,101.408685,2,4
0,0,8,8,10,12,22,35,22,57,0.000333,0.084729,5,1270.938011,70.607667,254.187602,76.238831,2,4
0,0,7,7,9,14,23,34,22,56,0.000333,0.08444,4,1013.277878,56.293215,253.31947,81.832294,2,4
0,0,7,7,9,11,20,30,19,49,0.000333,0.070591,4,847.097907,47.060995,211.774477,66.583073,2,4
0,0,6,6,10,12,22,30,19,49,0.000333,0.072837,5,1092.560747,60.697819,218.512149,76.238831,2,4
0,0,6,6,10,13,23,30,20,50,0.000333,0.075393,5,1130.890489,62.827249,226.178098,81.324997,2,4
0,0,7,7,9,14,23,34,22,56,0.000333,0.08444,4,1013.277878,56.293215,253.31947,81.832294,2,4
0,0,7,7,9,11,20,30,19,49,0.000333,0.070591,4,847.097907,47.060995,211.774477,66.583073,2,4
0,0,10,10,11,17,28,41,30,71,0.000333,0.113774,5,1706.610997,94.811722,341.322199,107.540616,2,4
0,0,9,9,9,17,26,34,30,64,0.000333,0.100276,4,1203.312568,66.850698,300.828142,98.016193,2,4
0,0,7,7,9,11,20,30,19,49,0.000333,0.070591,4,847.097907,47.060995,211.774477,66.583073,2,4
0,0,7,7,9,14,23,34,22,56,0.000333,0.08444,4,1013.277878,56.293215,253.31947,81.832294,2,4
0,0,6,6,9,15,24,29,22,51,0.000333,0.077944,4,935.33235,51.962908,233.833088,87.132684,2,4
0,0,6,6,9,14,23,29,21,50,0.000333,0.075393,4,904.712391,50.2618,226.178098,81.832294,2,4
0,0,7,7,9,14,23,34,22,56,0.000333,0.08444,4,1013.277878,56.293215,253.31947,81.832294,2,4
0,0,7,7,9,11,20,30,19,49,0.000333,0.070591,4,847.097907,47.060995,211.774477,66.583073,2,4
0,0,6,6,9,15,24,29,22,51,0.000333,0.077944,4,935.33235,51.962908,233.833088,87.132684,2,4
0,0,6,6,9,14,23,29,21,50,0.000333,0.075393,4,904.712391,50.2618,226.178098,81.832294,2,4
0,0,7,7,9,14,23,34,22,56,0.000333,0.08444,4,1013.277878,56.293215,253.31947,81.832294,2,4
0,0,7,7,9,11,20,30,19,49,0.000333,0.070591,4,847.097907,47.060995,211.774477,66.583073,2,4
0,0,6,6,9,14,23,29,21,50,0.000333,0.075393,4,904.712391,50.2618,226.178098,81.832294,2,4
0,0,6,6,9,15,24,29,22,51,0.000333,0.077944,4,935.33235,51.962908,233.833088,87.132684,2,4
0,0,7,7,9,14,23,34,22,56,0.000333,0.08444,4,1013.277878,56.293215,253.31947,81.832294,2,4
0,0,7,7,9,11,20,30,19,49,0.000333,0.070591,4,847.097907,47.060995,211.774477,66.583073,2,4
0,0,6,6,9,15,24,29,22,51,0.000333,0.077944,4,935.33235,51.962908,233.833088,87.132684,2,4
0,0,6,6,9,14,23,29,21,50,0.000333,0.075393,4,904.712391,50.2618,226.178098,81.832294,2,4
0,0,7,7,9,11,20,30,19,49,0.000333,0.070591,4,847.097907,47.060995,211.774477,66.583073,2,4
0,0,7,7,9,14,23,34,22,56,0.000333,0.08444,4,1013.277878,56.293215,253.31947,81.832294,2,4
0,0,6,6,9,13,22,31,21,52,0.000333,0.077297,4,927.561777,51.53121,231.890444,76.635041,2,4
0,0,6,6,9,12,21,31,20,51,0.000333,0.074669,4,896.032754,49.779597,224.008189,71.548875,2,4
0,0,7,7,9,14,23,34,22,56,0.000333,0.08444,4,1013.277878,56.293215,253.31947,81.832294,2,4
0,0,7,7,9,11,20,30,19,49,0.000333,0.070591,4,847.097907,47.060995,211.774477,66.583073,2,4
0,0,7,7,9,16,25,33,25,58,0.000333,0.089781,4,1077.374636,59.854146,269.343659,92.529325,2,4
0,0,7,7,9,15,24,33,24,57,0.000333,0.087114,4,1045.37145,58.076192,261.342863,87.132684,2,4
0,0,7,7,9,11,20,30,19,49,0.000333,0.070591,4,847.097907,47.060995,211.774477,66.583073,2,4
0,0,7,7,9,14,23,34,22,56,0.000333,0.08444,4,1013.277878,56.293215,253.31947,81.832294,2,4
0,0,8,8,9,17,26,41,29,70,0.000333,0.109677,4,1316.123121,73.117951,329.03078,98.016193,2,4
0,0,8,8,9,16,25,41,28,69,0.000333,0.106809,4,1281.704308,71.205795,320.426077,92.529325,2,4
0,0,7,7,9,14,23,34,22,56,0.000333,0.08444,4,1013.277878,56.293215,253.31947,81.832294,2,4
0,0,7,7,9,11,20,30,19,49,0.000333,0.070591,4,847.097907,47.060995,211.774477,66.583073,2,4
0,0,6,6,9,15,24,29,22,51,0.000333,0.077944,4,935.33235,51.962908,233.833088,87.132684,2,4
0,0,6,6,9,14,23,29,21,50,0.000333,0.075393,4,904.712391,50.2618,226.178098,81.832294,2,4
0,0,7,7,9,14,23,34,22,56,0.000333,0.08444,4,1013.277878,56.293215,253.31947,81.832294,2,4
0,0,6,6,11,12,23,31,19,50,0.000333,0.075393,5,1130.890489,62.827249,226.178098,81.073298,2,4
0,0,7,7,11,17,28,35,26,61,0.000333,0.09775,5,1466.243251,81.457958,293.24865,107.540616,2,4
0,0,7,7,11,16,27,35,25,60,0.000333,0.095098,5,1426.466251,79.248125,285.29325,102.053748,2,4
0,0,7,7,9,14,23,34,22,56,0.000333,0.08444,4,1013.277878,56.293215,253.31947,81.832294,2,4
0,0,7,7,9,11,20,30,19,49,0.000333,0.070591,4,847.097907,47.060995,211.774477,66.583073,2,4
0,0,7,7,10,18,28,32,28,60,0.000333,0.096147,5,1442.206477,80.122582,288.441295,108.277931,2,4
0,0,7,7,10,17,27,32,27,59,0.000333,0.093513,5,1402.691813,77.927323,280.538363,102.706149,2,4
0,0,7,7,9,11,20,30,19,49,0.000333,0.070591,4,847.097907,47.060995,211.774477,66.583073,2,4
0,0,7,7,9,14,23,34,22,56,0.000333,0.08444,4,1013.277878,56.293215,253.31947,81.832294,2,4
0,0,6,6,9,14,23,29,21,50,0.000333,0.075393,4,904.712391,50.2618,226.178098,81.832294,2,4
0,0,6,6,9,13,22,29,20,49,0.000333,0.072837,4,874.048597,48.558255,218.512149,76.635041,2,4
0,0,7,7,9,11,20,30,19,49,0.000333,0.070591,4,847.097907,47.060995,211.774477,66.583073,2,4
0,0,6,6,11,15,26,31,22,53,0.000333,0.083041,5,1245.616525,69.200918,249.123305,96.657107,2,4
0,0,7,7,9,11,20,30,19,49,0.000333,0.070591,4,847.097907,47.060995,211.774477,66.583073,2,4
0,0,6,6,10,15,25,30,22,52,0.000333,0.080494,5,1207.402609,67.077923,241.480522,91.82264,2,4
0,0,7,7,9,14,23,34,22,56,0.000333,0.08444,4,1013.277878,56.293215,253.31947,81.832294,2,4
0,0,7,7,9,11,20,30,19,49,0.000333,0.070591,4,847.097907,47.060995,211.774477,66.583073,2,4
0,0,6,6,9,10,19,29,17,46,0.000333,0.065135,4,781.618662,43.423259,195.404666,61.748606,2,4
0,0,9,9,12,19,31,48,32,80,0.000333,0.132112,6,2378.014229,132.111902,396.335705,123.730173,2,4
0,0,7,7,9,11,20,30,19,49,0.000333,0.070591,4,847.097907,47.060995,211.774477,66.583073,2,4
0,0,7,7,9,14,23,34,22,56,0.000333,0.08444,4,1013.277878,56.293215,253.31947,81.832294,2,4
0,0,7,7,9,11,20,30,19,49,0.000333,0.070591,4,847.097907,47.060995,211.774477,66.583073,2,4
0,0,7,7,9,11,20,31,19,50,0.000333,0.072032,4,864.385619,48.021423,216.096405,66.583073,2,4
0,0,7,7,9,11,20,31,19,50,0.000333,0.072032,4,864.385619,48.021423,216.096405,66.583073,2,4
0,0,8,8,11,14,25,39,24,63,0.000333,0.097521,5,1462.8147,81.267483,292.56294,91.356717,2,4
0,0,7,7,9,11,20,30,19,49,0.000333,0.070591,4,847.097907,47.060995,211.774477,66.583073,2,4
0,0,7,7,9,14,23,34,22,56,0.000333,0.08444,4,1013.277878,56.293215,253.31947,81.832294,2,4
0,0,7,7,9,11,20,30,19,49,0.000333,0.070591,4,847.097907,47.060995,211.774477,66.583073,2,4
0,0,7,7,9,11,20,31,19,50,0.000333,0.072032,4,864.385619,48.021423,216.096405,66.583073,2,4
0,0,7,7,9,11,20,31,19,50,0.000333,0.072032,4,864.385619,48.021423,216.096405,66.583073,2,4
0,0,8,8,11,14,25,39,24,63,0.000333,0.097521,5,1462.8147,81.267483,292.56294,91.356717,2,4
0,0,7,7,9,11,20,30,19,49,0.000333,0.070591,4,847.097907,47.060995,211.774477,66.583073,2,4
0,0,7,7,9,11,20,30,19,49,0.000333,0.070591,4,847.097907,47.060995,211.774477,66.583073,2,4
0,0,7,7,9,14,23,34,22,56,0.000333,0.08444,4,1013.277878,56.293215,253.31947,81.832294,2,4
0,0,7,7,9,11,20,31,19,50,0.000333,0.072032,4,864.385619,48.021423,216.096405,66.583073,2,4
0,0,8,8,11,14,25,39,24,63,0.000333,0.097521,5,1462.8147,81.267483,292.56294,91.356717,2,4
0,0,7,7,9,11,20,31,19,50,0.000333,0.072032,4,864.385619,48.021423,216.096405,66.583073,2,4
0,0,7,7,9,11,20,30,19,49,0.000333,0.070591,4,847.097907,47.060995,211.774477,66.583073,2,4
0,0,7,7,9,11,20,30,19,49,0.000333,0.070591,4,847.097907,47.060995,211.774477,66.583073,2,4
0,0,7,7,9,14,23,34,22,56,0.000333,0.08444,4,1013.277878,56.293215,253.31947,81.832294,2,4
0,0,7,7,9,11,20,31,19,50,0.000333,0.072032,4,864.385619,48.021423,216.096405,66.583073,2,4
0,0,8,8,11,14,25,39,24,63,0.000333,0.097521,5,1462.8147,81.267483,292.56294,91.356717,2,4
0,0,7,7,9,11,20,31,19,50,0.000333,0.072032,4,864.385619,48.021423,216.096405,66.583073,2,4
0,0,7,7,9,14,23,34,22,56,0.000333,0.08444,4,1013.277878,56.293215,253.31947,81.832294,2,4
0,0,7,7,9,11,20,30,19,49,0.000333,0.070591,4,847.097907,47.060995,211.774477,66.583073,2,4
0,0,7,7,9,11,20,30,19,49,0.000333,0.070591,4,847.097907,47.060995,211.774477,66.583073,2,4
0,0,8,8,11,14,25,39,24,63,0.000333,0.097521,5,1462.8147,81.267483,292.56294,91.356717,2,4
0,0,7,7,9,11,20,31,19,50,0.000333,0.072032,4,864.385619,48.021423,216.096405,66.583073,2,4
0,0,7,7,9,11,20,31,19,50,0.000333,0.072032,4,864.385619,48.021423,216.096405,66.583073,2,4
0,0,7,7,9,14,23,34,22,56,0.000333,0.08444,4,1013.277878,56.293215,253.31947,81.832294,2,4
0,0,7,7,9,11,20,30,19,49,0.000333,0.070591,4,847.097907,47.060995,211.774477,66.583073,2,4
0,0,7,7,9,11,20,30,19,49,0.000333,0.070591,4,847.097907,47.060995,211.774477,66.583073,2,4
0,0,8,8,11,14,25,39,24,63,0.000333,0.097521,5,1462.8147,81.267483,292.56294,91.356717,2,4
0,0,7,7,9,11,20,31,19,50,0.000333,0.072032,4,864.385619,48.021423,216.096405,66.583073,2,4
0,0,7,7,9,11,20,31,19,50,0.000333,0.072032,4,864.385619,48.021423,216.096405,66.583073,2,4
0,0,7,7,9,14,23,34,22,56,0.000333,0.08444,4,1013.277878,56.293215,253.31947,81.832294,2,4
0,0,7,7,9,11,20,30,19,49,0.000333,0.070591,4,847.097907,47.060995,211.774477,66.583073,2,4
0,0,7,7,9,11,20,30,19,49,0.000333,0.070591,4,847.097907,47.060995,211.774477,66.583073,2,4
0,0,8,8,11,14,25,39,24,63,0.000333,0.097521,5,1462.8147,81.267483,292.56294,91.356717,2,4
0,0,7,7,9,11,20,31,19,50,0.000333,0.072032,4,864.385619,48.021423,216.096405,66.583073,2,4
0,0,7,7,9,11,20,31,19,50,0.000333,0.072032,4,864.385619,48.021423,216.096405,66.583073,2,4
0,0,7,7,9,11,20,30,19,49,0.000333,0.070591,4,847.097907,47.060995,211.774477,66.583073,2,4
0,0,7,7,9,14,23,34,22,56,0.000333,0.08444,4,1013.277878,56.293215,253.31947,81.832294,2,4
0,0,7,7,9,11,20,30,19,49,0.000333,0.070591,4,847.097907,47.060995,211.774477,66.583073,2,4
0,0,7,7,9,11,20,31,19,50,0.000333,0.072032,4,864.385619,48.021423,216.096405,66.583073,2,4
0,0,7,7,9,11,20,31,19,50,0.000333,0.072032,4,864.385619,48.021423,216.096405,66.583073,2,4
0,0,8,8,11,14,25,39,24,63,0.000333,0.097521,5,1462.8147,81.267483,292.56294,91.356717,2,4
0,0,7,7,9,11,20,30,19,49,0.000333,0.070591,4,847.097907,47.060995,211.774477,66.583073,2,4
0,0,7,7,9,14,23,34,22,56,0.000333,0.08444,4,1013.277878,56.293215,253.31947,81.832294,2,4
0,0,7,7,9,11,20,30,19,49,0.000333,0.070591,4,847.097907,47.060995,211.774477,66.583073,2,4
0,0,7,7,9,11,20,31,19,50,0.000333,0.072032,4,864.385619,48.021423,216.096405,66.583073,2,4
0,0,7,7,9,11,20,31,19,50,0.000333,0.072032,4,864.385619,48.021423,216.096405,66.583073,2,4
0,0,8,8,11,14,25,39,24,63,0.000333,0.097521,5,1462.8147,81.267483,292.56294,91.356717,2,4
0,0,7,7,9,11,20,30,19,49,0.000333,0.070591,4,847.097907,47.060995,211.774477,66.583073,2,4
0,0,7,7,9,14,23,34,22,56,0.000333,0.08444,4,1013.277878,56.293215,253.31947,81.832294,2,4
0,0,7,7,9,11,20,30,19,49,0.000333,0.070591,4,847.097907,47.060995,211.774477,66.583073,2,4
0,0,7,7,9,11,20,31,19,50,0.000333,0.072032,4,864.385619,48.021423,216.096405,66.583073,2,4
0,0,7,7,9,11,20,31,19,50,0.000333,0.072032,4,864.385619,48.021423,216.096405,66.583073,2,4
0,0,8,8,11,14,25,39,24,63,0.000333,0.097521,5,1462.8147,81.267483,292.56294,91.356717,2,4
0,0,7,7,9,11,20,30,19,49,0.000333,0.070591,4,847.097907,47.060995,211.774477,66.583073,2,4
0,0,7,7,9,14,23,34,22,56,0.000333,0.08444,4,1013.277878,56.293215,253.31947,81.832294,2,4
0,0,7,7,9,11,20,30,19,49,0.000333,0.070591,4,847.097907,47.060995,211.774477,66.583073,2,4
0,0,7,7,9,10,19,31,19,50,0.000333,0.070799,4,849.585503,47.199195,212.396376,61.748606,2,4
0,0,7,7,9,10,19,31,19,50,0.000333,0.070799,4,849.585503,47.199195,212.396376,61.748606,2,4
0,0,10,10,12,20,32,50,34,84,0.000333,0.14,6,2520,140,420,129.458112,2,4
0,0,7,7,9,11,20,30,19,49,0.000333,0.070591,4,847.097907,47.060995,211.774477,66.583073,2,4
0,0,7,7,9,14,23,34,22,56,0.000333,0.08444,4,1013.277878,56.293215,253.31947,81.832294,2,4
0,0,7,7,9,11,20,30,19,49,0.000333,0.070591,4,847.097907,47.060995,211.774477,66.583073,2,4
0,0,7,7,9,11,20,31,19,50,0.000333,0.072032,4,864.385619,48.021423,216.096405,66.583073,2,4
0,0,7,7,9,11,20,31,19,50,0.000333,0.072032,4,864.385619,48.021423,216.096405,66.583073,2,4
0,0,8,8,11,14,25,39,24,63,0.000333,0.097521,5,1462.8147,81.267483,292.56294,91.356717,2,4
0,0,7,7,9,11,20,30,19,49,0.000333,0.070591,4,847.097907,47.060995,211.774477,66.583073,2,4
0,0,7,7,9,14,23,34,22,56,0.000333,0.08444,4,1013.277878,56.293215,253.31947,81.832294,2,4
0,0,7,7,9,11,20,30,19,49,0.000333,0.070591,4,847.097907,47.060995,211.774477,66.583073,2,4
0,0,7,7,9,11,20,31,19,50,0.000333,0.072032,4,864.385619,48.021423,216.096405,66.583073,2,4
0,0,7,7,9,11,20,31,19,50,0.000333,0.072032,4,864.385619,48.021423,216.096405,66.583073,2,4
0,0,8,8,11,14,25,39,24,63,0.000333,0.097521,5,1462.8147,81.267483,292.56294,91.356717,2,4
0,0,7,7,9,11,20,30,19,49,0.000333,0.070591,4,847.097907,47.060995,211.774477,66.583073,2,4
0,0,7,7,9,11,20,30,19,49,0.000333,0.070591,4,847.097907,47.060995,211.774477,66.583073,2,4
0,0,7,7,9,14,23,34,22,56,0.000333,0.08444,4,1013.277878,56.293215,253.31947,81.832294,2,4
0,0,8,8,11,14,25,39,24,63,0.000333,0.097521,5,1462.8147,81.267483,292.56294,91.356717,2,4
0,0,7,7,9,11,20,31,19,50,0.000333,0.072032,4,864.385619,48.021423,216.096405,66.583073,2,4
0,0,7,7,9,11,20,31,19,50,0.000333,0.072032,4,864.385619,48.021423,216.096405,66.583073,2,4
0,0,7,7,9,14,23,34,22,56,0.000333,0.08444,4,1013.277878,56.293215,253.31947,81.832294,2,4
0,0,7,7,9,11,20,30,19,49,0.000333,0.070591,4,847.097907,47.060995,211.774477,66.583073,2,4
0,0,8,8,11,14,25,39,24,63,0.000333,0.097521,5,1462.8147,81.267483,292.56294,91.356717,2,4
0,0,8,8,11,14,25,39,24,63,0.000333,0.097521,5,1462.8147,81.267483,292.56294,91.356717,2,4
0,0,7,7,9,11,20,30,19,49,0.000333,0.070591,4,847.097907,47.060995,211.774477,66.583073,2,4
0,0,7,7,9,14,23,34,22,56,0.000333,0.08444,4,1013.277878,56.293215,253.31947,81.832294,2,4
0,0,8,8,11,14,25,39,24,63,0.000333,0.097521,5,1462.8147,81.267483,292.56294,91.356717,2,4
0,0,8,8,11,14,25,39,24,63,0.000333,0.097521,5,1462.8147,81.267483,292.56294,91.356717,2,4
0,0,7,7,9,11,20,30,19,49,0.000333,0.070591,4,847.097907,47.060995,211.774477,66.583073,2,4
0,0,7,7,9,14,23,34,22,56,0.000333,0.08444,4,1013.277878,56.293215,253.31947,81.832294,2,4
0,0,9,9,12,19,31,48,32,80,0.000333,0.132112,6,2378.014229,132.111902,396.335705,123.730173,2,4
0,0,9,9,12,19,31,48,32,80,0.000333,0.132112,6,2378.014229,132.111902,396.335705,123.730173,2,4
0,0,7,7,9,14,23,34,22,56,0.000333,0.08444,4,1013.277878,56.293215,253.31947,81.832294,2,4
0,0,7,7,9,11,20,30,19,49,0.000333,0.070591,4,847.097907,47.060995,211.774477,66.583073,2,4
0,0,8,8,10,14,24,35,25,60,0.000333,0.091699,5,1375.48875,76.416042,275.09775,86.52225,2,4
0,0,11,11,13,22,35,54,38,92,0.000333,0.157298,6,2831.364225,157.298013,471.894038,146.213212,2,4
0,0,7,7,9,14,23,34,22,56,0.000333,0.08444,4,1013.277878,56.293215,253.31947,81.832294,2,4
0,0,7,7,9,11,20,30,19,49,0.000333,0.070591,4,847.097907,47.060995,211.774477,66.583073,2,4
0,0,6,6,9,14,23,29,21,50,0.000333,0.075393,4,904.712391,50.2618,226.178098,81.832294,2,4
0,0,8,8,9,16,25,34,29,63,0.000333,0.097521,4,1170.25176,65.013987,292.56294,92.529325,2,4
0,0,7,7,9,11,20,30,19,49,0.000333,0.070591,4,847.097907,47.060995,211.774477,66.583073,2,4
0,0,7,7,9,14,23,34,22,56,0.000333,0.08444,4,1013.277878,56.293215,253.31947,81.832294,2,4
0,0,8,8,9,12,21,33,23,56,0.000333,0.08199,4,983.879103,54.65995,245.969776,71.548875,2,4
0,0,11,11,12,21,33,52,38,90,0.000333,0.151332,6,2723.972824,151.331824,453.995471,135.258216,2,4
0,0,7,7,9,14,23,34,22,56,0.000333,0.08444,4,1013.277878,56.293215,253.31947,81.832294,2,4
0,0,7,7,9,11,20,30,19,49,0.000333,0.070591,4,847.097907,47.060995,211.774477,66.583073,2,4
0,0,7,7,10,11,21,34,21,55,0.000333,0.080526,5,1207.887291,67.10485,241.577458,71.273029,2,4
0,0,7,7,10,11,21,34,21,55,0.000333,0.080526,5,1207.887291,67.10485,241.577458,71.273029,2,4
0,0,7,7,9,11,20,30,19,49,0.000333,0.070591,4,847.097907,47.060995,211.774477,66.583073,2,4
0,0,7,7,9,14,23,34,22,56,0.000333,0.08444,4,1013.277878,56.293215,253.31947,81.832294,2,4
0,0,7,7,10,15,25,31,23,54,0.000333,0.083589,5,1253.841171,69.657843,250.768234,91.82264,2,4
0,0,7,7,10,15,25,31,23,54,0.000333,0.083589,5,1253.841171,69.657843,250.768234,91.82264,2,4
0,0,7,7,9,14,23,34,22,56,0.000333,0.08444,4,1013.277878,56.293215,253.31947,81.832294,2,4
0,0,7,7,9,11,20,30,19,49,0.000333,0.070591,4,847.097907,47.060995,211.774477,66.583073,2,4
0,0,8,8,10,14,24,35,25,60,0.000333,0.091699,5,1375.48875,76.416042,275.09775,86.52225,2,4
0,0,11,11,13,22,35,54,38,92,0.000333,0.157298,6,2831.364225,157.298013,471.894038,146.213212,2,4
0,0,7,7,9,14,23,34,22,56,0.000333,0.08444,4,1013.277878,56.293215,253.31947,81.832294,2,4
0,0,7,7,9,11,20,30,19,49,0.000333,0.070591,4,847.097907,47.060995,211.774477,66.583073,2,4
0,0,8,8,10,12,22,35,22,57,0.000333,0.084729,5,1270.938011,70.607667,254.187602,76.238831,2,4
0,0,11,11,13,20,33,54,36,90,0.000333,0.151332,6,2723.972824,151.331824,453.995471,134.544278,2,4
0,0,7,7,9,14,23,34,22,56,0.000333,0.08444,4,1013.277878,56.293215,253.31947,81.832294,2,4
0,0,7,7,9,11,20,30,19,49,0.000333,0.070591,4,847.097907,47.060995,211.774477,66.583073,2,4
0,0,6,6,10,13,23,30,20,50,0.000333,0.075393,5,1130.890489,62.827249,226.178098,81.324997,2,4
0,0,6,6,10,12,22,30,19,49,0.000333,0.072837,5,1092.560747,60.697819,218.512149,76.238831,2,4
0,0,7,7,9,11,20,30,19,49,0.000333,0.070591,4,847.097907,47.060995,211.774477,66.583073,2,4
0,0,7,7,9,14,23,34,22,56,0.000333,0.08444,4,1013.277878,56.293215,253.31947,81.832294,2,4
0,0,9,9,9,17,26,34,30,64,0.000333,0.100276,4,1203.312568,66.850698,300.828142,98.016193,2,4
0,0,12,12,12,24,36,53,42,95,0.000333,0.163714,6,2946.857251,163.714292,491.142875,153.05865,2,4
0,0,7,7,9,14,23,34,22,56,0.000333,0.08444,4,1013.277878,56.293215,253.31947,81.832294,2,4
0,0,7,7,9,11,20,30,19,49,0.000333,0.070591,4,847.097907,47.060995,211.774477,66.583073,2,4
0,0,6,6,9,15,24,29,22,51,0.000333,0.077944,4,935.33235,51.962908,233.833088,87.132684,2,4
0,0,6,6,9,14,23,29,21,50,0.000333,0.075393,4,904.712391,50.2618,226.178098,81.832294,2,4
0,0,7,7,9,14,23,34,22,56,0.000333,0.08444,4,1013.277878,56.293215,253.31947,81.832294,2,4
0,0,7,7,9,11,20,30,19,49,0.000333,0.070591,4,847.097907,47.060995,211.774477,66.583073,2,4
0,0,6,6,9,15,24,29,22,51,0.000333,0.077944,4,935.33235,51.962908,233.833088,87.132684,2,4
0,0,6,6,9,14,23,29,21,50,0.000333,0.075393,4,904.712391,50.2618,226.178098,81.832294,2,4
0,0,7,7,9,14,23,34,22,56,0.000333,0.08444,4,1013.277878,56.293215,253.31947,81.832294,2,4
0,0,7,7,9,11,20,30,19,49,0.000333,0.070591,4,847.097907,47.060995,211.774477,66.583073,2,4
0,0,6,6,9,15,24,29,22,51,0.000333,0.077944,4,935.33235,51.962908,233.833088,87.132684,2,4
0,0,6,6,9,14,23,29,21,50,0.000333,0.075393,4,904.712391,50.2618,226.178098,81.832294,2,4
0,0,7,7,9,14,23,34,22,56,0.000333,0.08444,4,1013.277878,56.293215,253.31947,81.832294,2,4
0,0,7,7,9,11,20,30,19,49,0.000333,0.070591,4,847.097907,47.060995,211.774477,66.583073,2,4
0,0,6,6,9,15,24,29,22,51,0.000333,0.077944,4,935.33235,51.962908,233.833088,87.132684,2,4
0,0,6,6,9,14,23,29,21,50,0.000333,0.075393,4,904.712391,50.2618,226.178098,81.832294,2,4
0,0,7,7,9,14,23,34,22,56,0.000333,0.08444,4,1013.277878,56.293215,253.31947,81.832294,2,4
0,0,7,7,9,11,20,30,19,49,0.000333,0.070591,4,847.097907,47.060995,211.774477,66.583073,2,4
0,0,6,6,9,12,21,31,20,51,0.000333,0.074669,4,896.032754,49.779597,224.008189,71.548875,2,4
0,0,6,6,9,13,22,31,21,52,0.000333,0.077297,4,927.561777,51.53121,231.890444,76.635041,2,4
0,0,7,7,9,14,23,34,22,56,0.000333,0.08444,4,1013.277878,56.293215,253.31947,81.832294,2,4
0,0,7,7,9,11,20,30,19,49,0.000333,0.070591,4,847.097907,47.060995,211.774477,66.583073,2,4
0,0,7,7,9,15,24,33,24,57,0.000333,0.087114,4,1045.37145,58.076192,261.342863,87.132684,2,4
0,0,7,7,9,16,25,33,25,58,0.000333,0.089781,4,1077.374636,59.854146,269.343659,92.529325,2,4
0,0,7,7,9,14,23,34,22,56,0.000333,0.08444,4,1013.277878,56.293215,253.31947,81.832294,2,4
0,0,7,7,9,11,20,30,19,49,0.000333,0.070591,4,847.097907,47.060995,211.774477,66.583073,2,4
0,0,8,8,9,16,25,41,28,69,0.000333,0.106809,4,1281.704308,71.205795,320.426077,92.529325,2,4
0,0,8,8,9,17,26,41,29,70,0.000333,0.109677,4,1316.123121,73.117951,329.03078,98.016193,2,4
0,0,7,7,9,14,23,34,22,56,0.000333,0.08444,4,1013.277878,56.293215,253.31947,81.832294,2,4
0,0,7,7,9,11,20,30,19,49,0.000333,0.070591,4,847.097907,47.060995,211.774477,66.583073,2,4
0,0,6,6,9,15,24,29,22,51,0.000333,0.077944,4,935.33235,51.962908,233.833088,87.132684,2,4
0,0,6,6,9,14,23,29,21,50,0.000333,0.075393,4,904.712391,50.2618,226.178098,81.832294,2,4
0,0,6,6,11,12,23,31,19,50,0.000333,0.075393,5,1130.890489,62.827249,226.178098,81.073298,2,4
0,0,6,6,11,12,23,31,19,50,0.000333,0.075393,5,1130.890489,62.827249,226.178098,81.073298,2,4
0,0,7,7,11,16,27,35,25,60,0.000333,0.095098,5,1426.466251,79.248125,285.29325,102.053748,2,4
0,0,7,7,11,17,28,35,26,61,0.000333,0.09775,5,1466.243251,81.457958,293.24865,107.540616,2,4
0,0,7,7,9,14,23,34,22,56,0.000333,0.08444,4,1013.277878,56.293215,253.31947,81.832294,2,4
0,0,7,7,9,11,20,30,19,49,0.000333,0.070591,4,847.097907,47.060995,211.774477,66.583073,2,4
0,0,7,7,10,17,27,32,27,59,0.000333,0.093513,5,1402.691813,77.927323,280.538363,102.706149,2,4
0,0,7,7,10,18,28,32,28,60,0.000333,0.096147,5,1442.206477,80.122582,288.441295,108.277931,2,4
0,0,7,7,9,14,23,34,22,56,0.000333,0.08444,4,1013.277878,56.293215,253.31947,81.832294,2,4
0,0,7,7,9,11,20,30,19,49,0.000333,0.070591,4,847.097907,47.060995,211.774477,66.583073,2,4
0,0,6,6,9,13,22,29,20,49,0.000333,0.072837,4,874.048597,48.558255,218.512149,76.635041,2,4
0,0,6,6,9,14,23,29,21,50,0.000333,0.075393,4,904.712391,50.2618,226.178098,81.832294,2,4
0,0,7,7,9,11,20,30,19,49,0.000333,0.070591,4,847.097907,47.060995,211.774477,66.583073,2,4
0,0,6,6,11,15,26,31,22,53,0.000333,0.083041,5,1245.616525,69.200918,249.123305,96.657107,2,4
0,0,7,7,9,11,20,30,19,49,0.000333,0.070591,4,847.097907,47.060995,211.774477,66.583073,2,4
0,0,6,6,10,15,25,30,22,52,0.000333,0.080494,5,1207.402609,67.077923,241.480522,91.82264,2,4
0,0,7,7,9,14,23,34,22,56,0.000333,0.08444,4,1013.277878,56.293215,253.31947,81.832294,2,4
0,0,7,7,9,11,20,30,19,49,0.000333,0.070591,4,847.097907,47.060995,211.774477,66.583073,2,4
0,0,6,6,9,10,19,29,17,46,0.000333,0.065135,4,781.618662,43.423259,195.404666,61.748606,2,4
0,0,6,6,9,10,19,29,17,46,0.000333,0.065135,4,781.618662,43.423259,195.404666,61.748606,2,4
0,0,7,7,9,11,20,30,19,49,0.000333,0.070591,4,847.097907,47.060995,211.774477,66.583073,2,4
0,0,7,7,9,11,20,30,19,49,0.000333,0.070591,4,847.097907,47.060995,211.774477,66.583073,2,4
0,0,7,7,9,14,23,34,22,56,0.000333,0.08444,4,1013.277878,56.293215,253.31947,81.832294,2,4
0,0,7,7,9,11,20,31,19,50,0.000333,0.072032,4,864.385619,48.021423,216.096405,66.583073,2,4
0,0,7,7,9,11,20,31,19,50,0.000333,0.072032,4,864.385619,48.021423,216.096405,66.583073,2,4
0,0,7,7,9,11,20,31,19,50,0.000333,0.072032,4,864.385619,48.021423,216.096405,66.583073,2,4
0,0,7,7,9,14,23,34,22,56,0.000333,0.08444,4,1013.277878,56.293215,253.31947,81.832294,2,4
0,0,7,7,9,11,20,30,19,49,0.000333,0.070591,4,847.097907,47.060995,211.774477,66.583073,2,4
0,0,6,6,9,10,19,29,17,46,0.000333,0.065135,4,781.618662,43.423259,195.404666,61.748606,2,4
0,0,6,6,9,10,19,29,17,46,0.000333,0.065135,4,781.618662,43.423259,195.404666,61.748606,2,4
0,0,7,7,9,11,20,30,19,49,0.000333,0.070591,4,847.097907,47.060995,211.774477,66.583073,2,4
0,0,7,7,9,11,20,30,19,49,0.000333,0.070591,4,847.097907,47.060995,211.774477,66.583073,2,4
0,0,7,7,9,14,23,34,22,56,0.000333,0.08444,4,1013.277878,56.293215,253.31947,81.832294,2,4
0,0,7,7,9,11,20,31,19,50,0.000333,0.072032,4,864.385619,48.021423,216.096405,66.583073,2,4
0,0,7,7,9,11,20,31,19,50,0.000333,0.072032,4,864.385619,48.021423,216.096405,66.583073,2,4
0,0,7,7,9,11,20,31,19,50,0.000333,0.072032,4,864.385619,48.021423,216.096405,66.583073,2,4
0,0,7,7,9,14,23,34,22,56,0.000333,0.08444,4,1013.277878,56.293215,253.31947,81.832294,2,4
0,0,7,7,9,11,20,30,19,49,0.000333,0.070591,4,847.097907,47.060995,211.774477,66.583073,2,4
0,0,13,13,12,14,26,39,29,68,0.000333,0.106543,12,3835.55881,213.086601,319.629901,96.322519,3,4
0,0,11,11,12,11,23,33,26,59,0.000333,0.088963,12,3202.681865,177.92677,266.890155,81.073298,2,4
0,0,14,14,13,12,25,46,34,80,0.000333,0.123836,12,4458.101942,247.67233,371.508495,91.125266,2,4
0,0,11,11,13,11,24,34,26,60,0.000333,0.091699,12,3301.173001,183.3985,275.09775,86.159464,2,4
0,0,12,12,13,14,27,36,29,65,0.000333,0.103023,12,3708.812252,206.045125,309.067688,101.408685,2,4
0,0,11,11,13,12,25,35,26,61,0.000333,0.094425,12,3399.302731,188.850152,283.275228,91.125266,2,4
0,0,12,12,14,11,25,38,28,66,0.000333,0.102165,14,4290.923119,238.384618,306.494509,91.356717,2,4
0,0,11,11,13,12,25,35,26,61,0.000333,0.094425,12,3399.302731,188.850152,283.275228,91.125266,2,4
0,0,12,12,13,13,26,42,30,72,0.000333,0.112811,12,4061.179916,225.621106,338.43166,96.211433,2,4
0,0,13,13,13,13,26,35,28,63,0.000333,0.098709,12,3553.532427,197.418468,296.127702,96.211433,2,4
0,0,11,11,12,12,24,34,26,60,0.000333,0.091699,12,3301.173001,183.3985,275.09775,86.0391,2,4
0,0,13,13,12,13,25,39,32,71,0.000333,0.109905,12,3956.565474,219.809193,329.713789,91.125266,2,4
0,0,15,15,12,14,26,44,38,82,0.000333,0.128479,12,4625.232683,256.957371,385.436057,96.322519,2,4
0,0,17,17,12,15,27,49,44,93,0.000333,0.147402,12,5306.454452,294.803025,442.204538,101.622909,2,4
0,0,12,12,13,11,24,37,28,65,0.000333,0.099341,12,3576.270751,198.681708,298.022563,86.159464,2,4
0,0,11,11,13,12,25,35,26,61,0.000333,0.094425,12,3399.302731,188.850152,283.275228,91.125266,2,4
0,0,12,12,13,13,26,39,29,68,0.000333,0.106543,12,3835.55881,213.086601,319.629901,96.211433,2,4
0,0,13,13,13,14,27,47,33,80,0.000333,0.126797,12,4564.692002,253.594,380.391,101.408685,2,4
0,0,12,12,12,13,25,41,30,71,0.000333,0.109905,12,3956.565474,219.809193,329.713789,91.125266,2,4
0,0,14,14,12,15,27,47,36,83,0.000333,0.131552,12,4735.867952,263.103775,394.655663,101.622909,2,4
0,0,14,14,13,15,28,41,35,76,0.000333,0.121786,12,4384.307689,243.572649,365.358974,106.709075,2,4
0,0,13,13,12,13,25,34,28,62,0.000333,0.095973,12,3455.029005,191.946056,287.919084,91.125266,2,4
0,0,16,16,14,18,32,64,52,116,0.000333,0.193333,14,8120,451.111111,580,128.361619,2,4
0,0,16,16,14,16,30,54,43,97,0.000333,0.158656,14,6663.557429,370.197635,475.968388,117.302969,2,4
0,0,16,16,13,17,30,57,45,102,0.000333,0.166834,12,6006.034089,333.668561,500.502841,117.592585,2,4
0,0,14,14,15,19,34,54,39,93,0.000333,0.157711,14,6623.876619,367.993146,473.134044,139.313982,4,4
0,0,16,16,15,19,34,60,41,101,0.000333,0.171278,14,7193.672458,399.64847,513.833747,139.313982,6,4
0,0,16,16,15,20,35,60,43,103,0.000333,0.176105,14,7396.42611,410.912562,528.316151,145.041921,6,4
0,0,16,16,15,20,35,60,41,101,0.000333,0.172686,14,7252.806186,402.933677,518.057585,145.041921,6,4
0,0,16,16,15,20,35,60,41,101,0.000333,0.172686,14,7252.806186,402.933677,518.057585,145.041921,6,4
0,0,16,16,15,21,36,60,43,103,0.000333,0.177501,14,7455.031852,414.168436,532.502275,150.842025,6,4
0,0,16,16,15,21,36,60,43,103,0.000333,0.177501,14,7455.031852,414.168436,532.502275,150.842025,6,4
0,0,16,16,15,20,35,60,41,101,0.000333,0.172686,14,7252.806186,402.933677,518.057585,145.041921,6,4
0,0,16,16,15,20,35,60,41,101,0.000333,0.172686,14,7252.806186,402.933677,518.057585,145.041921,6,4
0,0,16,16,15,20,35,60,41,101,0.000333,0.172686,14,7252.806186,402.933677,518.057585,145.041921,6,4
0,0,16,16,15,20,35,60,41,101,0.000333,0.172686,14,7252.806186,402.933677,518.057585,145.041921,6,4
0,0,16,16,15,21,36,60,43,103,0.000333,0.177501,14,7455.031852,414.168436,532.502275,150.842025,6,4
0,0,16,16,15,21,36,60,43,103,0.000333,0.177501,14,7455.031852,414.168436,532.502275,150.842025,6,4
0,0,21,21,19,21,40,70,43,113,0.000333,0.200459,18,10824.80175,601.377875,601.377875,172.949289,6,4
0,0,18,18,16,19,35,64,41,105,0.000333,0.179525,16,8617.195468,478.733082,538.574717,144.710623,6,4
0,0,16,16,18,21,39,70,49,119,0.000333,0.209654,18,11321.33155,628.962864,628.962864,167.297316,6,4
0,0,18,18,17,21,38,60,43,103,0.000333,0.180179,16,8648.584542,480.476919,540.536534,161.725534,4,4
0,0,18,18,16,22,38,65,48,113,0.000333,0.197672,16,9488.252944,527.125164,593.015809,162.107496,5,4
0,0,18,18,15,22,37,64,48,112,0.000333,0.194486,14,8168.422877,453.801271,583.458777,156.710855,5,4
0,0,16,16,15,20,35,58,45,103,0.000333,0.176105,14,7396.42611,410.912562,528.316151,145.041921,4,4
0,0,19,19,16,21,37,71,53,124,0.000333,0.215324,16,10335.55548,574.197527,645.972217,156.238666,4,4
0,0,16,16,16,20,36,59,45,104,0.000333,0.179224,16,8602.755202,477.930845,537.6722,150.438562,4,4
0,0,17,17,16,23,39,61,48,109,0.000333,0.192036,16,9217.74147,512.096748,576.108842,168.041925,4,4
0,0,16,16,16,21,37,60,45,105,0.000333,0.182331,16,8751.881654,486.215647,546.992603,156.238666,4,4
0,0,17,17,17,20,37,63,47,110,0.000333,0.191013,16,9168.637924,509.368774,573.03987,155.92543,4,4
0,0,16,16,16,21,37,60,45,105,0.000333,0.182331,16,8751.881654,486.215647,546.992603,156.238666,4,4
0,0,17,17,16,22,38,67,49,116,0.000333,0.20292,16,9740.153465,541.119637,608.759592,162.107496,4,4
0,0,18,18,16,22,38,60,47,107,0.000333,0.187176,16,8984.451903,499.136217,561.528244,162.107496,4,4
0,0,16,16,15,21,36,59,45,104,0.000333,0.179224,14,7527.410802,418.189489,537.6722,150.842025,4,4
0,0,18,18,15,22,37,64,51,115,0.000333,0.199696,14,8387.219919,465.956662,599.087137,156.710855,4,4
0,0,20,20,15,23,38,69,57,126,0.000333,0.220413,14,9257.344134,514.296896,661.238867,162.645284,4,4
0,0,22,22,15,24,39,74,63,137,0.000333,0.241367,14,10137.40146,563.18897,724.100104,168.642459,4,4
0,0,17,17,16,20,36,62,47,109,0.000333,0.187841,16,9016.349203,500.908289,563.521825,150.438562,4,4
0,0,16,16,16,21,37,60,45,105,0.000333,0.182331,16,8751.881654,486.215647,546.992603,156.238666,4,4
0,0,17,17,16,22,38,64,48,112,0.000333,0.195923,16,9404.286104,522.460339,587.767882,162.107496,4,4
0,0,18,18,16,23,39,72,52,124,0.000333,0.218463,16,10486.238,582.568778,655.389875,168.041925,4,4
0,0,17,17,15,22,37,66,49,115,0.000333,0.199696,14,8387.219919,465.956662,599.087137,156.710855,4,4
0,0,19,19,15,24,39,72,55,127,0.000333,0.223749,14,9397.445145,522.080286,671.246082,168.642459,4,4
0,0,19,19,16,24,40,66,54,120,0.000333,0.212877,16,10218.10194,567.67233,638.631371,174.0391,4,4
0,0,18,18,15,22,37,59,47,106,0.000333,0.184067,14,7730.828795,429.490489,552.202057,156.710855,4,4
0,0,21,21,17,26,43,89,71,160,0.000333,0.289401,16,13891.23777,771.735432,868.202361,191.698301,4,4
0,0,21,21,17,25,42,79,62,141,0.000333,0.253439,16,12165.06811,675.837117,760.316757,185.583273,4,4
0,0,21,21,16,25,41,82,64,146,0.000333,0.260734,16,12515.24148,695.291193,782.202593,180.096405,4,4
0,0,11,11,13,16,29,45,31,76,0.000333,0.123069,6,2215.239334,123.068852,369.206556,112.105716,3,4
0,0,13,13,13,17,30,51,33,84,0.000333,0.137393,6,2473.07286,137.392937,412.17881,117.592585,5,4
0,0,13,13,13,17,30,51,35,86,0.000333,0.140664,12,5063.911095,281.328394,421.992591,117.592585,5,4
0,0,13,13,13,17,30,51,33,84,0.000333,0.137393,6,2473.07286,137.392937,412.17881,117.592585,5,4
0,0,13,13,13,17,30,51,33,84,0.000333,0.137393,6,2473.07286,137.392937,412.17881,117.592585,5,4
0,0,13,13,13,18,31,51,35,86,0.000333,0.14202,6,2556.365296,142.020294,426.060883,123.164366,5,4
0,0,13,13,13,18,31,51,35,86,0.000333,0.14202,6,2556.365296,142.020294,426.060883,123.164366,5,4
0,0,13,13,13,17,30,51,33,84,0.000333,0.137393,6,2473.07286,137.392937,412.17881,117.592585,5,4
0,0,13,13,13,17,30,51,33,84,0.000333,0.137393,6,2473.07286,137.392937,412.17881,117.592585,5,4
0,0,13,13,13,17,30,51,33,84,0.000333,0.137393,6,2473.07286,137.392937,412.17881,117.592585,5,4
0,0,13,13,13,17,30,51,33,84,0.000333,0.137393,6,2473.07286,137.392937,412.17881,117.592585,5,4
0,0,13,13,13,18,31,51,35,86,0.000333,0.14202,6,2556.365296,142.020294,426.060883,123.164366,5,4
0,0,13,13,13,18,31,51,35,86,0.000333,0.14202,6,2556.365296,142.020294,426.060883,123.164366,5,4
0,0,18,18,18,18,36,61,35,96,0.000333,0.165438,9,4466.815201,248.1564,496.3128,150.1173,5,4
0,0,15,15,15,17,32,55,33,88,0.000333,0.146667,7,3080,171.111111,440,128.090227,5,4
0,0,13,13,16,19,35,61,41,102,0.000333,0.174396,16,8370.989884,465.054994,523.186868,144.710623,5,4
0,0,15,15,15,18,33,51,35,86,0.000333,0.144606,7,3036.72526,168.706959,433.817894,133.662009,3,4
0,0,15,15,14,20,34,56,40,96,0.000333,0.162799,14,6837.550059,379.863892,488.396433,139.741531,4,4
0,0,15,15,13,20,33,55,40,95,0.000333,0.159739,12,5750.609296,319.478294,479.217441,134.544278,4,4
0,0,13,13,13,17,30,49,37,86,0.000333,0.140664,12,5063.911095,281.328394,421.992591,117.592585,3,4
0,0,16,16,14,18,32,62,45,107,0.000333,0.178333,14,7490,416.111111,535,128.361619,3,4
0,0,13,13,14,17,31,50,37,87,0.000333,0.143672,14,6034.211106,335.23395,431.015079,122.789837,3,4
0,0,14,14,14,20,34,52,40,92,0.000333,0.156016,14,6552.65214,364.03623,468.046581,139.741531,3,4
0,0,13,13,14,18,32,51,37,88,0.000333,0.146667,14,6160,342.222222,440,128.361619,3,4
0,0,14,14,15,17,32,54,39,93,0.000333,0.155,14,6510,361.666667,465,128.090227,3,4
0,0,13,13,14,18,32,51,37,88,0.000333,0.146667,14,6160,342.222222,440,128.361619,3,4
0,0,14,14,14,19,33,58,41,99,0.000333,0.166465,14,6991.530249,388.418347,499.395018,134.013592,3,4
0,0,15,15,14,19,33,51,39,90,0.000333,0.151332,14,6355.93659,353.107588,453.995471,134.013592,3,4
0,0,13,13,13,18,31,50,37,87,0.000333,0.143672,12,5172.180948,287.343386,431.015079,123.164366,3,4
0,0,15,15,13,19,32,55,43,98,0.000333,0.163333,12,5880,326.666667,490,128.816339,3,4
0,0,17,17,13,20,33,60,49,109,0.000333,0.18328,12,6598.067508,366.559306,549.838959,134.544278,3,4
0,0,19,19,13,21,34,65,55,120,0.000333,0.203499,12,7325.946491,406.997027,610.495541,140.344382,3,4
0,0,14,14,14,17,31,53,39,92,0.000333,0.151929,14,6381.004848,354.500269,455.786061,122.789837,3,4
0,0,13,13,14,18,32,51,37,88,0.000333,0.146667,14,6160,342.222222,440,128.361619,3,4
0,0,14,14,14,19,33,55,40,95,0.000333,0.159739,14,6709.044179,372.724677,479.217441,134.013592,3,4
0,0,15,15,14,20,34,63,44,107,0.000333,0.181453,14,7621.019336,423.389963,544.358524,139.741531,3,4
0,0,14,14,13,19,32,57,41,98,0.000333,0.163333,12,5880,326.666667,490,128.816339,3,4
0,0,16,16,13,21,34,63,47,110,0.000333,0.18654,12,6715.45095,373.080608,559.620913,140.344382,3,4
0,0,16,16,14,21,35,57,46,103,0.000333,0.176105,14,7396.42611,410.912562,528.316151,145.541635,3,4
0,0,15,15,13,19,32,50,39,89,0.000333,0.148333,12,5340,296.666667,445,128.816339,3,4
0,0,18,18,15,24,39,80,63,143,0.000333,0.251938,14,10581.37524,587.85418,755.812517,168.642459,3,4
0,0,18,18,15,22,37,70,54,124,0.000333,0.215324,14,9043.611043,502.422836,645.972217,156.710855,3,4
0,0,18,18,14,23,37,73,56,129,0.000333,0.224006,14,9408.272778,522.681821,672.019484,157.344894,3,4
0,0,9,9,14,11,25,34,21,55,0.000333,0.085137,7,1787.884633,99.326924,255.41209,91.356717,2,4
0,0,11,11,14,12,26,40,23,63,0.000333,0.098709,7,2072.893916,115.160773,296.127702,96.322519,4,4
0,0,11,11,14,12,26,40,25,65,0.000333,0.101843,14,4277.400144,237.633341,305.528582,96.322519,4,4
0,0,11,11,14,12,26,40,23,63,0.000333,0.098709,7,2072.893916,115.160773,296.127702,96.322519,4,4
0,0,11,11,14,12,26,40,23,63,0.000333,0.098709,7,2072.893916,115.160773,296.127702,96.322519,4,4
0,0,11,11,14,13,27,40,25,65,0.000333,0.103023,7,2163.473813,120.19299,309.067688,101.408685,4,4
0,0,11,11,14,13,27,40,25,65,0.000333,0.103023,7,2163.473813,120.19299,309.067688,101.408685,4,4
0,0,11,11,14,12,26,40,23,63,0.000333,0.098709,7,2072.893916,115.160773,296.127702,96.322519,4,4
0,0,11,11,14,12,26,40,23,63,0.000333,0.098709,7,2072.893916,115.160773,296.127702,96.322519,4,4
0,0,11,11,14,12,26,40,23,63,0.000333,0.098709,7,2072.893916,115.160773,296.127702,96.322519,4,4
0,0,11,11,14,12,26,40,23,63,0.000333,0.098709,7,2072.893916,115.160773,296.127702,96.322519,4,4
0,0,11,11,14,13,27,40,25,65,0.000333,0.103023,7,2163.473813,120.19299,309.067688,101.408685,4,4
0,0,11,11,14,13,27,40,25,65,0.000333,0.103023,7,2163.473813,120.19299,309.067688,101.408685,4,4
0,0,16,16,19,13,32,50,25,75,0.000333,0.125,9,3375,187.5,375,128.816339,4,4
0,0,13,13,16,12,28,44,23,67,0.000333,0.107364,8,2576.742238,143.152347,322.09278,107.01955,4,4
0,0,11,11,17,14,31,50,31,81,0.000333,0.133763,16,6420.638418,356.702134,401.289901,122.789837,4,4
0,0,13,13,16,13,29,40,25,65,0.000333,0.105256,8,2526.150117,140.341673,315.768765,112.105716,2,4
0,0,13,13,15,15,30,45,30,75,0.000333,0.122672,14,5152.235125,286.235285,368.016795,117.206718,3,4
0,0,13,13,14,15,29,44,30,74,0.000333,0.11983,14,5032.868311,279.603795,359.490594,111.906328,3,4
0,0,11,11,14,12,26,38,27,65,0.000333,0.101843,14,4277.400144,237.633341,305.528582,96.322519,2,4
0,0,14,14,14,13,27,51,35,86,0.000333,0.136307,14,5724.884553,318.049142,408.920325,101.408685,2,4
0,0,11,11,14,12,26,39,27,66,0.000333,0.10341,14,4343.2063,241.289239,310.229021,96.322519,2,4
0,0,12,12,15,15,30,41,30,71,0.000333,0.11613,14,4877.449252,270.969403,348.389232,117.206718,2,4
0,0,11,11,15,13,28,40,27,67,0.000333,0.107364,14,4509.298917,250.516606,322.09278,106.709075,2,4
0,0,12,12,16,12,28,43,29,72,0.000333,0.115377,16,5538.07287,307.670715,346.129554,107.01955,2,4
0,0,11,11,14,13,27,40,27,67,0.000333,0.106192,14,4460.084477,247.782471,318.577463,101.408685,2,4
0,0,12,12,15,14,29,47,31,78,0.000333,0.126308,14,5304.915247,294.717514,378.922518,111.906328,2,4
0,0,13,13,15,14,29,40,29,69,0.000333,0.111734,14,4692.809641,260.711647,335.200689,111.906328,2,4
0,0,11,11,14,13,27,39,27,66,0.000333,0.104608,14,4393.516052,244.084225,313.822575,101.408685,2,4
0,0,13,13,14,14,28,44,33,77,0.000333,0.123389,14,5182.328606,287.907145,370.166329,106.605938,2,4
0,0,15,15,14,15,29,49,39,88,0.000333,0.142501,14,5985.032586,332.50181,427.502328,111.906328,2,4
0,0,17,17,14,16,30,54,45,99,0.000333,0.161927,14,6800.950366,377.830576,485.782169,117.302969,2,4
0,0,12,12,15,12,27,42,29,71,0.000333,0.112532,14,4726.358177,262.575454,337.597013,101.622909,2,4
0,0,11,11,14,13,27,40,27,67,0.000333,0.106192,14,4460.084477,247.782471,318.577463,101.408685,2,4
0,0,12,12,14,14,28,44,30,74,0.000333,0.118581,14,4980.419699,276.689983,355.744264,106.605938,2,4
0,0,13,13,14,15,29,52,34,86,0.000333,0.139262,14,5849.009118,324.944951,417.786366,111.906328,2,4
0,0,12,12,14,14,28,46,31,77,0.000333,0.123389,14,5182.328606,287.907145,370.166329,106.605938,2,4
0,0,14,14,14,16,30,52,37,89,0.000333,0.145571,14,6113.985682,339.665871,436.713263,117.302969,2,4
0,0,14,14,15,16,31,46,36,82,0.000333,0.135415,14,5687.417364,315.967631,406.244097,122.603359,2,4
0,0,13,13,14,14,28,39,29,68,0.000333,0.108967,14,4576.601886,254.25566,326.900135,106.605938,2,4
0,0,16,16,16,19,35,69,53,122,0.000333,0.208591,16,10012.36045,556.242247,625.772528,144.710623,2,4
0,0,16,16,16,17,33,59,44,103,0.000333,0.173191,16,8313.161509,461.842306,519.572594,133.486868,2,4
0,0,16,16,15,18,33,62,46,108,0.000333,0.181598,14,7627.123908,423.729106,544.794565,133.662009,2,4
0,0,14,14,15,19,34,54,39,93,0.000333,0.157711,14,6623.876619,367.993146,473.134044,139.313982,4,4
0,0,16,16,15,19,34,60,41,101,0.000333,0.171278,14,7193.672458,399.64847,513.833747,139.313982,6,4
0,0,16,16,15,20,35,60,43,103,0.000333,0.176105,14,7396.42611,410.912562,528.316151,145.041921,6,4
0,0,16,16,15,20,35,60,41,101,0.000333,0.172686,14,7252.806186,402.933677,518.057585,145.041921,6,4
0,0,16,16,15,20,35,60,41,101,0.000333,0.172686,14,7252.806186,402.933677,518.057585,145.041921,6,4
0,0,16,16,15,21,36,60,43,103,0.000333,0.177501,14,7455.031852,414.168436,532.502275,150.842025,6,4
0,0,16,16,15,21,36,60,43,103,0.000333,0.177501,14,7455.031852,414.168436,532.502275,150.842025,6,4
0,0,16,16,15,20,35,60,41,101,0.000333,0.172686,14,7252.806186,402.933677,518.057585,145.041921,6,4
0,0,16,16,15,20,35,60,41,101,0.000333,0.172686,14,7252.806186,402.933677,518.057585,145.041921,6,4
0,0,16,16,15,20,35,60,41,101,0.000333,0.172686,14,7252.806186,402.933677,518.057585,145.041921,6,4
0,0,16,16,15,20,35,60,41,101,0.000333,0.172686,14,7252.806186,402.933677,518.057585,145.041921,6,4
0,0,16,16,15,21,36,60,43,103,0.000333,0.177501,14,7455.031852,414.168436,532.502275,150.842025,6,4
0,0,16,16,15,21,36,60,43,103,0.000333,0.177501,14,7455.031852,414.168436,532.502275,150.842025,6,4
0,0,21,21,19,21,40,70,43,113,0.000333,0.200459,18,10824.80175,601.377875,601.377875,172.949289,6,4
0,0,18,18,16,19,35,64,41,105,0.000333,0.179525,16,8617.195468,478.733082,538.574717,144.710623,6,4
0,0,16,16,18,21,39,70,49,119,0.000333,0.209654,18,11321.33155,628.962864,628.962864,167.297316,6,4
0,0,18,18,17,21,38,60,43,103,0.000333,0.180179,16,8648.584542,480.476919,540.536534,161.725534,4,4
0,0,18,18,16,22,38,65,48,113,0.000333,0.197672,16,9488.252944,527.125164,593.015809,162.107496,5,4
0,0,18,18,15,22,37,64,48,112,0.000333,0.194486,14,8168.422877,453.801271,583.458777,156.710855,5,4
0,0,16,16,15,20,35,58,45,103,0.000333,0.176105,14,7396.42611,410.912562,528.316151,145.041921,4,4
0,0,19,19,16,21,37,71,53,124,0.000333,0.215324,16,10335.55548,574.197527,645.972217,156.238666,4,4
0,0,16,16,16,20,36,59,45,104,0.000333,0.179224,16,8602.755202,477.930845,537.6722,150.438562,4,4
0,0,17,17,16,23,39,61,48,109,0.000333,0.192036,16,9217.74147,512.096748,576.108842,168.041925,4,4
0,0,16,16,16,21,37,60,45,105,0.000333,0.182331,16,8751.881654,486.215647,546.992603,156.238666,4,4
0,0,17,17,17,20,37,63,47,110,0.000333,0.191013,16,9168.637924,509.368774,573.03987,155.92543,4,4
0,0,16,16,16,21,37,60,45,105,0.000333,0.182331,16,8751.881654,486.215647,546.992603,156.238666,4,4
0,0,17,17,16,22,38,67,49,116,0.000333,0.20292,16,9740.153465,541.119637,608.759592,162.107496,4,4
0,0,18,18,16,22,38,60,47,107,0.000333,0.187176,16,8984.451903,499.136217,561.528244,162.107496,4,4
0,0,16,16,15,21,36,59,45,104,0.000333,0.179224,14,7527.410802,418.189489,537.6722,150.842025,4,4
0,0,18,18,15,22,37,64,51,115,0.000333,0.199696,14,8387.219919,465.956662,599.087137,156.710855,4,4
0,0,20,20,15,23,38,69,57,126,0.000333,0.220413,14,9257.344134,514.296896,661.238867,162.645284,4,4
0,0,22,22,15,24,39,74,63,137,0.000333,0.241367,14,10137.40146,563.18897,724.100104,168.642459,4,4
0,0,17,17,16,20,36,62,47,109,0.000333,0.187841,16,9016.349203,500.908289,563.521825,150.438562,4,4
0,0,16,16,16,21,37,60,45,105,0.000333,0.182331,16,8751.881654,486.215647,546.992603,156.238666,4,4
0,0,17,17,16,22,38,64,48,112,0.000333,0.195923,16,9404.286104,522.460339,587.767882,162.107496,4,4
0,0,18,18,16,23,39,72,52,124,0.000333,0.218463,16,10486.238,582.568778,655.389875,168.041925,4,4
0,0,17,17,15,22,37,66,49,115,0.000333,0.199696,14,8387.219919,465.956662,599.087137,156.710855,4,4
0,0,19,19,15,24,39,72,55,127,0.000333,0.223749,14,9397.445145,522.080286,671.246082,168.642459,4,4
0,0,19,19,16,24,40,66,54,120,0.000333,0.212877,16,10218.10194,567.67233,638.631371,174.0391,4,4
0,0,18,18,15,22,37,59,47,106,0.000333,0.184067,14,7730.828795,429.490489,552.202057,156.710855,4,4
0,0,21,21,17,26,43,89,71,160,0.000333,0.289401,16,13891.23777,771.735432,868.202361,191.698301,4,4
0,0,21,21,17,25,42,79,62,141,0.000333,0.253439,16,12165.06811,675.837117,760.316757,185.583273,4,4
0,0,21,21,16,25,41,82,64,146,0.000333,0.260734,16,12515.24148,695.291193,782.202593,180.096405,4,4
0,0,9,9,12,10,22,29,20,49,0.000333,0.072837,12,2622.145792,145.674766,218.512149,76.238831,2,4
0,0,11,11,12,11,23,35,22,57,0.000333,0.085948,12,3094.116378,171.895354,257.843031,81.073298,4,4
0,0,11,11,12,11,23,35,24,59,0.000333,0.088963,12,3202.681865,177.92677,266.890155,81.073298,4,4
0,0,11,11,12,11,23,35,22,57,0.000333,0.085948,12,3094.116378,171.895354,257.843031,81.073298,4,4
0,0,11,11,12,11,23,35,22,57,0.000333,0.085948,12,3094.116378,171.895354,257.843031,81.073298,4,4
0,0,6,6,11,8,19,24,14,38,0.000333,0.053807,5,807.106228,44.839235,161.421246,62.053748,2,4
0,0,9,9,12,12,24,39,24,63,0.000333,0.096284,12,3466.231651,192.568425,288.852638,86.0391,2,4
0,0,7,7,11,9,20,26,16,42,0.000333,0.060507,5,907.6049,50.422494,181.52098,66.583073,2,4
0,0,11,11,12,14,26,44,30,74,0.000333,0.115944,12,4173.99047,231.888359,347.832539,96.322519,2,4
0,0,6,6,11,8,19,24,14,38,0.000333,0.053807,5,807.106228,44.839235,161.421246,62.053748,2,4
0,0,9,9,12,12,24,39,24,63,0.000333,0.096284,12,3466.231651,192.568425,288.852638,86.0391,2,4
0,0,7,7,11,9,20,26,16,42,0.000333,0.060507,5,907.6049,50.422494,181.52098,66.583073,2,4
0,0,11,11,12,14,26,44,30,74,0.000333,0.115944,12,4173.99047,231.888359,347.832539,96.322519,2,4
0,0,6,6,11,8,19,24,14,38,0.000333,0.053807,5,807.106228,44.839235,161.421246,62.053748,2,4
0,0,9,9,12,12,24,39,24,63,0.000333,0.096284,12,3466.231651,192.568425,288.852638,86.0391,2,4
0,0,7,7,11,9,20,26,16,42,0.000333,0.060507,5,907.6049,50.422494,181.52098,66.583073,2,4
0,0,11,11,12,14,26,44,30,74,0.000333,0.115944,12,4173.99047,231.888359,347.832539,96.322519,2,4
0,0,6,6,11,8,19,24,14,38,0.000333,0.053807,5,807.106228,44.839235,161.421246,62.053748,2,4
0,0,9,9,12,12,24,39,24,63,0.000333,0.096284,12,3466.231651,192.568425,288.852638,86.0391,2,4
0,0,7,7,11,9,20,26,16,42,0.000333,0.060507,5,907.6049,50.422494,181.52098,66.583073,2,4
0,0,11,11,12,14,26,44,30,74,0.000333,0.115944,12,4173.99047,231.888359,347.832539,96.322519,2,4
0,0,6,6,11,8,19,24,14,38,0.000333,0.053807,5,807.106228,44.839235,161.421246,62.053748,2,4
0,0,9,9,12,12,24,39,24,63,0.000333,0.096284,12,3466.231651,192.568425,288.852638,86.0391,2,4
0,0,7,7,11,9,20,26,16,42,0.000333,0.060507,5,907.6049,50.422494,181.52098,66.583073,2,4
0,0,11,11,12,14,26,44,30,74,0.000333,0.115944,12,4173.99047,231.888359,347.832539,96.322519,2,4
0,0,6,6,11,8,19,24,14,38,0.000333,0.053807,5,807.106228,44.839235,161.421246,62.053748,2,4
0,0,9,9,12,12,24,39,24,63,0.000333,0.096284,12,3466.231651,192.568425,288.852638,86.0391,2,4
0,0,7,7,11,9,20,26,16,42,0.000333,0.060507,5,907.6049,50.422494,181.52098,66.583073,2,4
0,0,11,11,12,14,26,44,30,74,0.000333,0.115944,12,4173.99047,231.888359,347.832539,96.322519,2,4
0,0,6,6,11,8,19,24,14,38,0.000333,0.053807,5,807.106228,44.839235,161.421246,62.053748,2,4
0,0,9,9,12,12,24,39,24,63,0.000333,0.096284,12,3466.231651,192.568425,288.852638,86.0391,2,4
0,0,7,7,11,9,20,26,16,42,0.000333,0.060507,5,907.6049,50.422494,181.52098,66.583073,2,4
0,0,11,11,12,14,26,44,30,74,0.000333,0.115944,12,4173.99047,231.888359,347.832539,96.322519,2,4
0,0,6,6,11,8,19,24,14,38,0.000333,0.053807,5,807.106228,44.839235,161.421246,62.053748,2,4
0,0,9,9,12,12,24,39,24,63,0.000333,0.096284,12,3466.231651,192.568425,288.852638,86.0391,2,4
0,0,7,7,11,9,20,26,16,42,0.000333,0.060507,5,907.6049,50.422494,181.52098,66.583073,2,4
0,0,11,11,12,14,26,44,30,74,0.000333,0.115944,12,4173.99047,231.888359,347.832539,96.322519,2,4
0,0,6,6,11,8,19,24,14,38,0.000333,0.053807,5,807.106228,44.839235,161.421246,62.053748,2,4
0,0,9,9,12,12,24,39,24,63,0.000333,0.096284,12,3466.231651,192.568425,288.852638,86.0391,2,4
0,0,7,7,11,9,20,26,16,42,0.000333,0.060507,5,907.6049,50.422494,181.52098,66.583073,2,4
0,0,11,11,12,14,26,44,30,74,0.000333,0.115944,12,4173.99047,231.888359,347.832539,96.322519,2,4
0,0,6,6,11,8,19,24,14,38,0.000333,0.053807,5,807.106228,44.839235,161.421246,62.053748,2,4
0,0,9,9,12,12,24,39,24,63,0.000333,0.096284,12,3466.231651,192.568425,288.852638,86.0391,2,4
0,0,7,7,11,9,20,26,16,42,0.000333,0.060507,5,907.6049,50.422494,181.52098,66.583073,2,4
0,0,11,11,12,14,26,44,30,74,0.000333,0.115944,12,4173.99047,231.888359,347.832539,96.322519,2,4
0,0,6,6,11,8,19,24,14,38,0.000333,0.053807,5,807.106228,44.839235,161.421246,62.053748,2,4
0,0,9,9,12,12,24,39,24,63,0.000333,0.096284,12,3466.231651,192.568425,288.852638,86.0391,2,4
0,0,7,7,11,9,20,26,16,42,0.000333,0.060507,5,907.6049,50.422494,181.52098,66.583073,2,4
0,0,11,11,12,14,26,44,30,74,0.000333,0.115944,12,4173.99047,231.888359,347.832539,96.322519,2,4
0,0,6,6,11,8,19,24,14,38,0.000333,0.053807,5,807.106228,44.839235,161.421246,62.053748,2,4
0,0,9,9,12,12,24,39,24,63,0.000333,0.096284,12,3466.231651,192.568425,288.852638,86.0391,2,4
0,0,7,7,11,9,20,26,16,42,0.000333,0.060507,5,907.6049,50.422494,181.52098,66.583073,2,4
0,0,11,11,12,14,26,44,30,74,0.000333,0.115944,12,4173.99047,231.888359,347.832539,96.322519,2,4
0,0,6,6,11,8,19,24,14,38,0.000333,0.053807,5,807.106228,44.839235,161.421246,62.053748,2,4
0,0,9,9,12,12,24,39,24,63,0.000333,0.096284,12,3466.231651,192.568425,288.852638,86.0391,2,4
0,0,7,7,11,9,20,26,16,42,0.000333,0.060507,5,907.6049,50.422494,181.52098,66.583073,2,4
0,0,11,11,12,14,26,44,30,74,0.000333,0.115944,12,4173.99047,231.888359,347.832539,96.322519,2,4
0,0,6,6,11,8,19,24,14,38,0.000333,0.053807,5,807.106228,44.839235,161.421246,62.053748,2,4
0,0,9,9,12,12,24,39,24,63,0.000333,0.096284,12,3466.231651,192.568425,288.852638,86.0391,2,4
0,0,7,7,11,9,20,26,16,42,0.000333,0.060507,5,907.6049,50.422494,181.52098,66.583073,2,4
0,0,11,11,12,14,26,44,30,74,0.000333,0.115944,12,4173.99047,231.888359,347.832539,96.322519,2,4
0,0,8,8,12,11,23,30,20,50,0.000333,0.075393,6,1357.068587,75.392699,226.178098,81.073298,2,4
0,0,9,9,13,12,25,40,24,64,0.000333,0.099069,12,3566.481554,198.137864,297.206796,91.125266,2,4
0,0,9,9,12,12,24,32,22,54,0.000333,0.082529,6,1485.52785,82.529325,247.587975,86.0391,2,4
0,0,11,11,13,14,27,43,30,73,0.000333,0.115702,12,4165.281452,231.404525,347.106788,101.408685,2,4
0,0,8,8,11,11,22,29,20,49,0.000333,0.072837,5,1092.560747,60.697819,218.512149,76.107496,2,4
0,0,9,9,12,12,24,39,24,63,0.000333,0.096284,12,3466.231651,192.568425,288.852638,86.0391,2,4
0,0,9,9,11,12,23,31,22,53,0.000333,0.079916,5,1198.743918,66.596884,239.748784,81.073298,2,4
0,0,11,11,13,14,27,43,30,73,0.000333,0.115702,12,4165.281452,231.404525,347.106788,101.408685,2,4
0,0,6,6,11,8,19,24,14,38,0.000333,0.053807,5,807.106228,44.839235,161.421246,62.053748,2,4
0,0,9,9,12,12,24,39,24,63,0.000333,0.096284,12,3466.231651,192.568425,288.852638,86.0391,2,4
0,0,7,7,11,9,20,26,16,42,0.000333,0.060507,5,907.6049,50.422494,181.52098,66.583073,2,4
0,0,11,11,13,14,27,43,30,73,0.000333,0.115702,12,4165.281452,231.404525,347.106788,101.408685,2,4
0,0,8,8,13,9,22,30,20,50,0.000333,0.074324,12,2675.658971,148.647721,222.971581,76.635041,2,4
0,0,11,11,13,12,25,45,30,75,0.000333,0.116096,12,4179.470571,232.192809,348.289214,91.125266,2,4
0,0,9,9,13,10,23,32,22,54,0.000333,0.081424,12,2931.268148,162.84823,244.272346,81.324997,2,4
0,0,13,13,14,14,28,49,36,85,0.000333,0.136208,14,5720.752357,317.819575,408.625168,106.605938,2,4
0,0,8,8,12,9,21,28,20,48,0.000333,0.070277,12,2529.974836,140.554158,210.831236,71.548875,2,4
0,0,11,11,13,12,25,43,30,73,0.000333,0.113001,12,4068.018022,226.001001,339.001502,91.125266,2,4
0,0,9,9,12,10,22,30,22,52,0.000333,0.077297,12,2782.68533,154.593629,231.890444,76.238831,2,4
0,0,13,13,14,14,28,47,36,83,0.000333,0.133003,14,5586.146419,310.341468,399.010459,106.605938,2,4
0,0,8,8,12,12,24,30,21,51,0.000333,0.077944,6,1402.998525,77.944363,233.833088,86.0391,2,4
0,0,11,11,13,15,28,45,31,76,0.000333,0.121786,12,4384.307689,243.572649,365.358974,106.709075,2,4
0,0,9,9,12,13,25,32,23,55,0.000333,0.085137,6,1532.472543,85.137363,255.41209,91.125266,2,4
0,0,13,13,14,17,31,49,37,86,0.000333,0.14202,14,5964.852358,331.380687,426.060883,122.789837,2,4
0,0,8,8,12,11,23,30,20,50,0.000333,0.075393,6,1357.068587,75.392699,226.178098,81.073298,2,4
0,0,9,9,13,12,25,40,24,64,0.000333,0.099069,12,3566.481554,198.137864,297.206796,91.125266,2,4
0,0,9,9,12,12,24,31,22,53,0.000333,0.081001,6,1458.018075,81.001004,243.003013,86.0391,2,4
0,0,11,11,13,14,27,43,30,73,0.000333,0.115702,12,4165.281452,231.404525,347.106788,101.408685,2,4
0,0,7,7,11,9,20,28,17,45,0.000333,0.064829,5,972.433821,54.024101,194.486764,66.583073,2,4
0,0,8,8,12,11,23,38,21,59,0.000333,0.088963,6,1601.340932,88.963385,266.890155,81.073298,2,4
0,0,8,8,11,10,21,30,19,49,0.000333,0.071741,5,1076.117769,59.78432,215.223554,71.273029,2,4
0,0,12,12,13,14,27,47,33,80,0.000333,0.126797,12,4564.692002,253.594,380.391,101.408685,2,4
0,0,7,7,11,9,20,27,16,43,0.000333,0.061948,5,929.21454,51.62303,185.842908,66.583073,2,4
0,0,8,8,12,12,24,37,20,57,0.000333,0.087114,6,1568.057175,87.114288,261.342863,86.0391,2,4
0,0,8,8,11,10,21,29,18,47,0.000333,0.068813,5,1032.194594,57.344144,206.438919,71.273029,2,4
0,0,12,12,13,15,28,46,32,78,0.000333,0.124991,12,4499.684207,249.982456,374.973684,106.709075,2,4
0,0,9,9,13,12,25,37,24,61,0.000333,0.094425,12,3399.302731,188.850152,283.275228,91.125266,2,4
0,0,10,10,13,13,26,39,26,65,0.000333,0.101843,12,3666.34298,203.685721,305.528582,96.211433,2,4
0,0,12,12,13,15,28,51,34,85,0.000333,0.136208,12,4903.50202,272.416779,408.625168,106.709075,2,4
0,0,6,6,11,9,20,24,15,39,0.000333,0.056185,5,842.775979,46.820888,168.555196,66.583073,2,4
0,0,9,9,12,12,24,39,25,64,0.000333,0.097813,12,3521.251201,195.625067,293.4376,86.0391,2,4
0,0,7,7,11,10,21,25,17,42,0.000333,0.061492,5,922.386659,51.243703,184.477332,71.273029,2,4
0,0,11,11,12,14,26,44,31,75,0.000333,0.117511,12,4230.395746,235.021986,352.532979,96.322519,2,4
0,0,8,8,11,11,22,29,20,49,0.000333,0.072837,5,1092.560747,60.697819,218.512149,76.107496,2,4
0,0,9,9,12,14,26,39,25,64,0.000333,0.100276,6,1804.968852,100.276047,300.828142,96.322519,2,4
0,0,9,9,11,12,23,30,22,52,0.000333,0.078408,5,1176.126109,65.340339,235.225222,81.073298,2,4
0,0,11,11,12,14,26,44,30,74,0.000333,0.115944,12,4173.99047,231.888359,347.832539,96.322519,2,4
0,0,9,9,11,12,23,32,22,54,0.000333,0.081424,5,1221.361728,67.853429,244.272346,81.073298,2,4
0,0,10,10,12,13,25,42,26,68,0.000333,0.105261,12,3789.386651,210.521481,315.782221,91.125266,2,4
0,0,10,10,11,13,24,33,24,57,0.000333,0.087114,5,1306.714313,72.59524,261.342863,86.159464,2,4
0,0,12,12,12,17,29,47,33,80,0.000333,0.129546,6,2331.830878,129.54616,388.63848,112.506418,2,4
0,0,10,10,11,13,24,35,24,59,0.000333,0.090171,5,1352.563938,75.142441,270.512788,86.159464,2,4
0,0,11,11,12,14,26,45,28,73,0.000333,0.114377,12,4117.585193,228.754733,343.132099,96.322519,2,4
0,0,11,11,11,14,25,36,26,62,0.000333,0.095973,5,1439.595419,79.977523,287.919084,91.356717,2,4
0,0,13,13,12,16,28,50,34,84,0.000333,0.134606,12,4845.813761,269.211876,403.817813,107.01955,2,4
0,0,11,11,11,14,25,38,26,64,0.000333,0.099069,5,1486.033981,82.557443,297.206796,91.356717,2,4
0,0,12,12,12,15,27,48,30,78,0.000333,0.123627,12,4450.574702,247.25415,370.881225,101.622909,2,4
0,0,12,12,11,15,26,39,28,67,0.000333,0.104976,5,1574.647306,87.480406,314.929461,96.657107,2,4
0,0,14,14,12,17,29,53,36,89,0.000333,0.14412,12,5188.323703,288.240206,432.360309,112.506418,2,4
0,0,7,7,11,9,20,28,17,45,0.000333,0.064829,5,972.433821,54.024101,194.486764,66.583073,2,4
0,0,8,8,12,11,23,38,21,59,0.000333,0.088963,6,1601.340932,88.963385,266.890155,81.073298,2,4
0,0,8,8,11,10,21,29,19,48,0.000333,0.070277,5,1054.156181,58.564232,210.831236,71.273029,2,4
0,0,12,12,12,15,27,48,33,81,0.000333,0.128382,12,4621.750652,256.763925,385.145888,101.622909,2,4
0,0,7,7,11,9,20,27,16,43,0.000333,0.061948,5,929.21454,51.62303,185.842908,66.583073,2,4
0,0,8,8,12,12,24,37,20,57,0.000333,0.087114,6,1568.057175,87.114288,261.342863,86.0391,2,4
0,0,8,8,11,10,21,28,18,46,0.000333,0.067349,5,1010.233007,56.124056,202.046601,71.273029,2,4
0,0,12,12,12,15,27,47,32,79,0.000333,0.125212,12,4507.633352,250.424075,375.636113,101.622909,2,4
0,0,9,9,13,14,27,34,24,58,0.000333,0.091928,6,1654.700851,91.927825,275.783475,101.408685,2,4
0,0,12,12,13,16,29,49,34,83,0.000333,0.134404,12,4838.549071,268.808282,403.212423,112.105716,2,4
0,0,10,10,13,15,28,35,26,61,0.000333,0.09775,6,1759.491901,97.74955,293.24865,106.709075,2,4
0,0,14,14,13,18,31,54,40,94,0.000333,0.155231,12,5588.333438,310.462969,465.694453,123.164366,2,4
0,0,10,10,13,13,26,42,27,69,0.000333,0.10811,12,3891.964087,216.220227,324.330341,96.211433,2,4
0,0,11,11,12,16,28,52,32,84,0.000333,0.134606,12,4845.813761,269.211876,403.817813,107.01955,2,4
0,0,11,11,13,14,27,43,29,72,0.000333,0.114117,12,4108.222802,228.2346,342.3519,101.408685,2,4
0,0,15,15,13,17,30,62,43,105,0.000333,0.171741,12,6182.68215,343.482342,515.223513,117.592585,2,4
0,0,9,9,12,12,24,36,24,60,0.000333,0.091699,12,3301.173001,183.3985,275.09775,86.0391,2,4
0,0,10,10,12,13,25,37,26,63,0.000333,0.097521,12,3510.755279,195.04196,292.56294,91.125266,2,4
0,0,12,12,12,15,27,51,34,85,0.000333,0.134722,12,4849.985252,269.443625,404.165438,101.622909,2,4
0,0,10,10,11,13,24,39,27,66,0.000333,0.100869,10,3026.07525,168.115292,302.607525,86.159464,2,4
0,0,11,11,11,14,25,40,29,69,0.000333,0.106809,10,3204.260771,178.014487,320.426077,91.356717,2,4
0,0,11,11,12,16,28,48,33,81,0.000333,0.129799,12,4672.748984,259.597166,389.395749,107.01955,2,4
0,0,10,10,12,14,26,35,27,62,0.000333,0.097142,6,1748.563575,97.142421,291.427263,96.322519,2,4
0,0,11,11,13,17,30,45,33,78,0.000333,0.127579,6,2296.424799,127.579155,382.737466,117.592585,2,4
0,0,11,11,12,15,27,36,29,65,0.000333,0.103023,6,1854.406126,103.022563,309.067688,101.622909,2,4
0,0,6,6,11,9,20,24,15,39,0.000333,0.056185,5,842.775979,46.820888,168.555196,66.583073,2,4
0,0,9,9,12,12,24,39,25,64,0.000333,0.097813,12,3521.251201,195.625067,293.4376,86.0391,2,4
0,0,7,7,11,10,21,25,17,42,0.000333,0.061492,5,922.386659,51.243703,184.477332,71.273029,2,4
0,0,11,11,12,14,26,44,31,75,0.000333,0.117511,12,4230.395746,235.021986,352.532979,96.322519,2,4
0,0,12,12,13,17,30,56,43,99,0.000333,0.161927,12,5829.386028,323.854779,485.782169,117.592585,2,4
0,0,15,15,14,19,33,71,53,124,0.000333,0.208502,14,8757.068191,486.503788,625.504871,134.013592,2,4
0,0,13,13,13,19,32,57,45,102,0.000333,0.17,12,6120,340,510,128.816339,2,4
0,0,12,12,13,15,28,46,34,80,0.000333,0.128196,12,4615.060725,256.392263,384.588394,106.709075,2,4
0,0,13,13,14,16,30,58,39,97,0.000333,0.158656,14,6663.557429,370.197635,475.968388,117.302969,2,4
0,0,13,13,13,16,29,47,36,83,0.000333,0.134404,12,4838.549071,268.808282,403.212423,112.105716,2,4
0,0,12,12,12,17,29,48,35,83,0.000333,0.134404,12,4838.549071,268.808282,403.212423,112.506418,2,4
0,0,13,13,13,18,31,61,41,102,0.000333,0.168443,12,6063.936284,336.885349,505.328024,123.164366,2,4
0,0,13,13,12,18,30,49,37,86,0.000333,0.140664,12,5063.911095,281.328394,421.992591,118.0782,2,4
0,0,6,6,11,8,19,24,14,38,0.000333,0.053807,5,807.106228,44.839235,161.421246,62.053748,2,4
0,0,6,6,11,8,19,24,14,38,0.000333,0.053807,5,807.106228,44.839235,161.421246,62.053748,2,4
0,0,6,6,11,8,19,24,14,38,0.000333,0.053807,5,807.106228,44.839235,161.421246,62.053748,2,4
0,0,6,6,11,8,19,24,14,38,0.000333,0.053807,5,807.106228,44.839235,161.421246,62.053748,2,4
0,0,6,6,11,8,19,24,14,38,0.000333,0.053807,5,807.106228,44.839235,161.421246,62.053748,2,4
0,0,6,6,11,8,19,24,14,38,0.000333,0.053807,5,807.106228,44.839235,161.421246,62.053748,2,4
0,0,6,6,11,8,19,24,14,38,0.000333,0.053807,5,807.106228,44.839235,161.421246,62.053748,2,4
0,0,6,6,11,8,19,24,14,38,0.000333,0.053807,5,807.106228,44.839235,161.421246,62.053748,2,4
0,0,6,6,11,8,19,24,14,38,0.000333,0.053807,5,807.106228,44.839235,161.421246,62.053748,2,4
0,0,6,6,11,8,19,24,14,38,0.000333,0.053807,5,807.106228,44.839235,161.421246,62.053748,2,4
0,0,6,6,11,8,19,24,14,38,0.000333,0.053807,5,807.106228,44.839235,161.421246,62.053748,2,4
0,0,6,6,11,8,19,24,14,38,0.000333,0.053807,5,807.106228,44.839235,161.421246,62.053748,2,4
0,0,6,6,11,8,19,24,14,38,0.000333,0.053807,5,807.106228,44.839235,161.421246,62.053748,2,4
0,0,6,6,11,8,19,24,14,38,0.000333,0.053807,5,807.106228,44.839235,161.421246,62.053748,2,4
0,0,8,8,12,11,23,30,20,50,0.000333,0.075393,6,1357.068587,75.392699,226.178098,81.073298,2,4
0,0,8,8,11,11,22,29,20,49,0.000333,0.072837,5,1092.560747,60.697819,218.512149,76.107496,2,4
0,0,6,6,11,8,19,24,14,38,0.000333,0.053807,5,807.106228,44.839235,161.421246,62.053748,2,4
0,0,8,8,13,9,22,30,20,50,0.000333,0.074324,12,2675.658971,148.647721,222.971581,76.635041,2,4
0,0,8,8,12,9,21,28,20,48,0.000333,0.070277,12,2529.974836,140.554158,210.831236,71.548875,2,4
0,0,8,8,12,12,24,30,21,51,0.000333,0.077944,6,1402.998525,77.944363,233.833088,86.0391,2,4
0,0,8,8,12,11,23,30,20,50,0.000333,0.075393,6,1357.068587,75.392699,226.178098,81.073298,2,4
0,0,7,7,11,9,20,28,17,45,0.000333,0.064829,5,972.433821,54.024101,194.486764,66.583073,2,4
0,0,7,7,11,9,20,27,16,43,0.000333,0.061948,5,929.21454,51.62303,185.842908,66.583073,2,4
0,0,9,9,13,12,25,37,24,61,0.000333,0.094425,12,3399.302731,188.850152,283.275228,91.125266,2,4
0,0,6,6,11,9,20,24,15,39,0.000333,0.056185,5,842.775979,46.820888,168.555196,66.583073,2,4
0,0,8,8,11,11,22,29,20,49,0.000333,0.072837,5,1092.560747,60.697819,218.512149,76.107496,2,4
0,0,9,9,11,12,23,32,22,54,0.000333,0.081424,5,1221.361728,67.853429,244.272346,81.073298,2,4
0,0,10,10,11,13,24,35,24,59,0.000333,0.090171,5,1352.563938,75.142441,270.512788,86.159464,2,4
0,0,11,11,11,14,25,38,26,64,0.000333,0.099069,5,1486.033981,82.557443,297.206796,91.356717,2,4
0,0,7,7,11,9,20,28,17,45,0.000333,0.064829,5,972.433821,54.024101,194.486764,66.583073,2,4
0,0,7,7,11,9,20,27,16,43,0.000333,0.061948,5,929.21454,51.62303,185.842908,66.583073,2,4
0,0,9,9,13,14,27,34,24,58,0.000333,0.091928,6,1654.700851,91.927825,275.783475,101.408685,2,4
0,0,10,10,13,13,26,42,27,69,0.000333,0.10811,12,3891.964087,216.220227,324.330341,96.211433,2,4
0,0,9,9,12,12,24,36,24,60,0.000333,0.091699,12,3301.173001,183.3985,275.09775,86.0391,2,4
0,0,10,10,11,13,24,39,27,66,0.000333,0.100869,10,3026.07525,168.115292,302.607525,86.159464,2,4
0,0,10,10,12,14,26,35,27,62,0.000333,0.097142,6,1748.563575,97.142421,291.427263,96.322519,2,4
0,0,6,6,11,9,20,24,15,39,0.000333,0.056185,5,842.775979,46.820888,168.555196,66.583073,2,4
0,0,12,12,13,17,30,56,43,99,0.000333,0.161927,12,5829.386028,323.854779,485.782169,117.592585,2,4
0,0,12,12,13,15,28,46,34,80,0.000333,0.128196,12,4615.060725,256.392263,384.588394,106.709075,2,4
0,0,12,12,12,17,29,48,35,83,0.000333,0.134404,12,4838.549071,268.808282,403.212423,112.506418,2,4
0,0,18,18,16,32,48,122,79,201,0.000333,0.374192,16,17961.2394,997.846633,1122.577463,224,3,4
0,0,13,13,17,29,46,85,50,135,0.000333,0.24856,8,5965.446913,331.413717,745.680864,210.368317,5,4
0,0,20,20,16,33,49,125,83,208,0.000333,0.389287,16,18685.75436,1038.097465,1167.859648,230.465006,5,4
0,0,13,13,17,29,46,85,50,135,0.000333,0.24856,8,5965.446913,331.413717,745.680864,210.368317,5,4
0,0,15,15,16,30,46,111,66,177,0.000333,0.32589,16,15642.72746,869.040414,977.670466,211.206718,3,4
0,0,13,13,17,29,46,85,50,135,0.000333,0.24856,8,5965.446913,331.413717,745.680864,210.368317,5,4
0,0,15,15,16,30,46,111,66,177,0.000333,0.32589,16,15642.72746,869.040414,977.670466,211.206718,3,4
0,0,13,13,17,29,46,85,50,135,0.000333,0.24856,8,5965.446913,331.413717,745.680864,210.368317,5,4
0,0,15,15,16,31,47,114,67,181,0.000333,0.335127,16,16086.08931,893.671629,1005.380582,217.580086,3,4
0,0,13,13,17,29,46,85,50,135,0.000333,0.24856,8,5965.446913,331.413717,745.680864,210.368317,5,4
0,0,16,16,16,30,46,110,68,178,0.000333,0.327731,16,15731.10445,873.950247,983.194028,211.206718,3,4
0,0,13,13,17,29,46,85,50,135,0.000333,0.24856,8,5965.446913,331.413717,745.680864,210.368317,5,4
0,0,15,15,16,30,46,108,66,174,0.000333,0.320367,16,15377.59649,854.310916,961.09978,211.206718,3,4
0,0,38,38,21,51,72,271,158,429,0.000333,0.882299,30,79406.93477,4411.496376,2646.897826,381.532358,9,4
0,0,13,13,17,29,46,85,50,135,0.000333,0.24856,8,5965.446913,331.413717,745.680864,210.368317,5,4
0,0,18,18,17,32,49,129,73,202,0.000333,0.378057,16,18146.74222,1008.152345,1134.171389,229.486868,5,4
0,0,13,13,17,29,46,85,50,135,0.000333,0.24856,8,5965.446913,331.413717,745.680864,210.368317,5,4
0,0,21,21,19,39,58,138,78,216,0.000333,0.421775,18,22775.83011,1265.323895,1265.323895,286.841309,6,4
0,0,31,31,21,45,66,200,107,307,0.000333,0.618543,20,37112.57989,2061.809994,1855.628995,339.372055,10,4
0,0,44,44,20,48,68,301,179,480,0.000333,0.973994,30,87659.46491,4869.970273,2921.982164,354.516762,3,4
0,0,13,13,17,29,46,85,50,135,0.000333,0.24856,8,5965.446913,331.413717,745.680864,210.368317,5,4
0,0,38,38,24,51,75,253,152,405,0.000333,0.840891,24,60544.11767,3363.562093,2522.67157,399.332792,4,4
0,0,13,13,17,29,46,85,50,135,0.000333,0.24856,8,5965.446913,331.413717,745.680864,210.368317,5,4
0,0,41,41,21,54,75,246,157,403,0.000333,0.836738,20,50204.27865,2789.126591,2510.213932,403.002591,6,4
0,0,13,13,17,29,46,85,50,135,0.000333,0.24856,8,5965.446913,331.413717,745.680864,210.368317,5,4
0,0,13,13,17,29,46,85,50,135,0.000333,0.24856,8,5965.446913,331.413717,745.680864,210.368317,5,4
0,0,39,39,19,50,69,272,159,431,0.000333,0.877591,27,71084.8991,3949.161061,2632.774041,362.903432,3,4
0,0,23,23,17,34,51,120,64,184,0.000333,0.347909,8,8349.810103,463.878339,1043.726263,242.460605,9,4
0,0,7,7,14,16,30,63,29,92,0.000333,0.150478,7,3160.037544,175.557641,451.433935,117.302969,4,4
0,0,14,14,14,23,37,60,34,94,0.000333,0.16323,7,3427.820315,190.434462,489.688616,157.344894,5,4
0,0,24,24,17,28,45,179,96,275,0.000333,0.50342,24,36246.23044,2013.679469,1510.259601,204.092806,3,4
0,0,13,13,17,29,46,85,50,135,0.000333,0.24856,8,5965.446913,331.413717,745.680864,210.368317,5,4
0,0,34,34,23,46,69,806,132,938,0.000333,1.909932,22,126055.5107,7003.083927,5729.79594,358.125775,4,4
0,0,31,31,20,43,63,201,106,307,0.000333,0.611675,20,36700.49873,2038.916596,1835.024937,319.767946,25,4
0,0,21,21,18,37,55,147,78,225,0.000333,0.433602,18,23414.50684,1300.805936,1300.805936,267.808425,14,4
0,0,12,12,17,29,46,81,49,130,0.000333,0.239354,8,5744.504434,319.139135,718.063054,210.368317,4,4
0,0,40,40,18,44,62,286,167,453,0.000333,0.899084,27,72825.77507,4045.876393,2697.250929,315.273641,19,4
0,0,13,13,17,29,46,85,50,135,0.000333,0.24856,8,5965.446913,331.413717,745.680864,210.368317,5,4
0,0,37,37,24,49,73,680,149,829,0.000333,1.710455,36,184729.1241,10262.72912,5131.364559,385.159882,18,4
0,0,13,13,17,29,46,85,50,135,0.000333,0.24856,8,5965.446913,331.413717,745.680864,210.368317,5,4
0,0,30,30,21,43,64,209,127,336,0.000333,0.672,20,40320,2240,2016,325.56805,4,4
0,0,14,14,17,30,47,92,53,145,0.000333,0.268472,8,6443.323068,357.962393,805.415383,216.693586,5,4
0,0,17,17,16,31,47,113,69,182,0.000333,0.336978,16,16174.96274,898.609041,1010.935171,217.580086,3,4
0,0,24,24,19,39,58,148,84,232,0.000333,0.453017,18,24462.92864,1359.051591,1359.051591,286.841309,8,4
0,0,13,13,17,30,47,88,52,140,0.000333,0.259214,8,6221.139514,345.618862,777.642439,216.693586,4,4
0,0,31,31,17,38,55,208,127,335,0.000333,0.645585,24,46482.1321,2582.340672,1936.755504,268.908114,3,4
0,0,14,14,18,31,49,93,54,147,0.000333,0.275121,9,7428.261124,412.681174,825.362347,228.638736,5,4
0,0,19,19,18,37,55,126,78,204,0.000333,0.393132,18,21229.15287,1179.397382,1179.397382,267.808425,3,4
0,0,13,13,17,31,48,94,53,147,0.000333,0.273663,8,6567.915901,364.884217,820.989488,223.066954,4,4
0,0,32,32,20,45,65,213,112,325,0.000333,0.652423,20,39145.39079,2174.743932,1957.269539,333.571951,10,4
0,0,22,22,18,39,57,159,84,243,0.000333,0.472464,18,25513.06092,1417.392273,1417.392273,281.189337,6,4
0,0,42,42,18,46,64,287,168,455,0.000333,0.91,27,73710,4095,2730,329.1425,3,4
0,0,23,23,18,37,55,157,82,239,0.000333,0.460582,18,24871.40949,1381.744972,1381.744972,267.808425,8,4
0,0,13,13,17,30,47,91,52,143,0.000333,0.264769,8,6354.449646,353.02498,794.306206,216.693586,4,4
0,0,21,21,17,37,54,139,80,219,0.000333,0.420107,16,20165.12581,1120.284767,1260.320363,262.236643,3,4
0,0,14,14,17,30,47,97,54,151,0.000333,0.279581,8,6709.943333,372.77463,838.742917,216.693586,5,4
0,0,18,18,16,32,48,128,80,208,0.000333,0.387224,16,18586.7552,1032.597511,1161.6722,224,3,4
0,0,14,14,17,30,47,122,53,175,0.000333,0.324018,8,7776.424392,432.023577,972.053049,216.693586,5,4
0,0,28,28,17,41,58,179,93,272,0.000333,0.531124,16,25493.93329,1416.329627,1593.370831,289.1465,8,4
0,0,14,14,18,31,49,93,54,147,0.000333,0.275121,9,7428.261124,412.681174,825.362347,228.638736,6,4
0,0,19,19,21,36,57,127,77,204,0.000333,0.396637,20,23798.19126,1322.121737,1189.909563,278.355966,5,4
0,0,14,14,18,32,50,99,55,154,0.000333,0.289718,9,7822.384679,434.576927,869.153853,235.05865,5,4
0,0,15,15,16,31,47,114,67,181,0.000333,0.335127,16,16086.08931,893.671629,1005.380582,217.580086,3,4
0,0,13,13,16,32,48,82,55,137,0.000333,0.255047,8,6121.118901,340.062161,765.139863,224,7,4
0,0,14,14,17,30,47,92,53,145,0.000333,0.268472,8,6443.323068,357.962393,805.415383,216.693586,5,4
0,0,15,15,16,32,48,108,69,177,0.000333,0.329513,16,15816.6138,878.700767,988.538363,224,4,4
0,0,13,13,16,32,48,82,55,137,0.000333,0.255047,8,6121.118901,340.062161,765.139863,224,5,4
0,0,31,31,18,51,69,171,96,267,0.000333,0.543659,9,14678.78427,815.488015,1630.97603,364.352342,10,4
0,0,22,22,18,43,61,112,66,178,0.000333,0.35189,9,9501.041215,527.835623,1055.671246,308.388034,6,4
0,0,22,22,20,36,56,147,77,224,0.000333,0.433616,20,26016.95005,1445.386114,1300.847503,272.555862,11,4
0,0,24,24,17,31,48,102,65,167,0.000333,0.310896,16,14923.0198,829.056656,932.688738,223.066954,7,4
0,0,33,33,18,40,58,161,95,256,0.000333,0.499881,18,26993.57643,1499.643135,1499.643135,287.935774,11,4
0,0,23,23,20,34,54,133,90,223,0.000333,0.42778,20,25666.79826,1425.933237,1283.339913,259.412299,12,4
0,0,43,43,16,44,60,225,150,375,0.000333,0.738361,24,53162.01536,2953.445298,2215.083973,304.214991,3,4
0,0,39,39,16,39,55,200,141,341,0.000333,0.657148,24,47314.6479,2628.59155,1971.443662,270.130687,3,4
0,0,23,23,20,34,54,133,90,223,0.000333,0.42778,20,25666.79826,1425.933237,1283.339913,259.412299,12,4
0,0,50,50,16,43,59,270,179,449,0.000333,0.880436,32,84521.81533,4695.656407,2641.306729,297.329384,6,4
0,0,49,49,16,43,59,266,175,441,0.000333,0.864749,32,83015.85871,4611.992151,2594.245585,297.329384,6,4
0,0,23,23,20,34,54,133,90,223,0.000333,0.42778,20,25666.79826,1425.933237,1283.339913,259.412299,12,4
0,0,41,41,17,43,60,248,146,394,0.000333,0.775772,24,55855.55747,3103.086526,2327.314895,302.816253,3,4
0,0,41,41,17,43,60,247,144,391,0.000333,0.769865,24,55430.26135,3079.458964,2309.594223,302.816253,3,4
0,0,30,30,17,38,55,150,86,236,0.000333,0.4548,16,21830.41428,1212.800793,1364.400892,268.908114,10,4
0,0,21,21,16,30,46,91,56,147,0.000333,0.270655,8,6495.70886,360.872714,811.963608,211.206718,6,4
0,0,19,19,15,22,37,82,45,127,0.000333,0.220534,14,9262.408084,514.578227,661.600577,156.710855,6,4
0,0,15,15,19,22,41,135,73,208,0.000333,0.371457,27,30088.01206,1671.556225,1114.370817,178.818118,4,4
0,0,27,27,20,42,62,153,90,243,0.000333,0.48229,20,28937.39407,1607.633004,1446.869703,312.915894,10,4
0,0,23,23,20,34,54,133,90,223,0.000333,0.42778,20,25666.79826,1425.933237,1283.339913,259.412299,12,4
0,0,54,54,18,53,71,283,194,477,0.000333,0.97781,27,79202.59315,4400.144064,2933.429376,378.638434,8,4
0,0,60,60,18,54,72,308,213,521,0.000333,1.07151,27,86792.335,4821.796389,3214.530926,385.822575,8,4
0,0,12,12,15,22,37,73,46,119,0.000333,0.206642,14,8678.949307,482.16385,619.924951,156.710855,3,4
0,0,6,6,11,19,30,43,28,71,0.000333,0.11613,5,1741.946161,96.774787,348.389232,118.764371,1,4
0,0,39,39,22,50,72,227,134,361,0.000333,0.742448,22,49001.54436,2722.30802,2227.342926,380.300305,4,4
0,0,9,9,16,23,39,65,42,107,0.000333,0.188513,8,4524.304299,251.350239,565.538037,168.041925,2,4
0,0,18,18,16,34,50,83,53,136,0.000333,0.255855,8,6140.515534,341.139752,767.564442,236.973737,5,4
0,0,23,23,20,34,54,133,90,223,0.000333,0.42778,20,25666.79826,1425.933237,1283.339913,259.412299,12,4
0,0,27,27,17,43,60,142,83,225,0.000333,0.443017,8,10632.40307,590.68906,1329.050384,302.816253,9,4
0,0,66,66,19,57,76,344,227,571,0.000333,1.189189,27,96324.29848,5351.349915,3567.56661,413.185354,10,4
0,0,64,64,20,61,81,343,225,568,0.000333,1.200345,30,108031.044,6001.724669,3601.034802,448.213539,11,4
0,0,19,19,15,22,37,82,45,127,0.000333,0.220534,14,9262.408084,514.578227,661.600577,156.710855,6,4
0,0,28,28,17,31,48,141,75,216,0.000333,0.402117,16,19301.6304,1072.3128,1206.3519,223.066954,10,4
0,0,15,15,19,22,41,135,73,208,0.000333,0.371457,27,30088.01206,1671.556225,1114.370817,178.818118,3,4
0,0,6,6,11,19,30,43,28,71,0.000333,0.11613,5,1741.946161,96.774787,348.389232,118.764371,1,4
0,0,12,12,15,22,37,73,46,119,0.000333,0.206642,14,8678.949307,482.16385,619.924951,156.710855,3,4
0,0,37,37,23,48,71,221,131,352,0.000333,0.72157,22,47623.64169,2645.757872,2164.710986,372.120125,7,4
0,0,9,9,16,23,39,65,42,107,0.000333,0.188513,8,4524.304299,251.350239,565.538037,168.041925,2,4
0,0,15,15,19,22,41,132,73,205,0.000333,0.366099,27,29654.05035,1647.447241,1098.298161,178.818118,4,4
0,0,6,6,11,19,30,43,28,71,0.000333,0.11613,5,1741.946161,96.774787,348.389232,118.764371,1,4
0,0,12,12,15,22,37,73,46,119,0.000333,0.206642,14,8678.949307,482.16385,619.924951,156.710855,3,4
0,0,31,31,24,40,64,181,108,289,0.000333,0.578,24,41616,2312,1734,322.916224,11,4
0,0,9,9,16,23,39,65,42,107,0.000333,0.188513,8,4524.304299,251.350239,565.538037,168.041925,2,4
0,0,19,19,17,37,54,92,57,149,0.000333,0.285826,8,6859.825903,381.101439,857.478238,262.236643,5,4
0,0,28,28,17,45,62,151,87,238,0.000333,0.472366,8,11336.78978,629.821654,1417.098722,316.620258,9,4
0,0,22,22,19,25,44,177,97,274,0.000333,0.498628,27,40388.87512,2243.826395,1495.884264,196.807027,3,4
0,0,15,15,18,23,41,136,74,210,0.000333,0.375029,27,30377.31987,1687.628881,1125.085921,179.100575,3,4
0,0,15,15,16,22,38,100,52,152,0.000333,0.265895,16,12762.95971,709.053317,797.684982,162.107496,7,4
0,0,16,16,18,24,42,136,77,213,0.000333,0.382855,27,31011.2175,1722.845417,1148.563611,185.09775,3,4
0,0,23,23,20,34,54,133,90,223,0.000333,0.42778,20,25666.79826,1425.933237,1283.339913,259.412299,12,4
0,0,41,41,18,44,62,224,147,371,0.000333,0.736336,27,59643.18444,3313.510247,2209.006831,315.273641,4,4
0,0,41,41,18,44,62,223,145,368,0.000333,0.730381,27,59160.89454,3286.716363,2191.144242,315.273641,4,4
0,0,23,23,22,31,53,151,82,233,0.000333,0.444868,22,29361.32025,1631.184458,1334.605466,251.687581,10,4
0,0,39,39,19,36,55,286,160,446,0.000333,0.859495,36,92825.51156,5156.972864,2578.486432,266.827923,6,4
0,0,19,19,15,25,40,82,51,133,0.000333,0.235939,14,9909.430113,550.523895,707.816437,174.699764,6,4
0,0,28,28,17,34,51,141,81,222,0.000333,0.419759,16,20148.45482,1119.358601,1259.278426,242.460605,10,4
0,0,22,22,20,34,54,178,93,271,0.000333,0.519858,20,31191.49026,1732.86057,1559.574513,259.412299,11,4
0,0,34,34,19,37,56,271,153,424,0.000333,0.820773,36,88643.46553,4924.636974,2462.318487,273.460397,9,4
0,0,26,26,20,36,56,145,85,230,0.000333,0.445231,20,26713.83264,1484.101813,1335.691632,272.555862,12,4
0,0,30,30,17,38,55,149,85,234,0.000333,0.450946,16,21645.41077,1202.52282,1352.838173,268.908114,10,4
0,0,21,21,16,29,45,90,55,145,0.000333,0.26544,8,6370.549592,353.919422,796.318699,204.881449,6,4
0,0,17,17,17,32,49,84,51,135,0.000333,0.252662,8,6063.886632,336.882591,757.985829,229.486868,5,4
0,0,26,26,17,40,57,143,81,224,0.000333,0.435522,16,20905.07781,1161.393212,1306.567363,282.363992,9,4
0,0,23,23,20,34,54,133,90,223,0.000333,0.42778,20,25666.79826,1425.933237,1283.339913,259.412299,12,4
0,0,22,22,17,41,58,105,63,168,0.000333,0.328047,8,7873.126457,437.395914,984.140807,289.1465,6,4
0,0,31,31,18,50,68,164,93,257,0.000333,0.521493,9,14080.30155,782.238975,1564.47795,357.25146,10,4
0,0,41,41,18,44,62,224,147,371,0.000333,0.736336,27,59643.18444,3313.510247,2209.006831,315.273641,3,4
0,0,41,41,18,44,62,223,145,368,0.000333,0.730381,27,59160.89454,3286.716363,2191.144242,315.273641,3,4
0,0,17,17,17,32,49,84,51,135,0.000333,0.252662,8,6063.886632,336.882591,757.985829,229.486868,5,4
0,0,26,26,17,40,57,143,81,224,0.000333,0.435522,16,20905.07781,1161.393212,1306.567363,282.363992,9,4
0,0,17,17,18,23,41,156,85,241,0.000333,0.43039,27,34861.59089,1936.75505,1291.170033,179.100575,3,4
0,0,15,15,19,22,41,132,73,205,0.000333,0.366099,27,29654.05035,1647.447241,1098.298161,178.818118,3,4
0,0,6,6,11,19,30,43,28,71,0.000333,0.11613,5,1741.946161,96.774787,348.389232,118.764371,1,4
0,0,12,12,15,22,37,73,46,119,0.000333,0.206642,14,8678.949307,482.16385,619.924951,156.710855,3,4
0,0,9,9,16,23,39,65,42,107,0.000333,0.188513,8,4524.304299,251.350239,565.538037,168.041925,2,4
0,0,24,24,21,35,56,151,91,242,0.000333,0.46846,20,28107.59782,1561.533212,1405.379891,271.763571,8,4
0,0,28,28,16,44,60,125,81,206,0.000333,0.405606,8,9734.555702,540.80865,1216.819463,304.214991,7,4
0,0,36,36,17,53,70,181,107,288,0.000333,0.588411,16,28243.73614,1569.096452,1765.233509,373.066652,11,4
0,0,31,31,18,42,60,160,91,251,0.000333,0.49421,18,26687.33171,1482.629539,1482.629539,301.535982,11,4
0,0,22,22,16,34,50,101,61,162,0.000333,0.304768,8,7314.437622,406.357646,914.304703,236.973737,7,4
0,0,22,22,18,26,44,173,100,273,0.000333,0.496808,27,40241.47046,2235.637248,1490.424832,197.270083,3,4
0,0,6,6,11,19,30,43,28,71,0.000333,0.11613,5,1741.946161,96.774787,348.389232,118.764371,1,4
0,0,12,12,15,22,37,73,46,119,0.000333,0.206642,14,8678.949307,482.16385,619.924951,156.710855,3,4
0,0,9,9,16,23,39,65,42,107,0.000333,0.188513,8,4524.304299,251.350239,565.538037,168.041925,2,4
0,0,35,35,22,44,66,223,129,352,0.000333,0.709209,22,46807.78806,2600.43267,2127.62673,338.322487,17,4
0,0,6,6,11,19,30,43,28,71,0.000333,0.11613,5,1741.946161,96.774787,348.389232,118.764371,1,4
0,0,12,12,15,22,37,73,46,119,0.000333,0.206642,14,8678.949307,482.16385,619.924951,156.710855,3,4
0,0,9,9,16,23,39,65,42,107,0.000333,0.188513,8,4524.304299,251.350239,565.538037,168.041925,2,4
0,0,18,18,23,29,52,123,71,194,0.000333,0.368628,22,24329.47672,1351.637595,1105.885305,244.923374,7,4
0,0,12,12,15,22,37,73,46,119,0.000333,0.206642,14,8678.949307,482.16385,619.924951,156.710855,3,4
0,0,6,6,11,19,30,43,28,71,0.000333,0.11613,5,1741.946161,96.774787,348.389232,118.764371,1,4
0,0,9,9,16,23,39,65,42,107,0.000333,0.188513,8,4524.304299,251.350239,565.538037,168.041925,2,4
0,0,24,24,26,33,59,157,89,246,0.000333,0.482377,26,37625.38494,2090.299164,1447.13019,288.676439,4,4
0,0,17,17,17,33,50,85,52,137,0.000333,0.257736,8,6185.666384,343.648132,773.208298,235.951874,5,4
0,0,26,26,17,41,58,144,82,226,0.000333,0.441301,16,21182.45928,1176.803293,1323.903705,289.1465,9,4
0,0,12,12,15,22,37,73,46,119,0.000333,0.206642,14,8678.949307,482.16385,619.924951,156.710855,3,4
0,0,6,6,11,19,30,43,28,71,0.000333,0.11613,5,1741.946161,96.774787,348.389232,118.764371,1,4
0,0,40,40,22,48,70,251,146,397,0.000333,0.811108,33,80299.73681,4461.096489,2433.325358,366.185696,12,4
0,0,9,9,16,23,39,65,42,107,0.000333,0.188513,8,4524.304299,251.350239,565.538037,168.041925,2,4
0,0,6,6,11,19,30,43,28,71,0.000333,0.11613,5,1741.946161,96.774787,348.389232,118.764371,1,4
0,0,12,12,15,22,37,73,46,119,0.000333,0.206642,14,8678.949307,482.16385,619.924951,156.710855,3,4
0,0,24,24,23,35,58,153,91,244,0.000333,0.476449,22,31445.64198,1746.98011,1429.347363,283.566831,4,4
0,0,9,9,16,23,39,65,42,107,0.000333,0.188513,8,4524.304299,251.350239,565.538037,168.041925,2,4
0,0,15,15,19,22,41,132,73,205,0.000333,0.366099,27,29654.05035,1647.447241,1098.298161,178.818118,5,4
0,0,19,19,16,36,52,86,55,141,0.000333,0.267921,8,6430.096002,357.227556,803.762,250.1173,6,4
0,0,28,28,17,45,62,145,85,230,0.000333,0.456488,8,10955.72121,608.651178,1369.465151,316.620258,10,4
0,0,23,23,20,34,54,133,90,223,0.000333,0.42778,20,25666.79826,1425.933237,1283.339913,259.412299,12,4
0,0,62,62,19,57,76,337,222,559,0.000333,1.164197,27,94299.96996,5238.88722,3492.59148,413.185354,11,4
0,0,62,62,19,57,76,336,220,556,0.000333,1.157949,27,93793.88783,5210.771546,3473.847697,413.185354,11,4
0,0,26,26,20,42,62,168,93,261,0.000333,0.518015,20,31080.90474,1726.71693,1554.045237,312.915894,9,4
0,0,29,29,17,36,53,146,83,229,0.000333,0.437231,16,20987.10055,1165.95003,1311.693784,255.604168,11,4
0,0,20,20,16,27,43,87,53,140,0.000333,0.253226,8,6077.416525,337.634251,759.677066,192.381963,7,4
0,0,19,19,15,25,40,82,51,133,0.000333,0.235939,14,9909.430113,550.523895,707.816437,174.699764,6,4
0,0,28,28,17,34,51,141,81,222,0.000333,0.419759,16,20148.45482,1119.358601,1259.278426,242.460605,10,4
0,0,24,24,19,36,55,130,76,206,0.000333,0.396987,18,21437.28182,1190.960101,1190.960101,266.827923,12,4
0,0,19,19,20,33,53,116,67,183,0.000333,0.349403,20,20964.18886,1164.677159,1048.209443,252.903568,9,4
0,0,28,28,21,40,61,175,97,272,0.000333,0.53772,20,32263.21112,1792.400618,1613.160556,305.11579,13,4
0,0,27,27,17,42,59,141,82,223,0.000333,0.437276,8,10494.6352,583.035289,1311.8294,295.9642,9,4
0,0,18,18,16,33,49,82,52,134,0.000333,0.25079,8,6018.968953,334.387164,752.371119,230.465006,5,4
0,0,23,23,20,34,54,133,90,223,0.000333,0.42778,20,25666.79826,1425.933237,1283.339913,259.412299,12,4
0,0,62,62,17,51,68,336,218,554,0.000333,1.124151,32,107918.5413,5995.474514,3372.454414,358.780561,4,4
0,0,58,58,17,49,66,320,207,527,0.000333,1.061799,32,101932.6624,5662.92569,3185.395701,344.607651,4,4
0,0,12,12,20,25,45,83,46,129,0.000333,0.23615,10,7084.490494,393.582805,708.449049,202.534967,5,4
0,0,5,5,12,12,24,26,16,42,0.000333,0.064189,6,1155.41055,64.189475,192.568425,86.0391,2,4
0,0,35,35,25,43,68,207,118,325,0.000333,0.659475,24,47482.21016,2637.900565,1978.425423,349.425789,9,4
0,0,9,9,14,13,27,53,29,82,0.000333,0.129967,14,5458.610852,303.256158,389.900775,101.408685,2,4
0,0,20,20,20,40,60,129,76,205,0.000333,0.403638,10,12109.12572,672.729207,1210.912572,299.315686,10,4
0,0,29,29,21,47,68,188,106,294,0.000333,0.596571,20,35794.28151,1988.571195,1789.714075,353.304342,14,4
0,0,22,22,20,33,53,129,87,216,0.000333,0.41241,20,24744.61636,1374.700909,1237.230818,252.903568,12,4
0,0,25,25,17,38,55,138,79,217,0.000333,0.418185,16,20072.88093,1115.160051,1254.555058,268.908114,9,4
0,0,16,16,16,30,46,79,49,128,0.000333,0.235672,8,5656.127443,314.229302,707.01593,211.206718,5,4
0,0,23,23,20,34,54,133,90,223,0.000333,0.42778,20,25666.79826,1425.933237,1283.339913,259.412299,12,4
0,0,53,53,17,47,64,281,190,471,0.000333,0.942,32,90432,5024,2826,330.552544,4,4
0,0,54,54,17,47,64,295,197,492,0.000333,0.984,32,94464,5248,2952,330.552544,4,4
0,0,20,20,16,25,41,88,48,136,0.000333,0.242876,8,5829.016581,323.834255,728.627073,180.096405,6,4
0,0,29,29,17,34,51,147,78,225,0.000333,0.425432,16,20420.73123,1134.485068,1276.295702,242.460605,10,4
0,0,15,15,18,22,40,136,74,210,0.000333,0.372535,27,30175.3323,1676.40735,1117.6049,173.166146,3,4
0,0,6,6,11,19,30,43,28,71,0.000333,0.11613,5,1741.946161,96.774787,348.389232,118.764371,1,4
0,0,12,12,15,22,37,73,46,119,0.000333,0.206642,14,8678.949307,482.16385,619.924951,156.710855,3,4
0,0,39,39,23,46,69,248,146,394,0.000333,0.802253,33,79423.03499,4412.390833,2406.758636,358.125775,16,4
0,0,9,9,16,23,39,65,42,107,0.000333,0.188513,8,4524.304299,251.350239,565.538037,168.041925,2,4
0,0,20,20,19,27,46,169,95,264,0.000333,0.486073,27,39371.94962,2187.330535,1458.220356,209.092585,3,4
0,0,6,6,7,11,18,41,25,66,0.000333,0.091738,6,1651.290301,91.73835,275.21505,57.705232,1,4
0,0,29,29,17,33,50,146,77,223,0.000333,0.419527,16,20137.27889,1118.737716,1258.57993,235.951874,10,4
0,0,20,20,16,24,40,87,47,134,0.000333,0.237713,8,5705.106918,316.950384,713.138365,174.0391,6,4
0,0,33,33,19,39,58,248,138,386,0.000333,0.753727,27,61051.87793,3391.770996,2261.180664,286.841309,3,4
0,0,20,20,19,26,45,138,74,212,0.000333,0.388091,18,20956.91142,1164.272856,1164.272856,202.922055,9,4
0,0,30,30,18,30,48,240,134,374,0.000333,0.696259,36,75195.93511,4177.551951,2088.775975,222.265368,3,4
0,0,35,35,17,51,68,179,106,285,0.000333,0.578309,16,27758.83056,1542.157253,1734.92691,358.780561,10,4
0,0,27,27,16,43,59,123,80,203,0.000333,0.398059,8,9553.412312,530.745128,1194.176539,297.329384,6,4
0,0,19,19,22,28,50,143,75,218,0.000333,0.41012,22,27067.93429,1503.774127,1230.360649,232.713433,8,4
0,0,20,20,16,24,40,87,47,134,0.000333,0.237713,8,5705.106918,316.950384,713.138365,174.0391,6,4
0,0,29,29,17,33,50,146,77,223,0.000333,0.419527,16,20137.27889,1118.737716,1258.57993,235.951874,10,4
0,0,48,48,19,47,66,358,198,556,0.000333,1.120228,36,120984.5927,6721.366261,3360.68313,341.776299,3,4
0,0,20,20,16,27,43,87,53,140,0.000333,0.253226,8,6077.416525,337.634251,759.677066,192.381963,6,4
0,0,29,29,17,36,53,146,83,229,0.000333,0.437231,16,20987.10055,1165.95003,1311.693784,255.604168,10,4
0,0,34,34,21,50,71,265,106,371,0.000333,0.760519,20,45631.12363,2535.062424,2281.556181,374.431475,8,4
0,0,44,44,22,57,79,319,134,453,0.000333,0.951871,22,62823.47894,3490.193274,2855.612679,430.582226,12,4
0,0,20,20,17,30,47,101,60,161,0.000333,0.298096,16,14308.62088,794.923382,894.288805,216.693586,6,4
0,0,29,29,18,38,56,160,90,250,0.000333,0.483946,18,26133.09715,1451.838731,1451.838731,274.479896,10,4
0,0,6,6,11,19,30,43,28,71,0.000333,0.11613,5,1741.946161,96.774787,348.389232,118.764371,1,4
0,0,12,12,15,22,37,73,46,119,0.000333,0.206642,14,8678.949307,482.16385,619.924951,156.710855,3,4
0,0,9,9,16,23,39,65,42,107,0.000333,0.188513,8,4524.304299,251.350239,565.538037,168.041925,2,4
0,0,32,32,23,41,64,207,121,328,0.000333,0.656,22,43296,2405.333333,1968,323.701557,7,4
0,0,18,18,16,33,49,82,52,134,0.000333,0.25079,8,6018.968953,334.387164,752.371119,230.465006,5,4
0,0,27,27,17,42,59,141,82,223,0.000333,0.437276,8,10494.6352,583.035289,1311.8294,295.9642,9,4
0,0,23,23,20,34,54,133,90,223,0.000333,0.42778,20,25666.79826,1425.933237,1283.339913,259.412299,12,4
0,0,61,61,17,50,67,328,212,540,0.000333,1.091896,32,104822.0212,5823.445623,3275.688163,351.679678,4,4
0,0,64,64,17,52,69,342,224,566,0.000333,1.152475,32,110637.595,6146.533053,3457.424843,365.909734,4,4
0,0,6,6,11,19,30,43,28,71,0.000333,0.11613,5,1741.946161,96.774787,348.389232,118.764371,1,4
0,0,12,12,15,22,37,73,46,119,0.000333,0.206642,14,8678.949307,482.16385,619.924951,156.710855,3,4
0,0,9,9,16,23,39,65,42,107,0.000333,0.188513,8,4524.304299,251.350239,565.538037,168.041925,2,4
0,0,21,21,21,31,52,125,79,204,0.000333,0.38763,20,23257.79405,1292.099669,1162.889703,245.818752,4,4
0,0,12,12,15,22,37,73,46,119,0.000333,0.206642,14,8678.949307,482.16385,619.924951,156.710855,3,4
0,0,6,6,11,19,30,43,28,71,0.000333,0.11613,5,1741.946161,96.774787,348.389232,118.764371,1,4
0,0,22,22,24,34,58,135,82,217,0.000333,0.423727,24,30508.36502,1694.909168,1271.181876,283.012837,4,4
0,0,9,9,16,23,39,65,42,107,0.000333,0.188513,8,4524.304299,251.350239,565.538037,168.041925,2,4
0,0,29,29,17,48,65,150,89,239,0.000333,0.479782,8,11514.76726,639.709292,1439.345907,337.565068,10,4
0,0,20,20,16,39,55,91,59,150,0.000333,0.289068,8,6937.631656,385.423981,867.203957,270.130687,6,4
0,0,23,23,20,34,54,133,90,223,0.000333,0.42778,20,25666.79826,1425.933237,1283.339913,259.412299,12,4
0,0,55,55,17,52,69,289,193,482,0.000333,0.981436,24,70663.41092,3925.745051,2944.308788,365.909734,7,4
0,0,67,67,17,58,75,354,233,587,0.000333,1.218772,32,117002.1303,6500.118349,3656.316571,409.249766,8,4
0,0,23,23,20,34,54,133,90,223,0.000333,0.42778,20,25666.79826,1425.933237,1283.339913,259.412299,12,4
0,0,42,42,17,43,60,221,148,369,0.000333,0.726548,24,52311.42312,2906.190173,2179.64263,302.816253,3,4
0,0,39,39,17,42,59,209,139,348,0.000333,0.682387,24,49131.83475,2729.546375,2047.159781,295.9642,3,4
0,0,6,6,11,19,30,43,28,71,0.000333,0.11613,5,1741.946161,96.774787,348.389232,118.764371,1,4
0,0,12,12,15,22,37,73,46,119,0.000333,0.206642,14,8678.949307,482.16385,619.924951,156.710855,3,4
0,0,9,9,16,23,39,65,42,107,0.000333,0.188513,8,4524.304299,251.350239,565.538037,168.041925,2,4
0,0,18,18,22,28,50,117,70,187,0.000333,0.3518,22,23218.82437,1289.934687,1055.401107,232.713433,4,4
0,0,6,6,11,19,30,43,28,71,0.000333,0.11613,5,1741.946161,96.774787,348.389232,118.764371,1,4
0,0,12,12,15,22,37,73,46,119,0.000333,0.206642,14,8678.949307,482.16385,619.924951,156.710855,3,4
0,0,9,9,16,23,39,65,42,107,0.000333,0.188513,8,4524.304299,251.350239,565.538037,168.041925,2,4
0,0,21,21,21,30,51,137,80,217,0.000333,0.410305,20,24618.32598,1367.684777,1230.916299,239.445384,8,4
0,0,27,27,17,43,60,148,85,233,0.000333,0.458769,8,11010.44407,611.691337,1376.305509,302.816253,9,4
0,0,18,18,17,35,52,89,55,144,0.000333,0.273621,8,6566.906555,364.828142,820.863319,249.011774,5,4
0,0,29,29,20,41,61,178,97,275,0.000333,0.543651,20,32619.05536,1812.169742,1630.952768,306.098194,12,4
0,0,6,6,11,19,30,43,28,71,0.000333,0.11613,5,1741.946161,96.774787,348.389232,118.764371,1,4
0,0,12,12,15,22,37,73,46,119,0.000333,0.206642,14,8678.949307,482.16385,619.924951,156.710855,3,4
0,0,18,18,21,28,49,124,70,194,0.000333,0.363085,20,21785.0742,1210.2819,1089.25371,226.844604,4,4
0,0,9,9,16,23,39,65,42,107,0.000333,0.188513,8,4524.304299,251.350239,565.538037,168.041925,2,4
0,0,5,5,10,18,28,32,23,55,0.000333,0.088135,5,1322.022604,73.4457,264.404521,108.277931,1,4
0,0,11,11,14,20,34,63,39,102,0.000333,0.172974,7,3632.448469,201.802693,518.92121,139.741531,3,4
0,0,24,24,22,33,55,139,84,223,0.000333,0.429748,22,28363.35076,1575.741709,1289.243216,264.572502,4,4
0,0,9,9,16,23,39,65,42,107,0.000333,0.188513,8,4524.304299,251.350239,565.538037,168.041925,2,4
0,0,20,20,20,31,51,120,81,201,0.000333,0.380052,20,22803.14988,1266.84166,1140.157494,240.018648,9,4
0,0,45,45,26,55,81,275,159,434,0.000333,0.917165,26,71538.86743,3974.381524,2751.494901,440.186217,23,4
0,0,56,56,18,51,69,293,195,488,0.000333,0.993653,27,80485.91824,4471.439902,2980.959935,364.352342,6,4
0,0,56,56,18,51,69,294,197,491,0.000333,0.999762,27,80980.70872,4498.928262,2999.285508,364.352342,6,4
0,0,25,25,20,40,60,142,86,228,0.000333,0.448924,20,26935.42112,1496.412284,1346.771056,299.315686,9,4
0,0,22,22,20,33,53,129,87,216,0.000333,0.41241,20,24744.61636,1374.700909,1237.230818,252.903568,12,4
0,0,50,50,17,48,65,271,180,451,0.000333,0.905363,24,65186.10921,3621.450512,2716.087884,337.565068,4,4
0,0,56,56,17,49,66,296,199,495,0.000333,0.997325,32,95743.20285,5319.066825,2991.975089,344.607651,4,4
0,0,5,5,10,18,28,32,23,55,0.000333,0.088135,5,1322.022604,73.4457,264.404521,108.277931,1,4
0,0,11,11,14,20,34,63,39,102,0.000333,0.172974,7,3632.448469,201.802693,518.92121,139.741531,3,4
0,0,9,9,16,23,39,65,42,107,0.000333,0.188513,8,4524.304299,251.350239,565.538037,168.041925,2,4
0,0,26,26,23,36,59,159,92,251,0.000333,0.492181,22,32483.95492,1804.664162,1476.543405,290.159225,4,4
0,0,23,23,16,28,44,94,55,149,0.000333,0.271152,8,6507.642489,361.535694,813.455311,198.605938,7,4
0,0,32,32,18,39,57,154,85,239,0.000333,0.464687,18,25093.09284,1394.060713,1394.060713,281.189337,11,4
0,0,21,21,20,32,52,165,85,250,0.000333,0.475037,20,28502.19859,1583.455477,1425.10993,246.438562,15,4
0,0,42,42,20,47,67,326,181,507,0.000333,1.025169,30,92265.21659,5125.845366,3075.50722,347.504238,14,4
0,0,18,18,18,25,43,409,62,471,0.000333,0.851924,18,46003.87259,2555.770699,2555.770699,191.155055,8,4
0,0,5,5,10,18,28,32,23,55,0.000333,0.088135,5,1322.022604,73.4457,264.404521,108.277931,1,4
0,0,11,11,14,20,34,63,39,102,0.000333,0.172974,7,3632.448469,201.802693,518.92121,139.741531,3,4
0,0,9,9,16,23,39,65,42,107,0.000333,0.188513,8,4524.304299,251.350239,565.538037,168.041925,2,4
0,0,19,19,21,30,51,121,74,195,0.000333,0.368708,20,22122.45883,1229.025491,1106.122942,239.445384,4,4
0,0,28,28,17,33,50,138,72,210,0.000333,0.39507,16,18963.3568,1053.519822,1185.2098,235.951874,10,4
0,0,19,19,15,22,37,78,42,120,0.000333,0.208378,7,4375.940827,243.107824,625.134404,156.710855,6,4
0,0,40,40,19,46,65,305,166,471,0.000333,0.945512,27,76586.45148,4254.80286,2836.53524,334.794473,3,4
0,0,26,26,17,42,59,139,79,218,0.000333,0.427472,8,10259.32948,569.962749,1282.416185,295.9642,9,4
0,0,17,17,17,32,49,79,49,128,0.000333,0.239561,8,5749.46288,319.414604,718.68286,229.486868,5,4
0,0,5,5,10,18,28,32,23,55,0.000333,0.088135,5,1322.022604,73.4457,264.404521,108.277931,1,4
0,0,11,11,14,20,34,63,39,102,0.000333,0.172974,7,3632.448469,201.802693,518.92121,139.741531,3,4
0,0,9,9,16,23,39,65,42,107,0.000333,0.188513,8,4524.304299,251.350239,565.538037,168.041925,2,4
0,0,32,32,21,37,58,217,125,342,0.000333,0.66781,30,60102.88501,3339.049167,2003.4295,284.98844,6,4
0,0,16,16,16,30,46,73,46,119,0.000333,0.219101,8,5258.430982,292.135055,657.303873,211.206718,5,4
0,0,5,5,10,18,28,32,23,55,0.000333,0.088135,5,1322.022604,73.4457,264.404521,108.277931,1,4
0,0,11,11,14,20,34,63,39,102,0.000333,0.172974,7,3632.448469,201.802693,518.92121,139.741531,3,4
0,0,33,33,21,39,60,223,129,352,0.000333,0.693075,30,62376.76469,3465.375816,2079.22549,298.369352,4,4
0,0,9,9,16,23,39,65,42,107,0.000333,0.188513,8,4524.304299,251.350239,565.538037,168.041925,2,4
0,0,21,21,22,29,51,157,88,245,0.000333,0.463248,33,45861.55889,2547.864383,1389.744209,238.988944,3,4
0,0,22,22,20,33,53,129,87,216,0.000333,0.41241,20,24744.61636,1374.700909,1237.230818,252.903568,12,4
0,0,60,60,18,52,70,316,212,528,0.000333,1.078754,36,116505.4116,6472.522866,3236.261433,371.481515,4,4
0,0,51,51,18,52,70,273,183,456,0.000333,0.931651,27,75463.73251,4192.429584,2794.953056,371.481515,3,4
0,0,22,22,20,33,53,129,87,216,0.000333,0.41241,20,24744.61636,1374.700909,1237.230818,252.903568,12,4
0,0,44,44,16,43,59,231,159,390,0.000333,0.764744,24,55061.53894,3058.974386,2294.230789,297.329384,4,4
0,0,51,51,16,44,60,267,183,450,0.000333,0.886034,32,85059.22458,4725.512476,2658.100768,304.214991,4,4
0,0,16,16,17,31,48,76,47,123,0.000333,0.228983,8,5495.603101,305.311283,686.950388,223.066954,5,4
0,0,25,25,17,41,58,136,77,213,0.000333,0.415917,8,9981.999616,554.555534,1247.749952,289.1465,9,4
0,0,22,22,20,33,53,129,87,216,0.000333,0.41241,20,24744.61636,1374.700909,1237.230818,252.903568,12,4
0,0,53,53,16,46,62,281,192,473,0.000333,0.938778,32,90122.71535,5006.81752,2816.334855,318.08385,4,4
0,0,48,48,16,46,62,249,172,421,0.000333,0.835572,24,60161.19952,3342.288862,2506.716647,318.08385,4,4
0,0,18,18,18,25,43,150,84,234,0.000333,0.423249,27,34283.14072,1904.618929,1269.745953,191.155055,5,4
0,0,18,18,14,20,34,73,40,113,0.000333,0.191628,14,8048.366215,447.131456,574.883301,139.741531,6,4
0,0,27,27,17,31,48,133,70,203,0.000333,0.377916,16,18139.9582,1007.775456,1133.747388,223.066954,10,4
0,0,18,18,18,25,43,143,80,223,0.000333,0.403352,27,32671.54009,1815.08556,1210.05704,191.155055,3,4
0,0,21,21,15,27,42,86,48,134,0.000333,0.240857,7,5057.993743,280.999652,722.570535,186.985321,7,4
0,0,30,30,17,38,55,146,78,224,0.000333,0.431675,16,20720.39321,1151.132956,1295.024576,268.908114,11,4
0,0,42,42,19,50,69,274,162,436,0.000333,0.887772,27,71909.54991,3994.974995,2663.316663,362.903432,10,4
0,0,28,28,17,37,54,139,79,218,0.000333,0.418188,16,20073.04761,1115.169312,1254.565475,262.236643,10,4
0,0,19,19,15,26,41,79,49,128,0.000333,0.228589,7,4800.366596,266.687033,685.766657,180.814792,6,4
0,0,22,22,20,33,53,129,87,216,0.000333,0.41241,20,24744.61636,1374.700909,1237.230818,252.903568,12,4
0,0,16,16,14,29,43,68,45,113,0.000333,0.204389,7,4292.175421,238.45419,613.167917,194.184418,5,4
0,0,25,25,17,40,57,128,75,203,0.000333,0.394692,8,9472.613383,526.256299,1184.076673,282.363992,9,4
0,0,43,43,16,45,61,217,146,363,0.000333,0.717619,24,51668.58369,2870.476871,2152.857654,311.133389,3,4
0,0,44,44,16,45,61,229,153,382,0.000333,0.755181,24,54372.99991,3020.722217,2265.541663,311.133389,3,4
0,0,22,22,20,33,53,129,87,216,0.000333,0.41241,20,24744.61636,1374.700909,1237.230818,252.903568,12,4
0,0,40,40,17,44,61,211,142,353,0.000333,0.69785,24,50245.20672,2791.400374,2093.55028,309.70186,3,4
0,0,41,41,17,44,61,221,145,366,0.000333,0.72355,24,52095.59677,2894.199821,2170.649866,309.70186,3,4
0,0,20,20,15,27,42,81,50,131,0.000333,0.235465,7,4944.755077,274.708615,706.393582,186.985321,8,4
0,0,29,29,17,38,55,141,80,221,0.000333,0.425893,16,20442.88795,1135.715997,1277.680497,268.908114,12,4
0,0,27,27,21,41,62,161,89,250,0.000333,0.496183,20,29770.98155,1653.94342,1488.549078,311.898298,10,4
0,0,20,20,15,26,41,83,46,129,0.000333,0.230375,7,4837.86946,268.770526,691.124209,180.814792,6,4
0,0,29,29,17,36,53,143,76,219,0.000333,0.418138,16,20070.63327,1115.035182,1254.41458,255.604168,10,4
0,0,19,19,21,28,49,150,85,235,0.000333,0.439819,30,39583.7044,2199.094689,1319.456813,226.844604,4,4
0,0,11,11,14,20,34,63,39,102,0.000333,0.172974,7,3632.448469,201.802693,518.92121,139.741531,3,4
0,0,5,5,10,18,28,32,23,55,0.000333,0.088135,5,1322.022604,73.4457,264.404521,108.277931,1,4
0,0,32,32,21,37,58,217,125,342,0.000333,0.66781,30,60102.88501,3339.049167,2003.4295,284.98844,4,4
0,0,9,9,16,23,39,65,42,107,0.000333,0.188513,8,4524.304299,251.350239,565.538037,168.041925,2,4
0,0,5,5,10,18,28,32,23,55,0.000333,0.088135,5,1322.022604,73.4457,264.404521,108.277931,1,4
0,0,11,11,14,20,34,63,39,102,0.000333,0.172974,7,3632.448469,201.802693,518.92121,139.741531,3,4
0,0,9,9,16,23,39,65,42,107,0.000333,0.188513,8,4524.304299,251.350239,565.538037,168.041925,2,4
0,0,20,20,22,30,52,124,75,199,0.000333,0.378129,22,24956.52509,1386.473616,1134.387504,245.314213,4,4
0,0,19,19,18,28,46,118,63,181,0.000333,0.333255,18,17995.76485,999.764714,999.764714,209.664588,14,4
0,0,23,23,16,30,46,94,61,155,0.000333,0.285384,16,13698.43365,761.024092,856.152103,211.206718,8,4
0,0,32,32,18,41,59,154,91,245,0.000333,0.480416,18,25942.45585,1441.247547,1441.247547,294.718282,12,4
0,0,22,22,20,33,53,129,87,216,0.000333,0.41241,20,24744.61636,1374.700909,1237.230818,252.903568,12,4
0,0,24,24,15,46,61,109,69,178,0.000333,0.35189,7,7389.698723,410.538818,1055.671246,312.687209,6,4
0,0,50,50,16,47,63,261,179,440,0.000333,0.876668,24,63120.07599,3506.670888,2630.003166,325.065676,5,4
0,0,54,54,16,48,64,284,193,477,0.000333,0.954,32,91584,5088,2862,332.0782,5,4
0,0,28,28,17,33,50,138,72,210,0.000333,0.39507,16,18963.3568,1053.519822,1185.2098,235.951874,10,4
0,0,19,19,15,22,37,78,42,120,0.000333,0.208378,7,4375.940827,243.107824,625.134404,156.710855,6,4
0,0,35,35,19,40,59,273,146,419,0.000333,0.821609,27,66550.34082,3697.241157,2464.827438,293.587747,3,4
0,0,12,12,18,18,36,60,33,93,0.000333,0.160268,9,4327.227226,240.401513,480.803025,150.1173,5,4
0,0,19,19,22,24,46,120,67,187,0.000333,0.344302,22,22723.93389,1262.440772,1032.906086,208.146596,6,4
0,0,11,11,15,20,35,58,35,93,0.000333,0.159008,7,3339.163244,185.509069,477.023321,145.041921,2,4
0,0,26,26,24,32,56,160,95,255,0.000333,0.493625,24,35541.01212,1974.500673,1480.875505,270.0391,8,4
0,0,9,9,16,23,39,65,42,107,0.000333,0.188513,8,4524.304299,251.350239,565.538037,168.041925,2,4
0,0,35,35,16,41,57,211,113,324,0.000333,0.629952,16,30237.70183,1679.872324,1889.856365,283.659632,8,4
0,0,11,11,14,20,34,66,42,108,0.000333,0.183149,14,7692.243816,427.346879,549.445987,139.741531,2,4
0,0,22,22,22,36,58,149,84,233,0.000333,0.45497,22,30028.01058,1668.22281,1364.909572,284.224796,6,4
0,0,27,27,20,39,59,130,80,210,0.000333,0.411785,20,24707.10081,1372.616712,1235.35504,292.569248,7,4
0,0,9,9,12,20,32,54,35,89,0.000333,0.148333,6,2670,148.333333,445,129.458112,1,4
0,0,22,22,21,32,53,145,88,233,0.000333,0.444868,20,26692.10932,1482.894962,1334.605466,252.238666,5,4
0,0,11,11,17,24,41,73,47,120,0.000333,0.214302,8,5143.249924,285.736107,642.906241,179.525968,2,4
0,0,26,26,21,30,51,181,105,286,0.000333,0.540771,30,48669.40943,2703.85608,1622.313648,239.445384,16,4
0,0,30,30,21,35,56,216,123,339,0.000333,0.656231,30,59060.79956,3281.155531,1968.693319,271.763571,15,4
0,0,27,27,20,39,59,130,80,210,0.000333,0.411785,20,24707.10081,1372.616712,1235.35504,292.569248,7,4
0,0,18,18,20,24,44,121,70,191,0.000333,0.347584,20,20855.02878,1158.61271,1042.751439,196.477662,6,4
0,0,21,21,19,40,59,129,76,205,0.000333,0.401981,9,10853.47643,602.970913,1205.941825,293.587747,7,4
0,0,27,27,19,48,67,167,88,255,0.000333,0.515618,9,13921.67469,773.426372,1546.852744,348.788823,3,4
0,0,17,17,14,28,42,99,60,159,0.000333,0.285793,14,12003.29858,666.849921,857.37847,187.908907,5,4
0,0,12,12,14,23,37,71,46,117,0.000333,0.203169,14,8533.084613,474.060256,609.506044,157.344894,2,4
0,0,13,13,14,21,35,68,42,110,0.000333,0.188074,14,7899.095846,438.838658,564.221132,145.541635,3,4
0,0,19,19,23,29,52,272,71,343,0.000333,0.65175,22,43015.51811,2389.751006,1955.250823,244.923374,7,4
0,0,13,13,19,24,43,79,49,128,0.000333,0.231521,18,12502.114,694.561889,694.561889,190.749723,3,4
0,0,11,11,14,20,34,66,42,108,0.000333,0.183149,14,7692.243816,427.346879,549.445987,139.741531,2,4
0,0,14,14,16,24,40,82,54,136,0.000333,0.241261,16,11580.51553,643.361974,723.782221,174.0391,3,4
0,0,29,29,17,38,55,158,97,255,0.000333,0.491416,16,23587.94763,1310.441535,1474.246727,268.908114,4,4
0,0,11,11,14,20,34,66,42,108,0.000333,0.183149,14,7692.243816,427.346879,549.445987,139.741531,2,4
0,0,29,29,17,41,58,153,100,253,0.000333,0.494023,16,23713.10707,1317.394837,1482.069192,289.1465,3,4
0,0,15,15,17,27,44,84,53,137,0.000333,0.249314,8,5983.537054,332.418725,747.942132,197.868831,5,4
0,0,21,21,14,28,42,106,71,177,0.000333,0.318147,14,13362.16257,742.342365,954.440184,187.908907,6,4
0,0,14,14,16,24,40,82,54,136,0.000333,0.241261,16,11580.51553,643.361974,723.782221,174.0391,3,4
0,0,34,34,19,40,59,192,112,304,0.000333,0.596108,18,32189.82277,1788.323487,1788.323487,293.587747,9,4
0,0,20,20,16,36,52,172,73,245,0.000333,0.465536,16,22345.7237,1241.429094,1396.607731,250.1173,6,4
0,0,23,23,18,33,51,133,73,206,0.000333,0.389507,18,21033.35317,1168.51962,1168.51962,241.523656,14,4
0,0,23,23,20,37,57,133,79,212,0.000333,0.412191,20,24731.45366,1373.969648,1236.572683,279.188336,10,4
0,0,25,25,18,40,58,149,88,237,0.000333,0.46278,18,24990.14693,1388.341496,1388.341496,287.935774,7,4
0,0,15,15,19,24,43,87,54,141,0.000333,0.255034,18,13771.85995,765.10333,765.10333,190.749723,4,4
0,0,26,26,23,42,65,149,95,244,0.000333,0.489819,22,32328.07042,1796.003912,1469.457746,330.519257,8,4
0,0,19,19,20,36,56,145,85,230,0.000333,0.445231,20,26713.83264,1484.101813,1335.691632,272.555862,10,4
0,0,16,16,18,13,31,136,70,206,0.000333,0.340188,45,45925.3998,2551.4111,1020.56444,123.164366,8,4
0,0,26,26,22,33,55,183,106,289,0.000333,0.556938,33,55136.82759,3063.157088,1670.812957,264.572502,9,4
0,0,11,11,14,20,34,66,42,108,0.000333,0.183149,14,7692.243816,427.346879,549.445987,139.741531,2,4
0,0,34,34,19,44,63,183,111,294,0.000333,0.585773,18,31631.76536,1757.320298,1757.320298,320.925614,7,4
0,0,8,8,14,19,33,49,30,79,0.000333,0.132836,7,2789.549948,154.974997,398.507135,134.013592,2,4
0,0,18,18,22,29,51,131,73,204,0.000333,0.385725,22,25457.84494,1414.324719,1157.17477,238.988944,5,4
0,0,10,10,19,23,42,68,42,110,0.000333,0.197718,9,5338.394249,296.577458,593.154917,184.752548,3,4
0,0,21,21,22,36,58,153,76,229,0.000333,0.447159,22,29512.50825,1639.583792,1341.477648,284.224796,8,4
0,0,18,18,17,31,48,123,63,186,0.000333,0.346268,16,16620.8484,923.380467,1038.803025,223.066954,5,4
0,0,18,18,17,29,46,124,66,190,0.000333,0.349826,16,16791.62835,932.868241,1049.476772,210.368317,4,4
0,0,13,13,17,20,37,77,48,125,0.000333,0.217061,16,10418.90673,578.828152,651.181671,155.92543,3,4
0,0,30,30,20,38,58,163,101,264,0.000333,0.515502,20,30930.13965,1718.341092,1546.506983,285.859807,7,4
0,0,31,31,23,37,60,218,129,347,0.000333,0.68323,33,67639.80421,3757.766901,2049.691037,296.7917,9,4
0,0,11,11,15,23,38,64,40,104,0.000333,0.181928,7,3820.49123,212.249513,545.784461,162.645284,2,4
0,0,13,13,19,24,43,79,49,128,0.000333,0.231521,18,12502.114,694.561889,694.561889,190.749723,3,4
0,0,36,36,23,46,69,214,127,341,0.000333,0.694336,22,45826.15048,2545.897249,2083.00684,358.125775,11,4
0,0,13,13,17,20,37,77,48,125,0.000333,0.217061,16,10418.90673,578.828152,651.181671,155.92543,3,4
0,0,33,33,19,41,60,172,109,281,0.000333,0.553279,18,29877.05263,1659.836257,1659.836257,300.370255,5,4
0,0,23,23,16,38,54,137,83,220,0.000333,0.422025,16,20257.20401,1125.400223,1266.07525,263.421246,1,4
0,0,34,34,22,43,65,194,117,311,0.000333,0.624319,22,41205.04058,2289.168921,1872.95639,331.43688,7,4
0,0,13,13,19,24,43,79,49,128,0.000333,0.231521,18,12502.114,694.561889,694.561889,190.749723,3,4
0,0,22,22,22,32,54,130,80,210,0.000333,0.402842,22,26587.58026,1477.087792,1208.526375,258.107496,5,4
0,0,12,12,18,18,36,60,33,93,0.000333,0.160268,9,4327.227226,240.401513,480.803025,150.1173,5,4
0,0,19,19,22,24,46,120,67,187,0.000333,0.344302,22,22723.93389,1262.440772,1032.906086,208.146596,6,4
0,0,11,11,15,20,35,58,35,93,0.000333,0.159008,7,3339.163244,185.509069,477.023321,145.041921,2,4
0,0,26,26,24,32,56,160,95,255,0.000333,0.493625,24,35541.01212,1974.500673,1480.875505,270.0391,8,4
0,0,9,9,16,23,39,65,42,107,0.000333,0.188513,8,4524.304299,251.350239,565.538037,168.041925,2,4
0,0,35,35,16,41,57,211,113,324,0.000333,0.629952,16,30237.70183,1679.872324,1889.856365,283.659632,8,4
0,0,11,11,14,20,34,66,42,108,0.000333,0.183149,14,7692.243816,427.346879,549.445987,139.741531,2,4
0,0,22,22,22,36,58,149,84,233,0.000333,0.45497,22,30028.01058,1668.22281,1364.909572,284.224796,6,4
0,0,27,27,20,39,59,130,80,210,0.000333,0.411785,20,24707.10081,1372.616712,1235.35504,292.569248,7,4
0,0,9,9,12,20,32,54,35,89,0.000333,0.148333,6,2670,148.333333,445,129.458112,1,4
0,0,22,22,21,32,53,145,88,233,0.000333,0.444868,20,26692.10932,1482.894962,1334.605466,252.238666,5,4
0,0,11,11,17,24,41,73,47,120,0.000333,0.214302,8,5143.249924,285.736107,642.906241,179.525968,2,4
0,0,26,26,21,30,51,181,105,286,0.000333,0.540771,30,48669.40943,2703.85608,1622.313648,239.445384,16,4
0,0,30,30,21,35,56,216,123,339,0.000333,0.656231,30,59060.79956,3281.155531,1968.693319,271.763571,15,4
0,0,27,27,20,39,59,130,80,210,0.000333,0.411785,20,24707.10081,1372.616712,1235.35504,292.569248,7,4
0,0,18,18,20,24,44,121,70,191,0.000333,0.347584,20,20855.02878,1158.61271,1042.751439,196.477662,6,4
0,0,21,21,19,40,59,129,76,205,0.000333,0.401981,9,10853.47643,602.970913,1205.941825,293.587747,7,4
0,0,27,27,19,48,67,167,88,255,0.000333,0.515618,9,13921.67469,773.426372,1546.852744,348.788823,3,4
0,0,17,17,14,28,42,99,60,159,0.000333,0.285793,14,12003.29858,666.849921,857.37847,187.908907,5,4
0,0,12,12,14,23,37,71,46,117,0.000333,0.203169,14,8533.084613,474.060256,609.506044,157.344894,2,4
0,0,19,19,22,24,46,120,67,187,0.000333,0.344302,22,22723.93389,1262.440772,1032.906086,208.146596,6,4
0,0,19,19,23,29,52,272,71,343,0.000333,0.65175,22,43015.51811,2389.751006,1955.250823,244.923374,7,4
0,0,13,13,19,24,43,79,49,128,0.000333,0.231521,18,12502.114,694.561889,694.561889,190.749723,3,4
0,0,11,11,14,20,34,66,42,108,0.000333,0.183149,14,7692.243816,427.346879,549.445987,139.741531,2,4
0,0,14,14,16,24,40,82,54,136,0.000333,0.241261,16,11580.51553,643.361974,723.782221,174.0391,3,4
0,0,29,29,17,38,55,158,97,255,0.000333,0.491416,16,23587.94763,1310.441535,1474.246727,268.908114,4,4
0,0,11,11,14,20,34,66,42,108,0.000333,0.183149,14,7692.243816,427.346879,549.445987,139.741531,2,4
0,0,29,29,17,41,58,153,100,253,0.000333,0.494023,16,23713.10707,1317.394837,1482.069192,289.1465,3,4
0,0,15,15,17,27,44,84,53,137,0.000333,0.249314,8,5983.537054,332.418725,747.942132,197.868831,5,4
0,0,21,21,14,28,42,106,71,177,0.000333,0.318147,14,13362.16257,742.342365,954.440184,187.908907,6,4
0,0,14,14,16,24,40,82,54,136,0.000333,0.241261,16,11580.51553,643.361974,723.782221,174.0391,3,4
0,0,34,34,19,40,59,192,112,304,0.000333,0.596108,18,32189.82277,1788.323487,1788.323487,293.587747,9,4
0,0,20,20,16,36,52,172,73,245,0.000333,0.465536,16,22345.7237,1241.429094,1396.607731,250.1173,6,4
0,0,23,23,18,33,51,133,73,206,0.000333,0.389507,18,21033.35317,1168.51962,1168.51962,241.523656,14,4
0,0,23,23,20,37,57,133,79,212,0.000333,0.412191,20,24731.45366,1373.969648,1236.572683,279.188336,10,4
0,0,25,25,18,40,58,149,88,237,0.000333,0.46278,18,24990.14693,1388.341496,1388.341496,287.935774,7,4
0,0,15,15,19,24,43,87,54,141,0.000333,0.255034,18,13771.85995,765.10333,765.10333,190.749723,4,4
0,0,26,26,23,42,65,149,95,244,0.000333,0.489819,22,32328.07042,1796.003912,1469.457746,330.519257,8,4
0,0,19,19,20,36,56,145,85,230,0.000333,0.445231,20,26713.83264,1484.101813,1335.691632,272.555862,10,4
0,0,16,16,18,13,31,136,70,206,0.000333,0.340188,45,45925.3998,2551.4111,1020.56444,123.164366,8,4
0,0,26,26,22,33,55,183,106,289,0.000333,0.556938,33,55136.82759,3063.157088,1670.812957,264.572502,9,4
0,0,11,11,14,20,34,66,42,108,0.000333,0.183149,14,7692.243816,427.346879,549.445987,139.741531,2,4
0,0,34,34,19,44,63,183,111,294,0.000333,0.585773,18,31631.76536,1757.320298,1757.320298,320.925614,7,4
0,0,8,8,14,19,33,49,30,79,0.000333,0.132836,7,2789.549948,154.974997,398.507135,134.013592,2,4
0,0,18,18,22,29,51,131,73,204,0.000333,0.385725,22,25457.84494,1414.324719,1157.17477,238.988944,5,4
0,0,10,10,19,23,42,68,42,110,0.000333,0.197718,9,5338.394249,296.577458,593.154917,184.752548,3,4
0,0,21,21,22,36,58,153,76,229,0.000333,0.447159,22,29512.50825,1639.583792,1341.477648,284.224796,8,4
0,0,18,18,17,31,48,123,63,186,0.000333,0.346268,16,16620.8484,923.380467,1038.803025,223.066954,5,4
0,0,18,18,17,29,46,124,66,190,0.000333,0.349826,16,16791.62835,932.868241,1049.476772,210.368317,4,4
0,0,13,13,17,20,37,77,48,125,0.000333,0.217061,16,10418.90673,578.828152,651.181671,155.92543,3,4
0,0,30,30,20,38,58,163,101,264,0.000333,0.515502,20,30930.13965,1718.341092,1546.506983,285.859807,7,4
0,0,31,31,23,37,60,218,129,347,0.000333,0.68323,33,67639.80421,3757.766901,2049.691037,296.7917,9,4
0,0,11,11,15,23,38,64,40,104,0.000333,0.181928,7,3820.49123,212.249513,545.784461,162.645284,2,4
0,0,13,13,19,24,43,79,49,128,0.000333,0.231521,18,12502.114,694.561889,694.561889,190.749723,3,4
0,0,36,36,23,46,69,214,127,341,0.000333,0.694336,22,45826.15048,2545.897249,2083.00684,358.125775,11,4
0,0,13,13,17,20,37,77,48,125,0.000333,0.217061,16,10418.90673,578.828152,651.181671,155.92543,3,4
0,0,33,33,19,41,60,172,109,281,0.000333,0.553279,18,29877.05263,1659.836257,1659.836257,300.370255,5,4
0,0,23,23,16,38,54,137,83,220,0.000333,0.422025,16,20257.20401,1125.400223,1266.07525,263.421246,1,4
0,0,34,34,22,43,65,194,117,311,0.000333,0.624319,22,41205.04058,2289.168921,1872.95639,331.43688,7,4
0,0,13,13,19,24,43,79,49,128,0.000333,0.231521,18,12502.114,694.561889,694.561889,190.749723,3,4
0,0,22,22,22,32,54,130,80,210,0.000333,0.402842,22,26587.58026,1477.087792,1208.526375,258.107496,5,4
0,0,20,20,18,35,53,119,73,192,0.000333,0.366587,18,19795.69309,1099.760727,1099.760727,254.583556,11,4
0,0,24,24,17,37,54,135,85,220,0.000333,0.422025,16,20257.20401,1125.400223,1266.07525,262.236643,7,4
0,0,22,22,22,36,58,124,73,197,0.000333,0.384674,22,25388.48963,1410.471646,1154.022256,284.224796,7,4
0,0,33,33,19,41,60,172,109,281,0.000333,0.553279,18,29877.05263,1659.836257,1659.836257,300.370255,5,4
0,0,33,33,19,41,60,172,109,281,0.000333,0.553279,18,29877.05263,1659.836257,1659.836257,300.370255,5,4
0,0,33,33,19,41,60,172,109,281,0.000333,0.553279,18,29877.05263,1659.836257,1659.836257,300.370255,5,4
0,0,22,22,18,33,51,130,71,201,0.000333,0.380052,18,20522.83489,1140.157494,1140.157494,241.523656,14,4
0,0,30,30,21,35,56,216,123,339,0.000333,0.656231,30,59060.79956,3281.155531,1968.693319,271.763571,15,4
0,0,23,23,16,35,51,166,83,249,0.000333,0.470811,16,22598.94256,1255.496809,1412.43391,243.524906,2,4
0,0,30,30,21,35,56,216,123,339,0.000333,0.656231,30,59060.79956,3281.155531,1968.693319,271.763571,15,4
0,0,18,18,17,31,48,123,63,186,0.000333,0.346268,16,16620.8484,923.380467,1038.803025,223.066954,5,4
0,0,33,33,19,41,60,172,109,281,0.000333,0.553279,18,29877.05263,1659.836257,1659.836257,300.370255,5,4
0,0,33,33,19,41,60,172,109,281,0.000333,0.553279,18,29877.05263,1659.836257,1659.836257,300.370255,5,4
0,0,33,33,19,41,60,172,109,281,0.000333,0.553279,18,29877.05263,1659.836257,1659.836257,300.370255,5,4
0,0,19,19,21,33,54,126,67,193,0.000333,0.370231,20,22213.86576,1234.103653,1110.693288,258.703672,14,4
0,0,30,30,21,35,56,216,123,339,0.000333,0.656231,30,59060.79956,3281.155531,1968.693319,271.763571,15,4
0,0,12,12,17,22,39,64,38,102,0.000333,0.179704,8,4312.888211,239.604901,539.111026,167.594364,7,4
0,0,29,29,18,42,60,167,99,266,0.000333,0.523744,18,28282.19217,1571.232898,1571.232898,301.535982,5,4
0,0,33,33,19,41,60,172,109,281,0.000333,0.553279,18,29877.05263,1659.836257,1659.836257,300.370255,5,4
0,0,13,13,19,24,43,79,49,128,0.000333,0.231521,18,12502.114,694.561889,694.561889,190.749723,3,4
0,0,13,13,19,24,43,79,49,128,0.000333,0.231521,18,12502.114,694.561889,694.561889,190.749723,3,4
0,0,19,19,22,24,46,120,67,187,0.000333,0.344302,22,22723.93389,1262.440772,1032.906086,208.146596,6,4
0,0,13,13,19,24,43,79,49,128,0.000333,0.231521,18,12502.114,694.561889,694.561889,190.749723,3,4
0,0,13,13,19,24,43,79,49,128,0.000333,0.231521,18,12502.114,694.561889,694.561889,190.749723,3,4
0,0,13,13,19,24,43,79,49,128,0.000333,0.231521,18,12502.114,694.561889,694.561889,190.749723,3,4
0,0,13,13,19,24,43,79,49,128,0.000333,0.231521,18,12502.114,694.561889,694.561889,190.749723,3,4
0,0,13,13,19,24,43,79,49,128,0.000333,0.231521,18,12502.114,694.561889,694.561889,190.749723,3,4
0,0,13,13,19,24,43,79,49,128,0.000333,0.231521,18,12502.114,694.561889,694.561889,190.749723,3,4
0,0,19,19,22,24,46,120,67,187,0.000333,0.344302,22,22723.93389,1262.440772,1032.906086,208.146596,6,4
0,0,13,13,19,24,43,79,49,128,0.000333,0.231521,18,12502.114,694.561889,694.561889,190.749723,3,4
0,0,13,13,17,20,37,77,48,125,0.000333,0.217061,16,10418.90673,578.828152,651.181671,155.92543,3,4
0,0,34,34,19,44,63,183,111,294,0.000333,0.585773,18,31631.76536,1757.320298,1757.320298,320.925614,7,4
0,0,34,34,19,44,63,183,111,294,0.000333,0.585773,18,31631.76536,1757.320298,1757.320298,320.925614,7,4
0,0,29,29,18,42,60,167,99,266,0.000333,0.523744,18,28282.19217,1571.232898,1571.232898,301.535982,5,4
0,0,13,13,17,20,37,77,48,125,0.000333,0.217061,16,10418.90673,578.828152,651.181671,155.92543,3,4
0,0,34,34,19,44,63,183,111,294,0.000333,0.585773,18,31631.76536,1757.320298,1757.320298,320.925614,7,4
0,0,34,34,19,44,63,183,111,294,0.000333,0.585773,18,31631.76536,1757.320298,1757.320298,320.925614,7,4
0,0,24,24,19,38,57,140,78,218,0.000333,0.423857,18,22888.26042,1271.570023,1271.570023,280.131868,3,4
0,0,13,13,17,20,37,77,48,125,0.000333,0.217061,16,10418.90673,578.828152,651.181671,155.92543,3,4
0,0,34,34,19,44,63,183,111,294,0.000333,0.585773,18,31631.76536,1757.320298,1757.320298,320.925614,7,4
0,0,34,34,19,44,63,183,111,294,0.000333,0.585773,18,31631.76536,1757.320298,1757.320298,320.925614,7,4
0,0,34,34,19,44,63,183,111,294,0.000333,0.585773,18,31631.76536,1757.320298,1757.320298,320.925614,7,4
0,0,13,13,19,24,43,79,49,128,0.000333,0.231521,18,12502.114,694.561889,694.561889,190.749723,3,4
0,0,13,13,19,24,43,79,49,128,0.000333,0.231521,18,12502.114,694.561889,694.561889,190.749723,3,4
0,0,36,36,23,46,69,214,127,341,0.000333,0.694336,22,45826.15048,2545.897249,2083.00684,358.125775,11,4
0,0,13,13,19,24,43,79,49,128,0.000333,0.231521,18,12502.114,694.561889,694.561889,190.749723,3,4
0,0,30,30,21,35,56,216,123,339,0.000333,0.656231,30,59060.79956,3281.155531,1968.693319,271.763571,15,4
0,0,18,18,14,29,43,100,65,165,0.000333,0.298445,14,12534.67158,696.370644,895.333685,194.184418,2,4
0,0,21,21,22,36,58,153,76,229,0.000333,0.447159,22,29512.50825,1639.583792,1341.477648,284.224796,8,4
0,0,26,26,21,30,51,181,105,286,0.000333,0.540771,30,48669.40943,2703.85608,1622.313648,239.445384,16,4
0,0,19,19,21,33,54,126,67,193,0.000333,0.370231,20,22213.86576,1234.103653,1110.693288,258.703672,14,4
0,0,18,18,17,31,48,123,63,186,0.000333,0.346268,16,16620.8484,923.380467,1038.803025,223.066954,5,4
0,0,22,22,22,36,58,124,73,197,0.000333,0.384674,22,25388.48963,1410.471646,1154.022256,284.224796,7,4
0,0,26,26,22,33,55,183,106,289,0.000333,0.556938,33,55136.82759,3063.157088,1670.812957,264.572502,9,4
0,0,26,26,21,30,51,181,105,286,0.000333,0.540771,30,48669.40943,2703.85608,1622.313648,239.445384,16,4
0,0,36,36,23,46,69,214,127,341,0.000333,0.694336,22,45826.15048,2545.897249,2083.00684,358.125775,11,4
0,0,13,13,19,24,43,79,49,128,0.000333,0.231521,18,12502.114,694.561889,694.561889,190.749723,3,4
0,0,26,26,22,33,55,183,106,289,0.000333,0.556938,33,55136.82759,3063.157088,1670.812957,264.572502,9,4
0,0,26,26,21,30,51,181,105,286,0.000333,0.540771,30,48669.40943,2703.85608,1622.313648,239.445384,16,4
0,0,19,19,21,33,54,126,67,193,0.000333,0.370231,20,22213.86576,1234.103653,1110.693288,258.703672,14,4
0,0,19,19,21,35,56,129,69,198,0.000333,0.383285,10,11498.56275,638.809041,1149.856275,271.763571,9,4
0,0,13,13,19,24,43,79,49,128,0.000333,0.231521,18,12502.114,694.561889,694.561889,190.749723,3,4
0,0,13,13,19,24,43,79,49,128,0.000333,0.231521,18,12502.114,694.561889,694.561889,190.749723,3,4
0,0,13,13,19,24,43,79,49,128,0.000333,0.231521,18,12502.114,694.561889,694.561889,190.749723,3,4
0,0,36,36,23,46,69,214,127,341,0.000333,0.694336,22,45826.15048,2545.897249,2083.00684,358.125775,11,4
0,0,13,13,17,20,37,77,48,125,0.000333,0.217061,16,10418.90673,578.828152,651.181671,155.92543,3,4
0,0,34,34,19,44,63,183,111,294,0.000333,0.585773,18,31631.76536,1757.320298,1757.320298,320.925614,7,4
0,0,34,34,19,44,63,183,111,294,0.000333,0.585773,18,31631.76536,1757.320298,1757.320298,320.925614,7,4
0,0,29,29,18,42,60,167,99,266,0.000333,0.523744,18,28282.19217,1571.232898,1571.232898,301.535982,5,4
0,0,13,13,19,24,43,79,49,128,0.000333,0.231521,18,12502.114,694.561889,694.561889,190.749723,3,4
0,0,19,19,22,24,46,120,67,187,0.000333,0.344302,22,22723.93389,1262.440772,1032.906086,208.146596,6,4
0,0,13,13,19,24,43,79,49,128,0.000333,0.231521,18,12502.114,694.561889,694.561889,190.749723,3,4
0,0,36,36,23,46,69,214,127,341,0.000333,0.694336,22,45826.15048,2545.897249,2083.00684,358.125775,11,4
0,0,16,16,18,13,31,136,70,206,0.000333,0.340188,45,45925.3998,2551.4111,1020.56444,123.164366,8,4
0,0,26,26,21,30,51,181,105,286,0.000333,0.540771,30,48669.40943,2703.85608,1622.313648,239.445384,16,4
0,0,13,13,15,21,36,83,46,129,0.000333,0.222307,14,9336.884553,518.715808,666.920325,150.842025,6,4
0,0,13,13,17,20,37,77,48,125,0.000333,0.217061,16,10418.90673,578.828152,651.181671,155.92543,3,4
0,0,34,34,19,44,63,183,111,294,0.000333,0.585773,18,31631.76536,1757.320298,1757.320298,320.925614,7,4
0,0,16,16,19,23,42,76,45,121,0.000333,0.21749,9,5872.233673,326.235204,652.470408,184.752548,8,4
0,0,16,16,19,23,42,76,45,121,0.000333,0.21749,9,5872.233673,326.235204,652.470408,184.752548,8,4
0,0,15,15,15,24,39,105,54,159,0.000333,0.280126,14,11765.30534,653.628074,840.378953,168.642459,4,4
0,0,19,19,21,33,54,126,67,193,0.000333,0.370231,20,22213.86576,1234.103653,1110.693288,258.703672,14,4
0,0,19,19,21,33,54,126,67,193,0.000333,0.370231,20,22213.86576,1234.103653,1110.693288,258.703672,14,4
0,0,13,13,19,24,43,79,49,128,0.000333,0.231521,18,12502.114,694.561889,694.561889,190.749723,3,4
0,0,19,19,22,24,46,120,67,187,0.000333,0.344302,22,22723.93389,1262.440772,1032.906086,208.146596,6,4
0,0,36,36,23,46,69,214,127,341,0.000333,0.694336,22,45826.15048,2545.897249,2083.00684,358.125775,11,4
0,0,13,13,19,24,43,79,49,128,0.000333,0.231521,18,12502.114,694.561889,694.561889,190.749723,3,4
0,0,19,19,22,24,46,120,67,187,0.000333,0.344302,22,22723.93389,1262.440772,1032.906086,208.146596,6,4
0,0,13,13,19,24,43,79,49,128,0.000333,0.231521,18,12502.114,694.561889,694.561889,190.749723,3,4
0,0,36,36,23,46,69,214,127,341,0.000333,0.694336,22,45826.15048,2545.897249,2083.00684,358.125775,11,4
0,0,13,13,19,24,43,79,49,128,0.000333,0.231521,18,12502.114,694.561889,694.561889,190.749723,3,4
0,0,13,13,17,20,37,77,48,125,0.000333,0.217061,16,10418.90673,578.828152,651.181671,155.92543,3,4
0,0,34,34,19,44,63,183,111,294,0.000333,0.585773,18,31631.76536,1757.320298,1757.320298,320.925614,7,4
0,0,34,34,19,44,63,183,111,294,0.000333,0.585773,18,31631.76536,1757.320298,1757.320298,320.925614,7,4
0,0,13,13,19,24,43,79,49,128,0.000333,0.231521,18,12502.114,694.561889,694.561889,190.749723,3,4
0,0,19,19,22,24,46,120,67,187,0.000333,0.344302,22,22723.93389,1262.440772,1032.906086,208.146596,6,4
0,0,13,13,19,24,43,79,49,128,0.000333,0.231521,18,12502.114,694.561889,694.561889,190.749723,3,4
0,0,36,36,23,46,69,214,127,341,0.000333,0.694336,22,45826.15048,2545.897249,2083.00684,358.125775,11,4
0,0,13,13,19,24,43,79,49,128,0.000333,0.231521,18,12502.114,694.561889,694.561889,190.749723,3,4
0,0,19,19,22,24,46,120,67,187,0.000333,0.344302,22,22723.93389,1262.440772,1032.906086,208.146596,6,4
0,0,36,36,23,46,69,214,127,341,0.000333,0.694336,22,45826.15048,2545.897249,2083.00684,358.125775,11,4
0,0,13,13,19,24,43,79,49,128,0.000333,0.231521,18,12502.114,694.561889,694.561889,190.749723,3,4
0,0,19,19,22,24,46,120,67,187,0.000333,0.344302,22,22723.93389,1262.440772,1032.906086,208.146596,6,4
2,0,28,30,21,33,54,180,107,287,0.000333,0.550551,30,49549.58139,2752.754522,1651.652713,258.703672,5,4
0,0,36,36,23,46,69,214,127,341,0.000333,0.694336,22,45826.15048,2545.897249,2083.00684,358.125775,11,4
0,0,13,13,19,24,43,79,49,128,0.000333,0.231521,18,12502.114,694.561889,694.561889,190.749723,3,4
0,0,13,13,19,24,43,79,49,128,0.000333,0.231521,18,12502.114,694.561889,694.561889,190.749723,3,4
0,0,36,36,23,46,69,214,127,341,0.000333,0.694336,22,45826.15048,2545.897249,2083.00684,358.125775,11,4
0,0,13,13,19,24,43,79,49,128,0.000333,0.231521,18,12502.114,694.561889,694.561889,190.749723,3,4
0,0,26,26,21,30,51,181,105,286,0.000333,0.540771,30,48669.40943,2703.85608,1622.313648,239.445384,16,4
0,0,13,13,19,24,43,79,49,128,0.000333,0.231521,18,12502.114,694.561889,694.561889,190.749723,3,4
0,0,13,13,19,24,43,79,49,128,0.000333,0.231521,18,12502.114,694.561889,694.561889,190.749723,3,4
0,0,13,13,19,24,43,79,49,128,0.000333,0.231521,18,12502.114,694.561889,694.561889,190.749723,3,4
0,0,36,36,23,46,69,214,127,341,0.000333,0.694336,22,45826.15048,2545.897249,2083.00684,358.125775,11,4
0,0,13,13,17,20,37,77,48,125,0.000333,0.217061,16,10418.90673,578.828152,651.181671,155.92543,3,4
0,0,34,34,19,44,63,183,111,294,0.000333,0.585773,18,31631.76536,1757.320298,1757.320298,320.925614,7,4
0,0,34,34,19,44,63,183,111,294,0.000333,0.585773,18,31631.76536,1757.320298,1757.320298,320.925614,7,4
0,0,13,13,17,20,37,77,48,125,0.000333,0.217061,16,10418.90673,578.828152,651.181671,155.92543,3,4
0,0,34,34,19,44,63,183,111,294,0.000333,0.585773,18,31631.76536,1757.320298,1757.320298,320.925614,7,4
0,0,34,34,19,44,63,183,111,294,0.000333,0.585773,18,31631.76536,1757.320298,1757.320298,320.925614,7,4
0,0,19,19,21,33,54,126,67,193,0.000333,0.370231,20,22213.86576,1234.103653,1110.693288,258.703672,14,4
0,0,13,13,19,24,43,79,49,128,0.000333,0.231521,18,12502.114,694.561889,694.561889,190.749723,3,4
0,0,13,13,19,24,43,79,49,128,0.000333,0.231521,18,12502.114,694.561889,694.561889,190.749723,3,4
0,0,36,36,23,46,69,214,127,341,0.000333,0.694336,22,45826.15048,2545.897249,2083.00684,358.125775,11,4
0,0,13,13,19,24,43,79,49,128,0.000333,0.231521,18,12502.114,694.561889,694.561889,190.749723,3,4
0,0,13,13,17,20,37,77,48,125,0.000333,0.217061,16,10418.90673,578.828152,651.181671,155.92543,3,4
0,0,34,34,19,44,63,183,111,294,0.000333,0.585773,18,31631.76536,1757.320298,1757.320298,320.925614,7,4
0,0,34,34,19,44,63,183,111,294,0.000333,0.585773,18,31631.76536,1757.320298,1757.320298,320.925614,7,4
0,0,13,13,19,24,43,79,49,128,0.000333,0.231521,18,12502.114,694.561889,694.561889,190.749723,3,4
0,0,13,13,19,24,43,79,49,128,0.000333,0.231521,18,12502.114,694.561889,694.561889,190.749723,3,4
0,0,13,13,19,24,43,79,49,128,0.000333,0.231521,18,12502.114,694.561889,694.561889,190.749723,3,4
0,0,36,36,23,46,69,214,127,341,0.000333,0.694336,22,45826.15048,2545.897249,2083.00684,358.125775,11,4
0,0,26,26,22,33,55,183,106,289,0.000333,0.556938,33,55136.82759,3063.157088,1670.812957,264.572502,9,4
0,0,13,13,19,24,43,79,49,128,0.000333,0.231521,18,12502.114,694.561889,694.561889,190.749723,3,4
0,0,13,13,19,24,43,79,49,128,0.000333,0.231521,18,12502.114,694.561889,694.561889,190.749723,3,4
0,0,36,36,23,46,69,214,127,341,0.000333,0.694336,22,45826.15048,2545.897249,2083.00684,358.125775,11,4
0,0,13,13,19,24,43,79,49,128,0.000333,0.231521,18,12502.114,694.561889,694.561889,190.749723,3,4
0,0,13,13,19,24,43,79,49,128,0.000333,0.231521,18,12502.114,694.561889,694.561889,190.749723,3,4
0,0,13,13,19,24,43,79,49,128,0.000333,0.231521,18,12502.114,694.561889,694.561889,190.749723,3,4
0,0,36,36,23,46,69,214,127,341,0.000333,0.694336,22,45826.15048,2545.897249,2083.00684,358.125775,11,4
0,0,13,13,19,24,43,79,49,128,0.000333,0.231521,18,12502.114,694.561889,694.561889,190.749723,3,4
0,0,36,36,23,46,69,214,127,341,0.000333,0.694336,22,45826.15048,2545.897249,2083.00684,358.125775,11,4
0,0,36,36,23,46,69,214,127,341,0.000333,0.694336,22,45826.15048,2545.897249,2083.00684,358.125775,11,4
0,0,26,26,21,30,51,181,105,286,0.000333,0.540771,30,48669.40943,2703.85608,1622.313648,239.445384,16,4
0,0,13,13,19,24,43,79,49,128,0.000333,0.231521,18,12502.114,694.561889,694.561889,190.749723,3,4
0,0,13,13,19,24,43,79,49,128,0.000333,0.231521,18,12502.114,694.561889,694.561889,190.749723,3,4
0,0,13,13,17,20,37,77,48,125,0.000333,0.217061,16,10418.90673,578.828152,651.181671,155.92543,3,4
0,0,26,26,21,30,51,181,105,286,0.000333,0.540771,30,48669.40943,2703.85608,1622.313648,239.445384,16,4
0,0,34,34,19,44,63,183,111,294,0.000333,0.585773,18,31631.76536,1757.320298,1757.320298,320.925614,7,4
0,0,34,34,19,44,63,183,111,294,0.000333,0.585773,18,31631.76536,1757.320298,1757.320298,320.925614,7,4
0,0,34,34,19,44,63,183,111,294,0.000333,0.585773,18,31631.76536,1757.320298,1757.320298,320.925614,7,4
0,0,34,34,19,44,63,183,111,294,0.000333,0.585773,18,31631.76536,1757.320298,1757.320298,320.925614,7,4
0,0,15,15,20,15,35,76,43,119,0.000333,0.203462,20,12207.69358,678.205199,610.384679,145.041921,6,4
0,0,19,19,20,18,38,91,52,143,0.000333,0.250151,20,15009.07269,833.837372,750.453634,161.497212,8,4
1,0,19,20,19,20,39,90,60,150,0.000333,0.26427,27,21405.87899,1189.215499,792.810333,167.149185,8,4
0,0,17,17,19,16,35,85,49,134,0.000333,0.229108,27,18557.74596,1030.985886,687.323924,144.710623,7,4
1,0,15,16,18,18,36,79,51,130,0.000333,0.22403,18,12097.6245,672.09025,672.09025,150.1173,6,4
1,0,17,18,18,19,37,85,61,146,0.000333,0.253527,27,20535.66517,1140.870287,760.580191,155.769273,6,4
1,0,19,20,18,20,38,91,71,162,0.000333,0.283388,27,22954.43494,1275.246386,850.164257,161.497212,6,4
0,0,21,21,18,21,39,97,81,178,0.000333,0.313601,27,25401.64306,1411.202392,940.801595,167.297316,6,4
0,0,18,18,20,18,38,89,55,144,0.000333,0.251901,30,22671.04686,1259.502603,755.701562,161.497212,7,4
0,0,18,18,20,20,40,91,56,147,0.000333,0.260774,20,15646.4686,869.248255,782.32343,172.877124,7,4
1,0,17,18,19,20,39,94,58,152,0.000333,0.267794,18,14460.86047,803.381137,803.381137,167.149185,6,4
0,0,18,18,18,21,39,94,61,155,0.000333,0.273079,18,14746.27219,819.237344,819.237344,167.297316,6,4
0,0,18,18,19,21,40,86,64,150,0.000333,0.266096,27,21553.80878,1197.433821,798.289214,172.949289,6,4
0,0,17,17,18,19,37,79,57,136,0.000333,0.236162,27,19129.11276,1062.728487,708.485658,155.769273,6,4
0,0,16,16,22,21,43,86,58,144,0.000333,0.260461,22,17190.40674,955.022597,781.382125,190.346161,6,4
0,0,16,16,21,21,42,85,58,143,0.000333,0.257034,20,15422.02783,856.779324,771.101391,184.477332,6,4
0,0,9,9,15,15,30,49,30,79,0.000333,0.129215,14,5427.020999,301.501167,387.644357,117.206718,3,4
0,0,10,10,15,15,30,52,31,83,0.000333,0.135757,14,5701.806872,316.767048,407.271919,117.206718,4,4
0,0,10,10,15,16,31,52,32,84,0.000333,0.138717,14,5826.134861,323.674159,416.15249,122.603359,4,4
0,0,10,10,15,16,31,52,31,83,0.000333,0.137066,7,2878.388056,159.910448,411.198294,122.603359,4,4
0,0,10,10,15,16,31,52,31,83,0.000333,0.137066,7,2878.388056,159.910448,411.198294,122.603359,4,4
0,0,10,10,15,17,32,52,32,84,0.000333,0.14,7,2940,163.333333,420,128.090227,4,4
0,0,10,10,15,17,32,52,32,84,0.000333,0.14,7,2940,163.333333,420,128.090227,4,4
0,0,10,10,15,16,31,52,31,83,0.000333,0.137066,7,2878.388056,159.910448,411.198294,122.603359,4,4
0,0,10,10,15,16,31,52,31,83,0.000333,0.137066,7,2878.388056,159.910448,411.198294,122.603359,4,4
0,0,10,10,15,16,31,52,31,83,0.000333,0.137066,7,2878.388056,159.910448,411.198294,122.603359,4,4
0,0,10,10,15,16,31,52,31,83,0.000333,0.137066,7,2878.388056,159.910448,411.198294,122.603359,4,4
0,0,10,10,15,17,32,52,32,84,0.000333,0.14,7,2940,163.333333,420,128.090227,4,4
0,0,10,10,15,17,32,52,32,84,0.000333,0.14,7,2940,163.333333,420,128.090227,4,4
0,0,11,11,18,16,34,54,32,86,0.000333,0.145841,18,7875.392478,437.521804,437.521804,139.05865,4,4
0,0,10,10,16,15,31,52,31,83,0.000333,0.137066,16,6579.1727,365.509594,411.198294,122.603359,4,4
0,0,10,10,16,16,32,57,35,92,0.000333,0.153333,16,7360,408.888889,460,128,4,4
0,0,11,11,17,16,33,52,32,84,0.000333,0.141243,16,6779.665696,376.648094,423.729106,133.486868,3,4
0,0,15,15,17,19,36,67,41,108,0.000333,0.186117,16,8933.630402,496.3128,558.3519,150.197491,5,4
0,0,12,12,15,20,35,57,44,101,0.000333,0.172686,14,7252.806186,402.933677,518.057585,145.041921,3,4
0,0,8,8,13,14,27,38,27,65,0.000333,0.103023,6,1854.406126,103.022563,309.067688,101.408685,2,4
0,0,14,14,16,17,33,70,44,114,0.000333,0.191687,16,9200.974874,511.165271,575.06093,133.486868,3,4
0,0,12,12,16,21,37,57,41,98,0.000333,0.170175,8,4084.211439,226.900635,510.52643,156.238666,3,4
0,0,10,10,14,15,29,50,31,81,0.000333,0.131165,14,5508.950448,306.052803,393.496461,111.906328,3,4
0,0,13,13,15,14,29,56,39,95,0.000333,0.153836,14,6461.114724,358.950818,461.508195,111.906328,2,4
0,0,12,12,16,18,34,64,40,104,0.000333,0.176365,16,8465.538168,470.307676,529.096135,139.05865,3,4
0,0,15,15,17,21,38,62,44,106,0.000333,0.185427,16,8900.485063,494.471392,556.280316,161.725534,4,4
0,0,11,11,15,19,34,55,40,95,0.000333,0.161103,14,6766.325579,375.906977,483.30897,139.313982,3,4
0,0,13,13,15,23,38,61,52,113,0.000333,0.197672,14,8302.221326,461.234518,593.015809,162.645284,3,4
0,0,15,15,15,21,36,67,60,127,0.000333,0.21886,14,9192.126653,510.673703,656.580475,150.842025,3,4
0,0,17,17,15,22,37,73,70,143,0.000333,0.248317,21,15643.98846,869.11047,744.951831,156.710855,3,4
0,0,12,12,16,18,34,59,42,101,0.000333,0.171278,16,8221.339951,456.741108,513.833747,139.05865,3,4
0,0,12,12,16,20,36,61,43,104,0.000333,0.179224,16,8602.755202,477.930845,537.6722,150.438562,3,4
0,0,13,13,16,21,37,70,47,117,0.000333,0.203169,16,9752.0967,541.78315,609.506044,156.238666,3,4
0,0,12,12,15,20,35,63,44,107,0.000333,0.182944,14,7683.665959,426.870331,548.833283,145.041921,3,4
0,0,14,14,15,22,37,70,50,120,0.000333,0.208378,14,8751.881654,486.215647,625.134404,156.710855,3,4
0,0,14,14,16,22,38,62,53,115,0.000333,0.201171,16,9656.186625,536.454812,603.511664,162.107496,3,4
0,0,12,12,15,19,34,55,42,97,0.000333,0.164495,14,6908.774538,383.820808,493.483896,139.313982,3,4
0,0,12,12,19,22,41,62,47,109,0.000333,0.194658,18,10511.51703,583.973169,583.973169,178.818118,3,4
0,0,12,12,18,22,40,61,47,108,0.000333,0.191589,18,10345.82822,574.768234,574.768234,173.166146,3,4
0,0,6,6,14,11,25,36,20,56,0.000333,0.086685,7,1820.391626,101.132868,260.055947,91.356717,3,4
0,0,14,14,16,18,34,71,40,111,0.000333,0.188236,16,9035.334006,501.963,564.708375,139.05865,6,4
0,0,14,14,16,19,35,71,41,112,0.000333,0.191493,16,9191.675166,510.64862,574.479698,144.710623,6,4
0,0,14,14,16,19,35,71,40,111,0.000333,0.189783,16,9109.606638,506.089258,569.350415,144.710623,6,4
0,0,14,14,16,19,35,71,40,111,0.000333,0.189783,16,9109.606638,506.089258,569.350415,144.710623,6,4
0,0,14,14,16,20,36,71,41,112,0.000333,0.193011,16,9264.505603,514.694756,579.0316,150.438562,6,4
0,0,14,14,16,20,36,71,41,112,0.000333,0.193011,16,9264.505603,514.694756,579.0316,150.438562,6,4
0,0,14,14,16,19,35,71,40,111,0.000333,0.189783,16,9109.606638,506.089258,569.350415,144.710623,6,4
0,0,14,14,16,19,35,71,40,111,0.000333,0.189783,16,9109.606638,506.089258,569.350415,144.710623,6,4
0,0,14,14,16,19,35,71,40,111,0.000333,0.189783,16,9109.606638,506.089258,569.350415,144.710623,6,4
0,0,14,14,16,19,35,71,40,111,0.000333,0.189783,16,9109.606638,506.089258,569.350415,144.710623,6,4
0,0,14,14,16,20,36,71,41,112,0.000333,0.193011,16,9264.505603,514.694756,579.0316,150.438562,6,4
0,0,14,14,16,20,36,71,41,112,0.000333,0.193011,16,9264.505603,514.694756,579.0316,150.438562,6,4
0,0,15,15,19,19,38,73,41,114,0.000333,0.199421,18,10768.74726,598.263737,598.263737,161.421246,6,4
0,0,6,6,14,11,25,36,20,56,0.000333,0.086685,7,1820.391626,101.132868,260.055947,91.356717,3,4
0,0,6,6,14,11,25,36,20,56,0.000333,0.086685,7,1820.391626,101.132868,260.055947,91.356717,3,4
0,0,6,6,14,11,25,36,20,56,0.000333,0.086685,7,1820.391626,101.132868,260.055947,91.356717,3,4
0,0,10,10,15,14,29,54,30,84,0.000333,0.136023,14,5712.98565,317.388092,408.070404,111.906328,4,4
0,0,16,16,16,23,39,76,53,129,0.000333,0.227272,16,10909.07018,606.059454,681.816886,168.041925,5,4
0,0,8,8,14,13,27,42,26,68,0.000333,0.107777,14,4526.652902,251.480717,323.33235,101.408685,3,4
0,0,4,4,9,4,13,20,10,30,0.000333,0.037004,8,888.105532,49.339196,111.013192,36.529325,2,4
0,0,4,4,9,8,17,16,12,28,0.000333,0.03815,4,457.795838,25.433102,114.44896,52.529325,2,4
0,0,10,10,15,14,29,54,30,84,0.000333,0.136023,14,5712.98565,317.388092,408.070404,111.906328,4,4
0,0,18,18,19,20,39,85,49,134,0.000333,0.236081,18,12748.39015,708.243897,708.243897,167.149185,6,4
0,0,16,16,17,21,38,83,49,132,0.000333,0.230909,16,11083.62291,615.756828,692.726432,161.725534,5,4
0,0,8,8,10,8,18,24,21,45,0.000333,0.062549,10,1876.466251,104.248125,187.646625,57.219281,2,4
0,0,15,15,16,22,38,74,49,123,0.000333,0.215165,16,10327.92135,573.773408,645.495084,162.107496,5,4
0,0,17,17,16,23,39,80,59,139,0.000333,0.24489,16,11754.73454,653.040807,734.670908,168.041925,5,4
0,0,19,19,16,24,40,86,69,155,0.000333,0.274966,16,13198.38168,733.243426,824.898855,174.0391,5,4
0,0,21,21,16,25,41,92,79,171,0.000333,0.30538,24,21987.39343,1221.521857,916.141393,180.096405,5,4
0,0,18,18,18,22,40,84,53,137,0.000333,0.243035,18,13123.87468,729.104149,729.104149,173.166146,6,4
0,0,16,16,17,23,40,80,52,132,0.000333,0.234165,16,11239.91214,624.439563,702.494509,173.528793,5,4
0,0,17,17,17,24,41,89,56,145,0.000333,0.258948,16,12429.52065,690.528925,776.845041,179.525968,5,4
0,0,16,16,16,23,39,82,53,135,0.000333,0.237843,16,11416.46879,634.248266,713.5293,168.041925,5,4
0,0,18,18,16,25,41,89,59,148,0.000333,0.264306,16,12686.68315,704.81573,792.917697,180.096405,5,4
0,0,18,18,17,25,42,81,62,143,0.000333,0.257034,16,12337.62226,685.423459,771.101391,185.583273,5,4
0,0,16,16,16,22,38,74,51,125,0.000333,0.218664,16,10495.85503,583.103057,655.990939,162.107496,5,4
0,0,16,16,20,25,45,81,56,137,0.000333,0.250795,20,15047.67748,835.982082,752.383874,202.534967,5,4
0,0,16,16,19,25,44,80,56,136,0.000333,0.247494,18,13364.6886,742.4827,742.4827,196.807027,5,4
0,0,6,6,12,8,20,32,16,48,0.000333,0.069151,12,2489.430583,138.301699,207.452549,67.01955,2,4
0,0,7,7,13,9,22,35,17,52,0.000333,0.077297,6,1391.342665,77.296815,231.890444,76.635041,3,4
0,0,7,7,13,9,22,35,18,53,0.000333,0.078783,12,2836.198509,157.566584,236.349876,76.635041,3,4
0,0,7,7,13,9,22,35,17,52,0.000333,0.077297,6,1391.342665,77.296815,231.890444,76.635041,3,4
0,0,7,7,13,9,22,35,17,52,0.000333,0.077297,6,1391.342665,77.296815,231.890444,76.635041,3,4
0,0,7,7,13,10,23,35,18,53,0.000333,0.079916,6,1438.492702,79.916261,239.748784,81.324997,3,4
0,0,7,7,13,10,23,35,18,53,0.000333,0.079916,6,1438.492702,79.916261,239.748784,81.324997,3,4
0,0,7,7,13,9,22,35,17,52,0.000333,0.077297,6,1391.342665,77.296815,231.890444,76.635041,3,4
0,0,7,7,13,9,22,35,17,52,0.000333,0.077297,6,1391.342665,77.296815,231.890444,76.635041,3,4
0,0,7,7,13,9,22,35,17,52,0.000333,0.077297,6,1391.342665,77.296815,231.890444,76.635041,3,4
0,0,7,7,13,9,22,35,17,52,0.000333,0.077297,6,1391.342665,77.296815,231.890444,76.635041,3,4
0,0,7,7,13,10,23,35,18,53,0.000333,0.079916,6,1438.492702,79.916261,239.748784,81.324997,3,4
0,0,7,7,13,10,23,35,18,53,0.000333,0.079916,6,1438.492702,79.916261,239.748784,81.324997,3,4
0,0,8,8,15,9,24,37,18,55,0.000333,0.084058,14,3530.421126,196.134507,252.172938,87.132684,3,4
0,0,7,7,13,9,22,35,17,52,0.000333,0.077297,6,1391.342665,77.296815,231.890444,76.635041,3,4
0,0,8,8,13,11,24,41,23,64,0.000333,0.097813,12,3521.251201,195.625067,293.4376,86.159464,3,4
0,0,33,33,13,34,47,155,139,294,0.000333,0.54435,24,39193.17894,2177.39883,1633.049122,221.079453,10,0
0,0,16,16,21,23,44,100,76,176,0.000333,0.320287,30,28825.79895,1601.433275,960.859965,196.280591,5,0
0,0,12,12,20,21,41,69,50,119,0.000333,0.212516,20,12750.97377,708.387432,637.548689,178.677228,5,0
0,0,3,3,13,9,22,24,14,38,0.000333,0.056486,6,1016.750409,56.486134,169.458402,76.635041,2,0
0,0,56,56,19,56,75,287,245,532,0.000333,1.104577,36,119294.3356,6627.463087,3313.731543,405.922498,11,0
0,0,3,3,11,9,20,28,14,42,0.000333,0.060507,5,907.6049,50.422494,181.52098,66.583073,3,0
0,0,15,15,13,22,35,78,68,146,0.000333,0.249625,18,13479.75577,748.87532,748.87532,146.213212,8,0
0,0,3,3,12,11,23,20,14,34,0.000333,0.051267,6,922.806639,51.267036,153.801107,81.073298,1,0
0,0,6,6,14,13,27,39,22,61,0.000333,0.096683,7,2030.336963,112.796498,290.048138,101.408685,2,0
0,0,8,8,16,12,28,43,34,77,0.000333,0.123389,16,5922.661264,329.036737,370.166329,107.01955,5,0
0,0,4,4,8,8,16,17,11,28,0.000333,0.037333,4,448,24.888889,112,48,1,0
0,0,26,26,13,28,41,143,95,238,0.000333,0.425032,18,22951.75279,1275.097377,1275.097377,182.711654,1,0
0,0,7,7,8,13,21,27,24,51,0.000333,0.074669,4,896.032754,49.779597,224.008189,72.105716,1,0
0,0,34,34,13,32,45,118,103,221,0.000333,0.404567,18,21846.59162,1213.699534,1213.699534,208.105716,1,0
0,0,30,30,13,32,45,114,96,210,0.000333,0.38443,18,20759.2047,1153.28915,1153.28915,208.105716,1,0
0,0,23,23,16,31,47,120,102,222,0.000333,0.41104,24,29594.8494,1644.1583,1233.118725,217.580086,4,0
0,0,11,11,15,26,41,74,51,125,0.000333,0.223231,7,4687.858004,260.436556,669.694001,180.814792,1,0
0,0,9,9,15,25,40,67,47,114,0.000333,0.202233,7,4246.89862,235.938812,606.699803,174.699764,1,0
0,0,8,8,13,18,31,61,43,104,0.000333,0.171745,12,6182.836995,343.490944,515.236416,123.164366,1,0
0,0,4,4,9,7,16,17,10,27,0.000333,0.036,4,432,24,108,48.180809,1,0
0,0,33,33,16,22,38,174,119,293,0.000333,0.512548,40,61505.71046,3416.983914,1537.642761,162.107496,1,0
0,0,13,13,19,29,48,132,83,215,0.000333,0.400256,18,21613.80488,1200.766938,1200.766938,221.592072,12,0
0,0,13,13,19,29,48,132,83,215,0.000333,0.400256,18,21613.80488,1200.766938,1200.766938,221.592072,12,0
0,0,10,10,8,15,23,42,30,72,0.000333,0.108565,8,2605.571687,144.753983,325.696461,82.603359,1,0
0,0,10,10,8,15,23,42,30,72,0.000333,0.108565,8,2605.571687,144.753983,325.696461,82.603359,1,0
0,0,7,7,14,19,33,36,29,65,0.000333,0.109295,7,2295.199324,127.511074,327.885618,134.013592,6,0
0,0,8,8,15,18,33,41,34,75,0.000333,0.12611,7,2648.306913,147.128162,378.329559,133.662009,2,0
0,0,8,8,15,18,33,41,34,75,0.000333,0.12611,7,2648.306913,147.128162,378.329559,133.662009,2,0
0,0,11,11,13,25,38,46,43,89,0.000333,0.155689,6,2802.393292,155.688516,467.065549,164.202121,1,0
0,0,5,5,10,14,24,31,27,58,0.000333,0.088643,5,1329.639125,73.86884,265.927825,86.52225,2,0
0,0,7,7,12,22,34,46,44,90,0.000333,0.152624,12,5494.459869,305.24777,457.871656,141.127046,1,0
0,0,38,38,18,45,63,190,145,335,0.000333,0.667463,27,54064.49691,3003.583162,2002.388774,322.192039,11,0
0,0,4,4,11,7,18,21,12,33,0.000333,0.045869,5,688.037625,38.224313,137.607525,57.705232,2,0
0,0,4,4,12,14,26,37,20,57,0.000333,0.089308,6,1607.550384,89.308355,267.925064,96.322519,4,0
0,0,11,11,13,30,43,86,84,170,0.000333,0.307488,12,11069.5801,614.976672,922.465008,195.312434,1,0
0,0,24,24,15,38,53,101,92,193,0.000333,0.368496,14,15476.84107,859.824504,1105.488648,258.024604,2,0
0,0,3,3,9,9,18,16,14,30,0.000333,0.041699,4,500.391,27.7995,125.09775,57.05865,1,0
0,0,6,6,14,14,28,34,28,62,0.000333,0.099352,14,4172.784072,231.821337,298.056005,106.605938,1,0
0,0,3,3,7,7,14,19,12,31,0.000333,0.039343,3,354.084008,19.671334,118.028003,39.302969,3,0
0,0,48,48,22,42,64,249,213,462,0.000333,0.924,55,152460,8470,2772,324.584827,7,0
0,0,3,3,9,9,18,20,13,33,0.000333,0.045869,4,550.4301,30.57945,137.607525,57.05865,1,0
0,0,13,13,13,25,38,101,76,177,0.000333,0.309628,18,16719.89706,928.88317,928.88317,164.202121,1,0
0,0,14,14,21,32,53,147,89,236,0.000333,0.450596,20,27035.78455,1501.98803,1351.789227,252.238666,12,0
0,0,4,4,8,13,21,17,19,36,0.000333,0.052708,4,632.493709,35.138539,158.123427,72.105716,1,0
0,0,10,10,12,21,33,47,34,81,0.000333,0.136199,6,2451.575542,136.198641,408.595924,135.258216,2,0
0,0,7,7,15,25,40,53,37,90,0.000333,0.159658,7,3352.8147,186.267483,478.973529,174.699764,1,0
0,0,53,53,25,40,65,265,215,480,0.000333,0.963579,60,173444.193,9635.788501,2890.73655,328.973529,15,0
0,0,9,9,15,26,41,60,41,101,0.000333,0.180371,7,3787.789267,210.432737,541.112752,180.814792,1,0
0,0,7,7,14,19,33,36,30,66,0.000333,0.110977,7,2330.510083,129.472782,332.930012,134.013592,6,0
0,0,11,11,12,28,40,65,56,121,0.000333,0.214651,12,7727.439594,429.3022,643.953299,177.625488,1,0
0,0,3,3,10,8,18,14,10,24,0.000333,0.033359,5,500.391,27.7995,100.0782,57.219281,1,0
0,0,21,21,15,40,55,137,99,236,0.000333,0.4548,14,19101.61249,1061.200694,1364.400892,271.480483,2,0
0,0,5,5,5,7,12,17,14,31,0.000333,0.037045,4,444.53535,24.696408,111.133838,31.261125,1,0
0,0,5,5,5,7,12,17,14,31,0.000333,0.037045,4,444.53535,24.696408,111.133838,31.261125,1,0
0,0,3,3,10,8,18,14,10,24,0.000333,0.033359,5,500.391,27.7995,100.0782,57.219281,1,0
0,0,23,23,17,25,42,225,143,368,0.000333,0.661458,40,79374.91246,4409.717359,1984.372812,185.583273,1,0
0,0,3,3,10,12,22,21,16,37,0.000333,0.055,5,824.994849,45.833047,164.99897,76.238831,1,0
0,0,28,28,22,35,57,189,120,309,0.000333,0.600788,33,59477.97947,3304.332193,1802.363014,277.632401,3,0
0,0,3,3,6,9,15,14,11,25,0.000333,0.032557,3,293.016795,16.278711,97.672265,44.0391,1,0
0,0,7,7,16,16,32,67,45,112,0.000333,0.186667,16,8960,497.777778,560,128,2,0
0,0,10,10,13,20,33,59,50,109,0.000333,0.18328,12,6598.067508,366.559306,549.838959,134.544278,1,0
0,0,6,6,10,12,22,36,30,66,0.000333,0.098107,10,2943.224868,163.512493,294.322487,76.238831,1,0
0,0,9,9,10,20,30,51,38,89,0.000333,0.145571,5,2183.566315,121.30924,436.713263,119.657843,10,0
0,0,3,3,8,9,17,19,13,32,0.000333,0.0436,4,523.195244,29.066402,130.798811,52.529325,1,0
0,0,33,33,15,37,52,196,165,361,0.000333,0.685953,28,57620.04467,3201.113593,2057.858738,251.353133,26,0
0,0,21,21,15,33,48,106,82,188,0.000333,0.349991,14,14699.6213,816.645628,1049.97295,225.068365,6,0
0,0,8,8,8,16,24,32,35,67,0.000333,0.102397,8,2457.5399,136.529994,307.192488,88,1,0
0,0,4,4,10,12,22,19,16,35,0.000333,0.052027,5,780.400533,43.355585,156.080107,76.238831,1,0
0,0,3,3,8,6,14,19,11,30,0.000333,0.038074,4,456.882591,25.382366,114.220648,39.509775,1,0
0,0,5,5,14,13,27,34,20,54,0.000333,0.085588,7,1797.347476,99.852638,256.763925,101.408685,2,0
0,0,9,9,17,21,38,71,48,119,0.000333,0.208168,16,9992.053986,555.11411,624.503374,161.725534,5,0
0,0,9,9,17,21,38,71,48,119,0.000333,0.208168,16,9992.053986,555.11411,624.503374,161.725534,5,0
0,0,7,7,11,21,32,45,43,88,0.000333,0.146667,10,4400,244.444444,440,130.292414,1,0
0,0,20,20,20,37,57,176,133,309,0.000333,0.600788,30,54070.89043,3003.938357,1802.363014,279.188336,3,0
0,0,40,40,16,44,60,205,179,384,0.000333,0.756082,32,72583.87164,4032.437313,2268.245989,304.214991,10,0
0,0,74,74,21,41,62,380,322,702,0.000333,1.393282,70,292589.2067,16254.95593,4179.84581,311.898298,46,0
0,0,27,27,13,34,47,151,104,255,0.000333,0.47214,18,25495.56283,1416.420157,1416.420157,221.079453,2,0
0,0,6,6,12,13,25,44,33,77,0.000333,0.119192,12,4290.923119,238.384618,357.576927,91.125266,2,0
0,0,3,3,9,9,18,20,13,33,0.000333,0.045869,4,550.4301,30.57945,137.607525,57.05865,1,0
0,0,29,29,20,57,77,166,141,307,0.000333,0.641301,20,38478.06936,2137.67052,1923.903468,418.913293,13,0
0,0,29,29,20,57,77,166,141,307,0.000333,0.641301,20,38478.06936,2137.67052,1923.903468,418.913293,13,0
0,0,7,7,15,20,35,46,32,78,0.000333,0.133361,7,2800.588527,155.588252,400.084075,145.041921,1,0
0,0,69,69,21,44,65,373,318,691,0.000333,1.387152,70,291301.9311,16183.44062,4161.456159,332.453657,46,0
0,0,13,13,14,28,42,70,74,144,0.000333,0.258831,14,10870.91192,603.939551,776.493709,187.908907,1,0
0,0,16,16,14,28,42,86,87,173,0.000333,0.310957,21,19590.2892,1088.3494,932.870914,187.908907,1,0
0,0,3,3,5,4,9,9,7,16,0.000333,0.016906,2,101.4376,5.635422,50.7188,19.60964,1,0
0,0,3,3,5,4,9,9,7,16,0.000333,0.016906,2,101.4376,5.635422,50.7188,19.60964,1,0
0,0,92,92,21,106,127,524,435,959,0.000333,2.23405,40,268085.9446,14893.66359,6702.148615,805.398234,7,0
0,0,45,45,17,44,61,213,185,398,0.000333,0.786811,32,75533.87073,4196.326152,2360.43346,309.70186,10,0
0,0,3,3,11,10,21,20,15,35,0.000333,0.051244,5,768.655549,42.703086,153.73111,71.273029,2,0
0,0,13,13,15,23,38,75,51,126,0.000333,0.220413,14,9257.344134,514.296896,661.238867,162.645284,1,0
0,0,5,5,11,18,29,38,26,64,0.000333,0.103637,5,1554.553918,86.364107,310.910784,113.112398,1,0
0,0,4,4,13,9,22,31,22,53,0.000333,0.078783,12,2836.198509,157.566584,236.349876,76.635041,4,0
0,0,49,49,17,49,66,245,212,457,0.000333,0.920763,32,88393.2196,4910.734422,2762.288113,344.607651,10,0
0,0,12,12,17,23,40,116,79,195,0.000333,0.345925,24,24906.62348,1383.701305,1037.775979,173.528793,1,0
0,0,3,3,9,9,18,18,14,32,0.000333,0.044479,4,533.7504,29.6528,133.4376,57.05865,1,0
0,0,64,64,22,45,67,342,279,621,0.000333,1.25568,66,248624.7316,13812.48509,3767.041387,345.240885,6,0
0,0,5,5,13,16,29,29,21,50,0.000333,0.080966,6,1457.394299,80.96635,242.89905,112.105716,2,0
0,0,44,44,23,69,92,262,224,486,0.000333,1.056817,33,104624.8867,5812.493703,3170.451111,525.530113,7,0
0,0,42,42,23,69,92,255,217,472,0.000333,1.026374,33,101611.001,5645.055613,3079.121243,525.530113,7,0
0,0,8,8,9,7,16,38,25,63,0.000333,0.084,12,3024,168,252,48.180809,1,0
0,0,5,5,9,13,22,39,26,65,0.000333,0.096621,8,2318.904442,128.828025,289.863055,76.635041,1,0
0,0,6,6,10,17,27,42,32,74,0.000333,0.117287,5,1759.308376,97.739354,351.861675,102.706149,1,0
0,0,6,6,10,17,27,42,32,74,0.000333,0.117287,5,1759.308376,97.739354,351.861675,102.706149,1,0
0,0,11,11,18,25,43,82,58,140,0.000333,0.253226,18,13674.18718,759.677066,759.677066,191.155055,5,0
0,0,11,11,18,25,43,82,58,140,0.000333,0.253226,18,13674.18718,759.677066,759.677066,191.155055,5,0
0,0,71,71,30,71,101,376,295,671,0.000333,1.48922,60,268059.5943,14892.19968,4467.659905,583.838763,10,0
0,0,48,48,21,42,63,242,208,450,0.000333,0.896592,40,107591.0386,5977.279923,2689.775966,318.715998,17,0
0,0,29,29,16,40,56,181,146,327,0.000333,0.633002,24,45576.12143,2532.006746,1899.00506,276.877124,16,0
0,0,25,25,15,45,60,131,102,233,0.000333,0.458769,14,19268.27712,1070.45984,1376.305509,305.736748,4,0
0,0,48,48,24,40,64,227,230,457,0.000333,0.914,60,164520,9140,2742,322.916224,3,0
0,0,48,48,24,40,64,227,230,457,0.000333,0.914,60,164520,9140,2742,322.916224,3,0
0,0,25,25,19,35,54,107,103,210,0.000333,0.402842,18,21753.47476,1208.526375,1208.526375,260.235528,4,0
0,0,17,17,16,35,51,83,88,171,0.000333,0.323328,16,15519.75574,862.208652,969.984733,243.524906,1,0
0,0,17,17,16,35,51,83,88,171,0.000333,0.323328,16,15519.75574,862.208652,969.984733,243.524906,1,0
0,0,26,26,20,37,57,173,116,289,0.000333,0.561902,30,50571.15642,2809.50869,1685.705214,279.188336,3,0
0,0,33,33,17,45,62,162,153,315,0.000333,0.625191,24,45013.72411,2500.76245,1875.571838,316.620258,7,0
0,0,38,38,13,31,44,133,118,251,0.000333,0.456772,18,24665.71205,1370.317336,1370.317336,201.685802,1,0
0,0,3,3,7,8,15,16,17,33,0.000333,0.042976,6,773.564338,42.975797,128.92739,43.651484,1,0
0,0,8,8,9,17,26,37,40,77,0.000333,0.120645,8,2895.470866,160.859493,361.933858,98.016193,1,0
0,0,13,13,20,28,48,81,59,140,0.000333,0.260632,20,15637.895,868.771945,781.89475,221.0445,5,0
0,0,13,13,20,28,48,81,59,140,0.000333,0.260632,20,15637.895,868.771945,781.89475,221.0445,5,0
0,0,64,64,19,52,71,368,214,582,0.000333,1.193051,36,128849.5016,7158.305647,3579.152824,377.133488,9,0
0,0,28,28,16,34,50,148,125,273,0.000333,0.513591,24,36978.54576,2054.363653,1540.77274,236.973737,9,0
0,0,4,4,9,10,19,20,13,33,0.000333,0.046727,4,560.726432,31.151468,140.181608,61.748606,1,0
0,0,8,8,11,17,28,56,45,101,0.000333,0.161848,10,4855.428471,269.746026,485.542847,107.540616,1,0
0,0,7,7,13,18,31,51,33,84,0.000333,0.138717,6,2496.91494,138.717497,416.15249,123.164366,2,0
0,0,10,10,14,23,37,68,50,118,0.000333,0.204905,14,8606.01696,478.112053,614.715497,157.344894,2,0
0,0,34,34,23,46,69,196,173,369,0.000333,0.751349,33,74383.50231,4132.416795,2254.045525,358.125775,5,0
0,0,57,57,21,58,79,305,263,568,0.000333,1.193516,40,143221.8986,7956.772144,3580.547465,432.001564,11,0
0,0,8,8,13,22,35,46,33,79,0.000333,0.135071,6,2431.28015,135.071119,405.213358,146.213212,4,0
0,0,3,3,5,6,11,9,8,17,0.000333,0.019603,2,117.620675,6.534482,58.810338,27.119415,1,0
0,0,3,3,5,6,11,9,8,17,0.000333,0.019603,2,117.620675,6.534482,58.810338,27.119415,1,0
0,0,18,18,22,24,46,100,75,175,0.000333,0.322208,33,31898.5703,1772.142794,966.623342,208.146596,2,0
0,0,69,69,26,48,74,361,346,707,0.000333,1.463361,91,399497.6012,22194.31118,4390.083529,390.289633,6,0
0,0,9,9,9,17,26,40,35,75,0.000333,0.117511,8,2820.263831,156.681324,352.532979,98.016193,1,0
0,0,10,10,13,18,31,84,46,130,0.000333,0.214682,12,7728.546244,429.36368,644.04552,123.164366,6,0
0,0,10,10,13,18,31,84,46,130,0.000333,0.214682,12,7728.546244,429.36368,644.04552,123.164366,6,0
0,0,11,11,19,17,36,76,51,127,0.000333,0.21886,27,17727.67283,984.870713,656.580475,150.197491,6,0
0,0,7,7,10,19,29,41,32,73,0.000333,0.118211,5,1773.163063,98.509059,354.632613,113.929904,10,0
0,0,11,11,10,25,35,57,48,105,0.000333,0.179525,5,2692.873584,149.604088,538.574717,149.315686,4,0
0,0,11,11,18,26,44,84,59,143,0.000333,0.260233,18,14052.57699,780.698721,780.698721,197.270083,5,0
0,0,11,11,18,26,44,84,59,143,0.000333,0.260233,18,14052.57699,780.698721,780.698721,197.270083,5,0
0,0,21,21,14,34,48,136,97,233,0.000333,0.433765,14,18218.14768,1012.119315,1301.296263,226.276706,2,0
0,0,8,8,13,17,30,62,49,111,0.000333,0.181555,12,6535.978273,363.109904,544.664856,117.592585,3,0
0,0,3,3,9,8,17,18,11,29,0.000333,0.039512,4,474.14569,26.341427,118.536422,52.529325,1,0
0,0,4,4,14,13,27,30,21,51,0.000333,0.080833,7,1697.494838,94.305269,242.499263,101.408685,2,0
0,0,24,24,13,28,41,117,106,223,0.000333,0.398245,18,21505.21375,1194.734097,1194.734097,182.711654,9,0
0,0,57,57,21,90,111,320,275,595,0.000333,1.347559,30,121280.3232,6737.795734,4042.67744,676.505445,7,0
0,0,67,67,21,98,119,377,326,703,0.000333,1.615686,30,145411.7066,8078.428146,4847.056888,740.480231,9,0
0,0,54,54,22,45,67,298,249,547,0.000333,1.10605,55,182498.2933,10138.79407,3318.150787,345.240885,7,0
0,0,46,46,14,33,47,207,151,358,0.000333,0.662848,28,55679.19865,3093.288814,1988.542809,219.767975,5,0
0,0,11,11,11,26,37,61,51,112,0.000333,0.194486,5,2917.293885,162.071882,583.458777,160.26518,4,0
0,0,6,6,12,19,31,40,30,70,0.000333,0.115598,6,2080.76245,115.597914,346.793742,123.730173,1,0
0,0,20,20,14,30,44,95,94,189,0.000333,0.343944,21,21668.48409,1203.804672,1031.832576,200.509687,4,0
0,0,51,51,17,47,64,226,221,447,0.000333,0.894,32,85824,4768,2682,330.552544,7,0
0,0,19,19,18,25,43,87,74,161,0.000333,0.29121,18,15725.31526,873.628626,873.628626,191.155055,3,0
0,0,5,5,10,10,20,22,17,39,0.000333,0.056185,5,842.775979,46.820888,168.555196,66.438562,1,0
0,0,10,10,12,17,29,83,45,128,0.000333,0.207274,12,7461.858809,414.547712,621.821567,112.506418,6,0
0,0,10,10,12,17,29,83,45,128,0.000333,0.207274,12,7461.858809,414.547712,621.821567,112.506418,6,0
0,0,13,13,17,31,48,71,53,124,0.000333,0.230845,8,5540.282801,307.793489,692.53535,223.066954,5,0
0,0,7,7,16,17,33,55,40,95,0.000333,0.159739,16,7667.479061,425.971059,479.217441,133.486868,3,0
0,0,32,32,22,39,61,182,141,323,0.000333,0.638543,33,63215.72928,3511.98496,1915.62816,304.238182,3,0
0,0,33,33,16,37,53,173,149,322,0.000333,0.614797,32,59020.49236,3278.916242,1844.390386,256.749775,10,0
0,0,30,30,22,39,61,165,131,296,0.000333,0.585166,33,57931.44231,3218.413462,1755.498252,304.238182,3,0
0,0,29,29,17,38,55,133,101,234,0.000333,0.450946,16,21645.41077,1202.52282,1352.838173,268.908114,10,0
0,0,3,3,8,13,21,37,24,61,0.000333,0.08931,4,1071.725451,59.540303,267.931363,72.105716,1,0
0,0,4,4,4,7,11,13,11,24,0.000333,0.027675,2,166.052718,9.225151,83.026359,27.651484,3,0
0,0,3,3,9,9,18,18,13,31,0.000333,0.043089,4,517.0707,28.72615,129.267675,57.05865,2,0
0,0,7,7,11,19,30,44,28,72,0.000333,0.117765,5,1766.480614,98.137812,353.296123,118.764371,2,0
0,0,3,3,8,9,17,17,12,29,0.000333,0.039512,4,474.14569,26.341427,118.536422,52.529325,2,0
0,0,3,3,9,9,18,18,13,31,0.000333,0.043089,4,517.0707,28.72615,129.267675,57.05865,2,0
0,0,4,4,6,10,16,26,15,41,0.000333,0.054667,3,492,27.333333,164,48.729056,1,0
0,0,3,3,10,8,18,16,13,29,0.000333,0.040309,5,604.639125,33.591063,120.927825,57.219281,3,0
0,0,28,28,17,38,55,144,79,223,0.000333,0.429748,16,20627.89146,1145.99397,1289.243216,268.908114,10,0
0,0,4,4,6,8,14,17,12,29,0.000333,0.036804,3,331.239878,18.402215,110.413293,39.509775,3,0
0,0,7,7,11,19,30,44,28,72,0.000333,0.117765,5,1766.480614,98.137812,353.296123,118.764371,2,0
0,0,7,7,11,19,30,44,28,72,0.000333,0.117765,5,1766.480614,98.137812,353.296123,118.764371,2,0
0,0,4,4,11,10,21,26,17,43,0.000333,0.062957,5,944.348246,52.463791,188.869649,71.273029,2,0
0,0,17,17,16,23,39,110,55,165,0.000333,0.290697,16,13953.46186,775.192325,872.091366,168.041925,7,0
0,0,6,6,15,15,30,35,24,59,0.000333,0.096502,7,2026.545816,112.585879,289.506545,117.206718,4,0
0,0,3,3,10,8,18,16,13,29,0.000333,0.040309,5,604.639125,33.591063,120.927825,57.219281,3,0
0,0,3,3,10,8,18,16,13,29,0.000333,0.040309,5,604.639125,33.591063,120.927825,57.219281,3,0
0,0,36,36,21,46,67,185,115,300,0.000333,0.606609,20,36396.53514,2022.02973,1819.826757,346.322516,16,0
0,0,22,22,17,31,48,117,74,191,0.000333,0.355576,16,17067.6454,948.202522,1066.727838,223.066954,3,0
0,0,3,3,10,10,20,17,13,30,0.000333,0.043219,5,648.289214,36.016067,129.657843,66.438562,2,0
0,0,7,7,11,19,30,44,28,72,0.000333,0.117765,5,1766.480614,98.137812,353.296123,118.764371,2,0
0,0,8,8,11,14,25,50,26,76,0.000333,0.117644,5,1764.665352,98.036964,352.93307,91.356717,3,0
0,0,4,4,10,12,22,21,17,38,0.000333,0.056486,5,847.292008,47.071778,169.458402,76.238831,1,0
0,0,4,4,8,10,18,28,18,46,0.000333,0.063939,4,767.2662,42.6259,191.81655,57.219281,4,0
0,0,3,3,9,9,18,18,13,31,0.000333,0.043089,4,517.0707,28.72615,129.267675,57.05865,2,0
0,0,4,4,11,9,20,23,14,37,0.000333,0.053304,5,799.556698,44.419817,159.91134,66.583073,2,0
0,0,3,3,10,10,20,17,13,30,0.000333,0.043219,5,648.289214,36.016067,129.657843,66.438562,2,0
0,0,4,4,11,10,21,26,17,43,0.000333,0.062957,5,944.348246,52.463791,188.869649,71.273029,2,0
0,0,3,3,10,8,18,16,13,29,0.000333,0.040309,5,604.639125,33.591063,120.927825,57.219281,3,0
0,0,18,18,13,25,38,129,71,200,0.000333,0.349862,12,12595.02603,699.723668,1049.585503,164.202121,11,0
0,0,7,7,11,19,30,44,28,72,0.000333,0.117765,5,1766.480614,98.137812,353.296123,118.764371,2,0
0,0,4,4,4,7,11,13,11,24,0.000333,0.027675,2,166.052718,9.225151,83.026359,27.651484,3,0
0,0,3,3,8,10,18,20,13,33,0.000333,0.045869,4,550.4301,30.57945,137.607525,57.219281,3,0
0,0,3,3,9,9,18,18,13,31,0.000333,0.043089,4,517.0707,28.72615,129.267675,57.05865,2,0
0,0,4,4,11,10,21,26,17,43,0.000333,0.062957,5,944.348246,52.463791,188.869649,71.273029,2,0
0,0,4,4,6,5,11,10,5,15,0.000333,0.017297,3,155.674423,8.648579,51.891474,27.119415,1,0
0,0,4,4,8,11,19,17,15,32,0.000333,0.045311,4,543.734722,30.207485,135.93368,62.053748,3,0
0,0,5,5,12,16,28,39,25,64,0.000333,0.102557,6,1846.02429,102.556905,307.670715,107.01955,4,0
0,0,3,3,10,8,18,16,13,29,0.000333,0.040309,5,604.639125,33.591063,120.927825,57.219281,3,0
0,0,16,16,14,30,44,101,53,154,0.000333,0.280251,7,5885.267285,326.959294,840.752469,200.509687,6,0
0,0,27,27,17,37,54,142,78,220,0.000333,0.422025,16,20257.20401,1125.400223,1266.07525,262.236643,10,0
0,0,4,4,4,7,11,13,11,24,0.000333,0.027675,2,166.052718,9.225151,83.026359,27.651484,3,0
0,0,4,4,7,9,16,16,12,28,0.000333,0.037333,3,336,18.666667,112,48.180809,3,0
0,0,6,6,9,18,27,24,23,47,0.000333,0.074493,4,893.91885,49.662158,223.479713,103.587975,3,0
0,0,7,7,11,19,30,44,28,72,0.000333,0.117765,5,1766.480614,98.137812,353.296123,118.764371,2,0
0,0,3,3,10,8,18,16,13,29,0.000333,0.040309,5,604.639125,33.591063,120.927825,57.219281,3,0
0,0,9,9,12,19,31,47,33,80,0.000333,0.132112,6,2378.014229,132.111902,396.335705,123.730173,4,0
0,0,4,4,10,12,22,21,17,38,0.000333,0.056486,5,847.292008,47.071778,169.458402,76.238831,1,0
0,0,4,4,11,9,20,24,12,36,0.000333,0.051863,5,777.947057,43.219281,155.589411,66.583073,5,0
0,0,4,4,11,10,21,26,17,43,0.000333,0.062957,5,944.348246,52.463791,188.869649,71.273029,2,0
0,0,4,4,10,9,19,46,19,65,0.000333,0.092038,10,2761.152884,153.397382,276.115288,61.748606,11,0
0,0,6,6,9,17,26,26,23,49,0.000333,0.076774,4,921.286185,51.182566,230.321546,98.016193,3,0
0,0,5,5,12,16,28,39,25,64,0.000333,0.102557,6,1846.02429,102.556905,307.670715,107.01955,2,0
0,0,7,7,11,19,30,44,28,72,0.000333,0.117765,5,1766.480614,98.137812,353.296123,118.764371,2,0
0,0,3,3,10,8,18,16,13,29,0.000333,0.040309,5,604.639125,33.591063,120.927825,57.219281,3,0
0,0,7,7,11,19,30,44,28,72,0.000333,0.117765,5,1766.480614,98.137812,353.296123,118.764371,2,0
0,0,4,4,7,13,20,20,20,40,0.000333,0.057626,3,518.631371,28.812854,172.877124,67.757201,2,0
0,0,6,6,9,18,27,24,23,47,0.000333,0.074493,4,893.91885,49.662158,223.479713,103.587975,3,0
0,0,4,4,4,7,11,13,11,24,0.000333,0.027675,2,166.052718,9.225151,83.026359,27.651484,3,0
0,0,17,17,16,23,39,110,55,165,0.000333,0.290697,16,13953.46186,775.192325,872.091366,168.041925,7,0
0,0,6,6,11,15,26,33,25,58,0.000333,0.090875,5,1363.127518,75.729307,272.625504,96.657107,2,0
0,0,17,17,16,23,39,110,55,165,0.000333,0.290697,16,13953.46186,775.192325,872.091366,168.041925,7,0
0,0,3,3,11,11,22,26,15,41,0.000333,0.060946,5,914.183482,50.787971,182.836696,76.107496,3,0
0,0,4,4,4,7,11,13,11,24,0.000333,0.027675,2,166.052718,9.225151,83.026359,27.651484,3,0
0,0,4,4,11,9,20,24,12,36,0.000333,0.051863,5,777.947057,43.219281,155.589411,66.583073,5,0
0,0,6,6,9,18,27,24,23,47,0.000333,0.074493,4,893.91885,49.662158,223.479713,103.587975,3,0
0,0,4,4,8,11,19,17,15,32,0.000333,0.045311,4,543.734722,30.207485,135.93368,62.053748,3,0
0,0,4,4,6,8,14,17,12,29,0.000333,0.036804,3,331.239878,18.402215,110.413293,39.509775,3,0
0,0,3,3,10,10,20,17,13,30,0.000333,0.043219,5,648.289214,36.016067,129.657843,66.438562,2,0
0,0,10,10,18,17,35,60,40,100,0.000333,0.170976,18,9232.709431,512.928302,512.928302,144.545518,6,0
0,0,8,8,9,17,26,35,26,61,0.000333,0.095576,4,1146.907291,63.717072,286.726823,98.016193,3,0
0,0,4,4,4,6,10,16,12,28,0.000333,0.031005,4,372.055947,20.669775,93.013987,23.509775,1,0
0,0,3,3,9,9,18,18,13,31,0.000333,0.043089,4,517.0707,28.72615,129.267675,57.05865,2,0
0,0,3,3,10,10,20,17,13,30,0.000333,0.043219,5,648.289214,36.016067,129.657843,66.438562,2,0
0,0,4,4,7,13,20,20,20,40,0.000333,0.057626,3,518.631371,28.812854,172.877124,67.757201,2,0
0,0,18,18,11,28,39,115,64,179,0.000333,0.315362,10,9460.869972,525.603887,946.086997,172.659686,1,0
0,0,10,10,12,19,31,78,41,119,0.000333,0.196516,12,7074.592331,393.032907,589.549361,123.730173,1,0
0,0,3,3,10,8,18,16,13,29,0.000333,0.040309,5,604.639125,33.591063,120.927825,57.219281,3,0
0,0,3,3,9,9,18,18,13,31,0.000333,0.043089,4,517.0707,28.72615,129.267675,57.05865,2,0
0,0,7,7,11,19,30,44,28,72,0.000333,0.117765,5,1766.480614,98.137812,353.296123,118.764371,2,0
0,0,3,3,10,11,21,22,15,37,0.000333,0.054172,5,812.578723,45.143262,162.515745,71.273029,4,0
0,0,17,17,16,23,39,110,55,165,0.000333,0.290697,16,13953.46186,775.192325,872.091366,168.041925,7,0
0,0,3,3,10,8,18,16,13,29,0.000333,0.040309,5,604.639125,33.591063,120.927825,57.219281,3,0
0,0,3,3,9,9,18,18,13,31,0.000333,0.043089,4,517.0707,28.72615,129.267675,57.05865,2,0
0,0,6,6,7,11,18,41,25,66,0.000333,0.091738,6,1651.290301,91.73835,275.21505,57.705232,1,0
0,0,12,12,11,19,30,73,36,109,0.000333,0.178284,5,2674.255375,148.569743,534.851075,118.764371,5,0
0,0,3,3,10,10,20,17,13,30,0.000333,0.043219,5,648.289214,36.016067,129.657843,66.438562,2,0
0,0,19,19,12,26,38,116,56,172,0.000333,0.300881,12,10831.72239,601.762355,902.643532,165.230983,7,0
0,0,3,3,9,9,18,18,13,31,0.000333,0.043089,4,517.0707,28.72615,129.267675,57.05865,2,0
0,0,3,3,11,11,22,26,15,41,0.000333,0.060946,5,914.183482,50.787971,182.836696,76.107496,3,0
0,0,3,3,9,9,18,18,13,31,0.000333,0.043089,4,517.0707,28.72615,129.267675,57.05865,2,0
0,0,3,3,10,8,18,16,13,29,0.000333,0.040309,5,604.639125,33.591063,120.927825,57.219281,3,0
0,0,6,6,11,16,27,30,23,53,0.000333,0.084003,5,1260.045188,70.00251,252.009038,102.053748,1,0
0,0,3,3,10,8,18,16,13,29,0.000333,0.040309,5,604.639125,33.591063,120.927825,57.219281,3,0
0,0,3,3,10,8,18,16,13,29,0.000333,0.040309,5,604.639125,33.591063,120.927825,57.219281,3,0
0,0,7,7,11,19,30,44,28,72,0.000333,0.117765,5,1766.480614,98.137812,353.296123,118.764371,2,0
0,0,3,3,10,8,18,16,13,29,0.000333,0.040309,5,604.639125,33.591063,120.927825,57.219281,3,0
0,0,7,7,11,19,30,44,28,72,0.000333,0.117765,5,1766.480614,98.137812,353.296123,118.764371,2,0
0,0,8,8,16,13,29,53,32,85,0.000333,0.137643,16,6606.854153,367.047453,412.928385,112.105716,6,0
0,0,6,6,10,11,21,30,16,46,0.000333,0.067349,5,1010.233007,56.124056,202.046601,71.273029,3,0
0,0,8,8,16,13,29,53,32,85,0.000333,0.137643,16,6606.854153,367.047453,412.928385,112.105716,6,0
0,0,7,7,11,18,29,48,28,76,0.000333,0.123069,5,1846.032778,102.557377,369.206556,113.112398,1,0
0,0,8,8,9,17,26,35,26,61,0.000333,0.095576,4,1146.907291,63.717072,286.726823,98.016193,3,0
0,0,25,25,19,38,57,203,112,315,0.000333,0.612453,18,33072.48638,1837.360354,1837.360354,280.131868,11,0
0,0,3,3,10,8,18,16,13,29,0.000333,0.040309,5,604.639125,33.591063,120.927825,57.219281,3,0
0,0,5,5,9,15,24,22,19,41,0.000333,0.062661,4,751.93385,41.774103,187.983463,87.132684,3,0
0,0,4,4,4,7,11,13,11,24,0.000333,0.027675,2,166.052718,9.225151,83.026359,27.651484,3,0
0,0,6,6,13,13,26,38,23,61,0.000333,0.095576,6,1720.360937,95.575608,286.726823,96.211433,4,0
0,0,3,3,5,6,11,9,8,17,0.000333,0.019603,2,117.620675,6.534482,58.810338,27.119415,1,0
0,0,8,8,17,13,30,41,27,68,0.000333,0.111223,16,5338.696968,296.594276,333.668561,117.592585,4,0
0,0,3,3,11,11,22,26,15,41,0.000333,0.060946,5,914.183482,50.787971,182.836696,76.107496,3,0
0,0,4,4,9,9,18,16,14,30,0.000333,0.041699,4,500.391,27.7995,125.09775,57.05865,1,0
0,0,7,7,11,19,30,44,28,72,0.000333,0.117765,5,1766.480614,98.137812,353.296123,118.764371,2,0
0,0,11,11,15,21,36,84,43,127,0.000333,0.21886,14,9192.126653,510.673703,656.580475,150.842025,2,0
0,0,36,36,21,46,67,185,115,300,0.000333,0.606609,20,36396.53514,2022.02973,1819.826757,346.322516,17,0
0,0,4,4,7,9,16,16,12,28,0.000333,0.037333,3,336,18.666667,112,48.180809,3,0
0,0,35,35,19,52,71,195,115,310,0.000333,0.635474,18,34315.58893,1906.421607,1906.421607,377.133488,12,0
0,0,3,3,9,5,14,11,6,17,0.000333,0.021575,4,258.900135,14.383341,64.725034,40.138965,3,0
0,0,3,3,10,8,18,16,13,29,0.000333,0.040309,5,604.639125,33.591063,120.927825,57.219281,3,0
0,0,3,3,10,8,18,16,13,29,0.000333,0.040309,5,604.639125,33.591063,120.927825,57.219281,3,0
0,0,5,5,10,14,24,24,23,47,0.000333,0.071831,5,1077.466188,59.859233,215.493238,86.52225,2,0
0,0,4,4,8,11,19,17,15,32,0.000333,0.045311,4,543.734722,30.207485,135.93368,62.053748,3,0
0,0,4,4,4,7,11,13,11,24,0.000333,0.027675,2,166.052718,9.225151,83.026359,27.651484,3,0
0,0,3,3,10,8,18,16,13,29,0.000333,0.040309,5,604.639125,33.591063,120.927825,57.219281,3,0
0,0,4,4,6,8,14,17,12,29,0.000333,0.036804,3,331.239878,18.402215,110.413293,39.509775,3,0
0,0,4,4,7,9,16,16,12,28,0.000333,0.037333,3,336,18.666667,112,48.180809,3,0
0,0,8,8,16,13,29,53,32,85,0.000333,0.137643,16,6606.854153,367.047453,412.928385,112.105716,6,0
0,0,3,3,9,9,18,18,13,31,0.000333,0.043089,4,517.0707,28.72615,129.267675,57.05865,2,0
0,0,3,3,9,9,18,18,13,31,0.000333,0.043089,4,517.0707,28.72615,129.267675,57.05865,2,0
0,0,3,3,5,5,10,12,7,19,0.000333,0.021039,2,126.233268,7.012959,63.116634,23.219281,1,0
0,0,33,33,21,38,59,198,102,300,0.000333,0.588264,20,35295.8583,1960.881016,1764.792915,291.659911,16,0
0,0,3,3,10,8,18,16,13,29,0.000333,0.040309,5,604.639125,33.591063,120.927825,57.219281,3,0
0,0,4,4,4,7,11,13,11,24,0.000333,0.027675,2,166.052718,9.225151,83.026359,27.651484,3,0
0,0,7,7,11,19,30,44,28,72,0.000333,0.117765,5,1766.480614,98.137812,353.296123,118.764371,2,0
0,0,8,8,15,18,33,45,33,78,0.000333,0.131154,7,2754.239189,153.013288,393.462741,133.662009,4,0
0,0,3,3,9,9,18,18,13,31,0.000333,0.043089,4,517.0707,28.72615,129.267675,57.05865,2,0
0,0,7,7,10,14,24,34,26,60,0.000333,0.091699,5,1375.48875,76.416042,275.09775,86.52225,2,0
0,0,6,6,10,15,25,27,24,51,0.000333,0.078946,5,1184.183328,65.787963,236.836666,91.82264,4,0
0,0,3,3,9,9,18,18,13,31,0.000333,0.043089,4,517.0707,28.72615,129.267675,57.05865,2,0
0,0,3,3,9,9,18,18,13,31,0.000333,0.043089,4,517.0707,28.72615,129.267675,57.05865,2,0
0,0,3,3,11,11,22,26,15,41,0.000333,0.060946,5,914.183482,50.787971,182.836696,76.107496,3,0
0,0,4,4,6,8,14,17,12,29,0.000333,0.036804,3,331.239878,18.402215,110.413293,39.509775,3,0
0,0,3,3,10,8,18,16,13,29,0.000333,0.040309,5,604.639125,33.591063,120.927825,57.219281,3,0
0,0,6,6,14,14,28,34,25,59,0.000333,0.094545,7,1985.437583,110.302088,283.63394,106.605938,2,0
0,0,8,8,16,13,29,53,32,85,0.000333,0.137643,16,6606.854153,367.047453,412.928385,112.105716,6,0
0,0,6,6,11,14,25,29,21,50,0.000333,0.077398,5,1160.964047,64.498003,232.192809,91.356717,1,0
0,0,7,7,11,19,30,44,28,72,0.000333,0.117765,5,1766.480614,98.137812,353.296123,118.764371,2,0
0,0,3,3,11,11,22,26,15,41,0.000333,0.060946,5,914.183482,50.787971,182.836696,76.107496,3,0
0,0,5,5,11,12,23,33,21,54,0.000333,0.081424,5,1221.361728,67.853429,244.272346,81.073298,1,0
0,0,4,4,4,7,11,13,11,24,0.000333,0.027675,2,166.052718,9.225151,83.026359,27.651484,3,0
0,0,6,6,15,15,30,35,24,59,0.000333,0.096502,7,2026.545816,112.585879,289.506545,117.206718,4,0
0,0,4,4,4,7,11,13,11,24,0.000333,0.027675,2,166.052718,9.225151,83.026359,27.651484,3,0
0,0,3,3,11,11,22,26,15,41,0.000333,0.060946,5,914.183482,50.787971,182.836696,76.107496,3,0
0,0,4,4,4,7,11,13,11,24,0.000333,0.027675,2,166.052718,9.225151,83.026359,27.651484,3,0
0,0,7,7,12,17,29,43,27,70,0.000333,0.113353,6,2040.352018,113.35289,340.05867,112.506418,4,0
0,0,7,7,11,19,30,44,28,72,0.000333,0.117765,5,1766.480614,98.137812,353.296123,118.764371,2,0
0,0,16,16,12,26,38,87,49,136,0.000333,0.237906,6,4282.308851,237.906047,713.718142,165.230983,5,0
0,0,9,9,15,19,34,68,35,103,0.000333,0.17467,7,3668.060709,203.78115,524.008673,139.313982,2,0
0,0,4,4,8,7,15,17,13,30,0.000333,0.039069,4,468.826871,26.045937,117.206718,43.651484,1,0
0,0,5,5,9,15,24,22,19,41,0.000333,0.062661,4,751.93385,41.774103,187.983463,87.132684,3,0
0,0,4,4,4,7,11,13,11,24,0.000333,0.027675,2,166.052718,9.225151,83.026359,27.651484,3,0
0,0,3,3,9,9,18,18,13,31,0.000333,0.043089,4,517.0707,28.72615,129.267675,57.05865,2,0
0,0,3,3,10,8,18,16,13,29,0.000333,0.040309,5,604.639125,33.591063,120.927825,57.219281,3,0
0,0,3,3,10,8,18,16,13,29,0.000333,0.040309,5,604.639125,33.591063,120.927825,57.219281,3,0
0,0,7,7,12,17,29,43,27,70,0.000333,0.113353,6,2040.352018,113.35289,340.05867,112.506418,4,0
0,0,3,3,5,6,11,9,8,17,0.000333,0.019603,2,117.620675,6.534482,58.810338,27.119415,1,0
0,0,7,7,12,17,29,43,27,70,0.000333,0.113353,6,2040.352018,113.35289,340.05867,112.506418,4,0
0,0,3,3,10,6,16,19,10,29,0.000333,0.038667,5,580,32.222222,116,48.729056,1,0
0,0,8,8,16,13,29,53,32,85,0.000333,0.137643,16,6606.854153,367.047453,412.928385,112.105716,6,0
0,0,5,5,10,15,25,24,25,49,0.000333,0.07585,5,1137.744766,63.208043,227.548953,91.82264,2,0
0,0,25,25,17,34,51,133,72,205,0.000333,0.387616,16,18605.55512,1033.641951,1162.847195,242.460605,10,0
0,0,9,9,15,21,36,41,37,78,0.000333,0.134418,7,2822.779051,156.821058,403.25415,150.842025,4,0
0,0,3,3,10,8,18,16,13,29,0.000333,0.040309,5,604.639125,33.591063,120.927825,57.219281,3,0
0,0,3,3,10,8,18,16,13,29,0.000333,0.040309,5,604.639125,33.591063,120.927825,57.219281,3,0
0,0,36,36,21,46,67,183,115,298,0.000333,0.602565,20,36153.89158,2008.549532,1807.694579,346.322516,16,0
0,0,3,3,10,8,18,16,13,29,0.000333,0.040309,5,604.639125,33.591063,120.927825,57.219281,3,0
0,0,3,3,10,6,16,21,9,30,0.000333,0.04,5,600,33.333333,120,48.729056,3,0
0,0,5,5,9,15,24,22,19,41,0.000333,0.062661,4,751.93385,41.774103,187.983463,87.132684,3,0
0,0,3,3,10,8,18,16,13,29,0.000333,0.040309,5,604.639125,33.591063,120.927825,57.219281,3,0
0,0,7,7,11,19,30,44,28,72,0.000333,0.117765,5,1766.480614,98.137812,353.296123,118.764371,2,0
0,0,3,3,11,11,22,26,15,41,0.000333,0.060946,5,914.183482,50.787971,182.836696,76.107496,3,0
0,0,7,7,11,19,30,44,28,72,0.000333,0.117765,5,1766.480614,98.137812,353.296123,118.764371,2,0
0,0,7,7,11,19,30,44,28,72,0.000333,0.117765,5,1766.480614,98.137812,353.296123,118.764371,2,0
0,0,7,7,11,19,30,44,28,72,0.000333,0.117765,5,1766.480614,98.137812,353.296123,118.764371,2,0
0,0,3,3,10,8,18,16,13,29,0.000333,0.040309,5,604.639125,33.591063,120.927825,57.219281,3,0
0,0,3,3,9,9,18,18,13,31,0.000333,0.043089,4,517.0707,28.72615,129.267675,57.05865,2,0
0,0,4,4,4,7,11,13,11,24,0.000333,0.027675,2,166.052718,9.225151,83.026359,27.651484,3,0
0,0,4,4,7,9,16,16,12,28,0.000333,0.037333,3,336,18.666667,112,48.180809,3,0
0,0,3,3,8,10,18,20,13,33,0.000333,0.045869,4,550.4301,30.57945,137.607525,57.219281,3,0
0,0,3,3,6,6,12,20,9,29,0.000333,0.034655,3,311.891738,17.327319,103.963913,31.01955,4,0
0,0,3,3,9,9,18,18,13,31,0.000333,0.043089,4,517.0707,28.72615,129.267675,57.05865,2,0
0,0,3,3,11,11,22,26,15,41,0.000333,0.060946,5,914.183482,50.787971,182.836696,76.107496,3,0
0,0,3,3,10,8,18,16,13,29,0.000333,0.040309,5,604.639125,33.591063,120.927825,57.219281,3,0
0,0,4,4,11,10,21,26,17,43,0.000333,0.062957,5,944.348246,52.463791,188.869649,71.273029,2,0
0,0,7,7,14,15,29,42,31,73,0.000333,0.118211,14,4964.856577,275.825365,354.632613,111.906328,4,0
0,0,3,3,11,11,22,26,15,41,0.000333,0.060946,5,914.183482,50.787971,182.836696,76.107496,3,0
0,0,4,4,4,7,11,13,11,24,0.000333,0.027675,2,166.052718,9.225151,83.026359,27.651484,3,0
0,0,4,4,4,7,11,13,11,24,0.000333,0.027675,2,166.052718,9.225151,83.026359,27.651484,3,0
0,0,3,3,10,10,20,17,13,30,0.000333,0.043219,5,648.289214,36.016067,129.657843,66.438562,2,0
0,0,16,16,12,29,41,88,51,139,0.000333,0.248233,6,4468.198372,248.233243,744.699729,183.900999,7,0
0,0,6,6,10,14,24,28,21,49,0.000333,0.074888,5,1123.315813,62.406434,224.663163,86.52225,1,0
0,0,7,7,11,19,30,44,28,72,0.000333,0.117765,5,1766.480614,98.137812,353.296123,118.764371,2,0
0,0,6,6,15,15,30,35,24,59,0.000333,0.096502,7,2026.545816,112.585879,289.506545,117.206718,4,0
0,0,3,3,10,8,18,16,13,29,0.000333,0.040309,5,604.639125,33.591063,120.927825,57.219281,3,0
0,0,3,3,10,8,18,16,13,29,0.000333,0.040309,5,604.639125,33.591063,120.927825,57.219281,3,0
0,0,3,3,10,8,18,16,13,29,0.000333,0.040309,5,604.639125,33.591063,120.927825,57.219281,3,0
0,0,3,3,10,8,18,16,13,29,0.000333,0.040309,5,604.639125,33.591063,120.927825,57.219281,3,0
0,0,3,3,10,10,20,17,13,30,0.000333,0.043219,5,648.289214,36.016067,129.657843,66.438562,2,0
0,0,4,4,10,12,22,21,17,38,0.000333,0.056486,5,847.292008,47.071778,169.458402,76.238831,1,0
0,0,8,8,10,16,26,50,28,78,0.000333,0.122211,5,1833.17149,101.842861,366.634298,97.219281,9,0
0,0,7,7,11,19,30,44,28,72,0.000333,0.117765,5,1766.480614,98.137812,353.296123,118.764371,2,0
0,0,7,7,13,18,31,43,26,69,0.000333,0.113947,6,2051.037273,113.946515,341.839545,123.164366,2,0
0,0,7,7,11,19,30,44,28,72,0.000333,0.117765,5,1766.480614,98.137812,353.296123,118.764371,2,0
0,0,6,6,11,15,26,29,22,51,0.000333,0.079907,5,1198.612128,66.589563,239.722426,96.657107,1,0
0,0,14,14,11,35,46,79,67,146,0.000333,0.268813,5,4032.200228,224.011124,806.440046,217.578653,6,0
0,0,7,7,11,19,30,44,28,72,0.000333,0.117765,5,1766.480614,98.137812,353.296123,118.764371,2,0
0,0,3,3,10,8,18,16,13,29,0.000333,0.040309,5,604.639125,33.591063,120.927825,57.219281,3,0
0,0,7,7,11,19,30,44,28,72,0.000333,0.117765,5,1766.480614,98.137812,353.296123,118.764371,2,0
0,0,4,4,13,8,21,27,11,38,0.000333,0.055636,6,1001.448372,55.636021,166.908062,72.105716,3,0
0,0,4,4,11,10,21,26,17,43,0.000333,0.062957,5,944.348246,52.463791,188.869649,71.273029,2,0
0,0,4,4,14,9,23,32,12,44,0.000333,0.066346,7,1393.257082,77.403171,199.036726,81.832294,3,0
0,0,8,8,16,13,29,56,25,81,0.000333,0.131165,8,3147.971685,174.887316,393.496461,112.105716,3,0
0,0,3,3,10,10,20,17,13,30,0.000333,0.043219,5,648.289214,36.016067,129.657843,66.438562,2,0
0,0,3,3,10,8,18,16,13,29,0.000333,0.040309,5,604.639125,33.591063,120.927825,57.219281,3,0
0,0,4,4,10,12,22,21,17,38,0.000333,0.056486,5,847.292008,47.071778,169.458402,76.238831,1,0
0,0,6,6,10,14,24,28,21,49,0.000333,0.074888,5,1123.315813,62.406434,224.663163,86.52225,1,0
0,0,7,7,11,19,30,44,28,72,0.000333,0.117765,5,1766.480614,98.137812,353.296123,118.764371,2,0
0,0,6,6,9,18,27,24,23,47,0.000333,0.074493,4,893.91885,49.662158,223.479713,103.587975,3,0
0,0,27,27,17,37,54,142,78,220,0.000333,0.422025,16,20257.20401,1125.400223,1266.07525,262.236643,10,0
0,0,9,9,13,22,35,49,37,86,0.000333,0.147039,6,2646.710037,147.039446,441.118339,146.213212,4,0
0,0,3,3,10,6,16,21,9,30,0.000333,0.04,5,600,33.333333,120,48.729056,3,0
0,0,3,3,5,5,10,12,7,19,0.000333,0.021039,2,126.233268,7.012959,63.116634,23.219281,1,0
0,0,26,26,17,36,53,140,74,214,0.000333,0.408592,16,19612.39964,1089.577758,1225.774977,255.604168,10,0
0,0,3,3,9,7,16,24,10,34,0.000333,0.045333,4,544,30.222222,136,48.180809,3,0
0,0,3,3,10,8,18,16,13,29,0.000333,0.040309,5,604.639125,33.591063,120.927825,57.219281,3,0
0,0,4,4,10,12,22,21,17,38,0.000333,0.056486,5,847.292008,47.071778,169.458402,76.238831,1,0
0,0,6,6,15,15,30,35,24,59,0.000333,0.096502,7,2026.545816,112.585879,289.506545,117.206718,4,0
0,0,4,4,4,7,11,13,11,24,0.000333,0.027675,2,166.052718,9.225151,83.026359,27.651484,3,0
0,0,3,3,10,8,18,16,13,29,0.000333,0.040309,5,604.639125,33.591063,120.927825,57.219281,3,0
0,0,3,3,10,8,18,16,13,29,0.000333,0.040309,5,604.639125,33.591063,120.927825,57.219281,3,0
0,0,7,7,11,19,30,44,28,72,0.000333,0.117765,5,1766.480614,98.137812,353.296123,118.764371,2,0
0,0,4,4,4,7,11,13,11,24,0.000333,0.027675,2,166.052718,9.225151,83.026359,27.651484,3,0
0,0,7,7,11,18,29,48,28,76,0.000333,0.123069,5,1846.032778,102.557377,369.206556,113.112398,1,0
0,0,3,3,10,8,18,16,13,29,0.000333,0.040309,5,604.639125,33.591063,120.927825,57.219281,3,0
0,0,8,8,16,19,35,72,39,111,0.000333,0.189783,16,9109.606638,506.089258,569.350415,144.710623,10,0
0,0,26,26,17,38,55,215,117,332,0.000333,0.639804,24,46065.8742,2559.215233,1919.411425,268.908114,11,0
0,0,5,5,11,14,25,27,24,51,0.000333,0.078946,5,1184.183328,65.787963,236.836666,91.356717,2,0
0,0,8,8,14,14,28,41,28,69,0.000333,0.110569,14,4643.904855,257.994714,331.70749,106.605938,2,0
0,0,3,3,10,10,20,17,13,30,0.000333,0.043219,5,648.289214,36.016067,129.657843,66.438562,2,0
0,0,7,7,11,19,30,44,28,72,0.000333,0.117765,5,1766.480614,98.137812,353.296123,118.764371,2,0
0,0,7,7,16,14,30,45,29,74,0.000333,0.121037,16,5809.758465,322.764359,363.109904,117.302969,4,0
0,0,4,4,9,7,16,21,10,31,0.000333,0.041333,4,496,27.555556,124,48.180809,2,0
0,0,6,6,15,15,30,35,24,59,0.000333,0.096502,7,2026.545816,112.585879,289.506545,117.206718,4,0
0,0,3,3,10,8,18,16,13,29,0.000333,0.040309,5,604.639125,33.591063,120.927825,57.219281,3,0
0,0,3,3,10,6,16,19,10,29,0.000333,0.038667,5,580,32.222222,116,48.729056,1,0
0,0,7,7,11,19,30,44,28,72,0.000333,0.117765,5,1766.480614,98.137812,353.296123,118.764371,2,0
0,0,7,7,11,19,30,44,28,72,0.000333,0.117765,5,1766.480614,98.137812,353.296123,118.764371,2,0
0,0,3,3,10,10,20,17,13,30,0.000333,0.043219,5,648.289214,36.016067,129.657843,66.438562,2,0
0,0,4,4,10,12,22,21,17,38,0.000333,0.056486,5,847.292008,47.071778,169.458402,76.238831,1,0
0,0,6,6,8,10,18,26,18,44,0.000333,0.061159,4,733.9068,40.7726,183.4767,57.219281,1,0
0,0,4,4,4,7,11,13,11,24,0.000333,0.027675,2,166.052718,9.225151,83.026359,27.651484,3,0
0,0,8,8,13,12,25,43,26,69,0.000333,0.106809,12,3845.112925,213.617385,320.426077,91.125266,4,0
0,0,9,9,13,12,25,53,31,84,0.000333,0.130028,12,4681.007039,260.055947,390.08392,91.125266,4,0
0,0,6,6,15,15,30,35,24,59,0.000333,0.096502,7,2026.545816,112.585879,289.506545,117.206718,4,0
0,0,4,4,8,9,17,15,14,29,0.000333,0.039512,4,474.14569,26.341427,118.536422,52.529325,1,0
0,0,7,7,11,19,30,44,28,72,0.000333,0.117765,5,1766.480614,98.137812,353.296123,118.764371,2,0
0,0,11,11,12,18,30,69,40,109,0.000333,0.178284,12,6418.212899,356.567383,534.851075,118.0782,2,0
0,0,5,5,12,16,28,39,25,64,0.000333,0.102557,6,1846.02429,102.556905,307.670715,107.01955,2,0
0,0,6,6,13,13,26,38,23,61,0.000333,0.095576,6,1720.360937,95.575608,286.726823,96.211433,4,0
0,0,4,4,4,7,11,13,11,24,0.000333,0.027675,2,166.052718,9.225151,83.026359,27.651484,3,0
0,0,11,11,11,18,29,70,34,104,0.000333,0.16841,5,2526.150117,140.341673,505.230023,113.112398,8,0
0,0,3,3,10,8,18,16,13,29,0.000333,0.040309,5,604.639125,33.591063,120.927825,57.219281,3,0
0,0,3,3,10,8,18,16,13,29,0.000333,0.040309,5,604.639125,33.591063,120.927825,57.219281,3,0
0,0,7,7,11,19,30,44,28,72,0.000333,0.117765,5,1766.480614,98.137812,353.296123,118.764371,2,0
0,0,3,3,8,10,18,20,13,33,0.000333,0.045869,4,550.4301,30.57945,137.607525,57.219281,3,0
0,0,3,3,9,9,18,18,13,31,0.000333,0.043089,4,517.0707,28.72615,129.267675,57.05865,2,0
0,0,7,7,11,19,30,44,28,72,0.000333,0.117765,5,1766.480614,98.137812,353.296123,118.764371,2,0
0,0,3,3,10,10,20,17,13,30,0.000333,0.043219,5,648.289214,36.016067,129.657843,66.438562,2,0
0,0,7,7,11,19,30,44,28,72,0.000333,0.117765,5,1766.480614,98.137812,353.296123,118.764371,2,0
0,0,7,7,12,15,27,37,32,69,0.000333,0.109362,12,3937.046852,218.724825,328.087238,101.622909,1,0
0,0,8,8,9,17,26,35,26,61,0.000333,0.095576,4,1146.907291,63.717072,286.726823,98.016193,3,0
0,0,3,3,10,8,18,16,13,29,0.000333,0.040309,5,604.639125,33.591063,120.927825,57.219281,3,0
0,0,8,8,12,17,29,51,32,83,0.000333,0.134404,6,2419.274536,134.404141,403.212423,112.506418,5,0
0,0,6,6,10,14,24,28,21,49,0.000333,0.074888,5,1123.315813,62.406434,224.663163,86.52225,1,0
0,0,6,6,9,13,22,31,19,50,0.000333,0.074324,4,891.886324,49.54924,222.971581,76.635041,1,0
0,0,10,10,16,24,40,84,58,142,0.000333,0.251905,16,12091.42063,671.745591,755.713789,174.0391,2,0
0,0,7,7,12,17,29,43,27,70,0.000333,0.113353,6,2040.352018,113.35289,340.05867,112.506418,4,0
0,0,3,3,10,8,18,16,13,29,0.000333,0.040309,5,604.639125,33.591063,120.927825,57.219281,3,0
0,0,3,3,10,8,18,16,13,29,0.000333,0.040309,5,604.639125,33.591063,120.927825,57.219281,3,0
0,0,7,7,12,17,29,43,27,70,0.000333,0.113353,6,2040.352018,113.35289,340.05867,112.506418,4,0
0,0,7,7,11,19,30,44,28,72,0.000333,0.117765,5,1766.480614,98.137812,353.296123,118.764371,2,0
0,0,6,6,7,10,17,25,16,41,0.000333,0.055862,3,502.757929,27.930996,167.585976,52.870765,1,0
0,0,4,4,11,9,20,24,12,36,0.000333,0.051863,5,777.947057,43.219281,155.589411,66.583073,5,0
0,0,7,7,11,19,30,44,28,72,0.000333,0.117765,5,1766.480614,98.137812,353.296123,118.764371,2,0
0,0,3,3,10,8,18,16,13,29,0.000333,0.040309,5,604.639125,33.591063,120.927825,57.219281,3,0
0,0,6,6,13,13,26,38,23,61,0.000333,0.095576,6,1720.360937,95.575608,286.726823,96.211433,4,0
0,0,3,3,10,10,20,17,13,30,0.000333,0.043219,5,648.289214,36.016067,129.657843,66.438562,2,0
0,0,3,3,11,11,22,26,15,41,0.000333,0.060946,5,914.183482,50.787971,182.836696,76.107496,3,0
0,0,36,36,16,62,78,272,185,457,0.000333,0.957476,16,45958.86102,2553.270057,2872.428814,433.160171,4,0
0,0,3,3,10,6,16,19,10,29,0.000333,0.038667,5,580,32.222222,116,48.729056,1,0
0,0,5,5,10,14,24,27,22,49,0.000333,0.074888,5,1123.315813,62.406434,224.663163,86.52225,3,0
0,0,36,36,21,46,67,185,115,300,0.000333,0.606609,20,36396.53514,2022.02973,1819.826757,346.322516,16,0
0,0,3,3,5,6,11,9,8,17,0.000333,0.019603,2,117.620675,6.534482,58.810338,27.119415,1,0
0,0,7,7,11,19,30,44,28,72,0.000333,0.117765,5,1766.480614,98.137812,353.296123,118.764371,2,0
0,0,3,3,9,9,18,18,13,31,0.000333,0.043089,4,517.0707,28.72615,129.267675,57.05865,2,0
0,0,3,3,10,8,18,16,13,29,0.000333,0.040309,5,604.639125,33.591063,120.927825,57.219281,3,0
0,0,3,3,10,11,21,22,15,37,0.000333,0.054172,5,812.578723,45.143262,162.515745,71.273029,4,0
0,0,7,7,11,19,30,44,28,72,0.000333,0.117765,5,1766.480614,98.137812,353.296123,118.764371,2,0
0,0,7,7,11,19,30,44,28,72,0.000333,0.117765,5,1766.480614,98.137812,353.296123,118.764371,2,0
0,0,3,3,10,8,18,16,13,29,0.000333,0.040309,5,604.639125,33.591063,120.927825,57.219281,3,0
0,0,4,4,8,11,19,17,15,32,0.000333,0.045311,4,543.734722,30.207485,135.93368,62.053748,3,0
0,0,4,4,6,8,14,17,12,29,0.000333,0.036804,3,331.239878,18.402215,110.413293,39.509775,3,0
0,0,8,8,14,15,29,44,29,73,0.000333,0.118211,7,2482.428289,137.912683,354.632613,111.906328,4,0
0,0,4,4,8,11,19,17,15,32,0.000333,0.045311,4,543.734722,30.207485,135.93368,62.053748,3,0
0,0,17,17,16,23,39,110,55,165,0.000333,0.290697,16,13953.46186,775.192325,872.091366,168.041925,7,0
0,0,4,4,4,7,11,13,11,24,0.000333,0.027675,2,166.052718,9.225151,83.026359,27.651484,3,0
0,0,4,4,7,15,22,20,24,44,0.000333,0.065405,3,588.644974,32.702499,196.214991,78.254843,2,0
0,0,5,5,9,15,24,22,19,41,0.000333,0.062661,4,751.93385,41.774103,187.983463,87.132684,3,0
0,0,4,4,4,7,11,13,11,24,0.000333,0.027675,2,166.052718,9.225151,83.026359,27.651484,3,0
0,0,3,3,10,8,18,16,13,29,0.000333,0.040309,5,604.639125,33.591063,120.927825,57.219281,3,0
0,0,3,3,10,8,18,16,13,29,0.000333,0.040309,5,604.639125,33.591063,120.927825,57.219281,3,0
0,0,3,3,10,8,18,16,13,29,0.000333,0.040309,5,604.639125,33.591063,120.927825,57.219281,3,0
0,0,3,3,9,11,20,19,16,35,0.000333,0.050422,4,605.069933,33.614996,151.267483,66.583073,1,0
0,0,3,3,10,6,16,19,10,29,0.000333,0.038667,5,580,32.222222,116,48.729056,1,0
0,0,7,7,11,19,30,44,28,72,0.000333,0.117765,5,1766.480614,98.137812,353.296123,118.764371,2,0
0,0,6,6,15,15,30,35,24,59,0.000333,0.096502,7,2026.545816,112.585879,289.506545,117.206718,4,0
0,0,3,3,10,8,18,16,13,29,0.000333,0.040309,5,604.639125,33.591063,120.927825,57.219281,3,0
0,0,7,7,11,19,30,44,28,72,0.000333,0.117765,5,1766.480614,98.137812,353.296123,118.764371,2,0
0,0,6,6,13,13,26,35,26,61,0.000333,0.095576,12,3440.721874,191.151215,286.726823,96.211433,2,0
0,0,3,3,10,8,18,16,13,29,0.000333,0.040309,5,604.639125,33.591063,120.927825,57.219281,3,0
0,0,4,4,10,11,21,20,15,35,0.000333,0.051244,5,768.655549,42.703086,153.73111,71.273029,2,0
0,0,5,5,14,17,31,60,30,90,0.000333,0.148626,7,3121.143676,173.396871,445.877668,122.789837,4,0
0,0,4,4,10,12,22,21,17,38,0.000333,0.056486,5,847.292008,47.071778,169.458402,76.238831,1,0
0,0,4,4,6,8,14,17,12,29,0.000333,0.036804,3,331.239878,18.402215,110.413293,39.509775,3,0
0,0,17,17,16,23,39,110,55,165,0.000333,0.290697,16,13953.46186,775.192325,872.091366,168.041925,7,0
0,0,3,3,10,8,18,16,13,29,0.000333,0.040309,5,604.639125,33.591063,120.927825,57.219281,3,0
0,0,8,8,15,18,33,66,34,100,0.000333,0.168146,7,3531.075884,196.170882,504.439412,133.662009,2,0
0,0,4,4,4,7,11,13,11,24,0.000333,0.027675,2,166.052718,9.225151,83.026359,27.651484,3,0
0,0,3,3,10,8,18,16,13,29,0.000333,0.040309,5,604.639125,33.591063,120.927825,57.219281,3,0
0,0,3,3,9,9,18,18,13,31,0.000333,0.043089,4,517.0707,28.72615,129.267675,57.05865,2,0
0,0,5,5,9,15,24,22,19,41,0.000333,0.062661,4,751.93385,41.774103,187.983463,87.132684,3,0
0,0,3,3,9,9,18,18,13,31,0.000333,0.043089,4,517.0707,28.72615,129.267675,57.05865,2,0
0,0,3,3,10,10,20,17,13,30,0.000333,0.043219,5,648.289214,36.016067,129.657843,66.438562,2,0
0,0,3,3,10,8,18,16,13,29,0.000333,0.040309,5,604.639125,33.591063,120.927825,57.219281,3,0
0,0,3,3,6,9,15,10,14,24,0.000333,0.031255,3,281.296123,15.627562,93.765374,44.0391,1,0
0,0,4,4,6,8,14,17,12,29,0.000333,0.036804,3,331.239878,18.402215,110.413293,39.509775,3,0
0,0,4,4,13,8,21,27,11,38,0.000333,0.055636,6,1001.448372,55.636021,166.908062,72.105716,3,0
0,0,5,5,9,15,24,22,19,41,0.000333,0.062661,4,751.93385,41.774103,187.983463,87.132684,3,0
0,0,3,3,10,8,18,16,13,29,0.000333,0.040309,5,604.639125,33.591063,120.927825,57.219281,3,0
0,0,4,4,10,9,19,23,14,37,0.000333,0.052391,5,785.86659,43.659255,157.173318,61.748606,2,0
0,0,3,3,10,8,18,16,13,29,0.000333,0.040309,5,604.639125,33.591063,120.927825,57.219281,3,0
0,0,4,4,11,10,21,26,17,43,0.000333,0.062957,5,944.348246,52.463791,188.869649,71.273029,2,0
0,0,3,3,10,8,18,16,13,29,0.000333,0.040309,5,604.639125,33.591063,120.927825,57.219281,3,0
0,0,18,18,14,36,50,111,62,173,0.000333,0.325462,7,6834.709846,379.706103,976.387121,239.420269,11,0
0,0,3,3,9,9,18,18,13,31,0.000333,0.043089,4,517.0707,28.72615,129.267675,57.05865,2,0
0,0,3,3,10,8,18,16,13,29,0.000333,0.040309,5,604.639125,33.591063,120.927825,57.219281,3,0
0,0,3,3,10,8,18,16,13,29,0.000333,0.040309,5,604.639125,33.591063,120.927825,57.219281,3,0
0,0,4,4,11,10,21,26,17,43,0.000333,0.062957,5,944.348246,52.463791,188.869649,71.273029,2,0
0,0,8,8,15,18,33,66,34,100,0.000333,0.168146,7,3531.075884,196.170882,504.439412,133.662009,2,0
0,0,3,3,10,8,18,16,13,29,0.000333,0.040309,5,604.639125,33.591063,120.927825,57.219281,3,0
0,0,3,3,10,8,18,16,13,29,0.000333,0.040309,5,604.639125,33.591063,120.927825,57.219281,3,0
0,0,6,6,10,14,24,28,21,49,0.000333,0.074888,5,1123.315813,62.406434,224.663163,86.52225,1,0
0,0,7,7,11,19,30,44,28,72,0.000333,0.117765,5,1766.480614,98.137812,353.296123,118.764371,2,0
0,0,4,4,4,7,11,13,11,24,0.000333,0.027675,2,166.052718,9.225151,83.026359,27.651484,3,0
0,0,4,4,13,8,21,27,11,38,0.000333,0.055636,6,1001.448372,55.636021,166.908062,72.105716,3,0
0,0,10,10,15,27,42,169,61,230,0.000333,0.413411,14,17363.2621,964.625672,1240.233007,186.985321,7,0
0,0,3,3,10,11,21,22,15,37,0.000333,0.054172,5,812.578723,45.143262,162.515745,71.273029,4,0
0,0,3,3,10,8,18,16,13,29,0.000333,0.040309,5,604.639125,33.591063,120.927825,57.219281,3,0
0,0,3,3,9,9,18,18,13,31,0.000333,0.043089,4,517.0707,28.72615,129.267675,57.05865,2,0
0,0,37,37,21,48,69,188,117,305,0.000333,0.621033,20,37261.99919,2070.111066,1863.099959,360.316866,16,0
0,0,27,27,17,39,56,141,78,219,0.000333,0.423937,16,20348.97165,1130.498425,1271.810728,275.617555,10,0
0,0,12,12,18,22,40,65,53,118,0.000333,0.209329,18,11303.77527,627.987515,627.987515,173.166146,6,0
0,0,3,3,10,8,18,16,13,29,0.000333,0.040309,5,604.639125,33.591063,120.927825,57.219281,3,0
0,0,27,27,17,38,55,141,76,217,0.000333,0.418185,16,20072.88093,1115.160051,1254.555058,268.908114,10,0
0,0,5,5,10,9,19,21,13,34,0.000333,0.048143,5,722.147677,40.119315,144.429535,61.748606,5,0
0,0,5,5,7,9,16,23,14,37,0.000333,0.049333,3,444,24.666667,148,48.180809,1,0
0,0,27,27,17,38,55,143,76,219,0.000333,0.422039,16,20257.88444,1125.438024,1266.117777,268.908114,10,0
0,0,4,4,11,10,21,26,17,43,0.000333,0.062957,5,944.348246,52.463791,188.869649,71.273029,2,0
0,0,3,3,10,8,18,16,13,29,0.000333,0.040309,5,604.639125,33.591063,120.927825,57.219281,3,0
0,0,3,3,10,8,18,16,13,29,0.000333,0.040309,5,604.639125,33.591063,120.927825,57.219281,3,0
0,0,6,6,9,18,27,24,23,47,0.000333,0.074493,4,893.91885,49.662158,223.479713,103.587975,3,0
0,0,4,4,4,7,11,13,11,24,0.000333,0.027675,2,166.052718,9.225151,83.026359,27.651484,3,0
0,0,6,6,13,13,26,38,23,61,0.000333,0.095576,6,1720.360937,95.575608,286.726823,96.211433,4,0
0,0,5,5,12,16,28,39,25,64,0.000333,0.102557,6,1846.02429,102.556905,307.670715,107.01955,2,0
0,0,20,20,19,27,46,157,73,230,0.000333,0.423473,18,22867.5465,1270.41925,1270.41925,209.092585,10,0
0,0,7,7,11,19,30,44,28,72,0.000333,0.117765,5,1766.480614,98.137812,353.296123,118.764371,2,0
0,0,19,19,19,27,46,152,72,224,0.000333,0.412426,18,22271.00181,1237.277878,1237.277878,209.092585,9,0
0,0,7,7,12,17,29,43,27,70,0.000333,0.113353,6,2040.352018,113.35289,340.05867,112.506418,4,0
0,0,7,7,11,19,30,44,28,72,0.000333,0.117765,5,1766.480614,98.137812,353.296123,118.764371,2,0
0,0,3,3,10,8,18,16,13,29,0.000333,0.040309,5,604.639125,33.591063,120.927825,57.219281,3,0
0,0,4,4,13,8,21,27,11,38,0.000333,0.055636,6,1001.448372,55.636021,166.908062,72.105716,3,0
0,0,10,10,15,27,42,169,61,230,0.000333,0.413411,14,17363.2621,964.625672,1240.233007,186.985321,7,0
0,0,3,3,10,6,16,19,10,29,0.000333,0.038667,5,580,32.222222,116,48.729056,1,0
0,0,4,4,7,9,16,16,12,28,0.000333,0.037333,3,336,18.666667,112,48.180809,3,0
0,0,7,7,12,17,29,43,27,70,0.000333,0.113353,6,2040.352018,113.35289,340.05867,112.506418,4,0
0,0,4,4,4,7,11,13,11,24,0.000333,0.027675,2,166.052718,9.225151,83.026359,27.651484,3,0
0,0,28,28,18,42,60,147,81,228,0.000333,0.448924,9,12120.9395,673.385528,1346.771056,301.535982,10,0
0,0,14,14,11,23,34,85,48,133,0.000333,0.225544,10,6766.325579,375.906977,676.632558,142.095673,6,0
0,0,4,4,11,9,20,23,14,37,0.000333,0.053304,5,799.556698,44.419817,159.91134,66.583073,2,0
0,0,4,4,10,12,22,21,17,38,0.000333,0.056486,5,847.292008,47.071778,169.458402,76.238831,1,0
0,0,3,3,10,10,20,17,13,30,0.000333,0.043219,5,648.289214,36.016067,129.657843,66.438562,2,0
0,0,11,11,13,26,39,54,48,102,0.000333,0.179704,6,3234.666158,179.703675,539.111026,170.317149,4,0
0,0,3,3,8,10,18,20,14,34,0.000333,0.047259,4,567.1098,31.5061,141.77745,57.219281,1,0
0,0,3,3,10,8,18,16,13,29,0.000333,0.040309,5,604.639125,33.591063,120.927825,57.219281,3,0
0,0,3,3,9,9,18,18,13,31,0.000333,0.043089,4,517.0707,28.72615,129.267675,57.05865,2,0
0,0,7,7,11,19,30,44,28,72,0.000333,0.117765,5,1766.480614,98.137812,353.296123,118.764371,2,0
0,0,3,3,5,6,11,9,8,17,0.000333,0.019603,2,117.620675,6.534482,58.810338,27.119415,1,0
0,0,3,3,10,11,21,22,15,37,0.000333,0.054172,5,812.578723,45.143262,162.515745,71.273029,4,0
0,0,34,34,16,36,52,216,123,339,0.000333,0.64415,24,46378.77755,2576.598753,1932.449064,250.1173,5,0
0,0,7,7,11,19,30,44,28,72,0.000333,0.117765,5,1766.480614,98.137812,353.296123,118.764371,2,0
0,0,56,56,28,89,117,556,373,929,0.000333,2.127523,56,357423.8542,19856.88079,6382.568824,710.946213,30,0
0,0,7,7,11,19,30,44,28,72,0.000333,0.117765,5,1766.480614,98.137812,353.296123,118.764371,2,0
0,0,3,3,10,8,18,16,13,29,0.000333,0.040309,5,604.639125,33.591063,120.927825,57.219281,3,0
0,0,7,7,11,19,30,44,28,72,0.000333,0.117765,5,1766.480614,98.137812,353.296123,118.764371,2,0
0,0,3,3,9,9,18,18,13,31,0.000333,0.043089,4,517.0707,28.72615,129.267675,57.05865,2,0
0,0,3,3,9,9,18,18,13,31,0.000333,0.043089,4,517.0707,28.72615,129.267675,57.05865,2,0
0,0,8,8,13,16,29,42,29,71,0.000333,0.114972,6,2069.499904,114.972217,344.916651,112.105716,2,0
0,0,3,3,8,10,18,20,13,33,0.000333,0.045869,4,550.4301,30.57945,137.607525,57.219281,3,0
0,0,3,3,10,8,18,20,12,32,0.000333,0.044479,5,667.188,37.066,133.4376,57.219281,2,0
0,0,7,7,11,19,30,44,28,72,0.000333,0.117765,5,1766.480614,98.137812,353.296123,118.764371,2,0
0,0,32,32,18,44,62,160,94,254,0.000333,0.504122,18,27222.58553,1512.365863,1512.365863,315.273641,14,0
0,0,4,4,4,7,11,13,11,24,0.000333,0.027675,2,166.052718,9.225151,83.026359,27.651484,3,0
0,0,3,3,5,6,11,9,8,17,0.000333,0.019603,2,117.620675,6.534482,58.810338,27.119415,1,0
0,0,3,3,10,8,18,16,13,29,0.000333,0.040309,5,604.639125,33.591063,120.927825,57.219281,3,0
0,0,5,5,12,16,28,39,25,64,0.000333,0.102557,6,1846.02429,102.556905,307.670715,107.01955,2,0
0,0,5,5,9,13,22,26,19,45,0.000333,0.066891,4,802.697691,44.594316,200.674423,76.635041,2,0
0,0,3,3,10,8,18,16,13,29,0.000333,0.040309,5,604.639125,33.591063,120.927825,57.219281,3,0
0,0,3,3,9,9,18,18,13,31,0.000333,0.043089,4,517.0707,28.72615,129.267675,57.05865,2,0
0,0,3,3,10,8,18,16,13,29,0.000333,0.040309,5,604.639125,33.591063,120.927825,57.219281,3,0
0,0,3,3,10,8,18,16,13,29,0.000333,0.040309,5,604.639125,33.591063,120.927825,57.219281,3,0
0,0,10,10,15,27,42,169,61,230,0.000333,0.413411,14,17363.2621,964.625672,1240.233007,186.985321,7,0
0,0,4,4,4,7,11,13,11,24,0.000333,0.027675,2,166.052718,9.225151,83.026359,27.651484,3,0
0,0,3,3,10,8,18,16,13,29,0.000333,0.040309,5,604.639125,33.591063,120.927825,57.219281,3,0
0,0,6,6,15,15,30,35,24,59,0.000333,0.096502,7,2026.545816,112.585879,289.506545,117.206718,4,0
0,0,4,4,4,7,11,13,11,24,0.000333,0.027675,2,166.052718,9.225151,83.026359,27.651484,3,0
0,0,7,7,11,19,30,44,28,72,0.000333,0.117765,5,1766.480614,98.137812,353.296123,118.764371,2,0
0,0,3,3,10,8,18,16,13,29,0.000333,0.040309,5,604.639125,33.591063,120.927825,57.219281,3,0
0,0,6,6,13,13,26,38,23,61,0.000333,0.095576,6,1720.360937,95.575608,286.726823,96.211433,4,0
0,0,3,3,10,8,18,16,13,29,0.000333,0.040309,5,604.639125,33.591063,120.927825,57.219281,3,0
0,0,4,4,11,10,21,23,15,38,0.000333,0.055636,5,834.54031,46.363351,166.908062,71.273029,2,0
0,0,3,3,10,8,18,16,13,29,0.000333,0.040309,5,604.639125,33.591063,120.927825,57.219281,3,0
0,0,9,9,12,20,32,46,38,84,0.000333,0.14,6,2520,140,420,129.458112,4,0
0,0,3,3,10,10,20,17,13,30,0.000333,0.043219,5,648.289214,36.016067,129.657843,66.438562,2,0
0,0,17,17,16,23,39,110,55,165,0.000333,0.290697,16,13953.46186,775.192325,872.091366,168.041925,7,0
0,0,3,3,9,9,18,18,13,31,0.000333,0.043089,4,517.0707,28.72615,129.267675,57.05865,2,0
0,0,3,3,9,9,18,18,13,31,0.000333,0.043089,4,517.0707,28.72615,129.267675,57.05865,2,0
0,0,7,7,11,19,30,44,28,72,0.000333,0.117765,5,1766.480614,98.137812,353.296123,118.764371,2,0
0,0,6,6,13,13,26,38,23,61,0.000333,0.095576,6,1720.360937,95.575608,286.726823,96.211433,4,0
0,0,4,4,4,7,11,13,11,24,0.000333,0.027675,2,166.052718,9.225151,83.026359,27.651484,3,0
0,0,3,3,9,9,18,18,13,31,0.000333,0.043089,4,517.0707,28.72615,129.267675,57.05865,2,0
0,0,3,3,8,10,18,20,13,33,0.000333,0.045869,4,550.4301,30.57945,137.607525,57.219281,3,0
0,0,3,3,10,6,16,19,10,29,0.000333,0.038667,5,580,32.222222,116,48.729056,1,0
0,0,4,4,4,7,11,13,11,24,0.000333,0.027675,2,166.052718,9.225151,83.026359,27.651484,3,0
0,0,7,7,11,19,30,44,28,72,0.000333,0.117765,5,1766.480614,98.137812,353.296123,118.764371,2,0
0,0,13,13,13,25,38,65,49,114,0.000333,0.199421,6,3589.582419,199.421246,598.263737,164.202121,4,0
0,0,3,3,10,8,18,16,13,29,0.000333,0.040309,5,604.639125,33.591063,120.927825,57.219281,3,0
0,0,3,3,10,8,18,16,13,29,0.000333,0.040309,5,604.639125,33.591063,120.927825,57.219281,3,0
0,0,8,8,15,18,33,66,34,100,0.000333,0.168146,7,3531.075884,196.170882,504.439412,133.662009,2,0
0,0,3,3,6,7,13,13,9,22,0.000333,0.027137,3,244.229021,13.568279,81.409674,35.161259,1,0
0,0,12,12,10,15,25,58,37,95,0.000333,0.147055,10,4411.66338,245.09241,441.166338,91.82264,1,0
0,0,27,27,17,37,54,142,75,217,0.000333,0.41627,16,19980.96941,1110.053856,1248.810588,262.236643,11,0
0,0,7,7,11,19,30,44,28,72,0.000333,0.117765,5,1766.480614,98.137812,353.296123,118.764371,2,0
0,0,20,20,15,34,49,160,90,250,0.000333,0.467892,14,19651.48445,1091.749136,1403.677461,231.577096,7,0
0,0,3,3,10,8,18,16,13,29,0.000333,0.040309,5,604.639125,33.591063,120.927825,57.219281,3,0
0,0,7,7,11,19,30,44,28,72,0.000333,0.117765,5,1766.480614,98.137812,353.296123,118.764371,2,0
0,0,7,7,11,19,30,44,28,72,0.000333,0.117765,5,1766.480614,98.137812,353.296123,118.764371,2,0
0,0,3,3,9,9,18,18,13,31,0.000333,0.043089,4,517.0707,28.72615,129.267675,57.05865,2,0
0,0,7,7,11,19,30,44,28,72,0.000333,0.117765,5,1766.480614,98.137812,353.296123,118.764371,2,0
0,0,3,3,10,8,18,16,13,29,0.000333,0.040309,5,604.639125,33.591063,120.927825,57.219281,3,0
0,0,3,3,10,8,18,16,13,29,0.000333,0.040309,5,604.639125,33.591063,120.927825,57.219281,3,0
0,0,7,7,11,19,30,44,28,72,0.000333,0.117765,5,1766.480614,98.137812,353.296123,118.764371,2,0
0,0,21,21,15,29,44,115,76,191,0.000333,0.347584,14,14598.52015,811.028897,1042.751439,199.484808,9,0
0,0,3,3,10,10,20,17,13,30,0.000333,0.043219,5,648.289214,36.016067,129.657843,66.438562,2,0
0,0,3,3,10,11,21,22,15,37,0.000333,0.054172,5,812.578723,45.143262,162.515745,71.273029,4,0
0,0,3,3,10,8,18,16,13,29,0.000333,0.040309,5,604.639125,33.591063,120.927825,57.219281,3,0
0,0,3,3,9,9,18,18,13,31,0.000333,0.043089,4,517.0707,28.72615,129.267675,57.05865,2,0
0,0,7,7,11,19,30,44,28,72,0.000333,0.117765,5,1766.480614,98.137812,353.296123,118.764371,2,0
0,0,6,6,13,13,26,38,23,61,0.000333,0.095576,6,1720.360937,95.575608,286.726823,96.211433,4,0
0,0,4,4,4,7,11,13,11,24,0.000333,0.027675,2,166.052718,9.225151,83.026359,27.651484,3,0
0,0,81,81,27,78,105,525,298,823,0.000333,1.841941,39,215507.1384,11972.6188,5525.824061,618.643336,39,0
0,0,6,6,9,18,27,24,23,47,0.000333,0.074493,4,893.91885,49.662158,223.479713,103.587975,3,0
0,0,7,7,11,19,30,44,28,72,0.000333,0.117765,5,1766.480614,98.137812,353.296123,118.764371,2,0
0,0,7,7,11,19,30,44,28,72,0.000333,0.117765,5,1766.480614,98.137812,353.296123,118.764371,2,0
0,0,3,3,10,10,20,17,13,30,0.000333,0.043219,5,648.289214,36.016067,129.657843,66.438562,2,0
0,0,5,5,8,12,20,20,16,36,0.000333,0.051863,4,622.357646,34.575425,155.589411,67.01955,3,0
0,0,4,4,4,7,11,13,11,24,0.000333,0.027675,2,166.052718,9.225151,83.026359,27.651484,3,0
0,0,4,4,10,12,22,21,17,38,0.000333,0.056486,5,847.292008,47.071778,169.458402,76.238831,1,0
0,0,6,6,11,15,26,30,27,57,0.000333,0.089308,5,1339.62532,74.423629,267.925064,96.657107,2,0
0,0,6,6,9,8,17,21,13,34,0.000333,0.046325,4,555.894946,30.883053,138.973737,52.529325,2,0
0,0,4,4,10,9,19,46,19,65,0.000333,0.092038,10,2761.152884,153.397382,276.115288,61.748606,11,0
0,0,3,3,10,9,19,37,16,53,0.000333,0.075047,5,1125.700791,62.538933,225.140158,61.748606,10,0
0,0,7,7,11,19,30,44,28,72,0.000333,0.117765,5,1766.480614,98.137812,353.296123,118.764371,2,0
0,0,22,22,17,34,51,128,68,196,0.000333,0.370598,16,17788.72587,988.262548,1111.795367,242.460605,9,0
0,0,3,3,10,8,18,16,13,29,0.000333,0.040309,5,604.639125,33.591063,120.927825,57.219281,3,0
0,0,3,3,10,8,18,16,13,29,0.000333,0.040309,5,604.639125,33.591063,120.927825,57.219281,3,0
0,0,7,7,11,19,30,44,28,72,0.000333,0.117765,5,1766.480614,98.137812,353.296123,118.764371,2,0
0,0,10,10,17,19,36,59,44,103,0.000333,0.177501,16,8520.036402,473.335356,532.502275,150.197491,6,0
0,0,3,3,10,8,18,16,13,29,0.000333,0.040309,5,604.639125,33.591063,120.927825,57.219281,3,0
0,0,7,7,11,19,30,44,28,72,0.000333,0.117765,5,1766.480614,98.137812,353.296123,118.764371,2,0
0,0,3,3,11,11,22,26,15,41,0.000333,0.060946,5,914.183482,50.787971,182.836696,76.107496,3,0
0,0,4,4,4,7,11,13,11,24,0.000333,0.027675,2,166.052718,9.225151,83.026359,27.651484,3,0
0,0,17,17,16,23,39,110,55,165,0.000333,0.290697,16,13953.46186,775.192325,872.091366,168.041925,7,0
0,0,5,5,13,13,26,30,20,50,0.000333,0.078341,6,1410.131915,78.340662,235.021986,96.211433,2,0
0,0,5,5,10,14,24,27,22,49,0.000333,0.074888,5,1123.315813,62.406434,224.663163,86.52225,3,0
0,0,5,5,12,16,28,39,25,64,0.000333,0.102557,6,1846.02429,102.556905,307.670715,107.01955,2,0
0,0,4,4,11,9,20,24,12,36,0.000333,0.051863,5,777.947057,43.219281,155.589411,66.583073,5,0
0,0,3,3,8,10,18,20,13,33,0.000333,0.045869,4,550.4301,30.57945,137.607525,57.219281,3,0
0,0,3,3,10,10,20,17,13,30,0.000333,0.043219,5,648.289214,36.016067,129.657843,66.438562,2,0
0,0,6,6,14,11,25,38,23,61,0.000333,0.094425,14,3965.853186,220.325177,283.275228,91.356717,4,0
0,0,15,15,14,24,38,66,52,118,0.000333,0.206418,14,8669.576252,481.643125,619.255447,163.342069,2,0
0,0,4,4,11,10,21,26,17,43,0.000333,0.062957,5,944.348246,52.463791,188.869649,71.273029,2,0
0,0,27,27,17,36,53,139,77,216,0.000333,0.41241,16,19795.69309,1099.760727,1237.230818,255.604168,10,0
0,0,3,3,10,8,18,16,13,29,0.000333,0.040309,5,604.639125,33.591063,120.927825,57.219281,3,0
0,0,70,70,28,89,117,714,488,1202,0.000333,2.752726,70,578072.4875,32115.1382,8258.178393,710.946213,39,0
0,0,3,3,5,6,11,9,8,17,0.000333,0.019603,2,117.620675,6.534482,58.810338,27.119415,1,0
0,0,3,3,10,8,18,16,13,29,0.000333,0.040309,5,604.639125,33.591063,120.927825,57.219281,3,0
0,0,3,3,10,11,21,22,15,37,0.000333,0.054172,5,812.578723,45.143262,162.515745,71.273029,4,0
0,0,4,4,4,7,11,13,11,24,0.000333,0.027675,2,166.052718,9.225151,83.026359,27.651484,3,0
0,0,4,4,8,11,19,17,15,32,0.000333,0.045311,4,543.734722,30.207485,135.93368,62.053748,3,0
0,0,3,3,10,8,18,16,13,29,0.000333,0.040309,5,604.639125,33.591063,120.927825,57.219281,3,0
0,0,3,3,10,8,18,16,13,29,0.000333,0.040309,5,604.639125,33.591063,120.927825,57.219281,3,0
0,0,7,7,11,19,30,44,28,72,0.000333,0.117765,5,1766.480614,98.137812,353.296123,118.764371,2,0
0,0,10,10,18,17,35,60,40,100,0.000333,0.170976,18,9232.709431,512.928302,512.928302,144.545518,6,0
0,0,3,3,10,9,19,37,16,53,0.000333,0.075047,5,1125.700791,62.538933,225.140158,61.748606,10,0
0,0,4,4,6,8,14,17,12,29,0.000333,0.036804,3,331.239878,18.402215,110.413293,39.509775,3,0
0,0,7,7,11,19,30,44,28,72,0.000333,0.117765,5,1766.480614,98.137812,353.296123,118.764371,2,0
0,0,6,6,13,13,26,38,23,61,0.000333,0.095576,6,1720.360937,95.575608,286.726823,96.211433,4,0
0,0,7,7,12,17,29,43,27,70,0.000333,0.113353,6,2040.352018,113.35289,340.05867,112.506418,4,0
0,0,11,11,12,18,30,69,40,109,0.000333,0.178284,12,6418.212899,356.567383,534.851075,118.0782,2,0
0,0,4,4,9,8,17,22,14,36,0.000333,0.04905,4,588.594649,32.699703,147.148662,52.529325,3,0
0,0,7,7,12,14,26,37,22,59,0.000333,0.092442,6,1663.95566,92.441981,277.325943,96.322519,2,0
0,0,27,27,21,27,48,179,86,265,0.000333,0.493338,30,44400.45188,2466.691771,1480.015063,220.620628,16,0
0,0,4,4,6,8,14,17,12,29,0.000333,0.036804,3,331.239878,18.402215,110.413293,39.509775,3,0
0,0,7,7,11,19,30,44,28,72,0.000333,0.117765,5,1766.480614,98.137812,353.296123,118.764371,2,0
0,0,3,3,6,7,13,13,9,22,0.000333,0.027137,3,244.229021,13.568279,81.409674,35.161259,1,0
0,0,3,3,10,8,18,16,13,29,0.000333,0.040309,5,604.639125,33.591063,120.927825,57.219281,3,0
0,0,4,4,10,9,19,46,19,65,0.000333,0.092038,10,2761.152884,153.397382,276.115288,61.748606,11,0
0,0,7,7,11,19,30,44,28,72,0.000333,0.117765,5,1766.480614,98.137812,353.296123,118.764371,2,0
0,0,3,3,10,9,19,37,16,53,0.000333,0.075047,5,1125.700791,62.538933,225.140158,61.748606,10,0
0,0,7,7,11,19,30,44,28,72,0.000333,0.117765,5,1766.480614,98.137812,353.296123,118.764371,2,0
0,0,7,7,11,19,30,44,28,72,0.000333,0.117765,5,1766.480614,98.137812,353.296123,118.764371,2,0
0,0,4,4,11,10,21,26,17,43,0.000333,0.062957,5,944.348246,52.463791,188.869649,71.273029,2,0
0,0,7,7,11,19,30,44,28,72,0.000333,0.117765,5,1766.480614,98.137812,353.296123,118.764371,2,0
0,0,17,17,16,23,39,110,55,165,0.000333,0.290697,16,13953.46186,775.192325,872.091366,168.041925,7,0
0,0,3,3,10,8,18,16,13,29,0.000333,0.040309,5,604.639125,33.591063,120.927825,57.219281,3,0
0,0,7,7,11,19,30,44,28,72,0.000333,0.117765,5,1766.480614,98.137812,353.296123,118.764371,2,0
0,0,3,3,10,8,18,16,13,29,0.000333,0.040309,5,604.639125,33.591063,120.927825,57.219281,3,0
0,0,5,5,12,16,28,39,25,64,0.000333,0.102557,6,1846.02429,102.556905,307.670715,107.01955,2,0
0,0,7,7,11,18,29,48,28,76,0.000333,0.123069,5,1846.032778,102.557377,369.206556,113.112398,1,0
0,0,16,16,14,25,39,87,47,134,0.000333,0.236081,7,4957.707281,275.428182,708.243897,169.399374,5,0
0,0,4,4,7,13,20,20,20,40,0.000333,0.057626,3,518.631371,28.812854,172.877124,67.757201,2,0
0,0,11,11,15,21,36,84,43,127,0.000333,0.21886,14,9192.126653,510.673703,656.580475,150.842025,2,0
0,0,3,3,10,8,18,16,13,29,0.000333,0.040309,5,604.639125,33.591063,120.927825,57.219281,3,0
0,0,4,4,10,12,22,21,17,38,0.000333,0.056486,5,847.292008,47.071778,169.458402,76.238831,1,0
0,0,7,7,16,14,30,45,29,74,0.000333,0.121037,16,5809.758465,322.764359,363.109904,117.302969,4,0
0,0,6,6,11,14,25,29,21,50,0.000333,0.077398,5,1160.964047,64.498003,232.192809,91.356717,1,0
0,0,3,3,10,8,18,16,13,29,0.000333,0.040309,5,604.639125,33.591063,120.927825,57.219281,3,0
0,0,6,6,13,13,26,38,23,61,0.000333,0.095576,6,1720.360937,95.575608,286.726823,96.211433,4,0
0,0,7,7,12,17,29,43,27,70,0.000333,0.113353,6,2040.352018,113.35289,340.05867,112.506418,4,0
0,0,5,5,10,10,20,27,14,41,0.000333,0.059066,5,885.995259,49.221959,177.199052,66.438562,3,0
0,0,7,7,11,19,30,44,28,72,0.000333,0.117765,5,1766.480614,98.137812,353.296123,118.764371,2,0
0,0,3,3,10,8,18,16,13,29,0.000333,0.040309,5,604.639125,33.591063,120.927825,57.219281,3,0
0,0,3,3,7,9,16,17,12,29,0.000333,0.038667,3,348,19.333333,116,48.180809,2,0
0,0,7,7,11,18,29,48,28,76,0.000333,0.123069,5,1846.032778,102.557377,369.206556,113.112398,1,0
0,0,4,4,11,10,21,26,17,43,0.000333,0.062957,5,944.348246,52.463791,188.869649,71.273029,2,0
0,0,14,14,18,21,39,77,54,131,0.000333,0.230796,18,12462.97843,692.387691,692.387691,167.297316,6,0
0,0,4,4,11,9,20,24,12,36,0.000333,0.051863,5,777.947057,43.219281,155.589411,66.583073,5,0
0,0,7,7,14,16,30,42,33,75,0.000333,0.122672,14,5152.235125,286.235285,368.016795,117.302969,4,0
0,0,4,4,11,10,21,26,17,43,0.000333,0.062957,5,944.348246,52.463791,188.869649,71.273029,2,0
0,0,11,11,15,21,36,84,43,127,0.000333,0.21886,14,9192.126653,510.673703,656.580475,150.842025,2,0
0,0,3,3,10,8,18,16,13,29,0.000333,0.040309,5,604.639125,33.591063,120.927825,57.219281,3,0
0,0,12,12,16,23,39,72,54,126,0.000333,0.221987,16,10655.37087,591.965049,665.96068,168.041925,4,0
0,0,15,15,11,37,48,83,71,154,0.000333,0.286695,5,4300.421126,238.912285,860.084225,230.803522,6,0
0,0,4,4,4,7,11,13,11,24,0.000333,0.027675,2,166.052718,9.225151,83.026359,27.651484,3,0
0,0,7,7,11,19,30,44,28,72,0.000333,0.117765,5,1766.480614,98.137812,353.296123,118.764371,2,0
0,0,3,3,9,9,18,18,13,31,0.000333,0.043089,4,517.0707,28.72615,129.267675,57.05865,2,0
0,0,3,3,10,8,18,20,12,32,0.000333,0.044479,5,667.188,37.066,133.4376,57.219281,2,0
0,0,5,5,13,10,23,35,21,56,0.000333,0.08444,12,3039.833634,168.879646,253.31947,81.324997,4,0
0,0,6,6,14,10,24,37,22,59,0.000333,0.090171,14,3787.179026,210.398835,270.512788,86.52225,4,0
0,0,7,7,11,19,30,44,28,72,0.000333,0.117765,5,1766.480614,98.137812,353.296123,118.764371,2,0
0,0,4,4,7,14,21,20,22,42,0.000333,0.061492,3,553.431995,30.746222,184.477332,72.954453,2,0
0,0,3,3,9,9,18,18,13,31,0.000333,0.043089,4,517.0707,28.72615,129.267675,57.05865,2,0
0,0,3,3,9,9,18,18,13,31,0.000333,0.043089,4,517.0707,28.72615,129.267675,57.05865,2,0
0,0,7,7,11,19,30,44,28,72,0.000333,0.117765,5,1766.480614,98.137812,353.296123,118.764371,2,0
0,0,8,8,12,17,29,51,32,83,0.000333,0.134404,6,2419.274536,134.404141,403.212423,112.506418,5,0
0,0,5,5,7,9,16,23,14,37,0.000333,0.049333,3,444,24.666667,148,48.180809,1,0
0,0,7,7,12,14,26,37,30,67,0.000333,0.104976,12,3779.153533,209.952974,314.929461,96.322519,1,0
0,0,4,4,4,7,11,13,11,24,0.000333,0.027675,2,166.052718,9.225151,83.026359,27.651484,3,0
0,0,3,3,10,10,20,17,13,30,0.000333,0.043219,5,648.289214,36.016067,129.657843,66.438562,2,0
0,0,5,5,8,9,17,26,14,40,0.000333,0.0545,4,653.994055,36.333003,163.498514,52.529325,1,0
0,0,10,10,15,27,42,169,61,230,0.000333,0.413411,14,17363.2621,964.625672,1240.233007,186.985321,7,0
0,0,6,6,9,13,22,31,19,50,0.000333,0.074324,4,891.886324,49.54924,222.971581,76.635041,1,0
0,0,7,7,11,19,30,44,28,72,0.000333,0.117765,5,1766.480614,98.137812,353.296123,118.764371,2,0
0,0,9,9,12,12,24,52,31,83,0.000333,0.126851,12,4566.622651,253.701258,380.551888,86.0391,4,0
0,0,6,6,8,16,24,48,28,76,0.000333,0.116152,4,1393.8286,77.434922,348.45715,88,1,0
0,0,16,16,15,27,42,89,49,138,0.000333,0.248047,7,5208.97863,289.387702,744.139804,186.985321,6,0
0,0,4,4,11,10,21,26,17,43,0.000333,0.062957,5,944.348246,52.463791,188.869649,71.273029,2,0
0,0,10,10,17,19,36,59,44,103,0.000333,0.177501,16,8520.036402,473.335356,532.502275,150.197491,6,0
0,0,3,3,10,8,18,16,13,29,0.000333,0.040309,5,604.639125,33.591063,120.927825,57.219281,3,0
0,0,7,7,14,15,29,42,31,73,0.000333,0.118211,14,4964.856577,275.825365,354.632613,111.906328,4,0
0,0,3,3,10,8,18,16,13,29,0.000333,0.040309,5,604.639125,33.591063,120.927825,57.219281,3,0
0,0,5,5,11,16,27,28,25,53,0.000333,0.084003,5,1260.045188,70.00251,252.009038,102.053748,4,0
0,0,3,3,10,8,18,16,13,29,0.000333,0.040309,5,604.639125,33.591063,120.927825,57.219281,3,0
0,0,3,3,9,9,18,18,13,31,0.000333,0.043089,4,517.0707,28.72615,129.267675,57.05865,2,0
0,0,7,7,11,16,27,35,27,62,0.000333,0.098268,5,1474.015126,81.889729,294.803025,102.053748,2,0
0,0,6,6,13,13,26,38,23,61,0.000333,0.095576,6,1720.360937,95.575608,286.726823,96.211433,4,0
0,0,3,3,9,9,18,18,13,31,0.000333,0.043089,4,517.0707,28.72615,129.267675,57.05865,2,0
0,0,5,5,12,16,28,39,25,64,0.000333,0.102557,6,1846.02429,102.556905,307.670715,107.01955,2,0
0,0,9,9,10,19,29,39,30,69,0.000333,0.111734,5,1676.003443,93.111302,335.200689,113.929904,3,0
0,0,36,36,15,37,52,239,135,374,0.000333,0.710655,21,44771.25355,2487.291864,2131.964455,251.353133,3,0
0,0,39,39,21,48,69,204,133,337,0.000333,0.686191,20,41171.45484,2287.303047,2058.572742,360.316866,17,0
0,0,3,3,10,10,20,17,13,30,0.000333,0.043219,5,648.289214,36.016067,129.657843,66.438562,2,0
0,0,17,17,16,23,39,110,55,165,0.000333,0.290697,16,13953.46186,775.192325,872.091366,168.041925,7,0
0,0,4,4,10,7,17,21,10,31,0.000333,0.042237,5,633.55674,35.197597,126.711348,52.870765,2,0
0,0,7,7,11,19,30,44,28,72,0.000333,0.117765,5,1766.480614,98.137812,353.296123,118.764371,2,0
0,0,3,3,10,8,18,16,13,29,0.000333,0.040309,5,604.639125,33.591063,120.927825,57.219281,3,0
0,0,7,7,11,19,30,44,28,72,0.000333,0.117765,5,1766.480614,98.137812,353.296123,118.764371,2,0
0,0,3,3,10,8,18,16,13,29,0.000333,0.040309,5,604.639125,33.591063,120.927825,57.219281,3,0
0,0,7,7,11,19,30,44,28,72,0.000333,0.117765,5,1766.480614,98.137812,353.296123,118.764371,2,0
0,0,27,27,17,36,53,141,77,218,0.000333,0.416229,16,19978.98655,1109.943697,1248.686659,255.604168,10,0
0,0,3,3,8,10,18,20,13,33,0.000333,0.045869,4,550.4301,30.57945,137.607525,57.219281,3,0
0,0,3,3,9,9,18,18,13,31,0.000333,0.043089,4,517.0707,28.72615,129.267675,57.05865,2,0
0,0,12,12,10,20,30,68,44,112,0.000333,0.183191,10,5495.717467,305.317637,549.571747,119.657843,6,0
0,0,6,6,14,12,26,38,24,62,0.000333,0.097142,14,4079.981675,226.665649,291.427263,96.322519,4,0
0,0,7,7,11,19,30,44,28,72,0.000333,0.117765,5,1766.480614,98.137812,353.296123,118.764371,2,0
0,0,4,4,4,7,11,13,11,24,0.000333,0.027675,2,166.052718,9.225151,83.026359,27.651484,3,0
0,0,17,17,16,23,39,110,55,165,0.000333,0.290697,16,13953.46186,775.192325,872.091366,168.041925,7,0
0,0,3,3,5,6,11,9,8,17,0.000333,0.019603,2,117.620675,6.534482,58.810338,27.119415,1,0
0,0,12,12,12,17,29,72,44,116,0.000333,0.187842,12,6762.309545,375.683864,563.525795,112.506418,6,0
0,0,7,7,11,12,23,29,18,47,0.000333,0.070869,5,1063.03706,59.057614,212.607412,81.073298,3,0
0,0,22,22,17,35,52,129,69,198,0.000333,0.376229,8,9029.496514,501.638695,1128.687064,249.011774,9,0
0,0,3,3,7,8,15,23,12,35,0.000333,0.04558,3,410.223513,22.790195,136.741171,43.651484,1,0
0,0,8,8,10,18,28,68,36,104,0.000333,0.166655,10,4999.649119,277.758284,499.964912,108.277931,1,0
0,0,4,4,4,7,11,13,11,24,0.000333,0.027675,2,166.052718,9.225151,83.026359,27.651484,3,0
0,0,27,27,17,39,56,150,79,229,0.000333,0.443295,16,21278.14843,1182.119357,1329.884277,275.617555,11,0
0,0,3,3,10,8,18,16,13,29,0.000333,0.040309,5,604.639125,33.591063,120.927825,57.219281,3,0
0,0,7,7,11,10,21,36,17,53,0.000333,0.077598,5,1163.964117,64.664673,232.792823,71.273029,4,0
0,0,8,8,17,13,30,41,27,68,0.000333,0.111223,16,5338.696968,296.594276,333.668561,117.592585,4,0
0,0,8,8,9,17,26,35,26,61,0.000333,0.095576,4,1146.907291,63.717072,286.726823,98.016193,3,0
0,0,4,4,4,7,11,13,11,24,0.000333,0.027675,2,166.052718,9.225151,83.026359,27.651484,3,0
0,0,7,7,11,19,30,44,28,72,0.000333,0.117765,5,1766.480614,98.137812,353.296123,118.764371,2,0
0,0,5,5,11,13,24,27,22,49,0.000333,0.074888,5,1123.315813,62.406434,224.663163,86.159464,2,0
0,0,7,7,11,19,30,44,28,72,0.000333,0.117765,5,1766.480614,98.137812,353.296123,118.764371,2,0
0,0,4,4,11,10,21,26,17,43,0.000333,0.062957,5,944.348246,52.463791,188.869649,71.273029,2,0
0,0,29,29,22,49,71,182,138,320,0.000333,0.655973,22,43294.21972,2405.234429,1967.919078,373.228278,5,0
0,0,7,7,11,19,30,44,28,72,0.000333,0.117765,5,1766.480614,98.137812,353.296123,118.764371,2,0
0,0,3,3,5,5,10,12,7,19,0.000333,0.021039,2,126.233268,7.012959,63.116634,23.219281,1,0
0,0,3,3,10,8,18,16,13,29,0.000333,0.040309,5,604.639125,33.591063,120.927825,57.219281,3,0
0,0,3,3,10,8,18,16,13,29,0.000333,0.040309,5,604.639125,33.591063,120.927825,57.219281,3,0
0,0,4,4,4,7,11,13,11,24,0.000333,0.027675,2,166.052718,9.225151,83.026359,27.651484,3,0
0,0,4,4,7,12,19,20,18,38,0.000333,0.053807,3,484.263737,26.903541,161.421246,62.671034,2,0
0,0,4,4,4,7,11,13,11,24,0.000333,0.027675,2,166.052718,9.225151,83.026359,27.651484,3,0
0,0,3,3,9,9,18,18,13,31,0.000333,0.043089,4,517.0707,28.72615,129.267675,57.05865,2,0
0,0,3,3,10,11,21,22,15,37,0.000333,0.054172,5,812.578723,45.143262,162.515745,71.273029,4,0
0,0,3,3,10,10,20,17,13,30,0.000333,0.043219,5,648.289214,36.016067,129.657843,66.438562,2,0
0,0,8,8,17,13,30,41,27,68,0.000333,0.111223,16,5338.696968,296.594276,333.668561,117.592585,4,0
0,0,7,7,11,15,26,36,32,68,0.000333,0.106543,10,3196.299008,177.572167,319.629901,96.657107,1,0
0,0,6,6,9,18,27,24,23,47,0.000333,0.074493,4,893.91885,49.662158,223.479713,103.587975,3,0
0,0,17,17,16,23,39,110,55,165,0.000333,0.290697,16,13953.46186,775.192325,872.091366,168.041925,7,0
0,0,7,7,11,19,30,44,28,72,0.000333,0.117765,5,1766.480614,98.137812,353.296123,118.764371,2,0
0,0,3,3,9,9,18,18,13,31,0.000333,0.043089,4,517.0707,28.72615,129.267675,57.05865,2,0
0,0,3,3,10,11,21,22,15,37,0.000333,0.054172,5,812.578723,45.143262,162.515745,71.273029,4,0
0,0,7,7,11,19,30,44,28,72,0.000333,0.117765,5,1766.480614,98.137812,353.296123,118.764371,2,0
0,0,7,7,11,19,30,44,28,72,0.000333,0.117765,5,1766.480614,98.137812,353.296123,118.764371,2,0
0,0,4,4,4,7,11,13,11,24,0.000333,0.027675,2,166.052718,9.225151,83.026359,27.651484,3,0
0,0,5,5,9,13,22,26,19,45,0.000333,0.066891,4,802.697691,44.594316,200.674423,76.635041,3,0
0,0,3,3,10,8,18,16,13,29,0.000333,0.040309,5,604.639125,33.591063,120.927825,57.219281,3,0
0,0,3,3,10,11,21,22,15,37,0.000333,0.054172,5,812.578723,45.143262,162.515745,71.273029,4,0
0,0,7,7,10,13,23,37,19,56,0.000333,0.08444,5,1266.597348,70.366519,253.31947,81.324997,3,0
0,0,3,3,10,11,21,22,15,37,0.000333,0.054172,5,812.578723,45.143262,162.515745,71.273029,4,0
0,0,3,3,9,9,18,18,13,31,0.000333,0.043089,4,517.0707,28.72615,129.267675,57.05865,2,0
0,0,4,4,11,10,21,26,17,43,0.000333,0.062957,5,944.348246,52.463791,188.869649,71.273029,2,0
0,0,5,5,9,15,24,22,19,41,0.000333,0.062661,4,751.93385,41.774103,187.983463,87.132684,3,0
0,0,8,8,16,13,29,53,32,85,0.000333,0.137643,16,6606.854153,367.047453,412.928385,112.105716,6,0
0,0,3,3,10,8,18,16,13,29,0.000333,0.040309,5,604.639125,33.591063,120.927825,57.219281,3,0
0,0,7,7,11,19,30,44,28,72,0.000333,0.117765,5,1766.480614,98.137812,353.296123,118.764371,2,0
0,0,4,4,11,9,20,24,12,36,0.000333,0.051863,5,777.947057,43.219281,155.589411,66.583073,5,0
0,0,6,6,14,12,26,38,24,62,0.000333,0.097142,14,4079.981675,226.665649,291.427263,96.322519,4,0
0,0,5,5,9,15,24,22,19,41,0.000333,0.062661,4,751.93385,41.774103,187.983463,87.132684,3,0
0,0,4,4,6,8,14,17,12,29,0.000333,0.036804,3,331.239878,18.402215,110.413293,39.509775,3,0
0,0,5,5,11,13,24,27,22,49,0.000333,0.074888,5,1123.315813,62.406434,224.663163,86.159464,2,0
0,0,4,4,4,7,11,13,11,24,0.000333,0.027675,2,166.052718,9.225151,83.026359,27.651484,3,0
0,0,7,7,11,19,30,44,28,72,0.000333,0.117765,5,1766.480614,98.137812,353.296123,118.764371,2,0
0,0,7,7,11,19,30,44,28,72,0.000333,0.117765,5,1766.480614,98.137812,353.296123,118.764371,2,0
0,0,3,3,10,8,18,16,13,29,0.000333,0.040309,5,604.639125,33.591063,120.927825,57.219281,3,0
0,0,3,3,11,11,22,26,15,41,0.000333,0.060946,5,914.183482,50.787971,182.836696,76.107496,3,0
0,0,14,14,11,35,46,79,67,146,0.000333,0.268813,5,4032.200228,224.011124,806.440046,217.578653,6,0
0,0,4,4,4,7,11,13,11,24,0.000333,0.027675,2,166.052718,9.225151,83.026359,27.651484,3,0
0,0,6,6,13,13,26,38,23,61,0.000333,0.095576,6,1720.360937,95.575608,286.726823,96.211433,4,0
0,0,3,3,10,8,18,16,13,29,0.000333,0.040309,5,604.639125,33.591063,120.927825,57.219281,3,0
0,0,8,8,13,12,25,43,26,69,0.000333,0.106809,12,3845.112925,213.617385,320.426077,91.125266,4,0
0,0,8,8,12,13,25,41,24,65,0.000333,0.100617,6,1811.103914,100.616884,301.850652,91.125266,4,0
0,0,9,9,13,12,25,53,31,84,0.000333,0.130028,12,4681.007039,260.055947,390.08392,91.125266,4,0
0,0,6,6,14,12,26,38,24,62,0.000333,0.097142,14,4079.981675,226.665649,291.427263,96.322519,4,0
0,0,8,8,16,13,29,53,32,85,0.000333,0.137643,16,6606.854153,367.047453,412.928385,112.105716,6,0
0,0,4,4,11,10,21,26,17,43,0.000333,0.062957,5,944.348246,52.463791,188.869649,71.273029,2,0
0,0,3,3,8,10,18,17,13,30,0.000333,0.041699,4,500.391,27.7995,125.09775,57.219281,2,0
0,0,4,4,10,12,22,21,17,38,0.000333,0.056486,5,847.292008,47.071778,169.458402,76.238831,1,0
0,0,7,7,11,19,30,44,28,72,0.000333,0.117765,5,1766.480614,98.137812,353.296123,118.764371,2,0
0,0,7,7,11,19,30,44,28,72,0.000333,0.117765,5,1766.480614,98.137812,353.296123,118.764371,2,0
0,0,7,7,11,19,30,44,28,72,0.000333,0.117765,5,1766.480614,98.137812,353.296123,118.764371,2,0
0,0,5,5,12,16,28,39,25,64,0.000333,0.102557,6,1846.02429,102.556905,307.670715,107.01955,2,0
0,0,3,3,10,11,21,22,15,37,0.000333,0.054172,5,812.578723,45.143262,162.515745,71.273029,4,0
0,0,3,3,9,9,18,18,13,31,0.000333,0.043089,4,517.0707,28.72615,129.267675,57.05865,2,0
0,0,10,10,16,23,39,47,45,92,0.000333,0.162086,8,3890.056033,216.114224,486.257004,168.041925,4,0
0,0,3,3,10,8,18,16,13,29,0.000333,0.040309,5,604.639125,33.591063,120.927825,57.219281,3,0
0,0,3,3,10,8,18,16,13,29,0.000333,0.040309,5,604.639125,33.591063,120.927825,57.219281,3,0
0,0,26,26,11,30,41,178,95,273,0.000333,0.487537,15,21939.17546,1218.843081,1462.611697,185.260466,1,0
0,0,3,3,10,9,19,37,16,53,0.000333,0.075047,5,1125.700791,62.538933,225.140158,61.748606,10,0
0,0,4,4,7,13,20,20,20,40,0.000333,0.057626,3,518.631371,28.812854,172.877124,67.757201,2,0
0,0,5,5,9,9,18,21,13,34,0.000333,0.047259,4,567.1098,31.5061,141.77745,57.05865,2,0
0,0,4,4,10,9,19,46,19,65,0.000333,0.092038,10,2761.152884,153.397382,276.115288,61.748606,11,0
0,0,3,3,10,8,18,16,13,29,0.000333,0.040309,5,604.639125,33.591063,120.927825,57.219281,3,0
0,0,3,3,10,8,18,16,13,29,0.000333,0.040309,5,604.639125,33.591063,120.927825,57.219281,3,0
0,0,4,4,4,7,11,13,11,24,0.000333,0.027675,2,166.052718,9.225151,83.026359,27.651484,3,0
0,0,7,7,11,19,30,44,28,72,0.000333,0.117765,5,1766.480614,98.137812,353.296123,118.764371,2,0
0,0,6,6,8,16,24,50,24,74,0.000333,0.113096,4,1357.1489,75.397161,339.287225,88,3,0
0,0,3,3,5,6,11,9,8,17,0.000333,0.019603,2,117.620675,6.534482,58.810338,27.119415,1,0
0,0,12,12,17,21,38,70,51,121,0.000333,0.211666,16,10159.98767,564.443759,634.999229,161.725534,6,0
0,0,4,4,4,7,11,13,11,24,0.000333,0.027675,2,166.052718,9.225151,83.026359,27.651484,3,0
0,0,4,4,11,10,21,26,17,43,0.000333,0.062957,5,944.348246,52.463791,188.869649,71.273029,2,0
0,0,6,6,8,13,21,25,19,44,0.000333,0.064421,4,773.047866,42.947104,193.261967,72.105716,3,0
0,0,4,4,6,8,14,17,12,29,0.000333,0.036804,3,331.239878,18.402215,110.413293,39.509775,3,0
0,0,6,6,13,13,26,38,23,61,0.000333,0.095576,6,1720.360937,95.575608,286.726823,96.211433,4,0
0,0,4,4,10,9,19,46,19,65,0.000333,0.092038,10,2761.152884,153.397382,276.115288,61.748606,11,0
0,0,3,3,10,8,18,16,13,29,0.000333,0.040309,5,604.639125,33.591063,120.927825,57.219281,3,0
0,0,3,3,10,9,19,37,16,53,0.000333,0.075047,5,1125.700791,62.538933,225.140158,61.748606,10,0
0,0,3,3,10,8,18,16,13,29,0.000333,0.040309,5,604.639125,33.591063,120.927825,57.219281,3,0
0,0,3,3,10,8,18,16,13,29,0.000333,0.040309,5,604.639125,33.591063,120.927825,57.219281,3,0
0,0,3,3,10,8,18,16,13,29,0.000333,0.040309,5,604.639125,33.591063,120.927825,57.219281,3,0
0,0,3,3,10,8,18,16,13,29,0.000333,0.040309,5,604.639125,33.591063,120.927825,57.219281,3,0
0,0,7,7,11,18,29,48,28,76,0.000333,0.123069,5,1846.032778,102.557377,369.206556,113.112398,1,0
0,0,11,11,13,23,36,60,35,95,0.000333,0.163714,6,2946.857251,163.714292,491.142875,152.147641,5,0
0,0,7,7,11,19,30,44,28,72,0.000333,0.117765,5,1766.480614,98.137812,353.296123,118.764371,2,0
0,0,4,4,8,11,19,17,15,32,0.000333,0.045311,4,543.734722,30.207485,135.93368,62.053748,3,0
0,0,7,7,11,19,30,44,28,72,0.000333,0.117765,5,1766.480614,98.137812,353.296123,118.764371,2,0
0,0,4,4,4,7,11,13,11,24,0.000333,0.027675,2,166.052718,9.225151,83.026359,27.651484,3,0
0,0,4,4,10,12,22,21,17,38,0.000333,0.056486,5,847.292008,47.071778,169.458402,76.238831,1,0
0,0,4,4,11,10,21,26,17,43,0.000333,0.062957,5,944.348246,52.463791,188.869649,71.273029,2,0
0,0,6,6,13,11,24,38,23,61,0.000333,0.093228,12,3356.192551,186.455142,279.682713,86.159464,4,0
0,0,4,4,6,8,14,17,12,29,0.000333,0.036804,3,331.239878,18.402215,110.413293,39.509775,3,0
0,0,3,3,10,8,18,16,13,29,0.000333,0.040309,5,604.639125,33.591063,120.927825,57.219281,3,0
0,0,4,4,4,7,11,13,11,24,0.000333,0.027675,2,166.052718,9.225151,83.026359,27.651484,3,0
0,0,3,3,10,8,18,16,13,29,0.000333,0.040309,5,604.639125,33.591063,120.927825,57.219281,3,0
0,0,3,3,10,8,18,20,12,32,0.000333,0.044479,5,667.188,37.066,133.4376,57.219281,2,0
0,0,3,3,10,8,18,16,13,29,0.000333,0.040309,5,604.639125,33.591063,120.927825,57.219281,3,0
0,0,25,25,17,33,50,134,71,205,0.000333,0.385664,16,18511.8483,1028.436017,1156.990519,235.951874,10,0
0,0,8,8,16,13,29,56,25,81,0.000333,0.131165,8,3147.971685,174.887316,393.496461,112.105716,3,0
0,0,5,5,14,17,31,60,30,90,0.000333,0.148626,7,3121.143676,173.396871,445.877668,122.789837,4,0
0,0,3,3,10,8,18,16,13,29,0.000333,0.040309,5,604.639125,33.591063,120.927825,57.219281,3,0
0,0,3,3,10,8,18,16,13,29,0.000333,0.040309,5,604.639125,33.591063,120.927825,57.219281,3,0
0,0,17,17,16,23,39,110,55,165,0.000333,0.290697,16,13953.46186,775.192325,872.091366,168.041925,7,0
0,0,3,3,10,8,18,16,13,29,0.000333,0.040309,5,604.639125,33.591063,120.927825,57.219281,3,0
0,0,4,4,5,4,9,9,5,14,0.000333,0.014793,2,88.7579,4.930994,44.37895,19.60964,1,0
0,0,4,4,4,7,11,13,11,24,0.000333,0.027675,2,166.052718,9.225151,83.026359,27.651484,3,0
0,0,8,8,9,17,26,35,26,61,0.000333,0.095576,4,1146.907291,63.717072,286.726823,98.016193,3,0
0,0,4,4,11,9,20,24,12,36,0.000333,0.051863,5,777.947057,43.219281,155.589411,66.583073,5,0
0,0,13,13,14,21,35,65,51,116,0.000333,0.198332,14,8329.95562,462.775312,594.99683,145.541635,1,0
0,0,4,4,4,7,11,13,11,24,0.000333,0.027675,2,166.052718,9.225151,83.026359,27.651484,3,0
0,0,3,3,10,8,18,16,13,29,0.000333,0.040309,5,604.639125,33.591063,120.927825,57.219281,3,0
0,0,4,4,8,11,19,17,15,32,0.000333,0.045311,4,543.734722,30.207485,135.93368,62.053748,3,0
0,0,3,3,10,11,21,22,15,37,0.000333,0.054172,5,812.578723,45.143262,162.515745,71.273029,4,0
0,0,3,3,10,8,18,16,13,29,0.000333,0.040309,5,604.639125,33.591063,120.927825,57.219281,3,0
0,0,4,4,11,9,20,24,12,36,0.000333,0.051863,5,777.947057,43.219281,155.589411,66.583073,5,0
0,0,4,4,11,9,20,24,12,36,0.000333,0.051863,5,777.947057,43.219281,155.589411,66.583073,5,0
0,0,3,3,10,8,18,16,13,29,0.000333,0.040309,5,604.639125,33.591063,120.927825,57.219281,3,0
0,0,3,3,9,9,18,18,13,31,0.000333,0.043089,4,517.0707,28.72615,129.267675,57.05865,2,0
0,0,4,4,7,9,16,16,12,28,0.000333,0.037333,3,336,18.666667,112,48.180809,3,0
0,0,4,4,10,12,22,21,17,38,0.000333,0.056486,5,847.292008,47.071778,169.458402,76.238831,1,0
0,0,7,7,12,17,29,43,27,70,0.000333,0.113353,6,2040.352018,113.35289,340.05867,112.506418,4,0
0,0,7,7,12,17,29,43,27,70,0.000333,0.113353,6,2040.352018,113.35289,340.05867,112.506418,4,0
0,0,3,3,10,8,18,16,13,29,0.000333,0.040309,5,604.639125,33.591063,120.927825,57.219281,3,0
0,0,6,6,15,15,30,35,24,59,0.000333,0.096502,7,2026.545816,112.585879,289.506545,117.206718,4,0
0,0,12,12,15,21,36,64,46,110,0.000333,0.189564,14,7961.684502,442.315806,568.69175,150.842025,4,0
0,0,3,3,10,8,18,16,13,29,0.000333,0.040309,5,604.639125,33.591063,120.927825,57.219281,3,0
0,0,8,8,16,13,29,56,25,81,0.000333,0.131165,8,3147.971685,174.887316,393.496461,112.105716,3,0
0,0,3,3,10,9,19,37,16,53,0.000333,0.075047,5,1125.700791,62.538933,225.140158,61.748606,10,0
0,0,3,3,9,9,18,18,13,31,0.000333,0.043089,4,517.0707,28.72615,129.267675,57.05865,2,0
0,0,3,3,10,8,18,16,13,29,0.000333,0.040309,5,604.639125,33.591063,120.927825,57.219281,3,0
0,0,3,3,10,11,21,22,15,37,0.000333,0.054172,5,812.578723,45.143262,162.515745,71.273029,4,0
0,0,4,4,10,9,19,46,19,65,0.000333,0.092038,10,2761.152884,153.397382,276.115288,61.748606,11,0
0,0,3,3,10,8,18,16,13,29,0.000333,0.040309,5,604.639125,33.591063,120.927825,57.219281,3,0
0,0,4,4,6,8,14,17,12,29,0.000333,0.036804,3,331.239878,18.402215,110.413293,39.509775,3,0
0,0,5,5,8,11,19,21,19,40,0.000333,0.056639,4,679.668402,37.759356,169.917101,62.053748,3,0
0,0,7,7,11,10,21,36,17,53,0.000333,0.077598,5,1163.964117,64.664673,232.792823,71.273029,4,0
0,0,17,17,16,23,39,110,55,165,0.000333,0.290697,16,13953.46186,775.192325,872.091366,168.041925,7,0
0,0,5,5,10,10,20,27,14,41,0.000333,0.059066,5,885.995259,49.221959,177.199052,66.438562,3,0
0,0,7,7,11,18,29,48,28,76,0.000333,0.123069,5,1846.032778,102.557377,369.206556,113.112398,1,0
0,0,7,7,11,19,30,44,28,72,0.000333,0.117765,5,1766.480614,98.137812,353.296123,118.764371,2,0
0,0,8,8,15,18,33,66,34,100,0.000333,0.168146,7,3531.075884,196.170882,504.439412,133.662009,2,0
0,0,5,5,9,12,21,26,18,44,0.000333,0.064421,4,773.047866,42.947104,193.261967,71.548875,2,0
0,0,3,3,9,9,18,18,13,31,0.000333,0.043089,4,517.0707,28.72615,129.267675,57.05865,2,0
0,0,7,7,11,19,30,44,28,72,0.000333,0.117765,5,1766.480614,98.137812,353.296123,118.764371,2,0
0,0,41,41,23,44,67,283,160,443,0.000333,0.895759,33,88680.15788,4926.675438,2687.277511,344.256916,21,0
0,0,3,3,10,8,18,16,13,29,0.000333,0.040309,5,604.639125,33.591063,120.927825,57.219281,3,0
0,0,4,4,6,8,14,17,12,29,0.000333,0.036804,3,331.239878,18.402215,110.413293,39.509775,3,0
0,0,3,3,10,8,18,16,13,29,0.000333,0.040309,5,604.639125,33.591063,120.927825,57.219281,3,0
0,0,6,6,13,13,26,38,23,61,0.000333,0.095576,6,1720.360937,95.575608,286.726823,96.211433,4,0
0,0,4,4,10,11,21,20,15,35,0.000333,0.051244,5,768.655549,42.703086,153.73111,71.273029,2,0
0,0,4,4,10,12,22,21,17,38,0.000333,0.056486,5,847.292008,47.071778,169.458402,76.238831,1,0
0,0,12,12,12,19,31,58,48,106,0.000333,0.175048,12,6301.737707,350.096539,525.144809,123.730173,1,0
0,0,7,7,11,19,30,44,28,72,0.000333,0.117765,5,1766.480614,98.137812,353.296123,118.764371,2,0
0,0,4,4,4,7,11,13,11,24,0.000333,0.027675,2,166.052718,9.225151,83.026359,27.651484,3,0
0,0,3,3,10,8,18,16,13,29,0.000333,0.040309,5,604.639125,33.591063,120.927825,57.219281,3,0
0,0,7,7,14,15,29,42,31,73,0.000333,0.118211,14,4964.856577,275.825365,354.632613,111.906328,4,0
0,0,8,8,12,14,26,32,23,55,0.000333,0.086175,6,1551.145107,86.174728,258.524184,96.322519,3,0
0,0,3,3,11,11,22,26,15,41,0.000333,0.060946,5,914.183482,50.787971,182.836696,76.107496,3,0
0,0,7,7,11,19,30,44,28,72,0.000333,0.117765,5,1766.480614,98.137812,353.296123,118.764371,2,0
0,0,28,28,18,42,60,147,81,228,0.000333,0.448924,9,12120.9395,673.385528,1346.771056,301.535982,10,0
0,0,7,7,11,19,30,44,28,72,0.000333,0.117765,5,1766.480614,98.137812,353.296123,118.764371,2,0
0,0,3,3,8,8,16,16,11,27,0.000333,0.036,4,432,24,108,48,2,0
0,0,3,3,9,9,18,18,13,31,0.000333,0.043089,4,517.0707,28.72615,129.267675,57.05865,2,0
0,0,5,5,12,16,28,39,25,64,0.000333,0.102557,6,1846.02429,102.556905,307.670715,107.01955,2,0
0,0,3,3,10,8,18,16,13,29,0.000333,0.040309,5,604.639125,33.591063,120.927825,57.219281,3,0
0,0,7,7,12,17,29,43,27,70,0.000333,0.113353,6,2040.352018,113.35289,340.05867,112.506418,4,0
0,0,7,7,11,19,30,44,28,72,0.000333,0.117765,5,1766.480614,98.137812,353.296123,118.764371,2,0
0,0,3,3,10,10,20,17,13,30,0.000333,0.043219,5,648.289214,36.016067,129.657843,66.438562,2,0
0,0,4,4,10,12,22,21,17,38,0.000333,0.056486,5,847.292008,47.071778,169.458402,76.238831,1,0
0,0,8,8,13,19,32,50,27,77,0.000333,0.128333,6,2310,128.333333,385,128.816339,4,0
0,0,7,7,11,18,29,48,28,76,0.000333,0.123069,5,1846.032778,102.557377,369.206556,113.112398,1,0
0,0,7,7,11,19,30,44,28,72,0.000333,0.117765,5,1766.480614,98.137812,353.296123,118.764371,2,0
0,0,3,3,10,8,18,16,13,29,0.000333,0.040309,5,604.639125,33.591063,120.927825,57.219281,3,0
0,0,3,3,11,11,22,26,15,41,0.000333,0.060946,5,914.183482,50.787971,182.836696,76.107496,3,0
0,0,13,13,12,23,35,66,53,119,0.000333,0.203462,12,7324.616148,406.923119,610.384679,147.061475,1,0
0,0,8,8,13,19,32,40,24,64,0.000333,0.106667,6,1920,106.666667,320,128.816339,3,0
0,0,22,22,17,35,52,129,69,198,0.000333,0.376229,8,9029.496514,501.638695,1128.687064,249.011774,8,0
0,0,3,3,10,8,18,16,13,29,0.000333,0.040309,5,604.639125,33.591063,120.927825,57.219281,3,0
0,0,3,3,10,8,18,16,13,29,0.000333,0.040309,5,604.639125,33.591063,120.927825,57.219281,3,0
0,0,24,24,15,30,45,155,84,239,0.000333,0.437518,14,18375.74046,1020.87447,1312.55289,205.810077,5,0
0,0,7,7,11,19,30,44,28,72,0.000333,0.117765,5,1766.480614,98.137812,353.296123,118.764371,2,0
0,0,3,3,10,8,18,16,13,29,0.000333,0.040309,5,604.639125,33.591063,120.927825,57.219281,3,0
0,0,4,4,7,11,18,20,16,36,0.000333,0.050039,3,450.3519,25.01955,150.1173,57.705232,2,0
0,0,4,4,4,7,11,13,11,24,0.000333,0.027675,2,166.052718,9.225151,83.026359,27.651484,3,0
0,0,7,7,11,19,30,44,28,72,0.000333,0.117765,5,1766.480614,98.137812,353.296123,118.764371,2,0
0,0,16,16,11,26,37,113,60,173,0.000333,0.300412,10,9012.354323,500.686351,901.235432,160.26518,1,0
0,0,6,6,13,12,25,35,24,59,0.000333,0.091329,12,3287.850182,182.658343,273.987515,91.125266,2,0
0,0,6,6,9,18,27,24,23,47,0.000333,0.074493,4,893.91885,49.662158,223.479713,103.587975,3,0
0,0,4,4,4,7,11,13,11,24,0.000333,0.027675,2,166.052718,9.225151,83.026359,27.651484,3,0
0,0,3,3,10,8,18,16,13,29,0.000333,0.040309,5,604.639125,33.591063,120.927825,57.219281,3,0
0,0,7,7,11,19,30,44,28,72,0.000333,0.117765,5,1766.480614,98.137812,353.296123,118.764371,2,0
0,0,3,3,10,6,16,19,10,29,0.000333,0.038667,5,580,32.222222,116,48.729056,1,0
0,0,3,3,10,10,20,17,13,30,0.000333,0.043219,5,648.289214,36.016067,129.657843,66.438562,2,0
0,0,3,3,5,5,10,12,7,19,0.000333,0.021039,2,126.233268,7.012959,63.116634,23.219281,1,0
0,0,3,3,10,8,18,16,13,29,0.000333,0.040309,5,604.639125,33.591063,120.927825,57.219281,3,0
0,0,3,3,10,8,18,16,13,29,0.000333,0.040309,5,604.639125,33.591063,120.927825,57.219281,3,0
0,0,4,4,8,11,19,17,15,32,0.000333,0.045311,4,543.734722,30.207485,135.93368,62.053748,3,0
0,0,4,4,4,7,11,13,11,24,0.000333,0.027675,2,166.052718,9.225151,83.026359,27.651484,3,0
0,0,4,4,4,7,11,13,11,24,0.000333,0.027675,2,166.052718,9.225151,83.026359,27.651484,3,0
0,0,4,4,8,11,19,17,15,32,0.000333,0.045311,4,543.734722,30.207485,135.93368,62.053748,3,0
0,0,3,3,10,8,18,16,13,29,0.000333,0.040309,5,604.639125,33.591063,120.927825,57.219281,3,0
0,0,4,4,4,7,11,13,11,24,0.000333,0.027675,2,166.052718,9.225151,83.026359,27.651484,3,0
0,0,3,3,10,8,18,16,13,29,0.000333,0.040309,5,604.639125,33.591063,120.927825,57.219281,3,0
0,0,21,21,13,30,43,129,66,195,0.000333,0.352707,12,12697.45953,705.414418,1058.121627,195.312434,7,0
0,0,7,7,11,19,30,44,28,72,0.000333,0.117765,5,1766.480614,98.137812,353.296123,118.764371,2,0
0,0,17,17,16,23,39,110,55,165,0.000333,0.290697,16,13953.46186,775.192325,872.091366,168.041925,7,0
0,0,7,7,11,19,30,44,28,72,0.000333,0.117765,5,1766.480614,98.137812,353.296123,118.764371,2,0
0,0,4,4,7,10,17,16,19,35,0.000333,0.047687,3,429.183598,23.843533,143.061199,52.870765,1,0
0,0,4,4,6,8,14,17,12,29,0.000333,0.036804,3,331.239878,18.402215,110.413293,39.509775,3,0
0,0,7,7,11,19,30,44,28,72,0.000333,0.117765,5,1766.480614,98.137812,353.296123,118.764371,2,0
0,0,3,3,11,11,22,26,15,41,0.000333,0.060946,5,914.183482,50.787971,182.836696,76.107496,3,0
0,0,7,7,11,19,30,44,28,72,0.000333,0.117765,5,1766.480614,98.137812,353.296123,118.764371,2,0
0,0,6,6,10,15,25,27,24,51,0.000333,0.078946,5,1184.183328,65.787963,236.836666,91.82264,4,0
0,0,7,7,12,17,29,43,27,70,0.000333,0.113353,6,2040.352018,113.35289,340.05867,112.506418,4,0
0,0,6,6,15,15,30,35,24,59,0.000333,0.096502,7,2026.545816,112.585879,289.506545,117.206718,4,0
0,0,3,3,10,8,18,16,13,29,0.000333,0.040309,5,604.639125,33.591063,120.927825,57.219281,3,0
0,0,6,6,13,13,26,38,23,61,0.000333,0.095576,6,1720.360937,95.575608,286.726823,96.211433,4,0
0,0,9,9,10,19,29,39,30,69,0.000333,0.111734,5,1676.003443,93.111302,335.200689,113.929904,3,0
0,0,6,6,15,15,30,35,24,59,0.000333,0.096502,7,2026.545816,112.585879,289.506545,117.206718,4,0
0,0,7,7,11,19,30,44,28,72,0.000333,0.117765,5,1766.480614,98.137812,353.296123,118.764371,2,0
0,0,7,7,11,19,30,44,28,72,0.000333,0.117765,5,1766.480614,98.137812,353.296123,118.764371,2,0
0,0,7,7,11,19,30,44,28,72,0.000333,0.117765,5,1766.480614,98.137812,353.296123,118.764371,2,0
0,0,3,3,10,8,18,16,13,29,0.000333,0.040309,5,604.639125,33.591063,120.927825,57.219281,3,0
0,0,8,8,15,15,30,47,35,82,0.000333,0.134122,14,5633.110404,312.950578,402.365029,117.206718,4,0
0,0,4,4,10,12,22,21,17,38,0.000333,0.056486,5,847.292008,47.071778,169.458402,76.238831,1,0
0,0,5,5,13,13,26,30,20,50,0.000333,0.078341,6,1410.131915,78.340662,235.021986,96.211433,2,0
0,0,7,7,12,17,29,43,27,70,0.000333,0.113353,6,2040.352018,113.35289,340.05867,112.506418,4,0
0,0,3,3,10,6,16,19,10,29,0.000333,0.038667,5,580,32.222222,116,48.729056,1,0
0,0,3,3,10,9,19,37,16,53,0.000333,0.075047,5,1125.700791,62.538933,225.140158,61.748606,10,0
0,0,3,3,10,8,18,16,13,29,0.000333,0.040309,5,604.639125,33.591063,120.927825,57.219281,3,0
0,0,4,4,10,9,19,46,19,65,0.000333,0.092038,10,2761.152884,153.397382,276.115288,61.748606,11,0
0,0,3,3,10,8,18,16,13,29,0.000333,0.040309,5,604.639125,33.591063,120.927825,57.219281,3,0
0,0,7,7,11,19,30,44,28,72,0.000333,0.117765,5,1766.480614,98.137812,353.296123,118.764371,2,0
0,0,3,3,11,11,22,26,15,41,0.000333,0.060946,5,914.183482,50.787971,182.836696,76.107496,3,0
0,0,17,17,16,23,39,110,55,165,0.000333,0.290697,16,13953.46186,775.192325,872.091366,168.041925,7,0
0,0,3,3,10,8,18,16,13,29,0.000333,0.040309,5,604.639125,33.591063,120.927825,57.219281,3,0
0,0,27,27,17,37,54,142,78,220,0.000333,0.422025,16,20257.20401,1125.400223,1266.07525,262.236643,10,0
0,0,3,3,10,8,18,16,13,29,0.000333,0.040309,5,604.639125,33.591063,120.927825,57.219281,3,0
0,0,4,4,6,8,14,17,12,29,0.000333,0.036804,3,331.239878,18.402215,110.413293,39.509775,3,0
0,0,8,8,9,17,26,35,26,61,0.000333,0.095576,4,1146.907291,63.717072,286.726823,98.016193,3,0
0,0,4,4,10,12,22,21,17,38,0.000333,0.056486,5,847.292008,47.071778,169.458402,76.238831,1,0
0,0,7,7,12,17,29,43,27,70,0.000333,0.113353,6,2040.352018,113.35289,340.05867,112.506418,4,0
0,0,7,7,10,13,23,37,19,56,0.000333,0.08444,5,1266.597348,70.366519,253.31947,81.324997,3,0
0,0,3,3,10,8,18,16,13,29,0.000333,0.040309,5,604.639125,33.591063,120.927825,57.219281,3,0
0,0,7,7,11,18,29,48,28,76,0.000333,0.123069,5,1846.032778,102.557377,369.206556,113.112398,1,0
0,0,3,3,9,9,18,18,13,31,0.000333,0.043089,4,517.0707,28.72615,129.267675,57.05865,2,0
0,0,3,3,11,11,22,26,15,41,0.000333,0.060946,5,914.183482,50.787971,182.836696,76.107496,3,0
0,0,4,4,4,7,11,13,11,24,0.000333,0.027675,2,166.052718,9.225151,83.026359,27.651484,3,0
0,0,4,4,11,10,21,26,17,43,0.000333,0.062957,5,944.348246,52.463791,188.869649,71.273029,2,0
0,0,3,3,10,8,18,16,13,29,0.000333,0.040309,5,604.639125,33.591063,120.927825,57.219281,3,0
0,0,8,8,16,13,29,53,32,85,0.000333,0.137643,16,6606.854153,367.047453,412.928385,112.105716,6,0
0,0,4,4,11,12,23,20,16,36,0.000333,0.054283,5,814.241152,45.23562,162.84823,81.073298,2,0
0,0,4,4,4,7,11,13,11,24,0.000333,0.027675,2,166.052718,9.225151,83.026359,27.651484,3,0
0,0,4,4,6,8,14,17,12,29,0.000333,0.036804,3,331.239878,18.402215,110.413293,39.509775,3,0
0,0,8,8,9,17,26,35,26,61,0.000333,0.095576,4,1146.907291,63.717072,286.726823,98.016193,3,0
0,0,4,4,8,11,19,17,15,32,0.000333,0.045311,4,543.734722,30.207485,135.93368,62.053748,3,0
0,0,4,4,10,12,22,21,17,38,0.000333,0.056486,5,847.292008,47.071778,169.458402,76.238831,1,0
0,0,6,6,15,15,30,35,24,59,0.000333,0.096502,7,2026.545816,112.585879,289.506545,117.206718,4,0
0,0,3,3,5,6,11,9,8,17,0.000333,0.019603,2,117.620675,6.534482,58.810338,27.119415,1,0
0,0,7,7,7,8,15,29,19,48,0.000333,0.06251,6,1125.184492,62.51025,187.530749,43.651484,4,0
0,0,3,3,10,8,18,16,13,29,0.000333,0.040309,5,604.639125,33.591063,120.927825,57.219281,3,0
0,0,3,3,10,8,18,16,13,29,0.000333,0.040309,5,604.639125,33.591063,120.927825,57.219281,3,0
0,0,15,15,12,22,34,100,56,156,0.000333,0.264548,12,9523.730439,529.096135,793.644203,141.127046,11,0
0,0,3,3,10,6,16,21,9,30,0.000333,0.04,5,600,33.333333,120,48.729056,3,0
0,0,3,3,9,9,18,18,13,31,0.000333,0.043089,4,517.0707,28.72615,129.267675,57.05865,2,0
0,0,4,4,11,10,21,26,17,43,0.000333,0.062957,5,944.348246,52.463791,188.869649,71.273029,2,0
0,0,5,5,9,15,24,22,19,41,0.000333,0.062661,4,751.93385,41.774103,187.983463,87.132684,3,0
0,0,7,7,14,16,30,42,33,75,0.000333,0.122672,14,5152.235125,286.235285,368.016795,117.302969,4,0
0,0,5,5,12,16,28,39,25,64,0.000333,0.102557,6,1846.02429,102.556905,307.670715,107.01955,2,0
0,0,3,3,9,9,18,18,13,31,0.000333,0.043089,4,517.0707,28.72615,129.267675,57.05865,2,0
0,0,3,3,8,10,18,20,13,33,0.000333,0.045869,4,550.4301,30.57945,137.607525,57.219281,3,0
0,0,4,4,4,7,11,13,11,24,0.000333,0.027675,2,166.052718,9.225151,83.026359,27.651484,3,0
0,0,4,4,10,12,22,21,17,38,0.000333,0.056486,5,847.292008,47.071778,169.458402,76.238831,1,0
0,0,3,3,10,10,20,17,13,30,0.000333,0.043219,5,648.289214,36.016067,129.657843,66.438562,2,0
0,0,3,3,10,8,18,16,13,29,0.000333,0.040309,5,604.639125,33.591063,120.927825,57.219281,3,0
0,0,17,17,16,23,39,110,55,165,0.000333,0.290697,16,13953.46186,775.192325,872.091366,168.041925,7,0
0,0,4,4,14,9,23,32,12,44,0.000333,0.066346,7,1393.257082,77.403171,199.036726,81.832294,3,0
0,0,3,3,9,9,18,18,13,31,0.000333,0.043089,4,517.0707,28.72615,129.267675,57.05865,2,0
0,0,8,8,16,13,29,53,32,85,0.000333,0.137643,16,6606.854153,367.047453,412.928385,112.105716,6,0
0,0,4,4,7,14,21,20,22,42,0.000333,0.061492,3,553.431995,30.746222,184.477332,72.954453,2,0
0,0,13,13,14,26,40,67,50,117,0.000333,0.207555,7,4358.65911,242.147728,622.665587,175.514402,4,0
0,0,3,3,10,9,19,37,16,53,0.000333,0.075047,5,1125.700791,62.538933,225.140158,61.748606,10,0
0,0,4,4,10,9,19,46,19,65,0.000333,0.092038,10,2761.152884,153.397382,276.115288,61.748606,11,0
0,0,7,7,11,19,30,44,28,72,0.000333,0.117765,5,1766.480614,98.137812,353.296123,118.764371,2,0
0,0,10,10,11,21,32,47,36,83,0.000333,0.138333,5,2075,115.277778,415,130.292414,1,0
0,0,9,9,11,20,31,72,40,112,0.000333,0.184957,10,5548.699868,308.261104,554.869987,124.49231,1,0
0,0,3,3,10,8,18,16,13,29,0.000333,0.040309,5,604.639125,33.591063,120.927825,57.219281,3,0
0,0,4,4,9,6,15,16,9,25,0.000333,0.032557,4,390.68906,21.704948,97.672265,44.0391,2,0
0,0,6,6,13,13,26,38,23,61,0.000333,0.095576,6,1720.360937,95.575608,286.726823,96.211433,4,0
0,0,4,4,7,11,18,20,16,36,0.000333,0.050039,3,450.3519,25.01955,150.1173,57.705232,2,0
0,0,6,6,11,15,26,29,22,51,0.000333,0.079907,5,1198.612128,66.589563,239.722426,96.657107,1,0
0,0,12,12,13,24,37,57,44,101,0.000333,0.175385,6,3156.92874,175.38493,526.15479,158.144816,2,0
0,0,3,3,10,8,18,16,13,29,0.000333,0.040309,5,604.639125,33.591063,120.927825,57.219281,3,0
0,0,8,8,17,13,30,41,27,68,0.000333,0.111223,16,5338.696968,296.594276,333.668561,117.592585,4,0
0,0,6,6,7,9,16,25,16,41,0.000333,0.054667,3,492,27.333333,164,48.180809,1,0
0,0,3,3,11,11,22,26,15,41,0.000333,0.060946,5,914.183482,50.787971,182.836696,76.107496,3,0
0,0,15,15,8,24,32,95,41,136,0.000333,0.226667,4,2720,151.111111,680,134.0391,6,0
0,0,27,27,17,37,54,142,78,220,0.000333,0.422025,16,20257.20401,1125.400223,1266.07525,262.236643,10,0
0,0,4,4,10,12,22,21,17,38,0.000333,0.056486,5,847.292008,47.071778,169.458402,76.238831,1,0
0,0,23,23,13,34,47,157,98,255,0.000333,0.47214,12,16997.04189,944.280105,1416.420157,221.079453,1,0
0,0,9,9,11,17,28,39,31,70,0.000333,0.112172,5,1682.574223,93.476346,336.514845,107.540616,1,0
0,0,4,4,11,9,20,24,12,36,0.000333,0.051863,5,777.947057,43.219281,155.589411,66.583073,5,0
0,0,3,3,9,9,18,18,13,31,0.000333,0.043089,4,517.0707,28.72615,129.267675,57.05865,2,0
0,0,4,4,4,7,11,13,11,24,0.000333,0.027675,2,166.052718,9.225151,83.026359,27.651484,3,0
0,0,3,3,10,8,18,16,13,29,0.000333,0.040309,5,604.639125,33.591063,120.927825,57.219281,3,0
0,0,4,4,7,13,20,20,20,40,0.000333,0.057626,3,518.631371,28.812854,172.877124,67.757201,2,0
0,0,3,3,9,9,18,18,13,31,0.000333,0.043089,4,517.0707,28.72615,129.267675,57.05865,2,0
0,0,5,5,9,13,22,26,24,50,0.000333,0.074324,4,891.886324,49.54924,222.971581,76.635041,2,0
0,0,3,3,11,11,22,26,15,41,0.000333,0.060946,5,914.183482,50.787971,182.836696,76.107496,3,0
0,0,8,8,15,18,33,66,34,100,0.000333,0.168146,7,3531.075884,196.170882,504.439412,133.662009,2,0
0,0,4,4,8,11,19,17,15,32,0.000333,0.045311,4,543.734722,30.207485,135.93368,62.053748,3,0
0,0,4,4,4,7,11,13,11,24,0.000333,0.027675,2,166.052718,9.225151,83.026359,27.651484,3,0
0,0,3,3,9,9,18,18,13,31,0.000333,0.043089,4,517.0707,28.72615,129.267675,57.05865,2,0
0,0,4,4,4,7,11,13,11,24,0.000333,0.027675,2,166.052718,9.225151,83.026359,27.651484,3,0
0,0,4,4,8,11,19,17,15,32,0.000333,0.045311,4,543.734722,30.207485,135.93368,62.053748,3,0
0,0,7,7,11,19,30,44,28,72,0.000333,0.117765,5,1766.480614,98.137812,353.296123,118.764371,2,0
0,0,5,5,9,13,22,26,19,45,0.000333,0.066891,4,802.697691,44.594316,200.674423,76.635041,3,0
0,0,5,5,11,16,27,28,25,53,0.000333,0.084003,5,1260.045188,70.00251,252.009038,102.053748,4,0
0,0,3,3,10,8,18,16,13,29,0.000333,0.040309,5,604.639125,33.591063,120.927825,57.219281,3,0
0,0,6,6,11,15,26,29,22,51,0.000333,0.079907,5,1198.612128,66.589563,239.722426,96.657107,1,0
0,0,3,3,10,8,18,16,13,29,0.000333,0.040309,5,604.639125,33.591063,120.927825,57.219281,3,0
0,0,7,7,11,19,30,44,28,72,0.000333,0.117765,5,1766.480614,98.137812,353.296123,118.764371,2,0
0,0,20,20,11,20,31,138,73,211,0.000333,0.348445,15,15680.03132,871.112851,1045.335421,124.49231,1,0
0,0,5,5,10,10,20,27,14,41,0.000333,0.059066,5,885.995259,49.221959,177.199052,66.438562,3,0
0,0,3,3,7,8,15,23,12,35,0.000333,0.04558,3,410.223513,22.790195,136.741171,43.651484,1,0
0,0,7,7,11,18,29,48,28,76,0.000333,0.123069,5,1846.032778,102.557377,369.206556,113.112398,1,0
0,0,26,26,17,35,52,139,73,212,0.000333,0.402831,16,19335.89152,1074.216196,1208.49322,249.011774,10,0
0,0,4,4,10,12,22,21,17,38,0.000333,0.056486,5,847.292008,47.071778,169.458402,76.238831,1,0
0,0,36,36,21,46,67,185,115,300,0.000333,0.606609,20,36396.53514,2022.02973,1819.826757,346.322516,16,0
0,0,4,4,8,16,24,37,23,60,0.000333,0.091699,4,1100.391,61.132833,275.09775,88,1,0
0,0,3,3,6,9,15,10,14,24,0.000333,0.031255,3,281.296123,15.627562,93.765374,44.0391,1,0
0,0,7,7,14,17,31,42,35,77,0.000333,0.127158,14,5340.623623,296.701312,381.473116,122.789837,4,0
0,0,3,3,10,8,18,16,13,29,0.000333,0.040309,5,604.639125,33.591063,120.927825,57.219281,3,0
0,0,8,8,12,13,25,41,24,65,0.000333,0.100617,6,1811.103914,100.616884,301.850652,91.125266,4,0
0,0,3,3,10,8,18,16,13,29,0.000333,0.040309,5,604.639125,33.591063,120.927825,57.219281,3,0
0,0,9,9,13,12,25,53,31,84,0.000333,0.130028,12,4681.007039,260.055947,390.08392,91.125266,4,0
0,0,8,8,13,12,25,43,26,69,0.000333,0.106809,12,3845.112925,213.617385,320.426077,91.125266,4,0
0,0,4,4,11,10,21,26,17,43,0.000333,0.062957,5,944.348246,52.463791,188.869649,71.273029,2,0
0,0,4,4,10,12,22,21,17,38,0.000333,0.056486,5,847.292008,47.071778,169.458402,76.238831,1,0
0,0,3,3,10,8,18,16,13,29,0.000333,0.040309,5,604.639125,33.591063,120.927825,57.219281,3,0
0,0,3,3,9,6,15,18,8,26,0.000333,0.03386,4,406.316622,22.573146,101.579155,44.0391,2,0
0,0,17,17,16,23,39,110,55,165,0.000333,0.290697,16,13953.46186,775.192325,872.091366,168.041925,7,0
0,0,7,7,11,19,30,44,28,72,0.000333,0.117765,5,1766.480614,98.137812,353.296123,118.764371,2,0
0,0,10,10,12,24,36,48,42,90,0.000333,0.155098,6,2791.759501,155.09775,465.29325,153.05865,4,0
0,0,3,3,10,8,18,16,13,29,0.000333,0.040309,5,604.639125,33.591063,120.927825,57.219281,3,0
0,0,3,3,8,10,18,20,13,33,0.000333,0.045869,4,550.4301,30.57945,137.607525,57.219281,3,0
0,0,3,3,10,8,18,16,13,29,0.000333,0.040309,5,604.639125,33.591063,120.927825,57.219281,3,0
0,0,4,4,11,10,21,26,17,43,0.000333,0.062957,5,944.348246,52.463791,188.869649,71.273029,2,0
0,0,8,8,8,21,29,45,32,77,0.000333,0.124688,4,1496.258146,83.125453,374.064537,116.238666,1,0
0,0,12,12,18,20,38,69,52,121,0.000333,0.211666,18,11429.98612,634.999229,634.999229,161.497212,6,0
0,0,3,3,10,8,18,16,13,29,0.000333,0.040309,5,604.639125,33.591063,120.927825,57.219281,3,0
0,0,8,8,15,18,33,66,34,100,0.000333,0.168146,7,3531.075884,196.170882,504.439412,133.662009,2,0
0,0,4,4,7,9,16,16,12,28,0.000333,0.037333,3,336,18.666667,112,48.180809,3,0
0,0,7,7,11,19,30,44,28,72,0.000333,0.117765,5,1766.480614,98.137812,353.296123,118.764371,2,0
0,0,8,8,12,13,25,41,24,65,0.000333,0.100617,6,1811.103914,100.616884,301.850652,91.125266,4,0
0,0,7,7,11,19,30,44,28,72,0.000333,0.117765,5,1766.480614,98.137812,353.296123,118.764371,2,0
0,0,10,10,16,24,40,84,58,142,0.000333,0.251905,16,12091.42063,671.745591,755.713789,174.0391,2,0
0,0,5,5,12,16,28,39,25,64,0.000333,0.102557,6,1846.02429,102.556905,307.670715,107.01955,2,0
0,0,39,39,21,48,69,204,133,337,0.000333,0.686191,20,41171.45484,2287.303047,2058.572742,360.316866,17,0
0,0,4,4,6,8,14,17,12,29,0.000333,0.036804,3,331.239878,18.402215,110.413293,39.509775,3,0
0,0,8,8,9,17,26,35,26,61,0.000333,0.095576,4,1146.907291,63.717072,286.726823,98.016193,3,0
0,0,4,4,4,7,11,13,11,24,0.000333,0.027675,2,166.052718,9.225151,83.026359,27.651484,3,0
0,0,4,4,8,11,19,17,15,32,0.000333,0.045311,4,543.734722,30.207485,135.93368,62.053748,3,0
0,0,6,6,13,13,26,38,23,61,0.000333,0.095576,6,1720.360937,95.575608,286.726823,96.211433,4,0
0,0,3,3,10,8,18,16,13,29,0.000333,0.040309,5,604.639125,33.591063,120.927825,57.219281,3,0
0,0,17,17,16,23,39,110,55,165,0.000333,0.290697,16,13953.46186,775.192325,872.091366,168.041925,7,0
0,0,10,10,12,19,31,48,28,76,0.000333,0.125506,6,2259.113518,125.506307,376.51892,123.730173,6,0
0,0,6,6,13,13,26,37,25,62,0.000333,0.097142,6,1748.563575,97.142421,291.427263,96.211433,4,0
0,0,4,4,4,7,11,22,14,36,0.000333,0.041513,4,498.158153,27.675453,124.539538,27.651484,1,0
0,0,7,7,11,18,29,48,28,76,0.000333,0.123069,5,1846.032778,102.557377,369.206556,113.112398,1,0
0,0,4,4,11,10,21,26,17,43,0.000333,0.062957,5,944.348246,52.463791,188.869649,71.273029,2,0
0,0,7,7,8,13,21,30,22,52,0.000333,0.076134,4,913.602024,50.755668,228.400506,72.105716,1,0
0,0,7,7,12,17,29,43,27,70,0.000333,0.113353,6,2040.352018,113.35289,340.05867,112.506418,4,0
0,0,4,4,9,9,18,23,13,36,0.000333,0.050039,4,600.4692,33.3594,150.1173,57.05865,5,0
0,0,11,11,11,18,29,70,34,104,0.000333,0.16841,5,2526.150117,140.341673,505.230023,113.112398,5,0
0,0,6,6,13,11,24,38,23,61,0.000333,0.093228,12,3356.192551,186.455142,279.682713,86.159464,4,0
0,0,3,3,10,8,18,16,13,29,0.000333,0.040309,5,604.639125,33.591063,120.927825,57.219281,3,0
0,0,4,4,11,10,21,26,17,43,0.000333,0.062957,5,944.348246,52.463791,188.869649,71.273029,2,0
0,0,7,7,11,18,29,33,30,63,0.000333,0.102018,5,1530.264013,85.014667,306.052803,113.112398,4,0
0,0,3,3,10,8,18,16,13,29,0.000333,0.040309,5,604.639125,33.591063,120.927825,57.219281,3,0
0,0,3,3,9,9,18,18,13,31,0.000333,0.043089,4,517.0707,28.72615,129.267675,57.05865,2,0
0,0,4,4,10,12,22,21,17,38,0.000333,0.056486,5,847.292008,47.071778,169.458402,76.238831,1,0
0,0,5,5,9,15,24,22,19,41,0.000333,0.062661,4,751.93385,41.774103,187.983463,87.132684,3,0
0,0,4,4,4,7,11,13,11,24,0.000333,0.027675,2,166.052718,9.225151,83.026359,27.651484,3,0
0,0,4,4,6,8,14,23,14,37,0.000333,0.046957,3,422.616396,23.478689,140.872132,39.509775,1,0
0,0,3,3,5,6,11,9,8,17,0.000333,0.019603,2,117.620675,6.534482,58.810338,27.119415,4,0
0,0,6,6,14,11,25,38,23,61,0.000333,0.094425,14,3965.853186,220.325177,283.275228,91.356717,4,0
0,0,7,7,10,12,22,39,19,58,0.000333,0.086216,5,1293.235169,71.846398,258.647034,76.238831,4,0
0,0,5,5,9,13,22,26,19,45,0.000333,0.066891,4,802.697691,44.594316,200.674423,76.635041,3,0
0,0,3,3,9,9,18,18,13,31,0.000333,0.043089,4,517.0707,28.72615,129.267675,57.05865,2,0
0,0,7,7,11,19,30,44,28,72,0.000333,0.117765,5,1766.480614,98.137812,353.296123,118.764371,2,0
0,0,5,5,11,15,26,27,26,53,0.000333,0.083041,5,1245.616525,69.200918,249.123305,96.657107,2,0
0,0,4,4,10,12,22,21,17,38,0.000333,0.056486,5,847.292008,47.071778,169.458402,76.238831,1,0
0,0,3,3,10,8,18,16,13,29,0.000333,0.040309,5,604.639125,33.591063,120.927825,57.219281,3,0
0,0,5,5,11,12,23,33,21,54,0.000333,0.081424,5,1221.361728,67.853429,244.272346,81.073298,1,0
0,0,3,3,10,8,18,16,13,29,0.000333,0.040309,5,604.639125,33.591063,120.927825,57.219281,3,0
0,0,5,5,10,13,23,26,21,47,0.000333,0.070869,5,1063.03706,59.057614,212.607412,81.324997,4,0
0,0,3,3,9,9,18,18,13,31,0.000333,0.043089,4,517.0707,28.72615,129.267675,57.05865,2,0
0,0,3,3,10,10,20,17,13,30,0.000333,0.043219,5,648.289214,36.016067,129.657843,66.438562,2,0
0,0,5,5,11,13,24,27,22,49,0.000333,0.074888,5,1123.315813,62.406434,224.663163,86.159464,2,0
0,0,4,4,11,10,21,26,17,43,0.000333,0.062957,5,944.348246,52.463791,188.869649,71.273029,2,0
0,0,8,8,16,13,29,53,32,85,0.000333,0.137643,16,6606.854153,367.047453,412.928385,112.105716,6,0
0,0,30,30,8,31,39,94,60,154,0.000333,0.271317,4,3255.807767,180.878209,813.951942,177.580086,4,0
0,0,5,5,10,10,20,27,14,41,0.000333,0.059066,5,885.995259,49.221959,177.199052,66.438562,3,0
0,0,4,4,10,12,22,21,17,38,0.000333,0.056486,5,847.292008,47.071778,169.458402,76.238831,1,0
0,0,15,15,12,22,34,99,56,155,0.000333,0.262852,12,9462.680885,525.704494,788.55674,141.127046,7,0
0,0,4,4,10,9,19,46,19,65,0.000333,0.092038,10,2761.152884,153.397382,276.115288,61.748606,11,0
0,0,3,3,10,10,20,17,13,30,0.000333,0.043219,5,648.289214,36.016067,129.657843,66.438562,2,0
0,0,3,3,10,9,19,37,16,53,0.000333,0.075047,5,1125.700791,62.538933,225.140158,61.748606,10,0
0,0,4,4,10,12,22,21,17,38,0.000333,0.056486,5,847.292008,47.071778,169.458402,76.238831,1,0
0,0,3,3,9,11,20,19,16,35,0.000333,0.050422,4,605.069933,33.614996,151.267483,66.583073,1,0
0,0,6,6,7,10,17,25,16,41,0.000333,0.055862,3,502.757929,27.930996,167.585976,52.870765,1,0
0,0,6,6,9,18,27,24,23,47,0.000333,0.074493,4,893.91885,49.662158,223.479713,103.587975,3,0
0,0,4,4,6,8,14,17,12,29,0.000333,0.036804,3,331.239878,18.402215,110.413293,39.509775,3,0
0,0,6,6,9,18,27,24,23,47,0.000333,0.074493,4,893.91885,49.662158,223.479713,103.587975,3,0
0,0,4,4,4,7,11,13,11,24,0.000333,0.027675,2,166.052718,9.225151,83.026359,27.651484,3,0
0,0,3,3,10,9,19,37,16,53,0.000333,0.075047,5,1125.700791,62.538933,225.140158,61.748606,10,0
0,0,4,4,10,9,19,46,19,65,0.000333,0.092038,10,2761.152884,153.397382,276.115288,61.748606,11,0
0,0,9,9,14,25,39,156,54,210,0.000333,0.369978,14,15539.08252,863.282362,1109.934466,169.399374,5,0
0,0,14,14,17,20,37,79,55,134,0.000333,0.232689,16,11169.06802,620.503779,698.066751,155.92543,6,0
0,0,27,27,17,36,53,141,77,218,0.000333,0.416229,16,19978.98655,1109.943697,1248.686659,255.604168,10,0
0,0,5,5,10,14,24,27,22,49,0.000333,0.074888,5,1123.315813,62.406434,224.663163,86.52225,3,0
0,0,7,7,11,19,30,44,28,72,0.000333,0.117765,5,1766.480614,98.137812,353.296123,118.764371,2,0
0,0,4,4,4,7,11,13,11,24,0.000333,0.027675,2,166.052718,9.225151,83.026359,27.651484,3,0
0,0,4,4,11,9,20,24,12,36,0.000333,0.051863,5,777.947057,43.219281,155.589411,66.583073,5,0
0,0,13,13,18,21,39,78,56,134,0.000333,0.236081,18,12748.39015,708.243897,708.243897,167.297316,6,0
0,0,16,16,14,30,44,106,54,160,0.000333,0.29117,7,6114.563413,339.697967,873.509059,200.509687,5,0
0,0,6,6,13,13,26,38,23,61,0.000333,0.095576,6,1720.360937,95.575608,286.726823,96.211433,4,0
0,0,6,6,11,11,22,29,16,45,0.000333,0.066891,5,1003.372114,55.742895,200.674423,76.107496,4,0
0,0,4,4,4,7,11,13,11,24,0.000333,0.027675,2,166.052718,9.225151,83.026359,27.651484,3,0
0,0,7,7,11,19,30,44,28,72,0.000333,0.117765,5,1766.480614,98.137812,353.296123,118.764371,2,0
0,0,10,10,16,17,33,65,46,111,0.000333,0.186643,16,8958.843956,497.713553,559.927747,133.486868,4,0
0,0,3,3,10,8,18,16,13,29,0.000333,0.040309,5,604.639125,33.591063,120.927825,57.219281,3,0
0,0,3,3,10,8,18,16,13,29,0.000333,0.040309,5,604.639125,33.591063,120.927825,57.219281,3,0
0,0,3,3,10,8,18,16,13,29,0.000333,0.040309,5,604.639125,33.591063,120.927825,57.219281,3,0
0,0,7,7,11,19,30,44,28,72,0.000333,0.117765,5,1766.480614,98.137812,353.296123,118.764371,2,0
0,0,3,3,11,11,22,26,15,41,0.000333,0.060946,5,914.183482,50.787971,182.836696,76.107496,3,0
0,0,5,5,9,16,25,23,27,50,0.000333,0.077398,4,928.771238,51.598402,232.192809,92.529325,1,0
0,0,7,7,12,17,29,43,27,70,0.000333,0.113353,6,2040.352018,113.35289,340.05867,112.506418,4,0
0,0,7,7,11,19,30,44,28,72,0.000333,0.117765,5,1766.480614,98.137812,353.296123,118.764371,2,0
0,0,30,30,17,41,58,157,85,242,0.000333,0.472544,16,22682.10241,1260.116801,1417.631401,289.1465,12,0
0,0,3,3,5,6,11,9,8,17,0.000333,0.019603,2,117.620675,6.534482,58.810338,27.119415,1,0
0,0,3,3,10,10,20,17,13,30,0.000333,0.043219,5,648.289214,36.016067,129.657843,66.438562,2,0
0,0,4,4,10,12,22,21,17,38,0.000333,0.056486,5,847.292008,47.071778,169.458402,76.238831,1,0
0,0,3,3,10,8,18,16,13,29,0.000333,0.040309,5,604.639125,33.591063,120.927825,57.219281,3,0
0,0,3,3,10,8,18,16,13,29,0.000333,0.040309,5,604.639125,33.591063,120.927825,57.219281,3,0
0,0,3,3,9,9,18,18,13,31,0.000333,0.043089,4,517.0707,28.72615,129.267675,57.05865,2,0
0,0,3,3,8,10,18,17,13,30,0.000333,0.041699,4,500.391,27.7995,125.09775,57.219281,2,0
0,0,3,3,10,9,19,37,16,53,0.000333,0.075047,5,1125.700791,62.538933,225.140158,61.748606,10,0
0,0,4,4,13,7,20,22,12,34,0.000333,0.048982,6,881.673331,48.981852,146.945555,67.757201,3,0
0,0,3,3,10,8,18,16,13,29,0.000333,0.040309,5,604.639125,33.591063,120.927825,57.219281,3,0
0,0,4,4,4,7,11,13,11,24,0.000333,0.027675,2,166.052718,9.225151,83.026359,27.651484,3,0
0,0,3,3,10,8,18,16,13,29,0.000333,0.040309,5,604.639125,33.591063,120.927825,57.219281,3,0
0,0,10,10,14,21,35,55,42,97,0.000333,0.165847,14,6965.566337,386.975908,497.540453,145.541635,4,0
0,0,3,3,10,8,18,16,13,29,0.000333,0.040309,5,604.639125,33.591063,120.927825,57.219281,3,0
0,0,17,17,16,23,39,110,55,165,0.000333,0.290697,16,13953.46186,775.192325,872.091366,168.041925,7,0
0,0,3,3,10,10,20,17,13,30,0.000333,0.043219,5,648.289214,36.016067,129.657843,66.438562,2,0
0,0,27,27,17,36,53,141,77,218,0.000333,0.416229,16,19978.98655,1109.943697,1248.686659,255.604168,10,0
0,0,26,26,17,35,52,139,73,212,0.000333,0.402831,16,19335.89152,1074.216196,1208.49322,249.011774,10,0
0,0,7,7,11,19,30,44,28,72,0.000333,0.117765,5,1766.480614,98.137812,353.296123,118.764371,2,0
0,0,3,3,9,9,18,18,13,31,0.000333,0.043089,4,517.0707,28.72615,129.267675,57.05865,2,0
0,0,5,5,10,14,24,27,22,49,0.000333,0.074888,5,1123.315813,62.406434,224.663163,86.52225,3,0
0,0,4,4,4,7,11,13,11,24,0.000333,0.027675,2,166.052718,9.225151,83.026359,27.651484,3,0
0,0,3,3,9,9,18,18,13,31,0.000333,0.043089,4,517.0707,28.72615,129.267675,57.05865,2,0
0,0,4,4,10,12,22,21,17,38,0.000333,0.056486,5,847.292008,47.071778,169.458402,76.238831,1,0
0,0,6,6,11,16,27,30,23,53,0.000333,0.084003,5,1260.045188,70.00251,252.009038,102.053748,1,0
0,0,14,14,12,22,34,81,42,123,0.000333,0.208586,6,3754.547577,208.585976,625.757929,141.127046,5,0
0,0,3,3,10,8,18,16,13,29,0.000333,0.040309,5,604.639125,33.591063,120.927825,57.219281,3,0
0,0,37,37,21,49,70,188,119,307,0.000333,0.62723,20,37633.79772,2090.76654,1881.689886,367.359448,17,0
0,0,5,5,11,13,24,27,22,49,0.000333,0.074888,5,1123.315813,62.406434,224.663163,86.159464,2,0
0,0,3,3,10,8,18,16,13,29,0.000333,0.040309,5,604.639125,33.591063,120.927825,57.219281,3,0
0,0,8,8,10,15,25,36,22,58,0.000333,0.089781,5,1346.718295,74.817683,269.343659,91.82264,3,0
0,0,3,3,10,8,18,16,13,29,0.000333,0.040309,5,604.639125,33.591063,120.927825,57.219281,3,0
0,0,17,17,16,23,39,110,55,165,0.000333,0.290697,16,13953.46186,775.192325,872.091366,168.041925,7,0
0,0,7,7,11,19,30,44,28,72,0.000333,0.117765,5,1766.480614,98.137812,353.296123,118.764371,2,0
0,0,5,5,11,14,25,27,24,51,0.000333,0.078946,5,1184.183328,65.787963,236.836666,91.356717,2,0
0,0,17,17,16,23,39,110,55,165,0.000333,0.290697,16,13953.46186,775.192325,872.091366,168.041925,7,0
0,0,10,10,17,17,34,59,39,98,0.000333,0.16619,16,7977.141735,443.174541,498.571358,138.973737,6,0
0,0,3,3,10,11,21,22,15,37,0.000333,0.054172,5,812.578723,45.143262,162.515745,71.273029,4,0
0,0,3,3,10,8,18,16,13,29,0.000333,0.040309,5,604.639125,33.591063,120.927825,57.219281,3,0
0,0,7,7,11,19,30,44,28,72,0.000333,0.117765,5,1766.480614,98.137812,353.296123,118.764371,2,0
0,0,5,5,11,12,23,33,21,54,0.000333,0.081424,5,1221.361728,67.853429,244.272346,81.073298,1,0
0,0,3,3,11,11,22,26,15,41,0.000333,0.060946,5,914.183482,50.787971,182.836696,76.107496,3,0
0,0,4,4,7,9,16,16,12,28,0.000333,0.037333,3,336,18.666667,112,48.180809,3,0
0,0,3,3,10,8,18,16,13,29,0.000333,0.040309,5,604.639125,33.591063,120.927825,57.219281,3,0
0,0,5,5,12,16,28,39,25,64,0.000333,0.102557,6,1846.02429,102.556905,307.670715,107.01955,2,0
0,0,5,5,10,16,26,24,27,51,0.000333,0.079907,5,1198.612128,66.589563,239.722426,97.219281,2,0
0,0,7,7,11,19,30,44,28,72,0.000333,0.117765,5,1766.480614,98.137812,353.296123,118.764371,2,0
0,0,4,4,4,7,11,13,11,24,0.000333,0.027675,2,166.052718,9.225151,83.026359,27.651484,3,0
0,0,3,3,8,10,18,20,13,33,0.000333,0.045869,4,550.4301,30.57945,137.607525,57.219281,3,0
0,0,3,3,9,9,18,18,13,31,0.000333,0.043089,4,517.0707,28.72615,129.267675,57.05865,2,0
0,0,4,4,11,10,21,26,17,43,0.000333,0.062957,5,944.348246,52.463791,188.869649,71.273029,2,0
0,0,4,4,4,7,11,13,11,24,0.000333,0.027675,2,166.052718,9.225151,83.026359,27.651484,3,0
0,0,8,8,15,18,33,66,34,100,0.000333,0.168146,7,3531.075884,196.170882,504.439412,133.662009,2,0
0,0,7,7,12,17,29,43,27,70,0.000333,0.113353,6,2040.352018,113.35289,340.05867,112.506418,4,0
0,0,29,29,18,33,51,184,107,291,0.000333,0.550225,27,44568.24591,2476.013662,1650.675775,241.523656,5,0
0,0,7,7,14,16,30,42,33,75,0.000333,0.122672,14,5152.235125,286.235285,368.016795,117.302969,4,0
0,0,3,3,11,11,22,26,15,41,0.000333,0.060946,5,914.183482,50.787971,182.836696,76.107496,3,0
0,0,3,3,11,11,22,26,15,41,0.000333,0.060946,5,914.183482,50.787971,182.836696,76.107496,3,0
0,0,4,4,7,14,21,36,21,57,0.000333,0.083454,3,751.086279,41.727016,250.362093,72.954453,1,0
0,0,7,7,14,16,30,42,33,75,0.000333,0.122672,14,5152.235125,286.235285,368.016795,117.302969,4,0
0,0,4,4,7,15,22,20,24,44,0.000333,0.065405,3,588.644974,32.702499,196.214991,78.254843,2,0
0,0,3,3,9,9,18,18,13,31,0.000333,0.043089,4,517.0707,28.72615,129.267675,57.05865,2,0
0,0,8,8,12,12,24,42,26,68,0.000333,0.103926,12,3741.329401,207.851633,311.77745,86.0391,4,0
0,0,8,8,12,13,25,41,24,65,0.000333,0.100617,6,1811.103914,100.616884,301.850652,91.125266,4,0
0,0,7,7,11,19,30,44,28,72,0.000333,0.117765,5,1766.480614,98.137812,353.296123,118.764371,2,0
0,0,6,6,10,14,24,28,21,49,0.000333,0.074888,5,1123.315813,62.406434,224.663163,86.52225,1,0
0,0,3,3,10,8,18,16,13,29,0.000333,0.040309,5,604.639125,33.591063,120.927825,57.219281,3,0
0,0,7,7,11,18,29,48,28,76,0.000333,0.123069,5,1846.032778,102.557377,369.206556,113.112398,1,0
0,0,3,3,10,8,18,16,13,29,0.000333,0.040309,5,604.639125,33.591063,120.927825,57.219281,3,0
0,0,4,4,4,7,11,13,11,24,0.000333,0.027675,2,166.052718,9.225151,83.026359,27.651484,3,0
0,0,3,3,9,9,18,18,13,31,0.000333,0.043089,4,517.0707,28.72615,129.267675,57.05865,2,0
0,0,4,4,10,12,22,21,17,38,0.000333,0.056486,5,847.292008,47.071778,169.458402,76.238831,1,0
0,0,3,3,10,8,18,16,13,29,0.000333,0.040309,5,604.639125,33.591063,120.927825,57.219281,3,0
0,0,8,8,15,18,33,66,34,100,0.000333,0.168146,7,3531.075884,196.170882,504.439412,133.662009,2,0
0,0,17,17,16,23,39,110,55,165,0.000333,0.290697,16,13953.46186,775.192325,872.091366,168.041925,7,0
0,0,4,4,12,12,24,42,17,59,0.000333,0.090171,6,1623.076725,90.170929,270.512788,86.0391,5,0
0,0,3,3,10,10,20,17,13,30,0.000333,0.043219,5,648.289214,36.016067,129.657843,66.438562,2,0
0,0,17,17,16,23,39,110,55,165,0.000333,0.290697,16,13953.46186,775.192325,872.091366,168.041925,7,0
0,0,3,3,10,8,18,16,13,29,0.000333,0.040309,5,604.639125,33.591063,120.927825,57.219281,3,0
0,0,17,17,16,23,39,110,55,165,0.000333,0.290697,16,13953.46186,775.192325,872.091366,168.041925,7,0
0,0,7,7,11,19,30,44,28,72,0.000333,0.117765,5,1766.480614,98.137812,353.296123,118.764371,2,0
0,0,6,6,12,14,26,33,26,59,0.000333,0.092442,6,1663.95566,92.441981,277.325943,96.322519,2,0
0,0,11,11,17,20,37,59,45,104,0.000333,0.180594,16,8668.5304,481.585022,541.78315,155.92543,6,0
0,0,4,4,4,7,11,13,11,24,0.000333,0.027675,2,166.052718,9.225151,83.026359,27.651484,3,0
0,0,3,3,10,9,19,37,16,53,0.000333,0.075047,5,1125.700791,62.538933,225.140158,61.748606,10,0
0,0,4,4,11,10,21,26,17,43,0.000333,0.062957,5,944.348246,52.463791,188.869649,71.273029,2,0
0,0,3,3,10,8,18,16,13,29,0.000333,0.040309,5,604.639125,33.591063,120.927825,57.219281,3,0
0,0,3,3,10,8,18,16,13,29,0.000333,0.040309,5,604.639125,33.591063,120.927825,57.219281,3,0
0,0,3,3,10,8,18,16,13,29,0.000333,0.040309,5,604.639125,33.591063,120.927825,57.219281,3,0
0,0,57,57,28,89,117,584,399,983,0.000333,2.25119,56,378199.8371,21011.10206,6753.568519,710.946213,31,0
0,0,7,7,11,19,30,44,28,72,0.000333,0.117765,5,1766.480614,98.137812,353.296123,118.764371,2,0
0,0,3,3,11,11,22,26,15,41,0.000333,0.060946,5,914.183482,50.787971,182.836696,76.107496,3,0
0,0,4,4,10,11,21,22,16,38,0.000333,0.055636,5,834.54031,46.363351,166.908062,71.273029,2,0
0,0,4,4,8,14,22,206,20,226,0.000333,0.335944,4,4031.326183,223.962566,1007.831546,77.302969,1,0
0,0,27,27,17,37,54,142,78,220,0.000333,0.422025,16,20257.20401,1125.400223,1266.07525,262.236643,10,0
0,0,8,8,9,17,26,35,26,61,0.000333,0.095576,4,1146.907291,63.717072,286.726823,98.016193,3,0
0,0,9,9,15,20,35,72,36,108,0.000333,0.184654,7,3877.737961,215.429887,553.962566,145.041921,2,0
0,0,3,3,10,8,18,16,13,29,0.000333,0.040309,5,604.639125,33.591063,120.927825,57.219281,3,0
0,0,7,7,12,17,29,43,27,70,0.000333,0.113353,6,2040.352018,113.35289,340.05867,112.506418,4,0
0,0,8,8,14,15,29,44,29,73,0.000333,0.118211,7,2482.428289,137.912683,354.632613,111.906328,4,0
0,0,3,3,10,8,18,16,13,29,0.000333,0.040309,5,604.639125,33.591063,120.927825,57.219281,3,0
0,0,7,7,11,19,30,44,28,72,0.000333,0.117765,5,1766.480614,98.137812,353.296123,118.764371,2,0
0,0,6,6,9,18,27,24,23,47,0.000333,0.074493,4,893.91885,49.662158,223.479713,103.587975,3,0
0,0,5,5,9,15,24,26,23,49,0.000333,0.074888,4,898.65265,49.925147,224.663163,87.132684,2,0
0,0,3,3,9,9,18,18,13,31,0.000333,0.043089,4,517.0707,28.72615,129.267675,57.05865,2,0
0,0,3,3,9,9,18,18,13,31,0.000333,0.043089,4,517.0707,28.72615,129.267675,57.05865,2,0
0,0,3,3,10,8,18,16,13,29,0.000333,0.040309,5,604.639125,33.591063,120.927825,57.219281,3,0
0,0,4,4,4,7,11,13,11,24,0.000333,0.027675,2,166.052718,9.225151,83.026359,27.651484,3,0
0,0,7,7,11,19,30,44,28,72,0.000333,0.117765,5,1766.480614,98.137812,353.296123,118.764371,2,0
0,0,7,7,11,19,30,44,28,72,0.000333,0.117765,5,1766.480614,98.137812,353.296123,118.764371,2,0
0,0,4,4,11,10,21,26,17,43,0.000333,0.062957,5,944.348246,52.463791,188.869649,71.273029,2,0
0,0,7,7,11,19,30,44,28,72,0.000333,0.117765,5,1766.480614,98.137812,353.296123,118.764371,2,0
0,0,3,3,8,9,17,17,12,29,0.000333,0.039512,4,474.14569,26.341427,118.536422,52.529325,2,0
0,0,3,3,9,9,18,18,13,31,0.000333,0.043089,4,517.0707,28.72615,129.267675,57.05865,2,0
0,0,4,4,8,11,19,17,15,32,0.000333,0.045311,4,543.734722,30.207485,135.93368,62.053748,3,0
0,0,11,11,13,24,37,57,47,104,0.000333,0.180594,6,3250.6989,180.594383,541.78315,158.144816,4,0
0,0,3,3,9,9,18,18,13,31,0.000333,0.043089,4,517.0707,28.72615,129.267675,57.05865,2,0
0,0,5,5,10,13,23,26,21,47,0.000333,0.070869,5,1063.03706,59.057614,212.607412,81.324997,4,0
0,0,27,27,17,36,53,139,77,216,0.000333,0.41241,16,19795.69309,1099.760727,1237.230818,255.604168,10,0
0,0,4,4,4,7,11,13,11,24,0.000333,0.027675,2,166.052718,9.225151,83.026359,27.651484,3,0
0,0,3,3,10,8,18,16,13,29,0.000333,0.040309,5,604.639125,33.591063,120.927825,57.219281,3,0
0,0,3,3,10,8,18,16,13,29,0.000333,0.040309,5,604.639125,33.591063,120.927825,57.219281,3,0
0,0,3,3,10,8,18,16,13,29,0.000333,0.040309,5,604.639125,33.591063,120.927825,57.219281,3,0
0,0,4,4,9,13,22,21,19,40,0.000333,0.059459,4,713.509059,39.639392,178.377265,76.635041,1,0
0,0,5,5,10,14,24,24,23,47,0.000333,0.071831,5,1077.466188,59.859233,215.493238,86.52225,2,0
0,0,3,3,9,9,18,18,13,31,0.000333,0.043089,4,517.0707,28.72615,129.267675,57.05865,2,0
0,0,17,17,16,23,39,110,55,165,0.000333,0.290697,16,13953.46186,775.192325,872.091366,168.041925,7,0
0,0,17,17,16,23,39,110,55,165,0.000333,0.290697,16,13953.46186,775.192325,872.091366,168.041925,7,0
0,0,7,7,11,19,30,44,28,72,0.000333,0.117765,5,1766.480614,98.137812,353.296123,118.764371,2,0
0,0,3,3,10,8,18,16,13,29,0.000333,0.040309,5,604.639125,33.591063,120.927825,57.219281,3,0
0,0,3,3,10,10,20,17,13,30,0.000333,0.043219,5,648.289214,36.016067,129.657843,66.438562,2,0
0,0,26,26,20,29,49,163,87,250,0.000333,0.467892,30,42110.32383,2339.462435,1403.677461,227.320011,20,0
0,0,5,5,11,14,25,27,24,51,0.000333,0.078946,5,1184.183328,65.787963,236.836666,91.356717,2,0
0,0,4,4,4,7,11,13,11,24,0.000333,0.027675,2,166.052718,9.225151,83.026359,27.651484,3,0
0,0,7,7,14,16,30,42,33,75,0.000333,0.122672,14,5152.235125,286.235285,368.016795,117.302969,4,0
0,0,3,3,10,8,18,16,13,29,0.000333,0.040309,5,604.639125,33.591063,120.927825,57.219281,3,0
0,0,4,4,8,11,19,17,15,32,0.000333,0.045311,4,543.734722,30.207485,135.93368,62.053748,3,0
0,0,4,4,6,8,14,17,12,29,0.000333,0.036804,3,331.239878,18.402215,110.413293,39.509775,3,0
0,0,27,27,17,37,54,142,78,220,0.000333,0.422025,16,20257.20401,1125.400223,1266.07525,262.236643,10,0
0,0,14,14,11,35,46,79,67,146,0.000333,0.268813,5,4032.200228,224.011124,806.440046,217.578653,6,0
0,0,4,4,4,7,11,13,11,24,0.000333,0.027675,2,166.052718,9.225151,83.026359,27.651484,3,0
0,0,3,3,10,8,18,16,13,29,0.000333,0.040309,5,604.639125,33.591063,120.927825,57.219281,3,0
0,0,3,3,10,8,18,16,13,29,0.000333,0.040309,5,604.639125,33.591063,120.927825,57.219281,3,0
0,0,3,3,10,8,18,16,13,29,0.000333,0.040309,5,604.639125,33.591063,120.927825,57.219281,3,0
0,0,3,3,10,10,20,17,13,30,0.000333,0.043219,5,648.289214,36.016067,129.657843,66.438562,2,0
0,0,3,3,9,9,18,18,13,31,0.000333,0.043089,4,517.0707,28.72615,129.267675,57.05865,2,0
0,0,3,3,10,8,18,16,13,29,0.000333,0.040309,5,604.639125,33.591063,120.927825,57.219281,3,0
0,0,7,7,11,19,30,44,28,72,0.000333,0.117765,5,1766.480614,98.137812,353.296123,118.764371,2,0
0,0,3,3,10,6,16,19,10,29,0.000333,0.038667,5,580,32.222222,116,48.729056,1,0
0,0,7,7,11,19,30,44,28,72,0.000333,0.117765,5,1766.480614,98.137812,353.296123,118.764371,2,0
0,0,8,8,16,19,35,72,39,111,0.000333,0.189783,16,9109.606638,506.089258,569.350415,144.710623,10,0
0,0,5,5,9,15,24,22,19,41,0.000333,0.062661,4,751.93385,41.774103,187.983463,87.132684,3,0
0,0,4,4,4,7,11,13,11,24,0.000333,0.027675,2,166.052718,9.225151,83.026359,27.651484,3,0
0,0,4,4,4,7,11,13,11,24,0.000333,0.027675,2,166.052718,9.225151,83.026359,27.651484,3,0
0,0,7,7,11,19,30,44,28,72,0.000333,0.117765,5,1766.480614,98.137812,353.296123,118.764371,2,0
0,0,7,7,11,19,30,44,28,72,0.000333,0.117765,5,1766.480614,98.137812,353.296123,118.764371,2,0
0,0,3,3,10,8,18,16,13,29,0.000333,0.040309,5,604.639125,33.591063,120.927825,57.219281,3,0
0,0,3,3,10,11,21,22,15,37,0.000333,0.054172,5,812.578723,45.143262,162.515745,71.273029,4,0
0,0,36,36,21,47,68,186,116,302,0.000333,0.612805,20,36768.27556,2042.681976,1838.413778,353.304342,16,0
0,0,3,3,9,9,18,18,13,31,0.000333,0.043089,4,517.0707,28.72615,129.267675,57.05865,2,0
0,0,7,7,11,18,29,48,28,76,0.000333,0.123069,5,1846.032778,102.557377,369.206556,113.112398,1,0
0,0,16,16,15,29,44,91,52,143,0.000333,0.260233,7,5464.89105,303.605058,780.698721,199.484808,5,0
0,0,4,4,10,9,19,23,14,37,0.000333,0.052391,5,785.86659,43.659255,157.173318,61.748606,2,0
0,0,7,7,11,19,30,44,28,72,0.000333,0.117765,5,1766.480614,98.137812,353.296123,118.764371,2,0
0,0,5,5,10,10,20,27,14,41,0.000333,0.059066,5,885.995259,49.221959,177.199052,66.438562,3,0
0,0,3,3,10,8,18,16,13,29,0.000333,0.040309,5,604.639125,33.591063,120.927825,57.219281,3,0
0,0,9,9,12,12,24,52,31,83,0.000333,0.126851,12,4566.622651,253.701258,380.551888,86.0391,4,0
0,0,8,8,12,12,24,42,26,68,0.000333,0.103926,12,3741.329401,207.851633,311.77745,86.0391,4,0
0,0,8,8,12,13,25,41,24,65,0.000333,0.100617,6,1811.103914,100.616884,301.850652,91.125266,4,0
0,0,4,4,11,10,21,26,17,43,0.000333,0.062957,5,944.348246,52.463791,188.869649,71.273029,2,0
0,0,7,7,11,19,30,44,28,72,0.000333,0.117765,5,1766.480614,98.137812,353.296123,118.764371,2,0
0,0,8,8,15,18,33,66,34,100,0.000333,0.168146,7,3531.075884,196.170882,504.439412,133.662009,2,0
0,0,3,3,10,8,18,16,13,29,0.000333,0.040309,5,604.639125,33.591063,120.927825,57.219281,3,0
0,0,3,3,10,8,18,16,13,29,0.000333,0.040309,5,604.639125,33.591063,120.927825,57.219281,3,0
0,0,3,3,10,8,18,16,13,29,0.000333,0.040309,5,604.639125,33.591063,120.927825,57.219281,3,0
0,0,10,10,15,27,42,169,61,230,0.000333,0.413411,14,17363.2621,964.625672,1240.233007,186.985321,7,0
0,0,10,10,18,18,36,60,42,102,0.000333,0.175777,18,9491.982303,527.33235,527.33235,150.1173,6,0
0,0,3,3,10,8,18,16,13,29,0.000333,0.040309,5,604.639125,33.591063,120.927825,57.219281,3,0
0,0,17,17,16,23,39,110,55,165,0.000333,0.290697,16,13953.46186,775.192325,872.091366,168.041925,7,0
0,0,4,4,4,7,11,13,11,24,0.000333,0.027675,2,166.052718,9.225151,83.026359,27.651484,3,0
0,0,4,4,6,8,14,17,12,29,0.000333,0.036804,3,331.239878,18.402215,110.413293,39.509775,3,0
0,0,7,7,11,19,30,44,28,72,0.000333,0.117765,5,1766.480614,98.137812,353.296123,118.764371,2,0
0,0,5,5,9,15,24,22,19,41,0.000333,0.062661,4,751.93385,41.774103,187.983463,87.132684,3,0
0,0,4,4,10,12,22,21,17,38,0.000333,0.056486,5,847.292008,47.071778,169.458402,76.238831,1,0
0,0,7,7,11,19,30,44,28,72,0.000333,0.117765,5,1766.480614,98.137812,353.296123,118.764371,2,0
0,0,3,3,11,11,22,26,15,41,0.000333,0.060946,5,914.183482,50.787971,182.836696,76.107496,3,0
0,0,7,7,11,19,30,44,28,72,0.000333,0.117765,5,1766.480614,98.137812,353.296123,118.764371,2,0
0,0,10,10,18,18,36,60,42,102,0.000333,0.175777,18,9491.982303,527.33235,527.33235,150.1173,6,0
0,0,3,3,11,11,22,26,15,41,0.000333,0.060946,5,914.183482,50.787971,182.836696,76.107496,3,0
0,0,3,3,10,8,18,16,13,29,0.000333,0.040309,5,604.639125,33.591063,120.927825,57.219281,3,0
0,0,4,4,4,7,11,13,11,24,0.000333,0.027675,2,166.052718,9.225151,83.026359,27.651484,3,0
0,0,7,7,11,19,30,44,28,72,0.000333,0.117765,5,1766.480614,98.137812,353.296123,118.764371,2,0
0,0,3,3,10,10,20,17,13,30,0.000333,0.043219,5,648.289214,36.016067,129.657843,66.438562,2,0
0,0,8,8,13,16,29,50,28,78,0.000333,0.126308,6,2273.535106,126.307506,378.922518,112.105716,2,0
0,0,14,14,11,35,46,79,67,146,0.000333,0.268813,5,4032.200228,224.011124,806.440046,217.578653,6,0
0,0,4,4,4,7,11,13,11,24,0.000333,0.027675,2,166.052718,9.225151,83.026359,27.651484,3,0
0,0,3,3,11,11,22,26,15,41,0.000333,0.060946,5,914.183482,50.787971,182.836696,76.107496,3,0
0,0,16,16,15,27,42,89,49,138,0.000333,0.248047,7,5208.97863,289.387702,744.139804,186.985321,5,0
0,0,7,7,11,19,30,44,28,72,0.000333,0.117765,5,1766.480614,98.137812,353.296123,118.764371,2,0
0,0,3,3,10,8,18,16,13,29,0.000333,0.040309,5,604.639125,33.591063,120.927825,57.219281,3,0
0,0,3,3,9,9,18,18,13,31,0.000333,0.043089,4,517.0707,28.72615,129.267675,57.05865,2,0
0,0,3,3,8,10,18,20,14,34,0.000333,0.047259,4,567.1098,31.5061,141.77745,57.219281,1,0
0,0,4,4,4,7,11,13,11,24,0.000333,0.027675,2,166.052718,9.225151,83.026359,27.651484,3,0
0,0,3,3,10,10,20,17,13,30,0.000333,0.043219,5,648.289214,36.016067,129.657843,66.438562,2,0
0,0,3,3,7,8,15,23,12,35,0.000333,0.04558,3,410.223513,22.790195,136.741171,43.651484,1,0
0,0,3,3,10,10,20,17,13,30,0.000333,0.043219,5,648.289214,36.016067,129.657843,66.438562,2,0
0,0,3,3,10,8,18,16,13,29,0.000333,0.040309,5,604.639125,33.591063,120.927825,57.219281,3,0
0,0,3,3,10,8,18,16,13,29,0.000333,0.040309,5,604.639125,33.591063,120.927825,57.219281,3,0
0,0,3,3,10,8,18,16,13,29,0.000333,0.040309,5,604.639125,33.591063,120.927825,57.219281,3,0
0,0,6,6,13,13,26,38,23,61,0.000333,0.095576,6,1720.360937,95.575608,286.726823,96.211433,4,0
0,0,4,4,11,10,21,26,17,43,0.000333,0.062957,5,944.348246,52.463791,188.869649,71.273029,2,0
0,0,4,4,11,9,20,24,12,36,0.000333,0.051863,5,777.947057,43.219281,155.589411,66.583073,5,0
0,0,7,7,11,19,30,44,28,72,0.000333,0.117765,5,1766.480614,98.137812,353.296123,118.764371,2,0
0,0,6,6,15,15,30,35,24,59,0.000333,0.096502,7,2026.545816,112.585879,289.506545,117.206718,4,0
0,0,9,9,12,15,27,336,24,360,0.000333,0.570587,6,10270.55701,570.5865,1711.759501,101.622909,3,0
0,0,7,7,11,18,29,48,28,76,0.000333,0.123069,5,1846.032778,102.557377,369.206556,113.112398,1,0
0,0,6,6,8,10,18,26,18,44,0.000333,0.061159,4,733.9068,40.7726,183.4767,57.219281,1,0
0,0,7,7,9,17,26,34,26,60,0.000333,0.094009,4,1128.105532,62.67253,282.026383,98.016193,5,0
0,0,7,7,11,19,30,44,28,72,0.000333,0.117765,5,1766.480614,98.137812,353.296123,118.764371,2,0
0,0,3,3,10,6,16,19,10,29,0.000333,0.038667,5,580,32.222222,116,48.729056,1,0
0,0,4,4,7,9,16,16,12,28,0.000333,0.037333,3,336,18.666667,112,48.180809,3,0
0,0,3,3,10,8,18,16,13,29,0.000333,0.040309,5,604.639125,33.591063,120.927825,57.219281,3,0
0,0,6,6,9,18,27,24,23,47,0.000333,0.074493,4,893.91885,49.662158,223.479713,103.587975,3,0
0,0,5,5,14,13,27,31,20,51,0.000333,0.080833,7,1697.494838,94.305269,242.499263,101.408685,2,0
0,0,7,7,11,19,30,44,28,72,0.000333,0.117765,5,1766.480614,98.137812,353.296123,118.764371,2,0
0,0,3,3,10,8,18,16,13,29,0.000333,0.040309,5,604.639125,33.591063,120.927825,57.219281,3,0
0,0,17,17,16,23,39,110,55,165,0.000333,0.290697,16,13953.46186,775.192325,872.091366,168.041925,7,0
0,0,7,7,11,19,30,44,28,72,0.000333,0.117765,5,1766.480614,98.137812,353.296123,118.764371,2,0
0,0,4,4,10,12,22,21,17,38,0.000333,0.056486,5,847.292008,47.071778,169.458402,76.238831,1,0
0,0,18,18,14,28,42,109,63,172,0.000333,0.30916,14,12984.70035,721.372242,927.478597,187.908907,3,0
0,0,3,3,10,10,20,17,13,30,0.000333,0.043219,5,648.289214,36.016067,129.657843,66.438562,2,0
0,0,3,3,10,8,18,16,13,29,0.000333,0.040309,5,604.639125,33.591063,120.927825,57.219281,3,0
0,0,7,7,11,19,30,44,28,72,0.000333,0.117765,5,1766.480614,98.137812,353.296123,118.764371,2,0
0,0,3,3,10,6,16,19,10,29,0.000333,0.038667,5,580,32.222222,116,48.729056,1,0
0,0,3,3,10,6,16,19,10,29,0.000333,0.038667,5,580,32.222222,116,48.729056,1,0
0,0,3,3,10,8,18,16,13,29,0.000333,0.040309,5,604.639125,33.591063,120.927825,57.219281,3,0
0,0,7,7,11,19,30,44,28,72,0.000333,0.117765,5,1766.480614,98.137812,353.296123,118.764371,2,0
0,0,3,3,10,8,18,16,13,29,0.000333,0.040309,5,604.639125,33.591063,120.927825,57.219281,3,0
0,0,3,3,9,9,18,18,13,31,0.000333,0.043089,4,517.0707,28.72615,129.267675,57.05865,2,0
0,0,8,8,16,19,35,41,31,72,0.000333,0.123103,8,2954.467018,164.137057,369.308377,144.710623,4,0
0,0,4,4,10,12,22,21,17,38,0.000333,0.056486,5,847.292008,47.071778,169.458402,76.238831,1,0
0,0,10,10,17,20,37,59,46,105,0.000333,0.182331,16,8751.881654,486.215647,546.992603,155.92543,6,0
0,0,3,3,10,10,20,17,13,30,0.000333,0.043219,5,648.289214,36.016067,129.657843,66.438562,2,0
0,0,18,18,11,28,39,116,64,180,0.000333,0.317124,10,9513.723994,528.540222,951.372399,172.659686,1,0
0,0,5,5,7,9,16,23,14,37,0.000333,0.049333,3,444,24.666667,148,48.180809,1,0
0,0,7,7,10,12,22,32,18,50,0.000333,0.074324,5,1114.857905,61.93655,222.971581,76.238831,3,0
0,0,7,7,11,18,29,48,28,76,0.000333,0.123069,5,1846.032778,102.557377,369.206556,113.112398,1,0
0,0,15,15,12,23,35,83,44,127,0.000333,0.21714,6,3908.513659,217.139648,651.418943,147.061475,5,0
0,0,4,4,4,7,11,13,11,24,0.000333,0.027675,2,166.052718,9.225151,83.026359,27.651484,3,0
0,0,7,7,11,19,30,44,28,72,0.000333,0.117765,5,1766.480614,98.137812,353.296123,118.764371,2,0
0,0,8,8,9,17,26,35,26,61,0.000333,0.095576,4,1146.907291,63.717072,286.726823,98.016193,3,0
0,0,4,4,4,7,11,13,11,24,0.000333,0.027675,2,166.052718,9.225151,83.026359,27.651484,3,0
0,0,5,5,9,15,24,22,19,41,0.000333,0.062661,4,751.93385,41.774103,187.983463,87.132684,3,0
0,0,3,3,9,9,18,18,13,31,0.000333,0.043089,4,517.0707,28.72615,129.267675,57.05865,2,0
0,0,4,4,11,9,20,24,12,36,0.000333,0.051863,5,777.947057,43.219281,155.589411,66.583073,5,0
0,0,4,4,4,7,11,13,11,24,0.000333,0.027675,2,166.052718,9.225151,83.026359,27.651484,3,0
0,0,7,7,14,15,29,42,31,73,0.000333,0.118211,14,4964.856577,275.825365,354.632613,111.906328,4,0
0,0,4,4,11,10,21,26,17,43,0.000333,0.062957,5,944.348246,52.463791,188.869649,71.273029,2,0
0,0,3,3,5,6,11,9,8,17,0.000333,0.019603,2,117.620675,6.534482,58.810338,27.119415,1,0
0,0,13,13,6,16,22,80,29,109,0.000333,0.162026,3,1458.234139,81.013008,486.078046,79.509775,3,0
0,0,15,15,14,21,35,86,52,138,0.000333,0.235947,14,9909.774789,550.543044,707.841056,145.541635,2,0
0,0,3,3,10,8,18,16,13,29,0.000333,0.040309,5,604.639125,33.591063,120.927825,57.219281,3,0
0,0,3,3,10,8,18,16,13,29,0.000333,0.040309,5,604.639125,33.591063,120.927825,57.219281,3,0
0,0,4,4,11,9,20,35,15,50,0.000333,0.072032,5,1080.482024,60.026779,216.096405,66.583073,2,0
0,0,3,3,8,10,18,20,14,34,0.000333,0.047259,4,567.1098,31.5061,141.77745,57.219281,1,0
0,0,3,3,10,8,18,16,13,29,0.000333,0.040309,5,604.639125,33.591063,120.927825,57.219281,3,0
0,0,7,7,11,19,30,44,28,72,0.000333,0.117765,5,1766.480614,98.137812,353.296123,118.764371,2,0
0,0,3,3,10,8,18,16,13,29,0.000333,0.040309,5,604.639125,33.591063,120.927825,57.219281,3,0
0,0,3,3,10,8,18,16,13,29,0.000333,0.040309,5,604.639125,33.591063,120.927825,57.219281,3,0
0,0,3,3,10,8,18,16,13,29,0.000333,0.040309,5,604.639125,33.591063,120.927825,57.219281,3,0
0,0,3,3,9,9,18,18,13,31,0.000333,0.043089,4,517.0707,28.72615,129.267675,57.05865,2,0
0,0,3,3,7,9,16,17,12,29,0.000333,0.038667,3,348,19.333333,116,48.180809,2,0
0,0,3,3,10,6,16,19,10,29,0.000333,0.038667,5,580,32.222222,116,48.729056,1,0
0,0,7,7,11,19,30,44,28,72,0.000333,0.117765,5,1766.480614,98.137812,353.296123,118.764371,2,0
0,0,7,7,11,19,30,44,28,72,0.000333,0.117765,5,1766.480614,98.137812,353.296123,118.764371,2,0
0,0,3,3,5,6,11,9,8,17,0.000333,0.019603,2,117.620675,6.534482,58.810338,27.119415,1,0
0,0,26,26,17,35,52,137,73,210,0.000333,0.399031,16,19153.47745,1064.082081,1197.092341,249.011774,10,0
0,0,3,3,10,10,20,17,13,30,0.000333,0.043219,5,648.289214,36.016067,129.657843,66.438562,2,0
0,0,7,7,11,19,30,44,28,72,0.000333,0.117765,5,1766.480614,98.137812,353.296123,118.764371,2,0
0,0,3,3,10,8,18,16,13,29,0.000333,0.040309,5,604.639125,33.591063,120.927825,57.219281,3,0
0,0,17,17,16,23,39,110,55,165,0.000333,0.290697,16,13953.46186,775.192325,872.091366,168.041925,7,0
0,0,3,3,10,8,18,16,13,29,0.000333,0.040309,5,604.639125,33.591063,120.927825,57.219281,3,0
0,0,3,3,5,6,11,9,8,17,0.000333,0.019603,2,117.620675,6.534482,58.810338,27.119415,2,0
0,0,7,7,11,19,30,44,28,72,0.000333,0.117765,5,1766.480614,98.137812,353.296123,118.764371,2,0
0,0,3,3,7,8,15,23,12,35,0.000333,0.04558,3,410.223513,22.790195,136.741171,43.651484,1,0
0,0,27,27,17,38,55,142,77,219,0.000333,0.422039,16,20257.88444,1125.438024,1266.117777,268.908114,10,0
0,0,4,4,6,8,14,17,12,29,0.000333,0.036804,3,331.239878,18.402215,110.413293,39.509775,3,0
0,0,4,4,11,9,20,35,15,50,0.000333,0.072032,5,1080.482024,60.026779,216.096405,66.583073,2,0
0,0,33,33,17,50,67,221,116,337,0.000333,0.681424,16,32708.35292,1817.130717,2044.272057,351.679678,9,0
0,0,3,3,10,8,18,16,13,29,0.000333,0.040309,5,604.639125,33.591063,120.927825,57.219281,3,0
0,0,5,5,11,15,26,27,26,53,0.000333,0.083041,5,1245.616525,69.200918,249.123305,96.657107,2,0
0,0,3,3,10,8,18,16,13,29,0.000333,0.040309,5,604.639125,33.591063,120.927825,57.219281,3,0
0,0,6,6,13,13,26,38,23,61,0.000333,0.095576,6,1720.360937,95.575608,286.726823,96.211433,4,0
0,0,3,3,11,11,22,26,15,41,0.000333,0.060946,5,914.183482,50.787971,182.836696,76.107496,3,0
0,0,4,4,7,9,16,16,12,28,0.000333,0.037333,3,336,18.666667,112,48.180809,3,0
0,0,9,9,15,20,35,72,36,108,0.000333,0.184654,7,3877.737961,215.429887,553.962566,145.041921,2,0
0,0,4,4,7,14,21,20,22,42,0.000333,0.061492,3,553.431995,30.746222,184.477332,72.954453,2,0
0,0,3,3,9,9,18,18,13,31,0.000333,0.043089,4,517.0707,28.72615,129.267675,57.05865,2,0
0,0,3,3,10,8,18,16,13,29,0.000333,0.040309,5,604.639125,33.591063,120.927825,57.219281,3,0
0,0,4,4,4,7,11,13,11,24,0.000333,0.027675,2,166.052718,9.225151,83.026359,27.651484,3,0
0,0,17,17,14,35,49,175,69,244,0.000333,0.456663,7,9589.924414,532.773579,1369.989202,232.827875,5,0
0,0,4,4,7,11,18,20,16,36,0.000333,0.050039,3,450.3519,25.01955,150.1173,57.705232,2,0
0,0,8,8,14,16,30,50,37,87,0.000333,0.1423,14,5976.592745,332.03293,426.899482,117.302969,2,0
0,0,25,25,12,35,47,382,213,595,0.000333,1.10166,36,118979.2932,6609.960733,3304.980367,222.544456,4,0
0,0,5,5,11,12,23,33,21,54,0.000333,0.081424,5,1221.361728,67.853429,244.272346,81.073298,1,0
0,0,3,3,10,8,18,16,13,29,0.000333,0.040309,5,604.639125,33.591063,120.927825,57.219281,3,0
0,0,9,9,15,20,35,72,36,108,0.000333,0.184654,7,3877.737961,215.429887,553.962566,145.041921,2,0
0,0,4,4,6,8,14,17,12,29,0.000333,0.036804,3,331.239878,18.402215,110.413293,39.509775,3,0
0,0,3,3,10,8,18,16,13,29,0.000333,0.040309,5,604.639125,33.591063,120.927825,57.219281,3,0
0,0,4,4,6,10,16,26,15,41,0.000333,0.054667,3,492,27.333333,164,48.729056,1,0
0,0,7,7,11,19,30,44,28,72,0.000333,0.117765,5,1766.480614,98.137812,353.296123,118.764371,2,0
0,0,26,26,17,44,61,148,86,234,0.000333,0.462598,8,11102.3403,616.796683,1387.792537,309.70186,8,0
0,0,20,20,16,28,44,143,80,223,0.000333,0.405818,16,19479.25202,1082.180668,1217.453251,198.605938,16,0
0,0,35,35,21,58,79,219,130,349,0.000333,0.73334,20,44000.38962,2444.46609,2200.019481,432.001564,11,0
0,0,7,7,11,19,30,44,28,72,0.000333,0.117765,5,1766.480614,98.137812,353.296123,118.764371,2,0
0,0,3,3,10,8,18,16,13,29,0.000333,0.040309,5,604.639125,33.591063,120.927825,57.219281,3,0
0,0,4,4,10,9,19,46,19,65,0.000333,0.092038,10,2761.152884,153.397382,276.115288,61.748606,11,0
0,0,3,3,10,9,19,37,16,53,0.000333,0.075047,5,1125.700791,62.538933,225.140158,61.748606,10,0
0,0,8,8,9,17,26,35,26,61,0.000333,0.095576,4,1146.907291,63.717072,286.726823,98.016193,3,0
0,0,4,4,4,7,11,13,11,24,0.000333,0.027675,2,166.052718,9.225151,83.026359,27.651484,3,0
0,0,7,7,12,17,29,43,27,70,0.000333,0.113353,6,2040.352018,113.35289,340.05867,112.506418,4,0
0,0,3,3,10,8,18,16,13,29,0.000333,0.040309,5,604.639125,33.591063,120.927825,57.219281,3,0
0,0,21,21,18,34,52,147,87,234,0.000333,0.444634,18,24010.25209,1333.902894,1333.902894,248.032387,2,0
0,0,11,11,15,21,36,63,47,110,0.000333,0.189564,14,7961.684502,442.315806,568.69175,150.842025,4,0
0,0,4,4,10,9,19,23,14,37,0.000333,0.052391,5,785.86659,43.659255,157.173318,61.748606,2,0
0,0,3,3,9,9,18,18,13,31,0.000333,0.043089,4,517.0707,28.72615,129.267675,57.05865,2,0
0,0,4,4,4,7,11,13,11,24,0.000333,0.027675,2,166.052718,9.225151,83.026359,27.651484,3,0
0,0,6,6,13,13,26,38,23,61,0.000333,0.095576,6,1720.360937,95.575608,286.726823,96.211433,4,0
0,0,10,10,12,24,36,48,40,88,0.000333,0.151651,6,2729.720401,151.651133,454.9534,153.05865,4,0
0,0,7,7,11,19,30,44,28,72,0.000333,0.117765,5,1766.480614,98.137812,353.296123,118.764371,2,0
0,0,3,3,10,8,18,16,13,29,0.000333,0.040309,5,604.639125,33.591063,120.927825,57.219281,3,0
0,0,8,8,17,13,30,41,27,68,0.000333,0.111223,16,5338.696968,296.594276,333.668561,117.592585,4,0
0,0,7,7,11,18,29,48,28,76,0.000333,0.123069,5,1846.032778,102.557377,369.206556,113.112398,1,0
0,0,5,5,10,10,20,27,14,41,0.000333,0.059066,5,885.995259,49.221959,177.199052,66.438562,3,0
0,0,8,8,9,17,26,35,26,61,0.000333,0.095576,4,1146.907291,63.717072,286.726823,98.016193,3,0
0,0,3,3,11,11,22,26,15,41,0.000333,0.060946,5,914.183482,50.787971,182.836696,76.107496,3,0
0,0,3,3,8,10,18,20,13,33,0.000333,0.045869,4,550.4301,30.57945,137.607525,57.219281,3,0
0,0,3,3,9,9,18,18,13,31,0.000333,0.043089,4,517.0707,28.72615,129.267675,57.05865,2,0
0,0,3,3,8,10,18,20,14,34,0.000333,0.047259,4,567.1098,31.5061,141.77745,57.219281,1,0
0,0,13,13,13,25,38,65,49,114,0.000333,0.199421,6,3589.582419,199.421246,598.263737,164.202121,4,0
0,0,9,9,13,21,34,54,46,100,0.000333,0.169582,12,6104.95541,339.164189,508.746284,140.344382,4,0
0,0,7,7,11,19,30,44,28,72,0.000333,0.117765,5,1766.480614,98.137812,353.296123,118.764371,2,0
0,0,17,17,17,26,43,97,61,158,0.000333,0.285783,16,13717.5973,762.088739,857.349831,191.698301,8,0
0,0,9,9,15,19,34,68,35,103,0.000333,0.17467,7,3668.060709,203.78115,524.008673,139.313982,2,0
0,0,8,8,15,18,33,66,34,100,0.000333,0.168146,7,3531.075884,196.170882,504.439412,133.662009,2,0
0,0,3,3,10,6,16,19,10,29,0.000333,0.038667,5,580,32.222222,116,48.729056,1,0
0,0,3,3,10,8,18,16,13,29,0.000333,0.040309,5,604.639125,33.591063,120.927825,57.219281,3,0
0,0,17,17,14,28,42,96,52,148,0.000333,0.266021,7,5586.44085,310.357825,798.062979,187.908907,5,0
0,0,3,3,10,8,18,16,13,29,0.000333,0.040309,5,604.639125,33.591063,120.927825,57.219281,3,0
0,0,7,7,11,19,30,44,28,72,0.000333,0.117765,5,1766.480614,98.137812,353.296123,118.764371,2,0
0,0,20,20,16,30,46,180,96,276,0.000333,0.508168,24,36588.0744,2032.6708,1524.5031,211.206718,9,0
0,0,3,3,10,8,18,16,13,29,0.000333,0.040309,5,604.639125,33.591063,120.927825,57.219281,3,0
0,0,3,3,10,8,18,16,13,29,0.000333,0.040309,5,604.639125,33.591063,120.927825,57.219281,3,0
0,0,3,3,10,8,18,16,13,29,0.000333,0.040309,5,604.639125,33.591063,120.927825,57.219281,3,0
0,0,4,4,11,9,20,24,12,36,0.000333,0.051863,5,777.947057,43.219281,155.589411,66.583073,5,0
0,0,4,4,10,9,19,46,19,65,0.000333,0.092038,10,2761.152884,153.397382,276.115288,61.748606,11,0
0,0,7,7,11,19,30,44,28,72,0.000333,0.117765,5,1766.480614,98.137812,353.296123,118.764371,2,0
0,0,5,5,7,9,16,23,14,37,0.000333,0.049333,3,444,24.666667,148,48.180809,1,0
0,0,6,6,15,15,30,35,24,59,0.000333,0.096502,7,2026.545816,112.585879,289.506545,117.206718,4,0
0,0,5,5,12,16,28,39,25,64,0.000333,0.102557,6,1846.02429,102.556905,307.670715,107.01955,2,0
0,0,9,9,14,25,39,156,54,210,0.000333,0.369978,14,15539.08252,863.282362,1109.934466,169.399374,5,0
0,0,3,3,10,8,18,16,13,29,0.000333,0.040309,5,604.639125,33.591063,120.927825,57.219281,3,0
0,0,4,4,8,11,19,17,15,32,0.000333,0.045311,4,543.734722,30.207485,135.93368,62.053748,3,0
0,0,3,3,10,8,18,16,13,29,0.000333,0.040309,5,604.639125,33.591063,120.927825,57.219281,3,0
0,0,6,6,15,15,30,35,24,59,0.000333,0.096502,7,2026.545816,112.585879,289.506545,117.206718,4,0
0,0,5,5,9,9,18,34,14,48,0.000333,0.066719,4,800.6256,44.4792,200.1564,57.05865,3,0
0,0,3,3,10,8,18,16,13,29,0.000333,0.040309,5,604.639125,33.591063,120.927825,57.219281,3,0
0,0,9,9,13,21,34,49,35,84,0.000333,0.142449,6,2564.081272,142.44896,427.346879,140.344382,4,0
0,0,7,7,11,18,29,48,28,76,0.000333,0.123069,5,1846.032778,102.557377,369.206556,113.112398,1,0
0,0,3,3,10,8,18,16,13,29,0.000333,0.040309,5,604.639125,33.591063,120.927825,57.219281,3,0
0,0,3,3,9,13,22,20,16,36,0.000333,0.053513,4,642.158153,35.675453,160.539538,76.635041,3,0
0,0,4,4,10,12,22,21,17,38,0.000333,0.056486,5,847.292008,47.071778,169.458402,76.238831,1,0
0,0,7,7,11,19,30,44,28,72,0.000333,0.117765,5,1766.480614,98.137812,353.296123,118.764371,2,0
0,0,6,6,11,16,27,30,23,53,0.000333,0.084003,5,1260.045188,70.00251,252.009038,102.053748,1,0
0,0,28,28,17,40,57,151,80,231,0.000333,0.449133,16,21558.36149,1197.68675,1347.397593,282.363992,10,0
0,0,4,4,10,12,22,21,17,38,0.000333,0.056486,5,847.292008,47.071778,169.458402,76.238831,1,0
0,0,3,3,10,10,20,17,13,30,0.000333,0.043219,5,648.289214,36.016067,129.657843,66.438562,2,0
0,0,10,10,17,15,32,59,37,96,0.000333,0.16,16,7680,426.666667,480,128.090227,6,0
0,0,4,4,9,7,16,21,10,31,0.000333,0.041333,4,496,27.555556,124,48.180809,2,0
0,0,3,3,10,8,18,16,13,29,0.000333,0.040309,5,604.639125,33.591063,120.927825,57.219281,3,0
0,0,36,36,21,46,67,185,115,300,0.000333,0.606609,20,36396.53514,2022.02973,1819.826757,346.322516,17,0
0,0,3,3,10,8,18,16,13,29,0.000333,0.040309,5,604.639125,33.591063,120.927825,57.219281,3,0
0,0,11,11,15,21,36,84,43,127,0.000333,0.21886,14,9192.126653,510.673703,656.580475,150.842025,2,0
0,0,3,3,10,8,18,16,13,29,0.000333,0.040309,5,604.639125,33.591063,120.927825,57.219281,3,0
0,0,3,3,9,9,18,18,13,31,0.000333,0.043089,4,517.0707,28.72615,129.267675,57.05865,2,0
0,0,3,3,10,8,18,16,13,29,0.000333,0.040309,5,604.639125,33.591063,120.927825,57.219281,3,0
0,0,9,9,15,19,34,68,35,103,0.000333,0.17467,7,3668.060709,203.78115,524.008673,139.313982,2,0
0,0,3,3,10,8,18,16,13,29,0.000333,0.040309,5,604.639125,33.591063,120.927825,57.219281,3,0
0,0,3,3,10,8,18,16,13,29,0.000333,0.040309,5,604.639125,33.591063,120.927825,57.219281,3,0
0,0,4,4,11,10,21,26,17,43,0.000333,0.062957,5,944.348246,52.463791,188.869649,71.273029,2,0
0,0,4,4,10,12,22,21,17,38,0.000333,0.056486,5,847.292008,47.071778,169.458402,76.238831,1,0
0,0,10,10,15,22,37,52,43,95,0.000333,0.164966,7,3464.286488,192.46036,494.89807,156.710855,4,0
0,0,7,7,11,19,30,44,28,72,0.000333,0.117765,5,1766.480614,98.137812,353.296123,118.764371,2,0
0,0,4,4,10,12,22,21,17,38,0.000333,0.056486,5,847.292008,47.071778,169.458402,76.238831,1,0
0,0,66,66,28,89,117,641,434,1075,0.000333,2.461881,56,413595.9561,22977.55312,7385.642074,710.946213,38,0
0,0,26,26,17,36,53,138,74,212,0.000333,0.404773,16,19429.10618,1079.394788,1214.319136,255.604168,10,0
0,0,3,3,10,10,20,17,13,30,0.000333,0.043219,5,648.289214,36.016067,129.657843,66.438562,2,0
0,0,17,17,16,29,45,711,74,785,0.000333,1.437035,16,68977.67489,3832.093049,4311.104681,204.881449,2,0
0,0,5,5,12,16,28,39,25,64,0.000333,0.102557,6,1846.02429,102.556905,307.670715,107.01955,2,0
0,0,4,4,11,10,21,19,14,33,0.000333,0.048315,5,724.732375,40.26291,144.946475,71.273029,2,0
0,0,6,6,9,12,21,28,21,49,0.000333,0.071741,4,860.894215,47.827456,215.223554,71.548875,3,0
0,0,3,3,10,8,18,16,13,29,0.000333,0.040309,5,604.639125,33.591063,120.927825,57.219281,3,0
0,0,7,7,11,19,30,44,28,72,0.000333,0.117765,5,1766.480614,98.137812,353.296123,118.764371,2,0
0,0,3,3,10,8,18,16,13,29,0.000333,0.040309,5,604.639125,33.591063,120.927825,57.219281,3,0
0,0,7,7,14,15,29,42,31,73,0.000333,0.118211,14,4964.856577,275.825365,354.632613,111.906328,4,0
0,0,6,6,15,15,30,35,24,59,0.000333,0.096502,7,2026.545816,112.585879,289.506545,117.206718,4,0
0,0,25,25,12,35,47,382,213,595,0.000333,1.10166,36,118979.2932,6609.960733,3304.980367,222.544456,4,0
0,0,7,7,11,19,30,44,28,72,0.000333,0.117765,5,1766.480614,98.137812,353.296123,118.764371,2,0
0,0,3,3,10,8,18,16,13,29,0.000333,0.040309,5,604.639125,33.591063,120.927825,57.219281,3,0
0,0,3,3,5,6,11,9,8,17,0.000333,0.019603,2,117.620675,6.534482,58.810338,27.119415,4,0
0,0,3,3,10,8,18,16,13,29,0.000333,0.040309,5,604.639125,33.591063,120.927825,57.219281,3,0
0,0,7,7,11,19,30,44,28,72,0.000333,0.117765,5,1766.480614,98.137812,353.296123,118.764371,2,0
0,0,7,7,14,19,33,48,28,76,0.000333,0.127791,7,2683.617671,149.089871,383.373953,134.013592,3,0
0,0,7,7,11,19,30,44,28,72,0.000333,0.117765,5,1766.480614,98.137812,353.296123,118.764371,2,0
0,0,11,11,15,21,36,84,43,127,0.000333,0.21886,14,9192.126653,510.673703,656.580475,150.842025,2,0
0,0,3,3,9,9,18,18,13,31,0.000333,0.043089,4,517.0707,28.72615,129.267675,57.05865,2,0
0,0,9,9,15,19,34,68,35,103,0.000333,0.17467,7,3668.060709,203.78115,524.008673,139.313982,2,0
0,0,3,3,7,9,16,17,12,29,0.000333,0.038667,3,348,19.333333,116,48.180809,2,0
0,0,14,14,11,23,34,85,48,133,0.000333,0.225544,10,6766.325579,375.906977,676.632558,142.095673,1,0
0,0,3,3,10,8,18,16,13,29,0.000333,0.040309,5,604.639125,33.591063,120.927825,57.219281,3,0
0,0,3,3,10,10,20,17,13,30,0.000333,0.043219,5,648.289214,36.016067,129.657843,66.438562,2,0
0,0,3,3,5,7,12,8,7,15,0.000333,0.017925,2,107.548875,5.974938,53.774438,31.261125,1,0
0,0,7,7,11,10,21,36,17,53,0.000333,0.077598,5,1163.964117,64.664673,232.792823,71.273029,4,0
0,0,7,7,11,19,30,44,28,72,0.000333,0.117765,5,1766.480614,98.137812,353.296123,118.764371,2,0
0,0,4,4,11,8,19,22,13,35,0.000333,0.049559,5,743.387315,41.299295,148.677463,62.053748,2,0
0,0,4,4,10,12,22,21,17,38,0.000333,0.056486,5,847.292008,47.071778,169.458402,76.238831,1,0
0,0,3,3,10,10,20,17,13,30,0.000333,0.043219,5,648.289214,36.016067,129.657843,66.438562,2,0
0,0,14,14,11,35,46,79,67,146,0.000333,0.268813,5,4032.200228,224.011124,806.440046,217.578653,6,0
0,0,3,3,10,8,18,16,13,29,0.000333,0.040309,5,604.639125,33.591063,120.927825,57.219281,3,0
0,0,4,4,4,7,11,13,11,24,0.000333,0.027675,2,166.052718,9.225151,83.026359,27.651484,3,0
0,0,8,8,9,19,28,60,32,92,0.000333,0.147426,4,1769.106611,98.283701,442.276653,109.239948,3,0
0,0,3,3,9,9,18,18,13,31,0.000333,0.043089,4,517.0707,28.72615,129.267675,57.05865,2,0
0,0,4,4,10,12,22,24,18,42,0.000333,0.062432,5,936.48064,52.026702,187.296128,76.238831,2,0
0,0,3,3,10,8,18,16,13,29,0.000333,0.040309,5,604.639125,33.591063,120.927825,57.219281,3,0
0,0,7,7,10,12,22,44,21,65,0.000333,0.096621,5,1449.315276,80.517515,289.863055,76.238831,3,0
0,0,3,3,10,8,18,16,13,29,0.000333,0.040309,5,604.639125,33.591063,120.927825,57.219281,3,0
0,0,4,4,6,8,14,17,12,29,0.000333,0.036804,3,331.239878,18.402215,110.413293,39.509775,3,0
0,0,6,6,9,18,27,24,23,47,0.000333,0.074493,4,893.91885,49.662158,223.479713,103.587975,3,0
0,0,8,8,16,13,29,53,32,85,0.000333,0.137643,16,6606.854153,367.047453,412.928385,112.105716,6,0
0,0,7,7,10,17,27,35,25,60,0.000333,0.095098,5,1426.466251,79.248125,285.29325,102.706149,6,0
0,0,4,4,4,7,11,13,11,24,0.000333,0.027675,2,166.052718,9.225151,83.026359,27.651484,3,0
0,0,7,7,11,19,30,44,28,72,0.000333,0.117765,5,1766.480614,98.137812,353.296123,118.764371,2,0
0,0,4,4,4,7,11,13,11,24,0.000333,0.027675,2,166.052718,9.225151,83.026359,27.651484,3,0
0,0,3,3,6,7,13,13,9,22,0.000333,0.027137,3,244.229021,13.568279,81.409674,35.161259,1,0
0,0,8,8,16,13,29,53,32,85,0.000333,0.137643,16,6606.854153,367.047453,412.928385,112.105716,6,0
0,0,4,4,11,10,21,26,17,43,0.000333,0.062957,5,944.348246,52.463791,188.869649,71.273029,2,0
0,0,9,9,14,19,33,44,36,80,0.000333,0.134517,7,2824.860707,156.936706,403.55153,134.013592,4,0
0,0,4,4,10,12,22,21,17,38,0.000333,0.056486,5,847.292008,47.071778,169.458402,76.238831,1,0
0,0,3,3,10,10,20,17,13,30,0.000333,0.043219,5,648.289214,36.016067,129.657843,66.438562,2,0
0,0,7,7,11,19,30,44,28,72,0.000333,0.117765,5,1766.480614,98.137812,353.296123,118.764371,2,0
0,0,3,3,10,8,18,16,13,29,0.000333,0.040309,5,604.639125,33.591063,120.927825,57.219281,3,0
0,0,7,7,11,19,30,44,28,72,0.000333,0.117765,5,1766.480614,98.137812,353.296123,118.764371,2,0
0,0,29,29,17,44,61,151,84,235,0.000333,0.464574,8,11149.7862,619.432566,1393.723274,309.70186,10,0
0,0,3,3,10,8,18,16,13,29,0.000333,0.040309,5,604.639125,33.591063,120.927825,57.219281,3,0
0,0,4,4,10,12,22,21,17,38,0.000333,0.056486,5,847.292008,47.071778,169.458402,76.238831,1,0
0,0,5,5,11,12,23,33,21,54,0.000333,0.081424,5,1221.361728,67.853429,244.272346,81.073298,1,0
0,0,3,3,9,9,18,18,13,31,0.000333,0.043089,4,517.0707,28.72615,129.267675,57.05865,2,0
0,0,25,25,12,35,47,382,213,595,0.000333,1.10166,36,118979.2932,6609.960733,3304.980367,222.544456,4,0
0,0,3,3,10,11,21,22,15,37,0.000333,0.054172,5,812.578723,45.143262,162.515745,71.273029,4,0
0,0,5,5,12,16,28,39,25,64,0.000333,0.102557,6,1846.02429,102.556905,307.670715,107.01955,2,0
0,0,3,3,8,10,18,20,13,33,0.000333,0.045869,4,550.4301,30.57945,137.607525,57.219281,3,0
0,0,3,3,9,9,18,18,13,31,0.000333,0.043089,4,517.0707,28.72615,129.267675,57.05865,2,0
0,0,7,7,11,19,30,44,28,72,0.000333,0.117765,5,1766.480614,98.137812,353.296123,118.764371,2,0
0,0,9,9,13,19,32,49,32,81,0.000333,0.135,6,2430,135,405,128.816339,4,0
0,0,3,3,10,8,18,16,13,29,0.000333,0.040309,5,604.639125,33.591063,120.927825,57.219281,3,0
0,0,4,4,10,12,22,21,17,38,0.000333,0.056486,5,847.292008,47.071778,169.458402,76.238831,1,0
0,0,36,36,16,62,78,272,185,457,0.000333,0.957476,16,45958.86102,2553.270057,2872.428814,433.160171,4,0
0,0,4,4,4,7,11,13,11,24,0.000333,0.027675,2,166.052718,9.225151,83.026359,27.651484,3,0
0,0,13,13,16,36,52,233,88,321,0.000333,0.609947,16,29277.45839,1626.525466,1829.84115,250.1173,14,0
0,0,3,3,10,8,18,16,13,29,0.000333,0.040309,5,604.639125,33.591063,120.927825,57.219281,3,0
0,0,4,4,11,9,20,24,12,36,0.000333,0.051863,5,777.947057,43.219281,155.589411,66.583073,5,0
0,0,6,6,11,12,23,30,17,47,0.000333,0.070869,5,1063.03706,59.057614,212.607412,81.073298,3,0
0,0,37,37,19,49,68,277,149,426,0.000333,0.86442,27,70017.9976,3889.888756,2593.25917,355.831405,13,0
0,0,4,4,4,7,11,13,11,24,0.000333,0.027675,2,166.052718,9.225151,83.026359,27.651484,3,0
0,0,14,14,11,35,46,79,67,146,0.000333,0.268813,5,4032.200228,224.011124,806.440046,217.578653,6,0
0,0,8,8,14,17,31,44,30,74,0.000333,0.122204,7,2566.273689,142.57076,366.610527,122.789837,4,0
0,0,7,7,9,21,30,28,27,55,0.000333,0.08996,4,1079.515931,59.973107,269.878983,120.767991,3,0
0,0,4,4,11,9,20,24,12,36,0.000333,0.051863,5,777.947057,43.219281,155.589411,66.583073,5,0
0,0,12,12,12,24,36,97,50,147,0.000333,0.253326,12,9119.747703,506.65265,759.978975,153.05865,1,0
0,0,7,7,11,19,30,44,28,72,0.000333,0.117765,5,1766.480614,98.137812,353.296123,118.764371,2,0
0,0,6,6,13,13,26,38,23,61,0.000333,0.095576,6,1720.360937,95.575608,286.726823,96.211433,4,0
0,0,4,4,4,7,11,13,11,24,0.000333,0.027675,2,166.052718,9.225151,83.026359,27.651484,3,0
0,0,3,3,10,10,20,17,13,30,0.000333,0.043219,5,648.289214,36.016067,129.657843,66.438562,2,0
0,0,4,4,11,9,20,24,12,36,0.000333,0.051863,5,777.947057,43.219281,155.589411,66.583073,5,0
0,0,3,3,10,8,18,16,13,29,0.000333,0.040309,5,604.639125,33.591063,120.927825,57.219281,3,0
0,0,3,3,10,8,18,16,13,29,0.000333,0.040309,5,604.639125,33.591063,120.927825,57.219281,3,0
0,0,7,7,10,12,22,44,21,65,0.000333,0.096621,5,1449.315276,80.517515,289.863055,76.238831,3,0
0,0,19,19,19,27,46,152,72,224,0.000333,0.412426,18,22271.00181,1237.277878,1237.277878,209.092585,9,0
0,0,8,8,9,17,26,35,26,61,0.000333,0.095576,4,1146.907291,63.717072,286.726823,98.016193,3,0
0,0,7,7,14,15,29,42,31,73,0.000333,0.118211,14,4964.856577,275.825365,354.632613,111.906328,4,0
0,0,8,8,9,17,26,35,26,61,0.000333,0.095576,4,1146.907291,63.717072,286.726823,98.016193,3,0
0,0,3,3,10,8,18,16,13,29,0.000333,0.040309,5,604.639125,33.591063,120.927825,57.219281,3,0
0,0,28,28,17,38,55,144,79,223,0.000333,0.429748,16,20627.89146,1145.99397,1289.243216,268.908114,10,0
0,0,7,7,11,19,30,44,28,72,0.000333,0.117765,5,1766.480614,98.137812,353.296123,118.764371,2,0
0,0,4,4,4,7,11,13,11,24,0.000333,0.027675,2,166.052718,9.225151,83.026359,27.651484,3,0
0,0,4,4,8,11,19,17,15,32,0.000333,0.045311,4,543.734722,30.207485,135.93368,62.053748,3,0
0,0,7,7,11,18,29,48,28,76,0.000333,0.123069,5,1846.032778,102.557377,369.206556,113.112398,3,0
0,0,10,10,13,25,38,60,36,96,0.000333,0.167934,6,3022.806248,167.93368,503.801041,164.202121,9,0
0,0,5,5,12,16,28,39,25,64,0.000333,0.102557,6,1846.02429,102.556905,307.670715,107.01955,3,0
0,0,7,7,11,19,30,44,28,72,0.000333,0.117765,5,1766.480614,98.137812,353.296123,118.764371,2,0
0,0,4,4,11,10,21,26,17,43,0.000333,0.062957,5,944.348246,52.463791,188.869649,71.273029,2,0
0,0,7,7,17,14,31,46,29,75,0.000333,0.123855,16,5945.035572,330.279754,371.564723,122.789837,4,0
0,0,11,11,16,13,29,71,43,114,0.000333,0.184603,24,13291.436,738.413111,553.809833,112.105716,8,0
0,0,28,28,21,31,52,177,90,267,0.000333,0.507339,20,30440.3481,1691.13045,1522.017405,245.818752,26,0
0,0,3,3,10,8,18,16,13,29,0.000333,0.040309,5,604.639125,33.591063,120.927825,57.219281,3,0
0,0,7,7,11,19,30,44,28,72,0.000333,0.117765,5,1766.480614,98.137812,353.296123,118.764371,2,0
0,0,17,17,16,23,39,110,55,165,0.000333,0.290697,16,13953.46186,775.192325,872.091366,168.041925,7,0
0,0,3,3,10,6,16,19,10,29,0.000333,0.038667,5,580,32.222222,116,48.729056,1,0
0,0,3,3,5,5,10,12,7,19,0.000333,0.021039,2,126.233268,7.012959,63.116634,23.219281,1,0
0,0,10,10,11,21,32,47,36,83,0.000333,0.138333,5,2075,115.277778,415,130.292414,1,0
0,0,8,8,15,15,30,47,35,82,0.000333,0.134122,14,5633.110404,312.950578,402.365029,117.206718,4,0
0,0,4,4,11,10,21,26,17,43,0.000333,0.062957,5,944.348246,52.463791,188.869649,71.273029,2,0
0,0,7,7,11,19,30,44,28,72,0.000333,0.117765,5,1766.480614,98.137812,353.296123,118.764371,2,0
0,0,7,7,11,18,29,48,28,76,0.000333,0.123069,5,1846.032778,102.557377,369.206556,113.112398,1,0
0,0,7,7,11,13,24,33,19,52,0.000333,0.079473,5,1192.09025,66.227236,238.41805,86.159464,3,0
0,0,20,20,19,27,46,157,73,230,0.000333,0.423473,18,22867.5465,1270.41925,1270.41925,209.092585,10,0
0,0,14,14,11,35,46,79,67,146,0.000333,0.268813,5,4032.200228,224.011124,806.440046,217.578653,6,0
0,0,37,37,21,48,69,188,117,305,0.000333,0.621033,20,37261.99919,2070.111066,1863.099959,360.316866,16,0
0,0,26,26,17,36,53,140,74,214,0.000333,0.408592,16,19612.39964,1089.577758,1225.774977,255.604168,10,0
0,0,3,3,10,8,18,16,13,29,0.000333,0.040309,5,604.639125,33.591063,120.927825,57.219281,3,0
0,0,6,6,9,12,21,28,21,49,0.000333,0.071741,4,860.894215,47.827456,215.223554,71.548875,3,0
0,0,5,5,9,9,18,34,14,48,0.000333,0.066719,4,800.6256,44.4792,200.1564,57.05865,3,0
0,0,4,4,4,7,11,13,11,24,0.000333,0.027675,2,166.052718,9.225151,83.026359,27.651484,3,0
0,0,6,6,13,13,26,38,23,61,0.000333,0.095576,6,1720.360937,95.575608,286.726823,96.211433,4,0
0,0,3,3,9,9,18,18,13,31,0.000333,0.043089,4,517.0707,28.72615,129.267675,57.05865,2,0
0,0,7,7,11,19,30,44,28,72,0.000333,0.117765,5,1766.480614,98.137812,353.296123,118.764371,2,0
0,0,6,6,11,12,23,30,17,47,0.000333,0.070869,5,1063.03706,59.057614,212.607412,81.073298,3,0
0,0,3,3,10,8,18,16,13,29,0.000333,0.040309,5,604.639125,33.591063,120.927825,57.219281,3,0
0,0,3,3,10,8,18,16,13,29,0.000333,0.040309,5,604.639125,33.591063,120.927825,57.219281,3,0
0,0,3,3,10,10,20,17,13,30,0.000333,0.043219,5,648.289214,36.016067,129.657843,66.438562,2,0
0,0,3,3,10,8,18,16,13,29,0.000333,0.040309,5,604.639125,33.591063,120.927825,57.219281,3,0
0,0,30,30,17,44,61,154,87,241,0.000333,0.476436,8,11434.46159,635.247866,1429.307698,309.70186,13,0
0,0,9,9,13,21,34,54,46,100,0.000333,0.169582,12,6104.95541,339.164189,508.746284,140.344382,4,0
0,0,6,6,15,15,30,35,24,59,0.000333,0.096502,7,2026.545816,112.585879,289.506545,117.206718,4,0
0,0,17,17,16,23,39,110,55,165,0.000333,0.290697,16,13953.46186,775.192325,872.091366,168.041925,7,0
0,0,7,7,11,19,30,44,28,72,0.000333,0.117765,5,1766.480614,98.137812,353.296123,118.764371,2,0
0,0,3,3,10,8,18,16,13,29,0.000333,0.040309,5,604.639125,33.591063,120.927825,57.219281,3,0
0,0,3,3,10,8,18,16,13,29,0.000333,0.040309,5,604.639125,33.591063,120.927825,57.219281,3,0
0,0,3,3,10,8,18,16,13,29,0.000333,0.040309,5,604.639125,33.591063,120.927825,57.219281,3,0
0,0,3,3,10,10,20,17,13,30,0.000333,0.043219,5,648.289214,36.016067,129.657843,66.438562,2,0
0,0,13,13,16,36,52,233,88,321,0.000333,0.609947,16,29277.45839,1626.525466,1829.84115,250.1173,14,0
0,0,4,4,6,8,14,17,12,29,0.000333,0.036804,3,331.239878,18.402215,110.413293,39.509775,3,0
0,0,3,3,10,8,18,16,13,29,0.000333,0.040309,5,604.639125,33.591063,120.927825,57.219281,3,0
0,0,4,4,4,7,11,13,11,24,0.000333,0.027675,2,166.052718,9.225151,83.026359,27.651484,3,0
0,0,3,3,10,8,18,16,13,29,0.000333,0.040309,5,604.639125,33.591063,120.927825,57.219281,3,0
0,0,6,6,11,15,26,30,22,52,0.000333,0.081474,5,1222.114327,67.89524,244.422865,96.657107,1,0
0,0,4,4,9,13,22,21,17,38,0.000333,0.056486,4,677.833606,37.657423,169.458402,76.635041,3,0
0,0,8,8,16,13,29,53,32,85,0.000333,0.137643,16,6606.854153,367.047453,412.928385,112.105716,6,0
0,0,25,25,13,41,54,176,101,277,0.000333,0.531368,12,19129.24606,1062.735892,1594.103838,267.765349,1,0
0,0,4,4,4,7,11,13,11,24,0.000333,0.027675,2,166.052718,9.225151,83.026359,27.651484,3,0
0,0,4,4,8,11,19,17,15,32,0.000333,0.045311,4,543.734722,30.207485,135.93368,62.053748,3,0
0,0,4,4,11,9,20,24,12,36,0.000333,0.051863,5,777.947057,43.219281,155.589411,66.583073,5,0
0,0,6,6,15,15,30,35,24,59,0.000333,0.096502,7,2026.545816,112.585879,289.506545,117.206718,4,0
0,0,13,13,12,19,31,55,42,97,0.000333,0.160186,12,5766.684505,320.371361,480.557042,123.730173,1,0
0,0,5,5,14,13,27,31,20,51,0.000333,0.080833,7,1697.494838,94.305269,242.499263,101.408685,2,0
0,0,8,8,9,17,26,35,26,61,0.000333,0.095576,4,1146.907291,63.717072,286.726823,98.016193,3,0
0,0,4,4,4,7,11,13,11,24,0.000333,0.027675,2,166.052718,9.225151,83.026359,27.651484,3,0
0,0,3,3,10,8,18,16,13,29,0.000333,0.040309,5,604.639125,33.591063,120.927825,57.219281,3,0
0,0,8,8,16,13,29,53,32,85,0.000333,0.137643,16,6606.854153,367.047453,412.928385,112.105716,6,0
0,0,7,7,11,19,30,44,28,72,0.000333,0.117765,5,1766.480614,98.137812,353.296123,118.764371,2,0
0,0,7,7,11,19,30,44,28,72,0.000333,0.117765,5,1766.480614,98.137812,353.296123,118.764371,2,0
0,0,7,7,11,19,30,44,28,72,0.000333,0.117765,5,1766.480614,98.137812,353.296123,118.764371,2,0
0,0,3,3,11,11,22,26,15,41,0.000333,0.060946,5,914.183482,50.787971,182.836696,76.107496,3,0
0,0,6,6,13,13,26,38,23,61,0.000333,0.095576,6,1720.360937,95.575608,286.726823,96.211433,4,0
0,0,4,4,4,7,11,13,11,24,0.000333,0.027675,2,166.052718,9.225151,83.026359,27.651484,3,0
0,0,9,9,11,19,30,44,37,81,0.000333,0.132486,5,1987.290691,110.405038,397.458138,118.764371,4,0
0,0,3,3,10,8,18,16,13,29,0.000333,0.040309,5,604.639125,33.591063,120.927825,57.219281,3,0
0,0,7,7,11,19,30,44,28,72,0.000333,0.117765,5,1766.480614,98.137812,353.296123,118.764371,2,0
0,0,4,4,8,11,19,17,15,32,0.000333,0.045311,4,543.734722,30.207485,135.93368,62.053748,3,0
0,0,3,3,10,8,18,16,13,29,0.000333,0.040309,5,604.639125,33.591063,120.927825,57.219281,3,0
0,0,3,3,10,8,18,16,13,29,0.000333,0.040309,5,604.639125,33.591063,120.927825,57.219281,3,0
0,0,3,3,10,8,18,16,13,29,0.000333,0.040309,5,604.639125,33.591063,120.927825,57.219281,3,0
0,0,7,7,11,19,30,44,28,72,0.000333,0.117765,5,1766.480614,98.137812,353.296123,118.764371,2,0
0,0,3,3,10,8,18,16,13,29,0.000333,0.040309,5,604.639125,33.591063,120.927825,57.219281,3,0
0,0,7,7,10,16,26,37,37,74,0.000333,0.115944,10,3478.325391,193.2403,347.832539,97.219281,1,0
0,0,7,7,11,19,30,44,28,72,0.000333,0.117765,5,1766.480614,98.137812,353.296123,118.764371,2,0
0,0,3,3,10,8,18,16,13,29,0.000333,0.040309,5,604.639125,33.591063,120.927825,57.219281,3,0
0,0,7,7,14,15,29,42,31,73,0.000333,0.118211,14,4964.856577,275.825365,354.632613,111.906328,4,0
0,0,4,4,11,10,21,26,17,43,0.000333,0.062957,5,944.348246,52.463791,188.869649,71.273029,2,0
0,0,4,4,11,9,20,24,12,36,0.000333,0.051863,5,777.947057,43.219281,155.589411,66.583073,5,0
0,0,8,8,16,13,29,53,32,85,0.000333,0.137643,16,6606.854153,367.047453,412.928385,112.105716,6,0
0,0,3,3,11,11,22,26,15,41,0.000333,0.060946,5,914.183482,50.787971,182.836696,76.107496,3,0
0,0,4,4,4,7,11,17,13,30,0.000333,0.034594,2,207.565897,11.531439,103.782949,27.651484,1,0
0,0,7,7,11,19,30,44,28,72,0.000333,0.117765,5,1766.480614,98.137812,353.296123,118.764371,2,0
0,0,7,7,11,19,30,44,28,72,0.000333,0.117765,5,1766.480614,98.137812,353.296123,118.764371,2,0
0,0,5,5,9,9,18,34,14,48,0.000333,0.066719,4,800.6256,44.4792,200.1564,57.05865,3,0
0,0,7,7,12,17,29,43,27,70,0.000333,0.113353,6,2040.352018,113.35289,340.05867,112.506418,4,0
0,0,4,4,6,8,14,17,12,29,0.000333,0.036804,3,331.239878,18.402215,110.413293,39.509775,3,0
0,0,3,3,10,8,18,16,13,29,0.000333,0.040309,5,604.639125,33.591063,120.927825,57.219281,3,0
0,0,4,4,12,12,24,42,17,59,0.000333,0.090171,6,1623.076725,90.170929,270.512788,86.0391,5,0
0,0,7,7,11,19,30,44,28,72,0.000333,0.117765,5,1766.480614,98.137812,353.296123,118.764371,2,0
0,0,3,3,11,11,22,26,15,41,0.000333,0.060946,5,914.183482,50.787971,182.836696,76.107496,3,0
0,0,7,7,12,17,29,43,27,70,0.000333,0.113353,6,2040.352018,113.35289,340.05867,112.506418,4,0
0,0,3,3,10,8,18,16,13,29,0.000333,0.040309,5,604.639125,33.591063,120.927825,57.219281,3,0
0,0,3,3,10,6,16,19,10,29,0.000333,0.038667,5,580,32.222222,116,48.729056,1,0
0,0,3,3,10,8,18,16,13,29,0.000333,0.040309,5,604.639125,33.591063,120.927825,57.219281,3,0
0,0,3,3,11,11,22,26,15,41,0.000333,0.060946,5,914.183482,50.787971,182.836696,76.107496,3,0
0,0,6,6,8,10,18,26,18,44,0.000333,0.061159,4,733.9068,40.7726,183.4767,57.219281,1,0
0,0,7,7,11,19,30,44,28,72,0.000333,0.117765,5,1766.480614,98.137812,353.296123,118.764371,2,0
0,0,6,6,13,13,26,38,23,61,0.000333,0.095576,6,1720.360937,95.575608,286.726823,96.211433,4,0
0,0,3,3,10,8,18,16,13,29,0.000333,0.040309,5,604.639125,33.591063,120.927825,57.219281,3,0
0,0,3,3,10,9,19,37,16,53,0.000333,0.075047,5,1125.700791,62.538933,225.140158,61.748606,10,0
0,0,4,4,10,9,19,46,19,65,0.000333,0.092038,10,2761.152884,153.397382,276.115288,61.748606,11,0
0,0,7,7,11,19,30,44,28,72,0.000333,0.117765,5,1766.480614,98.137812,353.296123,118.764371,2,0
0,0,3,3,10,8,18,16,13,29,0.000333,0.040309,5,604.639125,33.591063,120.927825,57.219281,3,0
0,0,4,4,11,10,21,26,17,43,0.000333,0.062957,5,944.348246,52.463791,188.869649,71.273029,2,0
0,0,27,27,15,35,50,154,90,244,0.000333,0.459034,14,19279.41274,1071.078486,1377.10091,238.128265,4,0
0,0,7,7,11,19,30,44,28,72,0.000333,0.117765,5,1766.480614,98.137812,353.296123,118.764371,2,0
0,0,3,3,9,9,18,18,13,31,0.000333,0.043089,4,517.0707,28.72615,129.267675,57.05865,2,0
0,0,15,15,12,20,32,85,48,133,0.000333,0.221667,12,7980,443.333333,665,129.458112,2,0
0,0,3,3,10,8,18,16,13,29,0.000333,0.040309,5,604.639125,33.591063,120.927825,57.219281,3,0
0,0,3,3,10,10,20,17,13,30,0.000333,0.043219,5,648.289214,36.016067,129.657843,66.438562,2,0
0,0,4,4,14,9,23,32,12,44,0.000333,0.066346,7,1393.257082,77.403171,199.036726,81.832294,3,0
0,0,4,4,10,12,22,21,17,38,0.000333,0.056486,5,847.292008,47.071778,169.458402,76.238831,1,0
0,0,4,4,4,7,11,13,11,24,0.000333,0.027675,2,166.052718,9.225151,83.026359,27.651484,3,0
0,0,14,14,11,35,46,79,67,146,0.000333,0.268813,5,4032.200228,224.011124,806.440046,217.578653,6,0
0,0,3,3,10,8,18,16,13,29,0.000333,0.040309,5,604.639125,33.591063,120.927825,57.219281,3,0
0,0,5,5,11,12,23,33,21,54,0.000333,0.081424,5,1221.361728,67.853429,244.272346,81.073298,1,0
0,0,6,6,13,13,26,38,23,61,0.000333,0.095576,6,1720.360937,95.575608,286.726823,96.211433,4,0
0,0,25,25,12,35,47,382,213,595,0.000333,1.10166,36,118979.2932,6609.960733,3304.980367,222.544456,4,0
0,0,19,19,12,26,38,116,56,172,0.000333,0.300881,12,10831.72239,601.762355,902.643532,165.230983,7,0
0,0,3,3,11,11,22,26,15,41,0.000333,0.060946,5,914.183482,50.787971,182.836696,76.107496,3,0
0,0,7,7,11,19,30,44,28,72,0.000333,0.117765,5,1766.480614,98.137812,353.296123,118.764371,2,0
0,0,3,3,10,8,18,16,13,29,0.000333,0.040309,5,604.639125,33.591063,120.927825,57.219281,3,0
0,0,4,4,7,11,18,20,16,36,0.000333,0.050039,3,450.3519,25.01955,150.1173,57.705232,2,0
0,0,5,5,11,13,24,27,22,49,0.000333,0.074888,5,1123.315813,62.406434,224.663163,86.159464,2,0
0,0,7,7,11,19,30,44,28,72,0.000333,0.117765,5,1766.480614,98.137812,353.296123,118.764371,2,0
0,0,4,4,4,7,11,13,11,24,0.000333,0.027675,2,166.052718,9.225151,83.026359,27.651484,3,0
0,0,4,4,8,10,18,28,18,46,0.000333,0.063939,4,767.2662,42.6259,191.81655,57.219281,4,0
0,0,9,9,14,25,39,156,54,210,0.000333,0.369978,14,15539.08252,863.282362,1109.934466,169.399374,5,0
0,0,3,3,9,9,18,18,13,31,0.000333,0.043089,4,517.0707,28.72615,129.267675,57.05865,2,0
0,0,3,3,9,9,18,18,13,31,0.000333,0.043089,4,517.0707,28.72615,129.267675,57.05865,2,0
0,0,7,7,10,14,24,34,26,60,0.000333,0.091699,5,1375.48875,76.416042,275.09775,86.52225,2,0
0,0,3,3,10,8,18,20,12,32,0.000333,0.044479,5,667.188,37.066,133.4376,57.219281,2,0
0,0,3,3,10,8,18,16,13,29,0.000333,0.040309,5,604.639125,33.591063,120.927825,57.219281,3,0
0,0,4,4,7,13,20,20,20,40,0.000333,0.057626,3,518.631371,28.812854,172.877124,67.757201,2,0
0,0,4,4,7,13,20,20,20,40,0.000333,0.057626,3,518.631371,28.812854,172.877124,67.757201,2,0
0,0,7,7,11,19,30,44,28,72,0.000333,0.117765,5,1766.480614,98.137812,353.296123,118.764371,2,0
0,0,7,7,11,19,30,44,28,72,0.000333,0.117765,5,1766.480614,98.137812,353.296123,118.764371,2,0
0,0,4,4,6,10,16,26,15,41,0.000333,0.054667,3,492,27.333333,164,48.729056,2,0
0,0,4,4,7,9,16,16,12,28,0.000333,0.037333,3,336,18.666667,112,48.180809,3,0
0,0,4,4,7,12,19,20,18,38,0.000333,0.053807,3,484.263737,26.903541,161.421246,62.671034,2,0
0,0,3,3,9,9,18,18,13,31,0.000333,0.043089,4,517.0707,28.72615,129.267675,57.05865,2,0
0,0,7,7,11,19,30,44,28,72,0.000333,0.117765,5,1766.480614,98.137812,353.296123,118.764371,2,0
0,0,7,7,11,19,30,44,28,72,0.000333,0.117765,5,1766.480614,98.137812,353.296123,118.764371,2,0
0,0,7,7,11,19,30,44,28,72,0.000333,0.117765,5,1766.480614,98.137812,353.296123,118.764371,2,0
0,0,4,4,11,10,21,26,17,43,0.000333,0.062957,5,944.348246,52.463791,188.869649,71.273029,2,0
0,0,17,17,16,23,39,110,55,165,0.000333,0.290697,16,13953.46186,775.192325,872.091366,168.041925,7,0
0,0,36,36,16,62,78,272,185,457,0.000333,0.957476,16,45958.86102,2553.270057,2872.428814,433.160171,4,0
0,0,4,4,7,11,18,20,16,36,0.000333,0.050039,3,450.3519,25.01955,150.1173,57.705232,2,0
0,0,6,6,7,11,18,41,25,66,0.000333,0.091738,6,1651.290301,91.73835,275.21505,57.705232,1,0
0,0,7,7,11,18,29,48,28,76,0.000333,0.123069,5,1846.032778,102.557377,369.206556,113.112398,1,0
0,0,18,18,16,30,46,157,56,213,0.000333,0.392173,8,9412.149573,522.897199,1176.518697,211.206718,5,0
0,0,27,27,17,37,54,142,78,220,0.000333,0.422025,16,20257.20401,1125.400223,1266.07525,262.236643,10,0
0,0,12,12,18,22,40,65,53,118,0.000333,0.209329,18,11303.77527,627.987515,627.987515,173.166146,6,0
0,0,3,3,8,13,21,32,17,49,0.000333,0.071741,4,860.894215,47.827456,215.223554,72.105716,1,0
0,0,6,6,11,13,24,35,18,53,0.000333,0.081001,5,1215.015063,67.500837,243.003013,86.159464,3,0
0,0,7,7,11,18,29,48,28,76,0.000333,0.123069,5,1846.032778,102.557377,369.206556,113.112398,1,0
0,0,14,14,13,23,36,86,44,130,0.000333,0.22403,6,4032.541501,224.030083,672.09025,152.147641,5,0
0,0,4,4,4,7,11,13,11,24,0.000333,0.027675,2,166.052718,9.225151,83.026359,27.651484,3,0
0,0,7,7,11,19,30,44,28,72,0.000333,0.117765,5,1766.480614,98.137812,353.296123,118.764371,2,0
0,0,6,6,9,18,27,24,23,47,0.000333,0.074493,4,893.91885,49.662158,223.479713,103.587975,3,0
0,0,4,4,11,10,21,26,17,43,0.000333,0.062957,5,944.348246,52.463791,188.869649,71.273029,2,0
0,0,3,3,7,9,16,16,12,28,0.000333,0.037333,3,336,18.666667,112,48.180809,2,0
0,0,3,3,7,9,16,10,15,25,0.000333,0.033333,3,300,16.666667,100,48.180809,1,0
0,0,3,3,10,8,18,16,13,29,0.000333,0.040309,5,604.639125,33.591063,120.927825,57.219281,3,0
0,0,3,3,11,11,22,26,15,41,0.000333,0.060946,5,914.183482,50.787971,182.836696,76.107496,3,0
0,0,4,4,4,7,11,13,11,24,0.000333,0.027675,2,166.052718,9.225151,83.026359,27.651484,3,0
0,0,3,3,10,8,18,16,13,29,0.000333,0.040309,5,604.639125,33.591063,120.927825,57.219281,3,0
0,0,3,3,11,11,22,26,15,41,0.000333,0.060946,5,914.183482,50.787971,182.836696,76.107496,3,0
0,0,6,6,9,18,27,24,23,47,0.000333,0.074493,4,893.91885,49.662158,223.479713,103.587975,3,0
0,0,4,4,6,8,14,17,12,29,0.000333,0.036804,3,331.239878,18.402215,110.413293,39.509775,3,0
0,0,3,3,10,8,18,16,13,29,0.000333,0.040309,5,604.639125,33.591063,120.927825,57.219281,3,0
0,0,3,3,10,8,18,16,13,29,0.000333,0.040309,5,604.639125,33.591063,120.927825,57.219281,3,0
0,0,4,4,8,11,19,17,15,32,0.000333,0.045311,4,543.734722,30.207485,135.93368,62.053748,3,0
0,0,3,3,10,8,18,16,13,29,0.000333,0.040309,5,604.639125,33.591063,120.927825,57.219281,3,0
0,0,8,8,9,17,26,35,26,61,0.000333,0.095576,4,1146.907291,63.717072,286.726823,98.016193,3,0
0,0,4,4,6,8,14,17,12,29,0.000333,0.036804,3,331.239878,18.402215,110.413293,39.509775,3,0
0,0,4,4,6,8,14,17,12,29,0.000333,0.036804,3,331.239878,18.402215,110.413293,39.509775,3,0
0,0,5,5,10,9,19,26,14,40,0.000333,0.056639,5,849.585503,47.199195,169.917101,61.748606,2,0
0,0,3,3,10,6,16,19,10,29,0.000333,0.038667,5,580,32.222222,116,48.729056,1,0
0,0,3,3,9,9,18,18,13,31,0.000333,0.043089,4,517.0707,28.72615,129.267675,57.05865,2,0
0,0,3,3,10,11,21,22,15,37,0.000333,0.054172,5,812.578723,45.143262,162.515745,71.273029,4,0
0,0,7,7,11,19,30,44,28,72,0.000333,0.117765,5,1766.480614,98.137812,353.296123,118.764371,2,0
0,0,4,4,4,7,11,13,11,24,0.000333,0.027675,2,166.052718,9.225151,83.026359,27.651484,3,0
0,0,7,7,11,19,30,44,28,72,0.000333,0.117765,5,1766.480614,98.137812,353.296123,118.764371,2,0
0,0,4,4,4,7,11,13,11,24,0.000333,0.027675,2,166.052718,9.225151,83.026359,27.651484,3,0
0,0,7,7,11,19,30,44,28,72,0.000333,0.117765,5,1766.480614,98.137812,353.296123,118.764371,2,0
0,0,4,4,7,14,21,20,22,42,0.000333,0.061492,3,553.431995,30.746222,184.477332,72.954453,2,0
0,0,3,3,9,9,18,18,13,31,0.000333,0.043089,4,517.0707,28.72615,129.267675,57.05865,2,0
0,0,7,7,11,19,30,44,28,72,0.000333,0.117765,5,1766.480614,98.137812,353.296123,118.764371,2,0
0,0,3,3,10,8,18,16,13,29,0.000333,0.040309,5,604.639125,33.591063,120.927825,57.219281,3,0
0,0,7,7,11,21,32,46,32,78,0.000333,0.13,5,1950,108.333333,390,130.292414,1,0
0,0,26,26,17,37,54,139,75,214,0.000333,0.410515,16,19704.73481,1094.707489,1231.545925,262.236643,10,0
0,0,4,4,8,11,19,17,15,32,0.000333,0.045311,4,543.734722,30.207485,135.93368,62.053748,3,0
0,0,3,3,9,9,18,18,13,31,0.000333,0.043089,4,517.0707,28.72615,129.267675,57.05865,2,0
0,0,7,7,12,17,29,37,30,67,0.000333,0.108495,6,1952.90836,108.494909,325.484727,112.506418,4,0
0,0,7,7,11,19,30,44,28,72,0.000333,0.117765,5,1766.480614,98.137812,353.296123,118.764371,2,0
0,0,10,10,16,24,40,84,58,142,0.000333,0.251905,16,12091.42063,671.745591,755.713789,174.0391,2,0
0,0,27,27,17,36,53,141,77,218,0.000333,0.416229,16,19978.98655,1109.943697,1248.686659,255.604168,10,0
0,0,6,6,9,18,27,24,23,47,0.000333,0.074493,4,893.91885,49.662158,223.479713,103.587975,3,0
0,0,3,3,10,8,18,16,13,29,0.000333,0.040309,5,604.639125,33.591063,120.927825,57.219281,3,0
0,0,3,3,10,8,18,16,13,29,0.000333,0.040309,5,604.639125,33.591063,120.927825,57.219281,3,0
0,0,4,4,6,8,14,17,12,29,0.000333,0.036804,3,331.239878,18.402215,110.413293,39.509775,3,0
0,0,7,7,11,19,30,44,28,72,0.000333,0.117765,5,1766.480614,98.137812,353.296123,118.764371,2,0
0,0,7,7,11,18,29,48,28,76,0.000333,0.123069,5,1846.032778,102.557377,369.206556,113.112398,1,0
0,0,5,5,9,11,20,26,17,43,0.000333,0.061948,4,743.371632,41.298424,185.842908,66.583073,3,0
0,0,4,4,10,9,19,46,19,65,0.000333,0.092038,10,2761.152884,153.397382,276.115288,61.748606,11,0
0,0,3,3,10,9,19,37,16,53,0.000333,0.075047,5,1125.700791,62.538933,225.140158,61.748606,10,0
0,0,3,3,10,8,18,16,13,29,0.000333,0.040309,5,604.639125,33.591063,120.927825,57.219281,3,0
0,0,3,3,10,6,16,19,10,29,0.000333,0.038667,5,580,32.222222,116,48.729056,1,0
0,0,6,6,7,11,18,41,25,66,0.000333,0.091738,6,1651.290301,91.73835,275.21505,57.705232,1,0
0,0,3,3,9,9,18,18,13,31,0.000333,0.043089,4,517.0707,28.72615,129.267675,57.05865,2,0
0,0,5,5,9,11,20,26,18,44,0.000333,0.063388,4,760.659345,42.258852,190.164836,66.583073,2,0
0,0,4,4,11,9,20,24,12,36,0.000333,0.051863,5,777.947057,43.219281,155.589411,66.583073,5,0
0,0,4,4,9,9,18,27,15,42,0.000333,0.058379,4,700.5474,38.9193,175.13685,57.05865,5,0
0,0,3,3,8,10,18,20,13,33,0.000333,0.045869,4,550.4301,30.57945,137.607525,57.219281,3,0
0,0,3,3,9,9,18,18,13,31,0.000333,0.043089,4,517.0707,28.72615,129.267675,57.05865,2,0
0,0,7,7,11,19,30,44,28,72,0.000333,0.117765,5,1766.480614,98.137812,353.296123,118.764371,2,0
0,0,39,39,21,55,76,221,139,360,0.000333,0.749751,20,44985.0781,2499.171005,2249.253905,410.21345,11,0
0,0,10,10,7,14,21,57,36,93,0.000333,0.136162,6,2450.913122,136.16184,408.48552,72.954453,1,0
0,0,19,19,21,26,47,149,82,231,0.000333,0.427703,30,38493.30074,2138.516708,1283.110025,214.450099,11,0
0,0,11,11,15,21,36,84,43,127,0.000333,0.21886,14,9192.126653,510.673703,656.580475,150.842025,2,0
0,0,9,9,15,19,34,68,35,103,0.000333,0.17467,7,3668.060709,203.78115,524.008673,139.313982,2,0
0,0,3,3,11,11,22,26,15,41,0.000333,0.060946,5,914.183482,50.787971,182.836696,76.107496,3,0
0,0,4,4,4,7,11,13,11,24,0.000333,0.027675,2,166.052718,9.225151,83.026359,27.651484,3,0
0,0,6,6,8,10,18,26,18,44,0.000333,0.061159,4,733.9068,40.7726,183.4767,57.219281,1,0
0,0,3,3,10,8,18,16,13,29,0.000333,0.040309,5,604.639125,33.591063,120.927825,57.219281,3,0
0,0,3,3,10,8,18,16,13,29,0.000333,0.040309,5,604.639125,33.591063,120.927825,57.219281,3,0
0,0,7,7,11,19,30,44,28,72,0.000333,0.117765,5,1766.480614,98.137812,353.296123,118.764371,2,0
0,0,5,5,9,15,24,23,25,48,0.000333,0.073359,4,880.3128,48.906267,220.0782,87.132684,1,0
0,0,4,4,4,7,11,13,11,24,0.000333,0.027675,2,166.052718,9.225151,83.026359,27.651484,3,0
0,0,3,3,10,6,16,19,10,29,0.000333,0.038667,5,580,32.222222,116,48.729056,1,0
0,0,4,4,11,10,21,26,17,43,0.000333,0.062957,5,944.348246,52.463791,188.869649,71.273029,2,0
0,0,3,3,11,11,22,26,15,41,0.000333,0.060946,5,914.183482,50.787971,182.836696,76.107496,3,0
0,0,3,3,5,6,11,9,8,17,0.000333,0.019603,2,117.620675,6.534482,58.810338,27.119415,1,0
0,0,3,3,10,8,18,16,13,29,0.000333,0.040309,5,604.639125,33.591063,120.927825,57.219281,3,0
0,0,5,5,11,15,26,28,27,55,0.000333,0.086175,5,1292.620922,71.812273,258.524184,96.657107,2,0
0,0,3,3,10,8,18,16,13,29,0.000333,0.040309,5,604.639125,33.591063,120.927825,57.219281,3,0
0,0,5,5,13,10,23,35,21,56,0.000333,0.08444,12,3039.833634,168.879646,253.31947,81.324997,4,0
0,0,4,4,11,10,21,26,17,43,0.000333,0.062957,5,944.348246,52.463791,188.869649,71.273029,2,0
0,0,12,12,10,17,27,48,39,87,0.000333,0.137892,10,4136.752127,229.819563,413.675213,102.706149,1,0
0,0,6,6,8,10,18,26,18,44,0.000333,0.061159,4,733.9068,40.7726,183.4767,57.219281,1,0
0,0,3,3,10,8,18,16,13,29,0.000333,0.040309,5,604.639125,33.591063,120.927825,57.219281,3,0
0,0,3,3,10,8,18,16,13,29,0.000333,0.040309,5,604.639125,33.591063,120.927825,57.219281,3,0
0,0,3,3,10,8,18,16,13,29,0.000333,0.040309,5,604.639125,33.591063,120.927825,57.219281,3,0
0,0,17,17,16,23,39,110,55,165,0.000333,0.290697,16,13953.46186,775.192325,872.091366,168.041925,7,0
0,0,23,23,20,29,49,181,80,261,0.000333,0.48848,20,29308.78539,1628.265855,1465.439269,227.320011,12,0
0,0,7,7,12,17,29,43,27,70,0.000333,0.113353,6,2040.352018,113.35289,340.05867,112.506418,4,0
0,0,3,3,10,8,18,16,13,29,0.000333,0.040309,5,604.639125,33.591063,120.927825,57.219281,3,0
0,0,3,3,10,8,18,16,13,29,0.000333,0.040309,5,604.639125,33.591063,120.927825,57.219281,3,0
0,0,5,5,10,10,20,27,14,41,0.000333,0.059066,5,885.995259,49.221959,177.199052,66.438562,3,0
0,0,17,17,16,23,39,110,55,165,0.000333,0.290697,16,13953.46186,775.192325,872.091366,168.041925,7,0
0,0,17,17,16,23,39,110,55,165,0.000333,0.290697,16,13953.46186,775.192325,872.091366,168.041925,7,0
0,0,3,3,10,8,18,16,13,29,0.000333,0.040309,5,604.639125,33.591063,120.927825,57.219281,3,0
0,0,8,8,12,13,25,41,24,65,0.000333,0.100617,6,1811.103914,100.616884,301.850652,91.125266,4,0
0,0,17,17,21,26,47,131,75,206,0.000333,0.381415,20,22884.90607,1271.38367,1144.245303,214.450099,9,0
0,0,7,7,11,19,30,44,28,72,0.000333,0.117765,5,1766.480614,98.137812,353.296123,118.764371,2,0
0,0,3,3,10,8,18,16,13,29,0.000333,0.040309,5,604.639125,33.591063,120.927825,57.219281,3,0
0,0,3,3,10,8,18,16,13,29,0.000333,0.040309,5,604.639125,33.591063,120.927825,57.219281,3,0
0,0,7,7,11,19,30,44,28,72,0.000333,0.117765,5,1766.480614,98.137812,353.296123,118.764371,2,0
0,0,3,3,11,10,21,25,13,38,0.000333,0.055636,5,834.54031,46.363351,166.908062,71.273029,4,0
0,0,8,8,15,18,33,66,34,100,0.000333,0.168146,7,3531.075884,196.170882,504.439412,133.662009,2,0
0,0,3,3,10,8,18,16,13,29,0.000333,0.040309,5,604.639125,33.591063,120.927825,57.219281,3,0
0,0,6,6,10,15,25,28,22,50,0.000333,0.077398,5,1160.964047,64.498003,232.192809,91.82264,1,0
0,0,7,7,11,19,30,44,28,72,0.000333,0.117765,5,1766.480614,98.137812,353.296123,118.764371,2,0
0,0,4,4,4,7,11,13,11,24,0.000333,0.027675,2,166.052718,9.225151,83.026359,27.651484,3,0
0,0,14,14,11,35,46,79,67,146,0.000333,0.268813,5,4032.200228,224.011124,806.440046,217.578653,6,0
0,0,3,3,10,8,18,16,13,29,0.000333,0.040309,5,604.639125,33.591063,120.927825,57.219281,3,0
0,0,4,4,6,8,14,17,12,29,0.000333,0.036804,3,331.239878,18.402215,110.413293,39.509775,3,0
0,0,4,4,8,5,13,14,6,20,0.000333,0.02467,4,296.035177,16.446399,74.008794,35.60964,2,0
0,0,3,3,10,8,18,16,13,29,0.000333,0.040309,5,604.639125,33.591063,120.927825,57.219281,3,0
0,0,5,5,11,12,23,33,21,54,0.000333,0.081424,5,1221.361728,67.853429,244.272346,81.073298,1,0
0,0,4,4,11,9,20,35,15,50,0.000333,0.072032,5,1080.482024,60.026779,216.096405,66.583073,2,0
0,0,4,4,9,13,22,21,17,38,0.000333,0.056486,4,677.833606,37.657423,169.458402,76.635041,3,0
0,0,3,3,9,9,18,18,13,31,0.000333,0.043089,4,517.0707,28.72615,129.267675,57.05865,2,0
0,0,6,6,15,15,30,35,24,59,0.000333,0.096502,7,2026.545816,112.585879,289.506545,117.206718,4,0
0,0,3,3,10,8,18,16,13,29,0.000333,0.040309,5,604.639125,33.591063,120.927825,57.219281,3,0
0,0,3,3,8,10,18,17,13,30,0.000333,0.041699,4,500.391,27.7995,125.09775,57.219281,2,0
0,0,7,7,11,19,30,44,28,72,0.000333,0.117765,5,1766.480614,98.137812,353.296123,118.764371,2,0
0,0,3,3,10,8,18,16,13,29,0.000333,0.040309,5,604.639125,33.591063,120.927825,57.219281,3,0
0,0,17,17,16,23,39,110,55,165,0.000333,0.290697,16,13953.46186,775.192325,872.091366,168.041925,7,0
0,0,11,11,16,22,38,60,48,108,0.000333,0.188925,16,9068.418743,503.801041,566.776171,162.107496,4,0
0,0,9,9,14,20,34,44,36,80,0.000333,0.135666,7,2848.979191,158.276622,406.997027,139.741531,4,0
0,0,3,3,9,9,18,18,13,31,0.000333,0.043089,4,517.0707,28.72615,129.267675,57.05865,2,0
0,0,3,3,10,8,18,16,13,29,0.000333,0.040309,5,604.639125,33.591063,120.927825,57.219281,3,0
0,0,3,3,6,7,13,13,9,22,0.000333,0.027137,3,244.229021,13.568279,81.409674,35.161259,4,0
0,0,9,9,15,19,34,68,35,103,0.000333,0.17467,7,3668.060709,203.78115,524.008673,139.313982,2,0
0,0,32,32,16,43,59,252,131,383,0.000333,0.751017,24,54073.25491,3004.069717,2253.052288,297.329384,13,0
0,0,3,3,9,9,18,18,13,31,0.000333,0.043089,4,517.0707,28.72615,129.267675,57.05865,2,0
0,0,3,3,11,10,21,26,13,39,0.000333,0.0571,5,856.501897,47.583439,171.300379,71.273029,3,0
0,0,8,8,10,14,24,50,26,76,0.000333,0.116152,5,1742.28575,96.793653,348.45715,86.52225,5,0
0,0,3,3,10,8,18,16,13,29,0.000333,0.040309,5,604.639125,33.591063,120.927825,57.219281,3,0
0,0,10,10,15,27,42,169,61,230,0.000333,0.413411,14,17363.2621,964.625672,1240.233007,186.985321,7,0
0,0,3,3,10,8,18,16,13,29,0.000333,0.040309,5,604.639125,33.591063,120.927825,57.219281,3,0
0,0,3,3,10,8,18,16,13,29,0.000333,0.040309,5,604.639125,33.591063,120.927825,57.219281,3,0
0,0,7,7,11,19,30,44,28,72,0.000333,0.117765,5,1766.480614,98.137812,353.296123,118.764371,2,0
0,0,6,6,11,15,26,30,22,52,0.000333,0.081474,5,1222.114327,67.89524,244.422865,96.657107,1,0
0,0,3,3,10,8,18,16,13,29,0.000333,0.040309,5,604.639125,33.591063,120.927825,57.219281,3,0
0,0,7,7,11,18,29,48,28,76,0.000333,0.123069,5,1846.032778,102.557377,369.206556,113.112398,1,0
0,0,16,16,12,28,40,94,52,146,0.000333,0.259001,6,4662.009011,259.000501,777.001502,177.625488,6,0
0,0,3,3,10,8,18,16,13,29,0.000333,0.040309,5,604.639125,33.591063,120.927825,57.219281,3,0
0,0,5,5,11,13,24,27,22,49,0.000333,0.074888,5,1123.315813,62.406434,224.663163,86.159464,2,0
0,0,31,31,22,36,58,197,101,298,0.000333,0.581893,22,38404.9234,2133.606856,1745.678337,284.224796,21,0
0,0,16,16,14,27,41,90,50,140,0.000333,0.250019,7,5250.400965,291.688942,750.057281,181.684931,5,0
0,0,7,7,11,19,30,44,28,72,0.000333,0.117765,5,1766.480614,98.137812,353.296123,118.764371,2,0
0,0,8,8,15,18,33,66,34,100,0.000333,0.168146,7,3531.075884,196.170882,504.439412,133.662009,2,0
0,0,7,7,11,19,30,44,28,72,0.000333,0.117765,5,1766.480614,98.137812,353.296123,118.764371,2,0
0,0,3,3,10,8,18,16,13,29,0.000333,0.040309,5,604.639125,33.591063,120.927825,57.219281,3,0
0,0,3,3,10,8,18,16,13,29,0.000333,0.040309,5,604.639125,33.591063,120.927825,57.219281,3,0
0,0,40,40,21,51,72,201,128,329,0.000333,0.676635,20,40598.10651,2255.450362,2029.905325,381.532358,17,0
0,0,3,3,10,8,18,16,13,29,0.000333,0.040309,5,604.639125,33.591063,120.927825,57.219281,3,0
0,0,6,6,9,18,27,24,23,47,0.000333,0.074493,4,893.91885,49.662158,223.479713,103.587975,3,0
0,0,4,4,4,7,11,13,11,24,0.000333,0.027675,2,166.052718,9.225151,83.026359,27.651484,3,0
0,0,3,3,10,8,18,16,13,29,0.000333,0.040309,5,604.639125,33.591063,120.927825,57.219281,3,0
0,0,7,7,11,19,30,44,28,72,0.000333,0.117765,5,1766.480614,98.137812,353.296123,118.764371,2,0
0,0,4,4,14,9,23,32,12,44,0.000333,0.066346,7,1393.257082,77.403171,199.036726,81.832294,3,0
0,0,3,3,5,6,11,9,8,17,0.000333,0.019603,2,117.620675,6.534482,58.810338,27.119415,1,0
0,0,3,3,10,11,21,22,15,37,0.000333,0.054172,5,812.578723,45.143262,162.515745,71.273029,4,0
0,0,3,3,9,9,18,18,13,31,0.000333,0.043089,4,517.0707,28.72615,129.267675,57.05865,2,0
0,0,3,3,10,8,18,16,13,29,0.000333,0.040309,5,604.639125,33.591063,120.927825,57.219281,3,0
0,0,4,4,7,13,20,31,19,50,0.000333,0.072032,3,648.289214,36.016067,216.096405,67.757201,1,0
0,0,3,3,10,8,18,16,13,29,0.000333,0.040309,5,604.639125,33.591063,120.927825,57.219281,3,0
0,0,3,3,10,6,16,19,10,29,0.000333,0.038667,5,580,32.222222,116,48.729056,1,0
0,0,4,4,4,7,11,13,11,24,0.000333,0.027675,2,166.052718,9.225151,83.026359,27.651484,3,0
0,0,3,3,5,6,11,9,8,17,0.000333,0.019603,2,117.620675,6.534482,58.810338,27.119415,1,0
0,0,4,4,8,16,24,32,22,54,0.000333,0.082529,4,990.3519,55.01955,247.587975,88,2,0
0,0,3,3,10,9,19,37,16,53,0.000333,0.075047,5,1125.700791,62.538933,225.140158,61.748606,10,0
0,0,4,4,10,9,19,46,19,65,0.000333,0.092038,10,2761.152884,153.397382,276.115288,61.748606,11,0
0,0,10,10,16,16,32,56,37,93,0.000333,0.155,16,7440,413.333333,465,128,4,0
0,0,4,4,4,7,11,13,11,24,0.000333,0.027675,2,166.052718,9.225151,83.026359,27.651484,3,0
0,0,4,4,7,9,16,16,12,28,0.000333,0.037333,3,336,18.666667,112,48.180809,3,0
0,0,3,3,10,8,18,16,13,29,0.000333,0.040309,5,604.639125,33.591063,120.927825,57.219281,3,0
0,0,5,5,9,9,18,34,14,48,0.000333,0.066719,4,800.6256,44.4792,200.1564,57.05865,3,0
0,0,15,15,12,24,36,87,47,134,0.000333,0.230923,6,4156.619701,230.923317,692.76995,153.05865,5,0
0,0,3,3,8,10,18,20,13,33,0.000333,0.045869,4,550.4301,30.57945,137.607525,57.219281,3,0
0,0,3,3,10,8,18,16,13,29,0.000333,0.040309,5,604.639125,33.591063,120.927825,57.219281,3,0
0,0,3,3,9,9,18,18,13,31,0.000333,0.043089,4,517.0707,28.72615,129.267675,57.05865,2,0
0,0,14,14,18,33,51,82,52,134,0.000333,0.253368,9,6840.944962,380.052498,760.104996,241.523656,7,0
0,0,3,3,10,8,18,16,13,29,0.000333,0.040309,5,604.639125,33.591063,120.927825,57.219281,3,0
0,0,3,3,8,10,18,20,13,33,0.000333,0.045869,4,550.4301,30.57945,137.607525,57.219281,3,0
0,0,3,3,5,6,11,9,8,17,0.000333,0.019603,2,117.620675,6.534482,58.810338,27.119415,1,0
0,0,10,10,15,20,35,54,43,97,0.000333,0.165847,14,6965.566337,386.975908,497.540453,145.041921,4,0
0,0,7,7,17,14,31,46,29,75,0.000333,0.123855,16,5945.035572,330.279754,371.564723,122.789837,4,0
0,0,5,5,8,12,20,24,19,43,0.000333,0.061948,4,743.371632,41.298424,185.842908,67.01955,3,0
0,0,3,3,9,9,18,18,13,31,0.000333,0.043089,4,517.0707,28.72615,129.267675,57.05865,2,0
0,0,7,7,11,19,30,44,28,72,0.000333,0.117765,5,1766.480614,98.137812,353.296123,118.764371,2,0
0,0,3,3,10,10,20,17,13,30,0.000333,0.043219,5,648.289214,36.016067,129.657843,66.438562,2,0
0,0,7,7,11,19,30,44,28,72,0.000333,0.117765,5,1766.480614,98.137812,353.296123,118.764371,2,0
0,0,4,4,9,13,22,21,17,38,0.000333,0.056486,4,677.833606,37.657423,169.458402,76.635041,3,0
0,0,3,3,10,6,16,19,10,29,0.000333,0.038667,5,580,32.222222,116,48.729056,1,0
0,0,3,3,10,6,16,19,10,29,0.000333,0.038667,5,580,32.222222,116,48.729056,1,0
0,0,7,7,11,19,30,44,28,72,0.000333,0.117765,5,1766.480614,98.137812,353.296123,118.764371,2,0
0,0,4,4,11,10,21,26,17,43,0.000333,0.062957,5,944.348246,52.463791,188.869649,71.273029,2,0
0,0,6,6,13,13,26,38,23,61,0.000333,0.095576,6,1720.360937,95.575608,286.726823,96.211433,4,0
0,0,6,6,8,10,18,26,18,44,0.000333,0.061159,4,733.9068,40.7726,183.4767,57.219281,1,0
0,0,3,3,10,6,16,19,10,29,0.000333,0.038667,5,580,32.222222,116,48.729056,1,0
0,0,3,3,10,8,18,16,13,29,0.000333,0.040309,5,604.639125,33.591063,120.927825,57.219281,3,0
0,0,4,4,4,7,11,13,11,24,0.000333,0.027675,2,166.052718,9.225151,83.026359,27.651484,3,0
0,0,18,18,14,33,47,108,59,167,0.000333,0.309205,7,6493.314368,360.739687,927.616338,219.767975,5,0
0,0,7,7,11,18,29,48,28,76,0.000333,0.123069,5,1846.032778,102.557377,369.206556,113.112398,1,0
0,0,7,7,11,19,30,44,28,72,0.000333,0.117765,5,1766.480614,98.137812,353.296123,118.764371,2,0
0,0,3,3,9,9,18,18,13,31,0.000333,0.043089,4,517.0707,28.72615,129.267675,57.05865,2,0
0,0,7,7,11,19,30,44,28,72,0.000333,0.117765,5,1766.480614,98.137812,353.296123,118.764371,2,0
0,0,3,3,10,8,18,16,13,29,0.000333,0.040309,5,604.639125,33.591063,120.927825,57.219281,3,0
0,0,9,9,15,20,35,41,37,78,0.000333,0.133361,7,2800.588527,155.588252,400.084075,145.041921,4,0
0,0,7,7,11,19,30,44,28,72,0.000333,0.117765,5,1766.480614,98.137812,353.296123,118.764371,2,0
0,0,3,3,10,10,20,17,13,30,0.000333,0.043219,5,648.289214,36.016067,129.657843,66.438562,2,0
0,0,11,11,15,21,36,84,43,127,0.000333,0.21886,14,9192.126653,510.673703,656.580475,150.842025,2,0
0,0,8,8,15,18,33,66,34,100,0.000333,0.168146,7,3531.075884,196.170882,504.439412,133.662009,2,0
0,0,3,3,10,8,18,16,13,29,0.000333,0.040309,5,604.639125,33.591063,120.927825,57.219281,3,0
0,0,3,3,10,8,18,16,13,29,0.000333,0.040309,5,604.639125,33.591063,120.927825,57.219281,3,0
0,0,3,3,9,9,18,18,13,31,0.000333,0.043089,4,517.0707,28.72615,129.267675,57.05865,2,0
0,0,36,36,21,46,67,183,115,298,0.000333,0.602565,20,36153.89158,2008.549532,1807.694579,346.322516,16,0
0,0,5,5,10,10,20,27,14,41,0.000333,0.059066,5,885.995259,49.221959,177.199052,66.438562,3,0
0,0,7,7,11,19,30,44,28,72,0.000333,0.117765,5,1766.480614,98.137812,353.296123,118.764371,2,0
0,0,3,3,10,10,20,17,13,30,0.000333,0.043219,5,648.289214,36.016067,129.657843,66.438562,2,0
0,0,9,9,13,19,32,44,30,74,0.000333,0.123333,6,2220,123.333333,370,128.816339,6,0
0,0,3,3,10,8,18,16,13,29,0.000333,0.040309,5,604.639125,33.591063,120.927825,57.219281,3,0
0,0,3,3,10,8,18,16,13,29,0.000333,0.040309,5,604.639125,33.591063,120.927825,57.219281,3,0
0,0,5,5,12,16,28,39,25,64,0.000333,0.102557,6,1846.02429,102.556905,307.670715,107.01955,2,0
0,0,3,3,10,8,18,16,13,29,0.000333,0.040309,5,604.639125,33.591063,120.927825,57.219281,3,0
0,0,3,3,5,6,11,9,8,17,0.000333,0.019603,2,117.620675,6.534482,58.810338,27.119415,1,0
0,0,14,14,11,35,46,79,67,146,0.000333,0.268813,5,4032.200228,224.011124,806.440046,217.578653,6,0
0,0,7,7,11,19,30,44,28,72,0.000333,0.117765,5,1766.480614,98.137812,353.296123,118.764371,2,0
0,0,3,3,7,8,15,10,13,23,0.000333,0.029953,3,269.575451,14.976414,89.858484,43.651484,1,0
0,0,6,6,15,15,30,35,24,59,0.000333,0.096502,7,2026.545816,112.585879,289.506545,117.206718,4,0
0,0,3,3,10,8,18,16,13,29,0.000333,0.040309,5,604.639125,33.591063,120.927825,57.219281,3,0
0,0,3,3,10,8,18,16,13,29,0.000333,0.040309,5,604.639125,33.591063,120.927825,57.219281,3,0
0,0,8,8,15,18,33,66,34,100,0.000333,0.168146,7,3531.075884,196.170882,504.439412,133.662009,2,0
0,0,7,7,11,19,30,44,28,72,0.000333,0.117765,5,1766.480614,98.137812,353.296123,118.764371,2,0
0,0,4,4,10,12,22,21,17,38,0.000333,0.056486,5,847.292008,47.071778,169.458402,76.238831,1,0
0,0,6,6,10,15,25,28,22,50,0.000333,0.077398,5,1160.964047,64.498003,232.192809,91.82264,1,0
0,0,4,4,11,10,21,26,17,43,0.000333,0.062957,5,944.348246,52.463791,188.869649,71.273029,2,0
0,0,3,3,10,8,18,16,13,29,0.000333,0.040309,5,604.639125,33.591063,120.927825,57.219281,3,0
0,0,4,4,6,8,14,17,12,29,0.000333,0.036804,3,331.239878,18.402215,110.413293,39.509775,3,0
0,0,3,3,10,8,18,16,13,29,0.000333,0.040309,5,604.639125,33.591063,120.927825,57.219281,3,0
0,0,3,3,5,6,11,9,8,17,0.000333,0.019603,2,117.620675,6.534482,58.810338,27.119415,1,0
0,0,7,7,14,15,29,42,31,73,0.000333,0.118211,14,4964.856577,275.825365,354.632613,111.906328,4,0
0,0,7,7,12,17,29,43,27,70,0.000333,0.113353,6,2040.352018,113.35289,340.05867,112.506418,4,0
0,0,18,18,14,26,40,107,64,171,0.000333,0.30335,14,12740.69586,707.816437,910.049704,175.514402,17,0
0,0,3,3,11,11,22,26,15,41,0.000333,0.060946,5,914.183482,50.787971,182.836696,76.107496,3,0
0,0,8,8,15,21,36,41,38,79,0.000333,0.136141,7,2858.968526,158.831585,408.424075,150.842025,4,0
0,0,7,7,11,19,30,44,28,72,0.000333,0.117765,5,1766.480614,98.137812,353.296123,118.764371,2,0
0,0,17,17,16,23,39,110,55,165,0.000333,0.290697,16,13953.46186,775.192325,872.091366,168.041925,7,0
0,0,3,3,10,8,18,16,13,29,0.000333,0.040309,5,604.639125,33.591063,120.927825,57.219281,3,0
0,0,8,8,16,13,29,53,32,85,0.000333,0.137643,16,6606.854153,367.047453,412.928385,112.105716,6,0
0,0,3,3,10,8,18,16,13,29,0.000333,0.040309,5,604.639125,33.591063,120.927825,57.219281,3,0
0,0,4,4,8,11,19,17,15,32,0.000333,0.045311,4,543.734722,30.207485,135.93368,62.053748,3,0
0,0,3,3,10,8,18,16,13,29,0.000333,0.040309,5,604.639125,33.591063,120.927825,57.219281,3,0
0,0,3,3,7,8,15,23,12,35,0.000333,0.04558,3,410.223513,22.790195,136.741171,43.651484,1,0
0,0,4,4,8,11,19,17,15,32,0.000333,0.045311,4,543.734722,30.207485,135.93368,62.053748,3,0
0,0,4,4,4,7,11,13,11,24,0.000333,0.027675,2,166.052718,9.225151,83.026359,27.651484,3,0
0,0,4,4,6,8,14,17,12,29,0.000333,0.036804,3,331.239878,18.402215,110.413293,39.509775,3,0
0,0,3,3,10,8,18,16,13,29,0.000333,0.040309,5,604.639125,33.591063,120.927825,57.219281,3,0
0,0,17,17,16,23,39,110,55,165,0.000333,0.290697,16,13953.46186,775.192325,872.091366,168.041925,7,0
0,0,5,5,12,16,28,39,25,64,0.000333,0.102557,6,1846.02429,102.556905,307.670715,107.01955,5,0
0,0,6,6,11,14,25,29,21,50,0.000333,0.077398,5,1160.964047,64.498003,232.192809,91.356717,1,0
0,0,3,3,10,8,18,16,13,29,0.000333,0.040309,5,604.639125,33.591063,120.927825,57.219281,3,0
0,0,3,3,8,8,16,16,11,27,0.000333,0.036,4,432,24,108,48,2,0
0,0,3,3,9,9,18,18,13,31,0.000333,0.043089,4,517.0707,28.72615,129.267675,57.05865,2,0
0,0,3,3,5,6,11,9,8,17,0.000333,0.019603,2,117.620675,6.534482,58.810338,27.119415,1,0
0,0,7,7,11,19,30,44,28,72,0.000333,0.117765,5,1766.480614,98.137812,353.296123,118.764371,2,0
0,0,3,3,9,13,22,20,16,36,0.000333,0.053513,4,642.158153,35.675453,160.539538,76.635041,3,0
0,0,4,4,6,8,14,17,12,29,0.000333,0.036804,3,331.239878,18.402215,110.413293,39.509775,3,0
0,0,7,7,11,19,30,44,28,72,0.000333,0.117765,5,1766.480614,98.137812,353.296123,118.764371,2,0
0,0,5,5,9,13,22,26,19,45,0.000333,0.066891,4,802.697691,44.594316,200.674423,76.635041,3,0
0,0,17,17,16,23,39,110,55,165,0.000333,0.290697,16,13953.46186,775.192325,872.091366,168.041925,7,0
0,0,6,6,8,10,18,26,18,44,0.000333,0.061159,4,733.9068,40.7726,183.4767,57.219281,1,0
0,0,19,19,18,28,46,128,68,196,0.000333,0.360873,18,19487.12658,1082.618143,1082.618143,209.664588,6,0
0,0,31,31,20,45,65,288,131,419,0.000333,0.841124,20,50467.44227,2803.746793,2523.372114,333.571951,18,0
0,0,3,3,9,9,18,18,13,31,0.000333,0.043089,4,517.0707,28.72615,129.267675,57.05865,2,0
0,0,10,10,8,5,13,25,9,34,0.000333,0.041938,4,503.259802,27.958878,125.81495,35.60964,4,0
0,0,4,4,7,13,20,20,20,40,0.000333,0.057626,3,518.631371,28.812854,172.877124,67.757201,2,0
0,0,8,8,9,17,26,35,26,61,0.000333,0.095576,4,1146.907291,63.717072,286.726823,98.016193,3,0
0,0,8,8,9,17,26,35,26,61,0.000333,0.095576,4,1146.907291,63.717072,286.726823,98.016193,3,0
0,0,5,5,12,16,28,39,25,64,0.000333,0.102557,6,1846.02429,102.556905,307.670715,107.01955,2,0
0,0,7,7,11,19,30,44,28,72,0.000333,0.117765,5,1766.480614,98.137812,353.296123,118.764371,2,0
0,0,3,3,8,10,18,20,14,34,0.000333,0.047259,4,567.1098,31.5061,141.77745,57.219281,1,0
0,0,3,3,10,8,18,16,13,29,0.000333,0.040309,5,604.639125,33.591063,120.927825,57.219281,3,0
0,0,22,22,17,27,44,123,77,200,0.000333,0.363962,16,17470.18118,970.565621,1091.886324,197.868831,9,0
0,0,4,4,10,12,22,21,17,38,0.000333,0.056486,5,847.292008,47.071778,169.458402,76.238831,1,0
0,0,3,3,8,9,17,17,12,29,0.000333,0.039512,4,474.14569,26.341427,118.536422,52.529325,2,0
0,0,7,7,11,19,30,44,28,72,0.000333,0.117765,5,1766.480614,98.137812,353.296123,118.764371,2,0
0,0,3,3,10,8,18,16,13,29,0.000333,0.040309,5,604.639125,33.591063,120.927825,57.219281,3,0
0,0,3,3,11,11,22,26,15,41,0.000333,0.060946,5,914.183482,50.787971,182.836696,76.107496,3,0
0,0,4,4,10,11,21,30,20,50,0.000333,0.073205,5,1098.079356,61.004409,219.615871,71.273029,5,0
0,0,3,3,9,9,18,18,13,31,0.000333,0.043089,4,517.0707,28.72615,129.267675,57.05865,2,0
0,0,3,3,10,10,20,17,13,30,0.000333,0.043219,5,648.289214,36.016067,129.657843,66.438562,2,0
0,0,3,3,9,9,18,18,13,31,0.000333,0.043089,4,517.0707,28.72615,129.267675,57.05865,2,0
0,0,7,7,11,19,30,44,28,72,0.000333,0.117765,5,1766.480614,98.137812,353.296123,118.764371,2,0
0,0,3,3,11,11,22,26,15,41,0.000333,0.060946,5,914.183482,50.787971,182.836696,76.107496,3,0
0,0,3,3,10,8,18,16,13,29,0.000333,0.040309,5,604.639125,33.591063,120.927825,57.219281,3,0
0,0,7,7,11,19,30,44,28,72,0.000333,0.117765,5,1766.480614,98.137812,353.296123,118.764371,2,0
0,0,7,7,11,19,30,44,28,72,0.000333,0.117765,5,1766.480614,98.137812,353.296123,118.764371,2,0
0,0,5,5,9,15,24,22,19,41,0.000333,0.062661,4,751.93385,41.774103,187.983463,87.132684,3,0
0,0,3,3,6,7,13,13,9,22,0.000333,0.027137,3,244.229021,13.568279,81.409674,35.161259,1,0
0,0,7,7,11,19,30,44,28,72,0.000333,0.117765,5,1766.480614,98.137812,353.296123,118.764371,2,0
0,0,11,11,17,19,36,59,45,104,0.000333,0.179224,16,8602.755202,477.930845,537.6722,150.197491,6,0
0,0,8,8,15,18,33,66,34,100,0.000333,0.168146,7,3531.075884,196.170882,504.439412,133.662009,2,0
0,0,3,3,10,8,18,16,13,29,0.000333,0.040309,5,604.639125,33.591063,120.927825,57.219281,3,0
0,0,6,6,13,13,26,38,23,61,0.000333,0.095576,6,1720.360937,95.575608,286.726823,96.211433,4,0
0,0,3,3,10,8,18,16,13,29,0.000333,0.040309,5,604.639125,33.591063,120.927825,57.219281,3,0
0,0,3,3,9,9,18,18,13,31,0.000333,0.043089,4,517.0707,28.72615,129.267675,57.05865,2,0
0,0,4,4,7,14,21,20,22,42,0.000333,0.061492,3,553.431995,30.746222,184.477332,72.954453,2,0
0,0,8,8,12,17,29,51,32,83,0.000333,0.134404,6,2419.274536,134.404141,403.212423,112.506418,5,0
0,0,6,6,13,11,24,38,23,61,0.000333,0.093228,12,3356.192551,186.455142,279.682713,86.159464,4,0
0,0,6,6,13,11,24,38,23,61,0.000333,0.093228,12,3356.192551,186.455142,279.682713,86.159464,4,0
0,0,3,3,10,8,18,16,13,29,0.000333,0.040309,5,604.639125,33.591063,120.927825,57.219281,3,0
0,0,18,18,11,21,32,147,77,224,0.000333,0.373333,15,16800,933.333333,1120,130.292414,1,0
0,0,4,4,11,10,21,26,17,43,0.000333,0.062957,5,944.348246,52.463791,188.869649,71.273029,2,0
0,0,4,4,11,10,21,26,17,43,0.000333,0.062957,5,944.348246,52.463791,188.869649,71.273029,2,0
0,0,3,3,10,8,18,16,13,29,0.000333,0.040309,5,604.639125,33.591063,120.927825,57.219281,3,0
0,0,11,11,15,21,36,84,43,127,0.000333,0.21886,14,9192.126653,510.673703,656.580475,150.842025,2,0
0,0,3,3,10,8,18,16,13,29,0.000333,0.040309,5,604.639125,33.591063,120.927825,57.219281,3,0
0,0,8,8,15,16,31,41,30,71,0.000333,0.117249,7,2462.235566,136.790865,351.747938,122.603359,4,0
0,0,4,4,11,9,20,24,12,36,0.000333,0.051863,5,777.947057,43.219281,155.589411,66.583073,5,0
0,0,7,7,11,19,30,44,28,72,0.000333,0.117765,5,1766.480614,98.137812,353.296123,118.764371,2,0
0,0,3,3,10,8,18,16,13,29,0.000333,0.040309,5,604.639125,33.591063,120.927825,57.219281,3,0
0,0,25,25,17,33,50,134,71,205,0.000333,0.385664,16,18511.8483,1028.436017,1156.990519,235.951874,10,0
0,0,5,5,13,10,23,35,21,56,0.000333,0.08444,12,3039.833634,168.879646,253.31947,81.324997,4,0
0,0,3,3,10,8,18,16,13,29,0.000333,0.040309,5,604.639125,33.591063,120.927825,57.219281,3,0
0,0,7,7,11,19,30,44,28,72,0.000333,0.117765,5,1766.480614,98.137812,353.296123,118.764371,2,0
0,0,7,7,11,19,30,44,28,72,0.000333,0.117765,5,1766.480614,98.137812,353.296123,118.764371,2,0
0,0,7,7,11,19,30,44,28,72,0.000333,0.117765,5,1766.480614,98.137812,353.296123,118.764371,2,0
0,0,3,3,9,9,18,18,13,31,0.000333,0.043089,4,517.0707,28.72615,129.267675,57.05865,2,0
0,0,3,3,9,9,18,18,13,31,0.000333,0.043089,4,517.0707,28.72615,129.267675,57.05865,2,0
0,0,7,7,11,19,30,44,28,72,0.000333,0.117765,5,1766.480614,98.137812,353.296123,118.764371,2,0
0,0,3,3,10,6,16,19,10,29,0.000333,0.038667,5,580,32.222222,116,48.729056,1,0
0,0,3,3,10,6,16,19,10,29,0.000333,0.038667,5,580,32.222222,116,48.729056,1,0
0,0,3,3,10,8,18,16,13,29,0.000333,0.040309,5,604.639125,33.591063,120.927825,57.219281,3,0
0,0,3,3,10,8,18,16,13,29,0.000333,0.040309,5,604.639125,33.591063,120.927825,57.219281,3,0
0,0,3,3,10,8,18,16,13,29,0.000333,0.040309,5,604.639125,33.591063,120.927825,57.219281,3,0
0,0,6,6,13,13,26,38,23,61,0.000333,0.095576,6,1720.360937,95.575608,286.726823,96.211433,4,0
0,0,3,3,10,10,20,17,13,30,0.000333,0.043219,5,648.289214,36.016067,129.657843,66.438562,2,0
0,0,24,24,15,29,44,235,86,321,0.000333,0.584159,14,24534.68569,1363.038094,1752.47755,199.484808,6,0
0,0,33,33,17,45,62,258,137,395,0.000333,0.783969,24,56445.78102,3135.876723,2351.907543,316.620258,13,0
0,0,5,5,11,13,24,28,20,48,0.000333,0.073359,5,1100.391,61.132833,220.0782,86.159464,4,0
0,0,3,3,9,9,18,18,13,31,0.000333,0.043089,4,517.0707,28.72615,129.267675,57.05865,2,0
0,0,6,6,15,15,30,35,24,59,0.000333,0.096502,7,2026.545816,112.585879,289.506545,117.206718,4,0
0,0,3,3,11,11,22,26,15,41,0.000333,0.060946,5,914.183482,50.787971,182.836696,76.107496,3,0
0,0,25,25,17,34,51,133,72,205,0.000333,0.387616,16,18605.55512,1033.641951,1162.847195,242.460605,10,0
0,0,3,3,10,8,18,16,13,29,0.000333,0.040309,5,604.639125,33.591063,120.927825,57.219281,3,0
0,0,4,4,4,6,10,16,12,28,0.000333,0.031005,4,372.055947,20.669775,93.013987,23.509775,1,0
0,0,3,3,11,11,22,26,15,41,0.000333,0.060946,5,914.183482,50.787971,182.836696,76.107496,3,0
0,0,4,4,4,7,11,13,11,24,0.000333,0.027675,2,166.052718,9.225151,83.026359,27.651484,3,0
0,0,3,3,8,10,18,17,13,30,0.000333,0.041699,4,500.391,27.7995,125.09775,57.219281,2,0
0,0,7,7,12,20,32,47,29,76,0.000333,0.126667,6,2280,126.666667,380,129.458112,1,0
0,0,37,37,20,75,95,248,154,402,0.000333,0.880361,20,52821.63909,2934.535505,2641.081955,553.599964,10,0
0,0,6,6,9,18,27,24,23,47,0.000333,0.074493,4,893.91885,49.662158,223.479713,103.587975,3,0
0,0,3,3,9,9,18,18,13,31,0.000333,0.043089,4,517.0707,28.72615,129.267675,57.05865,2,0
0,0,4,4,4,7,11,13,11,24,0.000333,0.027675,2,166.052718,9.225151,83.026359,27.651484,3,0
0,0,4,4,4,7,11,13,11,24,0.000333,0.027675,2,166.052718,9.225151,83.026359,27.651484,3,0
0,0,5,5,9,15,24,22,19,41,0.000333,0.062661,4,751.93385,41.774103,187.983463,87.132684,3,0
0,0,7,7,11,19,30,44,28,72,0.000333,0.117765,5,1766.480614,98.137812,353.296123,118.764371,2,0
0,0,4,4,4,7,11,13,11,24,0.000333,0.027675,2,166.052718,9.225151,83.026359,27.651484,3,0
0,0,3,3,10,8,18,16,13,29,0.000333,0.040309,5,604.639125,33.591063,120.927825,57.219281,3,0
0,0,3,3,10,8,18,16,13,29,0.000333,0.040309,5,604.639125,33.591063,120.927825,57.219281,3,0
0,0,3,3,10,11,21,22,15,37,0.000333,0.054172,5,812.578723,45.143262,162.515745,71.273029,4,0
0,0,7,7,11,13,24,30,19,49,0.000333,0.074888,5,1123.315813,62.406434,224.663163,86.159464,2,0
0,0,9,9,14,25,39,156,54,210,0.000333,0.369978,14,15539.08252,863.282362,1109.934466,169.399374,5,0
0,0,3,3,5,6,11,9,8,17,0.000333,0.019603,2,117.620675,6.534482,58.810338,27.119415,1,0
0,0,3,3,10,10,20,17,13,30,0.000333,0.043219,5,648.289214,36.016067,129.657843,66.438562,2,0
0,0,3,3,10,11,21,22,15,37,0.000333,0.054172,5,812.578723,45.143262,162.515745,71.273029,4,0
0,0,26,26,17,37,54,139,75,214,0.000333,0.410515,16,19704.73481,1094.707489,1231.545925,262.236643,11,0
0,0,7,7,10,16,26,43,35,78,0.000333,0.122211,10,3666.34298,203.685721,366.634298,97.219281,2,0
0,0,3,3,10,8,18,16,13,29,0.000333,0.040309,5,604.639125,33.591063,120.927825,57.219281,3,0
0,0,3,3,10,8,18,16,13,29,0.000333,0.040309,5,604.639125,33.591063,120.927825,57.219281,3,0
0,0,4,4,10,9,19,46,19,65,0.000333,0.092038,10,2761.152884,153.397382,276.115288,61.748606,11,0
0,0,3,3,10,8,18,16,13,29,0.000333,0.040309,5,604.639125,33.591063,120.927825,57.219281,3,0
0,0,3,3,10,6,16,19,10,29,0.000333,0.038667,5,580,32.222222,116,48.729056,1,0
0,0,3,3,10,8,18,16,13,29,0.000333,0.040309,5,604.639125,33.591063,120.927825,57.219281,3,0
0,0,8,8,12,17,29,44,33,77,0.000333,0.124688,6,2244.38722,124.688179,374.064537,112.506418,4,0
0,0,3,3,9,9,18,18,13,31,0.000333,0.043089,4,517.0707,28.72615,129.267675,57.05865,2,0
0,0,3,3,9,9,18,18,13,31,0.000333,0.043089,4,517.0707,28.72615,129.267675,57.05865,2,0
0,0,13,13,13,24,37,91,52,143,0.000333,0.248317,12,8939.421975,496.634554,744.951831,158.144816,1,0
0,0,8,8,15,18,33,66,34,100,0.000333,0.168146,7,3531.075884,196.170882,504.439412,133.662009,2,0
0,0,3,3,10,10,20,17,13,30,0.000333,0.043219,5,648.289214,36.016067,129.657843,66.438562,2,0
0,0,11,11,15,21,36,84,43,127,0.000333,0.21886,14,9192.126653,510.673703,656.580475,150.842025,2,0
0,0,3,3,11,11,22,26,15,41,0.000333,0.060946,5,914.183482,50.787971,182.836696,76.107496,3,0
0,0,3,3,10,8,18,16,13,29,0.000333,0.040309,5,604.639125,33.591063,120.927825,57.219281,3,0
0,0,3,3,10,8,18,16,13,29,0.000333,0.040309,5,604.639125,33.591063,120.927825,57.219281,3,0
0,0,4,4,11,9,20,24,12,36,0.000333,0.051863,5,777.947057,43.219281,155.589411,66.583073,5,0
0,0,5,5,14,13,27,31,20,51,0.000333,0.080833,7,1697.494838,94.305269,242.499263,101.408685,2,0
0,0,4,4,4,7,11,13,11,24,0.000333,0.027675,2,166.052718,9.225151,83.026359,27.651484,3,0
0,0,7,7,11,19,30,44,28,72,0.000333,0.117765,5,1766.480614,98.137812,353.296123,118.764371,2,0
0,0,10,10,18,18,36,60,42,102,0.000333,0.175777,18,9491.982303,527.33235,527.33235,150.1173,6,0
0,0,4,4,9,9,18,16,14,30,0.000333,0.041699,4,500.391,27.7995,125.09775,57.05865,1,0
0,0,3,3,10,8,18,16,13,29,0.000333,0.040309,5,604.639125,33.591063,120.927825,57.219281,3,0
0,0,3,3,10,8,18,16,13,29,0.000333,0.040309,5,604.639125,33.591063,120.927825,57.219281,3,0
0,0,4,4,10,12,22,21,17,38,0.000333,0.056486,5,847.292008,47.071778,169.458402,76.238831,1,0
0,0,3,3,10,8,18,16,13,29,0.000333,0.040309,5,604.639125,33.591063,120.927825,57.219281,3,0
0,0,3,3,10,8,18,16,13,29,0.000333,0.040309,5,604.639125,33.591063,120.927825,57.219281,3,0
0,0,3,3,10,10,20,17,13,30,0.000333,0.043219,5,648.289214,36.016067,129.657843,66.438562,2,0
0,0,4,4,4,7,11,13,11,24,0.000333,0.027675,2,166.052718,9.225151,83.026359,27.651484,3,0
0,0,5,5,8,12,20,20,16,36,0.000333,0.051863,4,622.357646,34.575425,155.589411,67.01955,3,0
0,0,10,10,16,17,33,65,46,111,0.000333,0.186643,16,8958.843956,497.713553,559.927747,133.486868,4,0
0,0,6,6,13,11,24,38,23,61,0.000333,0.093228,12,3356.192551,186.455142,279.682713,86.159464,4,0
0,0,5,5,7,9,16,23,14,37,0.000333,0.049333,3,444,24.666667,148,48.180809,1,0
0,0,4,4,10,12,22,21,17,38,0.000333,0.056486,5,847.292008,47.071778,169.458402,76.238831,1,0
0,0,7,7,11,19,30,44,28,72,0.000333,0.117765,5,1766.480614,98.137812,353.296123,118.764371,2,0
0,0,4,4,6,8,14,17,12,29,0.000333,0.036804,3,331.239878,18.402215,110.413293,39.509775,3,0
0,0,8,8,16,19,35,42,34,76,0.000333,0.129942,8,3118.604074,173.255782,389.825509,144.710623,4,0
0,0,17,17,13,27,40,91,51,142,0.000333,0.251905,6,4534.282737,251.904596,755.713789,176.487679,5,0
0,0,7,7,11,19,30,44,28,72,0.000333,0.117765,5,1766.480614,98.137812,353.296123,118.764371,2,0
0,0,3,3,10,8,18,16,13,29,0.000333,0.040309,5,604.639125,33.591063,120.927825,57.219281,3,0
0,0,3,3,10,8,18,16,13,29,0.000333,0.040309,5,604.639125,33.591063,120.927825,57.219281,3,0
0,0,16,16,12,26,38,87,49,136,0.000333,0.237906,6,4282.308851,237.906047,713.718142,165.230983,5,0
0,0,8,8,15,18,33,45,33,78,0.000333,0.131154,7,2754.239189,153.013288,393.462741,133.662009,4,0
0,0,10,10,17,20,37,59,46,105,0.000333,0.182331,16,8751.881654,486.215647,546.992603,155.92543,6,0
0,0,8,8,9,17,26,35,26,61,0.000333,0.095576,4,1146.907291,63.717072,286.726823,98.016193,3,0
0,0,4,4,4,7,11,13,11,24,0.000333,0.027675,2,166.052718,9.225151,83.026359,27.651484,3,0
0,0,5,5,11,12,23,33,21,54,0.000333,0.081424,5,1221.361728,67.853429,244.272346,81.073298,1,0
0,0,28,28,17,41,58,148,80,228,0.000333,0.445207,8,10684.95734,593.608741,1335.619667,289.1465,10,0
0,0,7,7,11,19,30,44,28,72,0.000333,0.117765,5,1766.480614,98.137812,353.296123,118.764371,2,0
0,0,7,7,11,19,30,44,28,72,0.000333,0.117765,5,1766.480614,98.137812,353.296123,118.764371,2,0
0,0,7,7,11,19,30,44,28,72,0.000333,0.117765,5,1766.480614,98.137812,353.296123,118.764371,2,0
0,0,18,18,14,30,44,95,54,149,0.000333,0.271152,7,5694.187178,316.343732,813.455311,200.509687,7,0
0,0,33,33,13,42,55,213,127,340,0.000333,0.655221,18,35381.92145,1965.662303,1965.662303,274.583048,1,0
0,0,6,6,11,13,24,35,18,53,0.000333,0.081001,5,1215.015063,67.500837,243.003013,86.159464,3,0
0,0,7,7,11,18,29,48,28,76,0.000333,0.123069,5,1846.032778,102.557377,369.206556,113.112398,1,0
0,0,4,4,7,12,19,20,18,38,0.000333,0.053807,3,484.263737,26.903541,161.421246,62.671034,2,0
0,0,17,17,16,23,39,110,55,165,0.000333,0.290697,16,13953.46186,775.192325,872.091366,168.041925,7,0
0,0,7,7,11,19,30,44,28,72,0.000333,0.117765,5,1766.480614,98.137812,353.296123,118.764371,2,0
0,0,7,7,12,17,29,43,27,70,0.000333,0.113353,6,2040.352018,113.35289,340.05867,112.506418,4,0
0,0,5,5,10,15,25,24,25,49,0.000333,0.07585,5,1137.744766,63.208043,227.548953,91.82264,2,0
0,0,7,7,11,19,30,44,28,72,0.000333,0.117765,5,1766.480614,98.137812,353.296123,118.764371,2,0
0,0,6,6,12,13,25,32,26,58,0.000333,0.089781,12,3232.123908,179.562439,269.343659,91.125266,2,0
0,0,8,8,10,14,24,50,26,76,0.000333,0.116152,5,1742.28575,96.793653,348.45715,86.52225,3,0
0,0,4,4,4,7,11,13,11,24,0.000333,0.027675,2,166.052718,9.225151,83.026359,27.651484,3,0
0,0,5,5,9,15,24,22,19,41,0.000333,0.062661,4,751.93385,41.774103,187.983463,87.132684,3,0
0,0,25,25,17,33,50,134,71,205,0.000333,0.385664,16,18511.8483,1028.436017,1156.990519,235.951874,10,0
0,0,4,4,11,10,21,26,17,43,0.000333,0.062957,5,944.348246,52.463791,188.869649,71.273029,2,0
0,0,6,6,8,10,18,26,18,44,0.000333,0.061159,4,733.9068,40.7726,183.4767,57.219281,1,0
0,0,4,4,4,7,11,13,11,24,0.000333,0.027675,2,166.052718,9.225151,83.026359,27.651484,3,0
0,0,7,7,11,19,30,44,28,72,0.000333,0.117765,5,1766.480614,98.137812,353.296123,118.764371,2,0
0,0,17,17,21,26,47,131,75,206,0.000333,0.381415,20,22884.90607,1271.38367,1144.245303,214.450099,9,0
0,0,4,4,7,9,16,16,12,28,0.000333,0.037333,3,336,18.666667,112,48.180809,3,0
0,0,7,7,11,19,30,44,28,72,0.000333,0.117765,5,1766.480614,98.137812,353.296123,118.764371,2,0
0,0,7,7,11,19,30,44,28,72,0.000333,0.117765,5,1766.480614,98.137812,353.296123,118.764371,2,0
0,0,7,7,11,19,30,44,28,72,0.000333,0.117765,5,1766.480614,98.137812,353.296123,118.764371,2,0
0,0,4,4,7,11,18,20,16,36,0.000333,0.050039,3,450.3519,25.01955,150.1173,57.705232,2,0
0,0,3,3,10,8,18,16,13,29,0.000333,0.040309,5,604.639125,33.591063,120.927825,57.219281,3,0
0,0,13,13,16,36,52,233,88,321,0.000333,0.609947,16,29277.45839,1626.525466,1829.84115,250.1173,14,0
0,0,4,4,4,7,11,13,11,24,0.000333,0.027675,2,166.052718,9.225151,83.026359,27.651484,3,0
0,0,11,11,15,21,36,84,43,127,0.000333,0.21886,14,9192.126653,510.673703,656.580475,150.842025,2,0
0,0,3,3,7,9,16,17,12,29,0.000333,0.038667,3,348,19.333333,116,48.180809,2,0
0,0,5,5,10,10,20,27,15,42,0.000333,0.060507,5,907.6049,50.422494,181.52098,66.438562,2,0
0,0,3,3,10,8,18,16,13,29,0.000333,0.040309,5,604.639125,33.591063,120.927825,57.219281,3,0
0,0,3,3,11,11,22,26,15,41,0.000333,0.060946,5,914.183482,50.787971,182.836696,76.107496,3,0
0,0,3,3,10,8,18,16,13,29,0.000333,0.040309,5,604.639125,33.591063,120.927825,57.219281,3,0
0,0,8,8,9,17,26,35,26,61,0.000333,0.095576,4,1146.907291,63.717072,286.726823,98.016193,3,0
0,0,4,4,4,7,11,13,11,24,0.000333,0.027675,2,166.052718,9.225151,83.026359,27.651484,3,0
0,0,3,3,10,11,21,22,15,37,0.000333,0.054172,5,812.578723,45.143262,162.515745,71.273029,4,0
0,0,8,8,7,9,16,17,12,29,0.000333,0.038667,3,348,19.333333,116,48.180809,1,0
0,0,4,4,6,10,16,26,15,41,0.000333,0.054667,3,492,27.333333,164,48.729056,1,0
0,0,7,7,11,19,30,44,28,72,0.000333,0.117765,5,1766.480614,98.137812,353.296123,118.764371,2,0
0,0,3,3,10,8,18,16,13,29,0.000333,0.040309,5,604.639125,33.591063,120.927825,57.219281,3,0
0,0,4,4,4,7,11,13,11,24,0.000333,0.027675,2,166.052718,9.225151,83.026359,27.651484,3,0
0,0,22,22,18,28,46,147,82,229,0.000333,0.421632,18,22768.12238,1264.895688,1264.895688,209.664588,6,0
0,0,3,3,8,10,18,20,13,33,0.000333,0.045869,4,550.4301,30.57945,137.607525,57.219281,3,0
0,0,11,11,14,25,39,58,46,104,0.000333,0.183227,7,3847.772815,213.765156,549.681831,169.399374,4,0
0,0,4,4,10,12,22,21,17,38,0.000333,0.056486,5,847.292008,47.071778,169.458402,76.238831,1,0
0,0,3,3,10,8,18,16,13,29,0.000333,0.040309,5,604.639125,33.591063,120.927825,57.219281,3,0
0,0,8,8,16,17,33,41,29,70,0.000333,0.117703,8,2824.860707,156.936706,353.107588,133.486868,4,0
0,0,10,10,15,27,42,169,61,230,0.000333,0.413411,14,17363.2621,964.625672,1240.233007,186.985321,7,0
0,0,4,4,10,12,22,21,17,38,0.000333,0.056486,5,847.292008,47.071778,169.458402,76.238831,1,0
0,0,5,5,9,14,23,26,24,50,0.000333,0.075393,4,904.712391,50.2618,226.178098,81.832294,2,0
0,0,3,3,9,9,18,18,13,31,0.000333,0.043089,4,517.0707,28.72615,129.267675,57.05865,2,0
0,0,3,3,10,10,20,17,13,30,0.000333,0.043219,5,648.289214,36.016067,129.657843,66.438562,2,0
0,0,4,4,10,12,22,21,17,38,0.000333,0.056486,5,847.292008,47.071778,169.458402,76.238831,1,0
0,0,3,3,10,8,18,16,13,29,0.000333,0.040309,5,604.639125,33.591063,120.927825,57.219281,3,0
0,0,3,3,10,8,18,16,13,29,0.000333,0.040309,5,604.639125,33.591063,120.927825,57.219281,3,0
0,0,3,3,10,8,18,16,13,29,0.000333,0.040309,5,604.639125,33.591063,120.927825,57.219281,3,0
0,0,14,14,12,22,34,81,42,123,0.000333,0.208586,6,3754.547577,208.585976,625.757929,141.127046,5,0
0,0,3,3,9,9,18,18,13,31,0.000333,0.043089,4,517.0707,28.72615,129.267675,57.05865,2,0
0,0,3,3,8,10,18,20,13,33,0.000333,0.045869,4,550.4301,30.57945,137.607525,57.219281,3,0
0,0,3,3,9,9,18,18,13,31,0.000333,0.043089,4,517.0707,28.72615,129.267675,57.05865,2,0
0,0,3,3,10,10,20,17,13,30,0.000333,0.043219,5,648.289214,36.016067,129.657843,66.438562,2,0
0,0,7,7,11,19,30,44,28,72,0.000333,0.117765,5,1766.480614,98.137812,353.296123,118.764371,2,0
0,0,7,7,12,17,29,43,27,70,0.000333,0.113353,6,2040.352018,113.35289,340.05867,112.506418,4,0
0,0,4,4,6,8,14,17,12,29,0.000333,0.036804,3,331.239878,18.402215,110.413293,39.509775,3,0
0,0,6,6,9,17,26,26,23,49,0.000333,0.076774,4,921.286185,51.182566,230.321546,98.016193,3,0
0,0,5,5,8,11,19,21,19,40,0.000333,0.056639,4,679.668402,37.759356,169.917101,62.053748,3,0
0,0,3,3,10,10,20,17,13,30,0.000333,0.043219,5,648.289214,36.016067,129.657843,66.438562,2,0
0,0,17,17,16,23,39,110,55,165,0.000333,0.290697,16,13953.46186,775.192325,872.091366,168.041925,7,0
0,0,3,3,10,8,18,16,13,29,0.000333,0.040309,5,604.639125,33.591063,120.927825,57.219281,3,0
0,0,4,4,4,7,11,13,11,24,0.000333,0.027675,2,166.052718,9.225151,83.026359,27.651484,3,0
0,0,13,13,12,23,35,66,53,119,0.000333,0.203462,12,7324.616148,406.923119,610.384679,147.061475,1,0
0,0,3,3,10,8,18,16,13,29,0.000333,0.040309,5,604.639125,33.591063,120.927825,57.219281,3,0
0,0,36,36,16,62,78,272,185,457,0.000333,0.957476,16,45958.86102,2553.270057,2872.428814,433.160171,4,0
0,0,6,6,11,15,26,30,22,52,0.000333,0.081474,5,1222.114327,67.89524,244.422865,96.657107,1,0
0,0,3,3,10,8,18,16,13,29,0.000333,0.040309,5,604.639125,33.591063,120.927825,57.219281,3,0
0,0,3,3,10,8,18,16,13,29,0.000333,0.040309,5,604.639125,33.591063,120.927825,57.219281,3,0
0,0,3,3,10,8,18,16,13,29,0.000333,0.040309,5,604.639125,33.591063,120.927825,57.219281,3,0
0,0,4,4,4,7,11,13,11,24,0.000333,0.027675,2,166.052718,9.225151,83.026359,27.651484,3,0
0,0,3,3,10,8,18,16,13,29,0.000333,0.040309,5,604.639125,33.591063,120.927825,57.219281,3,0
0,0,6,6,11,10,21,31,15,46,0.000333,0.067349,5,1010.233007,56.124056,202.046601,71.273029,2,0
0,0,4,4,4,7,11,13,11,24,0.000333,0.027675,2,166.052718,9.225151,83.026359,27.651484,3,0
0,0,8,8,15,17,32,45,31,76,0.000333,0.126667,7,2660,147.777778,380,128.090227,4,0
0,0,4,4,4,7,11,13,11,24,0.000333,0.027675,2,166.052718,9.225151,83.026359,27.651484,3,0
0,0,8,8,9,17,26,35,26,61,0.000333,0.095576,4,1146.907291,63.717072,286.726823,98.016193,3,0
0,0,6,6,13,13,26,38,23,61,0.000333,0.095576,6,1720.360937,95.575608,286.726823,96.211433,4,0
0,0,4,4,6,8,14,17,12,29,0.000333,0.036804,3,331.239878,18.402215,110.413293,39.509775,3,0
0,0,3,3,10,8,18,16,13,29,0.000333,0.040309,5,604.639125,33.591063,120.927825,57.219281,3,0
0,0,3,3,10,11,21,22,15,37,0.000333,0.054172,5,812.578723,45.143262,162.515745,71.273029,4,0
0,0,3,3,10,11,21,22,15,37,0.000333,0.054172,5,812.578723,45.143262,162.515745,71.273029,4,0
0,0,3,3,9,9,18,18,13,31,0.000333,0.043089,4,517.0707,28.72615,129.267675,57.05865,2,0
0,0,4,4,11,12,23,26,19,45,0.000333,0.067853,5,1017.80144,56.544524,203.560288,81.073298,2,0
0,0,3,3,9,9,18,18,13,31,0.000333,0.043089,4,517.0707,28.72615,129.267675,57.05865,2,0
0,0,7,7,11,18,29,48,28,76,0.000333,0.123069,5,1846.032778,102.557377,369.206556,113.112398,1,0
0,0,14,14,13,23,36,86,44,130,0.000333,0.22403,6,4032.541501,224.030083,672.09025,152.147641,5,0
0,0,3,3,10,8,18,16,13,29,0.000333,0.040309,5,604.639125,33.591063,120.927825,57.219281,3,0
0,0,6,6,11,13,24,35,18,53,0.000333,0.081001,5,1215.015063,67.500837,243.003013,86.159464,3,0
0,0,3,3,10,10,20,17,13,30,0.000333,0.043219,5,648.289214,36.016067,129.657843,66.438562,2,0
0,0,4,4,8,11,19,17,15,32,0.000333,0.045311,4,543.734722,30.207485,135.93368,62.053748,3,0
0,0,4,4,6,8,14,17,12,29,0.000333,0.036804,3,331.239878,18.402215,110.413293,39.509775,3,0
0,0,7,7,11,19,30,44,28,72,0.000333,0.117765,5,1766.480614,98.137812,353.296123,118.764371,2,0
0,0,3,3,10,8,18,16,13,29,0.000333,0.040309,5,604.639125,33.591063,120.927825,57.219281,3,0
0,0,7,7,11,19,30,44,28,72,0.000333,0.117765,5,1766.480614,98.137812,353.296123,118.764371,2,0
0,0,3,3,10,8,18,16,13,29,0.000333,0.040309,5,604.639125,33.591063,120.927825,57.219281,3,0
0,0,5,5,13,10,23,35,21,56,0.000333,0.08444,12,3039.833634,168.879646,253.31947,81.324997,4,0
0,0,3,3,10,8,18,16,13,29,0.000333,0.040309,5,604.639125,33.591063,120.927825,57.219281,3,0
0,0,3,3,10,8,18,16,13,29,0.000333,0.040309,5,604.639125,33.591063,120.927825,57.219281,3,0
0,0,3,3,10,8,18,16,13,29,0.000333,0.040309,5,604.639125,33.591063,120.927825,57.219281,3,0
0,0,6,6,15,15,30,35,24,59,0.000333,0.096502,7,2026.545816,112.585879,289.506545,117.206718,4,0
0,0,17,17,16,23,39,110,55,165,0.000333,0.290697,16,13953.46186,775.192325,872.091366,168.041925,7,0
0,0,3,3,11,11,22,26,15,41,0.000333,0.060946,5,914.183482,50.787971,182.836696,76.107496,3,0
0,0,3,3,9,9,18,18,13,31,0.000333,0.043089,4,517.0707,28.72615,129.267675,57.05865,2,0
0,0,6,6,9,17,26,26,23,49,0.000333,0.076774,4,921.286185,51.182566,230.321546,98.016193,3,0
0,0,3,3,10,8,18,16,13,29,0.000333,0.040309,5,604.639125,33.591063,120.927825,57.219281,3,0
0,0,3,3,10,8,18,16,13,29,0.000333,0.040309,5,604.639125,33.591063,120.927825,57.219281,3,0
0,0,7,7,8,13,21,30,22,52,0.000333,0.076134,4,913.602024,50.755668,228.400506,72.105716,1,0
0,0,7,7,11,19,30,44,28,72,0.000333,0.117765,5,1766.480614,98.137812,353.296123,118.764371,2,0
0,0,14,14,11,35,46,79,67,146,0.000333,0.268813,5,4032.200228,224.011124,806.440046,217.578653,6,0
0,0,4,4,11,12,23,20,16,36,0.000333,0.054283,5,814.241152,45.23562,162.84823,81.073298,2,0
0,0,5,5,11,12,23,33,21,54,0.000333,0.081424,5,1221.361728,67.853429,244.272346,81.073298,1,0
0,0,7,7,12,17,29,43,27,70,0.000333,0.113353,6,2040.352018,113.35289,340.05867,112.506418,4,0
0,0,7,7,11,19,30,44,28,72,0.000333,0.117765,5,1766.480614,98.137812,353.296123,118.764371,2,0
0,0,3,3,10,6,16,19,10,29,0.000333,0.038667,5,580,32.222222,116,48.729056,1,0
0,0,4,4,9,10,19,22,15,37,0.000333,0.052391,4,628.693272,34.927404,157.173318,61.748606,5,0
0,0,3,3,10,6,16,21,9,30,0.000333,0.04,5,600,33.333333,120,48.729056,3,0
0,0,3,3,10,8,18,16,13,29,0.000333,0.040309,5,604.639125,33.591063,120.927825,57.219281,3,0
0,0,3,3,10,8,18,16,13,29,0.000333,0.040309,5,604.639125,33.591063,120.927825,57.219281,3,0
0,0,8,8,15,18,33,66,34,100,0.000333,0.168146,7,3531.075884,196.170882,504.439412,133.662009,2,0
0,0,7,7,11,19,30,44,28,72,0.000333,0.117765,5,1766.480614,98.137812,353.296123,118.764371,2,0
0,0,3,3,9,9,18,18,13,31,0.000333,0.043089,4,517.0707,28.72615,129.267675,57.05865,2,0
0,0,17,17,21,26,47,131,75,206,0.000333,0.381415,20,22884.90607,1271.38367,1144.245303,214.450099,9,0
0,0,17,17,16,23,39,110,55,165,0.000333,0.290697,16,13953.46186,775.192325,872.091366,168.041925,7,0
0,0,7,7,11,19,30,44,28,72,0.000333,0.117765,5,1766.480614,98.137812,353.296123,118.764371,2,0
0,0,6,6,13,13,26,38,23,61,0.000333,0.095576,6,1720.360937,95.575608,286.726823,96.211433,4,0
0,0,6,6,11,13,24,35,18,53,0.000333,0.081001,5,1215.015063,67.500837,243.003013,86.159464,3,0
0,0,4,4,4,7,11,13,11,24,0.000333,0.027675,2,166.052718,9.225151,83.026359,27.651484,3,0
0,0,4,4,10,9,19,23,14,37,0.000333,0.052391,5,785.86659,43.659255,157.173318,61.748606,2,0
0,0,3,3,10,8,18,16,13,29,0.000333,0.040309,5,604.639125,33.591063,120.927825,57.219281,3,0
0,0,5,5,11,12,23,33,21,54,0.000333,0.081424,5,1221.361728,67.853429,244.272346,81.073298,1,0
0,0,3,3,10,8,18,16,13,29,0.000333,0.040309,5,604.639125,33.591063,120.927825,57.219281,3,0
0,0,8,8,15,18,33,66,34,100,0.000333,0.168146,7,3531.075884,196.170882,504.439412,133.662009,2,0
0,0,8,8,9,17,26,35,26,61,0.000333,0.095576,4,1146.907291,63.717072,286.726823,98.016193,3,0
0,0,6,6,13,13,26,38,23,61,0.000333,0.095576,6,1720.360937,95.575608,286.726823,96.211433,4,0
0,0,3,3,10,9,19,37,16,53,0.000333,0.075047,5,1125.700791,62.538933,225.140158,61.748606,10,0
0,0,4,4,10,9,19,46,19,65,0.000333,0.092038,10,2761.152884,153.397382,276.115288,61.748606,11,0
0,0,11,11,15,24,39,58,36,94,0.000333,0.165609,7,3477.79466,193.210814,496.827809,168.642459,5,0
0,0,4,4,4,6,10,16,12,28,0.000333,0.031005,4,372.055947,20.669775,93.013987,23.509775,1,0
0,0,5,5,12,16,28,39,25,64,0.000333,0.102557,6,1846.02429,102.556905,307.670715,107.01955,2,0
0,0,4,4,6,8,14,17,12,29,0.000333,0.036804,3,331.239878,18.402215,110.413293,39.509775,3,0
0,0,3,3,10,8,18,16,13,29,0.000333,0.040309,5,604.639125,33.591063,120.927825,57.219281,3,0
0,0,6,6,14,12,26,38,24,62,0.000333,0.097142,14,4079.981675,226.665649,291.427263,96.322519,4,0
0,0,4,4,7,9,16,16,12,28,0.000333,0.037333,3,336,18.666667,112,48.180809,3,0
0,0,7,7,8,13,21,30,22,52,0.000333,0.076134,4,913.602024,50.755668,228.400506,72.105716,1,0
0,0,3,3,10,8,18,16,13,29,0.000333,0.040309,5,604.639125,33.591063,120.927825,57.219281,3,0
0,0,5,5,10,14,24,24,23,47,0.000333,0.071831,5,1077.466188,59.859233,215.493238,86.52225,2,0
0,0,6,6,15,15,30,35,24,59,0.000333,0.096502,7,2026.545816,112.585879,289.506545,117.206718,4,0
0,0,7,7,11,18,29,48,28,76,0.000333,0.123069,5,1846.032778,102.557377,369.206556,113.112398,1,0
0,0,6,6,10,11,21,30,16,46,0.000333,0.067349,5,1010.233007,56.124056,202.046601,71.273029,3,0
0,0,7,7,11,19,30,44,28,72,0.000333,0.117765,5,1766.480614,98.137812,353.296123,118.764371,2,0
0,0,17,17,16,23,39,110,55,165,0.000333,0.290697,16,13953.46186,775.192325,872.091366,168.041925,7,0
0,0,26,26,17,37,54,139,75,214,0.000333,0.410515,16,19704.73481,1094.707489,1231.545925,262.236643,10,0
0,0,4,4,4,7,11,13,11,24,0.000333,0.027675,2,166.052718,9.225151,83.026359,27.651484,3,0
0,0,3,3,10,8,18,16,13,29,0.000333,0.040309,5,604.639125,33.591063,120.927825,57.219281,3,0
0,0,3,3,10,8,18,16,13,29,0.000333,0.040309,5,604.639125,33.591063,120.927825,57.219281,3,0
0,0,7,7,11,19,30,44,28,72,0.000333,0.117765,5,1766.480614,98.137812,353.296123,118.764371,2,0
0,0,7,7,11,18,29,48,28,76,0.000333,0.123069,5,1846.032778,102.557377,369.206556,113.112398,1,0
0,0,4,4,6,8,14,17,12,29,0.000333,0.036804,3,331.239878,18.402215,110.413293,39.509775,3,0
0,0,5,5,10,10,20,27,14,41,0.000333,0.059066,5,885.995259,49.221959,177.199052,66.438562,3,0
0,0,6,6,9,18,27,24,23,47,0.000333,0.074493,4,893.91885,49.662158,223.479713,103.587975,3,0
0,0,3,3,10,9,19,37,16,53,0.000333,0.075047,5,1125.700791,62.538933,225.140158,61.748606,10,0
0,0,4,4,10,11,21,30,20,50,0.000333,0.073205,5,1098.079356,61.004409,219.615871,71.273029,5,0
0,0,7,7,11,19,30,44,28,72,0.000333,0.117765,5,1766.480614,98.137812,353.296123,118.764371,2,0
0,0,7,7,12,17,29,43,27,70,0.000333,0.113353,6,2040.352018,113.35289,340.05867,112.506418,4,0
0,0,3,3,10,8,18,16,13,29,0.000333,0.040309,5,604.639125,33.591063,120.927825,57.219281,3,0
0,0,3,3,10,8,18,16,13,29,0.000333,0.040309,5,604.639125,33.591063,120.927825,57.219281,3,0
0,0,4,4,4,7,11,13,11,24,0.000333,0.027675,2,166.052718,9.225151,83.026359,27.651484,3,0
0,0,3,3,10,8,18,16,13,29,0.000333,0.040309,5,604.639125,33.591063,120.927825,57.219281,3,0
0,0,3,3,9,9,18,18,13,31,0.000333,0.043089,4,517.0707,28.72615,129.267675,57.05865,2,0
0,0,3,3,9,9,18,18,13,31,0.000333,0.043089,4,517.0707,28.72615,129.267675,57.05865,2,0
0,0,15,15,11,37,48,83,71,154,0.000333,0.286695,5,4300.421126,238.912285,860.084225,230.803522,6,0
0,0,3,3,10,8,18,16,13,29,0.000333,0.040309,5,604.639125,33.591063,120.927825,57.219281,3,0
0,0,3,3,8,9,17,17,12,29,0.000333,0.039512,4,474.14569,26.341427,118.536422,52.529325,2,0
0,0,3,3,7,9,16,17,12,29,0.000333,0.038667,3,348,19.333333,116,48.180809,2,0
0,0,9,9,14,25,39,156,54,210,0.000333,0.369978,14,15539.08252,863.282362,1109.934466,169.399374,5,0
0,0,7,7,11,19,30,44,28,72,0.000333,0.117765,5,1766.480614,98.137812,353.296123,118.764371,2,0
0,0,3,3,10,8,18,16,13,29,0.000333,0.040309,5,604.639125,33.591063,120.927825,57.219281,3,0
0,0,39,39,21,48,69,204,133,337,0.000333,0.686191,20,41171.45484,2287.303047,2058.572742,360.316866,17,0
0,0,4,4,6,8,14,17,12,29,0.000333,0.036804,3,331.239878,18.402215,110.413293,39.509775,3,0
0,0,3,3,10,8,18,16,13,29,0.000333,0.040309,5,604.639125,33.591063,120.927825,57.219281,3,0
0,0,3,3,10,10,20,17,13,30,0.000333,0.043219,5,648.289214,36.016067,129.657843,66.438562,2,0
0,0,3,3,10,8,18,16,13,29,0.000333,0.040309,5,604.639125,33.591063,120.927825,57.219281,3,0
0,0,4,4,10,12,22,21,17,38,0.000333,0.056486,5,847.292008,47.071778,169.458402,76.238831,1,0
0,0,6,6,11,14,25,29,21,50,0.000333,0.077398,5,1160.964047,64.498003,232.192809,91.356717,1,0
0,0,8,8,15,18,33,66,34,100,0.000333,0.168146,7,3531.075884,196.170882,504.439412,133.662009,2,0
0,0,3,3,10,10,20,17,13,30,0.000333,0.043219,5,648.289214,36.016067,129.657843,66.438562,2,0
0,0,4,4,10,12,22,21,17,38,0.000333,0.056486,5,847.292008,47.071778,169.458402,76.238831,1,0
0,0,4,4,4,7,11,13,11,24,0.000333,0.027675,2,166.052718,9.225151,83.026359,27.651484,3,0
0,0,8,8,9,17,26,35,26,61,0.000333,0.095576,4,1146.907291,63.717072,286.726823,98.016193,3,0
0,0,17,17,16,23,39,110,55,165,0.000333,0.290697,16,13953.46186,775.192325,872.091366,168.041925,7,0
0,0,3,3,10,8,18,16,13,29,0.000333,0.040309,5,604.639125,33.591063,120.927825,57.219281,3,0
0,0,4,4,10,12,22,21,17,38,0.000333,0.056486,5,847.292008,47.071778,169.458402,76.238831,1,0
0,0,3,3,8,3,11,10,3,13,0.000333,0.014991,4,179.890444,9.993914,44.972611,28.754888,2,0
0,0,3,3,10,10,20,17,13,30,0.000333,0.043219,5,648.289214,36.016067,129.657843,66.438562,2,0
0,0,9,9,13,21,34,49,35,84,0.000333,0.142449,6,2564.081272,142.44896,427.346879,140.344382,4,0
0,0,3,3,7,9,16,17,12,29,0.000333,0.038667,3,348,19.333333,116,48.180809,2,0
0,0,3,3,9,9,18,18,13,31,0.000333,0.043089,4,517.0707,28.72615,129.267675,57.05865,2,0
0,0,8,8,9,17,26,35,26,61,0.000333,0.095576,4,1146.907291,63.717072,286.726823,98.016193,3,0
0,0,7,7,11,19,30,44,28,72,0.000333,0.117765,5,1766.480614,98.137812,353.296123,118.764371,2,0
0,0,7,7,11,19,30,44,28,72,0.000333,0.117765,5,1766.480614,98.137812,353.296123,118.764371,2,0
0,0,3,3,10,8,18,16,13,29,0.000333,0.040309,5,604.639125,33.591063,120.927825,57.219281,3,0
0,0,7,7,11,19,30,44,28,72,0.000333,0.117765,5,1766.480614,98.137812,353.296123,118.764371,2,0
0,0,3,3,10,8,18,16,13,29,0.000333,0.040309,5,604.639125,33.591063,120.927825,57.219281,3,0
0,0,24,24,19,30,49,147,86,233,0.000333,0.436076,18,23548.09309,1308.227394,1308.227394,227.917341,17,0
0,0,3,3,10,8,18,16,13,29,0.000333,0.040309,5,604.639125,33.591063,120.927825,57.219281,3,0
0,0,10,10,15,27,42,169,61,230,0.000333,0.413411,14,17363.2621,964.625672,1240.233007,186.985321,7,0
0,0,7,7,11,19,30,44,28,72,0.000333,0.117765,5,1766.480614,98.137812,353.296123,118.764371,2,0
0,0,6,6,13,11,24,38,23,61,0.000333,0.093228,12,3356.192551,186.455142,279.682713,86.159464,4,0
0,0,4,4,6,8,14,17,12,29,0.000333,0.036804,3,331.239878,18.402215,110.413293,39.509775,3,0
0,0,3,3,10,6,16,19,10,29,0.000333,0.038667,5,580,32.222222,116,48.729056,1,0
0,0,40,40,17,43,60,189,107,296,0.000333,0.582813,16,27975.03386,1554.168548,1748.439616,302.816253,12,0
0,0,23,23,14,37,51,131,84,215,0.000333,0.406524,14,17074.00028,948.555571,1219.571449,246.052743,4,0
0,0,5,5,9,15,24,22,19,41,0.000333,0.062661,4,751.93385,41.774103,187.983463,87.132684,3,0
0,0,6,6,9,13,22,31,19,50,0.000333,0.074324,4,891.886324,49.54924,222.971581,76.635041,1,0
0,0,4,4,4,7,11,13,11,24,0.000333,0.027675,2,166.052718,9.225151,83.026359,27.651484,3,0
0,0,7,7,11,19,30,44,28,72,0.000333,0.117765,5,1766.480614,98.137812,353.296123,118.764371,2,0
0,0,17,17,16,23,39,110,55,165,0.000333,0.290697,16,13953.46186,775.192325,872.091366,168.041925,7,0
0,0,7,7,17,21,38,52,37,89,0.000333,0.155689,8,3736.52439,207.584688,467.065549,161.725534,5,0
0,0,4,4,9,8,17,16,12,28,0.000333,0.03815,4,457.795838,25.433102,114.44896,52.529325,1,0
0,0,28,28,22,49,71,177,134,311,0.000333,0.637524,22,42076.56979,2337.587211,1912.571354,373.228278,5,0
0,0,23,23,15,33,48,138,82,220,0.000333,0.409564,14,17201.6845,955.649139,1228.69175,225.068365,4,0
0,0,6,6,13,13,26,38,23,61,0.000333,0.095576,6,1720.360937,95.575608,286.726823,96.211433,4,0
0,0,8,8,9,17,26,35,26,61,0.000333,0.095576,4,1146.907291,63.717072,286.726823,98.016193,3,0
0,0,17,17,16,23,39,110,55,165,0.000333,0.290697,16,13953.46186,775.192325,872.091366,168.041925,7,0
0,0,3,3,10,11,21,22,15,37,0.000333,0.054172,5,812.578723,45.143262,162.515745,71.273029,4,0
0,0,22,22,17,35,52,129,69,198,0.000333,0.376229,8,9029.496514,501.638695,1128.687064,249.011774,8,0
0,0,4,4,7,14,21,20,22,42,0.000333,0.061492,3,553.431995,30.746222,184.477332,72.954453,2,0
0,0,13,13,11,22,33,99,50,149,0.000333,0.250538,10,7516.147238,417.563735,751.614724,136.161243,1,0
0,0,3,3,9,9,18,18,13,31,0.000333,0.043089,4,517.0707,28.72615,129.267675,57.05865,2,0
0,0,3,3,10,8,18,16,13,29,0.000333,0.040309,5,604.639125,33.591063,120.927825,57.219281,3,0
0,0,3,3,9,9,18,18,13,31,0.000333,0.043089,4,517.0707,28.72615,129.267675,57.05865,2,0
0,0,4,4,4,7,11,13,11,24,0.000333,0.027675,2,166.052718,9.225151,83.026359,27.651484,3,0
0,0,19,19,19,27,46,152,72,224,0.000333,0.412426,18,22271.00181,1237.277878,1237.277878,209.092585,9,0
0,0,3,3,10,8,18,16,13,29,0.000333,0.040309,5,604.639125,33.591063,120.927825,57.219281,3,0
0,0,20,20,19,27,46,157,73,230,0.000333,0.423473,18,22867.5465,1270.41925,1270.41925,209.092585,10,0
0,0,4,4,7,9,16,16,12,28,0.000333,0.037333,3,336,18.666667,112,48.180809,3,0
0,0,10,10,18,18,36,60,42,102,0.000333,0.175777,18,9491.982303,527.33235,527.33235,150.1173,6,0
0,0,4,4,11,9,20,24,12,36,0.000333,0.051863,5,777.947057,43.219281,155.589411,66.583073,5,0
0,0,3,3,11,11,22,26,15,41,0.000333,0.060946,5,914.183482,50.787971,182.836696,76.107496,3,0
0,0,4,4,11,10,21,26,17,43,0.000333,0.062957,5,944.348246,52.463791,188.869649,71.273029,2,0
0,0,23,23,13,34,47,157,98,255,0.000333,0.47214,12,16997.04189,944.280105,1416.420157,221.079453,1,0
0,0,3,3,10,8,18,16,13,29,0.000333,0.040309,5,604.639125,33.591063,120.927825,57.219281,3,0
0,0,4,4,6,8,14,17,12,29,0.000333,0.036804,3,331.239878,18.402215,110.413293,39.509775,3,0
0,0,8,8,15,18,33,66,34,100,0.000333,0.168146,7,3531.075884,196.170882,504.439412,133.662009,2,0
0,0,7,7,12,17,29,43,27,70,0.000333,0.113353,6,2040.352018,113.35289,340.05867,112.506418,4,0
0,0,3,3,10,8,18,16,13,29,0.000333,0.040309,5,604.639125,33.591063,120.927825,57.219281,3,0
0,0,3,3,10,8,18,16,13,29,0.000333,0.040309,5,604.639125,33.591063,120.927825,57.219281,3,0
0,0,57,57,28,89,117,584,399,983,0.000333,2.25119,56,378199.8371,21011.10206,6753.568519,710.946213,31,0
0,0,3,3,10,11,21,22,15,37,0.000333,0.054172,5,812.578723,45.143262,162.515745,71.273029,4,0
0,0,3,3,10,11,21,22,15,37,0.000333,0.054172,5,812.578723,45.143262,162.515745,71.273029,4,0
0,0,3,3,10,8,18,16,13,29,0.000333,0.040309,5,604.639125,33.591063,120.927825,57.219281,3,0
0,0,3,3,10,8,18,16,13,29,0.000333,0.040309,5,604.639125,33.591063,120.927825,57.219281,3,0
0,0,3,3,8,4,12,13,6,19,0.000333,0.022705,4,272.45715,15.136508,68.114288,32,2,0
0,0,3,3,10,11,21,22,15,37,0.000333,0.054172,5,812.578723,45.143262,162.515745,71.273029,4,0
0,0,3,3,9,9,18,18,13,31,0.000333,0.043089,4,517.0707,28.72615,129.267675,57.05865,2,0
0,0,4,4,10,12,22,21,17,38,0.000333,0.056486,5,847.292008,47.071778,169.458402,76.238831,1,0
0,0,3,3,10,6,16,19,10,29,0.000333,0.038667,5,580,32.222222,116,48.729056,1,0
0,0,7,7,11,19,30,44,28,72,0.000333,0.117765,5,1766.480614,98.137812,353.296123,118.764371,2,0
0,0,3,3,10,8,18,16,13,29,0.000333,0.040309,5,604.639125,33.591063,120.927825,57.219281,3,0
0,0,12,12,11,19,30,73,36,109,0.000333,0.178284,5,2674.255375,148.569743,534.851075,118.764371,11,0
0,0,3,3,10,11,21,22,15,37,0.000333,0.054172,5,812.578723,45.143262,162.515745,71.273029,4,0
0,0,3,3,8,10,18,20,13,33,0.000333,0.045869,4,550.4301,30.57945,137.607525,57.219281,3,0
0,0,3,3,10,10,20,17,13,30,0.000333,0.043219,5,648.289214,36.016067,129.657843,66.438562,2,0
0,0,6,6,13,13,26,38,23,61,0.000333,0.095576,6,1720.360937,95.575608,286.726823,96.211433,4,0
0,0,7,7,13,15,28,38,24,62,0.000333,0.099352,6,1788.336031,99.352002,298.056005,106.709075,6,0
0,0,4,4,10,12,22,21,17,38,0.000333,0.056486,5,847.292008,47.071778,169.458402,76.238831,1,0
0,0,7,7,11,19,30,44,28,72,0.000333,0.117765,5,1766.480614,98.137812,353.296123,118.764371,2,0
0,0,3,3,10,8,18,16,13,29,0.000333,0.040309,5,604.639125,33.591063,120.927825,57.219281,3,0
0,0,4,4,8,11,19,17,15,32,0.000333,0.045311,4,543.734722,30.207485,135.93368,62.053748,3,0
0,0,3,3,10,8,18,16,13,29,0.000333,0.040309,5,604.639125,33.591063,120.927825,57.219281,3,0
0,0,26,26,17,34,51,136,75,211,0.000333,0.398961,16,19150.10795,1063.894886,1196.881747,242.460605,10,0
0,0,4,4,11,10,21,26,17,43,0.000333,0.062957,5,944.348246,52.463791,188.869649,71.273029,2,0
0,0,4,4,4,6,10,16,12,28,0.000333,0.031005,4,372.055947,20.669775,93.013987,23.509775,1,0
0,0,3,3,10,8,18,16,13,29,0.000333,0.040309,5,604.639125,33.591063,120.927825,57.219281,3,0
0,0,4,4,4,7,11,13,11,24,0.000333,0.027675,2,166.052718,9.225151,83.026359,27.651484,3,0
0,0,3,3,10,8,18,16,13,29,0.000333,0.040309,5,604.639125,33.591063,120.927825,57.219281,3,0
0,0,3,3,8,10,18,17,13,30,0.000333,0.041699,4,500.391,27.7995,125.09775,57.219281,2,0
0,0,4,4,11,10,21,26,17,43,0.000333,0.062957,5,944.348246,52.463791,188.869649,71.273029,2,0
0,0,3,3,10,6,16,19,10,29,0.000333,0.038667,5,580,32.222222,116,48.729056,1,0
0,0,3,3,10,8,18,16,13,29,0.000333,0.040309,5,604.639125,33.591063,120.927825,57.219281,3,0
0,0,33,33,19,47,66,167,100,267,0.000333,0.537951,18,29049.35814,1613.85323,1613.85323,341.776299,13,0
0,0,10,10,16,24,40,84,58,142,0.000333,0.251905,16,12091.42063,671.745591,755.713789,174.0391,2,0
0,0,19,19,14,34,48,111,61,172,0.000333,0.320205,7,6724.294851,373.571936,960.61355,226.276706,7,0
0,0,16,16,13,28,41,100,52,152,0.000333,0.271449,6,4886.087428,271.449302,814.347905,182.711654,5,0
0,0,3,3,10,6,16,19,10,29,0.000333,0.038667,5,580,32.222222,116,48.729056,1,0
0,0,10,10,10,17,27,41,26,67,0.000333,0.106192,5,1592.887313,88.49374,318.577463,102.706149,3,0
0,0,13,13,15,27,42,75,58,133,0.000333,0.239059,14,10040.49504,557.80528,717.178217,186.985321,4,0
0,0,16,16,13,26,39,88,49,137,0.000333,0.241367,6,4344.600624,241.366701,724.100104,170.317149,5,0
0,0,3,3,11,11,22,26,15,41,0.000333,0.060946,5,914.183482,50.787971,182.836696,76.107496,3,0
0,0,3,3,10,8,18,16,13,29,0.000333,0.040309,5,604.639125,33.591063,120.927825,57.219281,3,0
0,0,7,7,11,19,30,44,28,72,0.000333,0.117765,5,1766.480614,98.137812,353.296123,118.764371,2,0
0,0,3,3,10,8,18,16,13,29,0.000333,0.040309,5,604.639125,33.591063,120.927825,57.219281,3,0
0,0,3,3,10,8,18,16,13,29,0.000333,0.040309,5,604.639125,33.591063,120.927825,57.219281,3,0
0,0,5,5,10,10,20,27,14,41,0.000333,0.059066,5,885.995259,49.221959,177.199052,66.438562,3,0
0,0,3,3,10,8,18,16,13,29,0.000333,0.040309,5,604.639125,33.591063,120.927825,57.219281,3,0
0,0,8,8,15,20,35,41,36,77,0.000333,0.131652,7,2764.683546,153.59353,394.954792,145.041921,4,0
0,0,3,3,10,8,18,16,13,29,0.000333,0.040309,5,604.639125,33.591063,120.927825,57.219281,3,0
0,0,7,7,11,19,30,44,28,72,0.000333,0.117765,5,1766.480614,98.137812,353.296123,118.764371,2,0
0,0,3,3,9,9,18,18,13,31,0.000333,0.043089,4,517.0707,28.72615,129.267675,57.05865,2,0
0,0,7,7,12,17,29,37,30,67,0.000333,0.108495,6,1952.90836,108.494909,325.484727,112.506418,4,0
0,0,6,6,10,15,25,28,22,50,0.000333,0.077398,5,1160.964047,64.498003,232.192809,91.82264,1,0
0,0,8,8,16,19,35,42,34,76,0.000333,0.129942,8,3118.604074,173.255782,389.825509,144.710623,4,0
0,0,8,8,16,13,29,53,32,85,0.000333,0.137643,16,6606.854153,367.047453,412.928385,112.105716,6,0
0,0,4,4,11,10,21,26,17,43,0.000333,0.062957,5,944.348246,52.463791,188.869649,71.273029,2,0
0,0,3,3,7,9,16,17,12,29,0.000333,0.038667,3,348,19.333333,116,48.180809,2,0
0,0,7,7,11,19,30,44,28,72,0.000333,0.117765,5,1766.480614,98.137812,353.296123,118.764371,2,0
0,0,3,3,9,9,18,18,13,31,0.000333,0.043089,4,517.0707,28.72615,129.267675,57.05865,2,0
0,0,3,3,10,8,18,16,13,29,0.000333,0.040309,5,604.639125,33.591063,120.927825,57.219281,3,0
0,0,3,3,10,8,18,16,13,29,0.000333,0.040309,5,604.639125,33.591063,120.927825,57.219281,3,0
0,0,6,6,8,18,26,40,27,67,0.000333,0.104976,4,1259.717844,69.984325,314.929461,99.05865,1,0
0,0,7,7,12,17,29,43,27,70,0.000333,0.113353,6,2040.352018,113.35289,340.05867,112.506418,4,0
0,0,3,3,10,8,18,16,13,29,0.000333,0.040309,5,604.639125,33.591063,120.927825,57.219281,3,0
0,0,7,7,10,13,23,37,19,56,0.000333,0.08444,5,1266.597348,70.366519,253.31947,81.324997,3,0
0,0,5,5,7,9,16,23,14,37,0.000333,0.049333,3,444,24.666667,148,48.180809,1,0
0,0,3,3,9,11,20,19,16,35,0.000333,0.050422,4,605.069933,33.614996,151.267483,66.583073,1,0
0,0,7,7,11,19,30,44,28,72,0.000333,0.117765,5,1766.480614,98.137812,353.296123,118.764371,2,0
0,0,7,7,11,19,30,44,28,72,0.000333,0.117765,5,1766.480614,98.137812,353.296123,118.764371,2,0
0,0,17,17,16,23,39,110,55,165,0.000333,0.290697,16,13953.46186,775.192325,872.091366,168.041925,7,0
0,0,3,3,10,8,18,16,13,29,0.000333,0.040309,5,604.639125,33.591063,120.927825,57.219281,3,0
0,0,6,6,11,15,26,30,22,52,0.000333,0.081474,5,1222.114327,67.89524,244.422865,96.657107,1,0
0,0,3,3,10,8,18,16,13,29,0.000333,0.040309,5,604.639125,33.591063,120.927825,57.219281,3,0
0,0,3,3,6,10,16,10,16,26,0.000333,0.034667,3,312,17.333333,104,48.729056,1,0
0,0,6,6,9,17,26,26,23,49,0.000333,0.076774,4,921.286185,51.182566,230.321546,98.016193,3,0
0,0,8,8,15,18,33,66,34,100,0.000333,0.168146,7,3531.075884,196.170882,504.439412,133.662009,2,0
0,0,27,27,17,38,55,143,76,219,0.000333,0.422039,16,20257.88444,1125.438024,1266.117777,268.908114,10,0
0,0,11,11,15,21,36,84,43,127,0.000333,0.21886,14,9192.126653,510.673703,656.580475,150.842025,2,0
0,0,4,4,4,7,11,13,11,24,0.000333,0.027675,2,166.052718,9.225151,83.026359,27.651484,3,0
0,0,4,4,11,10,21,26,17,43,0.000333,0.062957,5,944.348246,52.463791,188.869649,71.273029,2,0
0,0,7,7,11,19,30,44,28,72,0.000333,0.117765,5,1766.480614,98.137812,353.296123,118.764371,2,0
0,0,3,3,10,8,18,16,13,29,0.000333,0.040309,5,604.639125,33.591063,120.927825,57.219281,3,0
0,0,3,3,10,8,18,16,13,29,0.000333,0.040309,5,604.639125,33.591063,120.927825,57.219281,3,0
0,0,3,3,10,8,18,16,13,29,0.000333,0.040309,5,604.639125,33.591063,120.927825,57.219281,3,0
0,0,3,3,11,11,22,26,15,41,0.000333,0.060946,5,914.183482,50.787971,182.836696,76.107496,3,0
0,0,3,3,11,11,22,26,15,41,0.000333,0.060946,5,914.183482,50.787971,182.836696,76.107496,3,0
0,0,14,14,11,35,46,79,67,146,0.000333,0.268813,5,4032.200228,224.011124,806.440046,217.578653,6,0
0,0,4,4,4,7,11,13,11,24,0.000333,0.027675,2,166.052718,9.225151,83.026359,27.651484,3,0
0,0,7,7,11,19,30,44,28,72,0.000333,0.117765,5,1766.480614,98.137812,353.296123,118.764371,2,0
0,0,6,6,13,13,26,38,23,61,0.000333,0.095576,6,1720.360937,95.575608,286.726823,96.211433,4,0
0,0,7,7,12,17,29,43,27,70,0.000333,0.113353,6,2040.352018,113.35289,340.05867,112.506418,4,0
0,0,3,3,10,9,19,37,16,53,0.000333,0.075047,5,1125.700791,62.538933,225.140158,61.748606,10,0
0,0,4,4,10,9,19,46,19,65,0.000333,0.092038,10,2761.152884,153.397382,276.115288,61.748606,11,0
0,0,13,13,15,27,42,75,58,133,0.000333,0.239059,14,10040.49504,557.80528,717.178217,186.985321,4,0
0,0,3,3,10,8,18,16,13,29,0.000333,0.040309,5,604.639125,33.591063,120.927825,57.219281,3,0
0,0,4,4,7,12,19,20,18,38,0.000333,0.053807,3,484.263737,26.903541,161.421246,62.671034,2,0
0,0,3,3,9,9,18,18,13,31,0.000333,0.043089,4,517.0707,28.72615,129.267675,57.05865,2,0
0,0,17,17,16,23,39,110,55,165,0.000333,0.290697,16,13953.46186,775.192325,872.091366,168.041925,7,0
0,0,3,3,11,11,22,26,15,41,0.000333,0.060946,5,914.183482,50.787971,182.836696,76.107496,3,0
0,0,4,4,11,10,21,26,17,43,0.000333,0.062957,5,944.348246,52.463791,188.869649,71.273029,2,0
0,0,3,3,10,9,19,23,12,35,0.000333,0.049559,5,743.387315,41.299295,148.677463,61.748606,3,0
0,0,6,6,9,13,22,31,19,50,0.000333,0.074324,4,891.886324,49.54924,222.971581,76.635041,1,0
0,0,3,3,11,11,22,26,15,41,0.000333,0.060946,5,914.183482,50.787971,182.836696,76.107496,3,0
0,0,3,3,10,10,20,17,13,30,0.000333,0.043219,5,648.289214,36.016067,129.657843,66.438562,2,0
0,0,4,4,10,12,22,21,17,38,0.000333,0.056486,5,847.292008,47.071778,169.458402,76.238831,1,0
0,0,3,3,10,8,18,16,13,29,0.000333,0.040309,5,604.639125,33.591063,120.927825,57.219281,3,0
0,0,19,19,18,32,50,569,81,650,0.000333,1.222836,18,66033.11742,3668.506523,3668.506523,235.05865,16,0
0,0,15,15,12,24,36,88,45,133,0.000333,0.2292,6,4125.600151,229.200008,687.600025,153.05865,5,0
0,0,3,3,10,8,18,16,13,29,0.000333,0.040309,5,604.639125,33.591063,120.927825,57.219281,3,0
0,0,7,7,11,18,29,48,28,76,0.000333,0.123069,5,1846.032778,102.557377,369.206556,113.112398,1,0
0,0,37,37,21,47,68,188,117,305,0.000333,0.618892,20,37133.52333,2062.973518,1856.676167,353.304342,16,0
0,0,3,3,10,8,18,16,13,29,0.000333,0.040309,5,604.639125,33.591063,120.927825,57.219281,3,0
0,0,6,6,9,18,27,24,23,47,0.000333,0.074493,4,893.91885,49.662158,223.479713,103.587975,3,0
0,0,4,4,11,10,21,26,17,43,0.000333,0.062957,5,944.348246,52.463791,188.869649,71.273029,2,0
0,0,11,11,15,21,36,84,43,127,0.000333,0.21886,14,9192.126653,510.673703,656.580475,150.842025,2,0
0,0,8,8,15,18,33,66,34,100,0.000333,0.168146,7,3531.075884,196.170882,504.439412,133.662009,2,0
0,0,4,4,4,7,11,13,11,24,0.000333,0.027675,2,166.052718,9.225151,83.026359,27.651484,3,0
0,0,4,4,7,9,16,16,12,28,0.000333,0.037333,3,336,18.666667,112,48.180809,3,0
0,0,4,4,4,7,11,13,11,24,0.000333,0.027675,2,166.052718,9.225151,83.026359,27.651484,3,0
0,0,7,7,11,19,30,44,28,72,0.000333,0.117765,5,1766.480614,98.137812,353.296123,118.764371,2,0
0,0,4,4,6,8,14,17,12,29,0.000333,0.036804,3,331.239878,18.402215,110.413293,39.509775,3,0
0,0,7,7,11,19,30,44,28,72,0.000333,0.117765,5,1766.480614,98.137812,353.296123,118.764371,2,0
0,0,8,8,16,13,29,53,32,85,0.000333,0.137643,16,6606.854153,367.047453,412.928385,112.105716,6,0
0,0,3,3,10,8,18,16,13,29,0.000333,0.040309,5,604.639125,33.591063,120.927825,57.219281,3,0
0,0,4,4,6,8,14,17,12,29,0.000333,0.036804,3,331.239878,18.402215,110.413293,39.509775,3,0
0,0,4,4,11,12,23,20,16,36,0.000333,0.054283,5,814.241152,45.23562,162.84823,81.073298,2,0
0,0,10,10,15,16,31,57,38,95,0.000333,0.156883,14,6589.081093,366.060061,470.648649,122.603359,4,0
0,0,4,4,10,12,22,21,17,38,0.000333,0.056486,5,847.292008,47.071778,169.458402,76.238831,1,0
0,0,3,3,10,8,18,16,13,29,0.000333,0.040309,5,604.639125,33.591063,120.927825,57.219281,3,0
0,0,6,6,13,13,26,38,23,61,0.000333,0.095576,6,1720.360937,95.575608,286.726823,96.211433,4,0
0,0,8,8,14,17,31,44,30,74,0.000333,0.122204,7,2566.273689,142.57076,366.610527,122.789837,4,0
0,0,7,7,11,19,30,44,28,72,0.000333,0.117765,5,1766.480614,98.137812,353.296123,118.764371,2,0
0,0,7,7,11,19,30,44,28,72,0.000333,0.117765,5,1766.480614,98.137812,353.296123,118.764371,2,0
0,0,9,9,13,21,34,49,34,83,0.000333,0.140753,6,2533.556495,140.753139,422.259416,140.344382,4,0
0,0,27,27,17,36,53,141,77,218,0.000333,0.416229,16,19978.98655,1109.943697,1248.686659,255.604168,10,0
0,0,3,3,10,8,18,16,13,29,0.000333,0.040309,5,604.639125,33.591063,120.927825,57.219281,3,0
0,0,4,4,10,12,22,21,17,38,0.000333,0.056486,5,847.292008,47.071778,169.458402,76.238831,1,0
0,0,17,17,16,23,39,110,55,165,0.000333,0.290697,16,13953.46186,775.192325,872.091366,168.041925,7,0
0,0,3,3,10,6,16,19,10,29,0.000333,0.038667,5,580,32.222222,116,48.729056,1,0
0,0,14,14,11,35,46,79,67,146,0.000333,0.268813,5,4032.200228,224.011124,806.440046,217.578653,6,0
0,0,23,23,17,33,50,204,107,311,0.000333,0.58508,24,42125.7426,2340.319033,1755.239275,235.951874,9,0
0,0,3,3,10,8,18,16,13,29,0.000333,0.040309,5,604.639125,33.591063,120.927825,57.219281,3,0
0,0,4,4,4,7,11,13,11,24,0.000333,0.027675,2,166.052718,9.225151,83.026359,27.651484,3,0
0,0,4,4,11,10,21,26,17,43,0.000333,0.062957,5,944.348246,52.463791,188.869649,71.273029,2,0
0,0,3,3,10,6,16,19,10,29,0.000333,0.038667,5,580,32.222222,116,48.729056,1,0
0,0,7,7,11,19,30,44,28,72,0.000333,0.117765,5,1766.480614,98.137812,353.296123,118.764371,2,0
0,0,5,5,8,9,17,318,14,332,0.000333,0.452346,4,5428.150653,301.563925,1357.037663,52.529325,1,0
0,0,4,4,7,15,22,20,24,44,0.000333,0.065405,3,588.644974,32.702499,196.214991,78.254843,2,0
0,0,3,3,9,9,18,18,13,31,0.000333,0.043089,4,517.0707,28.72615,129.267675,57.05865,2,0
0,0,7,7,12,16,28,36,29,65,0.000333,0.104159,6,1874.86842,104.159357,312.47807,107.01955,4,0
0,0,3,3,9,9,18,18,13,31,0.000333,0.043089,4,517.0707,28.72615,129.267675,57.05865,2,0
0,0,7,7,11,19,30,44,28,72,0.000333,0.117765,5,1766.480614,98.137812,353.296123,118.764371,2,0
0,0,7,7,11,19,30,44,28,72,0.000333,0.117765,5,1766.480614,98.137812,353.296123,118.764371,2,0
0,0,6,6,15,15,30,35,24,59,0.000333,0.096502,7,2026.545816,112.585879,289.506545,117.206718,4,0
0,0,3,3,10,8,18,16,13,29,0.000333,0.040309,5,604.639125,33.591063,120.927825,57.219281,3,0
0,0,5,5,10,10,20,27,14,41,0.000333,0.059066,5,885.995259,49.221959,177.199052,66.438562,3,0
0,0,3,3,10,10,20,17,13,30,0.000333,0.043219,5,648.289214,36.016067,129.657843,66.438562,2,0
0,0,3,3,11,11,22,26,15,41,0.000333,0.060946,5,914.183482,50.787971,182.836696,76.107496,3,0
0,0,10,10,15,22,37,50,44,94,0.000333,0.16323,14,6855.640629,380.868924,489.688616,156.710855,4,0
0,0,7,7,11,19,30,44,28,72,0.000333,0.117765,5,1766.480614,98.137812,353.296123,118.764371,2,0
0,0,4,4,11,10,21,26,17,43,0.000333,0.062957,5,944.348246,52.463791,188.869649,71.273029,2,0
0,0,6,6,13,13,26,38,23,61,0.000333,0.095576,6,1720.360937,95.575608,286.726823,96.211433,4,0
0,0,7,7,11,19,30,44,28,72,0.000333,0.117765,5,1766.480614,98.137812,353.296123,118.764371,2,0
0,0,3,3,10,8,18,16,13,29,0.000333,0.040309,5,604.639125,33.591063,120.927825,57.219281,3,0
0,0,8,8,12,13,25,41,24,65,0.000333,0.100617,6,1811.103914,100.616884,301.850652,91.125266,4,0
0,0,5,5,11,13,24,27,22,49,0.000333,0.074888,5,1123.315813,62.406434,224.663163,86.159464,2,0
0,0,3,3,10,8,18,16,13,29,0.000333,0.040309,5,604.639125,33.591063,120.927825,57.219281,3,0
0,0,5,5,7,14,21,34,20,54,0.000333,0.079062,3,711.555422,39.530857,237.185141,72.954453,1,0
0,0,3,3,8,9,17,17,12,29,0.000333,0.039512,4,474.14569,26.341427,118.536422,52.529325,2,0
0,0,3,3,9,9,18,18,13,31,0.000333,0.043089,4,517.0707,28.72615,129.267675,57.05865,2,0
0,0,3,3,10,11,21,22,15,37,0.000333,0.054172,5,812.578723,45.143262,162.515745,71.273029,4,0
0,0,6,6,13,13,26,38,23,61,0.000333,0.095576,6,1720.360937,95.575608,286.726823,96.211433,4,0
0,0,3,3,9,9,18,18,13,31,0.000333,0.043089,4,517.0707,28.72615,129.267675,57.05865,2,0
0,0,3,3,10,8,18,16,13,29,0.000333,0.040309,5,604.639125,33.591063,120.927825,57.219281,3,0
0,0,14,14,12,22,34,81,42,123,0.000333,0.208586,6,3754.547577,208.585976,625.757929,141.127046,5,0
0,0,3,3,10,8,18,16,13,29,0.000333,0.040309,5,604.639125,33.591063,120.927825,57.219281,3,0
0,0,6,6,15,15,30,35,24,59,0.000333,0.096502,7,2026.545816,112.585879,289.506545,117.206718,4,0
0,0,3,3,9,11,20,19,16,35,0.000333,0.050422,4,605.069933,33.614996,151.267483,66.583073,1,0
0,0,7,7,11,19,30,44,28,72,0.000333,0.117765,5,1766.480614,98.137812,353.296123,118.764371,2,0
0,0,3,3,10,8,18,16,13,29,0.000333,0.040309,5,604.639125,33.591063,120.927825,57.219281,3,0
0,0,3,3,10,10,20,17,13,30,0.000333,0.043219,5,648.289214,36.016067,129.657843,66.438562,2,0
0,0,4,4,6,8,14,23,14,37,0.000333,0.046957,3,422.616396,23.478689,140.872132,39.509775,1,0
0,0,11,11,15,21,36,84,43,127,0.000333,0.21886,14,9192.126653,510.673703,656.580475,150.842025,2,0
0,0,21,21,13,30,43,130,67,197,0.000333,0.356325,12,12827.68988,712.649438,1068.974157,195.312434,11,0
0,0,3,3,10,8,18,16,13,29,0.000333,0.040309,5,604.639125,33.591063,120.927825,57.219281,3,0
0,0,7,7,12,17,29,43,27,70,0.000333,0.113353,6,2040.352018,113.35289,340.05867,112.506418,4,0
0,0,7,7,11,19,30,44,28,72,0.000333,0.117765,5,1766.480614,98.137812,353.296123,118.764371,2,0
0,0,6,6,8,10,18,26,18,44,0.000333,0.061159,4,733.9068,40.7726,183.4767,57.219281,1,0
0,0,3,3,10,6,16,19,10,29,0.000333,0.038667,5,580,32.222222,116,48.729056,1,0
0,0,3,3,10,8,18,16,13,29,0.000333,0.040309,5,604.639125,33.591063,120.927825,57.219281,3,0
0,0,3,3,10,8,18,16,13,29,0.000333,0.040309,5,604.639125,33.591063,120.927825,57.219281,3,0
0,0,3,3,10,8,18,16,13,29,0.000333,0.040309,5,604.639125,33.591063,120.927825,57.219281,3,0
0,0,7,7,10,16,26,49,38,87,0.000333,0.136313,10,4089.382555,227.18792,408.938255,97.219281,2,0
0,0,7,7,11,19,30,44,28,72,0.000333,0.117765,5,1766.480614,98.137812,353.296123,118.764371,2,0
0,0,7,7,11,19,30,44,28,72,0.000333,0.117765,5,1766.480614,98.137812,353.296123,118.764371,2,0
0,0,7,7,11,19,30,44,28,72,0.000333,0.117765,5,1766.480614,98.137812,353.296123,118.764371,2,0
0,0,4,4,10,12,22,21,17,38,0.000333,0.056486,5,847.292008,47.071778,169.458402,76.238831,1,0
0,0,7,7,11,19,30,44,28,72,0.000333,0.117765,5,1766.480614,98.137812,353.296123,118.764371,2,0
0,0,9,9,13,22,35,49,37,86,0.000333,0.147039,6,2646.710037,147.039446,441.118339,146.213212,4,0
0,0,4,4,10,12,22,28,16,44,0.000333,0.065405,5,981.074956,54.504164,196.214991,76.238831,3,0
0,0,9,9,16,24,40,75,54,129,0.000333,0.228843,16,10984.45959,610.247755,686.528724,174.0391,2,0
0,0,3,3,10,10,20,17,13,30,0.000333,0.043219,5,648.289214,36.016067,129.657843,66.438562,2,0
0,0,3,3,5,6,11,9,8,17,0.000333,0.019603,2,117.620675,6.534482,58.810338,27.119415,1,0
0,0,27,27,17,36,53,141,77,218,0.000333,0.416229,16,19978.98655,1109.943697,1248.686659,255.604168,10,0
0,0,3,3,10,8,18,16,13,29,0.000333,0.040309,5,604.639125,33.591063,120.927825,57.219281,3,0
0,0,3,3,9,9,18,18,13,31,0.000333,0.043089,4,517.0707,28.72615,129.267675,57.05865,2,0
0,0,4,4,4,7,11,13,11,24,0.000333,0.027675,2,166.052718,9.225151,83.026359,27.651484,3,0
0,0,3,3,10,8,18,16,13,29,0.000333,0.040309,5,604.639125,33.591063,120.927825,57.219281,3,0
0,0,3,3,8,10,18,20,13,33,0.000333,0.045869,4,550.4301,30.57945,137.607525,57.219281,3,0
0,0,4,4,10,9,19,23,14,37,0.000333,0.052391,5,785.86659,43.659255,157.173318,61.748606,2,0
0,0,4,4,4,7,11,13,11,24,0.000333,0.027675,2,166.052718,9.225151,83.026359,27.651484,3,0
0,0,7,7,10,14,24,34,26,60,0.000333,0.091699,5,1375.48875,76.416042,275.09775,86.52225,2,0
0,0,17,17,16,23,39,110,55,165,0.000333,0.290697,16,13953.46186,775.192325,872.091366,168.041925,7,0
0,0,3,3,9,9,18,18,13,31,0.000333,0.043089,4,517.0707,28.72615,129.267675,57.05865,2,0
0,0,4,4,4,7,11,13,11,24,0.000333,0.027675,2,166.052718,9.225151,83.026359,27.651484,3,0
0,0,3,3,10,8,18,16,13,29,0.000333,0.040309,5,604.639125,33.591063,120.927825,57.219281,3,0
0,0,6,6,8,13,21,25,19,44,0.000333,0.064421,4,773.047866,42.947104,193.261967,72.105716,3,0
0,0,10,10,17,15,32,59,37,96,0.000333,0.16,16,7680,426.666667,480,128.090227,6,0
0,0,3,3,5,6,11,9,8,17,0.000333,0.019603,2,117.620675,6.534482,58.810338,27.119415,1,0
0,0,7,7,11,19,30,44,28,72,0.000333,0.117765,5,1766.480614,98.137812,353.296123,118.764371,2,0
0,0,6,6,9,17,26,26,23,49,0.000333,0.076774,4,921.286185,51.182566,230.321546,98.016193,3,0
0,0,4,4,4,7,11,13,11,24,0.000333,0.027675,2,166.052718,9.225151,83.026359,27.651484,3,0
0,0,4,4,9,8,17,19,11,30,0.000333,0.040875,4,490.495541,27.249752,122.623885,52.529325,2,0
0,0,5,5,12,16,28,39,25,64,0.000333,0.102557,6,1846.02429,102.556905,307.670715,107.01955,2,0
0,0,5,5,10,10,20,27,14,41,0.000333,0.059066,5,885.995259,49.221959,177.199052,66.438562,3,0
0,0,3,3,10,8,18,16,13,29,0.000333,0.040309,5,604.639125,33.591063,120.927825,57.219281,3,0
0,0,3,3,10,8,18,16,13,29,0.000333,0.040309,5,604.639125,33.591063,120.927825,57.219281,3,0
0,0,3,3,10,8,18,16,13,29,0.000333,0.040309,5,604.639125,33.591063,120.927825,57.219281,3,0
0,0,7,7,11,19,30,44,28,72,0.000333,0.117765,5,1766.480614,98.137812,353.296123,118.764371,2,0
0,0,12,12,13,25,38,65,51,116,0.000333,0.20292,12,7305.115099,405.839728,608.759592,164.202121,4,0
0,0,7,7,11,19,30,44,28,72,0.000333,0.117765,5,1766.480614,98.137812,353.296123,118.764371,2,0
0,0,3,3,11,11,22,26,15,41,0.000333,0.060946,5,914.183482,50.787971,182.836696,76.107496,3,0
0,0,3,3,10,8,18,16,13,29,0.000333,0.040309,5,604.639125,33.591063,120.927825,57.219281,3,0
0,0,3,3,10,9,19,37,16,53,0.000333,0.075047,5,1125.700791,62.538933,225.140158,61.748606,10,0
0,0,3,3,10,8,18,16,13,29,0.000333,0.040309,5,604.639125,33.591063,120.927825,57.219281,3,0
0,0,3,3,10,8,18,16,13,29,0.000333,0.040309,5,604.639125,33.591063,120.927825,57.219281,3,0
0,0,3,3,9,9,18,18,13,31,0.000333,0.043089,4,517.0707,28.72615,129.267675,57.05865,2,0
0,0,6,6,13,11,24,38,23,61,0.000333,0.093228,12,3356.192551,186.455142,279.682713,86.159464,4,0
0,0,3,3,10,8,18,16,13,29,0.000333,0.040309,5,604.639125,33.591063,120.927825,57.219281,3,0
0,0,4,4,11,10,21,26,17,43,0.000333,0.062957,5,944.348246,52.463791,188.869649,71.273029,2,0
0,0,19,19,14,26,40,136,77,213,0.000333,0.377857,14,15869.98958,881.666088,1133.570684,175.514402,5,0
0,0,4,4,11,9,20,24,12,36,0.000333,0.051863,5,777.947057,43.219281,155.589411,66.583073,5,0
0,0,7,7,11,19,30,44,28,72,0.000333,0.117765,5,1766.480614,98.137812,353.296123,118.764371,2,0
0,0,7,7,11,19,30,44,28,72,0.000333,0.117765,5,1766.480614,98.137812,353.296123,118.764371,2,0
0,0,4,4,11,9,20,24,12,36,0.000333,0.051863,5,777.947057,43.219281,155.589411,66.583073,5,0
0,0,7,7,11,19,30,44,28,72,0.000333,0.117765,5,1766.480614,98.137812,353.296123,118.764371,2,0
0,0,4,4,12,12,24,42,17,59,0.000333,0.090171,6,1623.076725,90.170929,270.512788,86.0391,5,0
0,0,4,4,4,7,11,13,11,24,0.000333,0.027675,2,166.052718,9.225151,83.026359,27.651484,3,0
0,0,3,3,10,8,18,16,13,29,0.000333,0.040309,5,604.639125,33.591063,120.927825,57.219281,3,0
0,0,7,7,11,19,30,44,28,72,0.000333,0.117765,5,1766.480614,98.137812,353.296123,118.764371,2,0
0,0,3,3,10,8,18,16,13,29,0.000333,0.040309,5,604.639125,33.591063,120.927825,57.219281,3,0
0,0,4,4,10,12,22,21,17,38,0.000333,0.056486,5,847.292008,47.071778,169.458402,76.238831,1,0
0,0,3,3,10,8,18,16,13,29,0.000333,0.040309,5,604.639125,33.591063,120.927825,57.219281,3,0
0,0,17,17,16,23,39,110,55,165,0.000333,0.290697,16,13953.46186,775.192325,872.091366,168.041925,7,0
0,0,4,4,4,7,11,13,11,24,0.000333,0.027675,2,166.052718,9.225151,83.026359,27.651484,3,0
0,0,4,4,5,9,14,18,12,30,0.000333,0.038074,2,228.441295,12.691183,114.220648,40.138965,1,0
0,0,4,4,8,11,19,17,15,32,0.000333,0.045311,4,543.734722,30.207485,135.93368,62.053748,3,0
0,0,3,3,10,6,16,19,10,29,0.000333,0.038667,5,580,32.222222,116,48.729056,1,0
0,0,5,5,11,14,25,28,25,53,0.000333,0.082041,5,1230.62189,68.367883,246.124378,91.356717,2,0
0,0,4,4,4,7,11,13,11,24,0.000333,0.027675,2,166.052718,9.225151,83.026359,27.651484,3,0
0,0,4,4,8,11,19,17,15,32,0.000333,0.045311,4,543.734722,30.207485,135.93368,62.053748,3,0
0,0,17,17,16,23,39,110,55,165,0.000333,0.290697,16,13953.46186,775.192325,872.091366,168.041925,7,0
0,0,20,20,19,27,46,157,73,230,0.000333,0.423473,18,22867.5465,1270.41925,1270.41925,209.092585,10,0
0,0,3,3,10,8,18,16,13,29,0.000333,0.040309,5,604.639125,33.591063,120.927825,57.219281,3,0
0,0,6,6,9,18,27,24,23,47,0.000333,0.074493,4,893.91885,49.662158,223.479713,103.587975,3,0
0,0,6,6,9,18,27,24,23,47,0.000333,0.074493,4,893.91885,49.662158,223.479713,103.587975,3,0
0,0,3,3,10,8,18,16,13,29,0.000333,0.040309,5,604.639125,33.591063,120.927825,57.219281,3,0
0,0,15,15,11,20,31,98,43,141,0.000333,0.232847,10,6985.416798,388.078711,698.54168,124.49231,6,0
0,0,13,13,14,27,41,79,47,126,0.000333,0.225017,7,4725.360868,262.520048,675.051553,181.684931,2,0
0,0,19,19,19,27,46,152,72,224,0.000333,0.412426,18,22271.00181,1237.277878,1237.277878,209.092585,9,0
0,0,4,4,4,7,11,13,11,24,0.000333,0.027675,2,166.052718,9.225151,83.026359,27.651484,3,0
0,0,7,7,11,19,30,44,28,72,0.000333,0.117765,5,1766.480614,98.137812,353.296123,118.764371,2,0
0,0,5,5,10,10,20,27,14,41,0.000333,0.059066,5,885.995259,49.221959,177.199052,66.438562,3,0
0,0,4,4,4,7,11,13,11,24,0.000333,0.027675,2,166.052718,9.225151,83.026359,27.651484,3,0
0,0,3,3,10,8,18,16,13,29,0.000333,0.040309,5,604.639125,33.591063,120.927825,57.219281,3,0
0,0,7,7,11,19,30,44,28,72,0.000333,0.117765,5,1766.480614,98.137812,353.296123,118.764371,2,0
0,0,7,7,11,19,30,44,28,72,0.000333,0.117765,5,1766.480614,98.137812,353.296123,118.764371,2,0
0,0,7,7,11,19,30,44,28,72,0.000333,0.117765,5,1766.480614,98.137812,353.296123,118.764371,2,0
0,0,29,29,22,49,71,182,138,320,0.000333,0.655973,22,43294.21972,2405.234429,1967.919078,373.228278,5,0
0,0,7,7,11,19,30,44,28,72,0.000333,0.117765,5,1766.480614,98.137812,353.296123,118.764371,2,0
0,0,3,3,9,9,18,18,13,31,0.000333,0.043089,4,517.0707,28.72615,129.267675,57.05865,2,0
0,0,5,5,10,11,21,27,16,43,0.000333,0.062957,5,944.348246,52.463791,188.869649,71.273029,1,0
0,0,7,7,11,19,30,44,28,72,0.000333,0.117765,5,1766.480614,98.137812,353.296123,118.764371,2,0
0,0,7,7,10,14,24,34,26,60,0.000333,0.091699,5,1375.48875,76.416042,275.09775,86.52225,2,0
0,0,4,4,4,7,11,13,11,24,0.000333,0.027675,2,166.052718,9.225151,83.026359,27.651484,3,0
0,0,3,3,10,8,18,16,13,29,0.000333,0.040309,5,604.639125,33.591063,120.927825,57.219281,3,0
0,0,7,7,11,19,30,44,28,72,0.000333,0.117765,5,1766.480614,98.137812,353.296123,118.764371,2,0
0,0,3,3,10,8,18,16,13,29,0.000333,0.040309,5,604.639125,33.591063,120.927825,57.219281,3,0
0,0,4,4,10,12,22,21,17,38,0.000333,0.056486,5,847.292008,47.071778,169.458402,76.238831,1,0
0,0,7,7,11,19,30,44,28,72,0.000333,0.117765,5,1766.480614,98.137812,353.296123,118.764371,2,0
0,0,36,36,21,47,68,186,116,302,0.000333,0.612805,20,36768.27556,2042.681976,1838.413778,353.304342,16,0
0,0,7,7,11,19,30,44,28,72,0.000333,0.117765,5,1766.480614,98.137812,353.296123,118.764371,2,0
0,0,3,3,10,8,18,16,13,29,0.000333,0.040309,5,604.639125,33.591063,120.927825,57.219281,3,0
0,0,3,3,9,9,18,18,13,31,0.000333,0.043089,4,517.0707,28.72615,129.267675,57.05865,2,0
0,0,7,7,11,19,30,44,28,72,0.000333,0.117765,5,1766.480614,98.137812,353.296123,118.764371,2,0
0,0,4,4,13,8,21,27,11,38,0.000333,0.055636,6,1001.448372,55.636021,166.908062,72.105716,3,0
0,0,4,4,6,8,14,17,12,29,0.000333,0.036804,3,331.239878,18.402215,110.413293,39.509775,3,0
0,0,4,4,6,8,14,17,12,29,0.000333,0.036804,3,331.239878,18.402215,110.413293,39.509775,3,0
0,0,3,3,8,10,18,17,13,30,0.000333,0.041699,4,500.391,27.7995,125.09775,57.219281,2,0
0,0,4,4,10,12,22,21,17,38,0.000333,0.056486,5,847.292008,47.071778,169.458402,76.238831,1,0
0,0,11,11,13,24,37,57,47,104,0.000333,0.180594,6,3250.6989,180.594383,541.78315,158.144816,4,0
0,0,9,9,10,19,29,39,30,69,0.000333,0.111734,5,1676.003443,93.111302,335.200689,113.929904,3,0
0,0,3,3,10,10,20,17,13,30,0.000333,0.043219,5,648.289214,36.016067,129.657843,66.438562,2,0
0,0,4,4,4,7,11,13,11,24,0.000333,0.027675,2,166.052718,9.225151,83.026359,27.651484,3,0
0,0,3,3,10,8,18,16,13,29,0.000333,0.040309,5,604.639125,33.591063,120.927825,57.219281,3,0
0,0,4,4,7,13,20,20,20,40,0.000333,0.057626,3,518.631371,28.812854,172.877124,67.757201,2,0
0,0,17,17,16,23,39,110,55,165,0.000333,0.290697,16,13953.46186,775.192325,872.091366,168.041925,7,0
0,0,3,3,9,9,18,18,13,31,0.000333,0.043089,4,517.0707,28.72615,129.267675,57.05865,2,0
0,0,7,7,11,19,30,44,28,72,0.000333,0.117765,5,1766.480614,98.137812,353.296123,118.764371,2,0
0,0,3,3,10,8,18,16,13,29,0.000333,0.040309,5,604.639125,33.591063,120.927825,57.219281,3,0
0,0,7,7,9,21,30,28,27,55,0.000333,0.08996,4,1079.515931,59.973107,269.878983,120.767991,3,0
0,0,3,3,10,8,18,16,13,29,0.000333,0.040309,5,604.639125,33.591063,120.927825,57.219281,3,0
0,0,3,3,10,6,16,19,10,29,0.000333,0.038667,5,580,32.222222,116,48.729056,1,0
0,0,4,4,4,7,11,13,11,24,0.000333,0.027675,2,166.052718,9.225151,83.026359,27.651484,3,0
0,0,17,17,16,23,39,110,55,165,0.000333,0.290697,16,13953.46186,775.192325,872.091366,168.041925,7,0
0,0,7,7,11,19,30,44,28,72,0.000333,0.117765,5,1766.480614,98.137812,353.296123,118.764371,2,0
0,0,7,7,12,17,29,43,27,70,0.000333,0.113353,6,2040.352018,113.35289,340.05867,112.506418,4,0
0,0,3,3,9,9,18,18,13,31,0.000333,0.043089,4,517.0707,28.72615,129.267675,57.05865,2,0
0,0,3,3,11,11,22,26,15,41,0.000333,0.060946,5,914.183482,50.787971,182.836696,76.107496,3,0
0,0,3,3,10,8,18,16,13,29,0.000333,0.040309,5,604.639125,33.591063,120.927825,57.219281,3,0
0,0,11,11,15,21,36,84,43,127,0.000333,0.21886,14,9192.126653,510.673703,656.580475,150.842025,2,0
0,0,3,3,8,10,18,17,13,30,0.000333,0.041699,4,500.391,27.7995,125.09775,57.219281,2,0
0,0,27,27,17,36,53,140,78,218,0.000333,0.416229,16,19978.98655,1109.943697,1248.686659,255.604168,10,0
0,0,3,3,9,13,22,20,16,36,0.000333,0.053513,4,642.158153,35.675453,160.539538,76.635041,3,0
0,0,3,3,9,9,18,18,13,31,0.000333,0.043089,4,517.0707,28.72615,129.267675,57.05865,2,0
0,0,3,3,10,8,18,16,13,29,0.000333,0.040309,5,604.639125,33.591063,120.927825,57.219281,3,0
0,0,7,7,11,19,30,44,28,72,0.000333,0.117765,5,1766.480614,98.137812,353.296123,118.764371,2,0
0,0,3,3,9,9,18,18,13,31,0.000333,0.043089,4,517.0707,28.72615,129.267675,57.05865,2,0
0,0,3,3,9,9,18,18,13,31,0.000333,0.043089,4,517.0707,28.72615,129.267675,57.05865,2,0
0,0,3,3,10,11,21,22,15,37,0.000333,0.054172,5,812.578723,45.143262,162.515745,71.273029,4,0
0,0,9,9,9,20,29,71,38,109,0.000333,0.176507,4,2118.079714,117.671095,529.519928,114.967887,1,0
0,0,15,15,19,15,34,97,49,146,0.000333,0.24759,27,20054.77852,1114.154362,742.769575,139.313982,12,0
0,0,8,8,15,18,33,66,34,100,0.000333,0.168146,7,3531.075884,196.170882,504.439412,133.662009,2,0
0,0,4,4,4,7,11,13,11,24,0.000333,0.027675,2,166.052718,9.225151,83.026359,27.651484,3,0
0,0,5,5,10,15,25,27,23,50,0.000333,0.077398,5,1160.964047,64.498003,232.192809,91.82264,4,0
0,0,3,3,9,9,18,18,13,31,0.000333,0.043089,4,517.0707,28.72615,129.267675,57.05865,2,0
0,0,3,3,10,8,18,16,13,29,0.000333,0.040309,5,604.639125,33.591063,120.927825,57.219281,3,0
0,0,16,16,11,26,37,114,60,174,0.000333,0.302148,10,9064.448856,503.580492,906.444886,160.26518,1,0
0,0,7,7,11,19,30,44,28,72,0.000333,0.117765,5,1766.480614,98.137812,353.296123,118.764371,2,0
0,0,5,5,10,9,19,25,14,39,0.000333,0.055223,5,828.345865,46.019215,165.669173,61.748606,2,0
0,0,7,7,11,19,30,44,28,72,0.000333,0.117765,5,1766.480614,98.137812,353.296123,118.764371,2,0
0,0,4,4,7,10,17,16,19,35,0.000333,0.047687,3,429.183598,23.843533,143.061199,52.870765,1,0
0,0,3,3,10,8,18,16,13,29,0.000333,0.040309,5,604.639125,33.591063,120.927825,57.219281,3,0
0,0,23,23,20,29,49,181,80,261,0.000333,0.48848,20,29308.78539,1628.265855,1465.439269,227.320011,12,0
0,0,7,7,11,19,30,44,28,72,0.000333,0.117765,5,1766.480614,98.137812,353.296123,118.764371,2,0
0,0,7,7,11,19,30,44,28,72,0.000333,0.117765,5,1766.480614,98.137812,353.296123,118.764371,2,0
0,0,3,3,10,10,20,17,13,30,0.000333,0.043219,5,648.289214,36.016067,129.657843,66.438562,2,0
0,0,3,3,8,10,18,20,13,33,0.000333,0.045869,4,550.4301,30.57945,137.607525,57.219281,3,0
0,0,10,10,12,20,32,84,41,125,0.000333,0.208333,12,7500,416.666667,625,129.458112,4,0
0,0,4,4,10,9,19,46,19,65,0.000333,0.092038,10,2761.152884,153.397382,276.115288,61.748606,11,0
0,0,3,3,10,9,19,37,16,53,0.000333,0.075047,5,1125.700791,62.538933,225.140158,61.748606,10,0
0,0,8,8,15,18,33,66,34,100,0.000333,0.168146,7,3531.075884,196.170882,504.439412,133.662009,2,0
0,0,7,7,12,17,29,43,27,70,0.000333,0.113353,6,2040.352018,113.35289,340.05867,112.506418,4,0
0,0,3,3,11,11,22,26,15,41,0.000333,0.060946,5,914.183482,50.787971,182.836696,76.107496,3,0
0,0,3,3,10,8,18,16,13,29,0.000333,0.040309,5,604.639125,33.591063,120.927825,57.219281,3,0
0,0,4,4,4,7,11,13,11,24,0.000333,0.027675,2,166.052718,9.225151,83.026359,27.651484,3,0
0,0,3,3,10,8,18,16,13,29,0.000333,0.040309,5,604.639125,33.591063,120.927825,57.219281,3,0
0,0,5,5,9,9,18,34,14,48,0.000333,0.066719,4,800.6256,44.4792,200.1564,57.05865,3,0
0,0,7,7,11,16,27,35,27,62,0.000333,0.098268,5,1474.015126,81.889729,294.803025,102.053748,2,0
0,0,3,3,9,9,18,18,13,31,0.000333,0.043089,4,517.0707,28.72615,129.267675,57.05865,2,0
0,0,4,4,7,11,18,20,16,36,0.000333,0.050039,3,450.3519,25.01955,150.1173,57.705232,2,0
0,0,4,4,7,9,16,16,12,28,0.000333,0.037333,3,336,18.666667,112,48.180809,3,0
0,0,3,3,10,8,18,16,13,29,0.000333,0.040309,5,604.639125,33.591063,120.927825,57.219281,3,0
0,0,5,5,12,16,28,39,25,64,0.000333,0.102557,6,1846.02429,102.556905,307.670715,107.01955,2,0
0,0,3,3,10,8,18,16,13,29,0.000333,0.040309,5,604.639125,33.591063,120.927825,57.219281,3,0
0,0,4,4,10,11,21,20,15,35,0.000333,0.051244,5,768.655549,42.703086,153.73111,71.273029,2,0
0,0,7,7,11,19,30,44,28,72,0.000333,0.117765,5,1766.480614,98.137812,353.296123,118.764371,2,0
0,0,8,8,16,19,35,72,39,111,0.000333,0.189783,16,9109.606638,506.089258,569.350415,144.710623,10,0
0,0,6,6,14,13,27,34,23,57,0.000333,0.090343,7,1897.200113,105.400006,271.028588,101.408685,2,0
0,0,65,65,28,89,117,678,455,1133,0.000333,2.594708,70,544888.6259,30271.59033,7784.123227,710.946213,33,0
0,0,8,8,12,17,29,51,32,83,0.000333,0.134404,6,2419.274536,134.404141,403.212423,112.506418,5,0
0,0,26,26,10,29,39,198,111,309,0.000333,0.544396,15,24497.83928,1360.991071,1633.189286,174.10073,17,0
0,0,7,7,11,19,30,44,28,72,0.000333,0.117765,5,1766.480614,98.137812,353.296123,118.764371,2,0
0,0,3,3,5,6,11,9,8,17,0.000333,0.019603,2,117.620675,6.534482,58.810338,27.119415,1,0
0,0,3,3,10,11,21,22,15,37,0.000333,0.054172,5,812.578723,45.143262,162.515745,71.273029,4,0
0,0,3,3,10,8,18,16,13,29,0.000333,0.040309,5,604.639125,33.591063,120.927825,57.219281,3,0
0,0,5,5,8,8,16,19,12,31,0.000333,0.041333,4,496,27.555556,124,48,2,0
0,0,3,3,5,6,11,9,8,17,0.000333,0.019603,2,117.620675,6.534482,58.810338,27.119415,1,0
0,0,4,4,8,14,22,21,21,42,0.000333,0.062432,4,749.184512,41.621362,187.296128,77.302969,1,0
0,0,3,3,10,8,18,16,13,29,0.000333,0.040309,5,604.639125,33.591063,120.927825,57.219281,3,0
0,0,17,17,16,23,39,110,55,165,0.000333,0.290697,16,13953.46186,775.192325,872.091366,168.041925,7,0
0,0,7,7,11,19,30,44,28,72,0.000333,0.117765,5,1766.480614,98.137812,353.296123,118.764371,2,0
0,0,3,3,10,9,19,37,16,53,0.000333,0.075047,5,1125.700791,62.538933,225.140158,61.748606,10,0
0,0,17,17,16,23,39,110,55,165,0.000333,0.290697,16,13953.46186,775.192325,872.091366,168.041925,7,0
0,0,4,4,10,9,19,46,19,65,0.000333,0.092038,10,2761.152884,153.397382,276.115288,61.748606,11,0
0,0,5,5,10,10,20,27,14,41,0.000333,0.059066,5,885.995259,49.221959,177.199052,66.438562,3,0
0,0,7,7,11,19,30,44,28,72,0.000333,0.117765,5,1766.480614,98.137812,353.296123,118.764371,2,0
0,0,3,3,10,8,18,16,13,29,0.000333,0.040309,5,604.639125,33.591063,120.927825,57.219281,3,0
0,0,3,3,10,8,18,16,13,29,0.000333,0.040309,5,604.639125,33.591063,120.927825,57.219281,3,0
0,0,4,4,4,7,11,13,11,24,0.000333,0.027675,2,166.052718,9.225151,83.026359,27.651484,3,0
0,0,14,14,11,35,46,79,67,146,0.000333,0.268813,5,4032.200228,224.011124,806.440046,217.578653,6,0
0,0,4,4,7,13,20,20,20,40,0.000333,0.057626,3,518.631371,28.812854,172.877124,67.757201,2,0
0,0,3,3,9,9,18,18,13,31,0.000333,0.043089,4,517.0707,28.72615,129.267675,57.05865,2,0
0,0,12,12,17,21,38,70,51,121,0.000333,0.211666,16,10159.98767,564.443759,634.999229,161.725534,6,0
0,0,7,7,11,19,30,44,28,72,0.000333,0.117765,5,1766.480614,98.137812,353.296123,118.764371,2,0
0,0,7,7,11,19,30,44,28,72,0.000333,0.117765,5,1766.480614,98.137812,353.296123,118.764371,2,0
0,0,3,3,10,8,18,16,13,29,0.000333,0.040309,5,604.639125,33.591063,120.927825,57.219281,3,0
0,0,3,3,10,8,18,16,13,29,0.000333,0.040309,5,604.639125,33.591063,120.927825,57.219281,3,0
0,0,3,3,10,8,18,16,13,29,0.000333,0.040309,5,604.639125,33.591063,120.927825,57.219281,3,0
0,0,4,4,4,7,11,13,11,24,0.000333,0.027675,2,166.052718,9.225151,83.026359,27.651484,3,0
0,0,4,4,11,10,21,26,17,43,0.000333,0.062957,5,944.348246,52.463791,188.869649,71.273029,2,0
0,0,4,4,8,11,19,17,15,32,0.000333,0.045311,4,543.734722,30.207485,135.93368,62.053748,3,0
0,0,4,4,4,7,11,13,11,24,0.000333,0.027675,2,166.052718,9.225151,83.026359,27.651484,3,0
0,0,3,3,10,8,18,16,13,29,0.000333,0.040309,5,604.639125,33.591063,120.927825,57.219281,3,0
0,0,7,7,11,19,30,44,28,72,0.000333,0.117765,5,1766.480614,98.137812,353.296123,118.764371,2,0
0,0,3,3,10,8,18,16,13,29,0.000333,0.040309,5,604.639125,33.591063,120.927825,57.219281,3,0
0,0,3,3,10,8,18,16,13,29,0.000333,0.040309,5,604.639125,33.591063,120.927825,57.219281,3,0
0,0,4,4,8,11,19,17,15,32,0.000333,0.045311,4,543.734722,30.207485,135.93368,62.053748,3,0
0,0,4,4,4,7,11,13,11,24,0.000333,0.027675,2,166.052718,9.225151,83.026359,27.651484,3,0
0,0,3,3,10,11,21,22,15,37,0.000333,0.054172,5,812.578723,45.143262,162.515745,71.273029,4,0
0,0,7,7,11,19,30,44,28,72,0.000333,0.117765,5,1766.480614,98.137812,353.296123,118.764371,2,0
0,0,22,22,17,34,51,128,68,196,0.000333,0.370598,16,17788.72587,988.262548,1111.795367,242.460605,8,0
0,0,4,4,4,7,11,13,11,24,0.000333,0.027675,2,166.052718,9.225151,83.026359,27.651484,3,0
0,0,7,7,11,19,30,44,28,72,0.000333,0.117765,5,1766.480614,98.137812,353.296123,118.764371,2,0
0,0,4,4,8,10,18,28,18,46,0.000333,0.063939,4,767.2662,42.6259,191.81655,57.219281,4,0
0,0,3,3,9,9,18,18,13,31,0.000333,0.043089,4,517.0707,28.72615,129.267675,57.05865,2,0
0,0,3,3,10,8,18,16,13,29,0.000333,0.040309,5,604.639125,33.591063,120.927825,57.219281,3,0
0,0,7,7,11,19,30,44,28,72,0.000333,0.117765,5,1766.480614,98.137812,353.296123,118.764371,2,0
0,0,7,7,11,19,30,44,28,72,0.000333,0.117765,5,1766.480614,98.137812,353.296123,118.764371,2,0
0,0,3,3,9,9,18,18,13,31,0.000333,0.043089,4,517.0707,28.72615,129.267675,57.05865,2,0
0,0,17,17,16,23,39,110,55,165,0.000333,0.290697,16,13953.46186,775.192325,872.091366,168.041925,7,0
0,0,10,10,16,21,37,51,44,95,0.000333,0.164966,16,7918.369116,439.909395,494.89807,156.238666,4,0
0,0,3,3,7,9,16,17,12,29,0.000333,0.038667,3,348,19.333333,116,48.180809,2,0
0,0,12,12,7,18,25,72,44,116,0.000333,0.179562,6,3232.123908,179.562439,538.687318,94.710134,1,0
0,0,7,7,11,19,30,44,28,72,0.000333,0.117765,5,1766.480614,98.137812,353.296123,118.764371,2,0
0,0,3,3,9,9,18,18,13,31,0.000333,0.043089,4,517.0707,28.72615,129.267675,57.05865,2,0
0,0,4,4,14,9,23,32,12,44,0.000333,0.066346,7,1393.257082,77.403171,199.036726,81.832294,3,0
0,0,4,4,4,7,11,13,11,24,0.000333,0.027675,2,166.052718,9.225151,83.026359,27.651484,3,0
0,0,4,4,6,8,14,17,12,29,0.000333,0.036804,3,331.239878,18.402215,110.413293,39.509775,3,0
0,0,3,3,10,8,18,16,13,29,0.000333,0.040309,5,604.639125,33.591063,120.927825,57.219281,3,0
0,0,4,4,6,8,14,17,12,29,0.000333,0.036804,3,331.239878,18.402215,110.413293,39.509775,3,0
0,0,7,7,11,19,30,44,28,72,0.000333,0.117765,5,1766.480614,98.137812,353.296123,118.764371,2,0
0,0,3,3,9,9,18,18,13,31,0.000333,0.043089,4,517.0707,28.72615,129.267675,57.05865,2,0
0,0,3,3,10,8,18,16,13,29,0.000333,0.040309,5,604.639125,33.591063,120.927825,57.219281,3,0
0,0,9,9,16,24,40,75,54,129,0.000333,0.228843,16,10984.45959,610.247755,686.528724,174.0391,2,0
0,0,3,3,10,8,18,16,13,29,0.000333,0.040309,5,604.639125,33.591063,120.927825,57.219281,3,0
0,0,7,7,12,17,29,43,27,70,0.000333,0.113353,6,2040.352018,113.35289,340.05867,112.506418,4,0
0,0,3,3,9,9,18,18,13,31,0.000333,0.043089,4,517.0707,28.72615,129.267675,57.05865,2,0
0,0,5,5,11,13,24,28,20,48,0.000333,0.073359,5,1100.391,61.132833,220.0782,86.159464,4,0
0,0,7,7,10,14,24,61,31,92,0.000333,0.140606,10,4218.165501,234.342528,421.81655,86.52225,1,0
0,0,7,7,11,13,24,38,31,69,0.000333,0.105454,10,3163.624125,175.756896,316.362413,86.159464,1,0
0,0,34,34,21,34,55,222,106,328,0.000333,0.632095,30,56888.57958,3160.476643,1896.285986,265.212402,18,0
0,0,14,14,11,35,46,79,67,146,0.000333,0.268813,5,4032.200228,224.011124,806.440046,217.578653,6,0
0,0,3,3,10,8,18,16,13,29,0.000333,0.040309,5,604.639125,33.591063,120.927825,57.219281,3,0
0,0,7,7,11,16,27,35,27,62,0.000333,0.098268,5,1474.015126,81.889729,294.803025,102.053748,2,0
0,0,3,3,10,10,20,17,13,30,0.000333,0.043219,5,648.289214,36.016067,129.657843,66.438562,2,0
0,0,4,4,4,7,11,13,11,24,0.000333,0.027675,2,166.052718,9.225151,83.026359,27.651484,1,0
0,0,3,3,9,9,18,18,13,31,0.000333,0.043089,4,517.0707,28.72615,129.267675,57.05865,2,0
0,0,23,23,20,29,49,181,80,261,0.000333,0.48848,20,29308.78539,1628.265855,1465.439269,227.320011,12,0
0,0,5,5,9,12,21,26,18,44,0.000333,0.064421,4,773.047866,42.947104,193.261967,71.548875,2,0
0,0,3,3,9,9,18,18,13,31,0.000333,0.043089,4,517.0707,28.72615,129.267675,57.05865,2,0
0,0,3,3,10,8,18,16,13,29,0.000333,0.040309,5,604.639125,33.591063,120.927825,57.219281,3,0
0,0,4,4,4,7,11,13,11,24,0.000333,0.027675,2,166.052718,9.225151,83.026359,27.651484,3,0
0,0,17,17,16,23,39,110,55,165,0.000333,0.290697,16,13953.46186,775.192325,872.091366,168.041925,7,0
0,0,3,3,10,8,18,16,13,29,0.000333,0.040309,5,604.639125,33.591063,120.927825,57.219281,3,0
0,0,7,7,11,19,30,44,28,72,0.000333,0.117765,5,1766.480614,98.137812,353.296123,118.764371,2,0
0,0,7,7,11,19,30,44,28,72,0.000333,0.117765,5,1766.480614,98.137812,353.296123,118.764371,2,0
0,0,3,3,10,8,18,16,13,29,0.000333,0.040309,5,604.639125,33.591063,120.927825,57.219281,3,0
0,0,17,17,16,23,39,110,55,165,0.000333,0.290697,16,13953.46186,775.192325,872.091366,168.041925,7,0
0,0,4,4,10,12,22,21,17,38,0.000333,0.056486,5,847.292008,47.071778,169.458402,76.238831,1,0
0,0,4,4,4,7,11,13,11,24,0.000333,0.027675,2,166.052718,9.225151,83.026359,27.651484,3,0
0,0,3,3,10,10,20,17,13,30,0.000333,0.043219,5,648.289214,36.016067,129.657843,66.438562,2,0
0,0,8,8,14,20,34,44,37,81,0.000333,0.137361,7,2884.591431,160.255079,412.08449,139.741531,4,0
0,0,11,11,13,20,33,75,43,118,0.000333,0.198413,12,7142.862073,396.825671,595.238506,134.544278,1,0
0,0,3,3,10,8,18,16,13,29,0.000333,0.040309,5,604.639125,33.591063,120.927825,57.219281,3,0
0,0,26,26,15,36,51,154,90,244,0.000333,0.461357,14,19377.00497,1076.500276,1384.071783,244.720659,8,0
0,0,17,17,16,23,39,110,55,165,0.000333,0.290697,16,13953.46186,775.192325,872.091366,168.041925,7,0
0,0,3,3,11,11,22,26,15,41,0.000333,0.060946,5,914.183482,50.787971,182.836696,76.107496,3,0
0,0,10,10,17,17,34,59,39,98,0.000333,0.16619,16,7977.141735,443.174541,498.571358,138.973737,6,0
0,0,13,13,16,36,52,233,88,321,0.000333,0.609947,16,29277.45839,1626.525466,1829.84115,250.1173,14,0
0,0,3,3,6,7,13,13,9,22,0.000333,0.027137,3,244.229021,13.568279,81.409674,35.161259,1,0
0,0,3,3,10,6,16,19,10,29,0.000333,0.038667,5,580,32.222222,116,48.729056,1,0
0,0,3,3,10,8,18,16,13,29,0.000333,0.040309,5,604.639125,33.591063,120.927825,57.219281,3,0
0,0,7,7,11,19,30,44,28,72,0.000333,0.117765,5,1766.480614,98.137812,353.296123,118.764371,2,0
0,0,7,7,11,19,30,44,28,72,0.000333,0.117765,5,1766.480614,98.137812,353.296123,118.764371,2,0
0,0,3,3,9,9,18,18,13,31,0.000333,0.043089,4,517.0707,28.72615,129.267675,57.05865,2,0
0,0,3,3,10,8,18,16,13,29,0.000333,0.040309,5,604.639125,33.591063,120.927825,57.219281,3,0
0,0,3,3,10,11,21,22,15,37,0.000333,0.054172,5,812.578723,45.143262,162.515745,71.273029,4,0
0,0,4,4,4,7,11,13,11,24,0.000333,0.027675,2,166.052718,9.225151,83.026359,27.651484,3,0
0,0,3,3,10,8,18,16,13,29,0.000333,0.040309,5,604.639125,33.591063,120.927825,57.219281,3,0
0,0,7,7,11,19,30,44,28,72,0.000333,0.117765,5,1766.480614,98.137812,353.296123,118.764371,2,0
0,0,7,7,11,19,30,44,28,72,0.000333,0.117765,5,1766.480614,98.137812,353.296123,118.764371,2,0
0,0,3,3,9,9,18,18,13,31,0.000333,0.043089,4,517.0707,28.72615,129.267675,57.05865,2,0
0,0,7,7,11,19,30,44,28,72,0.000333,0.117765,5,1766.480614,98.137812,353.296123,118.764371,2,0
0,0,10,10,15,27,42,169,61,230,0.000333,0.413411,14,17363.2621,964.625672,1240.233007,186.985321,7,0
0,0,3,3,8,4,12,13,6,19,0.000333,0.022705,4,272.45715,15.136508,68.114288,32,2,0
0,0,7,7,11,19,30,44,28,72,0.000333,0.117765,5,1766.480614,98.137812,353.296123,118.764371,2,0
0,0,5,5,10,14,24,27,22,49,0.000333,0.074888,5,1123.315813,62.406434,224.663163,86.52225,3,0
0,0,4,4,11,10,21,26,17,43,0.000333,0.062957,5,944.348246,52.463791,188.869649,71.273029,2,0
0,0,7,7,11,19,30,44,28,72,0.000333,0.117765,5,1766.480614,98.137812,353.296123,118.764371,2,0
0,0,3,3,9,9,18,18,13,31,0.000333,0.043089,4,517.0707,28.72615,129.267675,57.05865,2,0
0,0,3,3,10,8,18,16,13,29,0.000333,0.040309,5,604.639125,33.591063,120.927825,57.219281,3,0
0,0,3,3,7,9,16,17,12,29,0.000333,0.038667,3,348,19.333333,116,48.180809,2,0
0,0,26,26,17,36,53,140,74,214,0.000333,0.408592,16,19612.39964,1089.577758,1225.774977,255.604168,12,0
0,0,7,7,11,19,30,44,28,72,0.000333,0.117765,5,1766.480614,98.137812,353.296123,118.764371,2,0
0,0,3,3,10,8,18,16,13,29,0.000333,0.040309,5,604.639125,33.591063,120.927825,57.219281,3,0
0,0,4,4,4,7,11,13,11,24,0.000333,0.027675,2,166.052718,9.225151,83.026359,27.651484,3,0
0,0,6,6,13,13,26,38,23,61,0.000333,0.095576,6,1720.360937,95.575608,286.726823,96.211433,4,0
0,0,3,3,10,6,16,19,10,29,0.000333,0.038667,5,580,32.222222,116,48.729056,1,0
0,0,7,7,11,19,30,44,28,72,0.000333,0.117765,5,1766.480614,98.137812,353.296123,118.764371,2,0
0,0,4,4,4,7,11,13,11,24,0.000333,0.027675,2,166.052718,9.225151,83.026359,27.651484,3,0
0,0,7,7,11,19,30,44,28,72,0.000333,0.117765,5,1766.480614,98.137812,353.296123,118.764371,2,0
0,0,33,33,19,51,70,170,99,269,0.000333,0.549592,9,14838.99418,824.388566,1648.777132,370.004315,10,0
0,0,5,5,9,15,24,22,19,41,0.000333,0.062661,4,751.93385,41.774103,187.983463,87.132684,3,0
0,0,3,3,10,10,20,17,13,30,0.000333,0.043219,5,648.289214,36.016067,129.657843,66.438562,2,0
0,0,3,3,10,11,21,22,15,37,0.000333,0.054172,5,812.578723,45.143262,162.515745,71.273029,4,0
0,0,4,4,4,7,11,13,11,24,0.000333,0.027675,2,166.052718,9.225151,83.026359,27.651484,3,0
0,0,3,3,9,9,18,18,13,31,0.000333,0.043089,4,517.0707,28.72615,129.267675,57.05865,2,0
0,0,5,5,9,13,22,26,24,50,0.000333,0.074324,4,891.886324,49.54924,222.971581,76.635041,2,0
0,0,29,29,22,49,71,182,138,320,0.000333,0.655973,22,43294.21972,2405.234429,1967.919078,373.228278,5,0
0,0,3,3,11,11,22,26,15,41,0.000333,0.060946,5,914.183482,50.787971,182.836696,76.107496,3,0
0,0,3,3,8,10,18,20,14,34,0.000333,0.047259,4,567.1098,31.5061,141.77745,57.219281,1,0
0,0,3,3,10,8,18,16,13,29,0.000333,0.040309,5,604.639125,33.591063,120.927825,57.219281,3,0
0,0,3,3,10,6,16,21,9,30,0.000333,0.04,5,600,33.333333,120,48.729056,3,0
0,0,3,3,5,6,11,9,8,17,0.000333,0.019603,2,117.620675,6.534482,58.810338,27.119415,1,0
0,0,4,4,11,10,21,23,15,38,0.000333,0.055636,5,834.54031,46.363351,166.908062,71.273029,2,0
0,0,4,4,10,12,22,21,17,38,0.000333,0.056486,5,847.292008,47.071778,169.458402,76.238831,1,0
0,0,10,10,17,15,32,59,38,97,0.000333,0.161667,16,7760,431.111111,485,128.090227,6,0
0,0,3,3,10,8,18,16,13,29,0.000333,0.040309,5,604.639125,33.591063,120.927825,57.219281,3,0
0,0,3,3,10,10,20,17,13,30,0.000333,0.043219,5,648.289214,36.016067,129.657843,66.438562,2,0
0,0,7,7,11,19,30,44,28,72,0.000333,0.117765,5,1766.480614,98.137812,353.296123,118.764371,2,0
0,0,3,3,8,10,18,17,13,30,0.000333,0.041699,4,500.391,27.7995,125.09775,57.219281,2,0
0,0,3,3,10,6,16,19,10,29,0.000333,0.038667,5,580,32.222222,116,48.729056,1,0
0,0,3,3,10,8,18,16,13,29,0.000333,0.040309,5,604.639125,33.591063,120.927825,57.219281,3,0
0,0,8,8,16,13,29,56,25,81,0.000333,0.131165,8,3147.971685,174.887316,393.496461,112.105716,3,0
0,0,7,7,11,19,30,44,28,72,0.000333,0.117765,5,1766.480614,98.137812,353.296123,118.764371,2,0
0,0,3,3,10,8,18,16,13,29,0.000333,0.040309,5,604.639125,33.591063,120.927825,57.219281,3,0
0,0,7,7,11,19,30,44,28,72,0.000333,0.117765,5,1766.480614,98.137812,353.296123,118.764371,2,0
0,0,3,3,9,9,18,18,13,31,0.000333,0.043089,4,517.0707,28.72615,129.267675,57.05865,2,0
0,0,3,3,9,9,18,18,13,31,0.000333,0.043089,4,517.0707,28.72615,129.267675,57.05865,2,0
0,0,3,3,10,9,19,37,16,53,0.000333,0.075047,5,1125.700791,62.538933,225.140158,61.748606,10,0
0,0,4,4,10,9,19,46,19,65,0.000333,0.092038,10,2761.152884,153.397382,276.115288,61.748606,11,0
0,0,3,3,9,9,18,18,13,31,0.000333,0.043089,4,517.0707,28.72615,129.267675,57.05865,2,0
0,0,7,7,11,19,30,44,28,72,0.000333,0.117765,5,1766.480614,98.137812,353.296123,118.764371,2,0
0,0,7,7,11,19,30,44,28,72,0.000333,0.117765,5,1766.480614,98.137812,353.296123,118.764371,2,0
0,0,10,10,13,37,50,54,51,105,0.000333,0.197535,6,3555.6294,197.534967,592.6049,240.855491,5,0
0,0,3,3,10,8,18,16,13,29,0.000333,0.040309,5,604.639125,33.591063,120.927825,57.219281,3,0
0,0,9,9,15,19,34,68,35,103,0.000333,0.17467,7,3668.060709,203.78115,524.008673,139.313982,2,0
0,0,3,3,11,11,22,26,15,41,0.000333,0.060946,5,914.183482,50.787971,182.836696,76.107496,3,0
0,0,4,4,4,7,11,13,11,24,0.000333,0.027675,2,166.052718,9.225151,83.026359,27.651484,3,0
0,0,7,7,12,17,29,43,27,70,0.000333,0.113353,6,2040.352018,113.35289,340.05867,112.506418,4,0
0,0,3,3,10,8,18,16,13,29,0.000333,0.040309,5,604.639125,33.591063,120.927825,57.219281,3,0
0,0,3,3,5,5,10,12,7,19,0.000333,0.021039,2,126.233268,7.012959,63.116634,23.219281,1,0
0,0,7,7,12,17,29,43,27,70,0.000333,0.113353,6,2040.352018,113.35289,340.05867,112.506418,4,0
0,0,7,7,11,19,30,44,28,72,0.000333,0.117765,5,1766.480614,98.137812,353.296123,118.764371,2,0
0,0,5,5,11,13,24,27,22,49,0.000333,0.074888,5,1123.315813,62.406434,224.663163,86.159464,2,0
0,0,5,5,11,15,26,28,23,51,0.000333,0.079907,5,1198.612128,66.589563,239.722426,96.657107,4,0
0,0,3,3,9,9,18,18,13,31,0.000333,0.043089,4,517.0707,28.72615,129.267675,57.05865,2,0
0,0,27,27,17,37,54,142,78,220,0.000333,0.422025,16,20257.20401,1125.400223,1266.07525,262.236643,10,0
0,0,7,7,11,19,30,44,28,72,0.000333,0.117765,5,1766.480614,98.137812,353.296123,118.764371,2,0
0,0,3,3,10,11,21,22,15,37,0.000333,0.054172,5,812.578723,45.143262,162.515745,71.273029,4,0
0,0,3,3,9,9,18,18,13,31,0.000333,0.043089,4,517.0707,28.72615,129.267675,57.05865,2,0
0,0,4,4,14,9,23,32,12,44,0.000333,0.066346,7,1393.257082,77.403171,199.036726,81.832294,3,0
0,0,7,7,11,19,30,44,28,72,0.000333,0.117765,5,1766.480614,98.137812,353.296123,118.764371,2,0
0,0,4,4,11,10,21,26,17,43,0.000333,0.062957,5,944.348246,52.463791,188.869649,71.273029,2,0
0,0,3,3,10,8,18,16,13,29,0.000333,0.040309,5,604.639125,33.591063,120.927825,57.219281,3,0
0,0,5,5,9,15,24,22,19,41,0.000333,0.062661,4,751.93385,41.774103,187.983463,87.132684,3,0
0,0,4,4,4,7,11,13,11,24,0.000333,0.027675,2,166.052718,9.225151,83.026359,27.651484,3,0
0,0,5,5,9,15,24,22,19,41,0.000333,0.062661,4,751.93385,41.774103,187.983463,87.132684,3,0
0,0,3,3,10,8,18,16,13,29,0.000333,0.040309,5,604.639125,33.591063,120.927825,57.219281,3,0
0,0,3,3,10,6,16,19,10,29,0.000333,0.038667,5,580,32.222222,116,48.729056,1,0
0,0,6,6,10,15,25,27,24,51,0.000333,0.078946,5,1184.183328,65.787963,236.836666,91.82264,4,0
0,0,3,3,10,11,21,22,15,37,0.000333,0.054172,5,812.578723,45.143262,162.515745,71.273029,4,0
0,0,3,3,9,9,18,18,13,31,0.000333,0.043089,4,517.0707,28.72615,129.267675,57.05865,2,0
0,0,3,3,9,9,18,18,13,31,0.000333,0.043089,4,517.0707,28.72615,129.267675,57.05865,2,0
0,0,4,4,4,7,11,13,11,24,0.000333,0.027675,2,166.052718,9.225151,83.026359,27.651484,3,0
0,0,8,8,9,17,26,35,26,61,0.000333,0.095576,4,1146.907291,63.717072,286.726823,98.016193,3,0
0,0,7,7,11,19,30,44,28,72,0.000333,0.117765,5,1766.480614,98.137812,353.296123,118.764371,2,0
0,0,3,3,10,8,18,16,13,29,0.000333,0.040309,5,604.639125,33.591063,120.927825,57.219281,3,0
0,0,7,7,11,19,30,44,28,72,0.000333,0.117765,5,1766.480614,98.137812,353.296123,118.764371,2,0
0,0,5,5,11,14,25,27,24,51,0.000333,0.078946,5,1184.183328,65.787963,236.836666,91.356717,2,0
0,0,4,4,4,7,11,13,11,24,0.000333,0.027675,2,166.052718,9.225151,83.026359,27.651484,3,0
0,0,7,7,11,19,30,44,28,72,0.000333,0.117765,5,1766.480614,98.137812,353.296123,118.764371,2,0
0,0,7,7,11,19,30,44,28,72,0.000333,0.117765,5,1766.480614,98.137812,353.296123,118.764371,2,0
0,0,7,7,11,19,30,44,28,72,0.000333,0.117765,5,1766.480614,98.137812,353.296123,118.764371,2,0
0,0,7,7,11,19,30,44,28,72,0.000333,0.117765,5,1766.480614,98.137812,353.296123,118.764371,2,0
0,0,3,3,10,8,18,16,13,29,0.000333,0.040309,5,604.639125,33.591063,120.927825,57.219281,3,0
0,0,3,3,10,8,18,16,13,29,0.000333,0.040309,5,604.639125,33.591063,120.927825,57.219281,3,0
0,0,4,4,4,7,11,13,11,24,0.000333,0.027675,2,166.052718,9.225151,83.026359,27.651484,3,0
0,0,3,3,10,8,18,16,13,29,0.000333,0.040309,5,604.639125,33.591063,120.927825,57.219281,3,0
0,0,3,3,9,9,18,18,13,31,0.000333,0.043089,4,517.0707,28.72615,129.267675,57.05865,2,0
0,0,7,7,11,19,30,44,28,72,0.000333,0.117765,5,1766.480614,98.137812,353.296123,118.764371,2,0
0,0,3,3,11,11,22,26,15,41,0.000333,0.060946,5,914.183482,50.787971,182.836696,76.107496,3,0
0,0,6,6,9,13,22,31,19,50,0.000333,0.074324,4,891.886324,49.54924,222.971581,76.635041,1,0
0,0,3,3,7,9,16,17,12,29,0.000333,0.038667,3,348,19.333333,116,48.180809,2,0
0,0,3,3,10,10,20,17,13,30,0.000333,0.043219,5,648.289214,36.016067,129.657843,66.438562,2,0
0,0,3,3,10,8,18,16,13,29,0.000333,0.040309,5,604.639125,33.591063,120.927825,57.219281,3,0
0,0,3,3,11,11,22,26,15,41,0.000333,0.060946,5,914.183482,50.787971,182.836696,76.107496,3,0
0,0,3,3,9,14,23,35,18,53,0.000333,0.079916,4,958.995135,53.277507,239.748784,81.832294,1,0
0,0,5,5,12,16,28,39,25,64,0.000333,0.102557,6,1846.02429,102.556905,307.670715,107.01955,2,0
0,0,7,7,11,19,30,44,28,72,0.000333,0.117765,5,1766.480614,98.137812,353.296123,118.764371,2,0
0,0,3,3,9,9,18,18,13,31,0.000333,0.043089,4,517.0707,28.72615,129.267675,57.05865,2,0
0,0,3,3,10,11,21,22,15,37,0.000333,0.054172,5,812.578723,45.143262,162.515745,71.273029,4,0
0,0,5,5,12,16,28,39,25,64,0.000333,0.102557,6,1846.02429,102.556905,307.670715,107.01955,2,0
0,0,3,3,10,8,18,16,13,29,0.000333,0.040309,5,604.639125,33.591063,120.927825,57.219281,3,0
0,0,3,3,10,8,18,16,13,29,0.000333,0.040309,5,604.639125,33.591063,120.927825,57.219281,3,0
0,0,4,4,10,9,19,46,19,65,0.000333,0.092038,10,2761.152884,153.397382,276.115288,61.748606,11,0
0,0,4,4,10,12,22,21,17,38,0.000333,0.056486,5,847.292008,47.071778,169.458402,76.238831,1,0
0,0,3,3,10,9,19,37,16,53,0.000333,0.075047,5,1125.700791,62.538933,225.140158,61.748606,10,0
0,0,3,3,10,10,20,17,13,30,0.000333,0.043219,5,648.289214,36.016067,129.657843,66.438562,2,0
0,0,4,4,4,7,11,13,11,24,0.000333,0.027675,2,166.052718,9.225151,83.026359,27.651484,3,0
0,0,3,3,10,8,18,16,13,29,0.000333,0.040309,5,604.639125,33.591063,120.927825,57.219281,3,0
0,0,3,3,10,8,18,16,13,29,0.000333,0.040309,5,604.639125,33.591063,120.927825,57.219281,3,0
0,0,3,3,11,11,22,26,15,41,0.000333,0.060946,5,914.183482,50.787971,182.836696,76.107496,3,0
0,0,7,7,14,15,29,42,31,73,0.000333,0.118211,14,4964.856577,275.825365,354.632613,111.906328,4,0
0,0,4,4,11,10,21,26,17,43,0.000333,0.062957,5,944.348246,52.463791,188.869649,71.273029,2,0
0,0,7,7,11,19,30,44,28,72,0.000333,0.117765,5,1766.480614,98.137812,353.296123,118.764371,2,0
0,0,6,6,13,13,26,38,23,61,0.000333,0.095576,6,1720.360937,95.575608,286.726823,96.211433,4,0
0,0,3,3,10,8,18,16,13,29,0.000333,0.040309,5,604.639125,33.591063,120.927825,57.219281,3,0
0,0,3,3,9,9,18,18,13,31,0.000333,0.043089,4,517.0707,28.72615,129.267675,57.05865,2,0
0,0,7,7,11,18,29,33,30,63,0.000333,0.102018,5,1530.264013,85.014667,306.052803,113.112398,4,0
0,0,11,11,17,20,37,59,45,104,0.000333,0.180594,16,8668.5304,481.585022,541.78315,155.92543,6,0
0,0,4,4,10,9,19,46,19,65,0.000333,0.092038,10,2761.152884,153.397382,276.115288,61.748606,11,0
0,0,3,3,10,9,19,37,16,53,0.000333,0.075047,5,1125.700791,62.538933,225.140158,61.748606,10,0
0,0,3,3,10,8,18,16,13,29,0.000333,0.040309,5,604.639125,33.591063,120.927825,57.219281,3,0
0,0,4,4,7,13,20,20,20,40,0.000333,0.057626,3,518.631371,28.812854,172.877124,67.757201,2,0
0,0,3,3,10,8,18,16,13,29,0.000333,0.040309,5,604.639125,33.591063,120.927825,57.219281,3,0
0,0,3,3,10,6,16,19,10,29,0.000333,0.038667,5,580,32.222222,116,48.729056,1,0
0,0,4,4,7,9,16,16,12,28,0.000333,0.037333,3,336,18.666667,112,48.180809,3,0
0,0,7,7,9,21,30,28,27,55,0.000333,0.08996,4,1079.515931,59.973107,269.878983,120.767991,3,0
0,0,4,4,4,7,11,13,11,24,0.000333,0.027675,2,166.052718,9.225151,83.026359,27.651484,3,0
0,0,4,4,6,8,14,17,12,29,0.000333,0.036804,3,331.239878,18.402215,110.413293,39.509775,3,0
0,0,3,3,6,10,16,10,16,26,0.000333,0.034667,3,312,17.333333,104,48.729056,1,0
0,0,39,39,21,48,69,195,125,320,0.000333,0.651576,20,39094.55652,2171.919807,1954.727826,360.316866,17,0
0,0,79,79,21,159,180,372,537,909,0.000333,2.270031,30,204302.8339,11350.15744,6810.094465,1254.987056,35,0
0,0,7,7,11,19,30,44,28,72,0.000333,0.117765,5,1766.480614,98.137812,353.296123,118.764371,2,0
0,0,3,3,10,8,18,16,13,29,0.000333,0.040309,5,604.639125,33.591063,120.927825,57.219281,3,0
0,0,5,5,7,9,16,19,16,35,0.000333,0.046667,3,420,23.333333,140,48.180809,2,0
0,0,3,3,9,7,16,24,10,34,0.000333,0.045333,4,544,30.222222,136,48.180809,3,0
0,0,3,3,10,8,18,16,13,29,0.000333,0.040309,5,604.639125,33.591063,120.927825,57.219281,3,0
0,0,7,7,11,19,30,44,28,72,0.000333,0.117765,5,1766.480614,98.137812,353.296123,118.764371,2,0
0,0,4,4,14,9,23,32,12,44,0.000333,0.066346,7,1393.257082,77.403171,199.036726,81.832294,3,0
0,0,7,7,11,14,25,324,21,345,0.000333,0.534043,5,8010.651927,445.036218,1602.130385,91.356717,2,0
0,0,6,6,13,13,26,38,23,61,0.000333,0.095576,6,1720.360937,95.575608,286.726823,96.211433,4,0
0,0,6,6,7,11,18,41,25,66,0.000333,0.091738,6,1651.290301,91.73835,275.21505,57.705232,1,0
0,0,4,4,4,7,11,13,11,24,0.000333,0.027675,2,166.052718,9.225151,83.026359,27.651484,3,0
0,0,9,9,13,22,35,49,37,86,0.000333,0.147039,6,2646.710037,147.039446,441.118339,146.213212,4,0
0,0,6,6,11,15,26,30,22,52,0.000333,0.081474,5,1222.114327,67.89524,244.422865,96.657107,1,0
0,0,5,5,9,15,24,22,19,41,0.000333,0.062661,4,751.93385,41.774103,187.983463,87.132684,3,0
0,0,3,3,10,8,18,16,13,29,0.000333,0.040309,5,604.639125,33.591063,120.927825,57.219281,3,0
0,0,22,22,17,34,51,128,68,196,0.000333,0.370598,16,17788.72587,988.262548,1111.795367,242.460605,8,0
0,0,3,3,10,8,18,16,13,29,0.000333,0.040309,5,604.639125,33.591063,120.927825,57.219281,3,0
0,0,3,3,10,8,18,16,13,29,0.000333,0.040309,5,604.639125,33.591063,120.927825,57.219281,3,0
0,0,8,8,16,13,29,56,25,81,0.000333,0.131165,8,3147.971685,174.887316,393.496461,112.105716,3,0
0,0,3,3,10,8,18,16,13,29,0.000333,0.040309,5,604.639125,33.591063,120.927825,57.219281,3,0
0,0,14,14,11,35,46,79,67,146,0.000333,0.268813,5,4032.200228,224.011124,806.440046,217.578653,6,0
0,0,4,4,4,7,11,13,11,24,0.000333,0.027675,2,166.052718,9.225151,83.026359,27.651484,3,0
0,0,8,8,12,14,26,36,21,57,0.000333,0.089308,6,1607.550384,89.308355,267.925064,96.322519,3,0
0,0,8,8,16,13,29,53,32,85,0.000333,0.137643,16,6606.854153,367.047453,412.928385,112.105716,6,0
0,0,3,3,10,8,18,16,13,29,0.000333,0.040309,5,604.639125,33.591063,120.927825,57.219281,3,0
0,0,10,10,15,27,42,169,61,230,0.000333,0.413411,14,17363.2621,964.625672,1240.233007,186.985321,7,0
0,0,7,7,11,19,30,44,28,72,0.000333,0.117765,5,1766.480614,98.137812,353.296123,118.764371,2,0
0,0,3,3,10,8,18,16,13,29,0.000333,0.040309,5,604.639125,33.591063,120.927825,57.219281,3,0
0,0,6,6,8,10,18,26,18,44,0.000333,0.061159,4,733.9068,40.7726,183.4767,57.219281,1,0
0,0,7,7,11,19,30,44,28,72,0.000333,0.117765,5,1766.480614,98.137812,353.296123,118.764371,2,0
0,0,3,3,10,10,20,17,13,30,0.000333,0.043219,5,648.289214,36.016067,129.657843,66.438562,2,0
0,0,3,3,10,8,18,16,13,29,0.000333,0.040309,5,604.639125,33.591063,120.927825,57.219281,3,0
0,0,3,3,9,7,16,24,10,34,0.000333,0.045333,4,544,30.222222,136,48.180809,3,0
0,0,16,16,13,25,38,93,49,142,0.000333,0.248402,6,4471.234241,248.401902,745.205707,164.202121,7,0
0,0,29,29,22,49,71,182,138,320,0.000333,0.655973,22,43294.21972,2405.234429,1967.919078,373.228278,5,0
0,0,3,3,10,10,20,17,13,30,0.000333,0.043219,5,648.289214,36.016067,129.657843,66.438562,2,0
0,0,9,9,12,23,35,48,39,87,0.000333,0.148749,6,2677.485735,148.749207,446.247622,147.061475,4,0
0,0,14,14,12,28,40,131,65,196,0.000333,0.347699,12,12517.17488,695.398604,1043.097907,177.625488,3,0
0,0,3,3,10,6,16,19,10,29,0.000333,0.038667,5,580,32.222222,116,48.729056,1,0
0,0,3,3,8,10,18,17,13,30,0.000333,0.041699,4,500.391,27.7995,125.09775,57.219281,2,0
0,0,7,7,11,19,30,44,28,72,0.000333,0.117765,5,1766.480614,98.137812,353.296123,118.764371,2,0
0,0,17,17,16,23,39,110,55,165,0.000333,0.290697,16,13953.46186,775.192325,872.091366,168.041925,7,0
0,0,3,3,10,8,18,16,13,29,0.000333,0.040309,5,604.639125,33.591063,120.927825,57.219281,3,0
0,0,5,5,10,10,20,27,14,41,0.000333,0.059066,5,885.995259,49.221959,177.199052,66.438562,3,0
0,0,7,7,11,18,29,48,28,76,0.000333,0.123069,5,1846.032778,102.557377,369.206556,113.112398,1,0
0,0,5,5,14,13,27,31,20,51,0.000333,0.080833,7,1697.494838,94.305269,242.499263,101.408685,2,0
0,0,5,5,14,17,31,60,30,90,0.000333,0.148626,7,3121.143676,173.396871,445.877668,122.789837,4,0
0,0,8,8,13,12,25,43,26,69,0.000333,0.106809,12,3845.112925,213.617385,320.426077,91.125266,4,0
0,0,9,9,13,12,25,53,31,84,0.000333,0.130028,12,4681.007039,260.055947,390.08392,91.125266,4,0
0,0,8,8,12,13,25,41,24,65,0.000333,0.100617,6,1811.103914,100.616884,301.850652,91.125266,4,0
0,0,4,4,7,9,16,16,12,28,0.000333,0.037333,3,336,18.666667,112,48.180809,3,0
0,0,4,4,10,12,22,21,17,38,0.000333,0.056486,5,847.292008,47.071778,169.458402,76.238831,1,0
0,0,4,4,6,8,14,17,12,29,0.000333,0.036804,3,331.239878,18.402215,110.413293,39.509775,3,0
0,0,6,6,15,15,30,35,24,59,0.000333,0.096502,7,2026.545816,112.585879,289.506545,117.206718,4,0
0,0,3,3,10,8,18,16,13,29,0.000333,0.040309,5,604.639125,33.591063,120.927825,57.219281,3,0
0,0,4,4,4,7,11,13,11,24,0.000333,0.027675,2,166.052718,9.225151,83.026359,27.651484,3,0
0,0,4,4,4,7,11,13,11,24,0.000333,0.027675,2,166.052718,9.225151,83.026359,27.651484,3,0
0,0,17,17,16,23,39,110,55,165,0.000333,0.290697,16,13953.46186,775.192325,872.091366,168.041925,7,0
0,0,3,3,9,7,16,24,10,34,0.000333,0.045333,4,544,30.222222,136,48.180809,3,0
0,0,4,4,4,7,11,13,11,24,0.000333,0.027675,2,166.052718,9.225151,83.026359,27.651484,3,0
0,0,8,8,9,17,26,35,26,61,0.000333,0.095576,4,1146.907291,63.717072,286.726823,98.016193,3,0
0,0,4,4,4,7,11,13,11,24,0.000333,0.027675,2,166.052718,9.225151,83.026359,27.651484,3,0
0,0,14,14,11,35,46,79,67,146,0.000333,0.268813,5,4032.200228,224.011124,806.440046,217.578653,6,0
0,0,3,3,10,8,18,16,13,29,0.000333,0.040309,5,604.639125,33.591063,120.927825,57.219281,3,0
0,0,4,4,4,7,11,13,11,24,0.000333,0.027675,2,166.052718,9.225151,83.026359,27.651484,3,0
0,0,3,3,10,8,18,16,13,29,0.000333,0.040309,5,604.639125,33.591063,120.927825,57.219281,3,0
0,0,3,3,10,8,18,16,13,29,0.000333,0.040309,5,604.639125,33.591063,120.927825,57.219281,3,0
0,0,3,3,9,9,18,18,13,31,0.000333,0.043089,4,517.0707,28.72615,129.267675,57.05865,2,0
0,0,3,3,8,10,18,20,13,33,0.000333,0.045869,4,550.4301,30.57945,137.607525,57.219281,3,0
0,0,7,7,11,19,30,44,28,72,0.000333,0.117765,5,1766.480614,98.137812,353.296123,118.764371,2,0
0,0,5,5,11,12,23,33,21,54,0.000333,0.081424,5,1221.361728,67.853429,244.272346,81.073298,1,0
0,0,7,7,11,16,27,35,27,62,0.000333,0.098268,5,1474.015126,81.889729,294.803025,102.053748,2,0
0,0,3,3,10,8,18,16,13,29,0.000333,0.040309,5,604.639125,33.591063,120.927825,57.219281,3,0
0,0,3,3,8,13,21,29,17,46,0.000333,0.067349,4,808.186406,44.899245,202.046601,72.105716,2,0
0,0,3,3,9,9,18,18,13,31,0.000333,0.043089,4,517.0707,28.72615,129.267675,57.05865,2,0
0,0,3,3,9,9,18,18,13,31,0.000333,0.043089,4,517.0707,28.72615,129.267675,57.05865,2,0
0,0,4,4,10,12,22,21,17,38,0.000333,0.056486,5,847.292008,47.071778,169.458402,76.238831,1,0
0,0,4,4,7,12,19,20,18,38,0.000333,0.053807,3,484.263737,26.903541,161.421246,62.671034,2,0
0,0,4,4,6,8,14,17,12,29,0.000333,0.036804,3,331.239878,18.402215,110.413293,39.509775,3,0
0,0,3,3,8,5,13,13,7,20,0.000333,0.02467,4,296.035177,16.446399,74.008794,35.60964,2,0
0,0,3,3,10,8,18,16,13,29,0.000333,0.040309,5,604.639125,33.591063,120.927825,57.219281,3,0
0,0,9,9,10,19,29,39,30,69,0.000333,0.111734,5,1676.003443,93.111302,335.200689,113.929904,3,0
0,0,11,11,15,21,36,84,43,127,0.000333,0.21886,14,9192.126653,510.673703,656.580475,150.842025,2,0
0,0,3,3,10,8,18,16,13,29,0.000333,0.040309,5,604.639125,33.591063,120.927825,57.219281,3,0
0,0,3,3,10,8,18,16,13,29,0.000333,0.040309,5,604.639125,33.591063,120.927825,57.219281,3,0
0,0,9,9,11,19,30,44,37,81,0.000333,0.132486,5,1987.290691,110.405038,397.458138,118.764371,4,0
0,0,4,4,10,7,17,21,10,31,0.000333,0.042237,5,633.55674,35.197597,126.711348,52.870765,8,0
0,0,5,5,14,17,31,60,30,90,0.000333,0.148626,7,3121.143676,173.396871,445.877668,122.789837,4,0
0,0,5,5,12,13,25,38,18,56,0.000333,0.086685,6,1560.33568,86.685316,260.055947,91.125266,2,0
0,0,3,3,10,8,18,16,13,29,0.000333,0.040309,5,604.639125,33.591063,120.927825,57.219281,3,0
0,0,3,3,10,8,18,16,13,29,0.000333,0.040309,5,604.639125,33.591063,120.927825,57.219281,3,0
0,0,6,6,13,13,26,38,23,61,0.000333,0.095576,6,1720.360937,95.575608,286.726823,96.211433,4,0
0,0,3,3,10,8,18,16,13,29,0.000333,0.040309,5,604.639125,33.591063,120.927825,57.219281,3,0
0,0,4,4,9,7,16,18,10,28,0.000333,0.037333,4,448,24.888889,112,48.180809,2,0
0,0,3,3,10,6,16,19,10,29,0.000333,0.038667,5,580,32.222222,116,48.729056,1,0
0,0,4,4,11,10,21,26,17,43,0.000333,0.062957,5,944.348246,52.463791,188.869649,71.273029,2,0
0,0,3,3,10,8,18,16,13,29,0.000333,0.040309,5,604.639125,33.591063,120.927825,57.219281,3,0
0,0,8,8,15,18,33,45,33,78,0.000333,0.131154,7,2754.239189,153.013288,393.462741,133.662009,4,0
0,0,7,7,9,21,30,28,27,55,0.000333,0.08996,4,1079.515931,59.973107,269.878983,120.767991,3,0
0,0,3,3,10,8,18,16,13,29,0.000333,0.040309,5,604.639125,33.591063,120.927825,57.219281,3,0
0,0,3,3,10,10,20,17,13,30,0.000333,0.043219,5,648.289214,36.016067,129.657843,66.438562,2,0
0,0,7,7,11,19,30,44,28,72,0.000333,0.117765,5,1766.480614,98.137812,353.296123,118.764371,2,0
0,0,14,14,13,23,36,81,43,124,0.000333,0.21369,6,3846.424201,213.690233,641.0707,152.147641,5,0
0,0,4,4,10,12,22,21,17,38,0.000333,0.056486,5,847.292008,47.071778,169.458402,76.238831,1,0
0,0,3,3,10,6,16,19,10,29,0.000333,0.038667,5,580,32.222222,116,48.729056,1,0
0,0,4,4,4,7,11,13,11,24,0.000333,0.027675,2,166.052718,9.225151,83.026359,27.651484,3,0
0,0,29,29,22,49,71,182,138,320,0.000333,0.655973,22,43294.21972,2405.234429,1967.919078,373.228278,5,0
0,0,3,3,10,8,18,16,13,29,0.000333,0.040309,5,604.639125,33.591063,120.927825,57.219281,3,0
0,0,19,19,12,26,38,116,56,172,0.000333,0.300881,12,10831.72239,601.762355,902.643532,165.230983,13,0
0,0,3,3,9,9,18,18,13,31,0.000333,0.043089,4,517.0707,28.72615,129.267675,57.05865,2,0
0,0,3,3,8,9,17,17,12,29,0.000333,0.039512,4,474.14569,26.341427,118.536422,52.529325,2,0
0,0,3,3,10,8,18,16,13,29,0.000333,0.040309,5,604.639125,33.591063,120.927825,57.219281,3,0
0,0,4,4,4,7,11,13,11,24,0.000333,0.027675,2,166.052718,9.225151,83.026359,27.651484,3,0
0,0,3,3,10,8,18,16,13,29,0.000333,0.040309,5,604.639125,33.591063,120.927825,57.219281,3,0
0,0,3,3,9,9,18,18,13,31,0.000333,0.043089,4,517.0707,28.72615,129.267675,57.05865,2,0
0,0,3,3,10,8,18,16,13,29,0.000333,0.040309,5,604.639125,33.591063,120.927825,57.219281,3,0
0,0,3,3,10,8,18,16,13,29,0.000333,0.040309,5,604.639125,33.591063,120.927825,57.219281,3,0
0,0,15,15,14,26,40,76,61,137,0.000333,0.243035,14,10207.45809,567.081005,729.104149,175.514402,2,0
0,0,3,3,10,8,18,16,13,29,0.000333,0.040309,5,604.639125,33.591063,120.927825,57.219281,3,0
0,0,4,4,10,11,21,20,15,35,0.000333,0.051244,5,768.655549,42.703086,153.73111,71.273029,2,0
0,0,3,3,10,10,20,17,13,30,0.000333,0.043219,5,648.289214,36.016067,129.657843,66.438562,2,0
0,0,3,3,10,8,18,16,13,29,0.000333,0.040309,5,604.639125,33.591063,120.927825,57.219281,3,0
0,0,7,7,11,19,30,44,28,72,0.000333,0.117765,5,1766.480614,98.137812,353.296123,118.764371,2,0
0,0,3,3,9,9,18,18,13,31,0.000333,0.043089,4,517.0707,28.72615,129.267675,57.05865,2,0
0,0,36,36,21,47,68,186,116,302,0.000333,0.612805,20,36768.27556,2042.681976,1838.413778,353.304342,16,0
0,0,3,3,10,8,18,16,13,29,0.000333,0.040309,5,604.639125,33.591063,120.927825,57.219281,3,0
0,0,4,4,10,12,22,21,17,38,0.000333,0.056486,5,847.292008,47.071778,169.458402,76.238831,1,0
0,0,3,3,10,10,20,17,13,30,0.000333,0.043219,5,648.289214,36.016067,129.657843,66.438562,2,0
0,0,3,3,10,8,18,16,13,29,0.000333,0.040309,5,604.639125,33.591063,120.927825,57.219281,3,0
0,0,4,4,6,8,14,17,12,29,0.000333,0.036804,3,331.239878,18.402215,110.413293,39.509775,3,0
0,0,5,5,12,16,28,39,25,64,0.000333,0.102557,6,1846.02429,102.556905,307.670715,107.01955,2,0
0,0,7,7,11,19,30,44,28,72,0.000333,0.117765,5,1766.480614,98.137812,353.296123,118.764371,2,0
0,0,3,3,10,8,18,16,13,29,0.000333,0.040309,5,604.639125,33.591063,120.927825,57.219281,3,0
0,0,4,4,11,10,21,26,17,43,0.000333,0.062957,5,944.348246,52.463791,188.869649,71.273029,2,0
0,0,3,3,10,8,18,16,13,29,0.000333,0.040309,5,604.639125,33.591063,120.927825,57.219281,3,0
0,0,39,39,17,44,61,187,110,297,0.000333,0.587143,16,28182.86383,1565.714657,1761.428989,309.70186,14,0
0,0,7,7,11,19,30,44,28,72,0.000333,0.117765,5,1766.480614,98.137812,353.296123,118.764371,2,0
0,0,5,5,9,15,24,22,19,41,0.000333,0.062661,4,751.93385,41.774103,187.983463,87.132684,3,0
0,0,4,4,11,10,21,26,17,43,0.000333,0.062957,5,944.348246,52.463791,188.869649,71.273029,2,0
0,0,8,8,16,13,29,56,25,81,0.000333,0.131165,8,3147.971685,174.887316,393.496461,112.105716,3,0
0,0,3,3,10,8,18,16,13,29,0.000333,0.040309,5,604.639125,33.591063,120.927825,57.219281,3,0
0,0,7,7,11,19,30,44,28,72,0.000333,0.117765,5,1766.480614,98.137812,353.296123,118.764371,2,0
0,0,3,3,8,9,17,17,12,29,0.000333,0.039512,4,474.14569,26.341427,118.536422,52.529325,2,0
0,0,3,3,10,8,18,16,13,29,0.000333,0.040309,5,604.639125,33.591063,120.927825,57.219281,3,0
0,0,3,3,9,9,18,18,13,31,0.000333,0.043089,4,517.0707,28.72615,129.267675,57.05865,2,0
0,0,4,4,10,9,19,46,19,65,0.000333,0.092038,10,2761.152884,153.397382,276.115288,61.748606,11,0
0,0,37,37,19,55,74,196,117,313,0.000333,0.647853,18,34984.06026,1943.558903,1943.558903,398.685407,13,0
0,0,6,6,10,14,24,28,21,49,0.000333,0.074888,5,1123.315813,62.406434,224.663163,86.52225,1,0
0,0,6,6,12,14,26,33,26,59,0.000333,0.092442,6,1663.95566,92.441981,277.325943,96.322519,2,0
0,0,5,5,8,12,20,20,16,36,0.000333,0.051863,4,622.357646,34.575425,155.589411,67.01955,3,0
0,0,4,4,4,7,11,13,11,24,0.000333,0.027675,2,166.052718,9.225151,83.026359,27.651484,3,0
0,0,3,3,10,8,18,16,13,29,0.000333,0.040309,5,604.639125,33.591063,120.927825,57.219281,3,0
0,0,4,4,11,9,20,24,12,36,0.000333,0.051863,5,777.947057,43.219281,155.589411,66.583073,5,0
0,0,4,4,7,13,20,20,20,40,0.000333,0.057626,3,518.631371,28.812854,172.877124,67.757201,2,0
0,0,3,3,9,9,18,18,13,31,0.000333,0.043089,4,517.0707,28.72615,129.267675,57.05865,2,0
0,0,4,4,4,7,11,13,11,24,0.000333,0.027675,2,166.052718,9.225151,83.026359,27.651484,3,0
0,0,7,7,11,19,30,44,28,72,0.000333,0.117765,5,1766.480614,98.137812,353.296123,118.764371,2,0
0,0,7,7,11,19,30,44,28,72,0.000333,0.117765,5,1766.480614,98.137812,353.296123,118.764371,2,0
0,0,4,4,4,7,11,13,11,24,0.000333,0.027675,2,166.052718,9.225151,83.026359,27.651484,3,0
0,0,3,3,10,6,16,21,9,30,0.000333,0.04,5,600,33.333333,120,48.729056,3,0
0,0,8,8,15,18,33,66,34,100,0.000333,0.168146,7,3531.075884,196.170882,504.439412,133.662009,2,0
0,0,6,6,13,13,26,38,23,61,0.000333,0.095576,6,1720.360937,95.575608,286.726823,96.211433,4,0
0,0,6,6,13,13,26,38,23,61,0.000333,0.095576,6,1720.360937,95.575608,286.726823,96.211433,4,0
0,0,7,7,11,19,30,44,28,72,0.000333,0.117765,5,1766.480614,98.137812,353.296123,118.764371,2,0
0,0,3,3,10,8,18,16,13,29,0.000333,0.040309,5,604.639125,33.591063,120.927825,57.219281,3,0
0,0,4,4,13,8,21,27,11,38,0.000333,0.055636,6,1001.448372,55.636021,166.908062,72.105716,3,0
0,0,3,3,10,8,18,16,13,29,0.000333,0.040309,5,604.639125,33.591063,120.927825,57.219281,3,0
0,0,4,4,10,12,22,21,17,38,0.000333,0.056486,5,847.292008,47.071778,169.458402,76.238831,1,0
0,0,3,3,10,10,20,17,13,30,0.000333,0.043219,5,648.289214,36.016067,129.657843,66.438562,2,0
0,0,6,6,13,13,26,38,23,61,0.000333,0.095576,6,1720.360937,95.575608,286.726823,96.211433,4,0
0,0,6,6,11,14,25,29,21,50,0.000333,0.077398,5,1160.964047,64.498003,232.192809,91.356717,1,0
0,0,6,6,13,13,26,38,23,61,0.000333,0.095576,6,1720.360937,95.575608,286.726823,96.211433,4,0
0,0,3,3,10,8,18,16,13,29,0.000333,0.040309,5,604.639125,33.591063,120.927825,57.219281,3,0
0,0,7,7,11,19,30,44,28,72,0.000333,0.117765,5,1766.480614,98.137812,353.296123,118.764371,2,0
0,0,3,3,11,11,22,26,15,41,0.000333,0.060946,5,914.183482,50.787971,182.836696,76.107496,3,0
0,0,3,3,8,5,13,13,7,20,0.000333,0.02467,4,296.035177,16.446399,74.008794,35.60964,2,0
0,0,5,5,12,16,28,39,25,64,0.000333,0.102557,6,1846.02429,102.556905,307.670715,107.01955,2,0
0,0,3,3,10,8,18,16,13,29,0.000333,0.040309,5,604.639125,33.591063,120.927825,57.219281,3,0
0,0,4,4,14,9,23,32,12,44,0.000333,0.066346,7,1393.257082,77.403171,199.036726,81.832294,3,0
0,0,4,4,4,7,11,13,11,24,0.000333,0.027675,2,166.052718,9.225151,83.026359,27.651484,3,0
0,0,4,4,4,7,11,13,11,24,0.000333,0.027675,2,166.052718,9.225151,83.026359,27.651484,3,0
0,0,7,7,11,19,30,44,28,72,0.000333,0.117765,5,1766.480614,98.137812,353.296123,118.764371,2,0
0,0,3,3,10,8,18,16,13,29,0.000333,0.040309,5,604.639125,33.591063,120.927825,57.219281,3,0
0,0,3,3,10,11,21,22,15,37,0.000333,0.054172,5,812.578723,45.143262,162.515745,71.273029,4,0
0,0,3,3,9,9,18,18,13,31,0.000333,0.043089,4,517.0707,28.72615,129.267675,57.05865,2,0
0,0,4,4,4,7,11,13,11,24,0.000333,0.027675,2,166.052718,9.225151,83.026359,27.651484,3,0
0,0,3,3,10,8,18,16,13,29,0.000333,0.040309,5,604.639125,33.591063,120.927825,57.219281,3,0
0,0,3,3,10,6,16,19,10,29,0.000333,0.038667,5,580,32.222222,116,48.729056,1,0
0,0,7,7,12,17,29,43,27,70,0.000333,0.113353,6,2040.352018,113.35289,340.05867,112.506418,4,0
0,0,7,7,11,19,30,44,28,72,0.000333,0.117765,5,1766.480614,98.137812,353.296123,118.764371,2,0
0,0,3,3,9,9,18,18,13,31,0.000333,0.043089,4,517.0707,28.72615,129.267675,57.05865,2,0
0,0,3,3,10,11,21,22,15,37,0.000333,0.054172,5,812.578723,45.143262,162.515745,71.273029,4,0
0,0,3,3,10,8,18,16,13,29,0.000333,0.040309,5,604.639125,33.591063,120.927825,57.219281,3,0
0,0,14,14,14,16,30,66,60,126,0.000333,0.206089,21,12983.63252,721.312918,618.268215,117.302969,3,0
0,0,10,10,16,16,32,56,37,93,0.000333,0.155,16,7440,413.333333,465,128,4,0
0,0,3,3,10,8,18,16,13,29,0.000333,0.040309,5,604.639125,33.591063,120.927825,57.219281,3,0
0,0,17,17,16,23,39,110,55,165,0.000333,0.290697,16,13953.46186,775.192325,872.091366,168.041925,7,0
0,0,3,3,10,8,18,16,13,29,0.000333,0.040309,5,604.639125,33.591063,120.927825,57.219281,3,0
0,0,7,7,12,17,29,43,27,70,0.000333,0.113353,6,2040.352018,113.35289,340.05867,112.506418,4,0
0,0,7,7,11,19,30,44,28,72,0.000333,0.117765,5,1766.480614,98.137812,353.296123,118.764371,2,0
0,0,3,3,10,8,18,16,13,29,0.000333,0.040309,5,604.639125,33.591063,120.927825,57.219281,3,0
0,0,4,4,4,7,11,13,11,24,0.000333,0.027675,2,166.052718,9.225151,83.026359,27.651484,3,0
0,0,4,4,6,8,14,17,12,29,0.000333,0.036804,3,331.239878,18.402215,110.413293,39.509775,3,0
0,0,8,8,9,17,26,35,26,61,0.000333,0.095576,4,1146.907291,63.717072,286.726823,98.016193,3,0
0,0,3,3,10,11,21,22,15,37,0.000333,0.054172,5,812.578723,45.143262,162.515745,71.273029,4,0
0,0,10,10,15,20,35,54,43,97,0.000333,0.165847,14,6965.566337,386.975908,497.540453,145.041921,4,0
0,0,3,3,9,9,18,18,13,31,0.000333,0.043089,4,517.0707,28.72615,129.267675,57.05865,2,0
0,0,3,3,10,8,18,16,13,29,0.000333,0.040309,5,604.639125,33.591063,120.927825,57.219281,3,0
0,0,8,8,12,13,25,41,24,65,0.000333,0.100617,6,1811.103914,100.616884,301.850652,91.125266,4,0
0,0,8,8,12,12,24,42,26,68,0.000333,0.103926,12,3741.329401,207.851633,311.77745,86.0391,4,0
0,0,9,9,12,12,24,52,31,83,0.000333,0.126851,12,4566.622651,253.701258,380.551888,86.0391,4,0
0,0,3,3,10,8,18,16,13,29,0.000333,0.040309,5,604.639125,33.591063,120.927825,57.219281,3,0
0,0,3,3,10,8,18,16,13,29,0.000333,0.040309,5,604.639125,33.591063,120.927825,57.219281,3,0
0,0,3,3,9,13,22,180,17,197,0.000333,0.292836,4,3514.032115,195.224006,878.508029,76.635041,1,0
0,0,3,3,10,8,18,16,13,29,0.000333,0.040309,5,604.639125,33.591063,120.927825,57.219281,3,0
0,0,3,3,10,10,20,17,13,30,0.000333,0.043219,5,648.289214,36.016067,129.657843,66.438562,2,0
0,0,17,17,15,28,43,101,53,154,0.000333,0.278548,7,5849.513406,324.972967,835.644772,193.209297,5,0
0,0,3,3,10,11,21,22,15,37,0.000333,0.054172,5,812.578723,45.143262,162.515745,71.273029,4,0
0,0,5,5,12,16,28,39,25,64,0.000333,0.102557,6,1846.02429,102.556905,307.670715,107.01955,3,0
0,0,4,4,7,9,16,16,12,28,0.000333,0.037333,3,336,18.666667,112,48.180809,3,0
0,0,3,3,10,11,21,22,15,37,0.000333,0.054172,5,812.578723,45.143262,162.515745,71.273029,4,0
0,0,3,3,9,9,18,18,13,31,0.000333,0.043089,4,517.0707,28.72615,129.267675,57.05865,2,0
0,0,4,4,8,11,19,17,15,32,0.000333,0.045311,4,543.734722,30.207485,135.93368,62.053748,3,0
0,0,5,5,11,14,25,27,24,51,0.000333,0.078946,5,1184.183328,65.787963,236.836666,91.356717,2,0
0,0,3,3,10,8,18,16,13,29,0.000333,0.040309,5,604.639125,33.591063,120.927825,57.219281,3,0
0,0,3,3,10,6,16,19,10,29,0.000333,0.038667,5,580,32.222222,116,48.729056,1,0
0,0,4,4,4,6,10,16,12,28,0.000333,0.031005,4,372.055947,20.669775,93.013987,23.509775,1,0
0,0,17,17,16,23,39,110,55,165,0.000333,0.290697,16,13953.46186,775.192325,872.091366,168.041925,7,0
0,0,3,3,11,11,22,26,15,41,0.000333,0.060946,5,914.183482,50.787971,182.836696,76.107496,3,0
0,0,4,4,4,7,11,13,11,24,0.000333,0.027675,2,166.052718,9.225151,83.026359,27.651484,3,0
0,0,13,13,14,26,40,67,50,117,0.000333,0.207555,7,4358.65911,242.147728,622.665587,175.514402,4,0
0,0,3,3,10,10,20,17,13,30,0.000333,0.043219,5,648.289214,36.016067,129.657843,66.438562,2,0
0,0,24,24,15,31,46,259,88,347,0.000333,0.638892,14,26833.46398,1490.747999,1916.675999,212.183445,4,0
0,0,7,7,11,19,30,44,28,72,0.000333,0.117765,5,1766.480614,98.137812,353.296123,118.764371,2,0
0,0,4,4,7,13,20,32,18,50,0.000333,0.072032,3,648.289214,36.016067,216.096405,67.757201,1,0
0,0,3,3,10,8,18,16,13,29,0.000333,0.040309,5,604.639125,33.591063,120.927825,57.219281,3,0
0,0,7,7,11,19,30,44,28,72,0.000333,0.117765,5,1766.480614,98.137812,353.296123,118.764371,2,0
0,0,27,27,17,37,54,142,78,220,0.000333,0.422025,16,20257.20401,1125.400223,1266.07525,262.236643,11,0
0,0,4,4,4,7,11,13,11,24,0.000333,0.027675,2,166.052718,9.225151,83.026359,27.651484,3,0
0,0,4,4,6,6,12,21,10,31,0.000333,0.037045,3,333.401513,18.522306,111.133838,31.01955,1,0
0,0,3,3,10,6,16,19,10,29,0.000333,0.038667,5,580,32.222222,116,48.729056,1,0
0,0,7,7,17,21,38,52,37,89,0.000333,0.155689,8,3736.52439,207.584688,467.065549,161.725534,5,0
0,0,3,3,9,9,18,18,13,31,0.000333,0.043089,4,517.0707,28.72615,129.267675,57.05865,2,0
0,0,11,11,15,21,36,84,43,127,0.000333,0.21886,14,9192.126653,510.673703,656.580475,150.842025,2,0
0,0,9,9,15,19,34,68,35,103,0.000333,0.17467,7,3668.060709,203.78115,524.008673,139.313982,2,0
0,0,3,3,10,8,18,16,13,29,0.000333,0.040309,5,604.639125,33.591063,120.927825,57.219281,3,0
0,0,4,4,4,7,11,13,11,24,0.000333,0.027675,2,166.052718,9.225151,83.026359,27.651484,3,0
0,0,7,7,11,19,30,44,28,72,0.000333,0.117765,5,1766.480614,98.137812,353.296123,118.764371,2,0
0,0,4,4,11,9,20,24,12,36,0.000333,0.051863,5,777.947057,43.219281,155.589411,66.583073,5,0
0,0,7,7,11,19,30,44,28,72,0.000333,0.117765,5,1766.480614,98.137812,353.296123,118.764371,2,0
0,0,3,3,10,11,21,22,15,37,0.000333,0.054172,5,812.578723,45.143262,162.515745,71.273029,4,0
0,0,3,3,9,9,18,18,13,31,0.000333,0.043089,4,517.0707,28.72615,129.267675,57.05865,2,0
0,0,7,7,11,19,30,44,28,72,0.000333,0.117765,5,1766.480614,98.137812,353.296123,118.764371,2,0
0,0,27,27,17,36,53,139,77,216,0.000333,0.41241,16,19795.69309,1099.760727,1237.230818,255.604168,10,0
0,0,3,3,5,6,11,9,8,17,0.000333,0.019603,2,117.620675,6.534482,58.810338,27.119415,1,0
0,0,3,3,10,8,18,16,13,29,0.000333,0.040309,5,604.639125,33.591063,120.927825,57.219281,3,0
0,0,7,7,12,17,29,43,27,70,0.000333,0.113353,6,2040.352018,113.35289,340.05867,112.506418,4,0
0,0,3,3,10,8,18,16,13,29,0.000333,0.040309,5,604.639125,33.591063,120.927825,57.219281,3,0
0,0,7,7,11,19,30,44,28,72,0.000333,0.117765,5,1766.480614,98.137812,353.296123,118.764371,2,0
0,0,4,4,6,8,14,17,12,29,0.000333,0.036804,3,331.239878,18.402215,110.413293,39.509775,3,0
0,0,8,8,9,17,26,35,26,61,0.000333,0.095576,4,1146.907291,63.717072,286.726823,98.016193,3,0
0,0,17,17,20,17,37,107,56,163,0.000333,0.283047,30,25474.22696,1415.234831,849.140899,155.92543,13,0
0,0,3,3,10,8,18,16,13,29,0.000333,0.040309,5,604.639125,33.591063,120.927825,57.219281,3,0
0,0,6,6,15,15,30,35,24,59,0.000333,0.096502,7,2026.545816,112.585879,289.506545,117.206718,4,0
0,0,28,28,17,39,56,145,80,225,0.000333,0.435552,16,20906.47772,1161.470984,1306.654857,275.617555,11,0
0,0,3,3,10,8,18,16,13,29,0.000333,0.040309,5,604.639125,33.591063,120.927825,57.219281,3,0
0,0,5,5,11,13,24,28,20,48,0.000333,0.073359,5,1100.391,61.132833,220.0782,86.159464,4,0
0,0,4,4,11,10,21,26,17,43,0.000333,0.062957,5,944.348246,52.463791,188.869649,71.273029,2,0
0,0,7,7,12,17,29,43,27,70,0.000333,0.113353,6,2040.352018,113.35289,340.05867,112.506418,4,0
0,0,3,3,10,8,18,16,13,29,0.000333,0.040309,5,604.639125,33.591063,120.927825,57.219281,3,0
0,0,3,3,10,10,20,17,13,30,0.000333,0.043219,5,648.289214,36.016067,129.657843,66.438562,2,0
0,0,13,13,14,26,40,103,62,165,0.000333,0.292706,14,12293.6539,682.980772,878.118136,175.514402,2,0
0,0,3,3,7,9,16,17,12,29,0.000333,0.038667,3,348,19.333333,116,48.180809,2,0
0,0,6,6,11,13,24,34,22,56,0.000333,0.085586,5,1283.7895,71.321639,256.7579,86.159464,3,0
0,0,4,4,8,8,16,17,15,32,0.000333,0.042667,4,512,28.444444,128,48,1,0
0,0,26,26,17,34,51,136,75,211,0.000333,0.398961,16,19150.10795,1063.894886,1196.881747,242.460605,10,0
0,0,7,7,12,17,29,43,27,70,0.000333,0.113353,6,2040.352018,113.35289,340.05867,112.506418,4,0
0,0,7,7,11,19,30,44,28,72,0.000333,0.117765,5,1766.480614,98.137812,353.296123,118.764371,2,0
0,0,3,3,9,9,18,18,13,31,0.000333,0.043089,4,517.0707,28.72615,129.267675,57.05865,2,0
0,0,5,5,9,15,24,26,23,49,0.000333,0.074888,4,898.65265,49.925147,224.663163,87.132684,2,0
0,0,5,5,9,9,18,34,14,48,0.000333,0.066719,4,800.6256,44.4792,200.1564,57.05865,3,0
0,0,3,3,9,9,18,18,13,31,0.000333,0.043089,4,517.0707,28.72615,129.267675,57.05865,2,0
0,0,3,3,10,8,18,16,13,29,0.000333,0.040309,5,604.639125,33.591063,120.927825,57.219281,3,0
0,0,7,7,10,16,26,43,35,78,0.000333,0.122211,10,3666.34298,203.685721,366.634298,97.219281,2,0
0,0,19,19,21,26,47,149,82,231,0.000333,0.427703,30,38493.30074,2138.516708,1283.110025,214.450099,11,0
0,0,15,15,12,24,36,88,45,133,0.000333,0.2292,6,4125.600151,229.200008,687.600025,153.05865,5,0
0,0,17,17,21,26,47,131,75,206,0.000333,0.381415,20,22884.90607,1271.38367,1144.245303,214.450099,9,0
0,0,4,4,11,9,20,24,12,36,0.000333,0.051863,5,777.947057,43.219281,155.589411,66.583073,5,0
0,0,4,4,8,11,19,17,15,32,0.000333,0.045311,4,543.734722,30.207485,135.93368,62.053748,3,0
0,0,28,28,17,41,58,146,80,226,0.000333,0.441301,8,10591.22964,588.401647,1323.903705,289.1465,10,0
0,0,4,4,11,10,21,26,17,43,0.000333,0.062957,5,944.348246,52.463791,188.869649,71.273029,2,0
0,0,7,7,14,16,30,42,33,75,0.000333,0.122672,14,5152.235125,286.235285,368.016795,117.302969,4,0
0,0,4,4,11,9,20,24,12,36,0.000333,0.051863,5,777.947057,43.219281,155.589411,66.583073,5,0
0,0,6,6,14,11,25,38,23,61,0.000333,0.094425,14,3965.853186,220.325177,283.275228,91.356717,4,0
0,0,5,5,9,15,24,22,19,41,0.000333,0.062661,4,751.93385,41.774103,187.983463,87.132684,3,0
0,0,3,3,5,6,11,9,8,17,0.000333,0.019603,2,117.620675,6.534482,58.810338,27.119415,1,0
0,0,7,7,11,19,30,44,28,72,0.000333,0.117765,5,1766.480614,98.137812,353.296123,118.764371,2,0
0,0,4,4,11,10,21,26,17,43,0.000333,0.062957,5,944.348246,52.463791,188.869649,71.273029,2,0
0,0,17,17,16,23,39,110,55,165,0.000333,0.290697,16,13953.46186,775.192325,872.091366,168.041925,7,0
0,0,8,8,16,13,29,53,32,85,0.000333,0.137643,16,6606.854153,367.047453,412.928385,112.105716,6,0
0,0,22,22,17,35,52,129,69,198,0.000333,0.376229,8,9029.496514,501.638695,1128.687064,249.011774,8,0
0,0,17,17,16,23,39,110,55,165,0.000333,0.290697,16,13953.46186,775.192325,872.091366,168.041925,7,0
0,0,8,8,13,20,33,55,28,83,0.000333,0.139562,6,2512.108271,139.561571,418.684712,134.544278,3,0
0,0,6,6,10,15,25,28,22,50,0.000333,0.077398,5,1160.964047,64.498003,232.192809,91.82264,1,0
0,0,4,4,11,10,21,26,17,43,0.000333,0.062957,5,944.348246,52.463791,188.869649,71.273029,2,0
0,0,6,6,11,15,26,29,22,51,0.000333,0.079907,5,1198.612128,66.589563,239.722426,96.657107,1,0
0,0,6,6,11,15,26,29,22,51,0.000333,0.079907,5,1198.612128,66.589563,239.722426,96.657107,1,0
0,0,7,7,10,14,24,35,22,57,0.000333,0.087114,5,1306.714313,72.59524,261.342863,86.52225,5,0
0,0,12,12,11,19,30,73,36,109,0.000333,0.178284,5,2674.255375,148.569743,534.851075,118.764371,5,0
0,0,7,7,11,19,30,44,28,72,0.000333,0.117765,5,1766.480614,98.137812,353.296123,118.764371,2,0
0,0,3,3,10,8,18,16,13,29,0.000333,0.040309,5,604.639125,33.591063,120.927825,57.219281,3,0
0,0,4,4,11,9,20,24,12,36,0.000333,0.051863,5,777.947057,43.219281,155.589411,66.583073,5,0
0,0,4,4,4,7,11,13,11,24,0.000333,0.027675,2,166.052718,9.225151,83.026359,27.651484,3,0
0,0,3,3,10,6,16,19,10,29,0.000333,0.038667,5,580,32.222222,116,48.729056,1,0
0,0,4,4,8,11,19,17,15,32,0.000333,0.045311,4,543.734722,30.207485,135.93368,62.053748,3,0
0,0,3,3,10,8,18,16,13,29,0.000333,0.040309,5,604.639125,33.591063,120.927825,57.219281,3,0
0,0,3,3,10,10,20,17,13,30,0.000333,0.043219,5,648.289214,36.016067,129.657843,66.438562,2,0
0,0,4,4,4,7,11,13,11,24,0.000333,0.027675,2,166.052718,9.225151,83.026359,27.651484,3,0
0,0,4,4,11,9,20,24,12,36,0.000333,0.051863,5,777.947057,43.219281,155.589411,66.583073,5,0
0,0,7,7,11,19,30,44,28,72,0.000333,0.117765,5,1766.480614,98.137812,353.296123,118.764371,2,0
0,0,34,34,16,41,57,199,118,317,0.000333,0.616342,16,29584.41815,1643.578786,1849.026134,283.659632,4,0
0,0,3,3,10,6,16,19,10,29,0.000333,0.038667,5,580,32.222222,116,48.729056,1,0
0,0,7,7,11,19,30,44,28,72,0.000333,0.117765,5,1766.480614,98.137812,353.296123,118.764371,2,0
0,0,7,7,11,19,30,44,28,72,0.000333,0.117765,5,1766.480614,98.137812,353.296123,118.764371,2,0
0,0,3,3,10,8,18,16,13,29,0.000333,0.040309,5,604.639125,33.591063,120.927825,57.219281,3,0
0,0,7,7,11,19,30,44,28,72,0.000333,0.117765,5,1766.480614,98.137812,353.296123,118.764371,2,0
0,0,3,3,10,8,18,16,13,29,0.000333,0.040309,5,604.639125,33.591063,120.927825,57.219281,3,0
0,0,7,7,11,19,30,44,28,72,0.000333,0.117765,5,1766.480614,98.137812,353.296123,118.764371,2,0
0,0,7,7,17,21,38,52,37,89,0.000333,0.155689,8,3736.52439,207.584688,467.065549,161.725534,5,0
0,0,7,7,11,19,30,44,28,72,0.000333,0.117765,5,1766.480614,98.137812,353.296123,118.764371,2,0
0,0,17,17,16,23,39,110,55,165,0.000333,0.290697,16,13953.46186,775.192325,872.091366,168.041925,7,0
0,0,4,4,6,8,14,17,12,29,0.000333,0.036804,3,331.239878,18.402215,110.413293,39.509775,3,0
0,0,3,3,10,8,18,16,13,29,0.000333,0.040309,5,604.639125,33.591063,120.927825,57.219281,3,0
0,0,7,7,11,19,30,44,28,72,0.000333,0.117765,5,1766.480614,98.137812,353.296123,118.764371,2,0
0,0,3,3,8,10,18,20,13,33,0.000333,0.045869,4,550.4301,30.57945,137.607525,57.219281,3,0
0,0,3,3,9,9,18,18,13,31,0.000333,0.043089,4,517.0707,28.72615,129.267675,57.05865,2,0
0,0,7,7,17,14,31,46,29,75,0.000333,0.123855,16,5945.035572,330.279754,371.564723,122.789837,4,0
0,0,3,3,10,9,19,37,16,53,0.000333,0.075047,5,1125.700791,62.538933,225.140158,61.748606,10,0
0,0,3,3,10,8,18,16,13,29,0.000333,0.040309,5,604.639125,33.591063,120.927825,57.219281,3,0
0,0,4,4,10,9,19,46,19,65,0.000333,0.092038,10,2761.152884,153.397382,276.115288,61.748606,11,0
0,0,3,3,10,8,18,16,13,29,0.000333,0.040309,5,604.639125,33.591063,120.927825,57.219281,3,0
0,0,7,7,11,18,29,48,28,76,0.000333,0.123069,5,1846.032778,102.557377,369.206556,113.112398,1,0
0,0,4,4,10,12,22,21,17,38,0.000333,0.056486,5,847.292008,47.071778,169.458402,76.238831,1,0
0,0,3,3,10,10,20,17,13,30,0.000333,0.043219,5,648.289214,36.016067,129.657843,66.438562,2,0
0,0,4,4,4,7,11,13,11,24,0.000333,0.027675,2,166.052718,9.225151,83.026359,27.651484,3,0
0,0,6,6,10,11,21,30,16,46,0.000333,0.067349,5,1010.233007,56.124056,202.046601,71.273029,3,0
0,0,22,22,17,35,52,129,69,198,0.000333,0.376229,8,9029.496514,501.638695,1128.687064,249.011774,8,0
0,0,3,3,10,8,18,16,13,29,0.000333,0.040309,5,604.639125,33.591063,120.927825,57.219281,3,0
0,0,3,3,9,9,18,18,13,31,0.000333,0.043089,4,517.0707,28.72615,129.267675,57.05865,2,0
0,0,4,4,4,7,11,13,11,24,0.000333,0.027675,2,166.052718,9.225151,83.026359,27.651484,3,0
0,0,14,14,11,35,46,79,67,146,0.000333,0.268813,5,4032.200228,224.011124,806.440046,217.578653,6,0
0,0,3,3,10,8,18,16,13,29,0.000333,0.040309,5,604.639125,33.591063,120.927825,57.219281,3,0
0,0,3,3,10,8,18,16,13,29,0.000333,0.040309,5,604.639125,33.591063,120.927825,57.219281,3,0
0,0,17,17,16,23,39,110,55,165,0.000333,0.290697,16,13953.46186,775.192325,872.091366,168.041925,7,0
0,0,7,7,8,13,21,30,22,52,0.000333,0.076134,4,913.602024,50.755668,228.400506,72.105716,1,0
0,0,7,7,11,19,30,44,28,72,0.000333,0.117765,5,1766.480614,98.137812,353.296123,118.764371,2,0
0,0,3,3,10,6,16,19,10,29,0.000333,0.038667,5,580,32.222222,116,48.729056,1,0
0,0,3,3,10,8,18,16,13,29,0.000333,0.040309,5,604.639125,33.591063,120.927825,57.219281,3,0
0,0,3,3,10,10,20,17,13,30,0.000333,0.043219,5,648.289214,36.016067,129.657843,66.438562,2,0
0,0,5,5,12,16,28,39,25,64,0.000333,0.102557,6,1846.02429,102.556905,307.670715,107.01955,2,0
0,0,7,7,11,19,30,44,28,72,0.000333,0.117765,5,1766.480614,98.137812,353.296123,118.764371,2,0
0,0,6,6,11,16,27,30,23,53,0.000333,0.084003,5,1260.045188,70.00251,252.009038,102.053748,1,0
0,0,15,15,11,37,48,83,71,154,0.000333,0.286695,5,4300.421126,238.912285,860.084225,230.803522,6,0
0,0,4,4,5,7,12,17,12,29,0.000333,0.034655,2,207.927825,11.551546,103.963913,31.261125,1,0
0,0,17,17,16,23,39,110,55,165,0.000333,0.290697,16,13953.46186,775.192325,872.091366,168.041925,7,0
0,0,4,4,9,12,21,23,18,41,0.000333,0.060028,4,720.340057,40.018892,180.085014,71.548875,2,0
0,0,3,3,5,6,11,9,8,17,0.000333,0.019603,2,117.620675,6.534482,58.810338,27.119415,1,0
0,0,3,3,10,8,18,16,13,29,0.000333,0.040309,5,604.639125,33.591063,120.927825,57.219281,3,0
0,0,3,3,10,8,18,16,13,29,0.000333,0.040309,5,604.639125,33.591063,120.927825,57.219281,3,0
0,0,3,3,10,8,18,16,13,29,0.000333,0.040309,5,604.639125,33.591063,120.927825,57.219281,3,0
0,0,3,3,10,8,18,16,13,29,0.000333,0.040309,5,604.639125,33.591063,120.927825,57.219281,3,0
0,0,3,3,5,6,11,9,8,17,0.000333,0.019603,2,117.620675,6.534482,58.810338,27.119415,2,0
0,0,7,7,11,19,30,44,28,72,0.000333,0.117765,5,1766.480614,98.137812,353.296123,118.764371,2,0
0,0,7,7,11,10,21,36,17,53,0.000333,0.077598,5,1163.964117,64.664673,232.792823,71.273029,4,0
0,0,35,35,17,40,57,170,97,267,0.000333,0.519127,16,24918.10614,1384.33923,1557.381634,282.363992,15,0
0,0,3,3,10,8,18,16,13,29,0.000333,0.040309,5,604.639125,33.591063,120.927825,57.219281,3,0
0,0,8,8,13,16,29,42,29,71,0.000333,0.114972,6,2069.499904,114.972217,344.916651,112.105716,2,0
0,0,3,3,10,8,18,16,13,29,0.000333,0.040309,5,604.639125,33.591063,120.927825,57.219281,3,0
0,0,4,4,11,10,21,23,15,38,0.000333,0.055636,5,834.54031,46.363351,166.908062,71.273029,2,0
0,0,21,21,17,32,49,123,66,189,0.000333,0.353727,16,16978.88257,943.271254,1061.180161,229.486868,8,0
0,0,4,4,10,9,19,46,19,65,0.000333,0.092038,10,2761.152884,153.397382,276.115288,61.748606,11,0
0,0,7,7,11,19,30,44,28,72,0.000333,0.117765,5,1766.480614,98.137812,353.296123,118.764371,2,0
0,0,7,7,12,17,29,43,27,70,0.000333,0.113353,6,2040.352018,113.35289,340.05867,112.506418,4,0
0,0,3,3,10,8,18,16,13,29,0.000333,0.040309,5,604.639125,33.591063,120.927825,57.219281,3,0
0,0,3,3,10,8,18,16,13,29,0.000333,0.040309,5,604.639125,33.591063,120.927825,57.219281,3,0
0,0,4,4,6,8,14,17,12,29,0.000333,0.036804,3,331.239878,18.402215,110.413293,39.509775,3,0
0,0,4,4,7,9,16,16,12,28,0.000333,0.037333,3,336,18.666667,112,48.180809,3,0
0,0,4,4,9,13,22,21,17,38,0.000333,0.056486,4,677.833606,37.657423,169.458402,76.635041,3,0
0,0,4,4,11,10,21,26,17,43,0.000333,0.062957,5,944.348246,52.463791,188.869649,71.273029,2,0
0,0,7,7,12,17,29,43,27,70,0.000333,0.113353,6,2040.352018,113.35289,340.05867,112.506418,4,0
0,0,3,3,11,11,22,26,15,41,0.000333,0.060946,5,914.183482,50.787971,182.836696,76.107496,3,0
0,0,3,3,10,6,16,19,10,29,0.000333,0.038667,5,580,32.222222,116,48.729056,1,0
0,0,7,7,11,19,30,44,28,72,0.000333,0.117765,5,1766.480614,98.137812,353.296123,118.764371,2,0
0,0,7,7,11,19,30,44,28,72,0.000333,0.117765,5,1766.480614,98.137812,353.296123,118.764371,2,0
0,0,3,3,11,11,22,26,15,41,0.000333,0.060946,5,914.183482,50.787971,182.836696,76.107496,3,0
0,0,3,3,10,8,18,16,13,29,0.000333,0.040309,5,604.639125,33.591063,120.927825,57.219281,3,0
0,0,3,3,10,11,21,22,15,37,0.000333,0.054172,5,812.578723,45.143262,162.515745,71.273029,4,0
0,0,8,8,9,17,26,35,26,61,0.000333,0.095576,4,1146.907291,63.717072,286.726823,98.016193,3,0
0,0,3,3,9,9,18,18,13,31,0.000333,0.043089,4,517.0707,28.72615,129.267675,57.05865,2,0
0,0,3,3,7,9,16,16,12,28,0.000333,0.037333,3,336,18.666667,112,48.180809,2,0
0,0,4,4,4,7,11,13,11,24,0.000333,0.027675,2,166.052718,9.225151,83.026359,27.651484,3,0
0,0,3,3,10,8,18,16,13,29,0.000333,0.040309,5,604.639125,33.591063,120.927825,57.219281,3,0
0,0,3,3,10,8,18,20,12,32,0.000333,0.044479,5,667.188,37.066,133.4376,57.219281,2,0
0,0,3,3,9,9,18,18,13,31,0.000333,0.043089,4,517.0707,28.72615,129.267675,57.05865,2,0
0,0,7,7,11,19,30,44,28,72,0.000333,0.117765,5,1766.480614,98.137812,353.296123,118.764371,2,0
0,0,7,7,11,19,30,44,28,72,0.000333,0.117765,5,1766.480614,98.137812,353.296123,118.764371,2,0
0,0,3,3,10,8,18,16,13,29,0.000333,0.040309,5,604.639125,33.591063,120.927825,57.219281,3,0
0,0,3,3,10,10,20,17,13,30,0.000333,0.043219,5,648.289214,36.016067,129.657843,66.438562,2,0
0,0,5,5,10,15,25,24,25,49,0.000333,0.07585,5,1137.744766,63.208043,227.548953,91.82264,2,0
0,0,6,6,11,14,25,29,21,50,0.000333,0.077398,5,1160.964047,64.498003,232.192809,91.356717,1,0
0,0,19,19,15,28,43,121,62,183,0.000333,0.331002,14,13902.0903,772.33835,993.00645,193.209297,6,0
0,0,3,3,10,8,18,16,13,29,0.000333,0.040309,5,604.639125,33.591063,120.927825,57.219281,3,0
0,0,3,3,10,8,18,16,13,29,0.000333,0.040309,5,604.639125,33.591063,120.927825,57.219281,3,0
0,0,8,8,9,17,26,35,26,61,0.000333,0.095576,4,1146.907291,63.717072,286.726823,98.016193,3,0
0,0,3,3,10,8,18,16,13,29,0.000333,0.040309,5,604.639125,33.591063,120.927825,57.219281,3,0
0,0,4,4,4,7,11,13,11,24,0.000333,0.027675,2,166.052718,9.225151,83.026359,27.651484,3,0
0,0,4,4,4,7,11,13,11,24,0.000333,0.027675,2,166.052718,9.225151,83.026359,27.651484,3,0
0,0,4,4,6,8,14,17,12,29,0.000333,0.036804,3,331.239878,18.402215,110.413293,39.509775,3,0
0,0,8,8,13,12,25,43,26,69,0.000333,0.106809,12,3845.112925,213.617385,320.426077,91.125266,4,0
0,0,9,9,13,12,25,53,31,84,0.000333,0.130028,12,4681.007039,260.055947,390.08392,91.125266,4,0
0,0,7,7,17,21,38,52,37,89,0.000333,0.155689,8,3736.52439,207.584688,467.065549,161.725534,5,0
0,0,7,7,11,19,30,44,28,72,0.000333,0.117765,5,1766.480614,98.137812,353.296123,118.764371,2,0
0,0,7,7,11,19,30,44,28,72,0.000333,0.117765,5,1766.480614,98.137812,353.296123,118.764371,2,0
0,0,3,3,11,11,22,26,15,41,0.000333,0.060946,5,914.183482,50.787971,182.836696,76.107496,3,0
0,0,26,26,17,37,54,139,75,214,0.000333,0.410515,16,19704.73481,1094.707489,1231.545925,262.236643,10,0
0,0,3,3,10,10,20,17,13,30,0.000333,0.043219,5,648.289214,36.016067,129.657843,66.438562,2,0
0,0,3,3,10,8,18,16,13,29,0.000333,0.040309,5,604.639125,33.591063,120.927825,57.219281,3,0
0,0,3,3,10,9,19,23,12,35,0.000333,0.049559,5,743.387315,41.299295,148.677463,61.748606,3,0
0,0,4,4,10,12,22,21,17,38,0.000333,0.056486,5,847.292008,47.071778,169.458402,76.238831,1,0
0,0,4,4,6,8,14,17,12,29,0.000333,0.036804,3,331.239878,18.402215,110.413293,39.509775,3,0
0,0,7,7,11,19,30,44,28,72,0.000333,0.117765,5,1766.480614,98.137812,353.296123,118.764371,2,0
0,0,3,3,11,11,22,26,15,41,0.000333,0.060946,5,914.183482,50.787971,182.836696,76.107496,3,0
0,0,3,3,11,11,22,26,15,41,0.000333,0.060946,5,914.183482,50.787971,182.836696,76.107496,3,0
0,0,4,4,6,8,14,17,12,29,0.000333,0.036804,3,331.239878,18.402215,110.413293,39.509775,3,0
0,0,3,3,10,8,18,16,13,29,0.000333,0.040309,5,604.639125,33.591063,120.927825,57.219281,3,0
0,0,3,3,10,11,21,22,15,37,0.000333,0.054172,5,812.578723,45.143262,162.515745,71.273029,4,0
0,0,4,4,13,8,21,27,11,38,0.000333,0.055636,6,1001.448372,55.636021,166.908062,72.105716,3,0
0,0,3,3,9,9,18,18,13,31,0.000333,0.043089,4,517.0707,28.72615,129.267675,57.05865,2,0
0,0,3,3,8,10,18,17,13,30,0.000333,0.041699,4,500.391,27.7995,125.09775,57.219281,2,0
0,0,3,3,10,8,18,16,13,29,0.000333,0.040309,5,604.639125,33.591063,120.927825,57.219281,3,0
0,0,7,7,11,19,30,44,28,72,0.000333,0.117765,5,1766.480614,98.137812,353.296123,118.764371,2,0
0,0,3,3,9,9,18,18,13,31,0.000333,0.043089,4,517.0707,28.72615,129.267675,57.05865,2,0
0,0,4,4,7,9,16,16,12,28,0.000333,0.037333,3,336,18.666667,112,48.180809,3,0
0,0,4,4,4,7,11,13,11,24,0.000333,0.027675,2,166.052718,9.225151,83.026359,27.651484,3,0
0,0,3,3,10,8,18,16,13,29,0.000333,0.040309,5,604.639125,33.591063,120.927825,57.219281,3,0
0,0,8,8,16,13,29,53,32,85,0.000333,0.137643,16,6606.854153,367.047453,412.928385,112.105716,6,0
0,0,6,6,13,14,27,33,25,58,0.000333,0.091928,6,1654.700851,91.927825,275.783475,101.408685,2,0
0,0,3,3,10,8,18,16,13,29,0.000333,0.040309,5,604.639125,33.591063,120.927825,57.219281,3,0
0,0,7,7,12,17,29,43,27,70,0.000333,0.113353,6,2040.352018,113.35289,340.05867,112.506418,4,0
0,0,7,7,11,19,30,44,28,72,0.000333,0.117765,5,1766.480614,98.137812,353.296123,118.764371,2,0
0,0,3,3,10,6,16,21,9,30,0.000333,0.04,5,600,33.333333,120,48.729056,3,0
0,0,6,6,9,18,27,24,23,47,0.000333,0.074493,4,893.91885,49.662158,223.479713,103.587975,3,0
0,0,4,4,6,8,14,17,12,29,0.000333,0.036804,3,331.239878,18.402215,110.413293,39.509775,3,0
0,0,4,4,11,10,21,26,17,43,0.000333,0.062957,5,944.348246,52.463791,188.869649,71.273029,2,0
0,0,3,3,10,8,18,16,13,29,0.000333,0.040309,5,604.639125,33.591063,120.927825,57.219281,3,0
0,0,7,7,11,19,30,44,28,72,0.000333,0.117765,5,1766.480614,98.137812,353.296123,118.764371,2,0
0,0,4,4,10,12,22,21,17,38,0.000333,0.056486,5,847.292008,47.071778,169.458402,76.238831,1,0
0,0,3,3,10,10,20,17,13,30,0.000333,0.043219,5,648.289214,36.016067,129.657843,66.438562,2,0
0,0,7,7,11,19,30,44,28,72,0.000333,0.117765,5,1766.480614,98.137812,353.296123,118.764371,2,0
0,0,17,17,16,23,39,110,55,165,0.000333,0.290697,16,13953.46186,775.192325,872.091366,168.041925,7,0
0,0,3,3,7,8,15,23,12,35,0.000333,0.04558,3,410.223513,22.790195,136.741171,43.651484,1,0
0,0,3,3,10,10,20,17,13,30,0.000333,0.043219,5,648.289214,36.016067,129.657843,66.438562,2,0
0,0,3,3,10,8,18,16,13,29,0.000333,0.040309,5,604.639125,33.591063,120.927825,57.219281,3,0
0,0,7,7,11,19,30,44,28,72,0.000333,0.117765,5,1766.480614,98.137812,353.296123,118.764371,2,0
0,0,3,3,10,8,18,16,13,29,0.000333,0.040309,5,604.639125,33.591063,120.927825,57.219281,3,0
0,0,7,7,11,19,30,44,28,72,0.000333,0.117765,5,1766.480614,98.137812,353.296123,118.764371,2,0
0,0,3,3,10,8,18,16,13,29,0.000333,0.040309,5,604.639125,33.591063,120.927825,57.219281,3,0
0,0,3,3,9,9,18,18,13,31,0.000333,0.043089,4,517.0707,28.72615,129.267675,57.05865,2,0
0,0,10,10,15,16,31,57,38,95,0.000333,0.156883,14,6589.081093,366.060061,470.648649,122.603359,4,0
0,0,3,3,10,8,18,16,13,29,0.000333,0.040309,5,604.639125,33.591063,120.927825,57.219281,3,0
0,0,7,7,10,16,26,43,35,78,0.000333,0.122211,10,3666.34298,203.685721,366.634298,97.219281,2,0
0,0,4,4,10,11,21,20,15,35,0.000333,0.051244,5,768.655549,42.703086,153.73111,71.273029,2,0
0,0,4,4,4,7,11,13,11,24,0.000333,0.027675,2,166.052718,9.225151,83.026359,27.651484,3,0
0,0,3,3,10,8,18,16,13,29,0.000333,0.040309,5,604.639125,33.591063,120.927825,57.219281,3,0
0,0,3,3,10,8,18,16,13,29,0.000333,0.040309,5,604.639125,33.591063,120.927825,57.219281,3,0
0,0,22,22,16,33,49,133,74,207,0.000333,0.387415,16,18595.919,1033.106611,1162.244938,230.465006,6,0
0,0,3,3,10,8,18,16,13,29,0.000333,0.040309,5,604.639125,33.591063,120.927825,57.219281,3,0
0,0,11,11,15,21,36,84,43,127,0.000333,0.21886,14,9192.126653,510.673703,656.580475,150.842025,2,0
0,0,36,36,16,62,78,272,185,457,0.000333,0.957476,16,45958.86102,2553.270057,2872.428814,433.160171,4,0
0,0,6,6,13,13,26,38,23,61,0.000333,0.095576,6,1720.360937,95.575608,286.726823,96.211433,4,0
0,0,9,9,15,19,34,68,35,103,0.000333,0.17467,7,3668.060709,203.78115,524.008673,139.313982,2,0
0,0,5,5,12,16,28,39,25,64,0.000333,0.102557,6,1846.02429,102.556905,307.670715,107.01955,5,0
0,0,5,5,9,15,24,22,19,41,0.000333,0.062661,4,751.93385,41.774103,187.983463,87.132684,3,0
0,0,20,20,21,23,44,117,63,180,0.000333,0.327566,20,19653.95383,1091.886324,982.697691,196.280591,12,0
0,0,4,4,4,7,11,13,11,24,0.000333,0.027675,2,166.052718,9.225151,83.026359,27.651484,3,0
0,0,3,3,11,11,22,26,15,41,0.000333,0.060946,5,914.183482,50.787971,182.836696,76.107496,3,0
0,0,3,3,9,9,18,18,13,31,0.000333,0.043089,4,517.0707,28.72615,129.267675,57.05865,2,0
0,0,8,8,12,17,29,48,26,74,0.000333,0.11983,6,2156.943562,119.830198,359.490594,112.506418,4,0
0,0,4,4,4,7,11,13,11,24,0.000333,0.027675,2,166.052718,9.225151,83.026359,27.651484,3,0
0,0,5,5,13,13,26,30,20,50,0.000333,0.078341,6,1410.131915,78.340662,235.021986,96.211433,2,0
0,0,3,3,11,11,22,26,15,41,0.000333,0.060946,5,914.183482,50.787971,182.836696,76.107496,3,0
0,0,3,3,8,10,18,20,14,34,0.000333,0.047259,4,567.1098,31.5061,141.77745,57.219281,1,0
0,0,4,4,9,6,15,17,9,26,0.000333,0.03386,4,406.316622,22.573146,101.579155,44.0391,5,0
0,0,3,3,10,10,20,17,13,30,0.000333,0.043219,5,648.289214,36.016067,129.657843,66.438562,2,0
0,0,8,8,15,18,33,66,34,100,0.000333,0.168146,7,3531.075884,196.170882,504.439412,133.662009,2,0
0,0,4,4,4,7,11,13,11,24,0.000333,0.027675,2,166.052718,9.225151,83.026359,27.651484,3,0
0,0,8,8,9,17,26,35,26,61,0.000333,0.095576,4,1146.907291,63.717072,286.726823,98.016193,3,0
0,0,3,3,10,8,18,16,13,29,0.000333,0.040309,5,604.639125,33.591063,120.927825,57.219281,3,0
0,0,5,5,10,10,20,27,14,41,0.000333,0.059066,5,885.995259,49.221959,177.199052,66.438562,3,0
0,0,7,7,11,18,29,48,28,76,0.000333,0.123069,5,1846.032778,102.557377,369.206556,113.112398,1,0
0,0,6,6,11,15,26,30,22,52,0.000333,0.081474,5,1222.114327,67.89524,244.422865,96.657107,1,0
0,0,3,3,10,8,18,16,13,29,0.000333,0.040309,5,604.639125,33.591063,120.927825,57.219281,3,0
0,0,10,10,15,27,42,169,61,230,0.000333,0.413411,14,17363.2621,964.625672,1240.233007,186.985321,7,0
0,0,4,4,11,9,20,24,12,36,0.000333,0.051863,5,777.947057,43.219281,155.589411,66.583073,5,0
0,0,14,14,11,35,46,79,67,146,0.000333,0.268813,5,4032.200228,224.011124,806.440046,217.578653,6,0
0,0,3,3,10,8,18,16,13,29,0.000333,0.040309,5,604.639125,33.591063,120.927825,57.219281,3,0
0,0,3,3,10,8,18,16,13,29,0.000333,0.040309,5,604.639125,33.591063,120.927825,57.219281,3,0
0,0,3,3,10,8,18,16,13,29,0.000333,0.040309,5,604.639125,33.591063,120.927825,57.219281,3,0
0,0,4,4,10,9,19,46,19,65,0.000333,0.092038,10,2761.152884,153.397382,276.115288,61.748606,11,0
0,0,3,3,5,6,11,9,8,17,0.000333,0.019603,2,117.620675,6.534482,58.810338,27.119415,1,0
0,0,17,17,15,29,44,127,74,201,0.000333,0.365782,14,15362.84058,853.491143,1097.345755,199.484808,5,0
0,0,3,3,10,8,18,16,13,29,0.000333,0.040309,5,604.639125,33.591063,120.927825,57.219281,3,0
0,0,3,3,9,9,18,18,13,31,0.000333,0.043089,4,517.0707,28.72615,129.267675,57.05865,2,0
0,0,6,6,14,10,24,37,22,59,0.000333,0.090171,14,3787.179026,210.398835,270.512788,86.52225,4,0
0,0,15,15,15,17,32,75,63,138,0.000333,0.23,21,14490,805,690,128.090227,4,0
0,0,4,4,10,13,23,26,21,47,0.000333,0.070869,5,1063.03706,59.057614,212.607412,81.324997,2,0
0,0,7,7,11,19,30,44,28,72,0.000333,0.117765,5,1766.480614,98.137812,353.296123,118.764371,2,0
0,0,3,3,10,10,20,17,13,30,0.000333,0.043219,5,648.289214,36.016067,129.657843,66.438562,2,0
0,0,3,3,10,8,18,16,13,29,0.000333,0.040309,5,604.639125,33.591063,120.927825,57.219281,3,0
0,0,3,3,9,9,18,18,13,31,0.000333,0.043089,4,517.0707,28.72615,129.267675,57.05865,2,0
0,0,7,7,11,19,30,44,28,72,0.000333,0.117765,5,1766.480614,98.137812,353.296123,118.764371,2,0
0,0,4,4,6,8,14,17,12,29,0.000333,0.036804,3,331.239878,18.402215,110.413293,39.509775,3,0
0,0,4,4,7,13,20,20,20,40,0.000333,0.057626,3,518.631371,28.812854,172.877124,67.757201,2,0
0,0,5,5,14,17,31,60,30,90,0.000333,0.148626,7,3121.143676,173.396871,445.877668,122.789837,4,0
0,0,14,14,11,35,46,79,67,146,0.000333,0.268813,5,4032.200228,224.011124,806.440046,217.578653,6,0
0,0,27,27,17,38,55,141,76,217,0.000333,0.418185,16,20072.88093,1115.160051,1254.555058,268.908114,10,0
0,0,6,6,9,18,27,24,23,47,0.000333,0.074493,4,893.91885,49.662158,223.479713,103.587975,3,0
0,0,7,7,12,17,29,43,27,70,0.000333,0.113353,6,2040.352018,113.35289,340.05867,112.506418,4,0
0,0,6,6,12,16,28,30,26,56,0.000333,0.089737,6,1615.271254,89.737292,269.211876,107.01955,2,0
0,0,7,7,11,19,30,44,28,72,0.000333,0.117765,5,1766.480614,98.137812,353.296123,118.764371,2,0
0,0,6,6,13,13,26,38,23,61,0.000333,0.095576,6,1720.360937,95.575608,286.726823,96.211433,4,0
0,0,4,4,10,12,22,21,17,38,0.000333,0.056486,5,847.292008,47.071778,169.458402,76.238831,1,0
0,0,3,3,10,8,18,16,13,29,0.000333,0.040309,5,604.639125,33.591063,120.927825,57.219281,3,0
0,0,3,3,10,8,18,16,13,29,0.000333,0.040309,5,604.639125,33.591063,120.927825,57.219281,3,0
0,0,7,7,11,19,30,44,28,72,0.000333,0.117765,5,1766.480614,98.137812,353.296123,118.764371,2,0
0,0,7,7,11,19,30,44,28,72,0.000333,0.117765,5,1766.480614,98.137812,353.296123,118.764371,2,0
0,0,4,4,7,15,22,20,24,44,0.000333,0.065405,3,588.644974,32.702499,196.214991,78.254843,2,0
0,0,3,3,9,9,18,18,13,31,0.000333,0.043089,4,517.0707,28.72615,129.267675,57.05865,2,0
0,0,4,4,4,7,11,13,11,24,0.000333,0.027675,2,166.052718,9.225151,83.026359,27.651484,3,0
0,0,5,5,13,10,23,35,21,56,0.000333,0.08444,12,3039.833634,168.879646,253.31947,81.324997,4,0
0,0,4,4,8,8,16,17,15,32,0.000333,0.042667,4,512,28.444444,128,48,1,0
0,0,3,3,11,11,22,26,15,41,0.000333,0.060946,5,914.183482,50.787971,182.836696,76.107496,3,0
0,0,3,3,8,10,18,20,13,33,0.000333,0.045869,4,550.4301,30.57945,137.607525,57.219281,3,0
0,0,31,31,17,46,63,161,95,256,0.000333,0.510061,16,24482.93857,1360.163254,1530.18366,323.570718,10,0
0,0,7,7,11,19,30,44,28,72,0.000333,0.117765,5,1766.480614,98.137812,353.296123,118.764371,2,0
0,0,29,29,18,38,56,240,125,365,0.000333,0.706562,27,57231.48276,3179.52682,2119.684547,274.479896,12,0
0,0,3,3,9,9,18,18,13,31,0.000333,0.043089,4,517.0707,28.72615,129.267675,57.05865,2,0
0,0,7,7,11,19,30,44,28,72,0.000333,0.117765,5,1766.480614,98.137812,353.296123,118.764371,2,0
0,0,7,7,9,21,30,28,27,55,0.000333,0.08996,4,1079.515931,59.973107,269.878983,120.767991,3,0
0,0,5,5,12,16,28,39,25,64,0.000333,0.102557,6,1846.02429,102.556905,307.670715,107.01955,2,0
0,0,4,4,6,8,14,17,12,29,0.000333,0.036804,3,331.239878,18.402215,110.413293,39.509775,3,0
0,0,3,3,10,8,18,16,13,29,0.000333,0.040309,5,604.639125,33.591063,120.927825,57.219281,3,0
0,0,4,4,8,16,24,32,22,54,0.000333,0.082529,4,990.3519,55.01955,247.587975,88,1,0
0,0,32,32,14,34,48,207,115,322,0.000333,0.599453,21,37765.51643,2098.084246,1798.357925,226.276706,3,0
0,0,27,27,15,35,50,155,94,249,0.000333,0.46844,14,19674.48268,1093.026815,1405.320191,238.128265,4,0
0,0,3,3,10,6,16,19,10,29,0.000333,0.038667,5,580,32.222222,116,48.729056,1,0
0,0,7,7,11,19,30,44,28,72,0.000333,0.117765,5,1766.480614,98.137812,353.296123,118.764371,2,0
0,0,3,3,9,9,18,18,13,31,0.000333,0.043089,4,517.0707,28.72615,129.267675,57.05865,2,0
0,0,13,13,12,21,33,56,44,100,0.000333,0.168146,12,6053.272943,336.292941,504.439412,135.258216,1,0
0,0,3,3,10,6,16,19,10,29,0.000333,0.038667,5,580,32.222222,116,48.729056,1,0
0,0,4,4,4,6,10,16,12,28,0.000333,0.031005,4,372.055947,20.669775,93.013987,23.509775,1,0
0,0,4,4,6,8,14,17,12,29,0.000333,0.036804,3,331.239878,18.402215,110.413293,39.509775,3,0
0,0,3,3,10,8,18,16,13,29,0.000333,0.040309,5,604.639125,33.591063,120.927825,57.219281,3,0
0,0,3,3,10,8,18,16,13,29,0.000333,0.040309,5,604.639125,33.591063,120.927825,57.219281,3,0
0,0,3,3,9,13,22,20,16,36,0.000333,0.053513,4,642.158153,35.675453,160.539538,76.635041,3,0
0,0,14,14,11,35,46,79,67,146,0.000333,0.268813,5,4032.200228,224.011124,806.440046,217.578653,6,0
0,0,7,7,11,19,30,44,28,72,0.000333,0.117765,5,1766.480614,98.137812,353.296123,118.764371,2,0
0,0,5,5,8,6,14,18,10,28,0.000333,0.035535,4,426.423751,23.690208,106.605938,39.509775,2,0
0,0,27,27,17,37,54,142,78,220,0.000333,0.422025,16,20257.20401,1125.400223,1266.07525,262.236643,10,0
0,0,3,3,10,6,16,19,10,29,0.000333,0.038667,5,580,32.222222,116,48.729056,1,0
0,0,7,7,11,19,30,44,28,72,0.000333,0.117765,5,1766.480614,98.137812,353.296123,118.764371,2,0
0,0,15,15,12,20,32,76,52,128,0.000333,0.213333,12,7680,426.666667,640,129.458112,3,0
0,0,3,3,10,8,18,16,13,29,0.000333,0.040309,5,604.639125,33.591063,120.927825,57.219281,3,0
0,0,3,3,10,8,18,16,13,29,0.000333,0.040309,5,604.639125,33.591063,120.927825,57.219281,3,0
0,0,17,17,16,23,39,110,55,165,0.000333,0.290697,16,13953.46186,775.192325,872.091366,168.041925,7,0
0,0,7,7,8,13,21,30,22,52,0.000333,0.076134,4,913.602024,50.755668,228.400506,72.105716,1,0
0,0,3,3,9,11,20,19,16,35,0.000333,0.050422,4,605.069933,33.614996,151.267483,66.583073,1,0
0,0,33,33,17,46,63,168,94,262,0.000333,0.522016,16,25056.75744,1392.04208,1566.04734,323.570718,10,0
0,0,3,3,10,8,18,16,13,29,0.000333,0.040309,5,604.639125,33.591063,120.927825,57.219281,3,0
0,0,4,4,4,7,11,13,11,24,0.000333,0.027675,2,166.052718,9.225151,83.026359,27.651484,3,0
0,0,8,8,9,17,26,35,26,61,0.000333,0.095576,4,1146.907291,63.717072,286.726823,98.016193,3,0
0,0,3,3,10,8,18,16,13,29,0.000333,0.040309,5,604.639125,33.591063,120.927825,57.219281,3,0
0,0,4,4,4,7,11,13,11,24,0.000333,0.027675,2,166.052718,9.225151,83.026359,27.651484,3,0
0,0,15,15,11,37,48,83,71,154,0.000333,0.286695,5,4300.421126,238.912285,860.084225,230.803522,6,0
0,0,5,5,9,15,24,22,19,41,0.000333,0.062661,4,751.93385,41.774103,187.983463,87.132684,3,0
0,0,4,4,4,7,11,13,11,24,0.000333,0.027675,2,166.052718,9.225151,83.026359,27.651484,3,0
0,0,3,3,10,8,18,16,13,29,0.000333,0.040309,5,604.639125,33.591063,120.927825,57.219281,3,0
0,0,4,4,10,12,22,21,17,38,0.000333,0.056486,5,847.292008,47.071778,169.458402,76.238831,1,0
0,0,3,3,9,9,18,18,13,31,0.000333,0.043089,4,517.0707,28.72615,129.267675,57.05865,2,0
0,0,4,4,10,11,21,30,20,50,0.000333,0.073205,5,1098.079356,61.004409,219.615871,71.273029,5,0
0,0,6,6,7,11,18,41,25,66,0.000333,0.091738,6,1651.290301,91.73835,275.21505,57.705232,1,0
0,0,4,4,7,9,16,16,12,28,0.000333,0.037333,3,336,18.666667,112,48.180809,3,0
0,0,5,5,11,16,27,28,25,53,0.000333,0.084003,5,1260.045188,70.00251,252.009038,102.053748,4,0
0,0,4,4,4,7,11,13,11,24,0.000333,0.027675,2,166.052718,9.225151,83.026359,27.651484,3,0
0,0,4,4,4,7,11,13,11,24,0.000333,0.027675,2,166.052718,9.225151,83.026359,27.651484,3,0
0,0,10,10,14,21,35,55,42,97,0.000333,0.165847,14,6965.566337,386.975908,497.540453,145.541635,4,0
0,0,3,3,10,8,18,16,13,29,0.000333,0.040309,5,604.639125,33.591063,120.927825,57.219281,3,0
0,0,44,44,18,57,75,324,174,498,0.000333,1.033984,27,83752.69611,4652.927562,3101.951708,407.533381,15,0
0,0,8,8,15,18,33,66,34,100,0.000333,0.168146,7,3531.075884,196.170882,504.439412,133.662009,2,0
0,0,3,3,10,11,21,22,15,37,0.000333,0.054172,5,812.578723,45.143262,162.515745,71.273029,4,0
0,0,3,3,10,8,18,16,13,29,0.000333,0.040309,5,604.639125,33.591063,120.927825,57.219281,3,0
0,0,26,26,17,36,53,140,74,214,0.000333,0.408592,16,19612.39964,1089.577758,1225.774977,255.604168,10,0
0,0,7,7,11,19,30,44,28,72,0.000333,0.117765,5,1766.480614,98.137812,353.296123,118.764371,2,0
0,0,4,4,10,12,22,21,17,38,0.000333,0.056486,5,847.292008,47.071778,169.458402,76.238831,1,0
0,0,3,3,9,13,22,20,16,36,0.000333,0.053513,4,642.158153,35.675453,160.539538,76.635041,3,0
0,0,3,3,10,10,20,17,13,30,0.000333,0.043219,5,648.289214,36.016067,129.657843,66.438562,2,0
0,0,4,4,10,12,22,21,17,38,0.000333,0.056486,5,847.292008,47.071778,169.458402,76.238831,1,0
0,0,9,9,15,19,34,68,35,103,0.000333,0.17467,7,3668.060709,203.78115,524.008673,139.313982,2,0
0,0,7,7,11,19,30,44,28,72,0.000333,0.117765,5,1766.480614,98.137812,353.296123,118.764371,2,0
0,0,17,17,16,23,39,110,55,165,0.000333,0.290697,16,13953.46186,775.192325,872.091366,168.041925,7,0
0,0,3,3,10,8,18,16,13,29,0.000333,0.040309,5,604.639125,33.591063,120.927825,57.219281,3,0
0,0,3,3,10,8,18,16,13,29,0.000333,0.040309,5,604.639125,33.591063,120.927825,57.219281,3,0
0,0,12,12,18,20,38,69,52,121,0.000333,0.211666,18,11429.98612,634.999229,634.999229,161.497212,6,0
0,0,4,4,4,7,11,13,11,24,0.000333,0.027675,2,166.052718,9.225151,83.026359,27.651484,3,0
0,0,4,4,10,12,22,21,17,38,0.000333,0.056486,5,847.292008,47.071778,169.458402,76.238831,1,0
0,0,3,3,10,8,18,16,13,29,0.000333,0.040309,5,604.639125,33.591063,120.927825,57.219281,3,0
0,0,4,4,11,10,21,23,15,38,0.000333,0.055636,5,834.54031,46.363351,166.908062,71.273029,2,0
0,0,31,31,18,42,60,156,91,247,0.000333,0.486334,18,26262.03559,1459.001977,1459.001977,301.535982,13,0
0,0,4,4,4,7,11,13,11,24,0.000333,0.027675,2,166.052718,9.225151,83.026359,27.651484,3,0
0,0,8,8,15,18,33,66,34,100,0.000333,0.168146,7,3531.075884,196.170882,504.439412,133.662009,2,0
0,0,4,4,6,8,14,17,12,29,0.000333,0.036804,3,331.239878,18.402215,110.413293,39.509775,3,0
0,0,6,6,13,13,26,38,23,61,0.000333,0.095576,6,1720.360937,95.575608,286.726823,96.211433,4,0
0,0,7,7,14,18,32,39,24,63,0.000333,0.105,7,2205,122.5,315,128.361619,2,0
0,0,7,7,11,19,30,44,28,72,0.000333,0.117765,5,1766.480614,98.137812,353.296123,118.764371,2,0
0,0,9,9,15,19,34,68,35,103,0.000333,0.17467,7,3668.060709,203.78115,524.008673,139.313982,2,0
0,0,9,9,16,24,40,75,54,129,0.000333,0.228843,16,10984.45959,610.247755,686.528724,174.0391,2,0
0,0,7,7,11,19,30,44,28,72,0.000333,0.117765,5,1766.480614,98.137812,353.296123,118.764371,2,0
0,0,3,3,10,8,18,16,13,29,0.000333,0.040309,5,604.639125,33.591063,120.927825,57.219281,3,0
0,0,3,3,10,8,18,16,13,29,0.000333,0.040309,5,604.639125,33.591063,120.927825,57.219281,3,0
0,0,7,7,11,19,30,44,28,72,0.000333,0.117765,5,1766.480614,98.137812,353.296123,118.764371,2,0
0,0,4,4,8,7,15,17,13,30,0.000333,0.039069,4,468.826871,26.045937,117.206718,43.651484,1,0
0,0,4,4,7,13,20,20,20,40,0.000333,0.057626,3,518.631371,28.812854,172.877124,67.757201,2,0
0,0,8,8,12,13,25,41,24,65,0.000333,0.100617,6,1811.103914,100.616884,301.850652,91.125266,4,0
0,0,9,9,12,12,24,52,31,83,0.000333,0.126851,12,4566.622651,253.701258,380.551888,86.0391,4,0
0,0,8,8,12,12,24,42,26,68,0.000333,0.103926,12,3741.329401,207.851633,311.77745,86.0391,4,0
0,0,3,3,9,9,18,18,13,31,0.000333,0.043089,4,517.0707,28.72615,129.267675,57.05865,2,0
0,0,25,25,17,34,51,133,72,205,0.000333,0.387616,16,18605.55512,1033.641951,1162.847195,242.460605,10,0
0,0,3,3,10,10,20,17,13,30,0.000333,0.043219,5,648.289214,36.016067,129.657843,66.438562,2,0
0,0,7,7,11,19,30,44,28,72,0.000333,0.117765,5,1766.480614,98.137812,353.296123,118.764371,2,0
0,0,3,3,10,10,20,17,13,30,0.000333,0.043219,5,648.289214,36.016067,129.657843,66.438562,2,0
0,0,4,4,6,8,14,17,12,29,0.000333,0.036804,3,331.239878,18.402215,110.413293,39.509775,3,0
0,0,5,5,9,15,24,22,19,41,0.000333,0.062661,4,751.93385,41.774103,187.983463,87.132684,3,0
0,0,4,4,10,12,22,21,17,38,0.000333,0.056486,5,847.292008,47.071778,169.458402,76.238831,1,0
0,0,8,8,16,13,29,53,32,85,0.000333,0.137643,16,6606.854153,367.047453,412.928385,112.105716,6,0
0,0,7,7,11,19,30,44,28,72,0.000333,0.117765,5,1766.480614,98.137812,353.296123,118.764371,2,0
0,0,5,5,12,16,28,39,25,64,0.000333,0.102557,6,1846.02429,102.556905,307.670715,107.01955,2,0
0,0,6,6,9,17,26,26,23,49,0.000333,0.076774,4,921.286185,51.182566,230.321546,98.016193,3,0
0,0,4,4,4,7,11,13,11,24,0.000333,0.027675,2,166.052718,9.225151,83.026359,27.651484,3,0
0,0,3,3,10,10,20,17,13,30,0.000333,0.043219,5,648.289214,36.016067,129.657843,66.438562,2,0
0,0,3,3,10,8,18,16,13,29,0.000333,0.040309,5,604.639125,33.591063,120.927825,57.219281,3,0
0,0,4,4,11,10,21,26,17,43,0.000333,0.062957,5,944.348246,52.463791,188.869649,71.273029,2,0
0,0,3,3,10,8,18,16,13,29,0.000333,0.040309,5,604.639125,33.591063,120.927825,57.219281,3,0
0,0,3,3,10,8,18,16,13,29,0.000333,0.040309,5,604.639125,33.591063,120.927825,57.219281,3,0
0,0,11,11,14,25,39,58,46,104,0.000333,0.183227,7,3847.772815,213.765156,549.681831,169.399374,4,0
0,0,7,7,11,19,30,44,28,72,0.000333,0.117765,5,1766.480614,98.137812,353.296123,118.764371,2,0
0,0,3,3,10,8,18,16,13,29,0.000333,0.040309,5,604.639125,33.591063,120.927825,57.219281,3,0
0,0,3,3,7,11,18,16,14,30,0.000333,0.041699,3,375.29325,20.849625,125.09775,57.705232,2,0
0,0,6,6,9,18,27,24,23,47,0.000333,0.074493,4,893.91885,49.662158,223.479713,103.587975,3,0
0,0,4,4,4,7,11,13,11,24,0.000333,0.027675,2,166.052718,9.225151,83.026359,27.651484,3,0
0,0,4,4,10,12,22,21,17,38,0.000333,0.056486,5,847.292008,47.071778,169.458402,76.238831,1,0
0,0,3,3,9,9,18,18,13,31,0.000333,0.043089,4,517.0707,28.72615,129.267675,57.05865,2,0
0,0,3,3,10,11,21,22,15,37,0.000333,0.054172,5,812.578723,45.143262,162.515745,71.273029,4,0
0,0,7,7,11,19,30,44,28,72,0.000333,0.117765,5,1766.480614,98.137812,353.296123,118.764371,2,0
0,0,7,7,11,19,30,44,28,72,0.000333,0.117765,5,1766.480614,98.137812,353.296123,118.764371,2,0
0,0,7,7,11,19,30,44,28,72,0.000333,0.117765,5,1766.480614,98.137812,353.296123,118.764371,2,0
0,0,6,6,9,18,27,24,23,47,0.000333,0.074493,4,893.91885,49.662158,223.479713,103.587975,3,0
0,0,7,7,11,19,30,44,28,72,0.000333,0.117765,5,1766.480614,98.137812,353.296123,118.764371,2,0
0,0,10,10,12,17,29,57,30,87,0.000333,0.140881,6,2535.866079,140.881449,422.644347,112.506418,7,0
0,0,5,5,12,16,28,39,25,64,0.000333,0.102557,6,1846.02429,102.556905,307.670715,107.01955,2,0
0,0,11,11,11,18,29,70,34,104,0.000333,0.16841,5,2526.150117,140.341673,505.230023,113.112398,5,0
0,0,7,7,11,19,30,44,28,72,0.000333,0.117765,5,1766.480614,98.137812,353.296123,118.764371,2,0
0,0,4,4,6,8,14,17,12,29,0.000333,0.036804,3,331.239878,18.402215,110.413293,39.509775,3,0
0,0,4,4,11,10,21,23,15,38,0.000333,0.055636,5,834.54031,46.363351,166.908062,71.273029,2,0
0,0,7,7,11,18,29,48,28,76,0.000333,0.123069,5,1846.032778,102.557377,369.206556,113.112398,1,0
0,0,14,14,13,23,36,81,43,124,0.000333,0.21369,6,3846.424201,213.690233,641.0707,152.147641,5,0
0,0,4,4,11,9,20,24,12,36,0.000333,0.051863,5,777.947057,43.219281,155.589411,66.583073,5,0
0,0,4,4,7,9,16,16,12,28,0.000333,0.037333,3,336,18.666667,112,48.180809,3,0
0,0,4,4,4,7,11,13,11,24,0.000333,0.027675,2,166.052718,9.225151,83.026359,27.651484,3,0
0,0,8,8,16,13,29,53,32,85,0.000333,0.137643,16,6606.854153,367.047453,412.928385,112.105716,6,0
0,0,4,4,8,11,19,17,15,32,0.000333,0.045311,4,543.734722,30.207485,135.93368,62.053748,3,0
0,0,4,4,4,7,11,13,11,24,0.000333,0.027675,2,166.052718,9.225151,83.026359,27.651484,3,0
0,0,3,3,10,6,16,19,10,29,0.000333,0.038667,5,580,32.222222,116,48.729056,1,0
0,0,3,3,10,8,18,16,13,29,0.000333,0.040309,5,604.639125,33.591063,120.927825,57.219281,3,0
0,0,4,4,4,7,11,13,11,24,0.000333,0.027675,2,166.052718,9.225151,83.026359,27.651484,3,0
0,0,10,10,15,27,42,169,61,230,0.000333,0.413411,14,17363.2621,964.625672,1240.233007,186.985321,7,0
0,0,4,4,11,10,21,26,17,43,0.000333,0.062957,5,944.348246,52.463791,188.869649,71.273029,2,0
0,0,6,6,15,15,30,35,24,59,0.000333,0.096502,7,2026.545816,112.585879,289.506545,117.206718,4,0
0,0,3,3,5,6,11,9,8,17,0.000333,0.019603,2,117.620675,6.534482,58.810338,27.119415,1,0
0,0,31,31,17,43,60,163,88,251,0.000333,0.49421,16,23722.07263,1317.892924,1482.629539,302.816253,10,0
0,0,23,23,19,33,52,130,85,215,0.000333,0.408532,18,22060.70171,1225.594539,1225.594539,247.175629,4,0
0,0,7,7,12,17,29,43,27,70,0.000333,0.113353,6,2040.352018,113.35289,340.05867,112.506418,4,0
0,0,17,17,14,31,45,102,63,165,0.000333,0.302052,14,12686.18065,704.787814,906.155761,206.883055,1,0
0,0,5,5,13,10,23,35,21,56,0.000333,0.08444,12,3039.833634,168.879646,253.31947,81.324997,4,0
0,0,4,4,10,12,22,21,17,38,0.000333,0.056486,5,847.292008,47.071778,169.458402,76.238831,1,0
0,0,9,9,12,19,31,47,33,80,0.000333,0.132112,6,2378.014229,132.111902,396.335705,123.730173,4,0
0,0,3,3,10,10,20,17,13,30,0.000333,0.043219,5,648.289214,36.016067,129.657843,66.438562,2,0
0,0,4,4,4,7,11,13,11,24,0.000333,0.027675,2,166.052718,9.225151,83.026359,27.651484,3,0
0,0,5,5,9,15,24,22,19,41,0.000333,0.062661,4,751.93385,41.774103,187.983463,87.132684,3,0
0,0,17,17,16,23,39,110,55,165,0.000333,0.290697,16,13953.46186,775.192325,872.091366,168.041925,7,0
0,0,9,9,12,12,24,52,31,83,0.000333,0.126851,12,4566.622651,253.701258,380.551888,86.0391,4,0
0,0,8,8,12,12,24,42,26,68,0.000333,0.103926,12,3741.329401,207.851633,311.77745,86.0391,4,0
0,0,3,3,10,11,21,22,15,37,0.000333,0.054172,5,812.578723,45.143262,162.515745,71.273029,4,0
0,0,3,3,10,10,20,17,13,30,0.000333,0.043219,5,648.289214,36.016067,129.657843,66.438562,2,0
0,0,3,3,5,7,12,12,9,21,0.000333,0.025095,2,150.568425,8.364913,75.284213,31.261125,1,0
0,0,7,7,11,19,30,44,28,72,0.000333,0.117765,5,1766.480614,98.137812,353.296123,118.764371,2,0
0,0,7,7,11,19,30,44,28,72,0.000333,0.117765,5,1766.480614,98.137812,353.296123,118.764371,2,0
0,0,4,4,6,8,14,17,12,29,0.000333,0.036804,3,331.239878,18.402215,110.413293,39.509775,3,0
0,0,3,3,10,8,18,16,13,29,0.000333,0.040309,5,604.639125,33.591063,120.927825,57.219281,3,0
0,0,3,3,10,8,18,16,13,29,0.000333,0.040309,5,604.639125,33.591063,120.927825,57.219281,3,0
0,0,4,4,11,9,20,35,15,50,0.000333,0.072032,5,1080.482024,60.026779,216.096405,66.583073,2,0
0,0,3,3,10,10,20,17,13,30,0.000333,0.043219,5,648.289214,36.016067,129.657843,66.438562,2,0
0,0,3,3,11,11,22,26,15,41,0.000333,0.060946,5,914.183482,50.787971,182.836696,76.107496,3,0
0,0,15,15,12,22,34,99,56,155,0.000333,0.262852,12,9462.680885,525.704494,788.55674,141.127046,2,0
0,0,19,19,16,31,47,130,78,208,0.000333,0.385118,16,18485.6717,1026.981761,1155.354481,217.580086,2,0
0,0,4,4,4,7,11,13,11,24,0.000333,0.027675,2,166.052718,9.225151,83.026359,27.651484,3,0
0,0,7,7,17,14,31,46,29,75,0.000333,0.123855,16,5945.035572,330.279754,371.564723,122.789837,4,0
0,0,8,8,14,15,29,44,28,72,0.000333,0.116592,7,2448.422422,136.023468,349.774632,111.906328,4,0
0,0,3,3,5,6,11,9,8,17,0.000333,0.019603,2,117.620675,6.534482,58.810338,27.119415,1,0
0,0,3,3,9,9,18,18,13,31,0.000333,0.043089,4,517.0707,28.72615,129.267675,57.05865,2,0
0,0,7,7,11,19,30,44,28,72,0.000333,0.117765,5,1766.480614,98.137812,353.296123,118.764371,2,0
0,0,5,5,9,14,23,26,24,50,0.000333,0.075393,4,904.712391,50.2618,226.178098,81.832294,2,0
0,0,3,3,10,8,18,16,13,29,0.000333,0.040309,5,604.639125,33.591063,120.927825,57.219281,3,0
0,0,6,6,7,10,17,25,16,41,0.000333,0.055862,3,502.757929,27.930996,167.585976,52.870765,1,0
0,0,3,3,10,8,18,16,13,29,0.000333,0.040309,5,604.639125,33.591063,120.927825,57.219281,3,0
0,0,3,3,11,11,22,26,15,41,0.000333,0.060946,5,914.183482,50.787971,182.836696,76.107496,3,0
0,0,7,7,11,19,30,44,28,72,0.000333,0.117765,5,1766.480614,98.137812,353.296123,118.764371,2,0
0,0,5,5,9,15,24,22,19,41,0.000333,0.062661,4,751.93385,41.774103,187.983463,87.132684,3,0
0,0,3,3,10,8,18,16,13,29,0.000333,0.040309,5,604.639125,33.591063,120.927825,57.219281,3,0
0,0,4,4,10,12,22,21,17,38,0.000333,0.056486,5,847.292008,47.071778,169.458402,76.238831,1,0
0,0,3,3,10,8,18,16,13,29,0.000333,0.040309,5,604.639125,33.591063,120.927825,57.219281,3,0
0,0,3,3,10,10,20,17,13,30,0.000333,0.043219,5,648.289214,36.016067,129.657843,66.438562,2,0
0,0,4,4,4,7,11,13,11,24,0.000333,0.027675,2,166.052718,9.225151,83.026359,27.651484,3,0
0,0,6,6,9,18,27,24,23,47,0.000333,0.074493,4,893.91885,49.662158,223.479713,103.587975,3,0
0,0,3,3,10,10,20,17,13,30,0.000333,0.043219,5,648.289214,36.016067,129.657843,66.438562,2,0
0,0,3,3,9,9,18,18,13,31,0.000333,0.043089,4,517.0707,28.72615,129.267675,57.05865,2,0
0,0,3,3,10,8,18,16,13,29,0.000333,0.040309,5,604.639125,33.591063,120.927825,57.219281,3,0
0,0,6,6,13,13,26,38,23,61,0.000333,0.095576,6,1720.360937,95.575608,286.726823,96.211433,4,0
0,0,3,3,10,8,18,16,13,29,0.000333,0.040309,5,604.639125,33.591063,120.927825,57.219281,3,0
0,0,4,4,4,7,11,13,11,24,0.000333,0.027675,2,166.052718,9.225151,83.026359,27.651484,3,0
0,0,12,12,9,23,32,77,49,126,0.000333,0.21,8,5040,280,630,132.57125,1,0
0,0,22,22,17,34,51,128,68,196,0.000333,0.370598,16,17788.72587,988.262548,1111.795367,242.460605,8,0
0,0,3,3,9,11,20,19,16,35,0.000333,0.050422,4,605.069933,33.614996,151.267483,66.583073,1,0
0,0,8,8,14,20,34,44,37,81,0.000333,0.137361,7,2884.591431,160.255079,412.08449,139.741531,4,0
0,0,3,3,10,8,18,16,13,29,0.000333,0.040309,5,604.639125,33.591063,120.927825,57.219281,3,0
0,0,7,7,11,19,30,44,28,72,0.000333,0.117765,5,1766.480614,98.137812,353.296123,118.764371,2,0
0,0,3,3,9,9,18,18,13,31,0.000333,0.043089,4,517.0707,28.72615,129.267675,57.05865,2,0
0,0,3,3,9,7,16,24,10,34,0.000333,0.045333,4,544,30.222222,136,48.180809,3,0
0,0,4,4,4,7,11,13,11,24,0.000333,0.027675,2,166.052718,9.225151,83.026359,27.651484,3,0
0,0,4,4,6,8,14,17,12,29,0.000333,0.036804,3,331.239878,18.402215,110.413293,39.509775,3,0
0,0,7,7,10,16,26,43,35,78,0.000333,0.122211,10,3666.34298,203.685721,366.634298,97.219281,2,0
0,0,7,7,11,19,30,44,28,72,0.000333,0.117765,5,1766.480614,98.137812,353.296123,118.764371,2,0
0,0,3,3,10,8,18,16,13,29,0.000333,0.040309,5,604.639125,33.591063,120.927825,57.219281,3,0
0,0,3,3,9,9,18,18,13,31,0.000333,0.043089,4,517.0707,28.72615,129.267675,57.05865,2,0
0,0,3,3,10,11,21,22,15,37,0.000333,0.054172,5,812.578723,45.143262,162.515745,71.273029,4,0
0,0,4,4,6,8,14,17,12,29,0.000333,0.036804,3,331.239878,18.402215,110.413293,39.509775,3,0
0,0,7,7,12,17,29,43,27,70,0.000333,0.113353,6,2040.352018,113.35289,340.05867,112.506418,4,0
0,0,3,3,9,9,18,18,13,31,0.000333,0.043089,4,517.0707,28.72615,129.267675,57.05865,2,0
0,0,4,4,10,9,19,23,14,37,0.000333,0.052391,5,785.86659,43.659255,157.173318,61.748606,2,0
0,0,3,3,10,8,18,16,13,29,0.000333,0.040309,5,604.639125,33.591063,120.927825,57.219281,3,0
0,0,3,3,10,11,21,22,15,37,0.000333,0.054172,5,812.578723,45.143262,162.515745,71.273029,4,0
0,0,27,27,17,39,56,141,78,219,0.000333,0.423937,16,20348.97165,1130.498425,1271.810728,275.617555,11,0
0,0,5,5,12,16,28,39,25,64,0.000333,0.102557,6,1846.02429,102.556905,307.670715,107.01955,4,0
0,0,3,3,10,8,18,16,13,29,0.000333,0.040309,5,604.639125,33.591063,120.927825,57.219281,3,0
0,0,3,3,9,9,18,18,13,31,0.000333,0.043089,4,517.0707,28.72615,129.267675,57.05865,2,0
0,0,5,5,8,12,20,24,19,43,0.000333,0.061948,4,743.371632,41.298424,185.842908,67.01955,3,0
0,0,3,3,10,10,20,17,13,30,0.000333,0.043219,5,648.289214,36.016067,129.657843,66.438562,2,0
0,0,7,7,11,19,30,44,28,72,0.000333,0.117765,5,1766.480614,98.137812,353.296123,118.764371,2,0
0,0,3,3,10,8,18,16,13,29,0.000333,0.040309,5,604.639125,33.591063,120.927825,57.219281,3,0
0,0,7,7,11,19,30,44,28,72,0.000333,0.117765,5,1766.480614,98.137812,353.296123,118.764371,2,0
0,0,9,9,11,12,23,44,29,73,0.000333,0.110073,10,3302.200228,183.455568,330.220023,81.073298,4,0
0,0,9,9,11,12,23,46,29,75,0.000333,0.113089,10,3392.671467,188.481748,339.267147,81.073298,4,0
0,0,3,3,10,8,18,16,13,29,0.000333,0.040309,5,604.639125,33.591063,120.927825,57.219281,3,0
0,0,3,3,10,10,20,17,13,30,0.000333,0.043219,5,648.289214,36.016067,129.657843,66.438562,2,0
0,0,4,4,10,12,22,21,17,38,0.000333,0.056486,5,847.292008,47.071778,169.458402,76.238831,1,0
0,0,8,8,14,19,33,44,35,79,0.000333,0.132836,7,2789.549948,154.974997,398.507135,134.013592,4,0
0,0,3,3,11,11,22,26,15,41,0.000333,0.060946,5,914.183482,50.787971,182.836696,76.107496,3,0
0,0,3,3,10,10,20,17,13,30,0.000333,0.043219,5,648.289214,36.016067,129.657843,66.438562,2,0
0,0,7,7,11,19,30,44,28,72,0.000333,0.117765,5,1766.480614,98.137812,353.296123,118.764371,2,0
0,0,6,6,10,15,25,28,22,50,0.000333,0.077398,5,1160.964047,64.498003,232.192809,91.82264,1,0
0,0,4,4,7,9,16,16,12,28,0.000333,0.037333,3,336,18.666667,112,48.180809,3,0
0,0,4,4,11,9,20,24,12,36,0.000333,0.051863,5,777.947057,43.219281,155.589411,66.583073,5,0
0,0,7,7,11,19,30,44,28,72,0.000333,0.117765,5,1766.480614,98.137812,353.296123,118.764371,2,0
0,0,3,3,10,8,18,16,13,29,0.000333,0.040309,5,604.639125,33.591063,120.927825,57.219281,3,0
0,0,6,6,13,13,26,38,23,61,0.000333,0.095576,6,1720.360937,95.575608,286.726823,96.211433,4,0
0,0,3,3,9,9,18,18,13,31,0.000333,0.043089,4,517.0707,28.72615,129.267675,57.05865,2,0
0,0,7,7,11,19,30,44,28,72,0.000333,0.117765,5,1766.480614,98.137812,353.296123,118.764371,2,0
0,0,4,4,7,11,18,20,16,36,0.000333,0.050039,3,450.3519,25.01955,150.1173,57.705232,2,0
0,0,4,4,10,15,25,32,21,53,0.000333,0.082041,5,1230.62189,68.367883,246.124378,91.82264,1,0
0,0,13,13,13,22,35,98,52,150,0.000333,0.256464,12,9232.709431,512.928302,769.392453,146.213212,7,0
0,0,4,4,11,9,20,23,14,37,0.000333,0.053304,5,799.556698,44.419817,159.91134,66.583073,2,0
0,0,17,17,16,23,39,110,55,165,0.000333,0.290697,16,13953.46186,775.192325,872.091366,168.041925,7,0
0,0,8,8,14,17,31,48,34,82,0.000333,0.135415,14,5687.417364,315.967631,406.244097,122.789837,4,0
0,0,11,11,10,18,28,82,47,129,0.000333,0.206716,10,6201.487849,344.527103,620.148785,108.277931,10,0
0,0,4,4,4,7,11,13,11,24,0.000333,0.027675,2,166.052718,9.225151,83.026359,27.651484,3,0
0,0,18,18,14,29,43,99,54,153,0.000333,0.27674,7,5811.529552,322.862753,830.218507,194.184418,8,0
0,0,8,8,9,17,26,35,26,61,0.000333,0.095576,4,1146.907291,63.717072,286.726823,98.016193,3,0
0,0,3,3,10,8,18,16,13,29,0.000333,0.040309,5,604.639125,33.591063,120.927825,57.219281,3,0
0,0,4,4,4,7,11,13,11,24,0.000333,0.027675,2,166.052718,9.225151,83.026359,27.651484,3,0
0,0,5,5,9,15,24,22,19,41,0.000333,0.062661,4,751.93385,41.774103,187.983463,87.132684,3,0
0,0,3,3,10,8,18,16,13,29,0.000333,0.040309,5,604.639125,33.591063,120.927825,57.219281,3,0
0,0,17,17,16,23,39,110,55,165,0.000333,0.290697,16,13953.46186,775.192325,872.091366,168.041925,7,0
0,0,4,4,4,7,11,13,11,24,0.000333,0.027675,2,166.052718,9.225151,83.026359,27.651484,3,0
0,0,6,6,9,17,26,26,23,49,0.000333,0.076774,4,921.286185,51.182566,230.321546,98.016193,3,0
0,0,14,14,11,35,46,79,67,146,0.000333,0.268813,5,4032.200228,224.011124,806.440046,217.578653,6,0
0,0,3,3,10,8,18,16,13,29,0.000333,0.040309,5,604.639125,33.591063,120.927825,57.219281,3,0
0,0,4,4,4,7,11,13,11,24,0.000333,0.027675,2,166.052718,9.225151,83.026359,27.651484,3,0
0,0,8,8,9,17,26,35,26,61,0.000333,0.095576,4,1146.907291,63.717072,286.726823,98.016193,3,0
0,0,3,3,10,8,18,16,13,29,0.000333,0.040309,5,604.639125,33.591063,120.927825,57.219281,3,0
0,0,3,3,10,8,18,16,13,29,0.000333,0.040309,5,604.639125,33.591063,120.927825,57.219281,3,0
0,0,25,25,12,35,47,382,213,595,0.000333,1.10166,36,118979.2932,6609.960733,3304.980367,222.544456,4,0
0,0,5,5,11,12,23,33,21,54,0.000333,0.081424,5,1221.361728,67.853429,244.272346,81.073298,1,0
0,0,7,7,9,21,30,28,27,55,0.000333,0.08996,4,1079.515931,59.973107,269.878983,120.767991,3,0
0,0,5,5,13,10,23,35,21,56,0.000333,0.08444,12,3039.833634,168.879646,253.31947,81.324997,4,0
0,0,7,7,12,17,29,43,27,70,0.000333,0.113353,6,2040.352018,113.35289,340.05867,112.506418,4,0
0,0,4,4,11,10,21,23,15,38,0.000333,0.055636,5,834.54031,46.363351,166.908062,71.273029,2,0
0,0,14,14,18,21,39,77,54,131,0.000333,0.230796,18,12462.97843,692.387691,692.387691,167.297316,6,0
0,0,4,4,10,12,22,21,17,38,0.000333,0.056486,5,847.292008,47.071778,169.458402,76.238831,1,0
0,0,4,4,4,7,11,13,11,24,0.000333,0.027675,2,166.052718,9.225151,83.026359,27.651484,3,0
0,0,9,9,13,12,25,53,31,84,0.000333,0.130028,12,4681.007039,260.055947,390.08392,91.125266,4,0
0,0,8,8,13,12,25,43,26,69,0.000333,0.106809,12,3845.112925,213.617385,320.426077,91.125266,4,0
0,0,8,8,12,13,25,41,24,65,0.000333,0.100617,6,1811.103914,100.616884,301.850652,91.125266,4,0
0,0,4,4,4,7,11,13,11,24,0.000333,0.027675,2,166.052718,9.225151,83.026359,27.651484,3,0
0,0,4,4,13,8,21,27,11,38,0.000333,0.055636,6,1001.448372,55.636021,166.908062,72.105716,3,0
0,0,3,3,10,8,18,16,13,29,0.000333,0.040309,5,604.639125,33.591063,120.927825,57.219281,3,0
0,0,4,4,9,8,17,16,12,28,0.000333,0.03815,4,457.795838,25.433102,114.44896,52.529325,1,0
0,0,3,3,10,8,18,16,13,29,0.000333,0.040309,5,604.639125,33.591063,120.927825,57.219281,3,0
0,0,3,3,11,11,22,26,15,41,0.000333,0.060946,5,914.183482,50.787971,182.836696,76.107496,3,0
0,0,3,3,10,8,18,16,13,29,0.000333,0.040309,5,604.639125,33.591063,120.927825,57.219281,3,0
0,0,3,3,8,10,18,20,13,33,0.000333,0.045869,4,550.4301,30.57945,137.607525,57.219281,3,0
0,0,9,9,14,25,39,156,54,210,0.000333,0.369978,14,15539.08252,863.282362,1109.934466,169.399374,5,0
0,0,3,3,10,8,18,16,13,29,0.000333,0.040309,5,604.639125,33.591063,120.927825,57.219281,3,0
0,0,21,21,17,32,49,123,66,189,0.000333,0.353727,16,16978.88257,943.271254,1061.180161,229.486868,8,0
0,0,7,7,11,19,30,44,28,72,0.000333,0.117765,5,1766.480614,98.137812,353.296123,118.764371,2,0
0,0,4,4,4,7,11,13,11,24,0.000333,0.027675,2,166.052718,9.225151,83.026359,27.651484,3,0
0,0,3,3,5,6,11,9,8,17,0.000333,0.019603,2,117.620675,6.534482,58.810338,27.119415,1,0
0,0,3,3,10,8,18,16,13,29,0.000333,0.040309,5,604.639125,33.591063,120.927825,57.219281,3,0
0,0,4,4,9,11,20,21,15,36,0.000333,0.051863,4,622.357646,34.575425,155.589411,66.583073,3,0
0,0,4,4,11,10,21,26,17,43,0.000333,0.062957,5,944.348246,52.463791,188.869649,71.273029,2,0
0,0,8,8,16,13,29,53,32,85,0.000333,0.137643,16,6606.854153,367.047453,412.928385,112.105716,6,0
0,0,3,3,10,6,16,19,10,29,0.000333,0.038667,5,580,32.222222,116,48.729056,1,0
0,0,6,6,14,11,25,38,23,61,0.000333,0.094425,14,3965.853186,220.325177,283.275228,91.356717,4,0
0,0,20,20,20,22,42,126,64,190,0.000333,0.341513,20,20490.80621,1138.378123,1024.54031,184.546058,24,0
0,0,3,3,10,8,18,16,13,29,0.000333,0.040309,5,604.639125,33.591063,120.927825,57.219281,3,0
0,0,7,7,11,19,30,44,28,72,0.000333,0.117765,5,1766.480614,98.137812,353.296123,118.764371,2,0
0,0,7,7,11,19,30,44,28,72,0.000333,0.117765,5,1766.480614,98.137812,353.296123,118.764371,2,0
0,0,27,27,17,36,53,139,77,216,0.000333,0.41241,16,19795.69309,1099.760727,1237.230818,255.604168,10,0
0,0,3,3,10,8,18,16,13,29,0.000333,0.040309,5,604.639125,33.591063,120.927825,57.219281,3,0
0,0,3,3,9,9,18,18,13,31,0.000333,0.043089,4,517.0707,28.72615,129.267675,57.05865,2,0
0,0,6,6,9,18,27,24,23,47,0.000333,0.074493,4,893.91885,49.662158,223.479713,103.587975,3,0
0,0,3,3,8,10,18,20,13,33,0.000333,0.045869,4,550.4301,30.57945,137.607525,57.219281,3,0
0,0,6,6,9,17,26,26,23,49,0.000333,0.076774,4,921.286185,51.182566,230.321546,98.016193,3,0
0,0,15,15,13,24,37,84,45,129,0.000333,0.224006,6,4032.116905,224.006495,672.019484,158.144816,5,0
0,0,7,7,11,19,30,44,28,72,0.000333,0.117765,5,1766.480614,98.137812,353.296123,118.764371,2,0
0,0,9,9,13,21,34,49,34,83,0.000333,0.140753,6,2533.556495,140.753139,422.259416,140.344382,4,0
0,0,17,17,16,23,39,110,55,165,0.000333,0.290697,16,13953.46186,775.192325,872.091366,168.041925,7,0
0,0,4,4,4,7,11,13,11,24,0.000333,0.027675,2,166.052718,9.225151,83.026359,27.651484,3,0
0,0,3,3,10,11,21,22,15,37,0.000333,0.054172,5,812.578723,45.143262,162.515745,71.273029,4,0
0,0,3,3,10,8,18,16,13,29,0.000333,0.040309,5,604.639125,33.591063,120.927825,57.219281,3,0
0,0,9,9,10,19,29,39,30,69,0.000333,0.111734,5,1676.003443,93.111302,335.200689,113.929904,3,0
0,0,4,4,4,7,11,13,11,24,0.000333,0.027675,2,166.052718,9.225151,83.026359,27.651484,3,0
0,0,7,7,11,14,25,38,33,71,0.000333,0.109905,10,3297.137895,183.174327,329.713789,91.356717,1,0
0,0,29,29,6,31,37,242,59,301,0.000333,0.522682,3,4704.136389,261.340911,1568.045463,169.089861,1,0
0,0,4,4,5,7,12,25,14,39,0.000333,0.046605,4,559.25415,31.069675,139.813538,31.261125,3,0
0,0,3,3,10,8,18,16,13,29,0.000333,0.040309,5,604.639125,33.591063,120.927825,57.219281,3,0
0,0,8,8,15,17,32,45,31,76,0.000333,0.126667,7,2660,147.777778,380,128.090227,4,0
0,0,4,4,7,11,18,20,16,36,0.000333,0.050039,3,450.3519,25.01955,150.1173,57.705232,2,0
0,0,4,4,4,7,11,13,11,24,0.000333,0.027675,2,166.052718,9.225151,83.026359,27.651484,3,0
0,0,3,3,5,5,10,12,7,19,0.000333,0.021039,2,126.233268,7.012959,63.116634,23.219281,1,0
0,0,18,18,11,28,39,115,64,179,0.000333,0.315362,10,9460.869972,525.603887,946.086997,172.659686,5,0
0,0,22,22,16,29,45,168,88,256,0.000333,0.468638,24,33741.94542,1874.552524,1405.914393,204.881449,16,0
0,0,4,4,11,10,21,26,17,43,0.000333,0.062957,5,944.348246,52.463791,188.869649,71.273029,2,0
0,0,8,8,16,13,29,53,32,85,0.000333,0.137643,16,6606.854153,367.047453,412.928385,112.105716,6,0
0,0,5,5,10,10,20,27,14,41,0.000333,0.059066,5,885.995259,49.221959,177.199052,66.438562,3,0
0,0,7,7,11,18,29,48,28,76,0.000333,0.123069,5,1846.032778,102.557377,369.206556,113.112398,1,0
0,0,8,8,15,18,33,66,34,100,0.000333,0.168146,7,3531.075884,196.170882,504.439412,133.662009,2,0
0,0,3,3,10,8,18,16,13,29,0.000333,0.040309,5,604.639125,33.591063,120.927825,57.219281,3,0
0,0,3,3,10,9,19,37,16,53,0.000333,0.075047,5,1125.700791,62.538933,225.140158,61.748606,10,0
0,0,4,4,6,8,14,17,12,29,0.000333,0.036804,3,331.239878,18.402215,110.413293,39.509775,3,0
0,0,3,3,10,8,18,16,13,29,0.000333,0.040309,5,604.639125,33.591063,120.927825,57.219281,3,0
0,0,5,5,6,10,16,29,20,49,0.000333,0.065333,6,1176,65.333333,196,48.729056,1,0
0,0,9,9,15,20,35,72,36,108,0.000333,0.184654,7,3877.737961,215.429887,553.962566,145.041921,2,0
0,0,3,3,10,8,18,16,13,29,0.000333,0.040309,5,604.639125,33.591063,120.927825,57.219281,3,0
0,0,6,6,12,15,27,34,30,64,0.000333,0.101438,12,3651.753602,202.8752,304.3128,101.622909,2,0
0,0,17,17,14,26,40,387,50,437,0.000333,0.775228,7,16279.77804,904.432113,2325.682577,175.514402,5,0
0,0,3,3,5,6,11,9,8,17,0.000333,0.019603,2,117.620675,6.534482,58.810338,27.119415,1,0
0,0,3,3,10,6,16,19,10,29,0.000333,0.038667,5,580,32.222222,116,48.729056,1,0
0,0,9,9,12,23,35,48,39,87,0.000333,0.148749,6,2677.485735,148.749207,446.247622,147.061475,4,0
0,0,3,3,10,8,18,16,13,29,0.000333,0.040309,5,604.639125,33.591063,120.927825,57.219281,3,0
0,0,3,3,10,8,18,16,13,29,0.000333,0.040309,5,604.639125,33.591063,120.927825,57.219281,3,0
0,0,3,3,10,10,20,17,13,30,0.000333,0.043219,5,648.289214,36.016067,129.657843,66.438562,2,0
0,0,3,3,10,8,18,16,13,29,0.000333,0.040309,5,604.639125,33.591063,120.927825,57.219281,3,0
0,0,3,3,8,13,21,29,17,46,0.000333,0.067349,4,808.186406,44.899245,202.046601,72.105716,1,0
0,0,3,3,10,8,18,16,13,29,0.000333,0.040309,5,604.639125,33.591063,120.927825,57.219281,3,0
0,0,3,3,10,8,18,16,13,29,0.000333,0.040309,5,604.639125,33.591063,120.927825,57.219281,3,0
0,0,7,7,11,19,30,44,28,72,0.000333,0.117765,5,1766.480614,98.137812,353.296123,118.764371,2,0
0,0,4,4,11,10,21,26,17,43,0.000333,0.062957,5,944.348246,52.463791,188.869649,71.273029,2,0
0,0,3,3,10,8,18,16,13,29,0.000333,0.040309,5,604.639125,33.591063,120.927825,57.219281,3,0
0,0,3,3,5,6,11,9,8,17,0.000333,0.019603,2,117.620675,6.534482,58.810338,27.119415,1,0
0,0,6,6,11,14,25,29,21,50,0.000333,0.077398,5,1160.964047,64.498003,232.192809,91.356717,1,0
0,0,12,12,12,17,29,72,44,116,0.000333,0.187842,12,6762.309545,375.683864,563.525795,112.506418,6,0
0,0,4,4,10,12,22,21,17,38,0.000333,0.056486,5,847.292008,47.071778,169.458402,76.238831,1,0
0,0,3,3,10,10,20,17,13,30,0.000333,0.043219,5,648.289214,36.016067,129.657843,66.438562,2,0
0,0,3,3,10,6,16,19,10,29,0.000333,0.038667,5,580,32.222222,116,48.729056,1,0
0,0,3,3,7,9,16,17,12,29,0.000333,0.038667,3,348,19.333333,116,48.180809,2,0
0,0,7,7,11,19,30,44,28,72,0.000333,0.117765,5,1766.480614,98.137812,353.296123,118.764371,2,0
0,0,3,3,9,9,18,18,13,31,0.000333,0.043089,4,517.0707,28.72615,129.267675,57.05865,2,0
0,0,7,7,11,19,30,44,28,72,0.000333,0.117765,5,1766.480614,98.137812,353.296123,118.764371,2,0
0,0,3,3,9,9,18,18,13,31,0.000333,0.043089,4,517.0707,28.72615,129.267675,57.05865,2,0
0,0,3,3,10,11,21,22,15,37,0.000333,0.054172,5,812.578723,45.143262,162.515745,71.273029,4,0
0,0,7,7,11,19,30,44,28,72,0.000333,0.117765,5,1766.480614,98.137812,353.296123,118.764371,2,0
0,0,3,3,10,8,18,16,13,29,0.000333,0.040309,5,604.639125,33.591063,120.927825,57.219281,3,0
0,0,4,4,11,10,21,26,17,43,0.000333,0.062957,5,944.348246,52.463791,188.869649,71.273029,2,0
0,0,7,7,8,13,21,30,22,52,0.000333,0.076134,4,913.602024,50.755668,228.400506,72.105716,1,0
0,0,7,7,11,19,30,44,28,72,0.000333,0.117765,5,1766.480614,98.137812,353.296123,118.764371,2,0
0,0,6,6,11,13,24,25,18,43,0.000333,0.065718,5,985.766938,54.76483,197.153388,86.159464,2,0
0,0,7,7,11,19,30,44,28,72,0.000333,0.117765,5,1766.480614,98.137812,353.296123,118.764371,2,0
0,0,4,4,4,7,11,13,11,24,0.000333,0.027675,2,166.052718,9.225151,83.026359,27.651484,3,0
0,0,4,4,7,9,16,16,12,28,0.000333,0.037333,3,336,18.666667,112,48.180809,3,0
0,0,7,7,11,19,30,44,28,72,0.000333,0.117765,5,1766.480614,98.137812,353.296123,118.764371,2,0
0,0,8,8,15,18,33,66,34,100,0.000333,0.168146,7,3531.075884,196.170882,504.439412,133.662009,2,0
0,0,18,18,14,29,43,104,56,160,0.000333,0.289401,7,6077.416525,337.634251,868.202361,194.184418,5,0
0,0,7,7,11,19,30,44,28,72,0.000333,0.117765,5,1766.480614,98.137812,353.296123,118.764371,2,0
0,0,7,7,11,19,30,44,28,72,0.000333,0.117765,5,1766.480614,98.137812,353.296123,118.764371,2,0
0,0,7,7,11,19,30,44,28,72,0.000333,0.117765,5,1766.480614,98.137812,353.296123,118.764371,2,0
0,0,4,4,11,10,21,26,17,43,0.000333,0.062957,5,944.348246,52.463791,188.869649,71.273029,2,0
0,0,7,7,11,19,30,44,28,72,0.000333,0.117765,5,1766.480614,98.137812,353.296123,118.764371,2,0
0,0,3,3,11,11,22,26,15,41,0.000333,0.060946,5,914.183482,50.787971,182.836696,76.107496,3,0
0,0,3,3,10,8,18,16,13,29,0.000333,0.040309,5,604.639125,33.591063,120.927825,57.219281,3,0
0,0,7,7,16,14,30,45,29,74,0.000333,0.121037,16,5809.758465,322.764359,363.109904,117.302969,4,0
0,0,7,7,11,19,30,44,28,72,0.000333,0.117765,5,1766.480614,98.137812,353.296123,118.764371,2,0
0,0,7,7,12,17,29,43,27,70,0.000333,0.113353,6,2040.352018,113.35289,340.05867,112.506418,4,0
0,0,4,4,7,9,16,16,12,28,0.000333,0.037333,3,336,18.666667,112,48.180809,3,0
0,0,4,4,6,8,14,17,12,29,0.000333,0.036804,3,331.239878,18.402215,110.413293,39.509775,3,0
0,0,13,13,12,21,33,56,44,100,0.000333,0.168146,12,6053.272943,336.292941,504.439412,135.258216,1,0
0,0,7,7,11,19,30,44,28,72,0.000333,0.117765,5,1766.480614,98.137812,353.296123,118.764371,2,0
0,0,7,7,11,19,30,44,28,72,0.000333,0.117765,5,1766.480614,98.137812,353.296123,118.764371,2,0
0,0,7,7,12,17,29,43,27,70,0.000333,0.113353,6,2040.352018,113.35289,340.05867,112.506418,4,0
0,0,3,3,10,8,18,16,13,29,0.000333,0.040309,5,604.639125,33.591063,120.927825,57.219281,3,0
0,0,4,4,6,8,14,17,12,29,0.000333,0.036804,3,331.239878,18.402215,110.413293,39.509775,3,0
0,0,3,3,9,9,18,18,13,31,0.000333,0.043089,4,517.0707,28.72615,129.267675,57.05865,2,0
0,0,5,5,11,16,27,28,25,53,0.000333,0.084003,5,1260.045188,70.00251,252.009038,102.053748,4,0
0,0,6,6,11,15,26,33,25,58,0.000333,0.090875,5,1363.127518,75.729307,272.625504,96.657107,2,0
0,0,4,4,13,8,21,27,11,38,0.000333,0.055636,6,1001.448372,55.636021,166.908062,72.105716,3,0
0,0,3,3,11,11,22,26,15,41,0.000333,0.060946,5,914.183482,50.787971,182.836696,76.107496,3,0
0,0,27,27,12,33,45,180,107,287,0.000333,0.525387,18,28370.9131,1576.161839,1576.161839,209.484556,1,0
0,0,4,4,10,12,22,21,17,38,0.000333,0.056486,5,847.292008,47.071778,169.458402,76.238831,1,0
0,0,3,3,10,8,18,16,13,29,0.000333,0.040309,5,604.639125,33.591063,120.927825,57.219281,3,0
0,0,3,3,10,10,20,17,13,30,0.000333,0.043219,5,648.289214,36.016067,129.657843,66.438562,2,0
0,0,4,4,6,8,14,17,12,29,0.000333,0.036804,3,331.239878,18.402215,110.413293,39.509775,3,0
0,0,5,5,9,15,24,22,19,41,0.000333,0.062661,4,751.93385,41.774103,187.983463,87.132684,3,0
0,0,3,3,10,8,18,16,13,29,0.000333,0.040309,5,604.639125,33.591063,120.927825,57.219281,3,0
0,0,3,3,10,8,18,16,13,29,0.000333,0.040309,5,604.639125,33.591063,120.927825,57.219281,3,0
0,0,3,3,10,8,18,16,13,29,0.000333,0.040309,5,604.639125,33.591063,120.927825,57.219281,3,0
0,0,4,4,11,10,21,26,17,43,0.000333,0.062957,5,944.348246,52.463791,188.869649,71.273029,2,0
0,0,7,7,11,19,30,44,28,72,0.000333,0.117765,5,1766.480614,98.137812,353.296123,118.764371,2,0
0,0,3,3,9,9,18,18,13,31,0.000333,0.043089,4,517.0707,28.72615,129.267675,57.05865,2,0
0,0,3,3,7,9,16,17,12,29,0.000333,0.038667,3,348,19.333333,116,48.180809,2,0
0,0,30,30,21,35,56,189,97,286,0.000333,0.553635,20,33218.07015,1845.448342,1660.903508,271.763571,21,0
0,0,4,4,4,7,11,13,11,24,0.000333,0.027675,2,166.052718,9.225151,83.026359,27.651484,3,0
0,0,4,4,7,9,16,16,12,28,0.000333,0.037333,3,336,18.666667,112,48.180809,3,0
0,0,27,27,17,36,53,141,77,218,0.000333,0.416229,16,19978.98655,1109.943697,1248.686659,255.604168,10,0
0,0,9,9,13,17,30,40,25,65,0.000333,0.106316,6,1913.687332,106.315963,318.947889,117.592585,3,0
0,0,3,3,10,8,18,16,13,29,0.000333,0.040309,5,604.639125,33.591063,120.927825,57.219281,3,0
0,0,7,7,11,19,30,44,28,72,0.000333,0.117765,5,1766.480614,98.137812,353.296123,118.764371,2,0
0,0,3,3,10,8,18,16,13,29,0.000333,0.040309,5,604.639125,33.591063,120.927825,57.219281,3,0
0,0,30,30,19,42,61,234,129,363,0.000333,0.717619,27,58127.15665,3229.28648,2152.857654,307.187955,11,0
0,0,4,4,7,9,16,16,12,28,0.000333,0.037333,3,336,18.666667,112,48.180809,3,0
0,0,4,4,4,7,11,13,11,24,0.000333,0.027675,2,166.052718,9.225151,83.026359,27.651484,3,0
0,0,8,8,15,16,31,48,35,83,0.000333,0.137066,14,5756.776113,319.820895,411.198294,122.603359,4,0
0,0,6,6,9,18,27,24,23,47,0.000333,0.074493,4,893.91885,49.662158,223.479713,103.587975,3,0
0,0,3,3,10,9,19,37,16,53,0.000333,0.075047,5,1125.700791,62.538933,225.140158,61.748606,10,0
0,0,4,4,10,9,19,46,19,65,0.000333,0.092038,10,2761.152884,153.397382,276.115288,61.748606,11,0
0,0,8,8,16,13,29,56,25,81,0.000333,0.131165,8,3147.971685,174.887316,393.496461,112.105716,3,0
0,0,5,5,10,10,20,27,14,41,0.000333,0.059066,5,885.995259,49.221959,177.199052,66.438562,5,0
0,0,15,15,11,37,48,83,71,154,0.000333,0.286695,5,4300.421126,238.912285,860.084225,230.803522,6,0
0,0,4,4,4,7,11,13,11,24,0.000333,0.027675,2,166.052718,9.225151,83.026359,27.651484,3,0
0,0,3,3,11,11,22,26,15,41,0.000333,0.060946,5,914.183482,50.787971,182.836696,76.107496,3,0
0,0,6,6,13,13,26,38,23,61,0.000333,0.095576,6,1720.360937,95.575608,286.726823,96.211433,4,0
0,0,3,3,10,8,18,16,13,29,0.000333,0.040309,5,604.639125,33.591063,120.927825,57.219281,3,0
0,0,23,23,14,26,40,588,88,676,0.000333,1.199208,21,75550.09124,4197.227291,3597.623392,175.514402,5,0
0,0,6,6,10,8,18,27,15,42,0.000333,0.058379,5,875.68425,48.649125,175.13685,57.219281,2,0
0,0,9,9,12,18,30,63,31,94,0.000333,0.153749,6,2767.486296,153.749239,461.247716,118.0782,13,0
0,0,6,6,11,15,26,29,27,56,0.000333,0.087742,5,1316.123121,73.117951,263.224624,96.657107,2,0
0,0,7,7,12,17,29,43,27,70,0.000333,0.113353,6,2040.352018,113.35289,340.05867,112.506418,4,0
0,0,7,7,12,17,29,43,27,70,0.000333,0.113353,6,2040.352018,113.35289,340.05867,112.506418,4,0
0,0,7,7,12,17,29,43,27,70,0.000333,0.113353,6,2040.352018,113.35289,340.05867,112.506418,4,0
0,0,3,3,10,8,18,20,12,32,0.000333,0.044479,5,667.188,37.066,133.4376,57.219281,2,0
0,0,8,8,16,13,29,53,32,85,0.000333,0.137643,16,6606.854153,367.047453,412.928385,112.105716,6,0
0,0,4,4,8,11,19,17,15,32,0.000333,0.045311,4,543.734722,30.207485,135.93368,62.053748,3,0
0,0,4,4,10,12,22,21,17,38,0.000333,0.056486,5,847.292008,47.071778,169.458402,76.238831,1,0
0,0,3,3,10,10,20,17,13,30,0.000333,0.043219,5,648.289214,36.016067,129.657843,66.438562,2,0
0,0,3,3,11,11,22,26,15,41,0.000333,0.060946,5,914.183482,50.787971,182.836696,76.107496,3,0
0,0,6,6,9,18,27,24,23,47,0.000333,0.074493,4,893.91885,49.662158,223.479713,103.587975,3,0
0,0,4,4,4,7,11,13,11,24,0.000333,0.027675,2,166.052718,9.225151,83.026359,27.651484,3,0
0,0,3,3,10,8,18,16,13,29,0.000333,0.040309,5,604.639125,33.591063,120.927825,57.219281,3,0
0,0,4,4,12,12,24,42,17,59,0.000333,0.090171,6,1623.076725,90.170929,270.512788,86.0391,5,0
0,0,3,3,10,8,18,16,13,29,0.000333,0.040309,5,604.639125,33.591063,120.927825,57.219281,3,0
0,0,5,5,12,16,28,39,25,64,0.000333,0.102557,6,1846.02429,102.556905,307.670715,107.01955,2,0
0,0,6,6,13,13,26,38,23,61,0.000333,0.095576,6,1720.360937,95.575608,286.726823,96.211433,4,0
0,0,3,3,9,9,18,18,13,31,0.000333,0.043089,4,517.0707,28.72615,129.267675,57.05865,2,0
0,0,3,3,10,11,21,22,15,37,0.000333,0.054172,5,812.578723,45.143262,162.515745,71.273029,4,0
0,0,17,17,16,23,39,110,55,165,0.000333,0.290697,16,13953.46186,775.192325,872.091366,168.041925,7,0
0,0,6,6,13,13,26,38,23,61,0.000333,0.095576,6,1720.360937,95.575608,286.726823,96.211433,4,0
0,0,3,3,10,8,18,16,13,29,0.000333,0.040309,5,604.639125,33.591063,120.927825,57.219281,3,0
0,0,3,3,10,6,16,19,10,29,0.000333,0.038667,5,580,32.222222,116,48.729056,1,0
0,0,17,17,16,23,39,110,55,165,0.000333,0.290697,16,13953.46186,775.192325,872.091366,168.041925,7,0
0,0,23,23,16,34,50,118,79,197,0.000333,0.370613,16,17789.43471,988.301928,1111.839669,236.973737,8,0
0,0,3,3,10,8,18,16,13,29,0.000333,0.040309,5,604.639125,33.591063,120.927825,57.219281,3,0
0,0,4,4,7,9,16,16,12,28,0.000333,0.037333,3,336,18.666667,112,48.180809,3,0
0,0,4,4,10,13,23,19,17,36,0.000333,0.054283,5,814.241152,45.23562,162.84823,81.324997,2,0
0,0,4,4,4,7,11,13,11,24,0.000333,0.027675,2,166.052718,9.225151,83.026359,27.651484,3,0
0,0,7,7,11,19,30,44,28,72,0.000333,0.117765,5,1766.480614,98.137812,353.296123,118.764371,2,0
0,0,7,7,12,17,29,43,27,70,0.000333,0.113353,6,2040.352018,113.35289,340.05867,112.506418,4,0
0,0,4,4,4,7,11,13,11,24,0.000333,0.027675,2,166.052718,9.225151,83.026359,27.651484,3,0
0,0,3,3,10,8,18,16,13,29,0.000333,0.040309,5,604.639125,33.591063,120.927825,57.219281,3,0
0,0,3,3,11,11,22,26,15,41,0.000333,0.060946,5,914.183482,50.787971,182.836696,76.107496,3,0
0,0,22,22,17,34,51,128,68,196,0.000333,0.370598,16,17788.72587,988.262548,1111.795367,242.460605,8,0
0,0,3,3,10,8,18,16,13,29,0.000333,0.040309,5,604.639125,33.591063,120.927825,57.219281,3,0
0,0,13,13,16,36,52,233,88,321,0.000333,0.609947,16,29277.45839,1626.525466,1829.84115,250.1173,14,0
0,0,4,4,7,9,16,16,12,28,0.000333,0.037333,3,336,18.666667,112,48.180809,3,0
0,0,4,4,4,7,11,13,11,24,0.000333,0.027675,2,166.052718,9.225151,83.026359,27.651484,3,0
0,0,4,4,11,10,21,26,17,43,0.000333,0.062957,5,944.348246,52.463791,188.869649,71.273029,2,0
0,0,3,3,10,6,16,19,10,29,0.000333,0.038667,5,580,32.222222,116,48.729056,1,0
0,0,3,3,10,8,18,16,13,29,0.000333,0.040309,5,604.639125,33.591063,120.927825,57.219281,3,0
0,0,3,3,10,8,18,16,13,29,0.000333,0.040309,5,604.639125,33.591063,120.927825,57.219281,3,0
0,0,4,4,10,9,19,46,19,65,0.000333,0.092038,10,2761.152884,153.397382,276.115288,61.748606,11,0
0,0,3,3,10,9,19,37,16,53,0.000333,0.075047,5,1125.700791,62.538933,225.140158,61.748606,10,0
0,0,3,3,10,8,18,16,13,29,0.000333,0.040309,5,604.639125,33.591063,120.927825,57.219281,3,0
0,0,4,4,10,12,22,21,17,38,0.000333,0.056486,5,847.292008,47.071778,169.458402,76.238831,1,0
0,0,3,3,7,8,15,23,12,35,0.000333,0.04558,3,410.223513,22.790195,136.741171,43.651484,1,0
0,0,7,7,12,17,29,43,27,70,0.000333,0.113353,6,2040.352018,113.35289,340.05867,112.506418,4,0
0,0,3,3,10,10,20,17,13,30,0.000333,0.043219,5,648.289214,36.016067,129.657843,66.438562,2,0
0,0,7,7,11,19,30,44,28,72,0.000333,0.117765,5,1766.480614,98.137812,353.296123,118.764371,2,0
0,0,7,7,11,19,30,44,28,72,0.000333,0.117765,5,1766.480614,98.137812,353.296123,118.764371,2,0
0,0,3,3,10,8,18,16,13,29,0.000333,0.040309,5,604.639125,33.591063,120.927825,57.219281,3,0
0,0,3,3,10,8,18,16,13,29,0.000333,0.040309,5,604.639125,33.591063,120.927825,57.219281,3,0
0,0,4,4,11,10,21,26,17,43,0.000333,0.062957,5,944.348246,52.463791,188.869649,71.273029,2,0
0,0,5,5,13,10,23,35,21,56,0.000333,0.08444,12,3039.833634,168.879646,253.31947,81.324997,4,0
0,0,3,3,10,8,18,16,13,29,0.000333,0.040309,5,604.639125,33.591063,120.927825,57.219281,3,0
0,0,3,3,10,8,18,16,13,29,0.000333,0.040309,5,604.639125,33.591063,120.927825,57.219281,3,0
0,0,3,3,10,10,20,17,13,30,0.000333,0.043219,5,648.289214,36.016067,129.657843,66.438562,2,0
0,0,4,4,10,12,22,21,17,38,0.000333,0.056486,5,847.292008,47.071778,169.458402,76.238831,1,0
0,0,3,3,10,8,18,16,13,29,0.000333,0.040309,5,604.639125,33.591063,120.927825,57.219281,3,0
0,0,4,4,4,7,11,13,11,24,0.000333,0.027675,2,166.052718,9.225151,83.026359,27.651484,3,0
0,0,4,4,7,9,16,16,12,28,0.000333,0.037333,3,336,18.666667,112,48.180809,3,0
0,0,7,7,10,12,22,44,21,65,0.000333,0.096621,5,1449.315276,80.517515,289.863055,76.238831,3,0
0,0,3,3,10,8,18,16,13,29,0.000333,0.040309,5,604.639125,33.591063,120.927825,57.219281,3,0
0,0,33,33,17,52,69,174,97,271,0.000333,0.551803,8,13243.28102,735.737835,1655.410128,365.909734,11,0
0,0,7,7,11,19,30,44,28,72,0.000333,0.117765,5,1766.480614,98.137812,353.296123,118.764371,2,0
0,0,3,3,10,8,18,16,13,29,0.000333,0.040309,5,604.639125,33.591063,120.927825,57.219281,3,0
0,0,7,7,11,19,30,44,28,72,0.000333,0.117765,5,1766.480614,98.137812,353.296123,118.764371,2,0
0,0,3,3,10,6,16,19,10,29,0.000333,0.038667,5,580,32.222222,116,48.729056,1,0
0,0,9,9,16,24,40,75,54,129,0.000333,0.228843,16,10984.45959,610.247755,686.528724,174.0391,2,0
0,0,3,3,11,11,22,26,15,41,0.000333,0.060946,5,914.183482,50.787971,182.836696,76.107496,3,0
0,0,4,4,11,9,20,24,12,36,0.000333,0.051863,5,777.947057,43.219281,155.589411,66.583073,5,0
0,0,13,13,18,21,39,78,56,134,0.000333,0.236081,18,12748.39015,708.243897,708.243897,167.297316,6,0
0,0,4,4,4,7,11,13,11,24,0.000333,0.027675,2,166.052718,9.225151,83.026359,27.651484,3,0
0,0,7,7,11,19,30,44,28,72,0.000333,0.117765,5,1766.480614,98.137812,353.296123,118.764371,2,0
0,0,3,3,10,8,18,16,13,29,0.000333,0.040309,5,604.639125,33.591063,120.927825,57.219281,3,0
0,0,3,3,10,8,18,16,13,29,0.000333,0.040309,5,604.639125,33.591063,120.927825,57.219281,3,0
0,0,3,3,10,8,18,16,13,29,0.000333,0.040309,5,604.639125,33.591063,120.927825,57.219281,3,0
0,0,30,30,18,45,63,161,86,247,0.000333,0.492129,9,13287.49327,738.194071,1476.388141,322.192039,11,0
0,0,4,4,10,12,22,21,17,38,0.000333,0.056486,5,847.292008,47.071778,169.458402,76.238831,1,0
0,0,7,7,11,19,30,44,28,72,0.000333,0.117765,5,1766.480614,98.137812,353.296123,118.764371,2,0
0,0,3,3,10,10,20,17,13,30,0.000333,0.043219,5,648.289214,36.016067,129.657843,66.438562,2,0
0,0,8,8,15,18,33,66,34,100,0.000333,0.168146,7,3531.075884,196.170882,504.439412,133.662009,2,0
0,0,3,3,10,10,20,17,13,30,0.000333,0.043219,5,648.289214,36.016067,129.657843,66.438562,2,0
0,0,9,9,14,19,33,44,36,80,0.000333,0.134517,7,2824.860707,156.936706,403.55153,134.013592,4,0
0,0,3,3,10,10,20,17,13,30,0.000333,0.043219,5,648.289214,36.016067,129.657843,66.438562,2,0
0,0,29,29,22,49,71,182,138,320,0.000333,0.655973,22,43294.21972,2405.234429,1967.919078,373.228278,5,0
0,0,3,3,10,8,18,16,13,29,0.000333,0.040309,5,604.639125,33.591063,120.927825,57.219281,3,0
0,0,3,3,10,8,18,16,13,29,0.000333,0.040309,5,604.639125,33.591063,120.927825,57.219281,3,0
0,0,14,14,18,22,40,87,63,150,0.000333,0.266096,18,14369.20586,798.289214,798.289214,173.166146,6,0
0,0,3,3,9,9,18,18,13,31,0.000333,0.043089,4,517.0707,28.72615,129.267675,57.05865,2,0
0,0,8,8,16,13,29,53,32,85,0.000333,0.137643,16,6606.854153,367.047453,412.928385,112.105716,6,0
0,0,4,4,7,12,19,20,18,38,0.000333,0.053807,3,484.263737,26.903541,161.421246,62.671034,2,0
0,0,7,7,12,13,25,29,21,50,0.000333,0.077398,6,1393.156857,77.397603,232.192809,91.125266,3,0
0,0,6,6,14,12,26,38,24,62,0.000333,0.097142,14,4079.981675,226.665649,291.427263,96.322519,4,0
0,0,3,3,9,9,18,18,13,31,0.000333,0.043089,4,517.0707,28.72615,129.267675,57.05865,2,0
0,0,3,3,9,9,18,18,13,31,0.000333,0.043089,4,517.0707,28.72615,129.267675,57.05865,2,0
0,0,5,5,11,15,26,28,23,51,0.000333,0.079907,5,1198.612128,66.589563,239.722426,96.657107,4,0
0,0,3,3,10,8,18,16,13,29,0.000333,0.040309,5,604.639125,33.591063,120.927825,57.219281,3,0
0,0,3,3,10,8,18,16,13,29,0.000333,0.040309,5,604.639125,33.591063,120.927825,57.219281,3,0
0,0,3,3,10,8,18,16,13,29,0.000333,0.040309,5,604.639125,33.591063,120.927825,57.219281,3,0
0,0,7,7,11,19,30,44,28,72,0.000333,0.117765,5,1766.480614,98.137812,353.296123,118.764371,2,0
0,0,3,3,9,9,18,18,13,31,0.000333,0.043089,4,517.0707,28.72615,129.267675,57.05865,2,0
0,0,17,17,16,23,39,110,55,165,0.000333,0.290697,16,13953.46186,775.192325,872.091366,168.041925,7,0
0,0,3,3,10,8,18,16,13,29,0.000333,0.040309,5,604.639125,33.591063,120.927825,57.219281,3,0
0,0,4,4,8,7,15,19,11,30,0.000333,0.039069,4,468.826871,26.045937,117.206718,43.651484,5,0
0,0,7,7,11,19,30,44,28,72,0.000333,0.117765,5,1766.480614,98.137812,353.296123,118.764371,2,0
0,0,3,3,10,8,18,16,13,29,0.000333,0.040309,5,604.639125,33.591063,120.927825,57.219281,3,0
0,0,17,17,16,23,39,110,55,165,0.000333,0.290697,16,13953.46186,775.192325,872.091366,168.041925,7,0
0,0,8,8,14,14,28,41,28,69,0.000333,0.110569,14,4643.904855,257.994714,331.70749,106.605938,2,0
0,0,3,3,10,8,18,16,13,29,0.000333,0.040309,5,604.639125,33.591063,120.927825,57.219281,3,0
0,0,3,3,10,8,18,16,13,29,0.000333,0.040309,5,604.639125,33.591063,120.927825,57.219281,3,0
0,0,3,3,10,8,18,16,13,29,0.000333,0.040309,5,604.639125,33.591063,120.927825,57.219281,3,0
0,0,3,3,10,10,20,17,13,30,0.000333,0.043219,5,648.289214,36.016067,129.657843,66.438562,2,0
0,0,4,4,10,11,21,30,20,50,0.000333,0.073205,5,1098.079356,61.004409,219.615871,71.273029,5,0
0,0,3,3,9,9,18,18,13,31,0.000333,0.043089,4,517.0707,28.72615,129.267675,57.05865,2,0
0,0,4,4,9,12,21,23,18,41,0.000333,0.060028,4,720.340057,40.018892,180.085014,71.548875,2,0
0,0,4,4,11,9,20,24,12,36,0.000333,0.051863,5,777.947057,43.219281,155.589411,66.583073,5,0
0,0,7,7,11,19,30,44,28,72,0.000333,0.117765,5,1766.480614,98.137812,353.296123,118.764371,2,0
0,0,3,3,10,8,18,16,13,29,0.000333,0.040309,5,604.639125,33.591063,120.927825,57.219281,3,0
0,0,15,15,12,26,38,111,64,175,0.000333,0.306129,12,11020.64778,612.25821,918.387315,165.230983,1,0
0,0,7,7,11,19,30,44,28,72,0.000333,0.117765,5,1766.480614,98.137812,353.296123,118.764371,2,0
0,0,8,8,16,13,29,56,25,81,0.000333,0.131165,8,3147.971685,174.887316,393.496461,112.105716,3,0
0,0,7,7,11,19,30,44,28,72,0.000333,0.117765,5,1766.480614,98.137812,353.296123,118.764371,2,0
0,0,11,11,17,19,36,59,45,104,0.000333,0.179224,16,8602.755202,477.930845,537.6722,150.197491,6,0
0,0,6,6,9,18,27,24,23,47,0.000333,0.074493,4,893.91885,49.662158,223.479713,103.587975,3,0
0,0,3,3,10,8,18,16,13,29,0.000333,0.040309,5,604.639125,33.591063,120.927825,57.219281,3,0
0,0,3,3,10,8,18,16,13,29,0.000333,0.040309,5,604.639125,33.591063,120.927825,57.219281,3,0
0,0,3,3,10,8,18,16,13,29,0.000333,0.040309,5,604.639125,33.591063,120.927825,57.219281,3,0
0,0,5,5,11,13,24,28,20,48,0.000333,0.073359,5,1100.391,61.132833,220.0782,86.159464,4,0
0,0,3,3,9,9,18,18,13,31,0.000333,0.043089,4,517.0707,28.72615,129.267675,57.05865,2,0
0,0,3,3,10,8,18,16,13,29,0.000333,0.040309,5,604.639125,33.591063,120.927825,57.219281,3,0
0,0,25,25,16,36,52,209,111,320,0.000333,0.608047,24,43779.37704,2432.187613,1824.14071,250.1173,11,0
0,0,8,8,15,18,33,66,34,100,0.000333,0.168146,7,3531.075884,196.170882,504.439412,133.662009,2,0
0,0,9,9,15,20,35,72,36,108,0.000333,0.184654,7,3877.737961,215.429887,553.962566,145.041921,2,0
0,0,3,3,6,9,15,10,14,24,0.000333,0.031255,3,281.296123,15.627562,93.765374,44.0391,1,0
0,0,4,4,6,10,16,26,15,41,0.000333,0.054667,3,492,27.333333,164,48.729056,4,0
0,0,3,3,8,10,18,20,13,33,0.000333,0.045869,4,550.4301,30.57945,137.607525,57.219281,3,0
0,0,3,3,9,9,18,18,13,31,0.000333,0.043089,4,517.0707,28.72615,129.267675,57.05865,2,0
0,0,5,5,10,10,20,27,14,41,0.000333,0.059066,5,885.995259,49.221959,177.199052,66.438562,3,0
0,0,3,3,9,9,18,18,13,31,0.000333,0.043089,4,517.0707,28.72615,129.267675,57.05865,2,0
0,0,3,3,10,11,21,22,15,37,0.000333,0.054172,5,812.578723,45.143262,162.515745,71.273029,4,0
0,0,3,3,10,8,18,16,13,29,0.000333,0.040309,5,604.639125,33.591063,120.927825,57.219281,3,0
0,0,3,3,10,8,18,16,13,29,0.000333,0.040309,5,604.639125,33.591063,120.927825,57.219281,3,0
0,0,3,3,10,8,18,16,13,29,0.000333,0.040309,5,604.639125,33.591063,120.927825,57.219281,3,0
0,0,3,3,10,8,18,16,13,29,0.000333,0.040309,5,604.639125,33.591063,120.927825,57.219281,3,0
0,0,5,5,10,10,20,27,14,41,0.000333,0.059066,5,885.995259,49.221959,177.199052,66.438562,3,0
0,0,5,5,10,10,20,27,14,41,0.000333,0.059066,5,885.995259,49.221959,177.199052,66.438562,3,0
0,0,3,3,11,11,22,26,15,41,0.000333,0.060946,5,914.183482,50.787971,182.836696,76.107496,3,0
0,0,7,7,11,18,29,48,28,76,0.000333,0.123069,5,1846.032778,102.557377,369.206556,113.112398,1,0
0,0,3,3,9,9,18,18,13,31,0.000333,0.043089,4,517.0707,28.72615,129.267675,57.05865,2,0
0,0,4,4,11,10,21,26,17,43,0.000333,0.062957,5,944.348246,52.463791,188.869649,71.273029,2,0
0,0,3,3,11,11,22,26,15,41,0.000333,0.060946,5,914.183482,50.787971,182.836696,76.107496,3,0
0,0,12,12,11,19,30,73,36,109,0.000333,0.178284,5,2674.255375,148.569743,534.851075,118.764371,9,0
0,0,4,4,4,6,10,16,12,28,0.000333,0.031005,4,372.055947,20.669775,93.013987,23.509775,1,0
0,0,8,8,16,13,29,53,32,85,0.000333,0.137643,16,6606.854153,367.047453,412.928385,112.105716,6,0
0,0,15,15,14,22,36,91,56,147,0.000333,0.253326,14,10639.70565,591.094758,759.978975,151.410465,6,0
0,0,3,3,10,8,18,16,13,29,0.000333,0.040309,5,604.639125,33.591063,120.927825,57.219281,3,0
0,0,21,21,17,32,49,123,66,189,0.000333,0.353727,16,16978.88257,943.271254,1061.180161,229.486868,8,0
0,0,6,6,11,15,26,30,22,52,0.000333,0.081474,5,1222.114327,67.89524,244.422865,96.657107,1,0
0,0,5,5,9,11,20,26,17,43,0.000333,0.061948,4,743.371632,41.298424,185.842908,66.583073,3,0
0,0,4,4,11,10,21,26,17,43,0.000333,0.062957,5,944.348246,52.463791,188.869649,71.273029,2,0
0,0,3,3,10,8,18,16,13,29,0.000333,0.040309,5,604.639125,33.591063,120.927825,57.219281,3,0
0,0,7,7,11,19,30,44,28,72,0.000333,0.117765,5,1766.480614,98.137812,353.296123,118.764371,2,0
0,0,7,7,11,19,30,44,28,72,0.000333,0.117765,5,1766.480614,98.137812,353.296123,118.764371,2,0
0,0,3,3,10,8,18,16,13,29,0.000333,0.040309,5,604.639125,33.591063,120.927825,57.219281,3,0
0,0,3,3,10,8,18,16,13,29,0.000333,0.040309,5,604.639125,33.591063,120.927825,57.219281,3,0
0,0,3,3,10,8,18,16,13,29,0.000333,0.040309,5,604.639125,33.591063,120.927825,57.219281,3,0
0,0,5,5,9,9,18,34,14,48,0.000333,0.066719,4,800.6256,44.4792,200.1564,57.05865,3,0
0,0,4,4,11,9,20,24,12,36,0.000333,0.051863,5,777.947057,43.219281,155.589411,66.583073,5,0
0,0,10,10,14,20,34,106,30,136,0.000333,0.230632,7,4843.264625,269.070257,691.894946,139.741531,3,0
0,0,3,3,10,8,18,16,13,29,0.000333,0.040309,5,604.639125,33.591063,120.927825,57.219281,3,0
0,0,4,4,4,7,11,13,11,24,0.000333,0.027675,2,166.052718,9.225151,83.026359,27.651484,3,0
0,0,3,3,9,9,18,18,13,31,0.000333,0.043089,4,517.0707,28.72615,129.267675,57.05865,2,0
0,0,3,3,7,9,16,17,12,29,0.000333,0.038667,3,348,19.333333,116,48.180809,2,0
0,0,3,3,11,11,22,26,15,41,0.000333,0.060946,5,914.183482,50.787971,182.836696,76.107496,3,0
0,0,3,3,10,8,18,20,12,32,0.000333,0.044479,5,667.188,37.066,133.4376,57.219281,2,0
0,0,3,3,10,6,16,19,10,29,0.000333,0.038667,5,580,32.222222,116,48.729056,1,0
0,0,6,6,13,13,26,38,23,61,0.000333,0.095576,6,1720.360937,95.575608,286.726823,96.211433,4,0
0,0,4,4,10,11,21,20,15,35,0.000333,0.051244,5,768.655549,42.703086,153.73111,71.273029,2,0
0,0,23,23,20,29,49,181,80,261,0.000333,0.48848,20,29308.78539,1628.265855,1465.439269,227.320011,12,0
0,0,6,6,9,18,27,24,23,47,0.000333,0.074493,4,893.91885,49.662158,223.479713,103.587975,3,0
0,0,4,4,4,7,11,13,11,24,0.000333,0.027675,2,166.052718,9.225151,83.026359,27.651484,3,0
0,0,4,4,4,7,11,13,11,24,0.000333,0.027675,2,166.052718,9.225151,83.026359,27.651484,3,0
0,0,21,21,17,32,49,123,66,189,0.000333,0.353727,16,16978.88257,943.271254,1061.180161,229.486868,8,0
0,0,3,3,11,11,22,26,15,41,0.000333,0.060946,5,914.183482,50.787971,182.836696,76.107496,3,0
0,0,8,8,16,13,29,53,32,85,0.000333,0.137643,16,6606.854153,367.047453,412.928385,112.105716,6,0
0,0,5,5,12,16,28,39,25,64,0.000333,0.102557,6,1846.02429,102.556905,307.670715,107.01955,2,0
0,0,4,4,11,10,21,26,17,43,0.000333,0.062957,5,944.348246,52.463791,188.869649,71.273029,2,0
0,0,7,7,11,19,30,44,28,72,0.000333,0.117765,5,1766.480614,98.137812,353.296123,118.764371,2,0
0,0,12,12,12,17,29,72,44,116,0.000333,0.187842,12,6762.309545,375.683864,563.525795,112.506418,6,0
0,0,4,4,11,9,20,35,15,50,0.000333,0.072032,5,1080.482024,60.026779,216.096405,66.583073,2,0
0,0,3,3,10,6,16,21,9,30,0.000333,0.04,5,600,33.333333,120,48.729056,3,0
0,0,8,8,16,19,35,72,39,111,0.000333,0.189783,16,9109.606638,506.089258,569.350415,144.710623,10,0
0,0,6,6,9,18,27,24,23,47,0.000333,0.074493,4,893.91885,49.662158,223.479713,103.587975,3,0
0,0,7,7,12,17,29,43,27,70,0.000333,0.113353,6,2040.352018,113.35289,340.05867,112.506418,4,0
0,0,3,3,10,8,18,16,13,29,0.000333,0.040309,5,604.639125,33.591063,120.927825,57.219281,3,0
0,0,3,3,10,8,18,16,13,29,0.000333,0.040309,5,604.639125,33.591063,120.927825,57.219281,3,0
0,0,5,5,9,15,24,22,19,41,0.000333,0.062661,4,751.93385,41.774103,187.983463,87.132684,3,0
0,0,7,7,11,19,30,44,28,72,0.000333,0.117765,5,1766.480614,98.137812,353.296123,118.764371,2,0
0,0,17,17,16,23,39,110,55,165,0.000333,0.290697,16,13953.46186,775.192325,872.091366,168.041925,7,0
0,0,3,3,9,9,18,18,13,31,0.000333,0.043089,4,517.0707,28.72615,129.267675,57.05865,2,0
0,0,4,4,10,9,19,46,19,65,0.000333,0.092038,10,2761.152884,153.397382,276.115288,61.748606,11,0
0,0,3,3,10,9,19,37,16,53,0.000333,0.075047,5,1125.700791,62.538933,225.140158,61.748606,10,0
0,0,4,4,6,8,14,17,12,29,0.000333,0.036804,3,331.239878,18.402215,110.413293,39.509775,3,0
0,0,6,6,13,13,26,38,23,61,0.000333,0.095576,6,1720.360937,95.575608,286.726823,96.211433,4,0
0,0,10,10,13,22,35,57,33,90,0.000333,0.153878,6,2769.812829,153.878491,461.635472,146.213212,3,0
0,0,7,7,14,17,31,38,23,61,0.000333,0.100735,7,2115.441825,117.524546,302.205975,122.789837,5,0
0,0,7,7,11,19,30,44,28,72,0.000333,0.117765,5,1766.480614,98.137812,353.296123,118.764371,2,0
0,0,3,3,9,9,18,18,13,31,0.000333,0.043089,4,517.0707,28.72615,129.267675,57.05865,2,0
0,0,4,4,7,11,18,20,16,36,0.000333,0.050039,3,450.3519,25.01955,150.1173,57.705232,2,0
0,0,3,3,10,8,18,16,13,29,0.000333,0.040309,5,604.639125,33.591063,120.927825,57.219281,3,0
0,0,7,7,11,19,30,44,28,72,0.000333,0.117765,5,1766.480614,98.137812,353.296123,118.764371,2,0
0,0,3,3,10,8,18,16,13,29,0.000333,0.040309,5,604.639125,33.591063,120.927825,57.219281,3,0
0,0,32,32,14,41,55,231,131,362,0.000333,0.697617,21,43949.89654,2441.660919,2092.852216,272.962601,1,0
0,0,7,7,11,19,30,44,28,72,0.000333,0.117765,5,1766.480614,98.137812,353.296123,118.764371,2,0
0,0,9,9,12,20,32,46,38,84,0.000333,0.14,6,2520,140,420,129.458112,4,0
0,0,3,3,10,8,18,16,13,29,0.000333,0.040309,5,604.639125,33.591063,120.927825,57.219281,3,0
0,0,7,7,11,19,30,44,28,72,0.000333,0.117765,5,1766.480614,98.137812,353.296123,118.764371,2,0
0,0,5,5,8,11,19,21,19,40,0.000333,0.056639,4,679.668402,37.759356,169.917101,62.053748,3,0
0,0,4,4,4,7,11,13,11,24,0.000333,0.027675,2,166.052718,9.225151,83.026359,27.651484,3,0
0,0,3,3,10,8,18,16,13,29,0.000333,0.040309,5,604.639125,33.591063,120.927825,57.219281,3,0
0,0,7,7,11,19,30,44,28,72,0.000333,0.117765,5,1766.480614,98.137812,353.296123,118.764371,2,0
0,0,7,7,11,18,29,48,28,76,0.000333,0.123069,5,1846.032778,102.557377,369.206556,113.112398,1,0
0,0,11,11,14,18,32,70,36,106,0.000333,0.176667,14,7420,412.222222,530,128.361619,4,0
0,0,17,17,16,23,39,110,55,165,0.000333,0.290697,16,13953.46186,775.192325,872.091366,168.041925,7,0
0,0,3,3,10,8,18,16,13,29,0.000333,0.040309,5,604.639125,33.591063,120.927825,57.219281,3,0
0,0,6,6,10,12,22,233,22,255,0.000333,0.379052,5,5685.775314,315.876406,1137.155063,76.238831,3,0
0,0,5,5,9,15,24,22,19,41,0.000333,0.062661,4,751.93385,41.774103,187.983463,87.132684,3,0
0,0,3,3,10,8,18,16,13,29,0.000333,0.040309,5,604.639125,33.591063,120.927825,57.219281,3,0
0,0,3,3,10,8,18,16,13,29,0.000333,0.040309,5,604.639125,33.591063,120.927825,57.219281,3,0
0,0,4,4,11,9,20,24,12,36,0.000333,0.051863,5,777.947057,43.219281,155.589411,66.583073,5,0
0,0,3,3,10,8,18,16,13,29,0.000333,0.040309,5,604.639125,33.591063,120.927825,57.219281,3,0
0,0,7,7,11,19,30,44,28,72,0.000333,0.117765,5,1766.480614,98.137812,353.296123,118.764371,2,0
0,0,3,3,11,11,22,26,15,41,0.000333,0.060946,5,914.183482,50.787971,182.836696,76.107496,3,0
0,0,7,7,11,19,30,44,28,72,0.000333,0.117765,5,1766.480614,98.137812,353.296123,118.764371,2,0
0,0,55,55,30,79,109,424,244,668,0.000333,1.507049,45,203451.6208,11302.86782,4521.147129,645.205397,33,0
0,0,4,4,6,8,14,17,12,29,0.000333,0.036804,3,331.239878,18.402215,110.413293,39.509775,3,0
0,0,7,7,11,19,30,44,28,72,0.000333,0.117765,5,1766.480614,98.137812,353.296123,118.764371,2,0
0,0,3,3,10,6,16,19,10,29,0.000333,0.038667,5,580,32.222222,116,48.729056,1,0
0,0,7,7,11,19,30,44,28,72,0.000333,0.117765,5,1766.480614,98.137812,353.296123,118.764371,2,0
0,0,3,3,10,8,18,16,13,29,0.000333,0.040309,5,604.639125,33.591063,120.927825,57.219281,3,0
0,0,7,7,11,19,30,44,28,72,0.000333,0.117765,5,1766.480614,98.137812,353.296123,118.764371,2,0
0,0,8,8,14,19,33,44,35,79,0.000333,0.132836,7,2789.549948,154.974997,398.507135,134.013592,4,0
0,0,8,8,16,13,29,53,32,85,0.000333,0.137643,16,6606.854153,367.047453,412.928385,112.105716,6,0
0,0,19,19,12,26,38,116,56,172,0.000333,0.300881,12,10831.72239,601.762355,902.643532,165.230983,11,0
0,0,4,4,4,7,11,13,11,24,0.000333,0.027675,2,166.052718,9.225151,83.026359,27.651484,3,0
0,0,4,4,7,9,16,16,12,28,0.000333,0.037333,3,336,18.666667,112,48.180809,3,0
0,0,4,4,4,7,11,13,11,24,0.000333,0.027675,2,166.052718,9.225151,83.026359,27.651484,3,0
0,0,3,3,9,9,18,18,13,31,0.000333,0.043089,4,517.0707,28.72615,129.267675,57.05865,2,0
0,0,7,7,11,19,30,44,28,72,0.000333,0.117765,5,1766.480614,98.137812,353.296123,118.764371,2,0
0,0,4,4,10,12,22,21,17,38,0.000333,0.056486,5,847.292008,47.071778,169.458402,76.238831,1,0
0,0,3,3,10,10,20,17,13,30,0.000333,0.043219,5,648.289214,36.016067,129.657843,66.438562,2,0
0,0,5,5,10,14,24,24,23,47,0.000333,0.071831,5,1077.466188,59.859233,215.493238,86.52225,2,0
0,0,7,7,11,19,30,44,28,72,0.000333,0.117765,5,1766.480614,98.137812,353.296123,118.764371,2,0
0,0,20,20,19,27,46,157,73,230,0.000333,0.423473,18,22867.5465,1270.41925,1270.41925,209.092585,10,0
0,0,19,19,19,27,46,152,72,224,0.000333,0.412426,18,22271.00181,1237.277878,1237.277878,209.092585,9,0
0,0,3,3,10,8,18,16,13,29,0.000333,0.040309,5,604.639125,33.591063,120.927825,57.219281,3,0
0,0,3,3,11,10,21,26,13,39,0.000333,0.0571,5,856.501897,47.583439,171.300379,71.273029,4,0
0,0,6,6,13,13,26,38,23,61,0.000333,0.095576,6,1720.360937,95.575608,286.726823,96.211433,4,0
0,0,4,4,4,7,11,13,11,24,0.000333,0.027675,2,166.052718,9.225151,83.026359,27.651484,3,0
0,0,4,4,6,8,14,17,12,29,0.000333,0.036804,3,331.239878,18.402215,110.413293,39.509775,3,0
0,0,3,3,10,8,18,16,13,29,0.000333,0.040309,5,604.639125,33.591063,120.927825,57.219281,3,0
0,0,15,15,12,24,36,87,47,134,0.000333,0.230923,6,4156.619701,230.923317,692.76995,153.05865,5,0
0,0,3,3,10,11,21,22,15,37,0.000333,0.054172,5,812.578723,45.143262,162.515745,71.273029,4,0
0,0,38,38,21,57,78,216,135,351,0.000333,0.735392,20,44123.52358,2451.306865,2206.176179,424.713397,11,0
0,0,3,3,10,8,18,16,13,29,0.000333,0.040309,5,604.639125,33.591063,120.927825,57.219281,3,0
0,0,3,3,10,8,18,16,13,29,0.000333,0.040309,5,604.639125,33.591063,120.927825,57.219281,3,0
0,0,3,3,10,8,18,16,13,29,0.000333,0.040309,5,604.639125,33.591063,120.927825,57.219281,3,0
0,0,40,40,20,79,99,258,162,420,0.000333,0.92811,20,55686.59561,3093.699756,2784.32978,584.437241,11,0
0,0,3,3,10,8,18,16,13,29,0.000333,0.040309,5,604.639125,33.591063,120.927825,57.219281,3,0
0,0,3,3,10,8,18,16,13,29,0.000333,0.040309,5,604.639125,33.591063,120.927825,57.219281,3,0
0,0,6,6,14,12,26,38,24,62,0.000333,0.097142,14,4079.981675,226.665649,291.427263,96.322519,4,0
0,0,4,4,11,10,21,26,17,43,0.000333,0.062957,5,944.348246,52.463791,188.869649,71.273029,2,0
0,0,3,3,10,8,18,16,13,29,0.000333,0.040309,5,604.639125,33.591063,120.927825,57.219281,3,0
0,0,3,3,10,8,18,16,13,29,0.000333,0.040309,5,604.639125,33.591063,120.927825,57.219281,3,0
0,0,7,7,11,19,30,44,28,72,0.000333,0.117765,5,1766.480614,98.137812,353.296123,118.764371,2,0
0,0,4,4,11,10,21,26,17,43,0.000333,0.062957,5,944.348246,52.463791,188.869649,71.273029,2,0
0,0,7,7,16,14,30,45,29,74,0.000333,0.121037,16,5809.758465,322.764359,363.109904,117.302969,4,0
0,0,3,3,9,9,18,18,13,31,0.000333,0.043089,4,517.0707,28.72615,129.267675,57.05865,2,0
0,0,3,3,8,10,18,20,13,33,0.000333,0.045869,4,550.4301,30.57945,137.607525,57.219281,3,0
0,0,3,3,10,6,16,19,10,29,0.000333,0.038667,5,580,32.222222,116,48.729056,1,0
0,0,5,5,14,17,31,60,30,90,0.000333,0.148626,7,3121.143676,173.396871,445.877668,122.789837,4,0
0,0,3,3,10,8,18,16,13,29,0.000333,0.040309,5,604.639125,33.591063,120.927825,57.219281,3,0
0,0,7,7,11,19,30,44,28,72,0.000333,0.117765,5,1766.480614,98.137812,353.296123,118.764371,2,0
0,0,3,3,10,8,18,16,13,29,0.000333,0.040309,5,604.639125,33.591063,120.927825,57.219281,3,0
0,0,3,3,10,8,18,16,13,29,0.000333,0.040309,5,604.639125,33.591063,120.927825,57.219281,3,0
0,0,26,26,13,29,42,141,100,241,0.000333,0.433183,18,23391.87298,1299.548499,1299.548499,188.987165,1,0
0,0,25,25,13,29,42,136,96,232,0.000333,0.417006,18,22518.31756,1251.017642,1251.017642,188.987165,1,0
0,0,8,8,16,19,35,72,39,111,0.000333,0.189783,16,9109.606638,506.089258,569.350415,144.710623,10,0
0,0,11,11,15,21,36,63,47,110,0.000333,0.189564,14,7961.684502,442.315806,568.69175,150.842025,4,0
0,0,26,26,17,34,51,136,75,211,0.000333,0.398961,16,19150.10795,1063.894886,1196.881747,242.460605,10,0
0,0,6,6,8,10,18,26,18,44,0.000333,0.061159,4,733.9068,40.7726,183.4767,57.219281,1,0
0,0,3,3,11,11,22,26,15,41,0.000333,0.060946,5,914.183482,50.787971,182.836696,76.107496,3,0
0,0,4,4,4,7,11,13,11,24,0.000333,0.027675,2,166.052718,9.225151,83.026359,27.651484,3,0
0,0,4,4,4,7,11,13,11,24,0.000333,0.027675,2,166.052718,9.225151,83.026359,27.651484,3,0
0,0,10,10,17,15,32,59,38,97,0.000333,0.161667,16,7760,431.111111,485,128.090227,6,0
0,0,4,4,11,9,20,23,14,37,0.000333,0.053304,5,799.556698,44.419817,159.91134,66.583073,2,0
0,0,7,7,11,19,30,44,28,72,0.000333,0.117765,5,1766.480614,98.137812,353.296123,118.764371,2,0
0,0,7,7,11,19,30,44,28,72,0.000333,0.117765,5,1766.480614,98.137812,353.296123,118.764371,2,0
0,0,6,6,7,10,17,25,16,41,0.000333,0.055862,3,502.757929,27.930996,167.585976,52.870765,1,0
0,0,9,9,14,20,34,44,36,80,0.000333,0.135666,7,2848.979191,158.276622,406.997027,139.741531,4,0
0,0,3,3,11,11,22,26,15,41,0.000333,0.060946,5,914.183482,50.787971,182.836696,76.107496,3,0
0,0,4,4,12,12,24,42,17,59,0.000333,0.090171,6,1623.076725,90.170929,270.512788,86.0391,5,0
0,0,7,7,11,19,30,44,28,72,0.000333,0.117765,5,1766.480614,98.137812,353.296123,118.764371,2,0
0,0,4,4,4,7,11,13,11,24,0.000333,0.027675,2,166.052718,9.225151,83.026359,27.651484,3,0
0,0,8,8,16,18,34,42,32,74,0.000333,0.125491,8,3011.778002,167.321,376.47225,139.05865,4,0
0,0,17,17,16,23,39,110,55,165,0.000333,0.290697,16,13953.46186,775.192325,872.091366,168.041925,7,0
0,0,7,7,11,19,30,44,28,72,0.000333,0.117765,5,1766.480614,98.137812,353.296123,118.764371,2,0
0,0,17,17,16,23,39,110,55,165,0.000333,0.290697,16,13953.46186,775.192325,872.091366,168.041925,7,0
0,0,7,7,11,19,30,44,28,72,0.000333,0.117765,5,1766.480614,98.137812,353.296123,118.764371,2,0
0,0,3,3,9,7,16,24,10,34,0.000333,0.045333,4,544,30.222222,136,48.180809,3,0
0,0,3,3,10,8,18,16,13,29,0.000333,0.040309,5,604.639125,33.591063,120.927825,57.219281,3,0
0,0,3,3,10,9,19,37,16,53,0.000333,0.075047,5,1125.700791,62.538933,225.140158,61.748606,10,0
0,0,3,3,8,10,18,17,13,30,0.000333,0.041699,4,500.391,27.7995,125.09775,57.219281,2,0
0,0,14,14,11,35,46,79,67,146,0.000333,0.268813,5,4032.200228,224.011124,806.440046,217.578653,6,0
0,0,4,4,4,7,11,13,11,24,0.000333,0.027675,2,166.052718,9.225151,83.026359,27.651484,3,0
0,0,3,3,9,9,18,18,13,31,0.000333,0.043089,4,517.0707,28.72615,129.267675,57.05865,2,0
0,0,4,4,11,10,21,26,17,43,0.000333,0.062957,5,944.348246,52.463791,188.869649,71.273029,2,0
0,0,4,4,11,10,21,26,17,43,0.000333,0.062957,5,944.348246,52.463791,188.869649,71.273029,2,0
0,0,3,3,10,8,18,16,13,29,0.000333,0.040309,5,604.639125,33.591063,120.927825,57.219281,3,0
0,0,29,29,16,37,53,254,127,381,0.000333,0.727446,24,52376.10464,2909.783591,2182.337693,256.749775,12,0
0,0,5,5,9,9,18,34,14,48,0.000333,0.066719,4,800.6256,44.4792,200.1564,57.05865,3,0
0,0,8,8,9,17,26,35,26,61,0.000333,0.095576,4,1146.907291,63.717072,286.726823,98.016193,3,0
0,0,5,5,12,16,28,39,25,64,0.000333,0.102557,6,1846.02429,102.556905,307.670715,107.01955,2,0
0,0,8,8,16,13,29,53,32,85,0.000333,0.137643,16,6606.854153,367.047453,412.928385,112.105716,6,0
0,0,7,7,11,19,30,44,28,72,0.000333,0.117765,5,1766.480614,98.137812,353.296123,118.764371,2,0
0,0,3,3,10,8,18,16,13,29,0.000333,0.040309,5,604.639125,33.591063,120.927825,57.219281,3,0
0,0,4,4,11,9,20,24,12,36,0.000333,0.051863,5,777.947057,43.219281,155.589411,66.583073,5,0
0,0,3,3,10,8,18,16,13,29,0.000333,0.040309,5,604.639125,33.591063,120.927825,57.219281,3,0
0,0,3,3,10,8,18,16,13,29,0.000333,0.040309,5,604.639125,33.591063,120.927825,57.219281,3,0
0,0,4,4,4,7,11,13,11,24,0.000333,0.027675,2,166.052718,9.225151,83.026359,27.651484,3,0
0,0,3,3,10,8,18,16,13,29,0.000333,0.040309,5,604.639125,33.591063,120.927825,57.219281,3,0
0,0,7,7,11,18,29,48,28,76,0.000333,0.123069,5,1846.032778,102.557377,369.206556,113.112398,1,0
0,0,17,17,16,23,39,110,55,165,0.000333,0.290697,16,13953.46186,775.192325,872.091366,168.041925,7,0
0,0,5,5,10,10,20,27,14,41,0.000333,0.059066,5,885.995259,49.221959,177.199052,66.438562,3,0
0,0,6,6,13,13,26,38,23,61,0.000333,0.095576,6,1720.360937,95.575608,286.726823,96.211433,4,0
0,0,3,3,11,11,22,26,15,41,0.000333,0.060946,5,914.183482,50.787971,182.836696,76.107496,3,0
0,0,7,7,11,19,30,44,28,72,0.000333,0.117765,5,1766.480614,98.137812,353.296123,118.764371,2,0
0,0,7,7,11,19,30,44,28,72,0.000333,0.117765,5,1766.480614,98.137812,353.296123,118.764371,2,0
0,0,7,7,11,19,30,44,28,72,0.000333,0.117765,5,1766.480614,98.137812,353.296123,118.764371,2,0
0,0,12,12,12,17,29,72,44,116,0.000333,0.187842,12,6762.309545,375.683864,563.525795,112.506418,6,0
0,0,7,7,14,17,31,42,35,77,0.000333,0.127158,14,5340.623623,296.701312,381.473116,122.789837,4,0
0,0,3,3,10,8,18,16,13,29,0.000333,0.040309,5,604.639125,33.591063,120.927825,57.219281,3,0
0,0,4,4,8,11,19,17,15,32,0.000333,0.045311,4,543.734722,30.207485,135.93368,62.053748,3,0
0,0,3,3,11,11,22,26,15,41,0.000333,0.060946,5,914.183482,50.787971,182.836696,76.107496,3,0
0,0,17,17,16,23,39,110,55,165,0.000333,0.290697,16,13953.46186,775.192325,872.091366,168.041925,7,0
0,0,3,3,10,6,16,19,10,29,0.000333,0.038667,5,580,32.222222,116,48.729056,1,0
0,0,4,4,10,12,22,21,17,38,0.000333,0.056486,5,847.292008,47.071778,169.458402,76.238831,1,0
0,0,3,3,10,8,18,16,13,29,0.000333,0.040309,5,604.639125,33.591063,120.927825,57.219281,3,0
0,0,4,4,10,12,22,21,17,38,0.000333,0.056486,5,847.292008,47.071778,169.458402,76.238831,1,0
0,0,3,3,10,8,18,16,13,29,0.000333,0.040309,5,604.639125,33.591063,120.927825,57.219281,3,0
0,0,3,3,10,8,18,16,13,29,0.000333,0.040309,5,604.639125,33.591063,120.927825,57.219281,3,0
0,0,7,7,14,15,29,42,31,73,0.000333,0.118211,14,4964.856577,275.825365,354.632613,111.906328,4,0
0,0,7,7,12,17,29,43,27,70,0.000333,0.113353,6,2040.352018,113.35289,340.05867,112.506418,4,0
0,0,3,3,10,8,18,16,13,29,0.000333,0.040309,5,604.639125,33.591063,120.927825,57.219281,3,0
0,0,6,6,13,13,26,38,23,61,0.000333,0.095576,6,1720.360937,95.575608,286.726823,96.211433,4,0
0,0,3,3,10,8,18,16,13,29,0.000333,0.040309,5,604.639125,33.591063,120.927825,57.219281,3,0
0,0,3,3,11,11,22,26,15,41,0.000333,0.060946,5,914.183482,50.787971,182.836696,76.107496,3,0
0,0,3,3,11,11,22,26,15,41,0.000333,0.060946,5,914.183482,50.787971,182.836696,76.107496,3,0
0,0,26,26,17,36,53,138,74,212,0.000333,0.404773,16,19429.10618,1079.394788,1214.319136,255.604168,10,0
0,0,3,3,10,8,18,16,13,29,0.000333,0.040309,5,604.639125,33.591063,120.927825,57.219281,3,0
0,0,3,3,9,11,20,19,16,35,0.000333,0.050422,4,605.069933,33.614996,151.267483,66.583073,1,0
0,0,8,8,12,14,26,34,21,55,0.000333,0.086175,6,1551.145107,86.174728,258.524184,96.322519,2,0
0,0,3,3,10,8,18,16,13,29,0.000333,0.040309,5,604.639125,33.591063,120.927825,57.219281,3,0
0,0,4,4,4,7,11,13,11,24,0.000333,0.027675,2,166.052718,9.225151,83.026359,27.651484,3,0
0,0,8,8,12,17,29,44,33,77,0.000333,0.124688,6,2244.38722,124.688179,374.064537,112.506418,4,0
0,0,14,14,11,35,46,79,67,146,0.000333,0.268813,5,4032.200228,224.011124,806.440046,217.578653,6,0
0,0,3,3,9,9,18,18,13,31,0.000333,0.043089,4,517.0707,28.72615,129.267675,57.05865,2,0
0,0,3,3,10,11,21,22,15,37,0.000333,0.054172,5,812.578723,45.143262,162.515745,71.273029,4,0
0,0,4,4,4,7,11,13,11,24,0.000333,0.027675,2,166.052718,9.225151,83.026359,27.651484,3,0
0,0,7,7,11,19,30,44,28,72,0.000333,0.117765,5,1766.480614,98.137812,353.296123,118.764371,2,0
0,0,4,4,11,8,19,22,13,35,0.000333,0.049559,5,743.387315,41.299295,148.677463,62.053748,2,0
0,0,6,6,9,18,27,24,23,47,0.000333,0.074493,4,893.91885,49.662158,223.479713,103.587975,3,0
0,0,59,59,28,89,117,602,423,1025,0.000333,2.347375,56,394358.9349,21908.82972,7042.123838,710.946213,37,0
0,0,4,4,8,11,19,17,15,32,0.000333,0.045311,4,543.734722,30.207485,135.93368,62.053748,3,0
0,0,4,4,4,7,11,13,11,24,0.000333,0.027675,2,166.052718,9.225151,83.026359,27.651484,3,0
0,0,12,12,16,23,39,72,54,126,0.000333,0.221987,16,10655.37087,591.965049,665.96068,168.041925,4,0
0,0,4,4,11,10,21,26,17,43,0.000333,0.062957,5,944.348246,52.463791,188.869649,71.273029,2,0
0,0,9,9,10,19,29,39,30,69,0.000333,0.111734,5,1676.003443,93.111302,335.200689,113.929904,3,0
0,0,4,4,4,7,11,13,11,24,0.000333,0.027675,2,166.052718,9.225151,83.026359,27.651484,3,0
0,0,4,4,4,7,11,13,11,24,0.000333,0.027675,2,166.052718,9.225151,83.026359,27.651484,3,0
0,0,3,3,10,8,18,16,13,29,0.000333,0.040309,5,604.639125,33.591063,120.927825,57.219281,3,0
0,0,4,4,10,9,19,46,19,65,0.000333,0.092038,10,2761.152884,153.397382,276.115288,61.748606,11,0
0,0,3,3,10,9,19,37,16,53,0.000333,0.075047,5,1125.700791,62.538933,225.140158,61.748606,10,0
0,0,14,14,11,35,46,79,67,146,0.000333,0.268813,5,4032.200228,224.011124,806.440046,217.578653,6,0
0,0,4,4,4,7,11,13,11,24,0.000333,0.027675,2,166.052718,9.225151,83.026359,27.651484,3,0
0,0,30,30,19,65,84,226,138,364,0.000333,0.775601,18,41882.46375,2326.803542,2326.803542,472.164531,7,0
0,0,5,5,12,16,28,39,25,64,0.000333,0.102557,6,1846.02429,102.556905,307.670715,107.01955,3,0
0,0,24,24,12,28,40,155,91,246,0.000333,0.436398,18,23565.4976,1309.194311,1309.194311,177.625488,3,0
0,0,3,3,5,6,11,9,8,17,0.000333,0.019603,2,117.620675,6.534482,58.810338,27.119415,1,0
0,0,7,7,17,21,38,52,37,89,0.000333,0.155689,8,3736.52439,207.584688,467.065549,161.725534,5,0
0,0,3,3,10,6,16,19,10,29,0.000333,0.038667,5,580,32.222222,116,48.729056,1,0
0,0,5,5,11,13,24,27,22,49,0.000333,0.074888,5,1123.315813,62.406434,224.663163,86.159464,2,0
0,0,23,23,13,34,47,157,98,255,0.000333,0.47214,12,16997.04189,944.280105,1416.420157,221.079453,1,0
0,0,5,5,10,10,20,27,14,41,0.000333,0.059066,5,885.995259,49.221959,177.199052,66.438562,3,0
0,0,7,7,11,18,29,48,28,76,0.000333,0.123069,5,1846.032778,102.557377,369.206556,113.112398,1,0
0,0,6,6,9,18,27,24,23,47,0.000333,0.074493,4,893.91885,49.662158,223.479713,103.587975,3,0
0,0,3,3,11,11,22,26,15,41,0.000333,0.060946,5,914.183482,50.787971,182.836696,76.107496,3,0
0,0,4,4,6,8,14,17,12,29,0.000333,0.036804,3,331.239878,18.402215,110.413293,39.509775,3,0
0,0,3,3,10,8,18,16,13,29,0.000333,0.040309,5,604.639125,33.591063,120.927825,57.219281,3,0
0,0,3,3,10,8,18,16,13,29,0.000333,0.040309,5,604.639125,33.591063,120.927825,57.219281,3,0
0,0,3,3,10,8,18,16,13,29,0.000333,0.040309,5,604.639125,33.591063,120.927825,57.219281,3,0
0,0,7,7,11,19,30,44,28,72,0.000333,0.117765,5,1766.480614,98.137812,353.296123,118.764371,2,0
0,0,4,4,10,11,21,22,16,38,0.000333,0.055636,5,834.54031,46.363351,166.908062,71.273029,2,0
0,0,7,7,11,19,30,44,28,72,0.000333,0.117765,5,1766.480614,98.137812,353.296123,118.764371,2,0
0,0,6,6,13,13,26,38,23,61,0.000333,0.095576,6,1720.360937,95.575608,286.726823,96.211433,4,0
0,0,3,3,10,8,18,16,13,29,0.000333,0.040309,5,604.639125,33.591063,120.927825,57.219281,3,0
0,0,7,7,11,19,30,44,28,72,0.000333,0.117765,5,1766.480614,98.137812,353.296123,118.764371,2,0
0,0,4,4,6,8,14,17,12,29,0.000333,0.036804,3,331.239878,18.402215,110.413293,39.509775,3,0
0,0,15,15,11,37,48,83,71,154,0.000333,0.286695,5,4300.421126,238.912285,860.084225,230.803522,6,0
0,0,7,7,11,18,29,48,28,76,0.000333,0.123069,5,1846.032778,102.557377,369.206556,113.112398,1,0
0,0,17,17,16,23,39,110,55,165,0.000333,0.290697,16,13953.46186,775.192325,872.091366,168.041925,7,0
0,0,5,5,11,14,25,27,24,51,0.000333,0.078946,5,1184.183328,65.787963,236.836666,91.356717,2,0
0,0,10,10,13,19,32,44,28,72,0.000333,0.12,6,2160,120,360,128.816339,5,0
0,0,4,4,7,9,16,16,12,28,0.000333,0.037333,3,336,18.666667,112,48.180809,3,0
0,0,14,14,13,23,36,86,44,130,0.000333,0.22403,6,4032.541501,224.030083,672.09025,152.147641,5,0
0,0,3,3,8,10,18,20,13,33,0.000333,0.045869,4,550.4301,30.57945,137.607525,57.219281,3,0
0,0,7,7,11,19,30,44,28,72,0.000333,0.117765,5,1766.480614,98.137812,353.296123,118.764371,2,0
0,0,12,12,15,21,36,64,46,110,0.000333,0.189564,14,7961.684502,442.315806,568.69175,150.842025,4,0
0,0,7,7,11,19,30,44,28,72,0.000333,0.117765,5,1766.480614,98.137812,353.296123,118.764371,2,0
0,0,3,3,9,9,18,18,13,31,0.000333,0.043089,4,517.0707,28.72615,129.267675,57.05865,2,0
0,0,7,7,11,19,30,44,28,72,0.000333,0.117765,5,1766.480614,98.137812,353.296123,118.764371,2,0
0,0,6,6,15,15,30,35,24,59,0.000333,0.096502,7,2026.545816,112.585879,289.506545,117.206718,4,0
0,0,3,3,11,11,22,26,15,41,0.000333,0.060946,5,914.183482,50.787971,182.836696,76.107496,3,0
0,0,12,12,16,21,37,62,45,107,0.000333,0.185804,16,8918.584162,495.476898,557.41151,156.238666,4,0
0,0,3,3,10,8,18,16,13,29,0.000333,0.040309,5,604.639125,33.591063,120.927825,57.219281,3,0
0,0,15,15,12,22,34,99,56,155,0.000333,0.262852,12,9462.680885,525.704494,788.55674,141.127046,2,0
0,0,4,4,10,12,22,21,17,38,0.000333,0.056486,5,847.292008,47.071778,169.458402,76.238831,1,0
0,0,7,7,11,19,30,44,28,72,0.000333,0.117765,5,1766.480614,98.137812,353.296123,118.764371,2,0
0,0,3,3,10,10,20,17,13,30,0.000333,0.043219,5,648.289214,36.016067,129.657843,66.438562,2,0
0,0,3,3,10,8,18,16,13,29,0.000333,0.040309,5,604.639125,33.591063,120.927825,57.219281,3,0
0,0,3,3,10,11,21,22,15,37,0.000333,0.054172,5,812.578723,45.143262,162.515745,71.273029,4,0
0,0,3,3,9,9,18,18,13,31,0.000333,0.043089,4,517.0707,28.72615,129.267675,57.05865,2,0
0,0,7,7,11,19,30,44,28,72,0.000333,0.117765,5,1766.480614,98.137812,353.296123,118.764371,2,0
0,0,3,3,10,8,18,16,13,29,0.000333,0.040309,5,604.639125,33.591063,120.927825,57.219281,3,0
0,0,3,3,8,10,18,20,13,33,0.000333,0.045869,4,550.4301,30.57945,137.607525,57.219281,3,0
0,0,5,5,10,8,18,24,12,36,0.000333,0.050039,5,750.5865,41.69925,150.1173,57.219281,4,0
0,0,3,3,9,9,18,18,13,31,0.000333,0.043089,4,517.0707,28.72615,129.267675,57.05865,2,0
0,0,3,3,10,8,18,16,13,29,0.000333,0.040309,5,604.639125,33.591063,120.927825,57.219281,3,0
0,0,3,3,10,10,20,17,13,30,0.000333,0.043219,5,648.289214,36.016067,129.657843,66.438562,2,0
0,0,4,4,11,9,20,24,12,36,0.000333,0.051863,5,777.947057,43.219281,155.589411,66.583073,5,0
0,0,26,26,17,35,52,139,73,212,0.000333,0.402831,16,19335.89152,1074.216196,1208.49322,249.011774,10,0
0,0,5,5,12,16,28,39,25,64,0.000333,0.102557,6,1846.02429,102.556905,307.670715,107.01955,2,0
0,0,6,6,13,13,26,37,25,62,0.000333,0.097142,6,1748.563575,97.142421,291.427263,96.211433,4,0
0,0,7,7,11,19,30,44,28,72,0.000333,0.117765,5,1766.480614,98.137812,353.296123,118.764371,2,0
0,0,3,3,10,8,18,16,13,29,0.000333,0.040309,5,604.639125,33.591063,120.927825,57.219281,3,0
0,0,3,3,11,11,22,26,15,41,0.000333,0.060946,5,914.183482,50.787971,182.836696,76.107496,3,0
0,0,4,4,14,9,23,32,12,44,0.000333,0.066346,7,1393.257082,77.403171,199.036726,81.832294,3,0
0,0,3,3,9,9,18,18,13,31,0.000333,0.043089,4,517.0707,28.72615,129.267675,57.05865,2,0
0,0,4,4,4,7,11,13,11,24,0.000333,0.027675,2,166.052718,9.225151,83.026359,27.651484,3,0
0,0,3,3,8,9,17,17,12,29,0.000333,0.039512,4,474.14569,26.341427,118.536422,52.529325,2,0
0,0,6,6,7,11,18,41,25,66,0.000333,0.091738,6,1651.290301,91.73835,275.21505,57.705232,1,0
0,0,11,11,15,21,36,84,43,127,0.000333,0.21886,14,9192.126653,510.673703,656.580475,150.842025,2,0
0,0,3,3,9,9,18,18,13,31,0.000333,0.043089,4,517.0707,28.72615,129.267675,57.05865,2,0
0,0,8,8,16,13,29,53,32,85,0.000333,0.137643,16,6606.854153,367.047453,412.928385,112.105716,6,0
0,0,4,4,8,10,18,28,18,46,0.000333,0.063939,4,767.2662,42.6259,191.81655,57.219281,4,0
0,0,4,4,4,7,11,13,11,24,0.000333,0.027675,2,166.052718,9.225151,83.026359,27.651484,3,0
0,0,3,3,10,8,18,16,13,29,0.000333,0.040309,5,604.639125,33.591063,120.927825,57.219281,3,0
0,0,7,7,11,19,30,44,28,72,0.000333,0.117765,5,1766.480614,98.137812,353.296123,118.764371,2,0
0,0,3,3,8,10,18,17,13,30,0.000333,0.041699,4,500.391,27.7995,125.09775,57.219281,2,0
0,0,12,12,13,25,38,65,51,116,0.000333,0.20292,12,7305.115099,405.839728,608.759592,164.202121,4,0
0,0,7,7,11,19,30,44,28,72,0.000333,0.117765,5,1766.480614,98.137812,353.296123,118.764371,2,0
0,0,7,7,11,19,30,44,28,72,0.000333,0.117765,5,1766.480614,98.137812,353.296123,118.764371,2,0
0,0,3,3,10,8,18,16,13,29,0.000333,0.040309,5,604.639125,33.591063,120.927825,57.219281,3,0
0,0,4,4,4,7,11,13,11,24,0.000333,0.027675,2,166.052718,9.225151,83.026359,27.651484,3,0
0,0,4,4,8,11,19,17,15,32,0.000333,0.045311,4,543.734722,30.207485,135.93368,62.053748,3,0
0,0,5,5,8,12,20,20,16,36,0.000333,0.051863,4,622.357646,34.575425,155.589411,67.01955,3,0
0,0,4,4,6,8,14,17,12,29,0.000333,0.036804,3,331.239878,18.402215,110.413293,39.509775,3,0
0,0,7,7,11,19,30,44,28,72,0.000333,0.117765,5,1766.480614,98.137812,353.296123,118.764371,2,0
0,0,4,4,4,7,11,13,11,24,0.000333,0.027675,2,166.052718,9.225151,83.026359,27.651484,3,0
0,0,3,3,8,10,18,20,13,33,0.000333,0.045869,4,550.4301,30.57945,137.607525,57.219281,3,0
0,0,26,26,17,35,52,137,73,210,0.000333,0.399031,16,19153.47745,1064.082081,1197.092341,249.011774,10,0
0,0,3,3,9,9,18,18,13,31,0.000333,0.043089,4,517.0707,28.72615,129.267675,57.05865,2,0
0,0,3,3,10,8,18,16,13,29,0.000333,0.040309,5,604.639125,33.591063,120.927825,57.219281,3,0
0,0,3,3,10,8,18,16,13,29,0.000333,0.040309,5,604.639125,33.591063,120.927825,57.219281,3,0
0,0,7,7,11,19,30,44,28,72,0.000333,0.117765,5,1766.480614,98.137812,353.296123,118.764371,2,0
0,0,4,4,10,12,22,24,18,42,0.000333,0.062432,5,936.48064,52.026702,187.296128,76.238831,2,0
0,0,3,3,10,9,19,20,12,32,0.000333,0.045311,5,679.668402,37.759356,135.93368,61.748606,6,0
0,0,3,3,10,8,18,16,13,29,0.000333,0.040309,5,604.639125,33.591063,120.927825,57.219281,3,0
0,0,3,3,9,9,18,18,13,31,0.000333,0.043089,4,517.0707,28.72615,129.267675,57.05865,2,0
0,0,11,11,15,21,36,84,43,127,0.000333,0.21886,14,9192.126653,510.673703,656.580475,150.842025,2,0
0,0,4,4,4,7,11,13,11,24,0.000333,0.027675,2,166.052718,9.225151,83.026359,27.651484,3,0
0,0,4,4,8,11,19,17,15,32,0.000333,0.045311,4,543.734722,30.207485,135.93368,62.053748,3,0
0,0,5,5,9,15,24,22,19,41,0.000333,0.062661,4,751.93385,41.774103,187.983463,87.132684,3,0
0,0,4,4,11,10,21,26,17,43,0.000333,0.062957,5,944.348246,52.463791,188.869649,71.273029,2,0
0,0,3,3,10,10,20,17,13,30,0.000333,0.043219,5,648.289214,36.016067,129.657843,66.438562,2,0
0,0,3,3,10,8,18,16,13,29,0.000333,0.040309,5,604.639125,33.591063,120.927825,57.219281,3,0
0,0,3,3,10,8,18,16,13,29,0.000333,0.040309,5,604.639125,33.591063,120.927825,57.219281,3,0
0,0,3,3,10,8,18,20,12,32,0.000333,0.044479,5,667.188,37.066,133.4376,57.219281,2,0
0,0,8,8,14,17,31,48,34,82,0.000333,0.135415,14,5687.417364,315.967631,406.244097,122.789837,4,0
0,0,4,4,4,7,11,13,11,24,0.000333,0.027675,2,166.052718,9.225151,83.026359,27.651484,3,0
0,0,4,4,7,9,16,16,12,28,0.000333,0.037333,3,336,18.666667,112,48.180809,3,0
0,0,3,3,10,8,18,16,13,29,0.000333,0.040309,5,604.639125,33.591063,120.927825,57.219281,3,0
0,0,3,3,10,8,18,16,13,29,0.000333,0.040309,5,604.639125,33.591063,120.927825,57.219281,3,0
0,0,6,6,12,11,23,28,16,44,0.000333,0.066346,6,1194.220356,66.345575,199.036726,81.073298,2,0
0,0,6,6,10,14,24,28,21,49,0.000333,0.074888,5,1123.315813,62.406434,224.663163,86.52225,1,0
0,0,14,14,11,35,46,79,67,146,0.000333,0.268813,5,4032.200228,224.011124,806.440046,217.578653,6,0
0,0,4,4,4,7,11,13,11,24,0.000333,0.027675,2,166.052718,9.225151,83.026359,27.651484,3,0
0,0,4,4,4,7,11,13,11,24,0.000333,0.027675,2,166.052718,9.225151,83.026359,27.651484,3,0
0,0,14,14,11,35,46,79,67,146,0.000333,0.268813,5,4032.200228,224.011124,806.440046,217.578653,6,0
0,0,4,4,9,12,21,23,17,40,0.000333,0.058564,4,702.770788,39.042822,175.692697,71.548875,3,0
0,0,9,9,12,12,24,52,31,83,0.000333,0.126851,12,4566.622651,253.701258,380.551888,86.0391,4,0
0,0,8,8,12,13,25,41,24,65,0.000333,0.100617,6,1811.103914,100.616884,301.850652,91.125266,4,0
0,0,8,8,12,12,24,42,26,68,0.000333,0.103926,12,3741.329401,207.851633,311.77745,86.0391,4,0
0,0,23,23,20,29,49,181,80,261,0.000333,0.48848,20,29308.78539,1628.265855,1465.439269,227.320011,12,0
0,0,28,28,17,39,56,145,80,225,0.000333,0.435552,16,20906.47772,1161.470984,1306.654857,275.617555,10,0
0,0,4,4,11,9,20,24,12,36,0.000333,0.051863,5,777.947057,43.219281,155.589411,66.583073,5,0
0,0,3,3,10,6,16,19,10,29,0.000333,0.038667,5,580,32.222222,116,48.729056,1,0
0,0,3,3,8,10,18,20,14,34,0.000333,0.047259,4,567.1098,31.5061,141.77745,57.219281,1,0
0,0,4,4,10,12,22,21,17,38,0.000333,0.056486,5,847.292008,47.071778,169.458402,76.238831,1,0
0,0,4,4,4,7,11,13,11,24,0.000333,0.027675,2,166.052718,9.225151,83.026359,27.651484,3,0
0,0,4,4,4,7,11,13,11,24,0.000333,0.027675,2,166.052718,9.225151,83.026359,27.651484,3,0
0,0,3,3,9,11,20,19,16,35,0.000333,0.050422,4,605.069933,33.614996,151.267483,66.583073,1,0
0,0,4,4,6,8,14,17,12,29,0.000333,0.036804,3,331.239878,18.402215,110.413293,39.509775,3,0
0,0,6,6,13,13,26,38,23,61,0.000333,0.095576,6,1720.360937,95.575608,286.726823,96.211433,4,0
0,0,14,14,11,35,46,79,67,146,0.000333,0.268813,5,4032.200228,224.011124,806.440046,217.578653,6,0
0,0,4,4,6,8,14,17,12,29,0.000333,0.036804,3,331.239878,18.402215,110.413293,39.509775,3,0
0,0,7,7,11,19,30,44,28,72,0.000333,0.117765,5,1766.480614,98.137812,353.296123,118.764371,2,0
0,0,7,7,11,19,30,44,28,72,0.000333,0.117765,5,1766.480614,98.137812,353.296123,118.764371,2,0
0,0,3,3,10,8,18,16,13,29,0.000333,0.040309,5,604.639125,33.591063,120.927825,57.219281,3,0
0,0,3,3,6,7,13,13,9,22,0.000333,0.027137,3,244.229021,13.568279,81.409674,35.161259,1,0
0,0,3,3,10,8,18,16,13,29,0.000333,0.040309,5,604.639125,33.591063,120.927825,57.219281,3,0
0,0,6,6,10,15,25,27,24,51,0.000333,0.078946,5,1184.183328,65.787963,236.836666,91.82264,4,0
0,0,5,5,13,13,26,30,20,50,0.000333,0.078341,6,1410.131915,78.340662,235.021986,96.211433,2,0
0,0,3,3,10,8,18,16,13,29,0.000333,0.040309,5,604.639125,33.591063,120.927825,57.219281,3,0
0,0,3,3,10,8,18,16,13,29,0.000333,0.040309,5,604.639125,33.591063,120.927825,57.219281,3,0
0,0,7,7,11,19,30,44,28,72,0.000333,0.117765,5,1766.480614,98.137812,353.296123,118.764371,2,0
0,0,3,3,10,8,18,16,13,29,0.000333,0.040309,5,604.639125,33.591063,120.927825,57.219281,3,0
0,0,9,9,13,22,35,49,37,86,0.000333,0.147039,6,2646.710037,147.039446,441.118339,146.213212,4,0
0,0,4,4,4,7,11,13,11,24,0.000333,0.027675,2,166.052718,9.225151,83.026359,27.651484,3,0
0,0,3,3,9,9,18,18,13,31,0.000333,0.043089,4,517.0707,28.72615,129.267675,57.05865,2,0
0,0,3,3,8,8,16,16,11,27,0.000333,0.036,4,432,24,108,48,2,0
0,0,7,7,11,19,30,44,28,72,0.000333,0.117765,5,1766.480614,98.137812,353.296123,118.764371,2,0
0,0,13,13,11,17,28,80,38,118,0.000333,0.189089,10,5672.678808,315.148823,567.267881,107.540616,5,0
0,0,6,6,13,13,26,38,23,61,0.000333,0.095576,6,1720.360937,95.575608,286.726823,96.211433,4,0
0,0,4,4,4,7,11,13,11,24,0.000333,0.027675,2,166.052718,9.225151,83.026359,27.651484,3,0
0,0,25,25,12,35,47,382,213,595,0.000333,1.10166,36,118979.2932,6609.960733,3304.980367,222.544456,4,0
0,0,3,3,10,10,20,17,13,30,0.000333,0.043219,5,648.289214,36.016067,129.657843,66.438562,2,0
0,0,3,3,11,11,22,26,15,41,0.000333,0.060946,5,914.183482,50.787971,182.836696,76.107496,3,0
0,0,6,6,15,15,30,35,24,59,0.000333,0.096502,7,2026.545816,112.585879,289.506545,117.206718,4,0
0,0,3,3,10,11,21,22,15,37,0.000333,0.054172,5,812.578723,45.143262,162.515745,71.273029,4,0
0,0,7,7,12,16,28,36,29,65,0.000333,0.104159,6,1874.86842,104.159357,312.47807,107.01955,4,0
0,0,7,7,11,18,29,48,28,76,0.000333,0.123069,5,1846.032778,102.557377,369.206556,113.112398,1,0
0,0,3,3,9,9,18,18,13,31,0.000333,0.043089,4,517.0707,28.72615,129.267675,57.05865,2,0
0,0,9,9,14,18,32,50,27,77,0.000333,0.128333,7,2695,149.722222,385,128.361619,3,0
0,0,5,5,9,13,22,26,19,45,0.000333,0.066891,4,802.697691,44.594316,200.674423,76.635041,2,0
0,0,4,4,10,12,22,21,17,38,0.000333,0.056486,5,847.292008,47.071778,169.458402,76.238831,1,0
0,0,3,3,9,9,18,18,13,31,0.000333,0.043089,4,517.0707,28.72615,129.267675,57.05865,2,0
0,0,4,4,10,12,22,21,17,38,0.000333,0.056486,5,847.292008,47.071778,169.458402,76.238831,1,0
0,0,17,17,16,23,39,110,55,165,0.000333,0.290697,16,13953.46186,775.192325,872.091366,168.041925,7,0
0,0,4,4,4,7,11,13,11,24,0.000333,0.027675,2,166.052718,9.225151,83.026359,27.651484,3,0
0,0,9,9,13,13,26,56,34,90,0.000333,0.141013,12,5076.474896,282.026383,423.039575,96.211433,6,0
0,0,4,4,4,7,11,13,11,24,0.000333,0.027675,2,166.052718,9.225151,83.026359,27.651484,3,0
0,0,3,3,10,8,18,16,13,29,0.000333,0.040309,5,604.639125,33.591063,120.927825,57.219281,3,0
0,0,7,7,11,19,30,44,28,72,0.000333,0.117765,5,1766.480614,98.137812,353.296123,118.764371,2,0
0,0,3,3,10,8,18,16,13,29,0.000333,0.040309,5,604.639125,33.591063,120.927825,57.219281,3,0
0,0,17,17,21,26,47,131,75,206,0.000333,0.381415,20,22884.90607,1271.38367,1144.245303,214.450099,9,0
0,0,10,10,13,19,32,46,34,80,0.000333,0.133333,6,2400,133.333333,400,128.816339,1,0
0,0,4,4,11,9,20,24,12,36,0.000333,0.051863,5,777.947057,43.219281,155.589411,66.583073,5,0
0,0,8,8,16,19,35,72,39,111,0.000333,0.189783,16,9109.606638,506.089258,569.350415,144.710623,10,0
0,0,10,10,12,24,36,48,40,88,0.000333,0.151651,6,2729.720401,151.651133,454.9534,153.05865,4,0
0,0,3,3,7,8,15,23,12,35,0.000333,0.04558,3,410.223513,22.790195,136.741171,43.651484,1,0
0,0,3,3,10,8,18,16,13,29,0.000333,0.040309,5,604.639125,33.591063,120.927825,57.219281,3,0
0,0,3,3,11,11,22,26,15,41,0.000333,0.060946,5,914.183482,50.787971,182.836696,76.107496,3,0
0,0,4,4,10,9,19,23,14,37,0.000333,0.052391,5,785.86659,43.659255,157.173318,61.748606,2,0
0,0,4,4,10,12,22,21,17,38,0.000333,0.056486,5,847.292008,47.071778,169.458402,76.238831,1,0
0,0,3,3,10,8,18,16,13,29,0.000333,0.040309,5,604.639125,33.591063,120.927825,57.219281,3,0
0,0,7,7,9,21,30,28,27,55,0.000333,0.08996,4,1079.515931,59.973107,269.878983,120.767991,3,0
0,0,4,4,4,7,11,13,11,24,0.000333,0.027675,2,166.052718,9.225151,83.026359,27.651484,3,0
0,0,22,22,17,34,51,128,68,196,0.000333,0.370598,16,17788.72587,988.262548,1111.795367,242.460605,8,0
0,0,14,14,13,23,36,86,44,130,0.000333,0.22403,6,4032.541501,224.030083,672.09025,152.147641,5,0
0,0,7,7,11,18,29,48,28,76,0.000333,0.123069,5,1846.032778,102.557377,369.206556,113.112398,1,0
0,0,7,7,11,18,29,48,28,76,0.000333,0.123069,5,1846.032778,102.557377,369.206556,113.112398,1,0
0,0,5,5,10,10,20,27,14,41,0.000333,0.059066,5,885.995259,49.221959,177.199052,66.438562,3,0
0,0,4,4,4,7,11,13,11,24,0.000333,0.027675,2,166.052718,9.225151,83.026359,27.651484,3,0
0,0,27,27,17,36,53,141,77,218,0.000333,0.416229,16,19978.98655,1109.943697,1248.686659,255.604168,11,0
0,0,20,20,14,27,41,120,68,188,0.000333,0.33574,14,14101.07688,783.39316,1007.219777,181.684931,5,0
0,0,8,8,9,17,26,35,26,61,0.000333,0.095576,4,1146.907291,63.717072,286.726823,98.016193,3,0
0,0,3,3,10,8,18,16,13,29,0.000333,0.040309,5,604.639125,33.591063,120.927825,57.219281,3,0
0,0,4,4,4,7,11,13,11,24,0.000333,0.027675,2,166.052718,9.225151,83.026359,27.651484,3,0
0,0,6,6,9,18,27,24,23,47,0.000333,0.074493,4,893.91885,49.662158,223.479713,103.587975,3,0
0,0,10,10,13,17,30,113,31,144,0.000333,0.235531,6,4239.553475,235.530749,706.592246,117.592585,7,0
0,0,3,3,10,8,18,16,13,29,0.000333,0.040309,5,604.639125,33.591063,120.927825,57.219281,3,0
0,0,11,11,13,26,39,54,48,102,0.000333,0.179704,6,3234.666158,179.703675,539.111026,170.317149,4,0
0,0,5,5,10,15,25,27,23,50,0.000333,0.077398,5,1160.964047,64.498003,232.192809,91.82264,4,0
0,0,3,3,9,9,18,18,13,31,0.000333,0.043089,4,517.0707,28.72615,129.267675,57.05865,2,0
0,0,3,3,9,9,18,18,13,31,0.000333,0.043089,4,517.0707,28.72615,129.267675,57.05865,2,0
0,0,8,8,15,18,33,45,33,78,0.000333,0.131154,7,2754.239189,153.013288,393.462741,133.662009,4,0
0,0,7,7,11,19,30,44,28,72,0.000333,0.117765,5,1766.480614,98.137812,353.296123,118.764371,2,0
0,0,19,19,21,26,47,149,82,231,0.000333,0.427703,30,38493.30074,2138.516708,1283.110025,214.450099,11,0
0,0,4,4,7,9,16,16,12,28,0.000333,0.037333,3,336,18.666667,112,48.180809,3,0
0,0,4,4,4,7,11,13,11,24,0.000333,0.027675,2,166.052718,9.225151,83.026359,27.651484,3,0
0,0,8,8,17,13,30,41,27,68,0.000333,0.111223,16,5338.696968,296.594276,333.668561,117.592585,4,0
0,0,3,3,9,9,18,18,13,31,0.000333,0.043089,4,517.0707,28.72615,129.267675,57.05865,2,0
0,0,6,6,13,13,26,38,23,61,0.000333,0.095576,6,1720.360937,95.575608,286.726823,96.211433,4,0
0,0,16,16,13,25,38,93,49,142,0.000333,0.248402,6,4471.234241,248.401902,745.205707,164.202121,5,0
0,0,7,7,11,19,30,44,28,72,0.000333,0.117765,5,1766.480614,98.137812,353.296123,118.764371,2,0
0,0,3,3,10,8,18,16,13,29,0.000333,0.040309,5,604.639125,33.591063,120.927825,57.219281,3,0
0,0,4,4,11,10,21,26,17,43,0.000333,0.062957,5,944.348246,52.463791,188.869649,71.273029,2,0
0,0,4,4,10,9,19,46,19,65,0.000333,0.092038,10,2761.152884,153.397382,276.115288,61.748606,11,0
0,0,8,8,16,13,29,53,32,85,0.000333,0.137643,16,6606.854153,367.047453,412.928385,112.105716,6,0
0,0,5,5,9,6,15,17,9,26,0.000333,0.03386,4,406.316622,22.573146,101.579155,44.0391,2,0
0,0,14,14,11,35,46,79,67,146,0.000333,0.268813,5,4032.200228,224.011124,806.440046,217.578653,6,0
0,0,4,4,6,8,14,17,12,29,0.000333,0.036804,3,331.239878,18.402215,110.413293,39.509775,3,0
0,0,19,19,21,26,47,149,82,231,0.000333,0.427703,30,38493.30074,2138.516708,1283.110025,214.450099,11,0
0,0,3,3,10,10,20,17,13,30,0.000333,0.043219,5,648.289214,36.016067,129.657843,66.438562,2,0
0,0,16,16,15,26,41,98,56,154,0.000333,0.275021,14,11550.88212,641.715673,825.063009,180.814792,5,0
0,0,3,3,10,8,18,16,13,29,0.000333,0.040309,5,604.639125,33.591063,120.927825,57.219281,3,0
0,0,7,7,11,19,30,44,28,72,0.000333,0.117765,5,1766.480614,98.137812,353.296123,118.764371,2,0
0,0,3,3,10,8,18,16,13,29,0.000333,0.040309,5,604.639125,33.591063,120.927825,57.219281,3,0
0,0,4,4,11,10,21,26,17,43,0.000333,0.062957,5,944.348246,52.463791,188.869649,71.273029,2,0
0,0,8,8,16,13,29,53,32,85,0.000333,0.137643,16,6606.854153,367.047453,412.928385,112.105716,6,0
0,0,3,3,10,10,20,17,13,30,0.000333,0.043219,5,648.289214,36.016067,129.657843,66.438562,2,0
0,0,4,4,11,10,21,26,17,43,0.000333,0.062957,5,944.348246,52.463791,188.869649,71.273029,2,0
0,0,4,4,10,12,22,21,17,38,0.000333,0.056486,5,847.292008,47.071778,169.458402,76.238831,1,0
0,0,3,3,10,8,18,16,13,29,0.000333,0.040309,5,604.639125,33.591063,120.927825,57.219281,3,0
0,0,3,3,10,8,18,16,13,29,0.000333,0.040309,5,604.639125,33.591063,120.927825,57.219281,3,0
0,0,22,22,21,26,47,138,71,209,0.000333,0.38697,20,23218.1814,1289.898967,1160.90907,214.450099,19,0
0,0,5,5,12,16,28,39,25,64,0.000333,0.102557,6,1846.02429,102.556905,307.670715,107.01955,2,0
0,0,8,8,17,13,30,41,27,68,0.000333,0.111223,16,5338.696968,296.594276,333.668561,117.592585,4,0
0,0,4,4,6,8,14,17,12,29,0.000333,0.036804,3,331.239878,18.402215,110.413293,39.509775,3,0
0,0,38,38,20,52,72,331,151,482,0.000333,0.991301,20,59478.07701,3304.337612,2973.903851,382.861427,20,0
0,0,3,3,10,8,18,16,13,29,0.000333,0.040309,5,604.639125,33.591063,120.927825,57.219281,3,0
0,0,7,7,11,19,30,44,28,72,0.000333,0.117765,5,1766.480614,98.137812,353.296123,118.764371,2,0
0,0,3,3,10,10,20,17,13,30,0.000333,0.043219,5,648.289214,36.016067,129.657843,66.438562,2,0
0,0,4,4,10,12,22,21,17,38,0.000333,0.056486,5,847.292008,47.071778,169.458402,76.238831,1,0
0,0,3,3,10,8,18,16,13,29,0.000333,0.040309,5,604.639125,33.591063,120.927825,57.219281,3,0
0,0,4,4,11,10,21,26,17,43,0.000333,0.062957,5,944.348246,52.463791,188.869649,71.273029,2,0
0,0,14,14,17,20,37,79,55,134,0.000333,0.232689,16,11169.06802,620.503779,698.066751,155.92543,6,0
0,0,3,3,10,8,18,16,13,29,0.000333,0.040309,5,604.639125,33.591063,120.927825,57.219281,3,0
0,0,6,6,13,13,26,38,23,61,0.000333,0.095576,6,1720.360937,95.575608,286.726823,96.211433,4,0
0,0,3,3,10,10,20,17,13,30,0.000333,0.043219,5,648.289214,36.016067,129.657843,66.438562,2,0
0,0,4,4,10,12,22,21,17,38,0.000333,0.056486,5,847.292008,47.071778,169.458402,76.238831,1,0
0,0,27,27,11,31,42,199,114,313,0.000333,0.562598,15,25316.9303,1406.496128,1687.795353,191.633833,1,0
0,0,4,4,8,11,19,17,15,32,0.000333,0.045311,4,543.734722,30.207485,135.93368,62.053748,3,0
0,0,4,4,8,11,19,17,15,32,0.000333,0.045311,4,543.734722,30.207485,135.93368,62.053748,3,0
0,0,4,4,4,7,11,13,11,24,0.000333,0.027675,2,166.052718,9.225151,83.026359,27.651484,3,0
0,0,4,4,4,7,11,13,11,24,0.000333,0.027675,2,166.052718,9.225151,83.026359,27.651484,3,0
0,0,4,4,4,7,11,13,11,24,0.000333,0.027675,2,166.052718,9.225151,83.026359,27.651484,3,0
0,0,6,6,9,18,27,24,23,47,0.000333,0.074493,4,893.91885,49.662158,223.479713,103.587975,3,0
0,0,4,4,4,7,11,13,11,24,0.000333,0.027675,2,166.052718,9.225151,83.026359,27.651484,3,0
0,0,3,3,9,9,18,18,13,31,0.000333,0.043089,4,517.0707,28.72615,129.267675,57.05865,2,0
0,0,7,7,11,19,30,44,28,72,0.000333,0.117765,5,1766.480614,98.137812,353.296123,118.764371,2,0
0,0,3,3,10,8,18,16,13,29,0.000333,0.040309,5,604.639125,33.591063,120.927825,57.219281,3,0
0,0,6,6,13,13,26,38,23,61,0.000333,0.095576,6,1720.360937,95.575608,286.726823,96.211433,4,0
0,0,3,3,10,8,18,16,13,29,0.000333,0.040309,5,604.639125,33.591063,120.927825,57.219281,3,0
0,0,10,10,15,22,37,50,44,94,0.000333,0.16323,14,6855.640629,380.868924,489.688616,156.710855,4,0
0,0,12,12,16,21,37,62,45,107,0.000333,0.185804,16,8918.584162,495.476898,557.41151,156.238666,4,0
0,0,3,3,10,8,18,16,13,29,0.000333,0.040309,5,604.639125,33.591063,120.927825,57.219281,3,0
0,0,8,8,16,13,29,53,32,85,0.000333,0.137643,16,6606.854153,367.047453,412.928385,112.105716,6,0
0,0,4,4,4,7,11,13,11,24,0.000333,0.027675,2,166.052718,9.225151,83.026359,27.651484,3,0
0,0,6,6,9,18,27,24,23,47,0.000333,0.074493,4,893.91885,49.662158,223.479713,103.587975,3,0
0,0,7,7,11,19,30,44,28,72,0.000333,0.117765,5,1766.480614,98.137812,353.296123,118.764371,2,0
0,0,4,4,11,9,20,24,12,36,0.000333,0.051863,5,777.947057,43.219281,155.589411,66.583073,5,0
0,0,4,4,4,7,11,13,11,24,0.000333,0.027675,2,166.052718,9.225151,83.026359,27.651484,3,0
0,0,8,8,15,18,33,66,34,100,0.000333,0.168146,7,3531.075884,196.170882,504.439412,133.662009,2,0
0,0,11,11,15,21,36,84,43,127,0.000333,0.21886,14,9192.126653,510.673703,656.580475,150.842025,2,0
0,0,23,23,13,34,47,157,98,255,0.000333,0.47214,12,16997.04189,944.280105,1416.420157,221.079453,1,0
0,0,7,7,12,17,29,43,27,70,0.000333,0.113353,6,2040.352018,113.35289,340.05867,112.506418,4,0
0,0,3,3,9,9,18,18,13,31,0.000333,0.043089,4,517.0707,28.72615,129.267675,57.05865,2,0
0,0,3,3,10,6,16,19,10,29,0.000333,0.038667,5,580,32.222222,116,48.729056,1,0
0,0,4,4,8,11,19,17,15,32,0.000333,0.045311,4,543.734722,30.207485,135.93368,62.053748,3,0
0,0,3,3,7,9,16,17,12,29,0.000333,0.038667,3,348,19.333333,116,48.180809,2,0
0,0,4,4,4,7,11,13,11,24,0.000333,0.027675,2,166.052718,9.225151,83.026359,27.651484,3,0
0,0,3,3,10,8,18,16,13,29,0.000333,0.040309,5,604.639125,33.591063,120.927825,57.219281,3,0
0,0,7,7,11,19,30,44,28,72,0.000333,0.117765,5,1766.480614,98.137812,353.296123,118.764371,2,0
0,0,13,13,16,36,52,233,88,321,0.000333,0.609947,16,29277.45839,1626.525466,1829.84115,250.1173,14,0
0,0,4,4,6,8,14,17,12,29,0.000333,0.036804,3,331.239878,18.402215,110.413293,39.509775,3,0
0,0,3,3,10,8,18,16,13,29,0.000333,0.040309,5,604.639125,33.591063,120.927825,57.219281,3,0
0,0,5,5,11,13,24,27,22,49,0.000333,0.074888,5,1123.315813,62.406434,224.663163,86.159464,2,0
0,0,3,3,5,5,10,12,7,19,0.000333,0.021039,2,126.233268,7.012959,63.116634,23.219281,1,0
0,0,3,3,10,8,18,16,13,29,0.000333,0.040309,5,604.639125,33.591063,120.927825,57.219281,3,0
0,0,3,3,10,8,18,16,13,29,0.000333,0.040309,5,604.639125,33.591063,120.927825,57.219281,3,0
0,0,4,4,11,10,21,26,17,43,0.000333,0.062957,5,944.348246,52.463791,188.869649,71.273029,2,0
0,0,14,14,18,22,40,87,63,150,0.000333,0.266096,18,14369.20586,798.289214,798.289214,173.166146,6,0
0,0,3,3,10,8,18,16,13,29,0.000333,0.040309,5,604.639125,33.591063,120.927825,57.219281,3,0
0,0,3,3,10,10,20,17,13,30,0.000333,0.043219,5,648.289214,36.016067,129.657843,66.438562,2,0
0,0,17,17,16,23,39,110,55,165,0.000333,0.290697,16,13953.46186,775.192325,872.091366,168.041925,7,0
0,0,7,7,12,17,29,43,27,70,0.000333,0.113353,6,2040.352018,113.35289,340.05867,112.506418,4,0
0,0,17,17,16,23,39,110,55,165,0.000333,0.290697,16,13953.46186,775.192325,872.091366,168.041925,7,0
0,0,4,4,9,6,15,16,9,25,0.000333,0.032557,4,390.68906,21.704948,97.672265,44.0391,2,0
0,0,4,4,9,7,16,21,10,31,0.000333,0.041333,4,496,27.555556,124,48.180809,2,0
0,0,3,3,9,9,18,18,13,31,0.000333,0.043089,4,517.0707,28.72615,129.267675,57.05865,2,0
0,0,3,3,6,10,16,10,16,26,0.000333,0.034667,3,312,17.333333,104,48.729056,1,0
0,0,5,5,12,16,28,39,25,64,0.000333,0.102557,6,1846.02429,102.556905,307.670715,107.01955,2,0
0,0,7,7,11,19,30,44,28,72,0.000333,0.117765,5,1766.480614,98.137812,353.296123,118.764371,2,0
0,0,27,27,17,36,53,141,77,218,0.000333,0.416229,16,19978.98655,1109.943697,1248.686659,255.604168,10,0
0,0,3,3,8,10,18,20,13,33,0.000333,0.045869,4,550.4301,30.57945,137.607525,57.219281,3,0
0,0,3,3,9,9,18,18,13,31,0.000333,0.043089,4,517.0707,28.72615,129.267675,57.05865,2,0
0,0,3,3,8,10,18,20,13,33,0.000333,0.045869,4,550.4301,30.57945,137.607525,57.219281,3,0
0,0,3,3,9,9,18,18,13,31,0.000333,0.043089,4,517.0707,28.72615,129.267675,57.05865,2,0
0,0,5,5,12,16,28,39,25,64,0.000333,0.102557,6,1846.02429,102.556905,307.670715,107.01955,2,0
0,0,30,30,10,33,43,99,62,161,0.000333,0.29121,5,4368.143128,242.674618,873.628626,199.684287,16,0
0,0,6,6,13,11,24,38,23,61,0.000333,0.093228,12,3356.192551,186.455142,279.682713,86.159464,4,0
0,0,4,4,11,10,21,26,17,43,0.000333,0.062957,5,944.348246,52.463791,188.869649,71.273029,2,0
0,0,3,3,8,8,16,16,11,27,0.000333,0.036,4,432,24,108,48,2,0
0,0,4,4,10,9,19,23,14,37,0.000333,0.052391,5,785.86659,43.659255,157.173318,61.748606,2,0
0,0,3,3,9,9,18,18,13,31,0.000333,0.043089,4,517.0707,28.72615,129.267675,57.05865,2,0
0,0,7,7,11,19,30,44,28,72,0.000333,0.117765,5,1766.480614,98.137812,353.296123,118.764371,2,0
0,0,3,3,10,6,16,19,10,29,0.000333,0.038667,5,580,32.222222,116,48.729056,1,0
0,0,7,7,11,19,30,44,28,72,0.000333,0.117765,5,1766.480614,98.137812,353.296123,118.764371,2,0
0,0,7,7,11,19,30,44,28,72,0.000333,0.117765,5,1766.480614,98.137812,353.296123,118.764371,2,0
0,0,6,6,9,18,27,24,23,47,0.000333,0.074493,4,893.91885,49.662158,223.479713,103.587975,3,0
0,0,4,4,6,8,14,17,12,29,0.000333,0.036804,3,331.239878,18.402215,110.413293,39.509775,3,0
0,0,17,17,16,23,39,110,55,165,0.000333,0.290697,16,13953.46186,775.192325,872.091366,168.041925,7,0
0,0,3,3,11,11,22,26,15,41,0.000333,0.060946,5,914.183482,50.787971,182.836696,76.107496,3,0
0,0,4,4,10,15,25,32,21,53,0.000333,0.082041,5,1230.62189,68.367883,246.124378,91.82264,1,0
0,0,4,4,4,7,11,13,11,24,0.000333,0.027675,2,166.052718,9.225151,83.026359,27.651484,3,0
0,0,12,12,9,15,24,57,37,94,0.000333,0.143662,8,3447.891801,191.549544,430.986475,87.132684,1,0
0,0,27,27,12,32,44,204,111,315,0.000333,0.57324,18,30954.97728,1719.72096,1719.72096,203.01955,1,0
0,0,7,7,13,15,28,34,21,55,0.000333,0.088135,6,1586.427124,88.13484,264.404521,106.709075,2,0
0,0,3,3,10,11,21,22,15,37,0.000333,0.054172,5,812.578723,45.143262,162.515745,71.273029,4,0
0,0,7,7,11,18,29,48,28,76,0.000333,0.123069,5,1846.032778,102.557377,369.206556,113.112398,1,0
0,0,8,8,12,18,30,49,26,75,0.000333,0.122672,6,2208.100768,122.672265,368.016795,118.0782,3,0
0,0,3,3,9,9,18,18,13,31,0.000333,0.043089,4,517.0707,28.72615,129.267675,57.05865,2,0
0,0,5,5,9,15,24,22,19,41,0.000333,0.062661,4,751.93385,41.774103,187.983463,87.132684,3,0
0,0,4,4,9,13,22,21,17,38,0.000333,0.056486,4,677.833606,37.657423,169.458402,76.635041,3,0
0,0,3,3,7,9,16,17,12,29,0.000333,0.038667,3,348,19.333333,116,48.180809,2,0
0,0,3,3,11,10,21,26,13,39,0.000333,0.0571,5,856.501897,47.583439,171.300379,71.273029,3,0
0,0,3,3,11,11,22,26,15,41,0.000333,0.060946,5,914.183482,50.787971,182.836696,76.107496,3,0
0,0,7,7,11,19,30,44,28,72,0.000333,0.117765,5,1766.480614,98.137812,353.296123,118.764371,2,0
0,0,3,3,11,11,22,26,15,41,0.000333,0.060946,5,914.183482,50.787971,182.836696,76.107496,3,0
0,0,3,3,11,11,22,26,15,41,0.000333,0.060946,5,914.183482,50.787971,182.836696,76.107496,3,0
0,0,5,5,9,11,20,26,18,44,0.000333,0.063388,4,760.659345,42.258852,190.164836,66.583073,2,0
0,0,3,3,11,11,22,26,15,41,0.000333,0.060946,5,914.183482,50.787971,182.836696,76.107496,3,0
0,0,3,3,9,9,18,18,13,31,0.000333,0.043089,4,517.0707,28.72615,129.267675,57.05865,2,0
0,0,4,4,11,9,20,24,12,36,0.000333,0.051863,5,777.947057,43.219281,155.589411,66.583073,5,0
0,0,7,7,11,18,29,48,28,76,0.000333,0.123069,5,1846.032778,102.557377,369.206556,113.112398,1,0
0,0,5,5,10,10,20,27,14,41,0.000333,0.059066,5,885.995259,49.221959,177.199052,66.438562,3,0
0,0,3,3,9,9,18,18,13,31,0.000333,0.043089,4,517.0707,28.72615,129.267675,57.05865,2,0
0,0,8,8,14,15,29,44,28,72,0.000333,0.116592,7,2448.422422,136.023468,349.774632,111.906328,4,0
0,0,6,6,12,13,25,32,26,58,0.000333,0.089781,12,3232.123908,179.562439,269.343659,91.125266,2,0
0,0,7,7,11,19,30,44,28,72,0.000333,0.117765,5,1766.480614,98.137812,353.296123,118.764371,2,0
0,0,7,7,11,19,30,44,28,72,0.000333,0.117765,5,1766.480614,98.137812,353.296123,118.764371,2,0
0,0,7,7,11,19,30,44,28,72,0.000333,0.117765,5,1766.480614,98.137812,353.296123,118.764371,2,0
0,0,8,8,14,16,30,50,37,87,0.000333,0.1423,14,5976.592745,332.03293,426.899482,117.302969,2,0
0,0,17,17,16,23,39,110,55,165,0.000333,0.290697,16,13953.46186,775.192325,872.091366,168.041925,7,0
0,0,7,7,11,19,30,44,28,72,0.000333,0.117765,5,1766.480614,98.137812,353.296123,118.764371,2,0
0,0,6,6,9,18,27,24,23,47,0.000333,0.074493,4,893.91885,49.662158,223.479713,103.587975,3,0
0,0,4,4,4,7,11,13,11,24,0.000333,0.027675,2,166.052718,9.225151,83.026359,27.651484,3,0
0,0,3,3,11,11,22,26,15,41,0.000333,0.060946,5,914.183482,50.787971,182.836696,76.107496,3,0
0,0,3,3,8,13,21,29,17,46,0.000333,0.067349,4,808.186406,44.899245,202.046601,72.105716,1,0
0,0,19,19,21,26,47,149,82,231,0.000333,0.427703,30,38493.30074,2138.516708,1283.110025,214.450099,11,0
0,0,6,6,11,16,27,30,23,53,0.000333,0.084003,5,1260.045188,70.00251,252.009038,102.053748,1,0
0,0,4,4,8,11,19,17,15,32,0.000333,0.045311,4,543.734722,30.207485,135.93368,62.053748,3,0
0,0,3,3,10,8,18,16,13,29,0.000333,0.040309,5,604.639125,33.591063,120.927825,57.219281,3,0
0,0,22,22,17,35,52,129,69,198,0.000333,0.376229,8,9029.496514,501.638695,1128.687064,249.011774,8,0
0,0,4,4,6,8,14,17,12,29,0.000333,0.036804,3,331.239878,18.402215,110.413293,39.509775,3,0
0,0,3,3,10,6,16,19,10,29,0.000333,0.038667,5,580,32.222222,116,48.729056,1,0
0,0,3,3,9,9,18,18,13,31,0.000333,0.043089,4,517.0707,28.72615,129.267675,57.05865,2,0
0,0,7,7,9,21,30,28,27,55,0.000333,0.08996,4,1079.515931,59.973107,269.878983,120.767991,3,0
0,0,3,3,10,10,20,17,13,30,0.000333,0.043219,5,648.289214,36.016067,129.657843,66.438562,2,0
0,0,3,3,10,11,21,22,15,37,0.000333,0.054172,5,812.578723,45.143262,162.515745,71.273029,4,0
0,0,3,3,9,9,18,18,13,31,0.000333,0.043089,4,517.0707,28.72615,129.267675,57.05865,2,0
0,0,21,21,17,32,49,123,66,189,0.000333,0.353727,16,16978.88257,943.271254,1061.180161,229.486868,8,0
0,0,4,4,6,8,14,17,12,29,0.000333,0.036804,3,331.239878,18.402215,110.413293,39.509775,3,0
0,0,15,15,12,24,36,88,45,133,0.000333,0.2292,6,4125.600151,229.200008,687.600025,153.05865,5,0
0,0,7,7,11,19,30,44,28,72,0.000333,0.117765,5,1766.480614,98.137812,353.296123,118.764371,2,0
0,0,7,7,11,18,29,48,28,76,0.000333,0.123069,5,1846.032778,102.557377,369.206556,113.112398,1,0
0,0,4,4,6,8,14,17,12,29,0.000333,0.036804,3,331.239878,18.402215,110.413293,39.509775,3,0
0,0,4,4,4,7,11,13,11,24,0.000333,0.027675,2,166.052718,9.225151,83.026359,27.651484,3,0
0,0,9,9,13,19,32,49,32,81,0.000333,0.135,6,2430,135,405,128.816339,4,0
0,0,7,7,11,19,30,44,28,72,0.000333,0.117765,5,1766.480614,98.137812,353.296123,118.764371,2,0
0,0,3,3,10,8,18,16,13,29,0.000333,0.040309,5,604.639125,33.591063,120.927825,57.219281,3,0
0,0,5,5,12,16,28,39,25,64,0.000333,0.102557,6,1846.02429,102.556905,307.670715,107.01955,2,0
0,0,3,3,10,8,18,16,13,29,0.000333,0.040309,5,604.639125,33.591063,120.927825,57.219281,3,0
0,0,4,4,8,9,17,15,14,29,0.000333,0.039512,4,474.14569,26.341427,118.536422,52.529325,1,0
0,0,4,4,4,7,11,13,11,24,0.000333,0.027675,2,166.052718,9.225151,83.026359,27.651484,3,0
0,0,8,8,15,16,31,48,35,83,0.000333,0.137066,14,5756.776113,319.820895,411.198294,122.603359,4,0
0,0,4,4,11,10,21,26,17,43,0.000333,0.062957,5,944.348246,52.463791,188.869649,71.273029,2,0
0,0,23,23,13,34,47,157,98,255,0.000333,0.47214,12,16997.04189,944.280105,1416.420157,221.079453,1,0
0,0,4,4,4,7,11,13,11,24,0.000333,0.027675,2,166.052718,9.225151,83.026359,27.651484,3,0
0,0,3,3,10,8,18,16,13,29,0.000333,0.040309,5,604.639125,33.591063,120.927825,57.219281,3,0
0,0,4,4,6,8,14,17,12,29,0.000333,0.036804,3,331.239878,18.402215,110.413293,39.509775,3,0
0,0,3,3,10,8,18,16,13,29,0.000333,0.040309,5,604.639125,33.591063,120.927825,57.219281,3,0
0,0,3,3,8,13,21,32,17,49,0.000333,0.071741,4,860.894215,47.827456,215.223554,72.105716,1,0
0,0,19,19,16,30,46,92,73,165,0.000333,0.303796,16,14582.20356,810.12242,911.387723,211.206718,7,0
0,0,26,26,24,37,61,135,98,233,0.000333,0.460621,24,33164.68319,1842.4824,1381.8618,302.788875,6,0
0,0,26,26,25,37,62,140,98,238,0.000333,0.472366,24,34010.36933,1889.464962,1417.098722,308.846179,6,0
0,0,19,19,17,30,47,95,73,168,0.000333,0.311057,16,14930.73483,829.485269,933.170927,216.693586,7,0
0,0,20,20,16,31,47,100,77,177,0.000333,0.327721,16,15730.59563,873.921979,983.162227,217.580086,7,0
0,0,27,27,24,38,62,143,103,246,0.000333,0.488244,24,35153.57502,1952.97639,1464.732292,309.460346,6,0
0,0,18,18,15,30,45,88,69,157,0.000333,0.287407,14,12071.09311,670.616284,862.220936,205.810077,7,0
0,0,25,25,24,36,60,128,93,221,0.000333,0.435141,24,31330.14772,1740.563762,1305.422822,296.1564,6,0
0,0,17,17,15,30,45,83,66,149,0.000333,0.272762,14,11456.00556,636.444753,818.286111,205.810077,7,0
0,0,24,24,24,36,60,125,90,215,0.000333,0.423327,24,30479.55547,1693.308637,1269.981478,296.1564,6,0
0,0,16,16,15,29,44,81,64,145,0.000333,0.263873,14,11082.64619,615.702566,791.617585,199.484808,7,0
0,0,23,23,24,35,59,123,88,211,0.000333,0.413746,24,29789.7044,1654.983578,1241.237683,289.564006,6,0
0,0,22,22,18,33,51,107,83,190,0.000333,0.359254,18,19399.69467,1077.760815,1077.760815,241.523656,7,0
0,0,29,29,24,39,63,150,108,258,0.000333,0.514046,24,37011.31729,2056.184294,1542.13822,316.169787,6,0
0,0,22,22,16,34,50,99,82,181,0.000333,0.340513,16,16344.60753,908.033751,1021.53797,236.973737,7,0
0,0,29,29,25,41,66,142,107,249,0.000333,0.501685,24,36121.29926,2006.738848,1505.054136,335.756037,6,0
0,0,22,22,16,33,49,99,82,181,0.000333,0.338754,16,16260.19971,903.344428,1016.262482,230.465006,7,0
0,0,29,29,25,40,65,142,107,249,0.000333,0.499857,24,35989.67005,1999.426114,1499.569585,328.973529,6,0
0,0,16,16,15,29,44,81,64,145,0.000333,0.263873,14,11082.64619,615.702566,791.617585,199.484808,7,0
0,0,23,23,24,35,59,123,88,211,0.000333,0.413746,24,29789.7044,1654.983578,1241.237683,289.564006,6,0
0,0,17,17,25,30,55,129,86,215,0.000333,0.414331,24,29831.81612,1657.323118,1242.992338,263.303123,6,0
0,0,7,7,13,14,27,26,19,45,0.000333,0.071323,6,1283.819626,71.323313,213.969938,101.408685,3,0
0,0,10,10,15,23,38,57,45,102,0.000333,0.17843,7,3747.020245,208.167791,535.288606,162.645284,2,0
0,0,34,34,21,22,43,185,116,301,0.000333,0.544435,50,81665.28456,4536.960253,1633.305691,190.346161,10,0
0,0,17,17,11,23,34,50,50,100,0.000333,0.169582,10,5087.462841,282.636825,508.746284,142.095673,4,0
0,0,29,29,11,31,42,98,84,182,0.000333,0.327134,10,9814.017709,545.223206,981.401771,191.633833,7,0
0,0,10,10,13,21,34,44,31,75,0.000333,0.127187,6,2289.358279,127.186571,381.559713,140.344382,3,0
0,0,23,23,19,33,52,96,69,165,0.000333,0.313524,18,16930.30596,940.572553,940.572553,247.175629,5,0
0,0,21,21,15,30,45,94,59,153,0.000333,0.280085,7,5881.774666,326.765259,840.253524,205.810077,5,0
0,0,24,24,21,26,47,114,78,192,0.000333,0.355494,30,31994.43179,1777.468433,1066.48106,214.450099,7,0
0,0,16,16,19,34,53,96,71,167,0.000333,0.318854,18,17218.12889,956.562716,956.562716,253.684359,7,0
0,0,12,12,15,27,42,63,50,113,0.000333,0.203111,7,4265.323081,236.962393,609.331869,186.985321,2,0
0,0,25,25,15,41,56,109,89,198,0.000333,0.383285,14,16097.98784,894.332658,1149.856275,278.262991,4,0
0,0,17,17,23,27,50,59,37,96,0.000333,0.180603,11,5959.912136,331.10623,541.810194,232.423888,2,0
0,0,19,19,27,30,57,145,95,240,0.000333,0.466631,39,54595.85053,3033.102807,1399.893603,275.58868,6,0
0,0,12,12,19,18,37,60,40,100,0.000333,0.173648,18,9377.016058,520.945337,520.945337,155.769273,3,0
0,0,15,15,18,35,53,108,71,179,0.000333,0.341766,18,18455.35971,1025.297761,1025.297761,254.583556,6,0
0,0,9,9,14,16,30,56,41,97,0.000333,0.158656,14,6663.557429,370.197635,475.968388,117.302969,2,0
0,0,10,10,12,19,31,48,34,82,0.000333,0.135415,6,2437.464585,135.414699,406.244097,123.730173,1,0
0,0,19,19,12,23,35,63,60,123,0.000333,0.210301,12,7570.821733,420.601207,630.901811,147.061475,4,0
0,0,31,31,12,31,43,111,94,205,0.000333,0.370795,18,20022.91695,1112.384275,1112.384275,196.599636,7,0
0,0,10,10,18,18,36,60,38,98,0.000333,0.168884,18,9119.747703,506.65265,506.65265,150.1173,3,0
0,0,25,25,20,33,53,112,77,189,0.000333,0.360859,20,21651.53932,1202.863295,1082.576966,252.903568,5,0
0,0,23,23,16,30,46,110,67,177,0.000333,0.32589,16,15642.72746,869.040414,977.670466,211.206718,5,0
0,0,26,26,22,26,48,133,90,223,0.000333,0.415149,33,41099.73904,2283.318836,1245.446638,220.318928,7,0
0,0,18,18,21,34,55,117,79,196,0.000333,0.377716,20,22662.93008,1259.051671,1133.146504,265.212402,7,0
0,0,14,14,17,28,45,82,60,142,0.000333,0.259948,16,12477.49024,693.193902,779.84314,204.092806,2,0
0,0,21,21,17,41,58,123,97,220,0.000333,0.429585,16,20620.0931,1145.560728,1288.755819,289.1465,4,0
1,0,42,43,29,79,108,285,216,501,0.000333,1.128066,28,94757.56188,5264.308993,3384.198639,638.880128,8,0
0,0,10,10,15,17,32,43,35,78,0.000333,0.13,14,5460,303.333333,390,128.090227,2,0
0,0,13,13,18,19,37,63,45,108,0.000333,0.18754,18,10127.17734,562.620963,562.620963,155.769273,3,0
0,0,16,16,17,36,53,110,76,186,0.000333,0.355131,16,17046.29127,947.016182,1065.393205,255.604168,6,0
0,0,10,10,12,17,29,65,50,115,0.000333,0.186223,12,6704.013773,372.44521,558.667814,112.506418,2,0
0,0,37,37,22,23,45,195,123,318,0.000333,0.582136,55,96052.51066,5336.250592,1746.409285,202.149421,10,0
0,0,11,11,10,20,30,52,35,87,0.000333,0.1423,5,2134.497409,118.583189,426.899482,119.657843,1,0
0,0,20,20,12,24,36,66,67,133,0.000333,0.2292,12,8251.200302,458.400017,687.600025,153.05865,4,0
0,0,32,32,12,32,44,114,101,215,0.000333,0.391259,18,21128.00036,1173.777798,1173.777798,203.01955,7,0
0,0,11,11,18,19,37,64,43,107,0.000333,0.185804,18,10033.40718,557.41151,557.41151,155.769273,3,0
0,0,11,11,11,15,26,41,28,69,0.000333,0.10811,5,1621.651703,90.091761,324.330341,96.657107,3,0
0,0,26,26,19,34,53,120,82,202,0.000333,0.38568,18,20826.71877,1157.039932,1157.039932,253.684359,5,0
0,0,24,24,15,31,46,118,72,190,0.000333,0.349826,14,14692.6748,816.259711,1049.476772,212.183445,5,0
0,0,26,26,21,27,48,141,98,239,0.000333,0.444935,30,40044.18113,2224.676729,1334.806038,220.620628,7,0
0,0,19,19,20,35,55,115,84,199,0.000333,0.383497,20,23009.81166,1278.32287,1150.490583,265.963467,7,0
0,0,15,15,16,29,45,88,66,154,0.000333,0.281915,16,13531.92603,751.773668,845.745377,204.881449,2,0
0,0,22,22,16,42,58,127,102,229,0.000333,0.447159,16,21463.64237,1192.424576,1341.477648,290.477332,4,0
0,0,19,19,25,30,55,142,95,237,0.000333,0.456727,36,49326.56108,2740.364504,1370.182252,263.303123,6,0
0,0,9,9,15,16,31,38,32,70,0.000333,0.115598,14,4855.112384,269.728466,346.793742,122.603359,2,0
0,0,12,12,18,18,36,55,40,95,0.000333,0.163714,18,8840.571752,491.142875,491.142875,150.1173,3,0
0,0,15,15,17,35,52,102,71,173,0.000333,0.328725,16,15778.81714,876.600952,986.176071,249.011774,6,0
0,0,9,9,12,16,28,53,41,94,0.000333,0.15063,12,5422.696352,301.260908,451.891363,107.01955,2,0
0,0,36,36,22,22,44,189,120,309,0.000333,0.562321,55,92783.04036,5154.613353,1686.96437,196.214991,10,0
0,0,10,10,10,19,29,41,30,71,0.000333,0.114972,5,1724.583253,95.810181,344.916651,113.929904,1,0
0,0,19,19,12,23,35,59,60,119,0.000333,0.203462,12,7324.616148,406.923119,610.384679,147.061475,4,0
0,0,31,31,12,31,43,107,94,201,0.000333,0.36356,18,19632.22588,1090.679216,1090.679216,196.599636,7,0
0,0,10,10,18,18,36,56,38,94,0.000333,0.161991,18,8747.513102,485.97295,485.97295,150.1173,3,0
0,0,10,10,11,14,25,35,25,60,0.000333,0.092877,5,1393.156857,77.397603,278.631371,91.356717,3,0
0,0,25,25,19,33,52,109,77,186,0.000333,0.353427,18,19085.07218,1060.281788,1060.281788,247.175629,5,0
0,0,23,23,15,30,45,107,67,174,0.000333,0.318527,14,13378.15414,743.230786,955.582439,205.810077,5,0
0,0,25,25,21,26,47,129,90,219,0.000333,0.405485,30,36493.64876,2027.424931,1216.454959,214.450099,7,0
0,0,18,18,20,34,54,106,79,185,0.000333,0.354885,20,21293.08376,1182.949098,1064.654188,259.412299,7,0
0,0,14,14,16,28,44,77,60,137,0.000333,0.249314,16,11967.07411,664.83745,747.942132,198.605938,2,0
0,0,21,21,16,41,57,118,97,215,0.000333,0.418024,16,20065.14165,1114.730092,1254.071353,283.659632,4,0
0,0,17,17,25,30,55,130,87,217,0.000333,0.418185,24,30109.32139,1672.740077,1254.555058,263.303123,6,0
0,0,7,7,14,17,31,34,28,62,0.000333,0.102387,7,2150.121199,119.451178,307.160171,122.789837,2,0
0,0,6,6,11,14,25,30,22,52,0.000333,0.080494,5,1207.402609,67.077923,241.480522,91.356717,2,0
0,0,10,10,17,18,35,46,33,79,0.000333,0.135071,8,3241.706867,180.094826,405.213358,144.545518,3,0
0,0,15,15,16,35,51,92,64,156,0.000333,0.294966,8,7079.186827,393.288157,884.898353,243.524906,6,0
0,0,6,6,11,14,25,30,22,52,0.000333,0.080494,5,1207.402609,67.077923,241.480522,91.356717,2,0
0,0,9,9,15,23,38,58,46,104,0.000333,0.181928,14,7640.98246,424.499026,545.784461,162.645284,2,0
0,0,34,34,21,22,43,186,117,303,0.000333,0.548053,50,82207.91103,4567.106169,1644.158221,190.346161,10,0
0,0,8,8,9,19,28,31,27,58,0.000333,0.092942,4,1115.306342,61.961463,278.826585,109.239948,1,0
0,0,17,17,11,23,34,52,51,103,0.000333,0.17467,10,5240.086726,291.115929,524.008673,142.095673,4,0
0,0,29,29,11,31,42,98,86,184,0.000333,0.330729,10,9921.864058,551.21467,992.186406,191.633833,7,0
0,0,8,8,16,18,34,46,31,77,0.000333,0.130578,8,3133.87711,174.104284,391.734639,139.05865,3,0
0,0,10,10,13,21,34,43,32,75,0.000333,0.127187,6,2289.358279,127.186571,381.559713,140.344382,3,0
0,0,23,23,19,33,52,98,70,168,0.000333,0.319225,18,17238.12971,957.673873,957.673873,247.175629,5,0
0,0,21,21,15,30,45,96,60,156,0.000333,0.285576,14,11994.20716,666.344842,856.729083,205.810077,5,0
0,0,24,24,21,26,47,116,79,195,0.000333,0.361048,30,32494.34478,1805.241377,1083.144826,214.450099,7,0
0,0,16,16,19,34,53,98,72,170,0.000333,0.324582,18,17527.43659,973.746477,973.746477,253.684359,7,0
0,0,12,12,15,27,42,65,52,117,0.000333,0.2103,7,4416.307969,245.350443,630.901138,186.985321,2,0
0,0,17,17,23,27,50,60,38,98,0.000333,0.184366,11,6084.076973,338.004276,553.097907,232.423888,2,0
0,0,22,22,25,33,58,157,105,262,0.000333,0.511597,36,55252.47675,3069.582041,1534.791021,282.561411,6,0
0,0,15,15,18,21,39,70,50,120,0.000333,0.211416,18,11416.46879,634.248266,634.248266,167.297316,3,0
0,0,18,18,19,38,57,115,81,196,0.000333,0.381082,18,20578.43597,1143.246443,1143.246443,280.131868,6,0
0,0,12,12,14,19,33,68,51,119,0.000333,0.200094,14,8403.960603,466.8867,600.2829,134.013592,2,0
0,0,13,13,12,22,34,62,44,106,0.000333,0.179757,12,6471.252734,359.514041,539.271061,141.127046,1,0
0,0,22,22,14,26,40,72,72,144,0.000333,0.255453,14,10729.00704,596.055947,766.357646,175.514402,4,0
0,0,34,34,14,34,48,120,106,226,0.000333,0.420734,21,26506.23203,1472.568446,1262.201525,226.276706,7,0
0,0,13,13,20,21,41,69,48,117,0.000333,0.208945,20,12536.67169,696.481761,626.833585,178.677228,3,0
0,0,28,28,21,36,57,126,87,213,0.000333,0.414135,20,24848.11146,1380.450637,1242.405573,278.355966,5,0
0,0,26,26,17,33,50,124,77,201,0.000333,0.378138,16,18150.64151,1008.368973,1134.415094,235.951874,5,0
0,0,28,28,23,29,52,142,102,244,0.000333,0.463636,33,45899.94061,2549.996701,1390.907291,244.923374,7,0
0,0,21,21,22,37,59,123,89,212,0.000333,0.415707,22,27436.64718,1524.258177,1247.120326,290.85727,7,0
0,0,17,17,18,31,49,94,71,165,0.000333,0.308809,18,16675.68824,926.427124,926.427124,228.638736,2,0
0,0,24,24,18,44,62,134,107,241,0.000333,0.47832,18,25829.30359,1434.961311,1434.961311,315.273641,4,0
0,0,22,22,26,33,59,149,104,253,0.000333,0.496103,39,58044.03897,3224.668832,1488.308691,288.676439,6,0
0,0,15,15,19,21,40,62,49,111,0.000333,0.196911,18,10633.21233,590.734019,590.734019,172.949289,3,0
0,0,18,18,18,38,56,109,80,189,0.000333,0.365863,18,19756.62145,1097.59008,1097.59008,274.479896,6,0
0,0,12,12,13,19,32,60,50,110,0.000333,0.183333,12,6600,366.666667,550,128.816339,2,0
0,0,13,13,11,22,33,52,43,95,0.000333,0.159739,5,2396.087207,133.115956,479.217441,136.161243,1,0
0,0,22,22,13,26,39,66,69,135,0.000333,0.237843,12,8562.351595,475.6862,713.5293,170.317149,4,0
0,0,34,34,13,34,47,114,103,217,0.000333,0.401782,18,21696.22406,1205.345781,1205.345781,221.079453,7,0
0,0,13,13,18,21,39,62,47,109,0.000333,0.192036,18,10369.95915,576.108842,576.108842,167.297316,3,0
0,0,28,28,19,36,55,116,86,202,0.000333,0.389278,18,21021.02392,1167.834662,1167.834662,266.827923,5,0
0,0,26,26,16,33,49,114,76,190,0.000333,0.355598,16,17068.71793,948.262107,1066.79487,230.465006,5,0
0,0,28,28,22,29,51,136,99,235,0.000333,0.44434,33,43989.65853,2443.869918,1333.019955,238.988944,7,0
0,0,21,21,21,37,58,113,88,201,0.000333,0.392485,20,23549.0836,1308.282422,1177.45418,284.98844,7,0
0,0,17,17,16,31,47,84,69,153,0.000333,0.283284,16,13597.63351,755.424084,849.852094,217.580086,2,0
0,0,24,24,16,44,60,124,106,230,0.000333,0.452862,16,21737.35739,1207.630966,1358.584837,304.214991,4,0
0,0,22,22,26,34,60,149,104,253,0.000333,0.498148,39,58283.28951,3237.960528,1494.443321,295.185169,6,0
0,0,15,15,19,22,41,62,49,111,0.000333,0.198229,18,10704.38891,594.688273,594.688273,178.818118,3,0
0,0,18,18,18,39,57,109,80,189,0.000333,0.367472,18,19843.49183,1102.416213,1102.416213,281.189337,6,0
0,0,12,12,13,20,33,60,50,110,0.000333,0.184961,12,6658.600238,369.922235,554.883353,134.544278,2,0
0,0,13,13,11,23,34,52,43,95,0.000333,0.161103,5,2416.54485,134.252492,483.30897,142.095673,1,0
0,0,22,22,13,27,40,66,69,135,0.000333,0.239487,12,8621.523514,478.973529,718.460293,176.487679,4,0
0,0,34,34,13,35,48,114,103,217,0.000333,0.403979,12,14543.24235,807.957908,1211.936863,227.630622,7,0
0,0,13,13,18,22,40,62,47,109,0.000333,0.193363,18,10441.62292,580.090162,580.090162,173.166146,3,0
0,0,28,28,19,37,56,116,86,202,0.000333,0.391029,18,21115.5425,1173.085694,1173.085694,273.460397,5,0
0,0,26,26,16,34,50,114,76,190,0.000333,0.357444,16,17157.32282,953.184601,1072.332676,236.973737,5,0
0,0,28,28,22,30,52,136,99,235,0.000333,0.446534,33,44206.91001,2455.939445,1339.603334,245.314213,7,0
0,0,21,21,21,38,59,113,88,201,0.000333,0.394137,20,23648.22506,1313.790281,1182.411253,291.659911,7,0
0,0,17,17,16,32,48,84,69,153,0.000333,0.284833,16,13671.9882,759.5549,854.499263,224,2,0
0,0,24,24,16,45,61,124,106,230,0.000333,0.45469,16,21825.1134,1212.5063,1364.069588,311.133389,4,0
0,0,16,16,25,29,54,127,84,211,0.000333,0.40476,24,29142.75031,1619.041684,1214.281263,256.977854,6,0
0,0,5,5,11,13,24,28,19,47,0.000333,0.071831,5,1077.466188,59.859233,215.493238,86.159464,2,0
0,0,9,9,17,17,34,43,30,73,0.000333,0.123795,8,2971.078299,165.059906,371.384787,138.973737,3,0
0,0,14,14,16,34,50,90,61,151,0.000333,0.284074,8,6817.778277,378.76546,852.222285,236.973737,6,0
0,0,6,6,13,13,26,24,17,41,0.000333,0.064239,6,1156.308171,64.239343,192.718028,96.211433,3,0
0,0,5,5,11,13,24,28,19,47,0.000333,0.071831,5,1077.466188,59.859233,215.493238,86.159464,2,0
0,0,8,8,15,22,37,55,43,98,0.000333,0.170175,7,3573.685009,198.538056,510.52643,156.710855,2,0
0,0,14,14,19,30,49,94,70,164,0.000333,0.306937,18,16574.62346,920.812414,920.812414,227.917341,5,0
0,0,33,33,21,21,42,183,114,297,0.000333,0.533839,50,80075.91373,4448.661874,1601.518275,184.477332,10,0
0,0,7,7,9,18,27,27,24,51,0.000333,0.080833,4,969.99705,53.888725,242.499263,103.587975,1,0
0,0,16,16,11,22,33,48,48,96,0.000333,0.161421,10,4842.618355,269.034353,484.261835,136.161243,4,0
0,0,28,28,11,30,41,96,82,178,0.000333,0.317881,10,9536.442568,529.802365,953.644257,185.260466,7,0
0,0,9,9,13,20,33,41,28,69,0.000333,0.116021,6,2088.379165,116.021065,348.063194,134.544278,3,0
0,0,22,22,19,32,51,94,67,161,0.000333,0.30442,18,16438.68864,913.26048,913.26048,240.710623,5,0
0,0,20,20,15,29,44,92,57,149,0.000333,0.271152,7,5694.187178,316.343732,813.455311,199.484808,5,0
0,0,23,23,21,25,46,112,76,188,0.000333,0.346143,30,31152.88943,1730.71608,1038.429648,208.335071,7,0
0,0,15,15,19,33,52,94,69,163,0.000333,0.309724,18,16725.09013,929.171674,929.171674,247.175629,7,0
0,0,11,11,15,26,41,61,48,109,0.000333,0.194658,7,4087.81218,227.100677,583.973169,180.814792,2,0
0,0,24,24,15,40,55,107,87,194,0.000333,0.373861,14,15702.17298,872.342943,1121.583784,271.480483,4,0
0,0,14,14,23,26,49,57,35,92,0.000333,0.172184,11,5682.086362,315.671465,516.553306,226.253358,2,0
0,0,16,16,25,29,54,127,84,211,0.000333,0.40476,24,29142.75031,1619.041684,1214.281263,256.977854,6,0
0,0,6,6,14,15,29,31,25,56,0.000333,0.090682,7,1904.32855,105.796031,272.046936,111.906328,2,0
0,0,6,6,11,13,24,28,19,47,0.000333,0.071831,5,1077.466188,59.859233,215.493238,86.159464,2,0
0,0,9,9,17,17,34,43,30,73,0.000333,0.123795,8,2971.078299,165.059906,371.384787,138.973737,3,0
0,0,4,4,10,8,18,18,13,31,0.000333,0.043089,5,646.338375,35.907688,129.267675,57.219281,2,0
0,0,5,5,10,9,19,22,16,38,0.000333,0.053807,5,807.106228,44.839235,161.421246,61.748606,2,0
0,0,14,14,16,34,50,90,61,151,0.000333,0.284074,8,6817.778277,378.76546,852.222285,236.973737,6,0
0,0,6,6,13,13,26,24,17,41,0.000333,0.064239,6,1156.308171,64.239343,192.718028,96.211433,3,0
0,0,5,5,11,13,24,28,19,47,0.000333,0.071831,5,1077.466188,59.859233,215.493238,86.159464,2,0
0,0,10,10,15,22,37,55,43,98,0.000333,0.170175,7,3573.685009,198.538056,510.52643,156.710855,2,0
0,0,14,14,19,30,49,94,70,164,0.000333,0.306937,18,16574.62346,920.812414,920.812414,227.917341,5,0
0,0,33,33,21,21,42,183,114,297,0.000333,0.533839,50,80075.91373,4448.661874,1601.518275,184.477332,10,0
0,0,3,3,7,6,13,8,7,15,0.000333,0.018502,3,166.519787,9.251099,55.506596,35.161259,1,0
0,0,3,3,7,6,13,8,7,15,0.000333,0.018502,3,166.519787,9.251099,55.506596,35.161259,1,0
0,0,7,7,9,18,27,27,24,51,0.000333,0.080833,4,969.99705,53.888725,242.499263,103.587975,1,0
0,0,16,16,11,22,33,48,48,96,0.000333,0.161421,10,4842.618355,269.034353,484.261835,136.161243,4,0
0,0,28,28,11,30,41,96,82,178,0.000333,0.317881,10,9536.442568,529.802365,953.644257,185.260466,7,0
0,0,7,7,16,17,33,44,28,72,0.000333,0.121065,8,2905.571013,161.420612,363.196377,133.486868,3,0
0,0,9,9,13,20,33,41,28,69,0.000333,0.116021,6,2088.379165,116.021065,348.063194,134.544278,3,0
0,0,7,7,10,12,22,29,19,48,0.000333,0.071351,5,1070.263588,59.459088,214.052718,76.238831,3,0
0,0,22,22,19,32,51,94,67,161,0.000333,0.30442,18,16438.68864,913.26048,913.26048,240.710623,5,0
0,0,20,20,15,29,44,92,57,149,0.000333,0.271152,7,5694.187178,316.343732,813.455311,199.484808,5,0
0,0,23,23,21,25,46,112,76,188,0.000333,0.346143,30,31152.88943,1730.71608,1038.429648,208.335071,7,0
0,0,15,15,19,33,52,94,69,163,0.000333,0.309724,18,16725.09013,929.171674,929.171674,247.175629,7,0
0,0,9,9,13,24,37,48,39,87,0.000333,0.151074,6,2719.334657,151.074148,453.222443,158.144816,1,0
0,0,11,11,15,26,41,61,48,109,0.000333,0.194658,7,4087.81218,227.100677,583.973169,180.814792,2,0
0,0,24,24,15,40,55,107,87,194,0.000333,0.373861,14,15702.17298,872.342943,1121.583784,271.480483,4,0
0,0,16,16,23,26,49,57,35,92,0.000333,0.172184,11,5682.086362,315.671465,516.553306,226.253358,2,0
0,0,20,20,16,18,34,122,92,214,0.000333,0.362906,40,43548.68192,2419.371218,1088.717048,139.05865,2,0
0,0,21,21,17,19,36,129,95,224,0.000333,0.386021,40,46322.52801,2573.473778,1158.0632,150.197491,2,0
0,0,19,19,15,20,35,121,91,212,0.000333,0.362469,28,30447.42399,1691.523555,1087.408,145.041921,2,0
0,0,18,18,15,18,33,113,87,200,0.000333,0.336293,28,28248.60707,1569.367059,1008.878824,133.662009,2,0
0,0,17,17,15,18,33,107,81,188,0.000333,0.316115,28,26553.69064,1475.205036,948.346094,133.662009,2,0
0,0,22,22,17,22,39,130,99,229,0.000333,0.403452,32,38731.42746,2151.74597,1210.357108,167.594364,2,0
0,0,19,19,16,21,37,115,90,205,0.000333,0.355979,32,34174.01408,1898.556338,1067.93794,156.238666,2,0
0,0,22,22,16,22,38,123,98,221,0.000333,0.386597,32,37113.34338,2061.85241,1159.79198,162.107496,2,0
0,0,22,22,18,32,50,105,80,185,0.000333,0.348038,18,18794.04111,1044.113395,1044.113395,235.05865,4,0
0,0,23,23,18,33,51,111,83,194,0.000333,0.366817,18,19808.10929,1100.450516,1100.450516,241.523656,4,0
0,0,21,21,17,33,50,104,79,183,0.000333,0.344275,16,16525.21092,918.067274,1032.825683,235.951874,4,0
0,0,20,20,17,32,49,96,75,171,0.000333,0.320038,16,15361.84613,853.435896,960.115383,229.486868,4,0
0,0,19,19,17,32,49,92,71,163,0.000333,0.305066,16,14643.16327,813.509071,915.197705,229.486868,4,0
0,0,24,24,20,35,55,114,87,201,0.000333,0.387351,20,23241.06605,1291.170336,1162.053302,265.963467,4,0
0,0,21,21,18,35,53,98,78,176,0.000333,0.336038,18,18146.052,1008.114,1008.114,254.583556,4,0
0,0,24,24,19,35,54,106,86,192,0.000333,0.368313,18,19888.89121,1104.9384,1104.9384,260.235528,4,0
0,0,19,19,18,28,46,93,69,162,0.000333,0.298272,18,16106.70666,894.817037,894.817037,209.664588,4,0
0,0,20,20,18,29,47,99,72,171,0.000333,0.316612,18,17097.02449,949.834694,949.834694,215.940099,4,0
0,0,18,18,17,29,46,92,68,160,0.000333,0.29459,16,14140.31861,785.573256,883.769913,210.368317,4,0
0,0,17,17,17,28,45,84,64,148,0.000333,0.270931,16,13004.70813,722.483785,812.794258,204.092806,4,0
0,0,16,16,17,28,45,80,60,140,0.000333,0.256286,16,12301.75094,683.430608,768.859433,204.092806,4,0
0,0,21,21,20,31,51,102,76,178,0.000333,0.336564,20,20193.83422,1121.879679,1009.691711,240.018648,4,0
0,0,18,18,18,31,49,86,67,153,0.000333,0.28635,18,15462.91091,859.050606,859.050606,228.638736,4,0
0,0,21,21,19,31,50,94,75,169,0.000333,0.317937,18,17168.61053,953.811696,953.811696,234.290708,4,0
0,0,14,14,16,15,31,73,25,98,0.000333,0.161837,8,3884.089907,215.782773,485.511238,122.603359,4,0
0,0,15,15,17,16,33,80,28,108,0.000333,0.181598,8,4358.356519,242.130918,544.794565,133.486868,4,0
0,0,13,13,16,17,33,68,28,96,0.000333,0.161421,8,3874.094684,215.227482,484.261835,133.486868,4,0
0,0,12,12,16,15,31,60,24,84,0.000333,0.138717,8,3329.219921,184.956662,416.15249,122.603359,4,0
0,0,11,11,16,15,31,54,22,76,0.000333,0.125506,8,3012.151357,167.341742,376.51892,122.603359,4,0
0,0,16,16,18,19,37,80,34,114,0.000333,0.197959,9,5344.899153,296.938842,593.877684,155.769273,4,0
0,0,13,13,17,18,35,62,27,89,0.000333,0.152169,8,3652.049508,202.891639,456.506189,144.545518,4,0
0,0,16,16,17,19,36,72,33,105,0.000333,0.180947,8,4342.737001,241.263167,542.842125,150.197491,4,0
0,0,12,12,13,18,31,52,39,91,0.000333,0.150277,12,5409.982371,300.554576,450.831864,123.164366,3,0
0,0,13,13,14,19,33,58,42,100,0.000333,0.168146,14,7062.151767,392.341765,504.439412,134.013592,3,0
0,0,11,11,11,20,31,51,38,89,0.000333,0.146974,5,2204.617358,122.478742,440.923472,124.49231,3,0
0,0,10,10,11,18,29,43,34,77,0.000333,0.124688,5,1870.322683,103.906816,374.064537,113.112398,3,0
0,0,9,9,11,18,29,39,30,69,0.000333,0.111734,5,1676.003443,93.111302,335.200689,113.112398,3,0
0,0,8,8,11,17,28,37,28,65,0.000333,0.104159,5,1562.39035,86.799464,312.47807,107.540616,3,0
0,0,14,14,14,22,36,61,46,107,0.000333,0.184394,14,7744.547652,430.252647,553.181975,151.410465,3,0
0,0,11,11,12,21,33,45,37,82,0.000333,0.13788,6,2481.841907,137.880106,413.640318,135.258216,3,0
0,0,14,14,13,22,35,53,45,98,0.000333,0.167557,12,6032.036828,335.113157,502.669736,146.213212,3,0
0,0,18,18,16,22,38,78,60,138,0.000333,0.241405,16,11587.42395,643.745775,724.213997,162.107496,4,0
0,0,19,19,17,23,40,85,63,148,0.000333,0.262548,16,12602.32573,700.129207,787.645358,173.528793,4,0
0,0,17,17,15,24,39,77,59,136,0.000333,0.239605,14,10063.40583,559.078101,718.814702,168.642459,4,0
0,0,16,16,15,22,37,69,55,124,0.000333,0.215324,14,9043.611043,502.422836,645.972217,156.710855,4,0
0,0,15,15,15,22,37,65,51,116,0.000333,0.201432,14,8460.152266,470.008459,604.29659,156.710855,4,0
0,0,14,14,15,21,36,63,49,112,0.000333,0.193011,14,8106.442402,450.357911,579.0316,150.842025,4,0
0,0,20,20,18,26,44,87,67,154,0.000333,0.280251,18,15133.54445,840.752469,840.752469,197.270083,4,0
0,0,17,17,16,25,41,71,58,129,0.000333,0.230375,16,11057.98734,614.33263,691.124209,180.096405,4,0
0,0,20,20,17,26,43,78,66,144,0.000333,0.260461,16,12502.114,694.561889,781.382125,191.698301,4,0
0,0,24,24,16,30,46,107,68,175,0.000333,0.322208,16,15465.97348,859.220749,966.623342,211.206718,5,0
0,0,25,25,17,31,48,113,71,184,0.000333,0.342544,16,16442.1296,913.451645,1027.6331,223.066954,5,0
0,0,23,23,15,31,46,106,67,173,0.000333,0.318525,14,13378.06706,743.225948,955.576218,212.183445,5,0
0,0,22,22,15,30,45,98,63,161,0.000333,0.294729,14,12378.63688,687.702049,884.188349,205.810077,5,0
0,0,21,21,15,30,45,95,60,155,0.000333,0.283746,14,11917.32122,662.073401,851.23723,205.810077,5,0
0,0,20,20,15,29,44,92,57,149,0.000333,0.271152,7,5694.187178,316.343732,813.455311,199.484808,5,0
0,0,26,26,17,33,50,116,75,191,0.000333,0.359326,16,17247.62452,958.201362,1077.976532,235.951874,5,0
0,0,23,23,16,33,49,100,66,166,0.000333,0.310681,16,14912.66935,828.48163,932.041834,230.465006,5,0
0,0,26,26,16,33,49,108,74,182,0.000333,0.340626,16,16350.03507,908.335281,1021.877192,230.465006,5,0
0,0,14,14,16,15,31,72,25,97,0.000333,0.160186,8,3844.456337,213.580908,480.557042,122.603359,4,0
0,0,15,15,17,16,33,79,28,107,0.000333,0.179917,8,4318.001366,239.888965,539.750171,133.486868,4,0
0,0,13,13,16,17,33,67,28,95,0.000333,0.159739,8,3833.739531,212.985529,479.217441,133.486868,4,0
0,0,12,12,16,15,31,59,24,83,0.000333,0.137066,8,3289.58635,182.754797,411.198294,122.603359,4,0
0,0,11,11,16,15,31,53,22,75,0.000333,0.123855,8,2972.517786,165.139877,371.564723,122.603359,4,0
0,0,16,16,18,19,37,79,34,113,0.000333,0.196223,9,5298.014073,294.334115,588.66823,155.769273,4,0
0,0,13,13,17,18,35,61,27,88,0.000333,0.150459,8,3611.015244,200.611958,451.376905,144.545518,4,0
0,0,16,16,17,19,36,71,33,104,0.000333,0.179224,8,4301.377601,238.965422,537.6722,150.197491,4,0
0,0,11,11,11,13,24,44,30,74,0.000333,0.113096,10,3392.872251,188.492903,339.287225,86.159464,3,0
0,0,12,12,12,14,26,51,33,84,0.000333,0.131612,12,4738.043236,263.224624,394.836936,96.322519,3,0
0,0,10,10,10,14,24,43,29,72,0.000333,0.110039,10,3301.173001,183.3985,330.1173,86.52225,3,0
0,0,9,9,10,13,23,35,25,60,0.000333,0.090471,5,1357.068587,75.392699,271.413717,81.324997,3,0
0,0,8,8,10,13,23,31,21,52,0.000333,0.078408,5,1176.126109,65.340339,235.225222,81.324997,3,0
0,0,13,13,13,16,29,53,37,90,0.000333,0.145739,12,5246.619475,291.47886,437.21829,112.105716,3,0
0,0,10,10,11,16,27,37,28,65,0.000333,0.103023,5,1545.338438,85.852135,309.067688,102.053748,3,0
0,0,13,13,12,16,28,45,36,81,0.000333,0.129799,12,4672.748984,259.597166,389.395749,107.01955,3,0
0,0,17,17,13,27,40,77,68,145,0.000333,0.257227,12,9260.154885,514.453049,771.679574,176.487679,2,0
0,0,19,19,13,29,42,85,72,157,0.000333,0.282198,12,10159.12603,564.39589,846.593835,188.987165,2,0
0,0,16,16,13,28,41,76,67,143,0.000333,0.255377,12,9193.55924,510.753291,766.129937,182.711654,2,0
0,0,15,15,13,27,40,68,63,131,0.000333,0.232391,12,8366.070965,464.78172,697.17258,176.487679,2,0
0,0,14,14,13,26,39,63,59,122,0.000333,0.21494,12,7737.828848,429.87938,644.819071,170.317149,2,0
0,0,19,19,15,30,45,86,75,161,0.000333,0.294729,14,12378.63688,687.702049,884.188349,205.810077,2,0
0,0,16,16,14,30,44,70,66,136,0.000333,0.247494,14,10394.7578,577.486545,742.4827,200.509687,2,0
0,0,19,19,14,30,44,78,74,152,0.000333,0.276611,14,11617.67048,645.426138,829.833606,200.509687,2,0
0,0,6,6,9,11,20,21,13,34,0.000333,0.048982,4,587.782221,32.654568,146.945555,66.583073,2,0
0,0,16,16,15,17,32,107,81,188,0.000333,0.313333,28,26320,1462.222222,940,128.090227,2,0
0,0,18,18,17,31,48,90,69,159,0.000333,0.296003,16,14208.1446,789.341367,888.009038,223.066954,4,0
0,0,15,15,17,27,44,78,58,136,0.000333,0.247494,16,11879.7232,659.984622,742.4827,197.868831,4,0
0,0,10,10,16,14,30,52,20,72,0.000333,0.117765,8,2826.368983,157.020499,353.296123,117.302969,4,0
0,0,8,8,11,17,28,37,28,65,0.000333,0.104159,5,1562.39035,86.799464,312.47807,107.540616,3,0
0,0,14,14,15,21,36,63,49,112,0.000333,0.193011,14,8106.442402,450.357911,579.0316,150.842025,4,0
0,0,20,20,15,29,44,92,57,149,0.000333,0.271152,7,5694.187178,316.343732,813.455311,199.484808,5,0
0,0,10,10,16,14,30,51,20,71,0.000333,0.11613,8,2787.113858,154.839659,348.389232,117.302969,4,0
0,0,7,7,10,12,22,29,19,48,0.000333,0.071351,5,1070.263588,59.459088,214.052718,76.238831,3,0
0,0,13,13,13,26,39,62,57,119,0.000333,0.209654,12,7547.554369,419.308576,628.962864,170.317149,2,0
0,0,4,4,7,6,13,12,9,21,0.000333,0.025903,3,233.127702,12.951539,77.709234,35.161259,1,0
0,0,5,5,7,7,14,14,11,25,0.000333,0.031728,3,285.551619,15.863979,95.183873,39.302969,1,0
0,0,3,3,6,3,9,10,5,15,0.000333,0.01585,3,142.646625,7.924813,47.548875,20.264663,1,0
0,0,3,3,5,2,7,8,4,12,0.000333,0.011229,4,134.753036,7.48628,33.688259,13.60964,1,0
0,0,3,3,5,2,7,8,4,12,0.000333,0.011229,4,134.753036,7.48628,33.688259,13.60964,1,0
0,0,3,3,6,3,9,10,5,15,0.000333,0.01585,3,142.646625,7.924813,47.548875,20.264663,1,0
0,0,3,3,5,2,7,8,4,12,0.000333,0.011229,4,134.753036,7.48628,33.688259,13.60964,1,0
0,0,3,3,5,2,7,8,4,12,0.000333,0.011229,4,134.753036,7.48628,33.688259,13.60964,1,0
0,0,3,3,5,2,7,8,4,12,0.000333,0.011229,4,134.753036,7.48628,33.688259,13.60964,1,0
0,0,5,5,7,6,13,15,11,26,0.000333,0.03207,3,288.634298,16.035239,96.211433,35.161259,1,0
0,0,5,5,7,6,13,15,11,26,0.000333,0.03207,3,288.634298,16.035239,96.211433,35.161259,1,0
0,0,6,6,7,7,14,17,13,30,0.000333,0.038074,3,342.661943,19.036775,114.220648,39.302969,1,0
0,0,6,6,7,7,14,17,13,30,0.000333,0.038074,3,342.661943,19.036775,114.220648,39.302969,1,0
0,0,4,4,9,7,16,20,14,34,0.000333,0.045333,8,1088,60.444444,136,48.180809,2,0
0,0,5,5,13,10,23,32,18,50,0.000333,0.075393,6,1357.068587,75.392699,226.178098,81.324997,2,0
0,0,5,5,13,10,23,32,18,50,0.000333,0.075393,6,1357.068587,75.392699,226.178098,81.324997,2,0
0,0,12,12,16,19,35,70,52,122,0.000333,0.208591,16,10012.36045,556.242247,625.772528,144.710623,2,0
0,0,12,12,16,17,33,60,43,103,0.000333,0.173191,16,8313.161509,461.842306,519.572594,133.486868,2,0
0,0,9,9,15,17,32,50,35,85,0.000333,0.141667,14,5950,330.555556,425,128.090227,2,0
0,0,4,4,9,4,13,18,10,28,0.000333,0.034537,8,828.898497,46.049916,103.612312,36.529325,2,0
0,0,10,10,17,17,34,56,38,94,0.000333,0.159407,16,7651.544113,425.085784,478.221507,138.973737,3,0
0,0,10,10,16,17,33,55,38,93,0.000333,0.156376,16,7506.05845,417.003247,469.128653,133.486868,3,0
0,0,15,15,17,22,39,86,64,150,0.000333,0.26427,16,12684.96533,704.720296,792.810333,167.594364,3,0
0,0,15,15,17,21,38,76,55,131,0.000333,0.22916,16,10999.65607,611.092004,687.478504,161.725534,3,0
0,0,12,12,16,20,36,66,47,113,0.000333,0.194734,16,9347.224403,519.290245,584.201525,150.438562,3,0
0,0,4,4,9,7,16,20,14,34,0.000333,0.045333,8,1088,60.444444,136,48.180809,2,0
0,0,7,7,15,15,30,37,29,66,0.000333,0.107952,7,2266.983455,125.943525,323.854779,117.206718,2,0
0,0,7,7,14,15,29,36,29,65,0.000333,0.105256,7,2210.381353,122.798964,315.768765,111.906328,2,0
0,0,12,12,15,20,35,67,55,122,0.000333,0.208591,14,8760.815393,486.711966,625.772528,145.041921,2,0
0,0,12,12,15,19,34,57,46,103,0.000333,0.17467,14,7336.121417,407.562301,524.008673,139.313982,2,0
0,0,9,9,14,19,33,47,38,85,0.000333,0.142925,14,6002.829002,333.4905,428.7735,134.013592,2,0
0,0,4,4,9,7,16,20,14,34,0.000333,0.045333,8,1088,60.444444,136,48.180809,2,0
0,0,6,6,16,16,32,39,27,66,0.000333,0.11,8,2640,146.666667,330,128,3,0
0,0,6,6,15,16,31,38,27,65,0.000333,0.107341,7,2254.159321,125.231073,322.02276,122.603359,3,0
0,0,13,13,16,22,38,76,58,134,0.000333,0.234407,16,11251.55659,625.086477,703.222287,162.107496,3,0
0,0,13,13,16,20,36,66,49,115,0.000333,0.19818,16,9512.662003,528.481222,594.541375,150.438562,3,0
0,0,10,10,15,19,34,56,41,97,0.000333,0.164495,14,6908.774538,383.820808,493.483896,139.313982,3,0
0,0,4,4,9,7,16,20,14,34,0.000333,0.045333,8,1088,60.444444,136,48.180809,2,0
0,0,6,6,13,11,24,29,21,50,0.000333,0.076416,6,1375.48875,76.416042,229.248125,86.159464,2,0
0,0,6,6,12,11,23,28,21,49,0.000333,0.073885,6,1329.927215,73.884845,221.654536,81.073298,2,0
0,0,11,11,13,17,30,59,47,106,0.000333,0.173377,12,6241.564838,346.753602,520.130403,117.592585,2,0
0,0,11,11,13,15,28,49,38,87,0.000333,0.139413,12,5018.878539,278.826585,418.239878,106.709075,2,0
0,0,8,8,12,15,27,39,30,69,0.000333,0.109362,12,3937.046852,218.724825,328.087238,101.622909,2,0
0,0,4,4,9,7,16,20,14,34,0.000333,0.045333,8,1088,60.444444,136,48.180809,2,0
0,0,5,5,13,10,23,32,18,50,0.000333,0.075393,6,1357.068587,75.392699,226.178098,81.324997,2,0
0,0,5,5,13,10,23,32,18,50,0.000333,0.075393,6,1357.068587,75.392699,226.178098,81.324997,2,0
0,0,12,12,16,19,35,70,52,122,0.000333,0.208591,16,10012.36045,556.242247,625.772528,144.710623,2,0
0,0,12,12,16,17,33,60,43,103,0.000333,0.173191,16,8313.161509,461.842306,519.572594,133.486868,2,0
0,0,9,9,15,17,32,50,35,85,0.000333,0.141667,14,5950,330.555556,425,128.090227,2,0
0,0,4,4,9,7,16,20,14,34,0.000333,0.045333,8,1088,60.444444,136,48.180809,2,0
0,0,5,5,13,10,23,32,18,50,0.000333,0.075393,6,1357.068587,75.392699,226.178098,81.324997,2,0
0,0,5,5,13,10,23,32,18,50,0.000333,0.075393,6,1357.068587,75.392699,226.178098,81.324997,2,0
0,0,12,12,16,19,35,70,52,122,0.000333,0.208591,16,10012.36045,556.242247,625.772528,144.710623,2,0
0,0,12,12,16,17,33,60,43,103,0.000333,0.173191,16,8313.161509,461.842306,519.572594,133.486868,2,0
0,0,9,9,15,17,32,50,35,85,0.000333,0.141667,14,5950,330.555556,425,128.090227,2,0
0,0,4,4,9,7,16,20,14,34,0.000333,0.045333,8,1088,60.444444,136,48.180809,2,0
0,0,10,10,17,17,34,56,38,94,0.000333,0.159407,16,7651.544113,425.085784,478.221507,138.973737,3,0
0,0,10,10,16,17,33,55,38,93,0.000333,0.156376,16,7506.05845,417.003247,469.128653,133.486868,3,0
0,0,15,15,17,22,39,86,64,150,0.000333,0.26427,16,12684.96533,704.720296,792.810333,167.594364,3,0
0,0,15,15,17,21,38,76,55,131,0.000333,0.22916,16,10999.65607,611.092004,687.478504,161.725534,3,0
0,0,12,12,16,20,36,66,47,113,0.000333,0.194734,16,9347.224403,519.290245,584.201525,150.438562,3,0
0,0,4,4,9,7,16,20,14,34,0.000333,0.045333,8,1088,60.444444,136,48.180809,2,0
0,0,7,7,15,15,30,37,29,66,0.000333,0.107952,7,2266.983455,125.943525,323.854779,117.206718,2,0
0,0,7,7,14,15,29,36,29,65,0.000333,0.105256,7,2210.381353,122.798964,315.768765,111.906328,2,0
0,0,12,12,15,20,35,67,55,122,0.000333,0.208591,14,8760.815393,486.711966,625.772528,145.041921,2,0
0,0,12,12,15,19,34,57,46,103,0.000333,0.17467,14,7336.121417,407.562301,524.008673,139.313982,2,0
0,0,9,9,14,19,33,47,38,85,0.000333,0.142925,14,6002.829002,333.4905,428.7735,134.013592,2,0
0,0,4,4,9,7,16,20,14,34,0.000333,0.045333,8,1088,60.444444,136,48.180809,2,0
0,0,6,6,16,16,32,39,27,66,0.000333,0.11,8,2640,146.666667,330,128,3,0
0,0,6,6,15,16,31,38,27,65,0.000333,0.107341,7,2254.159321,125.231073,322.02276,122.603359,3,0
0,0,13,13,16,22,38,76,58,134,0.000333,0.234407,16,11251.55659,625.086477,703.222287,162.107496,3,0
0,0,13,13,16,20,36,66,49,115,0.000333,0.19818,16,9512.662003,528.481222,594.541375,150.438562,3,0
0,0,10,10,15,19,34,56,41,97,0.000333,0.164495,14,6908.774538,383.820808,493.483896,139.313982,3,0
0,0,4,4,9,7,16,20,14,34,0.000333,0.045333,8,1088,60.444444,136,48.180809,2,0
0,0,6,6,13,11,24,29,21,50,0.000333,0.076416,6,1375.48875,76.416042,229.248125,86.159464,2,0
0,0,6,6,12,11,23,28,21,49,0.000333,0.073885,6,1329.927215,73.884845,221.654536,81.073298,2,0
0,0,11,11,13,17,30,59,47,106,0.000333,0.173377,12,6241.564838,346.753602,520.130403,117.592585,2,0
0,0,11,11,13,15,28,49,38,87,0.000333,0.139413,12,5018.878539,278.826585,418.239878,106.709075,2,0
0,0,8,8,12,15,27,39,30,69,0.000333,0.109362,12,3937.046852,218.724825,328.087238,101.622909,2,0
0,0,4,4,9,7,16,20,14,34,0.000333,0.045333,8,1088,60.444444,136,48.180809,2,0
0,0,5,5,13,10,23,32,18,50,0.000333,0.075393,6,1357.068587,75.392699,226.178098,81.324997,2,0
0,0,5,5,13,10,23,32,18,50,0.000333,0.075393,6,1357.068587,75.392699,226.178098,81.324997,2,0
0,0,12,12,16,19,35,70,52,122,0.000333,0.208591,16,10012.36045,556.242247,625.772528,144.710623,2,0
0,0,12,12,16,17,33,60,43,103,0.000333,0.173191,16,8313.161509,461.842306,519.572594,133.486868,2,0
0,0,9,9,15,17,32,50,35,85,0.000333,0.141667,14,5950,330.555556,425,128.090227,2,0
0,0,8,8,12,14,26,48,38,86,0.000333,0.134746,12,4850.853789,269.491877,404.237816,96.322519,1,0
0,0,8,8,13,11,24,40,34,74,0.000333,0.113096,18,6107.170051,339.287225,339.287225,86.159464,1,0
0,0,9,9,12,14,26,52,41,93,0.000333,0.145714,12,5245.690725,291.427263,437.140894,96.322519,1,0
0,0,11,11,10,13,23,39,29,68,0.000333,0.102534,10,3076.02213,170.890118,307.602213,81.324997,2,0
0,0,16,16,17,22,39,66,50,116,0.000333,0.204369,16,9809.706518,544.983695,613.106657,167.594364,5,0
0,0,16,16,18,24,42,68,52,120,0.000333,0.215693,18,11647.40563,647.078091,647.078091,185.09775,5,0
0,0,11,11,11,15,26,41,31,72,0.000333,0.112811,10,3384.316597,188.017589,338.43166,96.657107,2,0
0,0,16,16,17,24,41,67,52,119,0.000333,0.212516,16,10200.77902,566.709945,637.548689,179.525968,5,0
0,0,11,11,10,15,25,40,31,71,0.000333,0.109905,10,3297.137895,183.174327,329.713789,91.82264,2,0
0,0,21,21,17,29,46,96,78,174,0.000333,0.320367,16,15377.59649,854.310916,961.09978,210.368317,5,0
0,0,16,16,13,21,34,69,57,126,0.000333,0.213673,12,7692.243816,427.346879,641.020318,140.344382,2,0
0,0,6,6,11,15,26,29,22,51,0.000333,0.079907,5,1198.612128,66.589563,239.722426,96.657107,1,0
0,0,13,13,12,23,35,66,53,119,0.000333,0.203462,12,7324.616148,406.923119,610.384679,147.061475,1,0
0,0,21,21,17,28,45,86,69,155,0.000333,0.283746,16,13619.79568,756.655315,851.23723,204.092806,5,0
0,0,16,16,11,19,30,59,48,107,0.000333,0.175012,10,5250.372937,291.687385,525.037294,118.764371,2,0
0,0,6,6,10,15,25,28,22,50,0.000333,0.077398,5,1160.964047,64.498003,232.192809,91.82264,1,0
0,0,13,13,12,21,33,56,44,100,0.000333,0.168146,12,6053.272943,336.292941,504.439412,135.258216,1,0
0,0,21,21,16,28,44,89,71,160,0.000333,0.29117,16,13976.14494,776.452497,873.509059,198.605938,5,0
0,0,16,16,12,20,32,62,50,112,0.000333,0.186667,12,6720,373.333333,560,129.458112,2,0
0,0,6,6,11,16,27,30,23,53,0.000333,0.084003,5,1260.045188,70.00251,252.009038,102.053748,1,0
0,0,10,10,11,21,32,47,36,83,0.000333,0.138333,5,2075,115.277778,415,130.292414,1,0
0,0,11,11,10,13,23,39,29,68,0.000333,0.102534,10,3076.02213,170.890118,307.602213,81.324997,2,0
0,0,13,13,15,19,34,57,42,99,0.000333,0.167886,14,7051.223498,391.734639,503.658821,139.313982,4,0
0,0,6,6,8,10,18,26,18,44,0.000333,0.061159,4,733.9068,40.7726,183.4767,57.219281,1,0
0,0,6,6,8,10,18,26,18,44,0.000333,0.061159,4,733.9068,40.7726,183.4767,57.219281,1,0
0,0,13,13,16,21,37,59,44,103,0.000333,0.178858,16,8585.179147,476.954397,536.573697,156.238666,4,0
0,0,11,11,11,15,26,41,31,72,0.000333,0.112811,10,3384.316597,188.017589,338.43166,96.657107,2,0
0,0,5,5,7,9,16,23,14,37,0.000333,0.049333,3,444,24.666667,148,48.180809,1,0
0,0,10,10,13,19,32,48,35,83,0.000333,0.138333,6,2490,138.333333,415,128.816339,2,0
0,0,13,13,15,21,36,58,44,102,0.000333,0.175777,14,7382.652902,410.147383,527.33235,150.842025,4,0
0,0,11,11,10,15,25,40,31,71,0.000333,0.109905,10,3297.137895,183.174327,329.713789,91.82264,2,0
0,0,10,10,12,19,31,47,35,82,0.000333,0.135415,6,2437.464585,135.414699,406.244097,123.730173,2,0
0,0,7,7,8,13,21,30,22,52,0.000333,0.076134,4,913.602024,50.755668,228.400506,72.105716,1,0
0,0,18,18,15,27,42,87,70,157,0.000333,0.282198,14,11852.3137,658.461872,846.593835,186.985321,4,0
0,0,16,16,13,21,34,69,57,126,0.000333,0.213673,12,7692.243816,427.346879,641.020318,140.344382,2,0
0,0,6,6,11,15,26,29,22,51,0.000333,0.079907,5,1198.612128,66.589563,239.722426,96.657107,1,0
0,0,15,15,14,25,39,76,61,137,0.000333,0.241367,14,10137.40146,563.18897,724.100104,169.399374,2,0
0,0,18,18,15,25,40,77,61,138,0.000333,0.244809,14,10281.96508,571.220282,734.426077,174.699764,4,0
0,0,16,16,11,19,30,59,48,107,0.000333,0.175012,10,5250.372937,291.687385,525.037294,118.764371,2,0
0,0,6,6,10,15,25,28,22,50,0.000333,0.077398,5,1160.964047,64.498003,232.192809,91.82264,1,0
0,0,15,15,14,23,37,66,52,118,0.000333,0.204905,14,8606.01696,478.112053,614.715497,157.344894,2,0
0,0,18,18,14,26,40,80,63,143,0.000333,0.253679,14,10654.50005,591.916669,761.035718,175.514402,4,0
0,0,16,16,12,20,32,62,50,112,0.000333,0.186667,12,6720,373.333333,560,129.458112,2,0
0,0,12,12,13,23,36,57,44,101,0.000333,0.174054,6,3132.974551,174.054142,522.162425,152.147641,2,0
0,0,6,6,11,16,27,30,23,53,0.000333,0.084003,5,1260.045188,70.00251,252.009038,102.053748,1,0
0,0,11,11,13,15,28,46,32,78,0.000333,0.124991,12,4499.684207,249.982456,374.973684,106.709075,3,0
0,0,11,11,10,13,23,39,29,68,0.000333,0.102534,10,3076.02213,170.890118,307.602213,81.324997,2,0
0,0,6,6,8,10,18,26,18,44,0.000333,0.061159,4,733.9068,40.7726,183.4767,57.219281,1,0
0,0,6,6,8,10,18,26,18,44,0.000333,0.061159,4,733.9068,40.7726,183.4767,57.219281,1,0
0,0,11,11,11,15,26,41,31,72,0.000333,0.112811,10,3384.316597,188.017589,338.43166,96.657107,2,0
0,0,11,11,14,17,31,48,34,82,0.000333,0.135415,14,5687.417364,315.967631,406.244097,122.789837,3,0
0,0,5,5,7,9,16,23,14,37,0.000333,0.049333,3,444,24.666667,148,48.180809,1,0
0,0,8,8,10,15,25,37,25,62,0.000333,0.095973,5,1439.595419,79.977523,287.919084,91.82264,1,0
0,0,4,4,7,8,15,21,12,33,0.000333,0.042976,3,386.782169,21.487898,128.92739,43.651484,1,0
0,0,4,4,7,8,15,21,12,33,0.000333,0.042976,3,386.782169,21.487898,128.92739,43.651484,1,0
0,0,10,10,9,15,24,46,33,79,0.000333,0.120737,8,2897.6963,160.983128,362.212038,87.132684,1,0
0,0,9,9,8,14,22,35,29,64,0.000333,0.095135,8,2283.228989,126.846055,285.403624,77.302969,1,0
0,0,4,4,7,8,15,21,12,33,0.000333,0.042976,3,386.782169,21.487898,128.92739,43.651484,1,0
0,0,4,4,7,8,15,21,12,33,0.000333,0.042976,3,386.782169,21.487898,128.92739,43.651484,1,0
0,0,14,14,16,23,39,73,56,129,0.000333,0.227272,16,10909.07018,606.059454,681.816886,168.041925,3,0
0,0,14,14,12,20,32,61,52,113,0.000333,0.188333,12,6780,376.666667,565,129.458112,1,0
0,0,4,4,7,8,15,21,12,33,0.000333,0.042976,3,386.782169,21.487898,128.92739,43.651484,1,0
0,0,4,4,7,8,15,21,12,33,0.000333,0.042976,3,386.782169,21.487898,128.92739,43.651484,1,0
0,0,14,14,14,21,35,63,47,110,0.000333,0.188074,14,7899.095846,438.838658,564.221132,145.541635,3,0
0,0,14,14,10,18,28,51,43,94,0.000333,0.15063,10,4518.913627,251.050757,451.891363,108.277931,1,0
0,0,4,4,7,8,15,21,12,33,0.000333,0.042976,3,386.782169,21.487898,128.92739,43.651484,1,0
0,0,4,4,7,8,15,21,12,33,0.000333,0.042976,3,386.782169,21.487898,128.92739,43.651484,1,0
0,0,11,11,15,21,36,54,39,93,0.000333,0.160268,7,3365.621176,186.978954,480.803025,150.842025,3,0
0,0,14,14,11,19,30,54,45,99,0.000333,0.161927,10,4857.82169,269.878983,485.782169,118.764371,1,0
0,0,4,4,7,8,15,21,12,33,0.000333,0.042976,3,386.782169,21.487898,128.92739,43.651484,1,0
0,0,4,4,7,8,15,21,12,33,0.000333,0.042976,3,386.782169,21.487898,128.92739,43.651484,1,0
0,0,11,11,10,13,23,39,29,68,0.000333,0.102534,10,3076.02213,170.890118,307.602213,81.324997,2,0
0,0,16,16,17,22,39,66,50,116,0.000333,0.204369,16,9809.706518,544.983695,613.106657,167.594364,5,0
0,0,4,4,7,8,15,21,12,33,0.000333,0.042976,3,386.782169,21.487898,128.92739,43.651484,1,0
0,0,4,4,7,8,15,21,12,33,0.000333,0.042976,3,386.782169,21.487898,128.92739,43.651484,1,0
0,0,4,4,7,8,15,21,12,33,0.000333,0.042976,3,386.782169,21.487898,128.92739,43.651484,1,0
0,0,16,16,18,24,42,68,52,120,0.000333,0.215693,18,11647.40563,647.078091,647.078091,185.09775,5,0
0,0,11,11,11,15,26,41,31,72,0.000333,0.112811,10,3384.316597,188.017589,338.43166,96.657107,2,0
0,0,4,4,7,8,15,21,12,33,0.000333,0.042976,3,386.782169,21.487898,128.92739,43.651484,1,0
0,0,4,4,7,8,15,21,12,33,0.000333,0.042976,3,386.782169,21.487898,128.92739,43.651484,1,0
0,0,4,4,7,8,15,21,12,33,0.000333,0.042976,3,386.782169,21.487898,128.92739,43.651484,1,0
0,0,11,11,12,18,30,42,33,75,0.000333,0.122672,6,2208.100768,122.672265,368.016795,118.0782,3,0
0,0,15,15,15,25,40,66,51,117,0.000333,0.207555,14,8717.318219,484.295457,622.665587,174.699764,4,0
0,0,4,4,7,8,15,21,12,33,0.000333,0.042976,3,386.782169,21.487898,128.92739,43.651484,1,0
0,0,4,4,7,8,15,21,12,33,0.000333,0.042976,3,386.782169,21.487898,128.92739,43.651484,1,0
0,0,4,4,7,8,15,21,12,33,0.000333,0.042976,3,386.782169,21.487898,128.92739,43.651484,1,0
0,0,14,14,12,20,32,61,52,113,0.000333,0.188333,12,6780,376.666667,565,129.458112,1,0
0,0,20,20,17,29,46,93,76,169,0.000333,0.311161,16,14935.71153,829.761752,933.481971,210.368317,5,0
0,0,4,4,7,8,15,21,12,33,0.000333,0.042976,3,386.782169,21.487898,128.92739,43.651484,1,0
0,0,4,4,7,8,15,21,12,33,0.000333,0.042976,3,386.782169,21.487898,128.92739,43.651484,1,0
0,0,4,4,7,8,15,21,12,33,0.000333,0.042976,3,386.782169,21.487898,128.92739,43.651484,1,0
0,0,15,15,11,19,30,57,46,103,0.000333,0.16847,10,5054.097313,280.783184,505.409731,118.764371,2,0
0,0,20,20,17,28,45,84,67,151,0.000333,0.276423,16,13268.31708,737.128727,829.269818,204.092806,5,0
0,0,4,4,7,8,15,21,12,33,0.000333,0.042976,3,386.782169,21.487898,128.92739,43.651484,1,0
0,0,4,4,7,8,15,21,12,33,0.000333,0.042976,3,386.782169,21.487898,128.92739,43.651484,1,0
0,0,4,4,7,8,15,21,12,33,0.000333,0.042976,3,386.782169,21.487898,128.92739,43.651484,1,0
0,0,20,20,15,29,44,85,67,152,0.000333,0.276611,14,11617.67048,645.426138,829.833606,199.484808,4,0
0,0,15,15,13,23,36,62,50,112,0.000333,0.193011,12,6948.379202,386.021067,579.0316,152.147641,3,0
0,0,11,11,12,14,26,41,31,72,0.000333,0.112811,12,4061.179916,225.621106,338.43166,96.322519,3,0
0,0,11,11,10,13,23,39,29,68,0.000333,0.102534,10,3076.02213,170.890118,307.602213,81.324997,2,0
0,0,11,11,11,15,26,41,31,72,0.000333,0.112811,10,3384.316597,188.017589,338.43166,96.657107,2,0
0,0,11,11,13,16,29,43,33,76,0.000333,0.123069,12,4430.478668,246.137704,369.206556,112.105716,3,0
0,0,11,11,12,16,28,42,33,75,0.000333,0.120184,12,4326.61943,240.367746,360.551619,107.01955,3,0
0,0,10,10,10,15,25,41,32,73,0.000333,0.113001,10,3390.015019,188.334168,339.001502,91.82264,2,0
0,0,15,15,14,22,36,69,57,126,0.000333,0.217137,14,9119.747703,506.65265,651.41055,151.410465,3,0
0,0,15,15,13,21,34,67,55,122,0.000333,0.20689,12,7448.0456,413.780311,620.670467,140.344382,2,0
0,0,15,15,12,20,32,59,48,107,0.000333,0.178333,12,6420,356.666667,535,129.458112,3,0
0,0,15,15,11,19,30,57,46,103,0.000333,0.16847,10,5054.097313,280.783184,505.409731,118.764371,2,0
0,0,15,15,13,21,34,62,50,112,0.000333,0.189932,12,6837.550059,379.863892,569.795838,140.344382,3,0
0,0,15,15,12,20,32,60,48,108,0.000333,0.18,12,6480,360,540,129.458112,2,0
0,0,16,16,17,23,40,66,50,116,0.000333,0.205781,16,9877.498544,548.749919,617.343659,173.528793,5,0
0,0,11,11,10,13,23,39,29,68,0.000333,0.102534,10,3076.02213,170.890118,307.602213,81.324997,2,0
0,0,16,16,18,25,43,68,52,120,0.000333,0.217051,18,11720.73187,651.151771,651.151771,191.155055,5,0
0,0,11,11,11,15,26,41,31,72,0.000333,0.112811,10,3384.316597,188.017589,338.43166,96.657107,2,0
0,0,16,16,17,25,42,67,52,119,0.000333,0.213895,16,10266.97237,570.387354,641.685773,185.583273,5,0
0,0,11,11,10,15,25,40,31,71,0.000333,0.109905,10,3297.137895,183.174327,329.713789,91.82264,2,0
0,0,21,21,17,30,47,96,78,174,0.000333,0.322166,16,15463.97536,859.109742,966.49846,216.693586,5,0
0,0,16,16,13,21,34,69,57,126,0.000333,0.213673,12,7692.243816,427.346879,641.020318,140.344382,2,0
0,0,21,21,17,29,46,86,69,155,0.000333,0.285384,16,13698.43365,761.024092,856.152103,210.368317,5,0
0,0,16,16,11,19,30,59,48,107,0.000333,0.175012,10,5250.372937,291.687385,525.037294,118.764371,2,0
0,0,21,21,16,29,45,89,71,160,0.000333,0.292899,16,14059.14393,781.063551,878.696495,204.881449,5,0
0,0,16,16,12,20,32,62,50,112,0.000333,0.186667,12,6720,373.333333,560,129.458112,2,0
0,0,11,11,10,13,23,39,29,68,0.000333,0.102534,10,3076.02213,170.890118,307.602213,81.324997,2,0
0,0,13,13,15,20,35,57,42,99,0.000333,0.169266,14,7109.186261,394.954792,507.799019,145.041921,4,0
0,0,9,9,11,15,26,38,27,65,0.000333,0.101843,5,1527.642908,84.86905,305.528582,96.657107,2,0
0,0,11,11,16,22,38,56,40,96,0.000333,0.167934,8,4030.40833,223.911574,503.801041,162.107496,4,0
0,0,13,13,15,22,37,58,44,102,0.000333,0.177121,14,7439.099406,413.2833,531.364243,156.710855,4,0
0,0,11,11,10,15,25,40,31,71,0.000333,0.109905,10,3297.137895,183.174327,329.713789,91.82264,2,0
0,0,18,18,15,28,43,87,70,157,0.000333,0.283975,14,11926.92993,662.607218,851.923566,193.209297,4,0
0,0,16,16,13,21,34,69,57,126,0.000333,0.213673,12,7692.243816,427.346879,641.020318,140.344382,2,0
0,0,18,18,15,26,41,77,61,138,0.000333,0.246447,14,10350.79047,575.043915,739.342177,180.814792,4,0
0,0,16,16,11,19,30,59,48,107,0.000333,0.175012,10,5250.372937,291.687385,525.037294,118.764371,2,0
0,0,18,18,14,27,41,80,63,143,0.000333,0.255377,14,10725.81911,595.87884,766.129937,181.684931,4,0
0,0,16,16,12,20,32,62,50,112,0.000333,0.186667,12,6720,373.333333,560,129.458112,2,0
0,0,11,11,10,13,23,39,29,68,0.000333,0.102534,10,3076.02213,170.890118,307.602213,81.324997,2,0
0,0,11,11,13,15,28,46,32,78,0.000333,0.124991,12,4499.684207,249.982456,374.973684,106.709075,3,0
0,0,11,11,11,15,26,41,31,72,0.000333,0.112811,10,3384.316597,188.017589,338.43166,96.657107,2,0
0,0,11,11,14,17,31,48,34,82,0.000333,0.135415,14,5687.417364,315.967631,406.244097,122.789837,3,0
0,0,11,11,13,17,30,47,34,81,0.000333,0.132486,12,4769.497659,264.972092,397.458138,117.592585,3,0
0,0,11,11,10,15,25,40,31,71,0.000333,0.109905,10,3297.137895,183.174327,329.713789,91.82264,2,0
0,0,16,16,13,21,34,69,57,126,0.000333,0.213673,12,7692.243816,427.346879,641.020318,140.344382,2,0
0,0,16,16,16,23,39,76,60,136,0.000333,0.239605,16,11501.03523,638.946402,718.814702,168.041925,3,0
0,0,16,16,11,19,30,59,48,107,0.000333,0.175012,10,5250.372937,291.687385,525.037294,118.764371,2,0
0,0,16,16,14,21,35,66,51,117,0.000333,0.200042,14,8401.765582,466.764755,600.126113,145.541635,3,0
0,0,16,16,12,20,32,62,50,112,0.000333,0.186667,12,6720,373.333333,560,129.458112,2,0
0,0,16,16,15,22,37,69,53,122,0.000333,0.211851,14,8897.746348,494.319242,635.553311,156.710855,3,0
0,0,11,11,10,13,23,39,29,68,0.000333,0.102534,10,3076.02213,170.890118,307.602213,81.324997,2,0
0,0,16,16,17,23,40,66,50,116,0.000333,0.205781,16,9877.498544,548.749919,617.343659,173.528793,5,0
0,0,16,16,16,25,41,66,49,115,0.000333,0.205373,8,4928.947844,273.830436,616.118481,180.096405,4,0
0,0,16,16,18,25,43,68,52,120,0.000333,0.217051,18,11720.73187,651.151771,651.151771,191.155055,5,0
0,0,16,16,17,25,42,67,52,119,0.000333,0.213895,16,10266.97237,570.387354,641.685773,185.583273,5,0
0,0,11,11,10,15,25,40,31,71,0.000333,0.109905,10,3297.137895,183.174327,329.713789,91.82264,2,0
0,0,16,16,13,21,34,69,57,126,0.000333,0.213673,12,7692.243816,427.346879,641.020318,140.344382,2,0
0,0,21,21,17,30,47,96,78,174,0.000333,0.322166,16,15463.97536,859.109742,966.49846,216.693586,5,0
0,0,21,21,17,29,46,86,69,155,0.000333,0.285384,16,13698.43365,761.024092,856.152103,210.368317,5,0
0,0,16,16,11,19,30,59,48,107,0.000333,0.175012,10,5250.372937,291.687385,525.037294,118.764371,2,0
0,0,21,21,16,29,45,89,71,160,0.000333,0.292899,16,14059.14393,781.063551,878.696495,204.881449,5,0
0,0,16,16,12,20,32,62,50,112,0.000333,0.186667,12,6720,373.333333,560,129.458112,2,0
0,0,11,11,10,13,23,39,29,68,0.000333,0.102534,10,3076.02213,170.890118,307.602213,81.324997,2,0
0,0,11,11,12,14,26,41,31,72,0.000333,0.112811,12,4061.179916,225.621106,338.43166,96.322519,3,0
0,0,11,11,13,16,29,43,33,76,0.000333,0.123069,12,4430.478668,246.137704,369.206556,112.105716,3,0
0,0,11,11,11,15,26,41,31,72,0.000333,0.112811,10,3384.316597,188.017589,338.43166,96.657107,2,0
0,0,11,11,12,16,28,42,33,75,0.000333,0.120184,12,4326.61943,240.367746,360.551619,107.01955,3,0
0,0,11,11,10,15,25,40,31,71,0.000333,0.109905,10,3297.137895,183.174327,329.713789,91.82264,2,0
0,0,16,16,13,21,34,69,57,126,0.000333,0.213673,12,7692.243816,427.346879,641.020318,140.344382,2,0
0,0,16,16,14,22,36,71,59,130,0.000333,0.22403,14,9409.263503,522.736861,672.09025,151.410465,3,0
0,0,16,16,11,19,30,59,48,107,0.000333,0.175012,10,5250.372937,291.687385,525.037294,118.764371,2,0
0,0,16,16,12,20,32,61,50,111,0.000333,0.185,12,6660,370,555,129.458112,3,0
0,0,16,16,12,20,32,62,50,112,0.000333,0.186667,12,6720,373.333333,560,129.458112,2,0
0,0,16,16,13,21,34,64,52,116,0.000333,0.196715,12,7081.748275,393.43046,590.14569,140.344382,3,0
0,0,9,9,12,10,22,29,20,49,0.000333,0.072837,12,2622.145792,145.674766,218.512149,76.238831,2,0
0,0,14,14,17,19,36,56,41,97,0.000333,0.167161,16,8023.723602,445.762422,501.482725,150.197491,5,0
0,0,11,11,12,11,23,35,22,57,0.000333,0.085948,12,3094.116378,171.895354,257.843031,81.073298,4,0
0,0,16,16,17,19,36,62,43,105,0.000333,0.180947,16,8685.474002,482.526333,542.842125,150.197491,7,0
0,0,12,12,15,11,26,38,22,60,0.000333,0.094009,14,3948.369363,219.353854,282.026383,96.657107,4,0
0,0,17,17,20,19,39,65,43,108,0.000333,0.190274,20,11416.46879,634.248266,570.82344,167.149185,7,0
0,0,11,11,12,11,23,35,24,59,0.000333,0.088963,12,3202.681865,177.92677,266.890155,81.073298,4,0
0,0,16,16,17,20,37,62,45,107,0.000333,0.185804,16,8918.584162,495.476898,557.41151,155.92543,7,0
0,0,12,12,16,11,27,39,24,63,0.000333,0.099853,16,4792.926602,266.2737,299.557913,102.053748,4,0
0,0,17,17,21,20,41,66,45,111,0.000333,0.198229,20,11893.76545,660.764747,594.688273,178.677228,7,0
0,0,12,12,15,12,27,38,22,60,0.000333,0.095098,7,1997.052751,110.947375,285.29325,101.622909,4,0
0,0,16,16,17,20,37,62,43,105,0.000333,0.182331,16,8751.881654,486.215647,546.992603,155.92543,7,0
0,0,11,11,12,11,23,35,22,57,0.000333,0.085948,12,3094.116378,171.895354,257.843031,81.073298,4,0
0,0,17,17,20,21,41,65,43,108,0.000333,0.192872,20,11572.31233,642.906241,578.615616,178.677228,7,0
0,0,12,12,15,12,27,38,22,60,0.000333,0.095098,7,1997.052751,110.947375,285.29325,101.622909,4,0
0,0,16,16,17,20,37,62,43,105,0.000333,0.182331,16,8751.881654,486.215647,546.992603,155.92543,7,0
0,0,11,11,12,11,23,35,22,57,0.000333,0.085948,12,3094.116378,171.895354,257.843031,81.073298,4,0
0,0,17,17,20,21,41,65,43,108,0.000333,0.192872,20,11572.31233,642.906241,578.615616,178.677228,7,0
0,0,16,16,17,21,38,62,45,107,0.000333,0.187176,16,8984.451903,499.136217,561.528244,161.725534,7,0
0,0,12,12,16,12,28,39,24,63,0.000333,0.100954,16,4845.813761,269.211876,302.86336,107.01955,4,0
0,0,17,17,21,21,42,66,45,111,0.000333,0.199516,20,11970.94468,665.052482,598.547234,184.477332,7,0
0,0,11,11,12,12,24,35,24,59,0.000333,0.090171,12,3246.153451,180.341858,270.512788,86.0391,4,0
0,0,16,16,17,21,38,62,45,107,0.000333,0.187176,16,8984.451903,499.136217,561.528244,161.725534,7,0
0,0,12,12,16,12,28,39,24,63,0.000333,0.100954,16,4845.813761,269.211876,302.86336,107.01955,4,0
0,0,17,17,21,21,42,66,45,111,0.000333,0.199516,20,11970.94468,665.052482,598.547234,184.477332,7,0
0,0,11,11,12,12,24,35,24,59,0.000333,0.090171,12,3246.153451,180.341858,270.512788,86.0391,4,0
0,0,17,17,20,21,41,65,43,108,0.000333,0.192872,20,11572.31233,642.906241,578.615616,178.677228,7,0
0,0,16,16,17,20,37,62,43,105,0.000333,0.182331,16,8751.881654,486.215647,546.992603,155.92543,7,0
0,0,12,12,15,12,27,38,22,60,0.000333,0.095098,7,1997.052751,110.947375,285.29325,101.622909,4,0
0,0,11,11,12,11,23,35,22,57,0.000333,0.085948,12,3094.116378,171.895354,257.843031,81.073298,4,0
0,0,11,11,12,11,23,35,22,57,0.000333,0.085948,12,3094.116378,171.895354,257.843031,81.073298,4,0
0,0,16,16,17,20,37,62,43,105,0.000333,0.182331,16,8751.881654,486.215647,546.992603,155.92543,7,0
0,0,12,12,15,12,27,38,22,60,0.000333,0.095098,7,1997.052751,110.947375,285.29325,101.622909,4,0
0,0,17,17,20,21,41,65,43,108,0.000333,0.192872,20,11572.31233,642.906241,578.615616,178.677228,7,0
0,0,11,11,12,11,23,35,22,57,0.000333,0.085948,12,3094.116378,171.895354,257.843031,81.073298,4,0
0,0,16,16,17,20,37,62,43,105,0.000333,0.182331,16,8751.881654,486.215647,546.992603,155.92543,7,0
0,0,12,12,15,12,27,38,22,60,0.000333,0.095098,7,1997.052751,110.947375,285.29325,101.622909,4,0
0,0,17,17,20,21,41,65,43,108,0.000333,0.192872,20,11572.31233,642.906241,578.615616,178.677228,7,0
0,0,11,11,12,11,23,35,22,57,0.000333,0.085948,12,3094.116378,171.895354,257.843031,81.073298,4,0
0,0,12,12,15,12,27,38,22,60,0.000333,0.095098,7,1997.052751,110.947375,285.29325,101.622909,4,0
0,0,16,16,17,20,37,62,43,105,0.000333,0.182331,16,8751.881654,486.215647,546.992603,155.92543,7,0
0,0,17,17,20,21,41,65,43,108,0.000333,0.192872,20,11572.31233,642.906241,578.615616,178.677228,7,0
0,0,11,11,12,12,24,35,24,59,0.000333,0.090171,12,3246.153451,180.341858,270.512788,86.0391,4,0
0,0,12,12,16,12,28,39,24,63,0.000333,0.100954,16,4845.813761,269.211876,302.86336,107.01955,4,0
0,0,16,16,17,21,38,62,45,107,0.000333,0.187176,16,8984.451903,499.136217,561.528244,161.725534,7,0
0,0,17,17,21,21,42,66,45,111,0.000333,0.199516,20,11970.94468,665.052482,598.547234,184.477332,7,0
0,0,11,11,12,12,24,35,24,59,0.000333,0.090171,12,3246.153451,180.341858,270.512788,86.0391,4,0
0,0,12,12,16,12,28,39,24,63,0.000333,0.100954,16,4845.813761,269.211876,302.86336,107.01955,4,0
0,0,16,16,17,21,38,62,45,107,0.000333,0.187176,16,8984.451903,499.136217,561.528244,161.725534,7,0
0,0,17,17,21,21,42,66,45,111,0.000333,0.199516,20,11970.94468,665.052482,598.547234,184.477332,7,0
0,0,22,22,21,22,43,76,47,123,0.000333,0.222477,20,13348.6113,741.589516,667.430565,190.346161,7,0
0,0,25,25,21,23,44,84,49,133,0.000333,0.242035,20,14522.08811,806.782673,726.104405,196.280591,7,0
0,0,17,17,17,13,30,49,26,75,0.000333,0.122672,16,5888.268715,327.12604,368.016795,117.592585,4,0
0,0,17,17,17,14,31,49,26,75,0.000333,0.123855,8,2972.517786,165.139877,371.564723,122.789837,4,0
0,0,13,13,14,11,25,39,22,61,0.000333,0.094425,14,3965.853186,220.325177,283.275228,91.356717,4,0
0,0,18,18,18,19,37,66,43,109,0.000333,0.189277,18,10220.9475,567.830417,567.830417,155.769273,7,0
0,0,11,11,15,13,28,45,30,75,0.000333,0.120184,14,5047.722668,280.429037,360.551619,106.709075,4,0
0,0,16,16,19,21,40,72,51,123,0.000333,0.218199,18,11782.7488,654.597156,654.597156,172.949289,7,0
0,0,18,18,19,21,40,62,45,107,0.000333,0.189815,18,10250.03351,569.446306,569.446306,172.949289,5,0
0,0,13,13,14,12,26,35,24,59,0.000333,0.092442,14,3882.563207,215.697956,277.325943,96.322519,2,0
0,0,18,18,18,24,42,67,58,125,0.000333,0.22468,18,12132.7142,674.039678,674.039678,185.09775,6,0
0,0,13,13,13,15,28,40,33,73,0.000333,0.116979,12,4211.242912,233.95794,350.936909,106.709075,3,0
0,0,19,19,21,24,45,70,58,128,0.000333,0.234319,20,14059.14393,781.063551,702.957196,202.277766,6,0
0,0,19,19,20,24,44,69,58,127,0.000333,0.231116,20,13866.95631,770.386462,693.347816,196.477662,6,0
0,0,18,18,17,24,41,66,58,124,0.000333,0.221445,16,10629.38318,590.521288,664.336449,179.525968,6,0
0,0,13,13,12,16,28,39,37,76,0.000333,0.121786,12,4384.307689,243.572649,365.358974,107.01955,3,0
0,0,11,11,12,11,23,33,26,59,0.000333,0.088963,12,3202.681865,177.92677,266.890155,81.073298,2,0
0,0,17,17,17,20,37,65,50,115,0.000333,0.199696,16,9585.394193,532.5219,599.087137,155.92543,5,0
0,0,14,14,13,12,25,46,34,80,0.000333,0.123836,12,4458.101942,247.67233,371.508495,91.125266,2,0
0,0,19,19,18,21,39,73,55,128,0.000333,0.22551,18,12177.56671,676.531484,676.531484,167.297316,5,0
0,0,11,11,13,11,24,34,26,60,0.000333,0.091699,12,3301.173001,183.3985,275.09775,86.159464,2,0
0,0,16,16,18,20,38,61,47,108,0.000333,0.188925,18,10201.97109,566.776171,566.776171,161.497212,5,0
0,0,12,12,13,14,27,36,29,65,0.000333,0.103023,12,3708.812252,206.045125,309.067688,101.408685,2,0
0,0,17,17,18,23,41,63,50,113,0.000333,0.201801,18,10897.26078,605.403377,605.403377,179.100575,5,0
0,0,16,16,18,22,40,62,49,111,0.000333,0.196911,18,10633.21233,590.734019,590.734019,173.166146,5,0
0,0,11,11,13,13,26,35,28,63,0.000333,0.098709,12,3553.532427,197.418468,296.127702,96.211433,2,0
0,0,12,12,14,12,26,38,30,68,0.000333,0.106543,14,4474.818612,248.601034,319.629901,96.322519,2,0
0,0,17,17,19,21,40,65,51,116,0.000333,0.205781,18,11112.18586,617.343659,617.343659,172.949289,5,0
0,0,16,16,19,22,41,63,49,112,0.000333,0.200015,18,10800.82484,600.045825,600.045825,178.818118,5,0
0,0,11,11,14,13,27,36,28,64,0.000333,0.101438,14,4260.379202,236.687733,304.3128,101.408685,2,0
0,0,12,12,13,14,27,42,32,74,0.000333,0.117287,12,4222.340102,234.57445,351.861675,101.408685,2,0
0,0,17,17,18,23,41,69,53,122,0.000333,0.217874,18,11765.1842,653.621345,653.621345,179.100575,5,0
0,0,13,13,13,14,27,35,32,67,0.000333,0.106192,12,3822.929552,212.384975,318.577463,101.408685,2,0
0,0,18,18,18,23,41,62,53,115,0.000333,0.205373,18,11090.13265,616.118481,616.118481,179.100575,5,0
0,0,11,11,12,13,25,34,28,62,0.000333,0.095973,12,3455.029005,191.946056,287.919084,91.125266,2,0
0,0,16,16,17,22,39,61,49,110,0.000333,0.193798,16,9302.307905,516.794884,581.394244,167.594364,5,0
0,0,13,13,12,14,26,39,36,75,0.000333,0.117511,12,4230.395746,235.021986,352.532979,96.322519,2,0
0,0,18,18,17,23,40,66,57,123,0.000333,0.218199,16,10473.55449,581.864138,654.597156,173.528793,5,0
0,0,15,15,12,15,27,44,44,88,0.000333,0.139477,12,5021.161202,278.9534,418.4301,101.622909,2,0
0,0,20,20,17,24,41,71,65,136,0.000333,0.242876,16,11658.03316,647.668509,728.627073,179.525968,5,0
0,0,17,17,12,16,28,49,52,101,0.000333,0.161848,18,8739.771248,485.542847,485.542847,107.01955,2,0
0,0,22,22,17,25,42,76,73,149,0.000333,0.267818,16,12855.28474,714.182485,803.455296,185.583273,5,0
0,0,17,17,18,21,39,64,51,115,0.000333,0.202607,18,10940.78259,607.821255,607.821255,167.297316,5,0
0,0,12,12,13,12,25,37,30,67,0.000333,0.103713,12,3733.660377,207.425576,311.138365,91.125266,2,0
0,0,16,16,18,22,40,62,49,111,0.000333,0.196911,18,10633.21233,590.734019,590.734019,173.166146,5,0
0,0,11,11,13,13,26,35,28,63,0.000333,0.098709,12,3553.532427,197.418468,296.127702,96.211433,2,0
0,0,17,17,18,23,41,66,52,118,0.000333,0.21073,18,11379.44046,632.191137,632.191137,179.100575,5,0
0,0,12,12,13,14,27,39,31,70,0.000333,0.110947,12,3994.105502,221.89475,332.842125,101.408685,2,0
0,0,18,18,18,24,42,74,56,130,0.000333,0.233667,18,12618.02277,701.001265,701.001265,185.09775,5,0
0,0,13,13,13,15,28,47,35,82,0.000333,0.131401,12,4730.437243,262.802069,394.203104,106.709075,2,0
0,0,17,17,17,23,40,68,53,121,0.000333,0.214651,16,10303.25279,572.402933,643.953299,173.528793,5,0
0,0,12,12,12,14,26,41,32,73,0.000333,0.114377,12,4117.585193,228.754733,343.132099,96.322519,2,0
0,0,19,19,17,25,42,74,59,133,0.000333,0.239059,16,11474.85148,637.491749,717.178217,185.583273,5,0
0,0,14,14,12,16,28,47,38,85,0.000333,0.136208,12,4903.50202,272.416779,408.625168,107.01955,2,0
0,0,19,19,18,25,43,68,58,126,0.000333,0.227903,18,12306.76846,683.709359,683.709359,191.155055,5,0
0,0,14,14,13,16,29,41,37,78,0.000333,0.126308,12,4547.070211,252.615012,378.922518,112.105716,2,0
0,0,18,18,17,23,40,61,53,114,0.000333,0.202233,16,9707.196845,539.288714,606.699803,173.528793,5,0
0,0,13,13,12,14,26,34,32,66,0.000333,0.10341,12,3722.748257,206.819348,310.229021,96.322519,2,0
0,0,21,21,18,27,45,91,75,166,0.000333,0.303883,18,16409.65705,911.647614,911.647614,203.440613,5,0
0,0,16,16,14,19,33,64,54,118,0.000333,0.198413,14,8333.339085,462.963283,595.238506,134.013592,2,0
0,0,21,21,18,26,44,81,66,147,0.000333,0.267512,18,14445.65606,802.536448,802.536448,197.270083,5,0
0,0,16,16,14,17,31,54,45,99,0.000333,0.163488,14,6866.516086,381.473116,490.465435,122.789837,2,0
0,0,21,21,17,26,43,84,68,152,0.000333,0.274931,16,13196.67588,733.14866,824.792243,191.698301,5,0
0,0,16,16,13,18,31,57,47,104,0.000333,0.171745,12,6182.836995,343.490944,515.236416,123.164366,2,0
0,0,11,11,15,16,31,47,33,80,0.000333,0.132112,14,5548.699868,308.261104,396.335705,122.603359,4,0
0,0,9,9,12,10,22,29,20,49,0.000333,0.072837,12,2622.145792,145.674766,218.512149,76.238831,2,0
0,0,13,13,15,17,32,53,35,88,0.000333,0.146667,14,6160,342.222222,440,128.090227,6,0
0,0,12,12,15,11,26,38,22,60,0.000333,0.094009,14,3948.369363,219.353854,282.026383,96.657107,4,0
0,0,11,11,12,11,23,35,22,57,0.000333,0.085948,12,3094.116378,171.895354,257.843031,81.073298,4,0
0,0,14,14,18,17,35,56,35,91,0.000333,0.155588,18,8401.765582,466.764755,466.764755,144.545518,6,0
0,0,13,13,15,17,32,53,37,90,0.000333,0.15,14,6300,350,450,128.090227,6,0
0,0,12,12,16,11,27,39,24,63,0.000333,0.099853,16,4792.926602,266.2737,299.557913,102.053748,4,0
0,0,11,11,12,11,23,35,24,59,0.000333,0.088963,12,3202.681865,177.92677,266.890155,81.073298,4,0
0,0,14,14,18,17,35,57,37,94,0.000333,0.160718,18,8678.746865,482.152604,482.152604,144.545518,6,0
0,0,13,13,15,17,32,53,35,88,0.000333,0.146667,14,6160,342.222222,440,128.090227,6,0
0,0,12,12,15,12,27,38,22,60,0.000333,0.095098,7,1997.052751,110.947375,285.29325,101.622909,4,0
0,0,11,11,12,11,23,35,22,57,0.000333,0.085948,12,3094.116378,171.895354,257.843031,81.073298,4,0
0,0,14,14,18,18,36,56,35,91,0.000333,0.156821,9,4234.168576,235.231588,470.463175,150.1173,6,0
0,0,13,13,15,17,32,53,35,88,0.000333,0.146667,14,6160,342.222222,440,128.090227,6,0
0,0,12,12,15,12,27,38,22,60,0.000333,0.095098,7,1997.052751,110.947375,285.29325,101.622909,4,0
0,0,11,11,12,11,23,35,22,57,0.000333,0.085948,12,3094.116378,171.895354,257.843031,81.073298,4,0
0,0,14,14,18,18,36,56,35,91,0.000333,0.156821,9,4234.168576,235.231588,470.463175,150.1173,6,0
0,0,11,11,12,12,24,35,24,59,0.000333,0.090171,12,3246.153451,180.341858,270.512788,86.0391,4,0
0,0,13,13,15,18,33,53,37,90,0.000333,0.151332,14,6355.93659,353.107588,453.995471,133.662009,6,0
0,0,14,14,18,18,36,57,37,94,0.000333,0.161991,18,8747.513102,485.97295,485.97295,150.1173,6,0
0,0,12,12,16,12,28,39,24,63,0.000333,0.100954,16,4845.813761,269.211876,302.86336,107.01955,4,0
0,0,11,11,12,12,24,35,24,59,0.000333,0.090171,12,3246.153451,180.341858,270.512788,86.0391,4,0
0,0,13,13,15,18,33,53,37,90,0.000333,0.151332,14,6355.93659,353.107588,453.995471,133.662009,6,0
0,0,14,14,18,18,36,57,37,94,0.000333,0.161991,18,8747.513102,485.97295,485.97295,150.1173,6,0
0,0,12,12,16,12,28,39,24,63,0.000333,0.100954,16,4845.813761,269.211876,302.86336,107.01955,4,0
0,0,11,11,12,11,23,35,22,57,0.000333,0.085948,12,3094.116378,171.895354,257.843031,81.073298,4,0
0,0,13,13,15,17,32,53,35,88,0.000333,0.146667,14,6160,342.222222,440,128.090227,6,0
0,0,14,14,18,18,36,56,35,91,0.000333,0.156821,9,4234.168576,235.231588,470.463175,150.1173,6,0
0,0,12,12,15,12,27,38,22,60,0.000333,0.095098,7,1997.052751,110.947375,285.29325,101.622909,4,0
0,0,13,13,15,17,32,53,35,88,0.000333,0.146667,14,6160,342.222222,440,128.090227,6,0
0,0,12,12,15,12,27,38,22,60,0.000333,0.095098,7,1997.052751,110.947375,285.29325,101.622909,4,0
0,0,11,11,12,11,23,35,22,57,0.000333,0.085948,12,3094.116378,171.895354,257.843031,81.073298,4,0
0,0,14,14,18,18,36,56,35,91,0.000333,0.156821,9,4234.168576,235.231588,470.463175,150.1173,6,0
0,0,13,13,15,17,32,53,35,88,0.000333,0.146667,14,6160,342.222222,440,128.090227,6,0
0,0,12,12,15,12,27,38,22,60,0.000333,0.095098,7,1997.052751,110.947375,285.29325,101.622909,4,0
0,0,11,11,12,11,23,35,22,57,0.000333,0.085948,12,3094.116378,171.895354,257.843031,81.073298,4,0
0,0,14,14,18,18,36,56,35,91,0.000333,0.156821,9,4234.168576,235.231588,470.463175,150.1173,6,0
0,0,12,12,15,12,27,38,22,60,0.000333,0.095098,7,1997.052751,110.947375,285.29325,101.622909,4,0
0,0,11,11,12,11,23,35,22,57,0.000333,0.085948,12,3094.116378,171.895354,257.843031,81.073298,4,0
0,0,13,13,15,17,32,53,35,88,0.000333,0.146667,14,6160,342.222222,440,128.090227,6,0
0,0,14,14,18,18,36,56,35,91,0.000333,0.156821,9,4234.168576,235.231588,470.463175,150.1173,6,0
0,0,12,12,16,12,28,39,24,63,0.000333,0.100954,16,4845.813761,269.211876,302.86336,107.01955,4,0
0,0,11,11,12,12,24,35,24,59,0.000333,0.090171,12,3246.153451,180.341858,270.512788,86.0391,4,0
0,0,13,13,15,18,33,53,37,90,0.000333,0.151332,14,6355.93659,353.107588,453.995471,133.662009,6,0
0,0,14,14,18,18,36,57,37,94,0.000333,0.161991,18,8747.513102,485.97295,485.97295,150.1173,6,0
0,0,12,12,16,12,28,39,24,63,0.000333,0.100954,16,4845.813761,269.211876,302.86336,107.01955,4,0
0,0,11,11,12,12,24,35,24,59,0.000333,0.090171,12,3246.153451,180.341858,270.512788,86.0391,4,0
0,0,13,13,15,18,33,53,37,90,0.000333,0.151332,14,6355.93659,353.107588,453.995471,133.662009,6,0
0,0,14,14,18,18,36,57,37,94,0.000333,0.161991,18,8747.513102,485.97295,485.97295,150.1173,6,0
0,0,17,17,17,13,30,49,26,75,0.000333,0.122672,16,5888.268715,327.12604,368.016795,117.592585,4,0
0,0,17,17,17,14,31,49,26,75,0.000333,0.123855,8,2972.517786,165.139877,371.564723,122.789837,4,0
0,0,19,19,20,19,39,67,39,106,0.000333,0.186751,20,11205.0527,622.502928,560.252635,167.149185,6,0
0,0,22,22,20,20,40,75,41,116,0.000333,0.205781,20,12346.87318,685.937399,617.343659,172.877124,6,0
0,0,4,4,7,6,13,12,9,21,0.000333,0.025903,3,233.127702,12.951539,77.709234,35.161259,1,0
0,0,6,6,9,8,17,22,17,39,0.000333,0.053137,8,1275.288406,70.849356,159.411051,52.529325,1,0
0,0,5,5,7,7,14,14,11,25,0.000333,0.031728,3,285.551619,15.863979,95.183873,39.302969,1,0
0,0,7,7,9,9,18,24,19,43,0.000333,0.059769,8,1434.4542,79.6919,179.306775,57.05865,1,0
0,0,3,3,6,3,9,10,5,15,0.000333,0.01585,3,142.646625,7.924813,47.548875,20.264663,1,0
0,0,5,5,8,6,14,20,12,32,0.000333,0.040612,8,974.68286,54.149048,121.835358,39.509775,1,0
0,0,3,3,5,2,7,8,4,12,0.000333,0.011229,4,134.753036,7.48628,33.688259,13.60964,1,0
0,0,3,3,5,2,7,8,4,12,0.000333,0.011229,4,134.753036,7.48628,33.688259,13.60964,1,0
0,0,3,3,6,3,9,10,5,15,0.000333,0.01585,3,142.646625,7.924813,47.548875,20.264663,1,0
0,0,5,5,8,6,14,20,12,32,0.000333,0.040612,8,974.68286,54.149048,121.835358,39.509775,1,0
0,0,3,3,5,2,7,8,4,12,0.000333,0.011229,4,134.753036,7.48628,33.688259,13.60964,1,0
0,0,3,3,5,2,7,8,4,12,0.000333,0.011229,4,134.753036,7.48628,33.688259,13.60964,1,0
0,0,3,3,5,2,7,8,4,12,0.000333,0.011229,4,134.753036,7.48628,33.688259,13.60964,1,0
0,0,5,5,7,6,13,15,11,26,0.000333,0.03207,3,288.634298,16.035239,96.211433,35.161259,1,0
0,0,5,5,7,6,13,15,11,26,0.000333,0.03207,3,288.634298,16.035239,96.211433,35.161259,1,0
0,0,6,6,7,7,14,17,13,30,0.000333,0.038074,3,342.661943,19.036775,114.220648,39.302969,1,0
0,0,6,6,7,7,14,17,13,30,0.000333,0.038074,3,342.661943,19.036775,114.220648,39.302969,1,0
0,0,6,6,7,7,14,17,13,30,0.000333,0.038074,3,342.661943,19.036775,114.220648,39.302969,1,0
0,0,6,6,7,7,14,17,13,30,0.000333,0.038074,3,342.661943,19.036775,114.220648,39.302969,1,0
0,0,4,4,9,7,16,20,14,34,0.000333,0.045333,8,1088,60.444444,136,48.180809,2,0
0,0,7,7,9,10,19,37,24,61,0.000333,0.086375,8,2072.988627,115.166035,259.123578,61.748606,2,0
0,0,5,5,13,10,23,32,18,50,0.000333,0.075393,6,1357.068587,75.392699,226.178098,81.324997,2,0
0,0,8,8,14,14,28,47,28,75,0.000333,0.120184,14,5047.722668,280.429037,360.551619,106.605938,2,0
0,0,6,6,13,11,24,33,20,53,0.000333,0.081001,6,1458.018075,81.001004,243.003013,86.159464,2,0
0,0,5,5,13,10,23,32,18,50,0.000333,0.075393,6,1357.068587,75.392699,226.178098,81.324997,2,0
0,0,8,8,14,13,27,49,28,77,0.000333,0.122042,14,5125.768727,284.764929,366.126338,101.408685,2,0
0,0,6,6,13,11,24,34,20,54,0.000333,0.082529,6,1485.52785,82.529325,247.587975,86.159464,2,0
0,0,12,12,16,19,35,70,52,122,0.000333,0.208591,16,10012.36045,556.242247,625.772528,144.710623,2,0
0,0,13,13,16,20,36,83,58,141,0.000333,0.242986,16,11663.3508,647.963934,728.959425,150.438562,2,0
0,0,13,13,16,20,36,72,54,126,0.000333,0.217137,16,10422.5688,579.0316,651.41055,150.438562,2,0
0,0,12,12,16,17,33,60,43,103,0.000333,0.173191,16,8313.161509,461.842306,519.572594,133.486868,2,0
0,0,13,13,16,18,34,73,49,122,0.000333,0.20689,16,9930.727466,551.707081,620.670467,139.05865,2,0
0,0,13,13,16,18,34,62,45,107,0.000333,0.181453,16,8709.736384,483.874244,544.358524,139.05865,2,0
0,0,9,9,15,17,32,50,35,85,0.000333,0.141667,14,5950,330.555556,425,128.090227,2,0
0,0,10,10,15,18,33,63,42,105,0.000333,0.176554,14,7415.259355,411.958853,529.661383,133.662009,2,0
0,0,10,10,15,18,33,52,37,89,0.000333,0.14965,14,6285.315073,349.184171,448.951077,133.662009,2,0
0,0,4,4,9,4,13,18,10,28,0.000333,0.034537,8,828.898497,46.049916,103.612312,36.529325,2,0
0,0,10,10,17,17,34,56,38,94,0.000333,0.159407,16,7651.544113,425.085784,478.221507,138.973737,3,0
0,0,11,11,17,18,35,68,43,111,0.000333,0.189783,16,9109.606638,506.089258,569.350415,144.545518,3,0
0,0,11,11,17,17,34,57,40,97,0.000333,0.164495,16,7895.74233,438.652352,493.483896,138.973737,3,0
0,0,10,10,16,17,33,55,38,93,0.000333,0.156376,16,7506.05845,417.003247,469.128653,133.486868,3,0
0,0,11,11,16,18,34,67,43,110,0.000333,0.18654,16,8953.934601,497.440811,559.620913,139.05865,3,0
0,0,11,11,16,17,33,56,40,96,0.000333,0.161421,16,7748.189367,430.454965,484.261835,133.486868,3,0
0,0,15,15,17,22,39,86,64,150,0.000333,0.26427,16,12684.96533,704.720296,792.810333,167.594364,3,0
0,0,16,16,17,23,40,99,70,169,0.000333,0.299802,24,21585.74035,1199.207797,899.405848,173.528793,3,0
0,0,16,16,17,23,40,87,66,153,0.000333,0.271418,16,13028.07998,723.782221,814.254999,173.528793,3,0
0,0,15,15,17,21,38,76,55,131,0.000333,0.22916,16,10999.65607,611.092004,687.478504,161.725534,3,0
0,0,16,16,17,23,40,89,62,151,0.000333,0.26787,16,12857.77828,714.321015,803.611142,173.528793,3,0
0,0,16,16,17,22,39,77,57,134,0.000333,0.236081,16,11331.90236,629.550131,708.243897,167.594364,3,0
0,0,12,12,16,20,36,66,47,113,0.000333,0.194734,16,9347.224403,519.290245,584.201525,150.438562,3,0
0,0,13,13,16,21,37,80,54,134,0.000333,0.232689,16,11169.06802,620.503779,698.066751,156.238666,3,0
0,0,13,13,16,21,37,67,49,116,0.000333,0.201432,16,9668.745447,537.152525,604.29659,156.238666,3,0
0,0,4,4,9,7,16,20,14,34,0.000333,0.045333,8,1088,60.444444,136,48.180809,2,0
0,0,7,7,9,10,19,37,24,61,0.000333,0.086375,8,2072.988627,115.166035,259.123578,61.748606,2,0
0,0,5,5,9,8,17,21,16,37,0.000333,0.050412,8,1209.889001,67.216056,151.236125,52.529325,2,0
0,0,9,9,11,13,24,40,30,70,0.000333,0.106982,10,3209.473751,178.304097,320.947375,86.159464,2,0
0,0,7,7,15,15,30,37,29,66,0.000333,0.107952,7,2266.983455,125.943525,323.854779,117.206718,2,0
0,0,8,8,15,16,31,48,34,82,0.000333,0.135415,14,5687.417364,315.967631,406.244097,122.603359,2,0
0,0,8,8,15,16,31,38,31,69,0.000333,0.113947,7,2392.876818,132.937601,341.839545,122.603359,2,0
0,0,8,8,15,16,31,38,31,69,0.000333,0.113947,7,2392.876818,132.937601,341.839545,122.603359,2,0
0,0,10,10,15,18,33,51,39,90,0.000333,0.151332,14,6355.93659,353.107588,453.995471,133.662009,2,0
0,0,7,7,14,15,29,36,29,65,0.000333,0.105256,7,2210.381353,122.798964,315.768765,111.906328,2,0
0,0,8,8,14,16,30,47,34,81,0.000333,0.132486,14,5564.413935,309.134108,397.458138,117.302969,2,0
0,0,8,8,14,16,30,37,31,68,0.000333,0.111223,7,2335.679924,129.759996,333.668561,117.302969,2,0
0,0,8,8,14,16,30,37,31,68,0.000333,0.111223,7,2335.679924,129.759996,333.668561,117.302969,2,0
0,0,10,10,14,19,33,50,39,89,0.000333,0.14965,14,6285.315073,349.184171,448.951077,134.013592,2,0
0,0,12,12,15,20,35,67,55,122,0.000333,0.208591,14,8760.815393,486.711966,625.772528,145.041921,2,0
0,0,13,13,15,21,36,80,61,141,0.000333,0.242986,14,10205.43195,566.968442,728.959425,150.842025,2,0
0,0,13,13,15,21,36,68,57,125,0.000333,0.215414,14,9047.368753,502.631597,646.240625,150.842025,2,0
0,0,12,12,15,19,34,57,46,103,0.000333,0.17467,14,7336.121417,407.562301,524.008673,139.313982,2,0
0,0,13,13,15,20,35,70,52,122,0.000333,0.208591,14,8760.815393,486.711966,625.772528,145.041921,2,0
0,0,13,13,15,20,35,58,48,106,0.000333,0.181235,14,7611.855997,422.880889,543.704,145.041921,2,0
0,0,9,9,14,19,33,47,38,85,0.000333,0.142925,14,6002.829002,333.4905,428.7735,134.013592,2,0
0,0,10,10,14,20,34,61,45,106,0.000333,0.179757,14,7549.794856,419.433048,539.271061,139.741531,2,0
0,0,10,10,14,20,34,48,40,88,0.000333,0.149232,14,6267.75422,348.208568,447.69673,139.741531,2,0
0,0,4,4,9,7,16,20,14,34,0.000333,0.045333,8,1088,60.444444,136,48.180809,2,0
0,0,7,7,9,10,19,37,24,61,0.000333,0.086375,8,2072.988627,115.166035,259.123578,61.748606,2,0
0,0,5,5,9,8,17,21,16,37,0.000333,0.050412,8,1209.889001,67.216056,151.236125,52.529325,2,0
0,0,9,9,11,12,23,41,30,71,0.000333,0.107058,10,3211.728989,178.429388,321.172899,81.073298,2,0
0,0,6,6,16,16,32,39,27,66,0.000333,0.11,8,2640,146.666667,330,128,3,0
0,0,7,7,16,17,33,40,29,69,0.000333,0.116021,8,2784.505554,154.694753,348.063194,133.486868,3,0
0,0,7,7,16,17,33,40,29,69,0.000333,0.116021,8,2784.505554,154.694753,348.063194,133.486868,3,0
0,0,6,6,15,16,31,38,27,65,0.000333,0.107341,7,2254.159321,125.231073,322.02276,122.603359,3,0
0,0,9,9,15,18,33,56,37,93,0.000333,0.156376,14,6567.801143,364.877841,469.128653,133.662009,3,0
0,0,7,7,15,17,32,39,29,68,0.000333,0.113333,7,2380,132.222222,340,128.090227,3,0
0,0,11,11,15,21,36,58,43,101,0.000333,0.174054,14,7310.273952,406.126331,522.162425,150.842025,3,0
0,0,13,13,16,22,38,76,58,134,0.000333,0.234407,16,11251.55659,625.086477,703.222287,162.107496,3,0
0,0,14,14,16,23,39,89,64,153,0.000333,0.269556,16,12938.66463,718.814702,808.666539,168.041925,3,0
0,0,14,14,16,23,39,77,60,137,0.000333,0.241367,16,11585.60166,643.644537,724.100104,168.041925,3,0
0,0,13,13,16,20,36,66,49,115,0.000333,0.19818,16,9512.662003,528.481222,594.541375,150.438562,3,0
0,0,14,14,16,21,37,79,55,134,0.000333,0.232689,16,11169.06802,620.503779,698.066751,156.238666,3,0
0,0,14,14,16,21,37,70,52,122,0.000333,0.211851,16,10168.85297,564.936276,635.553311,156.238666,3,0
0,0,10,10,15,19,34,56,41,97,0.000333,0.164495,14,6908.774538,383.820808,493.483896,139.313982,3,0
0,0,11,11,15,21,36,70,48,118,0.000333,0.20335,14,8540.716102,474.484228,610.05115,150.842025,3,0
0,0,11,11,15,20,35,57,43,100,0.000333,0.170976,14,7180.996224,398.944235,512.928302,145.041921,3,0
0,0,4,4,9,7,16,20,14,34,0.000333,0.045333,8,1088,60.444444,136,48.180809,2,0
0,0,7,7,9,10,19,38,24,62,0.000333,0.087791,8,2106.972047,117.054003,263.371506,61.748606,2,0
0,0,5,5,9,8,17,23,17,40,0.000333,0.0545,8,1307.988109,72.666006,163.498514,52.529325,2,0
0,0,6,6,13,11,24,29,21,50,0.000333,0.076416,6,1375.48875,76.416042,229.248125,86.159464,2,0
0,0,8,8,13,12,25,43,29,72,0.000333,0.111453,12,4012.291748,222.905097,334.357646,91.125266,2,0
0,0,7,7,13,12,25,32,24,56,0.000333,0.086685,12,3120.67136,173.370631,260.055947,91.125266,2,0
0,0,6,6,12,11,23,28,21,49,0.000333,0.073885,6,1329.927215,73.884845,221.654536,81.073298,2,0
0,0,7,7,12,12,24,39,26,65,0.000333,0.099341,12,3576.270751,198.681708,298.022563,86.0391,2,0
0,0,7,7,12,12,24,31,24,55,0.000333,0.084058,12,3026.07525,168.115292,252.172938,86.0391,2,0
0,0,11,11,13,17,30,59,47,106,0.000333,0.173377,12,6241.564838,346.753602,520.130403,117.592585,2,0
0,0,12,12,13,19,32,72,51,123,0.000333,0.205,12,7380,410,615,128.816339,2,0
0,0,12,12,13,18,31,60,49,109,0.000333,0.180002,12,6480.088774,360.004932,540.007398,123.164366,2,0
0,0,11,11,13,15,28,49,38,87,0.000333,0.139413,12,5018.878539,278.826585,418.239878,106.709075,2,0
0,0,12,12,13,17,30,62,43,105,0.000333,0.171741,12,6182.68215,343.482342,515.223513,117.592585,2,0
0,0,12,12,13,16,29,50,40,90,0.000333,0.145739,12,5246.619475,291.47886,437.21829,112.105716,2,0
0,0,11,11,13,15,28,49,38,87,0.000333,0.139413,12,5018.878539,278.826585,418.239878,106.709075,2,0
0,0,8,8,12,15,27,39,30,69,0.000333,0.109362,12,3937.046852,218.724825,328.087238,101.622909,2,0
0,0,9,9,12,16,28,53,37,90,0.000333,0.144221,12,5191.943316,288.441295,432.661943,107.01955,2,0
0,0,9,9,12,16,28,40,32,72,0.000333,0.115377,12,4153.554653,230.753036,346.129554,107.01955,2,0
0,0,4,4,9,7,16,20,14,34,0.000333,0.045333,8,1088,60.444444,136,48.180809,2,0
0,0,7,7,9,10,19,38,24,62,0.000333,0.087791,8,2106.972047,117.054003,263.371506,61.748606,2,0
0,0,5,5,9,8,17,21,16,37,0.000333,0.050412,8,1209.889001,67.216056,151.236125,52.529325,2,0
0,0,5,5,13,10,23,32,18,50,0.000333,0.075393,6,1357.068587,75.392699,226.178098,81.324997,2,0
0,0,8,8,15,13,28,50,28,78,0.000333,0.124991,14,5249.631575,291.646199,374.973684,106.709075,2,0
0,0,6,6,13,11,24,35,21,56,0.000333,0.085586,6,1540.5474,85.585967,256.7579,86.159464,2,0
0,0,5,5,13,10,23,32,18,50,0.000333,0.075393,6,1357.068587,75.392699,226.178098,81.324997,2,0
0,0,8,8,15,13,28,50,28,78,0.000333,0.124991,14,5249.631575,291.646199,374.973684,106.709075,2,0
0,0,6,6,13,11,24,33,20,53,0.000333,0.081001,6,1458.018075,81.001004,243.003013,86.159464,2,0
0,0,12,12,16,19,35,70,52,122,0.000333,0.208591,16,10012.36045,556.242247,625.772528,144.710623,2,0
0,0,13,13,16,20,36,83,58,141,0.000333,0.242986,16,11663.3508,647.963934,728.959425,150.438562,2,0
0,0,13,13,16,20,36,71,54,125,0.000333,0.215414,16,10339.85,574.436111,646.240625,150.438562,2,0
0,0,13,13,16,20,36,71,54,125,0.000333,0.215414,16,10339.85,574.436111,646.240625,150.438562,2,0
0,0,12,12,16,17,33,60,43,103,0.000333,0.173191,16,8313.161509,461.842306,519.572594,133.486868,2,0
0,0,13,13,16,18,34,73,49,122,0.000333,0.20689,16,9930.727466,551.707081,620.670467,139.05865,2,0
0,0,13,13,16,18,34,61,45,106,0.000333,0.179757,16,8628.336979,479.352054,539.271061,139.05865,2,0
0,0,12,12,16,17,33,60,43,103,0.000333,0.173191,16,8313.161509,461.842306,519.572594,133.486868,2,0
0,0,9,9,15,17,32,50,35,85,0.000333,0.141667,14,5950,330.555556,425,128.090227,2,0
0,0,10,10,15,18,33,64,42,106,0.000333,0.178235,14,7485.880873,415.882271,534.705777,133.662009,2,0
0,0,10,10,15,18,33,53,38,91,0.000333,0.153013,14,6426.558108,357.031006,459.039865,133.662009,2,0
0,0,4,4,9,7,16,20,14,34,0.000333,0.045333,8,1088,60.444444,136,48.180809,2,0
0,0,7,7,9,10,19,37,24,61,0.000333,0.086375,8,2072.988627,115.166035,259.123578,61.748606,2,0
0,0,5,5,9,8,17,21,16,37,0.000333,0.050412,8,1209.889001,67.216056,151.236125,52.529325,2,0
0,0,5,5,13,10,23,32,18,50,0.000333,0.075393,6,1357.068587,75.392699,226.178098,81.324997,2,0
0,0,8,8,15,13,28,50,28,78,0.000333,0.124991,14,5249.631575,291.646199,374.973684,106.709075,2,0
0,0,6,6,13,11,24,35,21,56,0.000333,0.085586,6,1540.5474,85.585967,256.7579,86.159464,2,0
0,0,5,5,13,10,23,32,18,50,0.000333,0.075393,6,1357.068587,75.392699,226.178098,81.324997,2,0
0,0,8,8,15,13,28,50,28,78,0.000333,0.124991,14,5249.631575,291.646199,374.973684,106.709075,2,0
0,0,6,6,13,11,24,35,21,56,0.000333,0.085586,6,1540.5474,85.585967,256.7579,86.159464,2,0
0,0,12,12,16,19,35,70,52,122,0.000333,0.208591,16,10012.36045,556.242247,625.772528,144.710623,2,0
0,0,13,13,16,20,36,83,58,141,0.000333,0.242986,16,11663.3508,647.963934,728.959425,150.438562,2,0
0,0,13,13,16,20,36,71,54,125,0.000333,0.215414,16,10339.85,574.436111,646.240625,150.438562,2,0
0,0,13,13,16,20,36,71,54,125,0.000333,0.215414,16,10339.85,574.436111,646.240625,150.438562,2,0
0,0,12,12,16,17,33,60,43,103,0.000333,0.173191,16,8313.161509,461.842306,519.572594,133.486868,2,0
0,0,13,13,16,18,34,73,49,122,0.000333,0.20689,16,9930.727466,551.707081,620.670467,139.05865,2,0
0,0,13,13,16,18,34,61,45,106,0.000333,0.179757,16,8628.336979,479.352054,539.271061,139.05865,2,0
0,0,13,13,16,18,34,61,45,106,0.000333,0.179757,16,8628.336979,479.352054,539.271061,139.05865,2,0
0,0,9,9,15,17,32,50,35,85,0.000333,0.141667,14,5950,330.555556,425,128.090227,2,0
0,0,10,10,15,18,33,64,42,106,0.000333,0.178235,14,7485.880873,415.882271,534.705777,133.662009,2,0
0,0,10,10,15,18,33,51,37,88,0.000333,0.147969,14,6214.693555,345.260753,443.906683,133.662009,2,0
0,0,10,10,15,18,33,51,37,88,0.000333,0.147969,14,6214.693555,345.260753,443.906683,133.662009,2,0
0,0,4,4,9,7,16,20,14,34,0.000333,0.045333,8,1088,60.444444,136,48.180809,2,0
0,0,7,7,9,10,19,38,24,62,0.000333,0.087791,8,2106.972047,117.054003,263.371506,61.748606,2,0
0,0,5,5,9,8,17,21,16,37,0.000333,0.050412,8,1209.889001,67.216056,151.236125,52.529325,2,0
0,0,10,10,17,17,34,56,38,94,0.000333,0.159407,16,7651.544113,425.085784,478.221507,138.973737,3,0
0,0,11,11,17,18,35,58,40,98,0.000333,0.167557,16,8042.715771,446.817543,502.669736,144.545518,3,0
0,0,11,11,17,18,35,58,40,98,0.000333,0.167557,16,8042.715771,446.817543,502.669736,144.545518,3,0
0,0,10,10,16,17,33,55,38,93,0.000333,0.156376,16,7506.05845,417.003247,469.128653,133.486868,3,0
0,0,11,11,16,18,34,65,43,108,0.000333,0.183149,16,8791.13579,488.396433,549.445987,139.05865,3,0
0,0,11,11,16,18,34,57,40,97,0.000333,0.164495,16,7895.74233,438.652352,493.483896,139.05865,3,0
0,0,11,11,16,18,34,57,40,97,0.000333,0.164495,16,7895.74233,438.652352,493.483896,139.05865,3,0
0,0,13,13,16,20,36,69,48,117,0.000333,0.201627,16,9678.099603,537.6722,604.881225,150.438562,3,0
0,0,15,15,17,22,39,86,64,150,0.000333,0.26427,16,12684.96533,704.720296,792.810333,167.594364,3,0
0,0,16,16,17,23,40,99,70,169,0.000333,0.299802,24,21585.74035,1199.207797,899.405848,173.528793,3,0
0,0,16,16,17,23,40,88,66,154,0.000333,0.273192,16,13113.23083,728.512824,819.576927,173.528793,3,0
0,0,15,15,17,21,38,76,55,131,0.000333,0.22916,16,10999.65607,611.092004,687.478504,161.725534,3,0
0,0,16,16,17,22,39,86,60,146,0.000333,0.257223,16,12346.69958,685.927755,771.668724,167.594364,3,0
0,0,16,16,17,22,39,78,57,135,0.000333,0.237843,16,11416.46879,634.248266,713.5293,167.594364,3,0
0,0,12,12,16,20,36,66,47,113,0.000333,0.194734,16,9347.224403,519.290245,584.201525,150.438562,3,0
0,0,13,13,16,21,37,80,54,134,0.000333,0.232689,16,11169.06802,620.503779,698.066751,156.238666,3,0
0,0,13,13,16,21,37,68,49,117,0.000333,0.203169,16,9752.0967,541.78315,609.506044,156.238666,3,0
0,0,4,4,9,7,16,20,14,34,0.000333,0.045333,8,1088,60.444444,136,48.180809,2,0
0,0,7,7,9,10,19,38,24,62,0.000333,0.087791,8,2106.972047,117.054003,263.371506,61.748606,2,0
0,0,5,5,9,8,17,22,16,38,0.000333,0.051775,8,1242.588704,69.032706,155.323588,52.529325,2,0
0,0,9,9,11,13,24,40,30,70,0.000333,0.106982,10,3209.473751,178.304097,320.947375,86.159464,2,0
0,0,7,7,15,15,30,37,29,66,0.000333,0.107952,7,2266.983455,125.943525,323.854779,117.206718,2,0
0,0,9,9,15,16,31,51,37,88,0.000333,0.145323,14,6103.569854,339.087214,435.969275,122.603359,2,0
0,0,8,8,15,16,31,39,31,70,0.000333,0.115598,7,2427.556192,134.864233,346.793742,122.603359,2,0
0,0,10,10,13,18,31,50,39,89,0.000333,0.146974,12,5291.081659,293.948981,440.923472,123.164366,2,0
0,0,7,7,14,15,29,36,29,65,0.000333,0.105256,7,2210.381353,122.798964,315.768765,111.906328,2,0
0,0,8,8,14,16,30,47,34,81,0.000333,0.132486,14,5564.413935,309.134108,397.458138,117.302969,2,0
0,0,8,8,14,16,30,38,31,69,0.000333,0.112858,7,2370.028158,131.668231,338.575451,117.302969,2,0
0,0,10,10,13,18,31,49,39,88,0.000333,0.145323,12,5231.631304,290.646184,435.969275,123.164366,2,0
0,0,12,12,15,20,35,67,55,122,0.000333,0.208591,14,8760.815393,486.711966,625.772528,145.041921,2,0
0,0,13,13,15,21,36,77,60,137,0.000333,0.236093,14,9915.916153,550.884231,708.279725,150.842025,2,0
0,0,13,13,15,21,36,69,57,126,0.000333,0.217137,14,9119.747703,506.65265,651.41055,150.842025,2,0
0,0,12,12,15,19,34,57,46,103,0.000333,0.17467,14,7336.121417,407.562301,524.008673,139.313982,2,0
0,0,13,13,15,20,35,70,52,122,0.000333,0.208591,14,8760.815393,486.711966,625.772528,145.041921,2,0
0,0,13,13,15,20,35,59,48,107,0.000333,0.182944,14,7683.665959,426.870331,548.833283,145.041921,2,0
0,0,9,9,14,19,33,47,38,85,0.000333,0.142925,14,6002.829002,333.4905,428.7735,134.013592,2,0
0,0,10,10,14,20,34,61,45,106,0.000333,0.179757,14,7549.794856,419.433048,539.271061,139.741531,2,0
0,0,10,10,14,20,34,49,40,89,0.000333,0.150928,14,6338.9787,352.165483,452.784193,139.741531,2,0
0,0,4,4,9,7,16,20,14,34,0.000333,0.045333,8,1088,60.444444,136,48.180809,2,0
0,0,7,7,9,11,20,38,24,62,0.000333,0.08932,8,2143.676335,119.09313,267.959542,66.583073,2,0
0,0,5,5,9,8,17,22,16,38,0.000333,0.051775,8,1242.588704,69.032706,155.323588,52.529325,2,0
0,0,9,9,11,12,23,40,30,70,0.000333,0.10555,10,3166.493369,175.916298,316.649337,81.073298,2,0
0,0,6,6,16,16,32,39,27,66,0.000333,0.11,8,2640,146.666667,330,128,3,0
0,0,7,7,16,17,33,41,29,70,0.000333,0.117703,8,2824.860707,156.936706,353.107588,133.486868,3,0
0,0,6,6,15,16,31,38,27,65,0.000333,0.107341,7,2254.159321,125.231073,322.02276,122.603359,3,0
0,0,7,7,15,17,32,40,29,69,0.000333,0.115,7,2415,134.166667,345,128.090227,3,0
0,0,9,9,15,19,34,56,37,93,0.000333,0.157711,7,3311.93831,183.996573,473.134044,139.313982,3,0
0,0,11,11,15,20,35,58,43,101,0.000333,0.172686,14,7252.806186,402.933677,518.057585,145.041921,3,0
0,0,13,13,16,22,38,76,58,134,0.000333,0.234407,16,11251.55659,625.086477,703.222287,162.107496,3,0
0,0,14,14,16,23,39,89,64,153,0.000333,0.269556,16,12938.66463,718.814702,808.666539,168.041925,3,0
0,0,14,14,16,23,39,78,60,138,0.000333,0.243129,16,11670.1681,648.342672,729.385506,168.041925,3,0
0,0,13,13,16,20,36,66,49,115,0.000333,0.19818,16,9512.662003,528.481222,594.541375,150.438562,3,0
0,0,14,14,16,21,37,79,55,134,0.000333,0.232689,16,11169.06802,620.503779,698.066751,156.238666,3,0
0,0,14,14,16,21,37,68,51,119,0.000333,0.206642,16,9918.799208,551.0444,619.924951,156.238666,3,0
0,0,10,10,15,19,34,56,41,97,0.000333,0.164495,14,6908.774538,383.820808,493.483896,139.313982,3,0
0,0,11,11,15,20,35,70,48,118,0.000333,0.201752,14,8473.575544,470.754197,605.255396,145.041921,3,0
0,0,11,11,15,20,35,58,43,101,0.000333,0.172686,14,7252.806186,402.933677,518.057585,145.041921,3,0
0,0,4,4,9,7,16,20,14,34,0.000333,0.045333,8,1088,60.444444,136,48.180809,2,0
0,0,7,7,9,11,20,38,24,62,0.000333,0.08932,8,2143.676335,119.09313,267.959542,66.583073,2,0
0,0,5,5,9,8,17,22,16,38,0.000333,0.051775,8,1242.588704,69.032706,155.323588,52.529325,2,0
0,0,9,9,11,12,23,40,30,70,0.000333,0.10555,10,3166.493369,175.916298,316.649337,81.073298,2,0
0,0,6,6,13,11,24,29,21,50,0.000333,0.076416,6,1375.48875,76.416042,229.248125,86.159464,2,0
0,0,7,7,13,13,26,40,26,66,0.000333,0.10341,12,3722.748257,206.819348,310.229021,96.211433,2,0
0,0,7,7,13,12,25,31,23,54,0.000333,0.083589,6,1504.609405,83.589411,250.768234,91.125266,2,0
0,0,9,9,12,14,26,42,31,73,0.000333,0.114377,12,4117.585193,228.754733,343.132099,96.322519,2,0
0,0,6,6,12,11,23,28,21,49,0.000333,0.073885,6,1329.927215,73.884845,221.654536,81.073298,2,0
0,0,7,7,12,13,25,40,27,67,0.000333,0.103713,12,3733.660377,207.425576,311.138365,91.125266,2,0
0,0,7,7,12,12,24,30,23,53,0.000333,0.081001,6,1458.018075,81.001004,243.003013,86.0391,2,0
0,0,9,9,11,15,26,41,30,71,0.000333,0.111244,10,3337.3122,185.406233,333.73122,96.657107,2,0
0,0,11,11,13,17,30,59,47,106,0.000333,0.173377,12,6241.564838,346.753602,520.130403,117.592585,2,0
0,0,12,12,13,18,31,72,53,125,0.000333,0.206425,12,7431.294466,412.849693,619.274539,123.164366,2,0
0,0,12,12,13,18,31,61,49,110,0.000333,0.181654,12,6539.53913,363.307729,544.961594,123.164366,2,0
0,0,11,11,13,15,28,49,38,87,0.000333,0.139413,12,5018.878539,278.826585,418.239878,106.709075,2,0
0,0,12,12,13,16,29,62,44,106,0.000333,0.171649,12,6179.351826,343.297324,514.945985,112.105716,2,0
0,0,12,12,13,16,29,51,40,91,0.000333,0.147359,12,5304.915247,294.717514,442.076271,112.105716,2,0
0,0,8,8,12,15,27,39,30,69,0.000333,0.109362,12,3937.046852,218.724825,328.087238,101.622909,2,0
0,0,9,9,12,16,28,53,37,90,0.000333,0.144221,12,5191.943316,288.441295,432.661943,107.01955,2,0
0,0,9,9,12,16,28,41,32,73,0.000333,0.116979,12,4211.242912,233.95794,350.936909,107.01955,2,0
0,0,4,4,9,7,16,20,14,34,0.000333,0.045333,8,1088,60.444444,136,48.180809,2,0
0,0,7,7,9,11,20,38,24,62,0.000333,0.08932,8,2143.676335,119.09313,267.959542,66.583073,2,0
0,0,5,5,9,8,17,22,16,38,0.000333,0.051775,8,1242.588704,69.032706,155.323588,52.529325,2,0
0,0,9,9,11,12,23,40,30,70,0.000333,0.10555,10,3166.493369,175.916298,316.649337,81.073298,2,0
0,0,5,5,13,10,23,32,18,50,0.000333,0.075393,6,1357.068587,75.392699,226.178098,81.324997,2,0
0,0,8,8,15,14,29,50,28,78,0.000333,0.126308,14,5304.915247,294.717514,378.922518,111.906328,2,0
0,0,6,6,13,11,24,34,20,54,0.000333,0.082529,6,1485.52785,82.529325,247.587975,86.159464,2,0
0,0,10,10,14,15,29,52,34,86,0.000333,0.139262,14,5849.009118,324.944951,417.786366,111.906328,2,0
0,0,5,5,13,10,23,32,18,50,0.000333,0.075393,6,1357.068587,75.392699,226.178098,81.324997,2,0
0,0,8,8,15,14,29,50,28,78,0.000333,0.126308,14,5304.915247,294.717514,378.922518,111.906328,2,0
0,0,6,6,13,11,24,34,20,54,0.000333,0.082529,6,1485.52785,82.529325,247.587975,86.159464,2,0
0,0,10,10,14,15,29,52,34,86,0.000333,0.139262,14,5849.009118,324.944951,417.786366,111.906328,2,0
0,0,12,12,16,19,35,70,52,122,0.000333,0.208591,16,10012.36045,556.242247,625.772528,144.710623,2,0
0,0,13,13,16,20,36,83,58,141,0.000333,0.242986,16,11663.3508,647.963934,728.959425,150.438562,2,0
0,0,13,13,16,20,36,72,54,126,0.000333,0.217137,16,10422.5688,579.0316,651.41055,150.438562,2,0
0,0,12,12,16,19,35,70,52,122,0.000333,0.208591,16,10012.36045,556.242247,625.772528,144.710623,2,0
0,0,12,12,16,17,33,60,43,103,0.000333,0.173191,16,8313.161509,461.842306,519.572594,133.486868,2,0
0,0,13,13,16,18,34,73,49,122,0.000333,0.20689,16,9930.727466,551.707081,620.670467,139.05865,2,0
0,0,13,13,16,18,34,62,45,107,0.000333,0.181453,16,8709.736384,483.874244,544.358524,139.05865,2,0
0,0,9,9,15,17,32,50,35,85,0.000333,0.141667,14,5950,330.555556,425,128.090227,2,0
0,0,10,10,15,18,33,64,42,106,0.000333,0.178235,14,7485.880873,415.882271,534.705777,133.662009,2,0
0,0,10,10,15,18,33,52,37,89,0.000333,0.14965,14,6285.315073,349.184171,448.951077,133.662009,2,0
0,0,8,8,12,14,26,48,38,86,0.000333,0.134746,12,4850.853789,269.491877,404.237816,96.322519,1,0
0,0,9,9,12,15,27,61,44,105,0.000333,0.166421,12,5991.158253,332.842125,499.263188,101.622909,1,0
0,0,8,8,13,11,24,40,34,74,0.000333,0.113096,18,6107.170051,339.287225,339.287225,86.159464,1,0
0,0,9,9,13,12,25,53,40,93,0.000333,0.14396,18,7773.815262,431.878626,431.878626,91.125266,1,0
0,0,9,9,12,14,26,52,41,93,0.000333,0.145714,12,5245.690725,291.427263,437.140894,96.322519,1,0
0,0,10,10,12,15,27,65,47,112,0.000333,0.177516,18,9585.853204,532.5474,532.5474,101.622909,1,0
0,0,9,9,12,14,26,52,41,93,0.000333,0.145714,12,5245.690725,291.427263,437.140894,96.322519,1,0
0,0,11,11,10,13,23,39,29,68,0.000333,0.102534,10,3076.02213,170.890118,307.602213,81.324997,2,0
0,0,14,14,10,16,26,54,39,93,0.000333,0.145714,10,4371.408938,242.856052,437.140894,97.219281,2,0
0,0,12,12,10,14,24,41,31,72,0.000333,0.110039,10,3301.173001,183.3985,330.1173,86.52225,2,0
0,0,16,16,12,18,30,59,45,104,0.000333,0.170106,12,6123.799463,340.211081,510.316622,118.0782,2,0
0,0,16,16,17,22,39,66,50,116,0.000333,0.204369,16,9809.706518,544.983695,613.106657,167.594364,5,0
0,0,19,19,17,25,42,81,60,141,0.000333,0.253439,16,12165.06811,675.837117,760.316757,185.583273,5,0
0,0,17,17,17,23,40,68,52,120,0.000333,0.212877,16,10218.10194,567.67233,638.631371,173.528793,5,0
0,0,21,21,17,27,44,86,66,152,0.000333,0.276611,16,13277.3377,737.629872,829.833606,197.868831,5,0
0,0,16,16,18,24,42,68,52,120,0.000333,0.215693,18,11647.40563,647.078091,647.078091,185.09775,5,0
0,0,19,19,18,26,44,83,62,145,0.000333,0.263873,18,14249.11653,791.617585,791.617585,197.270083,5,0
0,0,17,17,18,25,43,70,54,124,0.000333,0.224286,18,12111.42293,672.85683,672.85683,191.155055,5,0
0,0,21,21,18,28,46,88,68,156,0.000333,0.287225,18,15510.16197,861.675665,861.675665,209.664588,5,0
0,0,11,11,11,15,26,41,31,72,0.000333,0.112811,10,3384.316597,188.017589,338.43166,96.657107,2,0
0,0,12,12,11,16,27,51,36,87,0.000333,0.137892,10,4136.752127,229.819563,413.675213,102.053748,2,0
0,0,12,12,11,16,27,43,33,76,0.000333,0.120457,10,3613.714502,200.761917,361.37145,102.053748,2,0
0,0,14,14,12,18,30,55,41,96,0.000333,0.15702,12,5652.737966,314.040998,471.061497,118.0782,2,0
0,0,16,16,17,24,41,67,52,119,0.000333,0.212516,16,10200.77902,566.709945,637.548689,179.525968,5,0
0,0,17,17,17,26,43,77,56,133,0.000333,0.240564,16,11547.0914,641.505078,721.693212,191.698301,5,0
0,0,17,17,17,25,42,69,54,123,0.000333,0.221085,16,10612.08069,589.560038,663.255043,185.583273,5,0
0,0,19,19,16,27,43,81,62,143,0.000333,0.258652,16,12415.29376,689.738542,775.95586,192.381963,5,0
0,0,11,11,10,15,25,40,31,71,0.000333,0.109905,10,3297.137895,183.174327,329.713789,91.82264,2,0
0,0,12,12,10,16,26,50,36,86,0.000333,0.134746,10,4042.378158,224.576564,404.237816,97.219281,2,0
0,0,12,12,10,16,26,42,33,75,0.000333,0.117511,10,3525.329789,195.851655,352.532979,97.219281,2,0
0,0,14,14,11,19,30,54,40,94,0.000333,0.153749,10,4612.47716,256.248731,461.247716,118.764371,2,0
0,0,21,21,17,29,46,96,78,174,0.000333,0.320367,16,15377.59649,854.310916,961.09978,210.368317,5,0
0,0,22,22,17,30,47,108,84,192,0.000333,0.355494,16,17063.69695,947.983164,1066.48106,216.693586,5,0
0,0,22,22,17,30,47,98,80,178,0.000333,0.329572,16,15819.46905,878.859392,988.716816,216.693586,5,0
0,0,16,16,13,21,34,69,57,126,0.000333,0.213673,12,7692.243816,427.346879,641.020318,140.344382,2,0
0,0,17,17,13,22,35,81,63,144,0.000333,0.246206,12,8863.401053,492.41117,738.616754,146.213212,2,0
0,0,17,17,13,22,35,71,59,130,0.000333,0.222269,12,8001.681506,444.537861,666.806792,146.213212,2,0
0,0,16,16,13,21,34,69,57,126,0.000333,0.213673,12,7692.243816,427.346879,641.020318,140.344382,2,0
0,0,6,6,11,15,26,29,22,51,0.000333,0.079907,5,1198.612128,66.589563,239.722426,96.657107,1,0
0,0,13,13,12,23,35,66,53,119,0.000333,0.203462,12,7324.616148,406.923119,610.384679,147.061475,1,0
0,0,14,14,12,26,38,78,59,137,0.000333,0.239655,12,8627.592832,479.310713,718.966069,165.230983,1,0
0,0,13,13,12,23,35,66,53,119,0.000333,0.203462,12,7324.616148,406.923119,610.384679,147.061475,1,0
0,0,21,21,17,28,45,86,69,155,0.000333,0.283746,16,13619.79568,756.655315,851.23723,204.092806,5,0
0,0,22,22,17,29,46,98,75,173,0.000333,0.318525,16,15289.21949,849.401083,955.576218,210.368317,5,0
0,0,22,22,17,29,46,88,71,159,0.000333,0.292749,16,14051.94162,780.663423,878.246351,210.368317,5,0
0,0,21,21,17,28,45,86,69,155,0.000333,0.283746,16,13619.79568,756.655315,851.23723,204.092806,5,0
0,0,16,16,11,19,30,59,48,107,0.000333,0.175012,10,5250.372937,291.687385,525.037294,118.764371,2,0
0,0,17,17,11,20,31,71,54,125,0.000333,0.206425,10,6192.745388,344.04141,619.274539,124.49231,2,0
0,0,17,17,11,20,31,61,50,111,0.000333,0.183305,10,5499.157905,305.508772,549.91579,124.49231,2,0
0,0,16,16,11,19,30,59,48,107,0.000333,0.175012,10,5250.372937,291.687385,525.037294,118.764371,2,0
0,0,6,6,10,15,25,28,22,50,0.000333,0.077398,5,1160.964047,64.498003,232.192809,91.82264,1,0
0,0,13,13,12,21,33,56,44,100,0.000333,0.168146,12,6053.272943,336.292941,504.439412,135.258216,1,0
0,0,14,14,12,22,34,68,50,118,0.000333,0.200107,12,7203.847383,400.213744,600.320615,141.127046,1,0
0,0,13,13,12,21,33,56,44,100,0.000333,0.168146,12,6053.272943,336.292941,504.439412,135.258216,1,0
0,0,21,21,16,28,44,89,71,160,0.000333,0.29117,16,13976.14494,776.452497,873.509059,198.605938,5,0
0,0,22,22,16,29,45,102,78,180,0.000333,0.329511,16,15816.53692,878.696495,988.533557,204.881449,5,0
0,0,22,22,16,29,45,91,73,164,0.000333,0.300221,16,14410.62253,800.59014,900.663908,204.881449,5,0
0,0,21,21,16,28,44,89,71,160,0.000333,0.29117,16,13976.14494,776.452497,873.509059,198.605938,5,0
0,0,16,16,12,20,32,62,50,112,0.000333,0.186667,12,6720,373.333333,560,129.458112,2,0
0,0,17,17,12,21,33,75,57,132,0.000333,0.221953,12,7990.320285,443.906683,665.860024,135.258216,2,0
0,0,17,17,12,21,33,64,52,116,0.000333,0.19505,12,7021.796614,390.099812,585.149718,135.258216,2,0
0,0,16,16,12,20,32,62,50,112,0.000333,0.186667,12,6720,373.333333,560,129.458112,2,0
0,0,6,6,11,16,27,30,23,53,0.000333,0.084003,5,1260.045188,70.00251,252.009038,102.053748,1,0
0,0,10,10,11,21,32,47,36,83,0.000333,0.138333,5,2075,115.277778,415,130.292414,1,0
0,0,11,11,11,22,33,60,43,103,0.000333,0.173191,5,2597.862971,144.325721,519.572594,136.161243,1,0
0,0,11,11,10,13,23,39,29,68,0.000333,0.102534,10,3076.02213,170.890118,307.602213,81.324997,2,0
0,0,14,14,10,16,26,54,39,93,0.000333,0.145714,10,4371.408938,242.856052,437.140894,97.219281,2,0
0,0,12,12,10,14,24,41,31,72,0.000333,0.110039,10,3301.173001,183.3985,330.1173,86.52225,2,0
0,0,16,16,12,18,30,59,45,104,0.000333,0.170106,12,6123.799463,340.211081,510.316622,118.0782,2,0
0,0,13,13,15,19,34,57,42,99,0.000333,0.167886,14,7051.223498,391.734639,503.658821,139.313982,4,0
0,0,16,16,15,22,37,72,52,124,0.000333,0.215324,14,9043.611043,502.422836,645.972217,156.710855,4,0
0,0,14,14,15,20,35,59,44,103,0.000333,0.176105,14,7396.42611,410.912562,528.316151,145.041921,4,0
0,0,18,18,15,24,39,77,58,135,0.000333,0.237843,14,9989.410194,554.967233,713.5293,168.642459,4,0
0,0,6,6,8,10,18,26,18,44,0.000333,0.061159,4,733.9068,40.7726,183.4767,57.219281,1,0
0,0,9,9,8,13,21,41,28,69,0.000333,0.101023,8,2424.559217,134.697734,303.069902,72.105716,1,0
0,0,11,11,10,15,25,46,34,80,0.000333,0.123836,10,3715.084952,206.393608,371.508495,91.82264,1,0
0,0,6,6,8,10,18,26,18,44,0.000333,0.061159,4,733.9068,40.7726,183.4767,57.219281,1,0
0,0,9,9,8,13,21,41,28,69,0.000333,0.101023,8,2424.559217,134.697734,303.069902,72.105716,1,0
0,0,11,11,10,15,25,46,34,80,0.000333,0.123836,10,3715.084952,206.393608,371.508495,91.82264,1,0
0,0,13,13,16,21,37,59,44,103,0.000333,0.178858,16,8585.179147,476.954397,536.573697,156.238666,4,0
0,0,14,14,16,22,38,69,49,118,0.000333,0.206418,16,9908.087145,550.449286,619.255447,162.107496,4,0
0,0,14,14,16,22,38,61,46,107,0.000333,0.187176,16,8984.451903,499.136217,561.528244,162.107496,4,0
0,0,16,16,15,24,39,73,54,127,0.000333,0.223749,14,9397.445145,522.080286,671.246082,168.642459,4,0
0,0,11,11,11,15,26,41,31,72,0.000333,0.112811,10,3384.316597,188.017589,338.43166,96.657107,2,0
0,0,12,12,11,16,27,51,36,87,0.000333,0.137892,10,4136.752127,229.819563,413.675213,102.053748,2,0
0,0,12,12,11,16,27,43,33,76,0.000333,0.120457,10,3613.714502,200.761917,361.37145,102.053748,2,0
0,0,14,14,12,19,31,55,40,95,0.000333,0.156883,12,5647.783794,313.765766,470.648649,123.730173,2,0
0,0,5,5,7,9,16,23,14,37,0.000333,0.049333,3,444,24.666667,148,48.180809,1,0
0,0,8,8,7,13,20,38,24,62,0.000333,0.08932,3,803.878626,44.659924,267.959542,67.757201,1,0
0,0,10,10,9,15,24,43,30,73,0.000333,0.111567,8,2677.6181,148.756561,334.702263,87.132684,1,0
0,0,10,10,13,19,32,48,35,83,0.000333,0.138333,6,2490,138.333333,415,128.816339,2,0
0,0,11,11,13,20,33,58,40,98,0.000333,0.164784,12,5932.207484,329.567082,494.350624,134.544278,2,0
0,0,13,13,12,22,34,60,45,105,0.000333,0.178061,12,6410.20318,356.122399,534.183598,141.127046,2,0
0,0,13,13,15,21,36,58,44,102,0.000333,0.175777,14,7382.652902,410.147383,527.33235,150.842025,4,0
0,0,14,14,15,22,37,68,49,117,0.000333,0.203169,14,8533.084613,474.060256,609.506044,156.710855,4,0
0,0,14,14,15,22,37,60,46,106,0.000333,0.184067,14,7730.828795,429.490489,552.202057,156.710855,4,0
0,0,16,16,14,24,38,72,54,126,0.000333,0.220413,14,9257.344134,514.296896,661.238867,163.342069,4,0
0,0,11,11,10,15,25,40,31,71,0.000333,0.109905,10,3297.137895,183.174327,329.713789,91.82264,2,0
0,0,12,12,10,16,26,50,36,86,0.000333,0.134746,10,4042.378158,224.576564,404.237816,97.219281,2,0
0,0,12,12,10,16,26,42,33,75,0.000333,0.117511,10,3525.329789,195.851655,352.532979,97.219281,2,0
0,0,14,14,11,18,29,54,41,95,0.000333,0.153836,10,4615.081945,256.393441,461.508195,113.112398,2,0
0,0,10,10,12,19,31,47,35,82,0.000333,0.135415,6,2437.464585,135.414699,406.244097,123.730173,2,0
0,0,11,11,12,20,32,57,40,97,0.000333,0.161667,12,5820,323.333333,485,129.458112,2,0
0,0,13,13,11,22,33,59,45,104,0.000333,0.174872,10,5246.169884,291.453882,524.616988,136.161243,2,0
0,0,7,7,8,13,21,30,22,52,0.000333,0.076134,4,913.602024,50.755668,228.400506,72.105716,1,0
0,0,8,8,8,14,22,40,27,67,0.000333,0.099594,4,1195.127674,66.395982,298.781918,77.302969,1,0
0,0,10,10,9,16,25,44,32,76,0.000333,0.117644,8,2823.464563,156.859142,352.93307,92.529325,1,0
0,0,18,18,15,27,42,87,70,157,0.000333,0.282198,14,11852.3137,658.461872,846.593835,186.985321,4,0
0,0,19,19,15,28,43,99,76,175,0.000333,0.316532,14,13294.34865,738.574925,949.596332,193.209297,4,0
0,0,19,19,15,29,44,89,72,161,0.000333,0.292989,14,12305.55887,683.642159,878.968491,199.484808,4,0
0,0,18,18,15,27,42,87,70,157,0.000333,0.282198,14,11852.3137,658.461872,846.593835,186.985321,4,0
0,0,16,16,13,21,34,69,57,126,0.000333,0.213673,12,7692.243816,427.346879,641.020318,140.344382,2,0
0,0,17,17,13,22,35,81,63,144,0.000333,0.246206,12,8863.401053,492.41117,738.616754,146.213212,2,0
0,0,17,17,13,23,36,71,59,130,0.000333,0.22403,12,8065.083002,448.060167,672.09025,152.147641,2,0
0,0,16,16,13,21,34,69,57,126,0.000333,0.213673,12,7692.243816,427.346879,641.020318,140.344382,2,0
0,0,6,6,11,15,26,29,22,51,0.000333,0.079907,5,1198.612128,66.589563,239.722426,96.657107,1,0
0,0,15,15,14,25,39,76,61,137,0.000333,0.241367,14,10137.40146,563.18897,724.100104,169.399374,2,0
0,0,16,16,14,26,40,88,67,155,0.000333,0.274966,14,11548.58397,641.587998,824.898855,175.514402,2,0
0,0,18,18,15,25,40,77,61,138,0.000333,0.244809,14,10281.96508,571.220282,734.426077,174.699764,4,0
0,0,19,19,15,26,41,89,67,156,0.000333,0.278593,14,11700.89358,650.049643,835.778113,180.814792,4,0
0,0,19,19,15,27,42,79,63,142,0.000333,0.255236,14,10719.92704,595.551502,765.709074,186.985321,4,0
0,0,18,18,15,25,40,77,61,138,0.000333,0.244809,14,10281.96508,571.220282,734.426077,174.699764,4,0
0,0,16,16,11,19,30,59,48,107,0.000333,0.175012,10,5250.372937,291.687385,525.037294,118.764371,2,0
0,0,17,17,11,20,31,71,54,125,0.000333,0.206425,10,6192.745388,344.04141,619.274539,124.49231,2,0
0,0,17,17,11,20,31,61,50,111,0.000333,0.183305,10,5499.157905,305.508772,549.91579,124.49231,2,0
0,0,16,16,11,19,30,59,48,107,0.000333,0.175012,10,5250.372937,291.687385,525.037294,118.764371,2,0
0,0,6,6,10,15,25,28,22,50,0.000333,0.077398,5,1160.964047,64.498003,232.192809,91.82264,1,0
0,0,15,15,14,23,37,66,52,118,0.000333,0.204905,14,8606.01696,478.112053,614.715497,157.344894,2,0
0,0,16,16,14,24,38,78,58,136,0.000333,0.237906,14,9992.053986,555.11411,713.718142,163.342069,2,0
0,0,18,18,14,26,40,80,63,143,0.000333,0.253679,14,10654.50005,591.916669,761.035718,175.514402,4,0
0,0,19,19,14,27,41,93,70,163,0.000333,0.291094,14,12225.93368,679.218537,873.280977,181.684931,4,0
0,0,19,19,14,27,41,82,65,147,0.000333,0.26252,14,11025.84203,612.546779,787.560145,181.684931,4,0
0,0,18,18,14,26,40,80,63,143,0.000333,0.253679,14,10654.50005,591.916669,761.035718,175.514402,4,0
0,0,16,16,12,20,32,62,50,112,0.000333,0.186667,12,6720,373.333333,560,129.458112,2,0
0,0,18,18,12,22,34,77,61,138,0.000333,0.234023,12,8424.838465,468.046581,702.069872,141.127046,2,0
0,0,17,17,12,21,33,64,52,116,0.000333,0.19505,12,7021.796614,390.099812,585.149718,135.258216,2,0
0,0,16,16,12,20,32,62,50,112,0.000333,0.186667,12,6720,373.333333,560,129.458112,2,0
0,0,12,12,13,23,36,57,44,101,0.000333,0.174054,6,3132.974551,174.054142,522.162425,152.147641,2,0
0,0,13,13,13,24,37,70,51,121,0.000333,0.210115,12,7564.126287,420.229238,630.343857,158.144816,2,0
0,0,6,6,11,16,27,30,23,53,0.000333,0.084003,5,1260.045188,70.00251,252.009038,102.053748,1,0
0,0,11,11,13,15,28,46,32,78,0.000333,0.124991,12,4499.684207,249.982456,374.973684,106.709075,3,0
0,0,14,14,13,18,31,61,42,103,0.000333,0.170094,12,6123.38664,340.188147,510.28222,123.164366,3,0
0,0,12,12,13,17,30,48,34,82,0.000333,0.134122,12,4828.380346,268.243353,402.365029,117.592585,3,0
0,0,16,16,15,20,35,66,48,114,0.000333,0.194913,14,8186.335695,454.796428,584.738264,145.041921,3,0
0,0,11,11,10,13,23,39,29,68,0.000333,0.102534,10,3076.02213,170.890118,307.602213,81.324997,2,0
0,0,14,14,10,16,26,54,39,93,0.000333,0.145714,10,4371.408938,242.856052,437.140894,97.219281,2,0
0,0,12,12,10,14,24,41,31,72,0.000333,0.110039,10,3301.173001,183.3985,330.1173,86.52225,2,0
0,0,16,16,12,18,30,59,45,104,0.000333,0.170106,12,6123.799463,340.211081,510.316622,118.0782,2,0
0,0,6,6,8,10,18,26,18,44,0.000333,0.061159,4,733.9068,40.7726,183.4767,57.219281,1,0
0,0,9,9,8,13,21,41,28,69,0.000333,0.101023,8,2424.559217,134.697734,303.069902,72.105716,1,0
0,0,11,11,10,15,25,46,34,80,0.000333,0.123836,10,3715.084952,206.393608,371.508495,91.82264,1,0
0,0,6,6,8,10,18,26,18,44,0.000333,0.061159,4,733.9068,40.7726,183.4767,57.219281,1,0
0,0,9,9,8,13,21,41,28,69,0.000333,0.101023,8,2424.559217,134.697734,303.069902,72.105716,1,0
0,0,11,11,10,15,25,46,34,80,0.000333,0.123836,10,3715.084952,206.393608,371.508495,91.82264,1,0
0,0,11,11,11,15,26,41,31,72,0.000333,0.112811,10,3384.316597,188.017589,338.43166,96.657107,2,0
0,0,12,12,11,16,27,51,36,87,0.000333,0.137892,10,4136.752127,229.819563,413.675213,102.053748,2,0
0,0,12,12,11,16,27,43,33,76,0.000333,0.120457,10,3613.714502,200.761917,361.37145,102.053748,2,0
0,0,14,14,12,18,30,55,41,96,0.000333,0.15702,12,5652.737966,314.040998,471.061497,118.0782,2,0
0,0,11,11,14,17,31,48,34,82,0.000333,0.135415,14,5687.417364,315.967631,406.244097,122.789837,3,0
0,0,12,12,14,18,32,58,39,97,0.000333,0.161667,14,6790,377.222222,485,128.361619,3,0
0,0,12,12,14,18,32,50,36,86,0.000333,0.143333,14,6020,334.444444,430,128.361619,3,0
0,0,14,14,16,20,36,62,44,106,0.000333,0.182671,16,8768.192802,487.121822,548.01205,150.438562,3,0
0,0,5,5,7,9,16,23,14,37,0.000333,0.049333,3,444,24.666667,148,48.180809,1,0
0,0,8,8,7,13,20,38,24,62,0.000333,0.08932,3,803.878626,44.659924,267.959542,67.757201,1,0
0,0,10,10,9,15,24,43,30,73,0.000333,0.111567,8,2677.6181,148.756561,334.702263,87.132684,1,0
0,0,8,8,10,15,25,37,25,62,0.000333,0.095973,5,1439.595419,79.977523,287.919084,91.82264,1,0
0,0,9,9,10,16,26,47,30,77,0.000333,0.120645,5,1809.669291,100.537183,361.933858,97.219281,1,0
0,0,4,4,7,8,15,21,12,33,0.000333,0.042976,3,386.782169,21.487898,128.92739,43.651484,1,0
0,0,4,4,7,8,15,21,12,33,0.000333,0.042976,3,386.782169,21.487898,128.92739,43.651484,1,0
0,0,10,10,9,15,24,46,33,79,0.000333,0.120737,8,2897.6963,160.983128,362.212038,87.132684,1,0
0,0,11,11,9,16,25,56,38,94,0.000333,0.145507,8,3492.179855,194.009992,436.522482,92.529325,1,0
0,0,12,12,11,18,29,57,38,95,0.000333,0.153836,10,4615.081945,256.393441,461.508195,113.112398,1,0
0,0,9,9,8,14,22,35,29,64,0.000333,0.095135,8,2283.228989,126.846055,285.403624,77.302969,1,0
0,0,10,10,8,15,23,45,34,79,0.000333,0.11912,8,2858.891156,158.827286,357.361395,82.603359,1,0
0,0,11,11,9,17,26,45,34,79,0.000333,0.123778,8,2970.677902,165.037661,371.334738,98.016193,1,0
0,0,4,4,7,8,15,21,12,33,0.000333,0.042976,3,386.782169,21.487898,128.92739,43.651484,1,0
0,0,4,4,7,8,15,21,12,33,0.000333,0.042976,3,386.782169,21.487898,128.92739,43.651484,1,0
0,0,14,14,16,23,39,73,56,129,0.000333,0.227272,16,10909.07018,606.059454,681.816886,168.041925,3,0
0,0,15,15,16,24,40,85,62,147,0.000333,0.260774,16,12517.17488,695.398604,782.32343,174.0391,3,0
0,0,15,15,16,25,41,75,58,133,0.000333,0.237518,16,11400.87067,633.381704,712.554417,180.096405,3,0
0,0,14,14,16,23,39,73,56,129,0.000333,0.227272,16,10909.07018,606.059454,681.816886,168.041925,3,0
0,0,14,14,12,20,32,61,52,113,0.000333,0.188333,12,6780,376.666667,565,129.458112,1,0
0,0,15,15,12,21,33,71,57,128,0.000333,0.215227,12,7748.189367,430.454965,645.682447,135.258216,1,0
0,0,14,14,12,20,32,61,52,113,0.000333,0.188333,12,6780,376.666667,565,129.458112,1,0
0,0,4,4,7,8,15,21,12,33,0.000333,0.042976,3,386.782169,21.487898,128.92739,43.651484,1,0
0,0,4,4,7,8,15,21,12,33,0.000333,0.042976,3,386.782169,21.487898,128.92739,43.651484,1,0
0,0,14,14,14,21,35,63,47,110,0.000333,0.188074,14,7899.095846,438.838658,564.221132,145.541635,3,0
0,0,15,15,14,22,36,75,53,128,0.000333,0.220583,14,9264.505603,514.694756,661.7504,151.410465,3,0
0,0,15,15,14,23,37,65,49,114,0.000333,0.197959,14,8314.287572,461.904865,593.877684,157.344894,3,0
0,0,14,14,14,21,35,63,47,110,0.000333,0.188074,14,7899.095846,438.838658,564.221132,145.541635,3,0
0,0,14,14,10,18,28,51,43,94,0.000333,0.15063,10,4518.913627,251.050757,451.891363,108.277931,1,0
0,0,15,15,10,19,29,63,49,112,0.000333,0.181365,10,5440.938715,302.274373,544.093871,113.929904,1,0
0,0,14,14,10,18,28,51,43,94,0.000333,0.15063,10,4518.913627,251.050757,451.891363,108.277931,1,0
0,0,4,4,7,8,15,21,12,33,0.000333,0.042976,3,386.782169,21.487898,128.92739,43.651484,1,0
0,0,4,4,7,8,15,21,12,33,0.000333,0.042976,3,386.782169,21.487898,128.92739,43.651484,1,0
0,0,11,11,15,21,36,54,39,93,0.000333,0.160268,7,3365.621176,186.978954,480.803025,150.842025,3,0
0,0,12,12,15,22,37,67,46,113,0.000333,0.196223,14,8241.355224,457.853068,588.66823,156.710855,3,0
0,0,12,12,15,22,37,56,41,97,0.000333,0.168439,7,3537.218835,196.512158,505.316976,156.710855,3,0
0,0,14,14,11,19,30,54,45,99,0.000333,0.161927,10,4857.82169,269.878983,485.782169,118.764371,1,0
0,0,15,15,11,20,31,67,52,119,0.000333,0.196516,10,5895.493609,327.527423,589.549361,124.49231,1,0
0,0,14,14,11,19,30,54,45,99,0.000333,0.161927,10,4857.82169,269.878983,485.782169,118.764371,1,0
0,0,4,4,7,8,15,21,12,33,0.000333,0.042976,3,386.782169,21.487898,128.92739,43.651484,1,0
0,0,4,4,7,8,15,21,12,33,0.000333,0.042976,3,386.782169,21.487898,128.92739,43.651484,1,0
0,0,11,11,10,13,23,39,29,68,0.000333,0.102534,10,3076.02213,170.890118,307.602213,81.324997,2,0
0,0,14,14,10,16,26,54,39,93,0.000333,0.145714,10,4371.408938,242.856052,437.140894,97.219281,2,0
0,0,12,12,10,14,24,41,31,72,0.000333,0.110039,10,3301.173001,183.3985,330.1173,86.52225,2,0
0,0,16,16,12,18,30,59,45,104,0.000333,0.170106,12,6123.799463,340.211081,510.316622,118.0782,2,0
0,0,16,16,17,22,39,66,50,116,0.000333,0.204369,16,9809.706518,544.983695,613.106657,167.594364,5,0
0,0,19,19,17,25,42,81,60,141,0.000333,0.253439,16,12165.06811,675.837117,760.316757,185.583273,5,0
0,0,17,17,17,23,40,68,52,120,0.000333,0.212877,16,10218.10194,567.67233,638.631371,173.528793,5,0
0,0,21,21,17,27,44,86,66,152,0.000333,0.276611,16,13277.3377,737.629872,829.833606,197.868831,5,0
0,0,4,4,7,8,15,21,12,33,0.000333,0.042976,3,386.782169,21.487898,128.92739,43.651484,1,0
0,0,4,4,7,8,15,21,12,33,0.000333,0.042976,3,386.782169,21.487898,128.92739,43.651484,1,0
0,0,4,4,7,8,15,21,12,33,0.000333,0.042976,3,386.782169,21.487898,128.92739,43.651484,1,0
0,0,16,16,18,24,42,68,52,120,0.000333,0.215693,18,11647.40563,647.078091,647.078091,185.09775,5,0
0,0,17,17,18,25,43,78,57,135,0.000333,0.244182,18,13185.82335,732.545742,732.545742,191.155055,5,0
0,0,17,17,18,26,44,70,54,124,0.000333,0.225657,18,12185.45137,676.969521,676.969521,197.270083,5,0
0,0,19,19,16,27,43,81,62,143,0.000333,0.258652,16,12415.29376,689.738542,775.95586,192.381963,5,0
0,0,11,11,11,15,26,41,31,72,0.000333,0.112811,10,3384.316597,188.017589,338.43166,96.657107,2,0
0,0,12,12,11,16,27,51,36,87,0.000333,0.137892,10,4136.752127,229.819563,413.675213,102.053748,2,0
0,0,12,12,11,16,27,43,33,76,0.000333,0.120457,10,3613.714502,200.761917,361.37145,102.053748,2,0
0,0,14,14,12,18,30,55,41,96,0.000333,0.15702,12,5652.737966,314.040998,471.061497,118.0782,2,0
0,0,4,4,7,8,15,21,12,33,0.000333,0.042976,3,386.782169,21.487898,128.92739,43.651484,1,0
0,0,4,4,7,8,15,21,12,33,0.000333,0.042976,3,386.782169,21.487898,128.92739,43.651484,1,0
0,0,4,4,7,8,15,21,12,33,0.000333,0.042976,3,386.782169,21.487898,128.92739,43.651484,1,0
0,0,11,11,12,18,30,42,33,75,0.000333,0.122672,6,2208.100768,122.672265,368.016795,118.0782,3,0
0,0,12,12,12,17,29,52,38,90,0.000333,0.145739,12,5246.619475,291.47886,437.21829,112.506418,3,0
0,0,12,12,12,20,32,44,35,79,0.000333,0.131667,6,2370,131.666667,395,129.458112,3,0
0,0,14,14,13,19,32,56,43,99,0.000333,0.165,12,5940,330,495,128.816339,3,0
0,0,15,15,15,25,40,66,51,117,0.000333,0.207555,14,8717.318219,484.295457,622.665587,174.699764,4,0
0,0,17,17,15,27,42,78,60,138,0.000333,0.248047,14,10417.95726,578.775403,744.139804,186.985321,4,0
0,0,16,16,15,27,42,68,53,121,0.000333,0.21749,7,4567.292857,253.738492,652.470408,186.985321,4,0
0,0,18,18,15,28,43,78,61,139,0.000333,0.251417,14,10559.51121,586.639512,754.250801,193.209297,4,0
0,0,4,4,7,8,15,21,12,33,0.000333,0.042976,3,386.782169,21.487898,128.92739,43.651484,1,0
0,0,4,4,7,8,15,21,12,33,0.000333,0.042976,3,386.782169,21.487898,128.92739,43.651484,1,0
0,0,4,4,7,8,15,21,12,33,0.000333,0.042976,3,386.782169,21.487898,128.92739,43.651484,1,0
0,0,14,14,12,20,32,61,52,113,0.000333,0.188333,12,6780,376.666667,565,129.458112,1,0
0,0,15,15,12,21,33,73,58,131,0.000333,0.220272,12,7929.787556,440.543753,660.81563,135.258216,1,0
0,0,14,14,12,20,32,61,52,113,0.000333,0.188333,12,6780,376.666667,565,129.458112,1,0
0,0,20,20,17,29,46,93,76,169,0.000333,0.311161,16,14935.71153,829.761752,933.481971,210.368317,5,0
0,0,21,21,17,30,47,105,82,187,0.000333,0.346236,16,16619.32984,923.296102,1038.708115,216.693586,5,0
0,0,21,21,17,31,48,95,78,173,0.000333,0.322066,16,15459.1762,858.843122,966.198513,223.066954,5,0
0,0,20,20,17,29,46,93,76,169,0.000333,0.311161,16,14935.71153,829.761752,933.481971,210.368317,5,0
0,0,4,4,7,8,15,21,12,33,0.000333,0.042976,3,386.782169,21.487898,128.92739,43.651484,1,0
0,0,4,4,7,8,15,21,12,33,0.000333,0.042976,3,386.782169,21.487898,128.92739,43.651484,1,0
0,0,4,4,7,8,15,21,12,33,0.000333,0.042976,3,386.782169,21.487898,128.92739,43.651484,1,0
0,0,15,15,11,19,30,57,46,103,0.000333,0.16847,10,5054.097313,280.783184,505.409731,118.764371,2,0
0,0,16,16,11,20,31,69,52,121,0.000333,0.199819,10,5994.577536,333.032085,599.457754,124.49231,2,0
0,0,16,16,11,21,32,59,48,107,0.000333,0.178333,10,5350,297.222222,535,130.292414,2,0
0,0,15,15,11,19,30,57,46,103,0.000333,0.16847,10,5054.097313,280.783184,505.409731,118.764371,2,0
0,0,20,20,17,28,45,84,67,151,0.000333,0.276423,16,13268.31708,737.128727,829.269818,204.092806,5,0
0,0,21,21,17,29,46,96,73,169,0.000333,0.311161,16,14935.71153,829.761752,933.481971,210.368317,5,0
0,0,21,21,17,29,46,86,69,155,0.000333,0.285384,16,13698.43365,761.024092,856.152103,210.368317,5,0
0,0,20,20,17,28,45,84,67,151,0.000333,0.276423,16,13268.31708,737.128727,829.269818,204.092806,5,0
0,0,4,4,7,8,15,21,12,33,0.000333,0.042976,3,386.782169,21.487898,128.92739,43.651484,1,0
0,0,4,4,7,8,15,21,12,33,0.000333,0.042976,3,386.782169,21.487898,128.92739,43.651484,1,0
0,0,4,4,7,8,15,21,12,33,0.000333,0.042976,3,386.782169,21.487898,128.92739,43.651484,1,0
0,0,20,20,15,29,44,85,67,152,0.000333,0.276611,14,11617.67048,645.426138,829.833606,199.484808,4,0
0,0,21,21,15,28,43,98,76,174,0.000333,0.314723,14,13218.38094,734.354497,944.170067,193.209297,4,0
0,0,21,21,15,31,46,87,69,156,0.000333,0.287225,14,12063.45931,670.192184,861.675665,212.183445,4,0
0,0,20,20,15,29,44,85,67,152,0.000333,0.276611,14,11617.67048,645.426138,829.833606,199.484808,4,0
0,0,15,15,13,23,36,62,50,112,0.000333,0.193011,12,6948.379202,386.021067,579.0316,152.147641,3,0
0,0,16,16,13,22,35,75,57,132,0.000333,0.225688,12,8124.784299,451.376905,677.065358,146.213212,3,0
0,0,16,16,13,25,38,64,52,116,0.000333,0.20292,12,7305.115099,405.839728,608.759592,164.202121,3,0
0,0,15,15,13,23,36,62,50,112,0.000333,0.193011,12,6948.379202,386.021067,579.0316,152.147641,3,0
0,0,11,11,12,14,26,41,31,72,0.000333,0.112811,12,4061.179916,225.621106,338.43166,96.322519,3,0
0,0,14,14,12,17,29,56,41,97,0.000333,0.157075,12,5654.689878,314.149438,471.224157,112.506418,3,0
0,0,12,12,12,16,28,43,33,76,0.000333,0.121786,12,4384.307689,243.572649,365.358974,107.01955,3,0
0,0,16,16,14,19,33,61,47,108,0.000333,0.181598,14,7627.123908,423.729106,544.794565,134.013592,3,0
0,0,11,11,10,13,23,39,29,68,0.000333,0.102534,10,3076.02213,170.890118,307.602213,81.324997,2,0
0,0,14,14,10,16,26,54,39,93,0.000333,0.145714,10,4371.408938,242.856052,437.140894,97.219281,2,0
0,0,12,12,10,15,25,41,31,72,0.000333,0.111453,10,3343.576457,185.754248,334.357646,91.82264,2,0
0,0,16,16,12,18,30,59,45,104,0.000333,0.170106,12,6123.799463,340.211081,510.316622,118.0782,2,0
0,0,11,11,11,15,26,41,31,72,0.000333,0.112811,10,3384.316597,188.017589,338.43166,96.657107,2,0
0,0,12,12,11,16,27,51,36,87,0.000333,0.137892,10,4136.752127,229.819563,413.675213,102.053748,2,0
0,0,12,12,11,17,28,43,33,76,0.000333,0.121786,5,1826.79487,101.488604,365.358974,107.540616,2,0
0,0,14,14,12,18,30,55,41,96,0.000333,0.15702,12,5652.737966,314.040998,471.061497,118.0782,2,0
0,0,11,11,13,16,29,43,33,76,0.000333,0.123069,12,4430.478668,246.137704,369.206556,112.105716,3,0
0,0,12,12,13,17,30,53,38,91,0.000333,0.148842,12,5358.32453,297.684696,446.527044,117.592585,3,0
0,0,12,12,13,18,31,45,35,80,0.000333,0.132112,6,2378.014229,132.111902,396.335705,123.164366,3,0
0,0,14,14,13,19,32,56,43,99,0.000333,0.165,12,5940,330,495,128.816339,3,0
0,0,11,11,12,16,28,42,33,75,0.000333,0.120184,12,4326.61943,240.367746,360.551619,107.01955,3,0
0,0,10,10,10,15,25,41,32,73,0.000333,0.113001,10,3390.015019,188.334168,339.001502,91.82264,2,0
0,0,11,11,10,16,26,51,37,88,0.000333,0.13788,10,4136.386952,229.799275,413.638695,97.219281,2,0
0,0,11,11,10,16,26,43,34,77,0.000333,0.120645,10,3619.338583,201.074366,361.933858,97.219281,2,0
0,0,13,13,12,18,30,53,42,95,0.000333,0.155385,12,5593.855279,310.769738,466.154607,118.0782,2,0
0,0,15,15,14,22,36,69,57,126,0.000333,0.217137,14,9119.747703,506.65265,651.41055,151.410465,3,0
0,0,16,16,14,23,37,79,62,141,0.000333,0.244844,14,10283.46094,571.303386,734.532925,157.344894,3,0
0,0,16,16,14,24,38,71,59,130,0.000333,0.22741,14,9551.228074,530.623782,682.230577,163.342069,3,0
0,0,15,15,14,22,36,69,57,126,0.000333,0.217137,14,9119.747703,506.65265,651.41055,151.410465,3,0
0,0,15,15,13,21,34,67,55,122,0.000333,0.20689,12,7448.0456,413.780311,620.670467,140.344382,2,0
0,0,16,16,13,22,35,79,61,140,0.000333,0.239367,12,8617.195468,478.733082,718.099622,146.213212,2,0
0,0,16,16,13,22,35,69,57,126,0.000333,0.21543,12,7755.475922,430.859773,646.28966,146.213212,2,0
0,0,15,15,13,21,34,67,55,122,0.000333,0.20689,12,7448.0456,413.780311,620.670467,140.344382,2,0
0,0,15,15,12,20,32,59,48,107,0.000333,0.178333,12,6420,356.666667,535,129.458112,3,0
0,0,16,16,12,21,33,71,54,125,0.000333,0.210183,12,7566.591179,420.366177,630.549265,135.258216,3,0
0,0,15,15,12,20,32,59,48,107,0.000333,0.178333,12,6420,356.666667,535,129.458112,3,0
0,0,15,15,12,20,32,59,48,107,0.000333,0.178333,12,6420,356.666667,535,129.458112,3,0
0,0,16,16,12,21,33,71,54,125,0.000333,0.210183,12,7566.591179,420.366177,630.549265,135.258216,3,0
0,0,16,16,12,22,34,61,50,111,0.000333,0.188236,12,6776.500505,376.47225,564.708375,141.127046,3,0
0,0,15,15,12,20,32,59,48,107,0.000333,0.178333,12,6420,356.666667,535,129.458112,3,0
0,0,15,15,11,19,30,57,46,103,0.000333,0.16847,10,5054.097313,280.783184,505.409731,118.764371,2,0
0,0,16,16,11,20,31,69,52,121,0.000333,0.199819,10,5994.577536,333.032085,599.457754,124.49231,2,0
0,0,16,16,11,20,31,59,48,107,0.000333,0.1767,10,5300.990052,294.499447,530.099005,124.49231,2,0
0,0,15,15,11,19,30,57,46,103,0.000333,0.16847,10,5054.097313,280.783184,505.409731,118.764371,2,0
0,0,15,15,13,21,34,62,50,112,0.000333,0.189932,12,6837.550059,379.863892,569.795838,140.344382,3,0
0,0,16,16,13,22,35,75,57,132,0.000333,0.225688,12,8124.784299,451.376905,677.065358,146.213212,3,0
0,0,16,16,13,23,36,64,52,116,0.000333,0.199904,12,7196.535602,399.807533,599.7113,152.147641,3,0
0,0,15,15,13,21,34,62,50,112,0.000333,0.189932,12,6837.550059,379.863892,569.795838,140.344382,3,0
0,0,15,15,12,20,32,60,48,108,0.000333,0.18,12,6480,360,540,129.458112,2,0
0,0,16,16,12,21,33,73,55,128,0.000333,0.215227,12,7748.189367,430.454965,645.682447,135.258216,2,0
0,0,16,16,12,22,34,62,50,112,0.000333,0.189932,12,6837.550059,379.863892,569.795838,141.127046,2,0
0,0,15,15,12,20,32,60,48,108,0.000333,0.18,12,6480,360,540,129.458112,2,0
0,0,16,16,17,23,40,66,50,116,0.000333,0.205781,16,9877.498544,548.749919,617.343659,173.528793,5,0
0,0,17,17,17,24,41,68,52,120,0.000333,0.214302,16,10286.49985,571.472214,642.906241,179.525968,5,0
0,0,11,11,10,13,23,39,29,68,0.000333,0.102534,10,3076.02213,170.890118,307.602213,81.324997,2,0
0,0,14,14,10,16,26,54,39,93,0.000333,0.145714,10,4371.408938,242.856052,437.140894,97.219281,2,0
0,0,12,12,10,14,24,41,31,72,0.000333,0.110039,10,3301.173001,183.3985,330.1173,86.52225,2,0
0,0,16,16,12,18,30,59,45,104,0.000333,0.170106,12,6123.799463,340.211081,510.316622,118.0782,2,0
0,0,16,16,18,25,43,68,52,120,0.000333,0.217051,18,11720.73187,651.151771,651.151771,191.155055,5,0
0,0,17,17,18,26,44,78,57,135,0.000333,0.245674,18,13266.41883,737.023269,737.023269,197.270083,5,0
0,0,17,17,18,26,44,70,54,124,0.000333,0.225657,18,12185.45137,676.969521,676.969521,197.270083,5,0
0,0,19,19,18,28,46,80,62,142,0.000333,0.261449,18,14118.22436,784.345798,784.345798,209.664588,5,0
0,0,11,11,11,15,26,41,31,72,0.000333,0.112811,10,3384.316597,188.017589,338.43166,96.657107,2,0
0,0,12,12,11,16,27,51,36,87,0.000333,0.137892,10,4136.752127,229.819563,413.675213,102.053748,2,0
0,0,12,12,11,16,27,43,33,76,0.000333,0.120457,10,3613.714502,200.761917,361.37145,102.053748,2,0
0,0,14,14,12,18,30,55,41,96,0.000333,0.15702,12,5652.737966,314.040998,471.061497,118.0782,2,0
0,0,16,16,17,25,42,67,52,119,0.000333,0.213895,16,10266.97237,570.387354,641.685773,185.583273,5,0
0,0,17,17,17,27,44,77,57,134,0.000333,0.243855,16,11705.02139,650.278966,731.563837,197.868831,5,0
0,0,17,17,17,27,44,69,54,123,0.000333,0.223837,16,10744.16143,596.897857,671.510089,197.868831,5,0
0,0,19,19,16,28,44,81,62,143,0.000333,0.260233,16,12491.17954,693.954419,780.698721,198.605938,5,0
0,0,11,11,10,15,25,40,31,71,0.000333,0.109905,10,3297.137895,183.174327,329.713789,91.82264,2,0
0,0,12,12,10,16,26,50,36,86,0.000333,0.134746,10,4042.378158,224.576564,404.237816,97.219281,2,0
0,0,12,12,10,16,26,42,33,75,0.000333,0.117511,10,3525.329789,195.851655,352.532979,97.219281,2,0
0,0,14,14,11,18,29,54,41,95,0.000333,0.153836,10,4615.081945,256.393441,461.508195,113.112398,2,0
0,0,21,21,17,30,47,96,78,174,0.000333,0.322166,16,15463.97536,859.109742,966.49846,216.693586,5,0
0,0,22,22,17,31,48,108,84,192,0.000333,0.357438,16,17157.0048,953.166933,1072.3128,223.066954,5,0
0,0,22,22,17,32,49,98,80,178,0.000333,0.333139,16,15990.69364,888.371869,999.418352,229.486868,5,0
0,0,21,21,17,30,47,96,78,174,0.000333,0.322166,16,15463.97536,859.109742,966.49846,216.693586,5,0
0,0,16,16,13,21,34,69,57,126,0.000333,0.213673,12,7692.243816,427.346879,641.020318,140.344382,2,0
0,0,17,17,13,22,35,81,63,144,0.000333,0.246206,12,8863.401053,492.41117,738.616754,146.213212,2,0
0,0,17,17,13,22,35,71,59,130,0.000333,0.222269,12,8001.681506,444.537861,666.806792,146.213212,2,0
0,0,16,16,13,21,34,69,57,126,0.000333,0.213673,12,7692.243816,427.346879,641.020318,140.344382,2,0
0,0,21,21,17,29,46,86,69,155,0.000333,0.285384,16,13698.43365,761.024092,856.152103,210.368317,5,0
0,0,22,22,17,30,47,98,75,173,0.000333,0.320315,16,15375.10194,854.17233,960.943871,216.693586,5,0
0,0,22,22,17,30,47,88,71,159,0.000333,0.294393,16,14130.87404,785.048558,883.179627,216.693586,5,0
0,0,21,21,17,29,46,86,69,155,0.000333,0.285384,16,13698.43365,761.024092,856.152103,210.368317,5,0
0,0,16,16,11,19,30,59,48,107,0.000333,0.175012,10,5250.372937,291.687385,525.037294,118.764371,2,0
0,0,17,17,11,20,31,71,54,125,0.000333,0.206425,10,6192.745388,344.04141,619.274539,124.49231,2,0
0,0,17,17,11,20,31,61,50,111,0.000333,0.183305,10,5499.157905,305.508772,549.91579,124.49231,2,0
0,0,16,16,11,19,30,59,48,107,0.000333,0.175012,10,5250.372937,291.687385,525.037294,118.764371,2,0
0,0,21,21,16,29,45,89,71,160,0.000333,0.292899,16,14059.14393,781.063551,878.696495,204.881449,5,0
0,0,22,22,16,30,46,102,78,180,0.000333,0.331414,16,15907.85843,883.769913,994.241152,211.206718,5,0
0,0,22,22,16,30,46,91,73,164,0.000333,0.301955,16,14493.82657,805.212587,905.864161,211.206718,5,0
0,0,21,21,16,29,45,89,71,160,0.000333,0.292899,16,14059.14393,781.063551,878.696495,204.881449,5,0
0,0,16,16,12,20,32,62,50,112,0.000333,0.186667,12,6720,373.333333,560,129.458112,2,0
0,0,17,17,12,21,33,75,57,132,0.000333,0.221953,12,7990.320285,443.906683,665.860024,135.258216,2,0
0,0,17,17,12,22,34,63,52,115,0.000333,0.195019,12,7020.698721,390.038818,585.058227,141.127046,2,0
0,0,16,16,12,20,32,62,50,112,0.000333,0.186667,12,6720,373.333333,560,129.458112,2,0
0,0,11,11,10,13,23,39,29,68,0.000333,0.102534,10,3076.02213,170.890118,307.602213,81.324997,2,0
0,0,14,14,10,16,26,54,39,93,0.000333,0.145714,10,4371.408938,242.856052,437.140894,97.219281,2,0
0,0,12,12,10,14,24,41,31,72,0.000333,0.110039,10,3301.173001,183.3985,330.1173,86.52225,2,0
0,0,16,16,12,18,30,59,45,104,0.000333,0.170106,12,6123.799463,340.211081,510.316622,118.0782,2,0
0,0,13,13,15,20,35,57,42,99,0.000333,0.169266,14,7109.186261,394.954792,507.799019,145.041921,4,0
0,0,16,16,15,23,38,72,52,124,0.000333,0.216914,14,9110.402163,506.133454,650.743012,162.645284,4,0
0,0,14,14,15,22,37,59,44,103,0.000333,0.178858,14,7512.031753,417.335097,536.573697,156.710855,4,0
0,0,18,18,15,25,40,77,58,135,0.000333,0.239487,14,10058.4441,558.80245,718.460293,174.699764,4,0
0,0,9,9,11,15,26,38,27,65,0.000333,0.101843,5,1527.642908,84.86905,305.528582,96.657107,2,0
0,0,10,10,11,16,27,48,32,80,0.000333,0.126797,10,3803.910002,211.328333,380.391,102.053748,2,0
0,0,10,10,11,16,27,40,29,69,0.000333,0.109362,5,1640.436188,91.135344,328.087238,102.053748,2,0
0,0,12,12,12,18,30,52,37,89,0.000333,0.145571,12,5240.559156,291.142175,436.713263,118.0782,2,0
0,0,11,11,16,22,38,56,40,96,0.000333,0.167934,8,4030.40833,223.911574,503.801041,162.107496,4,0
0,0,12,12,16,23,39,66,45,111,0.000333,0.19556,8,4693.43717,260.746509,586.679646,168.041925,4,0
0,0,12,12,16,23,39,58,42,100,0.000333,0.17618,8,4228.321775,234.906765,528.540222,168.041925,4,0
0,0,14,14,14,25,39,69,50,119,0.000333,0.209654,14,8805.480097,489.193339,628.962864,169.399374,4,0
0,0,13,13,15,22,37,58,44,102,0.000333,0.177121,14,7439.099406,413.2833,531.364243,156.710855,4,0
0,0,14,14,15,23,38,68,49,117,0.000333,0.204669,14,8596.105267,477.561404,614.007519,162.645284,4,0
0,0,14,14,15,23,38,60,46,106,0.000333,0.185427,14,7787.92443,432.662468,556.280316,162.645284,4,0
0,0,16,16,14,25,39,72,54,126,0.000333,0.221987,14,9323.449514,517.969417,665.96068,169.399374,4,0
0,0,11,11,10,15,25,40,31,71,0.000333,0.109905,10,3297.137895,183.174327,329.713789,91.82264,2,0
0,0,12,12,10,16,26,50,36,86,0.000333,0.134746,10,4042.378158,224.576564,404.237816,97.219281,2,0
0,0,12,12,10,16,26,42,33,75,0.000333,0.117511,10,3525.329789,195.851655,352.532979,97.219281,2,0
0,0,14,14,11,18,29,54,41,95,0.000333,0.153836,10,4615.081945,256.393441,461.508195,113.112398,2,0
0,0,18,18,15,28,43,87,70,157,0.000333,0.283975,14,11926.92993,662.607218,851.923566,193.209297,4,0
0,0,19,19,15,29,44,99,76,175,0.000333,0.318467,14,13375.60747,743.089304,955.400533,199.484808,4,0
0,0,19,19,15,30,45,89,72,161,0.000333,0.294729,14,12378.63688,687.702049,884.188349,205.810077,4,0
0,0,18,18,15,28,43,87,70,157,0.000333,0.283975,14,11926.92993,662.607218,851.923566,193.209297,4,0
0,0,16,16,13,21,34,69,57,126,0.000333,0.213673,12,7692.243816,427.346879,641.020318,140.344382,2,0
0,0,17,17,13,22,35,81,63,144,0.000333,0.246206,12,8863.401053,492.41117,738.616754,146.213212,2,0
0,0,17,17,13,22,35,71,59,130,0.000333,0.222269,12,8001.681506,444.537861,666.806792,146.213212,2,0
0,0,16,16,13,21,34,69,57,126,0.000333,0.213673,12,7692.243816,427.346879,641.020318,140.344382,2,0
0,0,18,18,15,26,41,77,61,138,0.000333,0.246447,14,10350.79047,575.043915,739.342177,180.814792,4,0
0,0,19,19,15,27,42,89,67,156,0.000333,0.280401,14,11776.82125,654.267847,841.201518,186.985321,4,0
0,0,19,19,15,27,42,79,63,142,0.000333,0.255236,14,10719.92704,595.551502,765.709074,186.985321,4,0
0,0,18,18,15,26,41,77,61,138,0.000333,0.246447,14,10350.79047,575.043915,739.342177,180.814792,4,0
0,0,16,16,11,19,30,59,48,107,0.000333,0.175012,10,5250.372937,291.687385,525.037294,118.764371,2,0
0,0,17,17,11,20,31,71,54,125,0.000333,0.206425,10,6192.745388,344.04141,619.274539,124.49231,2,0
0,0,17,17,11,20,31,61,50,111,0.000333,0.183305,10,5499.157905,305.508772,549.91579,124.49231,2,0
0,0,16,16,11,19,30,59,48,107,0.000333,0.175012,10,5250.372937,291.687385,525.037294,118.764371,2,0
0,0,18,18,14,27,41,80,63,143,0.000333,0.255377,14,10725.81911,595.87884,766.129937,181.684931,4,0
0,0,19,19,14,28,42,93,70,163,0.000333,0.292983,14,12305.26836,683.62602,878.94774,187.908907,4,0
0,0,19,19,14,28,42,82,65,147,0.000333,0.264224,14,11097.38926,616.521625,792.670661,187.908907,4,0
0,0,18,18,14,27,41,80,63,143,0.000333,0.255377,14,10725.81911,595.87884,766.129937,181.684931,4,0
0,0,16,16,12,20,32,62,50,112,0.000333,0.186667,12,6720,373.333333,560,129.458112,2,0
0,0,17,17,12,21,33,75,57,132,0.000333,0.221953,12,7990.320285,443.906683,665.860024,135.258216,2,0
0,0,17,17,12,21,33,64,52,116,0.000333,0.19505,12,7021.796614,390.099812,585.149718,135.258216,2,0
0,0,16,16,12,20,32,62,50,112,0.000333,0.186667,12,6720,373.333333,560,129.458112,2,0
0,0,11,11,10,13,23,39,29,68,0.000333,0.102534,10,3076.02213,170.890118,307.602213,81.324997,2,0
0,0,14,14,10,16,26,54,39,93,0.000333,0.145714,10,4371.408938,242.856052,437.140894,97.219281,2,0
0,0,12,12,10,14,24,41,31,72,0.000333,0.110039,10,3301.173001,183.3985,330.1173,86.52225,2,0
0,0,16,16,12,18,30,59,45,104,0.000333,0.170106,12,6123.799463,340.211081,510.316622,118.0782,2,0
0,0,11,11,13,15,28,46,32,78,0.000333,0.124991,12,4499.684207,249.982456,374.973684,106.709075,3,0
0,0,14,14,13,18,31,61,42,103,0.000333,0.170094,12,6123.38664,340.188147,510.28222,123.164366,3,0
0,0,12,12,13,16,29,48,34,82,0.000333,0.132785,12,4780.253299,265.569628,398.354442,112.105716,3,0
0,0,16,16,15,20,35,66,48,114,0.000333,0.194913,14,8186.335695,454.796428,584.738264,145.041921,3,0
0,0,11,11,11,15,26,41,31,72,0.000333,0.112811,10,3384.316597,188.017589,338.43166,96.657107,2,0
0,0,12,12,11,16,27,51,36,87,0.000333,0.137892,10,4136.752127,229.819563,413.675213,102.053748,2,0
0,0,12,12,11,16,27,43,33,76,0.000333,0.120457,10,3613.714502,200.761917,361.37145,102.053748,2,0
0,0,14,14,11,18,29,54,41,95,0.000333,0.153836,10,4615.081945,256.393441,461.508195,113.112398,2,0
0,0,11,11,14,17,31,48,34,82,0.000333,0.135415,14,5687.417364,315.967631,406.244097,122.789837,3,0
0,0,12,12,14,18,32,58,39,97,0.000333,0.161667,14,6790,377.222222,485,128.361619,3,0
0,0,12,12,14,18,32,50,36,86,0.000333,0.143333,14,6020,334.444444,430,128.361619,3,0
0,0,14,14,15,20,35,61,44,105,0.000333,0.179525,14,7540.046035,418.891446,538.574717,145.041921,3,0
0,0,11,11,13,17,30,47,34,81,0.000333,0.132486,12,4769.497659,264.972092,397.458138,117.592585,3,0
0,0,12,12,13,18,31,57,39,96,0.000333,0.158534,12,5707.23415,317.068564,475.602846,123.164366,3,0
0,0,12,12,13,18,31,49,36,85,0.000333,0.140369,12,5053.280237,280.737791,421.106686,123.164366,3,0
0,0,14,14,15,20,35,61,44,105,0.000333,0.179525,14,7540.046035,418.891446,538.574717,145.041921,3,0
0,0,11,11,10,15,25,40,31,71,0.000333,0.109905,10,3297.137895,183.174327,329.713789,91.82264,2,0
0,0,12,12,10,16,26,50,36,86,0.000333,0.134746,10,4042.378158,224.576564,404.237816,97.219281,2,0
0,0,12,12,10,16,26,42,33,75,0.000333,0.117511,10,3525.329789,195.851655,352.532979,97.219281,2,0
0,0,14,14,11,18,29,54,41,95,0.000333,0.153836,10,4615.081945,256.393441,461.508195,113.112398,2,0
0,0,16,16,13,21,34,69,57,126,0.000333,0.213673,12,7692.243816,427.346879,641.020318,140.344382,2,0
0,0,17,17,13,22,35,81,63,144,0.000333,0.246206,12,8863.401053,492.41117,738.616754,146.213212,2,0
0,0,17,17,13,22,35,71,59,130,0.000333,0.222269,12,8001.681506,444.537861,666.806792,146.213212,2,0
0,0,16,16,13,21,34,69,57,126,0.000333,0.213673,12,7692.243816,427.346879,641.020318,140.344382,2,0
0,0,16,16,16,23,39,76,60,136,0.000333,0.239605,16,11501.03523,638.946402,718.814702,168.041925,3,0
0,0,17,17,16,24,40,88,66,154,0.000333,0.273192,16,13113.23083,728.512824,819.576927,174.0391,3,0
0,0,17,17,16,24,40,78,62,140,0.000333,0.248357,16,11921.11893,662.284385,745.069933,174.0391,3,0
0,0,16,16,16,23,39,76,60,136,0.000333,0.239605,16,11501.03523,638.946402,718.814702,168.041925,3,0
0,0,16,16,11,19,30,59,48,107,0.000333,0.175012,10,5250.372937,291.687385,525.037294,118.764371,2,0
0,0,17,17,11,20,31,71,54,125,0.000333,0.206425,10,6192.745388,344.04141,619.274539,124.49231,2,0
0,0,17,17,11,20,31,61,50,111,0.000333,0.183305,10,5499.157905,305.508772,549.91579,124.49231,2,0
0,0,16,16,11,19,30,59,48,107,0.000333,0.175012,10,5250.372937,291.687385,525.037294,118.764371,2,0
0,0,16,16,14,21,35,66,51,117,0.000333,0.200042,14,8401.765582,466.764755,600.126113,145.541635,3,0
0,0,17,17,14,22,36,78,57,135,0.000333,0.232647,14,9771.158253,542.842125,697.939875,151.410465,3,0
0,0,17,17,14,22,36,68,53,121,0.000333,0.20852,14,8757.852952,486.547386,625.560925,151.410465,3,0
0,0,16,16,14,21,35,66,51,117,0.000333,0.200042,14,8401.765582,466.764755,600.126113,145.541635,3,0
0,0,16,16,12,20,32,62,50,112,0.000333,0.186667,12,6720,373.333333,560,129.458112,2,0
0,0,17,17,12,21,33,75,57,132,0.000333,0.221953,12,7990.320285,443.906683,665.860024,135.258216,2,0
0,0,17,17,12,21,33,64,52,116,0.000333,0.19505,12,7021.796614,390.099812,585.149718,135.258216,2,0
0,0,16,16,12,20,32,62,50,112,0.000333,0.186667,12,6720,373.333333,560,129.458112,2,0
0,0,16,16,15,22,37,69,53,122,0.000333,0.211851,14,8897.746348,494.319242,635.553311,156.710855,3,0
0,0,17,17,15,23,38,82,60,142,0.000333,0.248402,14,10432.8799,579.604439,745.205707,162.645284,3,0
0,0,17,17,15,23,38,71,55,126,0.000333,0.220413,14,9257.344134,514.296896,661.238867,162.645284,3,0
0,0,16,16,15,22,37,69,53,122,0.000333,0.211851,14,8897.746348,494.319242,635.553311,156.710855,3,0
0,0,11,11,10,13,23,39,29,68,0.000333,0.102534,10,3076.02213,170.890118,307.602213,81.324997,2,0
0,0,14,14,10,16,26,54,39,93,0.000333,0.145714,10,4371.408938,242.856052,437.140894,97.219281,2,0
0,0,12,12,10,14,24,41,31,72,0.000333,0.110039,10,3301.173001,183.3985,330.1173,86.52225,2,0
0,0,16,16,12,18,30,59,45,104,0.000333,0.170106,12,6123.799463,340.211081,510.316622,118.0782,2,0
0,0,16,16,17,23,40,66,50,116,0.000333,0.205781,16,9877.498544,548.749919,617.343659,173.528793,5,0
0,0,19,19,17,26,43,81,60,141,0.000333,0.255034,16,12241.65329,680.091849,765.10333,191.698301,5,0
0,0,17,17,17,24,41,68,52,120,0.000333,0.214302,16,10286.49985,571.472214,642.906241,179.525968,5,0
0,0,21,21,17,28,45,86,66,152,0.000333,0.278254,16,13356.18673,742.010374,834.761671,204.092806,5,0
0,0,16,16,16,25,41,66,49,115,0.000333,0.205373,8,4928.947844,273.830436,616.118481,180.096405,4,0
0,0,17,17,16,24,40,76,52,128,0.000333,0.227069,16,10899.30874,605.517152,681.206796,174.0391,4,0
0,0,17,17,16,26,42,68,51,119,0.000333,0.213895,8,5133.486186,285.193677,641.685773,186.211433,4,0
0,0,19,19,15,28,43,80,59,139,0.000333,0.251417,14,10559.51121,586.639512,754.250801,193.209297,4,0
0,0,16,16,18,25,43,68,52,120,0.000333,0.217051,18,11720.73187,651.151771,651.151771,191.155055,5,0
0,0,17,17,18,26,44,78,57,135,0.000333,0.245674,18,13266.41883,737.023269,737.023269,197.270083,5,0
0,0,17,17,18,26,44,70,54,124,0.000333,0.225657,18,12185.45137,676.969521,676.969521,197.270083,5,0
0,0,19,19,17,28,45,82,62,144,0.000333,0.263609,16,12653.22953,702.957196,790.826846,204.092806,5,0
0,0,16,16,17,25,42,67,52,119,0.000333,0.213895,16,10266.97237,570.387354,641.685773,185.583273,5,0
0,0,17,17,17,26,43,77,57,134,0.000333,0.242373,16,11633.91163,646.328424,727.119477,191.698301,5,0
0,0,17,17,17,26,43,69,54,123,0.000333,0.222477,16,10678.88904,593.271613,667.430565,191.698301,5,0
0,0,19,19,16,28,44,81,62,143,0.000333,0.260233,16,12491.17954,693.954419,780.698721,198.605938,5,0
0,0,11,11,10,15,25,40,31,71,0.000333,0.109905,10,3297.137895,183.174327,329.713789,91.82264,2,0
0,0,12,12,10,16,26,50,36,86,0.000333,0.134746,10,4042.378158,224.576564,404.237816,97.219281,2,0
0,0,12,12,10,16,26,42,33,75,0.000333,0.117511,10,3525.329789,195.851655,352.532979,97.219281,2,0
0,0,14,14,11,18,29,54,41,95,0.000333,0.153836,10,4615.081945,256.393441,461.508195,113.112398,2,0
0,0,16,16,13,21,34,69,57,126,0.000333,0.213673,12,7692.243816,427.346879,641.020318,140.344382,2,0
0,0,17,17,13,22,35,81,63,144,0.000333,0.246206,12,8863.401053,492.41117,738.616754,146.213212,2,0
0,0,17,17,13,22,35,71,59,130,0.000333,0.222269,12,8001.681506,444.537861,666.806792,146.213212,2,0
0,0,16,16,13,21,34,69,57,126,0.000333,0.213673,12,7692.243816,427.346879,641.020318,140.344382,2,0
0,0,17,17,13,22,35,81,63,144,0.000333,0.246206,12,8863.401053,492.41117,738.616754,146.213212,2,0
0,0,17,17,13,22,35,71,59,130,0.000333,0.222269,12,8001.681506,444.537861,666.806792,146.213212,2,0
0,0,16,16,13,21,34,69,57,126,0.000333,0.213673,12,7692.243816,427.346879,641.020318,140.344382,2,0
0,0,21,21,17,30,47,96,78,174,0.000333,0.322166,16,15463.97536,859.109742,966.49846,216.693586,5,0
0,0,22,22,17,31,48,108,84,192,0.000333,0.357438,16,17157.0048,953.166933,1072.3128,223.066954,5,0
0,0,22,22,17,31,48,98,80,178,0.000333,0.331374,16,15905.9732,883.665178,994.123325,223.066954,5,0
0,0,21,21,17,30,47,96,78,174,0.000333,0.322166,16,15463.97536,859.109742,966.49846,216.693586,5,0
0,0,21,21,17,29,46,86,69,155,0.000333,0.285384,16,13698.43365,761.024092,856.152103,210.368317,5,0
0,0,22,22,17,30,47,98,75,173,0.000333,0.320315,16,15375.10194,854.17233,960.943871,216.693586,5,0
0,0,22,22,17,30,47,88,71,159,0.000333,0.294393,16,14130.87404,785.048558,883.179627,216.693586,5,0
0,0,21,21,17,29,46,86,69,155,0.000333,0.285384,16,13698.43365,761.024092,856.152103,210.368317,5,0
0,0,16,16,11,19,30,59,48,107,0.000333,0.175012,10,5250.372937,291.687385,525.037294,118.764371,2,0
0,0,17,17,11,20,31,71,54,125,0.000333,0.206425,10,6192.745388,344.04141,619.274539,124.49231,2,0
0,0,17,17,11,20,31,61,50,111,0.000333,0.183305,10,5499.157905,305.508772,549.91579,124.49231,2,0
0,0,16,16,11,19,30,59,48,107,0.000333,0.175012,10,5250.372937,291.687385,525.037294,118.764371,2,0
0,0,21,21,16,29,45,89,71,160,0.000333,0.292899,16,14059.14393,781.063551,878.696495,204.881449,5,0
0,0,22,22,16,30,46,102,78,180,0.000333,0.331414,16,15907.85843,883.769913,994.241152,211.206718,5,0
0,0,22,22,16,30,46,91,73,164,0.000333,0.301955,16,14493.82657,805.212587,905.864161,211.206718,5,0
0,0,21,21,16,29,45,89,71,160,0.000333,0.292899,16,14059.14393,781.063551,878.696495,204.881449,5,0
0,0,16,16,12,20,32,62,50,112,0.000333,0.186667,12,6720,373.333333,560,129.458112,2,0
0,0,17,17,12,21,33,75,57,132,0.000333,0.221953,12,7990.320285,443.906683,665.860024,135.258216,2,0
0,0,17,17,12,21,33,64,52,116,0.000333,0.19505,12,7021.796614,390.099812,585.149718,135.258216,2,0
0,0,16,16,12,20,32,62,50,112,0.000333,0.186667,12,6720,373.333333,560,129.458112,2,0
0,0,11,11,10,13,23,39,29,68,0.000333,0.102534,10,3076.02213,170.890118,307.602213,81.324997,2,0
0,0,14,14,10,16,26,54,39,93,0.000333,0.145714,10,4371.408938,242.856052,437.140894,97.219281,2,0
0,0,12,12,10,14,24,41,31,72,0.000333,0.110039,10,3301.173001,183.3985,330.1173,86.52225,2,0
0,0,16,16,12,18,30,59,45,104,0.000333,0.170106,12,6123.799463,340.211081,510.316622,118.0782,2,0
0,0,11,11,12,14,26,41,31,72,0.000333,0.112811,12,4061.179916,225.621106,338.43166,96.322519,3,0
0,0,11,11,12,14,26,41,31,72,0.000333,0.112811,12,4061.179916,225.621106,338.43166,96.322519,3,0
0,0,11,11,12,14,26,41,31,72,0.000333,0.112811,12,4061.179916,225.621106,338.43166,96.322519,3,0
0,0,11,11,13,16,29,43,33,76,0.000333,0.123069,12,4430.478668,246.137704,369.206556,112.105716,3,0
0,0,12,12,13,17,30,53,38,91,0.000333,0.148842,12,5358.32453,297.684696,446.527044,117.592585,3,0
0,0,12,12,13,17,30,45,35,80,0.000333,0.13085,12,4710.614972,261.700832,392.551248,117.592585,3,0
0,0,14,14,14,19,33,57,43,100,0.000333,0.168146,14,7062.151767,392.341765,504.439412,134.013592,3,0
0,0,11,11,11,15,26,41,31,72,0.000333,0.112811,10,3384.316597,188.017589,338.43166,96.657107,2,0
0,0,12,12,11,16,27,51,36,87,0.000333,0.137892,10,4136.752127,229.819563,413.675213,102.053748,2,0
0,0,12,12,11,16,27,43,33,76,0.000333,0.120457,10,3613.714502,200.761917,361.37145,102.053748,2,0
0,0,14,14,12,18,30,55,41,96,0.000333,0.15702,12,5652.737966,314.040998,471.061497,118.0782,2,0
0,0,11,11,12,16,28,42,33,75,0.000333,0.120184,12,4326.61943,240.367746,360.551619,107.01955,3,0
0,0,12,12,12,17,29,52,38,90,0.000333,0.145739,12,5246.619475,291.47886,437.21829,112.506418,3,0
0,0,12,12,12,17,29,44,35,79,0.000333,0.127927,12,4605.365983,255.853666,383.780499,112.506418,3,0
0,0,14,14,13,20,33,56,43,99,0.000333,0.166465,12,5992.740214,332.930012,499.395018,134.544278,3,0
0,0,11,11,10,15,25,40,31,71,0.000333,0.109905,10,3297.137895,183.174327,329.713789,91.82264,2,0
0,0,12,12,10,16,26,50,36,86,0.000333,0.134746,10,4042.378158,224.576564,404.237816,97.219281,2,0
0,0,12,12,10,16,26,42,33,75,0.000333,0.117511,10,3525.329789,195.851655,352.532979,97.219281,2,0
0,0,14,14,11,18,29,54,41,95,0.000333,0.153836,10,4615.081945,256.393441,461.508195,113.112398,2,0
0,0,16,16,13,21,34,69,57,126,0.000333,0.213673,12,7692.243816,427.346879,641.020318,140.344382,2,0
0,0,17,17,13,22,35,81,63,144,0.000333,0.246206,12,8863.401053,492.41117,738.616754,146.213212,2,0
0,0,17,17,13,22,35,71,59,130,0.000333,0.222269,12,8001.681506,444.537861,666.806792,146.213212,2,0
0,0,16,16,13,21,34,69,57,126,0.000333,0.213673,12,7692.243816,427.346879,641.020318,140.344382,2,0
0,0,16,16,14,22,36,71,59,130,0.000333,0.22403,14,9409.263503,522.736861,672.09025,151.410465,3,0
0,0,17,17,14,23,37,83,65,148,0.000333,0.257,14,10793.98737,599.665965,770.999098,157.344894,3,0
0,0,17,17,14,23,37,73,61,134,0.000333,0.232689,14,9772.934514,542.940806,698.066751,157.344894,3,0
0,0,16,16,14,22,36,71,59,130,0.000333,0.22403,14,9409.263503,522.736861,672.09025,151.410465,3,0
0,0,16,16,11,19,30,59,48,107,0.000333,0.175012,10,5250.372937,291.687385,525.037294,118.764371,2,0
0,0,17,17,11,21,32,71,54,125,0.000333,0.208333,10,6250,347.222222,625,130.292414,2,0
0,0,17,17,11,20,31,61,50,111,0.000333,0.183305,10,5499.157905,305.508772,549.91579,124.49231,2,0
0,0,16,16,11,19,30,59,48,107,0.000333,0.175012,10,5250.372937,291.687385,525.037294,118.764371,2,0
0,0,16,16,12,20,32,61,50,111,0.000333,0.185,12,6660,370,555,129.458112,3,0
0,0,17,17,12,22,34,73,56,129,0.000333,0.218761,12,7875.392478,437.521804,656.282707,141.127046,3,0
0,0,17,17,12,21,33,63,52,115,0.000333,0.193368,12,6961.263885,386.736882,580.105324,135.258216,3,0
0,0,16,16,12,20,32,61,50,111,0.000333,0.185,12,6660,370,555,129.458112,3,0
0,0,16,16,12,20,32,62,50,112,0.000333,0.186667,12,6720,373.333333,560,129.458112,2,0
0,0,17,17,12,21,33,75,57,132,0.000333,0.221953,12,7990.320285,443.906683,665.860024,135.258216,2,0
0,0,17,17,12,21,33,64,52,116,0.000333,0.19505,12,7021.796614,390.099812,585.149718,135.258216,2,0
0,0,16,16,12,20,32,62,50,112,0.000333,0.186667,12,6720,373.333333,560,129.458112,2,0
0,0,16,16,13,21,34,64,52,116,0.000333,0.196715,12,7081.748275,393.43046,590.14569,140.344382,3,0
0,0,17,17,13,22,35,77,59,136,0.000333,0.232527,12,8370.989884,465.054994,697.58249,146.213212,3,0
0,0,17,17,13,22,35,66,54,120,0.000333,0.205171,12,7386.167544,410.342641,615.513962,146.213212,3,0
0,0,16,16,13,21,34,64,52,116,0.000333,0.196715,12,7081.748275,393.43046,590.14569,140.344382,3,0
0,0,9,9,12,10,22,29,20,49,0.000333,0.072837,12,2622.145792,145.674766,218.512149,76.238831,2,0
0,0,12,12,12,13,25,44,30,74,0.000333,0.114548,12,4123.744297,229.096905,343.645358,91.125266,2,0
0,0,10,10,12,11,23,31,22,53,0.000333,0.079916,12,2876.985404,159.832522,239.748784,81.073298,2,0
0,0,14,14,12,15,27,49,36,85,0.000333,0.134722,12,4849.985252,269.443625,404.165438,101.622909,2,0
0,0,14,14,17,19,36,56,41,97,0.000333,0.167161,16,8023.723602,445.762422,501.482725,150.197491,5,0
0,0,17,17,17,22,39,71,51,122,0.000333,0.21494,16,10317.10513,573.172507,644.819071,167.594364,5,0
0,0,15,15,17,20,37,58,43,101,0.000333,0.175385,16,8418.476639,467.693147,526.15479,155.92543,5,0
0,0,19,19,17,24,41,76,57,133,0.000333,0.237518,16,11400.87067,633.381704,712.554417,179.525968,5,0
0,0,11,11,12,11,23,35,22,57,0.000333,0.085948,12,3094.116378,171.895354,257.843031,81.073298,4,0
0,0,14,14,12,14,26,50,32,82,0.000333,0.128479,12,4625.232683,256.957371,385.436057,96.322519,4,0
0,0,12,12,12,12,24,37,24,61,0.000333,0.093228,12,3356.192551,186.455142,279.682713,86.0391,4,0
0,0,16,16,12,16,28,55,38,93,0.000333,0.149028,12,5365.008093,298.056005,447.084008,107.01955,4,0
0,0,16,16,17,19,36,62,43,105,0.000333,0.180947,16,8685.474002,482.526333,542.842125,150.197491,7,0
0,0,19,19,17,22,39,77,53,130,0.000333,0.229034,16,10993.63662,610.75759,687.102288,167.594364,7,0
0,0,17,17,17,20,37,64,45,109,0.000333,0.189277,16,9085.28667,504.738148,567.830417,155.92543,7,0
0,0,21,21,17,24,41,82,59,141,0.000333,0.251805,16,12086.63732,671.479851,755.414833,179.525968,7,0
0,0,12,12,15,11,26,38,22,60,0.000333,0.094009,14,3948.369363,219.353854,282.026383,96.657107,4,0
0,0,15,15,15,14,29,53,32,85,0.000333,0.137643,14,5780.997384,321.166521,412.928385,111.906328,4,0
0,0,13,13,15,12,27,40,24,64,0.000333,0.101438,14,4260.379202,236.687733,304.3128,101.622909,4,0
0,0,17,17,15,16,31,58,38,96,0.000333,0.158534,14,6658.439841,369.913325,475.602846,122.603359,4,0
0,0,17,17,20,19,39,65,43,108,0.000333,0.190274,20,11416.46879,634.248266,570.82344,167.149185,7,0
0,0,20,20,20,22,42,80,53,133,0.000333,0.239059,20,14343.56435,796.864686,717.178217,184.546058,7,0
0,0,18,18,20,20,40,67,45,112,0.000333,0.198685,20,11921.11893,662.284385,596.055947,172.877124,7,0
0,0,22,22,20,24,44,85,59,144,0.000333,0.262053,20,15723.16306,873.509059,786.158153,196.477662,7,0
0,0,11,11,12,11,23,35,24,59,0.000333,0.088963,12,3202.681865,177.92677,266.890155,81.073298,4,0
0,0,14,14,12,14,26,50,34,84,0.000333,0.131612,12,4738.043236,263.224624,394.836936,96.322519,4,0
0,0,12,12,12,12,24,37,26,63,0.000333,0.096284,12,3466.231651,192.568425,288.852638,86.0391,4,0
0,0,16,16,12,15,27,55,40,95,0.000333,0.150571,12,5420.571752,301.142875,451.714313,101.622909,4,0
0,0,13,13,14,12,26,38,27,65,0.000333,0.101843,14,4277.400144,237.633341,305.528582,96.322519,4,0
0,0,16,16,17,20,37,62,45,107,0.000333,0.185804,16,8918.584162,495.476898,557.41151,155.92543,7,0
0,0,19,19,17,23,40,77,55,132,0.000333,0.234165,16,11239.91214,624.439563,702.494509,173.528793,7,0
0,0,17,17,17,21,38,64,47,111,0.000333,0.194173,16,9320.319264,517.795515,582.519954,161.725534,7,0
0,0,21,21,17,24,41,82,61,143,0.000333,0.255377,16,12258.07899,681.004388,766.129937,179.525968,7,0
0,0,12,12,16,11,27,39,24,63,0.000333,0.099853,16,4792.926602,266.2737,299.557913,102.053748,4,0
0,0,15,15,16,14,30,54,34,88,0.000333,0.143935,16,6908.901959,383.827887,431.806372,117.302969,4,0
0,0,13,13,16,12,28,41,26,67,0.000333,0.107364,16,5153.484476,286.304693,322.09278,107.01955,4,0
0,0,17,17,16,15,31,59,40,99,0.000333,0.163488,16,7847.446956,435.969275,490.465435,122.603359,4,0
0,0,14,14,18,12,30,42,27,69,0.000333,0.112858,18,6094.35812,338.575451,338.575451,118.0782,4,0
0,0,17,17,21,20,41,66,45,111,0.000333,0.198229,20,11893.76545,660.764747,594.688273,178.677228,7,0
0,0,20,20,21,23,44,81,55,136,0.000333,0.247494,20,14849.654,824.980778,742.4827,196.280591,7,0
0,0,18,18,21,21,42,68,47,115,0.000333,0.206706,20,12402.33007,689.018337,620.116504,184.477332,7,0
0,0,22,22,21,24,45,86,61,147,0.000333,0.269101,20,16146.0481,897.002672,807.302405,202.277766,7,0
0,0,12,12,15,12,27,38,22,60,0.000333,0.095098,7,1997.052751,110.947375,285.29325,101.622909,4,0
0,0,15,15,15,15,30,53,32,85,0.000333,0.139029,14,5839.199809,324.399989,417.085701,117.206718,4,0
0,0,13,13,15,13,28,40,24,64,0.000333,0.102557,7,2153.695005,119.649723,307.670715,106.709075,4,0
0,0,17,17,15,17,32,58,38,96,0.000333,0.16,14,6720,373.333333,480,128.090227,4,0
0,0,14,14,17,13,30,41,25,66,0.000333,0.107952,8,2590.838234,143.935457,323.854779,117.592585,4,0
0,0,16,16,17,20,37,62,43,105,0.000333,0.182331,16,8751.881654,486.215647,546.992603,155.92543,7,0
0,0,19,19,17,23,40,77,53,130,0.000333,0.230617,16,11069.61044,614.978358,691.850652,173.528793,7,0
0,0,17,17,17,21,38,64,45,109,0.000333,0.190675,16,9152.385583,508.465866,572.024099,161.725534,7,0
0,0,21,21,17,25,42,82,59,141,0.000333,0.253439,16,12165.06811,675.837117,760.316757,185.583273,7,0
0,0,11,11,12,11,23,35,22,57,0.000333,0.085948,12,3094.116378,171.895354,257.843031,81.073298,4,0
0,0,14,14,12,14,26,50,32,82,0.000333,0.128479,12,4625.232683,256.957371,385.436057,96.322519,4,0
0,0,12,12,12,12,24,37,24,61,0.000333,0.093228,12,3356.192551,186.455142,279.682713,86.0391,4,0
0,0,16,16,12,16,28,55,38,93,0.000333,0.149028,12,5365.008093,298.056005,447.084008,107.01955,4,0
0,0,13,13,14,12,26,38,25,63,0.000333,0.098709,14,4145.787831,230.321546,296.127702,96.322519,4,0
0,0,17,17,20,21,41,65,43,108,0.000333,0.192872,20,11572.31233,642.906241,578.615616,178.677228,7,0
0,0,20,20,20,24,44,80,53,133,0.000333,0.242035,20,14522.08811,806.782673,726.104405,196.477662,7,0
0,0,18,18,20,22,42,67,45,112,0.000333,0.201313,20,12078.79103,671.043946,603.939551,184.546058,7,0
0,0,22,22,20,26,46,85,59,144,0.000333,0.265131,20,15907.85843,883.769913,795.392922,208.649995,7,0
0,0,12,12,15,12,27,38,22,60,0.000333,0.095098,7,1997.052751,110.947375,285.29325,101.622909,4,0
0,0,15,15,15,15,30,53,32,85,0.000333,0.139029,14,5839.199809,324.399989,417.085701,117.206718,4,0
0,0,13,13,15,13,28,40,24,64,0.000333,0.102557,7,2153.695005,119.649723,307.670715,106.709075,4,0
0,0,17,17,15,17,32,58,38,96,0.000333,0.16,14,6720,373.333333,480,128.090227,4,0
0,0,14,14,17,13,30,41,25,66,0.000333,0.107952,8,2590.838234,143.935457,323.854779,117.592585,4,0
0,0,16,16,17,20,37,62,43,105,0.000333,0.182331,16,8751.881654,486.215647,546.992603,155.92543,7,0
0,0,19,19,17,23,40,77,53,130,0.000333,0.230617,16,11069.61044,614.978358,691.850652,173.528793,7,0
0,0,17,17,17,21,38,64,45,109,0.000333,0.190675,16,9152.385583,508.465866,572.024099,161.725534,7,0
0,0,21,21,17,25,42,82,59,141,0.000333,0.253439,16,12165.06811,675.837117,760.316757,185.583273,7,0
0,0,11,11,12,11,23,35,22,57,0.000333,0.085948,12,3094.116378,171.895354,257.843031,81.073298,4,0
0,0,14,14,12,14,26,50,32,82,0.000333,0.128479,12,4625.232683,256.957371,385.436057,96.322519,4,0
0,0,12,12,12,12,24,37,24,61,0.000333,0.093228,12,3356.192551,186.455142,279.682713,86.0391,4,0
0,0,16,16,12,16,28,55,38,93,0.000333,0.149028,12,5365.008093,298.056005,447.084008,107.01955,4,0
0,0,13,13,14,12,26,38,25,63,0.000333,0.098709,14,4145.787831,230.321546,296.127702,96.322519,4,0
0,0,17,17,20,21,41,65,43,108,0.000333,0.192872,20,11572.31233,642.906241,578.615616,178.677228,7,0
0,0,20,20,20,24,44,80,53,133,0.000333,0.242035,20,14522.08811,806.782673,726.104405,196.477662,7,0
0,0,18,18,20,22,42,67,45,112,0.000333,0.201313,20,12078.79103,671.043946,603.939551,184.546058,7,0
0,0,22,22,20,26,46,85,59,144,0.000333,0.265131,20,15907.85843,883.769913,795.392922,208.649995,7,0
0,0,16,16,17,21,38,62,45,107,0.000333,0.187176,16,8984.451903,499.136217,561.528244,161.725534,7,0
0,0,19,19,17,24,41,77,55,132,0.000333,0.235732,16,11315.14983,628.619435,707.196865,179.525968,7,0
0,0,17,17,17,22,39,64,47,111,0.000333,0.19556,16,9386.874341,521.493019,586.679646,167.594364,7,0
0,0,21,21,17,25,42,82,61,143,0.000333,0.257034,16,12337.62226,685.423459,771.101391,185.583273,7,0
0,0,12,12,16,12,28,39,24,63,0.000333,0.100954,16,4845.813761,269.211876,302.86336,107.01955,4,0
0,0,15,15,16,15,31,54,34,88,0.000333,0.145323,16,6975.508405,387.528245,435.969275,122.603359,4,0
0,0,13,13,16,13,29,41,26,67,0.000333,0.108495,16,5207.755627,289.319757,325.484727,112.105716,4,0
0,0,17,17,16,16,32,59,40,99,0.000333,0.165,16,7920,440,495,128,4,0
0,0,14,14,18,13,31,42,27,69,0.000333,0.113947,18,6153.111818,341.839545,341.839545,123.164366,4,0
0,0,17,17,21,21,42,66,45,111,0.000333,0.199516,20,11970.94468,665.052482,598.547234,184.477332,7,0
0,0,20,20,21,24,45,81,55,136,0.000333,0.248964,20,14937.84042,829.880023,746.892021,202.277766,7,0
0,0,18,18,21,22,43,68,47,115,0.000333,0.208007,20,12480.40894,693.356052,624.020447,190.346161,7,0
0,0,22,22,21,25,46,86,61,147,0.000333,0.270655,20,16239.27215,902.181786,811.963608,208.335071,7,0
0,0,11,11,12,12,24,35,24,59,0.000333,0.090171,12,3246.153451,180.341858,270.512788,86.0391,4,0
0,0,14,14,12,15,27,50,34,84,0.000333,0.133137,12,4792.926602,266.2737,399.41055,101.622909,4,0
0,0,12,12,12,13,25,37,26,63,0.000333,0.097521,12,3510.755279,195.04196,292.56294,91.125266,4,0
0,0,16,16,12,16,28,55,40,95,0.000333,0.152233,12,5480.384611,304.465812,456.698718,107.01955,4,0
0,0,13,13,14,13,27,38,27,65,0.000333,0.103023,14,4326.947627,240.385979,309.067688,101.408685,4,0
0,0,16,16,17,21,38,62,45,107,0.000333,0.187176,16,8984.451903,499.136217,561.528244,161.725534,7,0
0,0,19,19,17,24,41,77,55,132,0.000333,0.235732,16,11315.14983,628.619435,707.196865,179.525968,7,0
0,0,17,17,17,22,39,64,47,111,0.000333,0.19556,16,9386.874341,521.493019,586.679646,167.594364,7,0
0,0,21,21,17,25,42,82,61,143,0.000333,0.257034,16,12337.62226,685.423459,771.101391,185.583273,7,0
0,0,12,12,16,12,28,39,24,63,0.000333,0.100954,16,4845.813761,269.211876,302.86336,107.01955,4,0
0,0,15,15,16,15,31,54,34,88,0.000333,0.145323,16,6975.508405,387.528245,435.969275,122.603359,4,0
0,0,13,13,16,13,29,41,26,67,0.000333,0.108495,16,5207.755627,289.319757,325.484727,112.105716,4,0
0,0,17,17,16,16,32,59,40,99,0.000333,0.165,16,7920,440,495,128,4,0
0,0,14,14,18,13,31,42,27,69,0.000333,0.113947,18,6153.111818,341.839545,341.839545,123.164366,4,0
0,0,17,17,21,21,42,66,45,111,0.000333,0.199516,20,11970.94468,665.052482,598.547234,184.477332,7,0
0,0,20,20,21,24,45,81,55,136,0.000333,0.248964,20,14937.84042,829.880023,746.892021,202.277766,7,0
0,0,18,18,21,22,43,68,47,115,0.000333,0.208007,20,12480.40894,693.356052,624.020447,190.346161,7,0
0,0,22,22,21,25,46,86,61,147,0.000333,0.270655,20,16239.27215,902.181786,811.963608,208.335071,7,0
0,0,11,11,12,12,24,35,24,59,0.000333,0.090171,12,3246.153451,180.341858,270.512788,86.0391,4,0
0,0,14,14,12,15,27,50,34,84,0.000333,0.133137,12,4792.926602,266.2737,399.41055,101.622909,4,0
0,0,12,12,12,13,25,37,26,63,0.000333,0.097521,12,3510.755279,195.04196,292.56294,91.125266,4,0
0,0,16,16,12,16,28,55,40,95,0.000333,0.152233,12,5480.384611,304.465812,456.698718,107.01955,4,0
0,0,13,13,14,13,27,38,27,65,0.000333,0.103023,14,4326.947627,240.385979,309.067688,101.408685,4,0
0,0,17,17,20,21,41,65,43,108,0.000333,0.192872,20,11572.31233,642.906241,578.615616,178.677228,7,0
0,0,20,20,20,24,44,80,53,133,0.000333,0.242035,20,14522.08811,806.782673,726.104405,196.477662,7,0
0,0,18,18,20,22,42,67,45,112,0.000333,0.201313,20,12078.79103,671.043946,603.939551,184.546058,7,0
0,0,22,22,20,26,46,85,59,144,0.000333,0.265131,20,15907.85843,883.769913,795.392922,208.649995,7,0
0,0,16,16,17,20,37,62,43,105,0.000333,0.182331,16,8751.881654,486.215647,546.992603,155.92543,7,0
0,0,19,19,17,23,40,77,53,130,0.000333,0.230617,16,11069.61044,614.978358,691.850652,173.528793,7,0
0,0,17,17,17,21,38,64,45,109,0.000333,0.190675,16,9152.385583,508.465866,572.024099,161.725534,7,0
0,0,21,21,17,25,42,82,59,141,0.000333,0.253439,16,12165.06811,675.837117,760.316757,185.583273,7,0
0,0,12,12,15,12,27,38,22,60,0.000333,0.095098,7,1997.052751,110.947375,285.29325,101.622909,4,0
0,0,15,15,15,15,30,53,32,85,0.000333,0.139029,14,5839.199809,324.399989,417.085701,117.206718,4,0
0,0,13,13,15,13,28,40,24,64,0.000333,0.102557,7,2153.695005,119.649723,307.670715,106.709075,4,0
0,0,17,17,15,17,32,58,38,96,0.000333,0.16,14,6720,373.333333,480,128.090227,4,0
0,0,14,14,17,13,30,41,25,66,0.000333,0.107952,8,2590.838234,143.935457,323.854779,117.592585,4,0
0,0,11,11,12,11,23,35,22,57,0.000333,0.085948,12,3094.116378,171.895354,257.843031,81.073298,4,0
0,0,14,14,12,14,26,50,32,82,0.000333,0.128479,12,4625.232683,256.957371,385.436057,96.322519,4,0
0,0,12,12,12,12,24,37,24,61,0.000333,0.093228,12,3356.192551,186.455142,279.682713,86.0391,4,0
0,0,16,16,12,16,28,55,38,93,0.000333,0.149028,12,5365.008093,298.056005,447.084008,107.01955,4,0
0,0,13,13,14,12,26,38,25,63,0.000333,0.098709,14,4145.787831,230.321546,296.127702,96.322519,4,0
0,0,11,11,12,11,23,35,22,57,0.000333,0.085948,12,3094.116378,171.895354,257.843031,81.073298,4,0
0,0,14,14,12,14,26,50,32,82,0.000333,0.128479,12,4625.232683,256.957371,385.436057,96.322519,4,0
0,0,12,12,12,12,24,37,24,61,0.000333,0.093228,12,3356.192551,186.455142,279.682713,86.0391,4,0
0,0,16,16,12,16,28,55,38,93,0.000333,0.149028,12,5365.008093,298.056005,447.084008,107.01955,4,0
0,0,13,13,14,12,26,38,25,63,0.000333,0.098709,14,4145.787831,230.321546,296.127702,96.322519,4,0
0,0,16,16,17,20,37,62,43,105,0.000333,0.182331,16,8751.881654,486.215647,546.992603,155.92543,7,0
0,0,19,19,17,23,40,77,53,130,0.000333,0.230617,16,11069.61044,614.978358,691.850652,173.528793,7,0
0,0,17,17,17,21,38,64,45,109,0.000333,0.190675,16,9152.385583,508.465866,572.024099,161.725534,7,0
0,0,21,21,17,25,42,82,59,141,0.000333,0.253439,16,12165.06811,675.837117,760.316757,185.583273,7,0
0,0,12,12,15,12,27,38,22,60,0.000333,0.095098,7,1997.052751,110.947375,285.29325,101.622909,4,0
0,0,15,15,15,15,30,53,32,85,0.000333,0.139029,14,5839.199809,324.399989,417.085701,117.206718,4,0
0,0,13,13,15,13,28,40,24,64,0.000333,0.102557,7,2153.695005,119.649723,307.670715,106.709075,4,0
0,0,17,17,15,17,32,58,38,96,0.000333,0.16,14,6720,373.333333,480,128.090227,4,0
0,0,14,14,17,13,30,41,25,66,0.000333,0.107952,8,2590.838234,143.935457,323.854779,117.592585,4,0
0,0,17,17,20,21,41,65,43,108,0.000333,0.192872,20,11572.31233,642.906241,578.615616,178.677228,7,0
0,0,20,20,20,24,44,80,53,133,0.000333,0.242035,20,14522.08811,806.782673,726.104405,196.477662,7,0
0,0,18,18,20,22,42,67,45,112,0.000333,0.201313,20,12078.79103,671.043946,603.939551,184.546058,7,0
0,0,21,21,22,24,46,73,50,123,0.000333,0.226466,22,14946.75865,830.375481,679.398121,208.146596,8,0
0,0,11,11,12,11,23,35,22,57,0.000333,0.085948,12,3094.116378,171.895354,257.843031,81.073298,4,0
0,0,14,14,12,14,26,50,32,82,0.000333,0.128479,12,4625.232683,256.957371,385.436057,96.322519,4,0
0,0,12,12,12,12,24,37,24,61,0.000333,0.093228,12,3356.192551,186.455142,279.682713,86.0391,4,0
0,0,16,16,12,16,28,55,38,93,0.000333,0.149028,12,5365.008093,298.056005,447.084008,107.01955,4,0
0,0,13,13,14,12,26,38,25,63,0.000333,0.098709,14,4145.787831,230.321546,296.127702,96.322519,4,0
0,0,16,16,17,20,37,62,43,105,0.000333,0.182331,16,8751.881654,486.215647,546.992603,155.92543,7,0
0,0,19,19,17,23,40,77,53,130,0.000333,0.230617,16,11069.61044,614.978358,691.850652,173.528793,7,0
0,0,17,17,17,21,38,64,45,109,0.000333,0.190675,16,9152.385583,508.465866,572.024099,161.725534,7,0
0,0,21,21,17,25,42,82,59,141,0.000333,0.253439,16,12165.06811,675.837117,760.316757,185.583273,7,0
0,0,12,12,15,12,27,38,22,60,0.000333,0.095098,7,1997.052751,110.947375,285.29325,101.622909,4,0
0,0,15,15,15,15,30,53,32,85,0.000333,0.139029,14,5839.199809,324.399989,417.085701,117.206718,4,0
0,0,13,13,15,13,28,40,24,64,0.000333,0.102557,7,2153.695005,119.649723,307.670715,106.709075,4,0
0,0,17,17,15,17,32,58,38,96,0.000333,0.16,14,6720,373.333333,480,128.090227,4,0
0,0,14,14,17,13,30,41,25,66,0.000333,0.107952,8,2590.838234,143.935457,323.854779,117.592585,4,0
0,0,17,17,20,21,41,65,43,108,0.000333,0.192872,20,11572.31233,642.906241,578.615616,178.677228,7,0
0,0,20,20,20,24,44,80,53,133,0.000333,0.242035,20,14522.08811,806.782673,726.104405,196.477662,7,0
0,0,18,18,20,22,42,67,45,112,0.000333,0.201313,20,12078.79103,671.043946,603.939551,184.546058,7,0
0,0,22,22,20,26,46,85,59,144,0.000333,0.265131,20,15907.85843,883.769913,795.392922,208.649995,7,0
0,0,11,11,12,11,23,35,22,57,0.000333,0.085948,12,3094.116378,171.895354,257.843031,81.073298,4,0
0,0,14,14,12,14,26,50,32,82,0.000333,0.128479,12,4625.232683,256.957371,385.436057,96.322519,4,0
0,0,12,12,12,12,24,37,24,61,0.000333,0.093228,12,3356.192551,186.455142,279.682713,86.0391,4,0
0,0,16,16,12,16,28,55,38,93,0.000333,0.149028,12,5365.008093,298.056005,447.084008,107.01955,4,0
0,0,13,13,14,12,26,38,25,63,0.000333,0.098709,14,4145.787831,230.321546,296.127702,96.322519,4,0
0,0,12,12,15,12,27,38,22,60,0.000333,0.095098,7,1997.052751,110.947375,285.29325,101.622909,4,0
0,0,15,15,15,15,30,53,32,85,0.000333,0.139029,14,5839.199809,324.399989,417.085701,117.206718,4,0
0,0,13,13,15,13,28,40,24,64,0.000333,0.102557,7,2153.695005,119.649723,307.670715,106.709075,4,0
0,0,17,17,15,17,32,58,38,96,0.000333,0.16,14,6720,373.333333,480,128.090227,4,0
0,0,14,14,17,13,30,41,25,66,0.000333,0.107952,8,2590.838234,143.935457,323.854779,117.592585,4,0
0,0,16,16,17,20,37,62,43,105,0.000333,0.182331,16,8751.881654,486.215647,546.992603,155.92543,7,0
0,0,19,19,17,23,40,77,53,130,0.000333,0.230617,16,11069.61044,614.978358,691.850652,173.528793,7,0
0,0,17,17,17,21,38,64,45,109,0.000333,0.190675,16,9152.385583,508.465866,572.024099,161.725534,7,0
0,0,21,21,17,25,42,82,59,141,0.000333,0.253439,16,12165.06811,675.837117,760.316757,185.583273,7,0
0,0,17,17,20,21,41,65,43,108,0.000333,0.192872,20,11572.31233,642.906241,578.615616,178.677228,7,0
0,0,20,20,20,24,44,80,53,133,0.000333,0.242035,20,14522.08811,806.782673,726.104405,196.477662,7,0
0,0,18,18,20,22,42,67,45,112,0.000333,0.201313,20,12078.79103,671.043946,603.939551,184.546058,7,0
0,0,22,22,20,26,46,85,59,144,0.000333,0.265131,20,15907.85843,883.769913,795.392922,208.649995,7,0
0,0,11,11,12,12,24,35,24,59,0.000333,0.090171,12,3246.153451,180.341858,270.512788,86.0391,4,0
0,0,14,14,12,15,27,50,34,84,0.000333,0.133137,12,4792.926602,266.2737,399.41055,101.622909,4,0
0,0,12,12,12,13,25,37,26,63,0.000333,0.097521,12,3510.755279,195.04196,292.56294,91.125266,4,0
0,0,16,16,12,16,28,55,40,95,0.000333,0.152233,12,5480.384611,304.465812,456.698718,107.01955,4,0
0,0,13,13,14,13,27,38,27,65,0.000333,0.103023,14,4326.947627,240.385979,309.067688,101.408685,4,0
0,0,12,12,16,12,28,39,24,63,0.000333,0.100954,16,4845.813761,269.211876,302.86336,107.01955,4,0
0,0,15,15,16,15,31,54,34,88,0.000333,0.145323,16,6975.508405,387.528245,435.969275,122.603359,4,0
0,0,13,13,16,13,29,41,26,67,0.000333,0.108495,16,5207.755627,289.319757,325.484727,112.105716,4,0
0,0,17,17,16,16,32,59,40,99,0.000333,0.165,16,7920,440,495,128,4,0
0,0,14,14,18,13,31,42,27,69,0.000333,0.113947,18,6153.111818,341.839545,341.839545,123.164366,4,0
0,0,16,16,17,21,38,62,45,107,0.000333,0.187176,16,8984.451903,499.136217,561.528244,161.725534,7,0
0,0,19,19,17,24,41,77,55,132,0.000333,0.235732,16,11315.14983,628.619435,707.196865,179.525968,7,0
0,0,17,17,17,22,39,64,47,111,0.000333,0.19556,16,9386.874341,521.493019,586.679646,167.594364,7,0
0,0,21,21,17,25,42,82,61,143,0.000333,0.257034,16,12337.62226,685.423459,771.101391,185.583273,7,0
0,0,17,17,21,21,42,66,45,111,0.000333,0.199516,20,11970.94468,665.052482,598.547234,184.477332,7,0
0,0,20,20,21,24,45,81,55,136,0.000333,0.248964,20,14937.84042,829.880023,746.892021,202.277766,7,0
0,0,18,18,21,22,43,68,47,115,0.000333,0.208007,20,12480.40894,693.356052,624.020447,190.346161,7,0
0,0,22,22,21,25,46,86,61,147,0.000333,0.270655,20,16239.27215,902.181786,811.963608,208.335071,7,0
0,0,11,11,12,12,24,35,24,59,0.000333,0.090171,12,3246.153451,180.341858,270.512788,86.0391,4,0
0,0,14,14,12,15,27,50,34,84,0.000333,0.133137,12,4792.926602,266.2737,399.41055,101.622909,4,0
0,0,12,12,12,13,25,37,26,63,0.000333,0.097521,12,3510.755279,195.04196,292.56294,91.125266,4,0
0,0,16,16,12,16,28,55,40,95,0.000333,0.152233,12,5480.384611,304.465812,456.698718,107.01955,4,0
0,0,13,13,14,13,27,38,27,65,0.000333,0.103023,14,4326.947627,240.385979,309.067688,101.408685,4,0
0,0,12,12,16,12,28,39,24,63,0.000333,0.100954,16,4845.813761,269.211876,302.86336,107.01955,4,0
0,0,15,15,16,15,31,54,34,88,0.000333,0.145323,16,6975.508405,387.528245,435.969275,122.603359,4,0
0,0,13,13,16,13,29,41,26,67,0.000333,0.108495,16,5207.755627,289.319757,325.484727,112.105716,4,0
0,0,14,14,18,13,31,42,27,69,0.000333,0.113947,18,6153.111818,341.839545,341.839545,123.164366,4,0
0,0,16,16,17,21,38,62,45,107,0.000333,0.187176,16,8984.451903,499.136217,561.528244,161.725534,7,0
0,0,19,19,17,24,41,77,55,132,0.000333,0.235732,16,11315.14983,628.619435,707.196865,179.525968,7,0
0,0,17,17,17,22,39,64,47,111,0.000333,0.19556,16,9386.874341,521.493019,586.679646,167.594364,7,0
0,0,21,21,17,25,42,82,61,143,0.000333,0.257034,16,12337.62226,685.423459,771.101391,185.583273,7,0
0,0,17,17,21,21,42,66,45,111,0.000333,0.199516,20,11970.94468,665.052482,598.547234,184.477332,7,0
0,0,20,20,21,24,45,81,55,136,0.000333,0.248964,20,14937.84042,829.880023,746.892021,202.277766,7,0
0,0,18,18,21,22,43,68,47,115,0.000333,0.208007,20,12480.40894,693.356052,624.020447,190.346161,7,0
0,0,22,22,21,25,46,86,61,147,0.000333,0.270655,20,16239.27215,902.181786,811.963608,208.335071,7,0
0,0,22,22,21,22,43,76,47,123,0.000333,0.222477,20,13348.6113,741.589516,667.430565,190.346161,7,0
0,0,25,25,21,25,46,91,57,148,0.000333,0.272496,20,16349.74339,908.319077,817.487169,208.335071,7,0
0,0,23,23,21,23,44,78,49,127,0.000333,0.231116,20,13866.95631,770.386462,693.347816,196.280591,7,0
0,0,27,27,21,27,48,96,63,159,0.000333,0.296003,20,17760.18075,986.676708,888.009038,220.620628,7,0
0,0,25,25,21,23,44,84,49,133,0.000333,0.242035,20,14522.08811,806.782673,726.104405,196.280591,7,0
0,0,28,28,21,26,47,99,59,158,0.000333,0.292542,20,17552.50077,975.138932,877.625039,214.450099,7,0
0,0,26,26,21,24,45,86,51,137,0.000333,0.250795,20,15047.67748,835.982082,752.383874,202.277766,7,0
0,0,30,30,21,28,49,104,65,169,0.000333,0.316295,20,18977.71927,1054.317737,948.885964,226.844604,7,0
0,0,17,17,17,13,30,49,26,75,0.000333,0.122672,16,5888.268715,327.12604,368.016795,117.592585,4,0
0,0,20,20,17,16,33,64,36,100,0.000333,0.168146,16,8071.030591,448.390588,504.439412,133.486868,4,0
0,0,18,18,17,14,31,51,28,79,0.000333,0.130461,16,6262.104136,347.894674,391.381509,122.789837,4,0
0,0,22,22,17,18,35,69,42,111,0.000333,0.189783,16,9109.606638,506.089258,569.350415,144.545518,4,0
0,0,17,17,17,14,31,49,26,75,0.000333,0.123855,8,2972.517786,165.139877,371.564723,122.789837,4,0
0,0,20,20,17,17,34,64,36,100,0.000333,0.169582,16,8139.940546,452.218919,508.746284,138.973737,4,0
0,0,18,18,17,15,32,51,28,79,0.000333,0.131667,8,3160,175.555556,395,128.090227,4,0
0,0,22,22,17,18,35,69,42,111,0.000333,0.189783,16,9109.606638,506.089258,569.350415,144.545518,4,0
0,0,13,13,14,11,25,39,22,61,0.000333,0.094425,14,3965.853186,220.325177,283.275228,91.356717,4,0
0,0,16,16,14,14,28,54,32,86,0.000333,0.137811,14,5788.055326,321.558629,413.432523,106.605938,4,0
0,0,14,14,14,12,26,41,24,65,0.000333,0.101843,14,4277.400144,237.633341,305.528582,96.322519,4,0
0,0,18,18,14,16,30,59,38,97,0.000333,0.158656,14,6663.557429,370.197635,475.968388,117.302969,4,0
0,0,18,18,18,19,37,66,43,109,0.000333,0.189277,18,10220.9475,567.830417,567.830417,155.769273,7,0
0,0,21,21,18,22,40,81,53,134,0.000333,0.237713,18,12836.49057,713.138365,713.138365,173.166146,7,0
0,0,19,19,18,20,38,68,45,113,0.000333,0.197672,18,10674.28456,593.015809,593.015809,161.497212,7,0
0,0,23,23,18,24,42,86,59,145,0.000333,0.260629,18,14073.94847,781.886026,781.886026,185.09775,7,0
0,0,11,11,15,13,28,45,30,75,0.000333,0.120184,14,5047.722668,280.429037,360.551619,106.709075,4,0
0,0,14,14,15,16,31,60,40,100,0.000333,0.16514,14,6935.874835,385.32638,495.419631,122.603359,4,0
0,0,12,12,15,14,29,47,32,79,0.000333,0.127927,14,5372.926981,298.495943,383.780499,111.906328,4,0
0,0,16,16,15,18,33,65,46,111,0.000333,0.186643,14,7838.988461,435.499359,559.927747,133.662009,4,0
0,0,16,16,19,21,40,72,51,123,0.000333,0.218199,18,11782.7488,654.597156,654.597156,172.949289,7,0
0,0,19,19,19,24,43,87,61,148,0.000333,0.267696,18,14455.56931,803.087184,803.087184,190.749723,7,0
0,0,17,17,19,22,41,74,53,127,0.000333,0.226803,18,12247.36388,680.409105,680.409105,178.818118,7,0
0,0,21,21,19,26,45,92,67,159,0.000333,0.291068,18,15717.68356,873.204642,873.204642,202.922055,7,0
0,0,18,18,19,21,40,62,45,107,0.000333,0.189815,18,10250.03351,569.446306,569.446306,172.949289,5,0
0,0,21,21,19,24,43,77,55,132,0.000333,0.238756,18,12892.80506,716.266948,716.266948,190.749723,5,0
0,0,19,19,19,22,41,64,47,111,0.000333,0.198229,18,10704.38891,594.688273,594.688273,178.818118,5,0
0,0,23,23,19,26,45,82,61,143,0.000333,0.261778,18,14136.02987,785.334993,785.334993,202.922055,5,0
0,0,16,16,14,15,29,50,34,84,0.000333,0.136023,14,5712.98565,317.388092,408.070404,111.906328,2,0
0,0,14,14,14,13,27,37,26,63,0.000333,0.099853,14,4193.810777,232.989488,299.557913,101.408685,2,0
0,0,18,18,14,17,31,55,40,95,0.000333,0.156883,14,6589.081093,366.060061,470.648649,122.789837,2,0
0,0,18,18,18,24,42,67,58,125,0.000333,0.22468,18,12132.7142,674.039678,674.039678,185.09775,6,0
0,0,19,19,18,26,44,77,62,139,0.000333,0.252954,18,13659.49791,758.860995,758.860995,197.270083,6,0
0,0,19,19,18,25,43,69,60,129,0.000333,0.233329,18,12599.78676,699.988153,699.988153,191.155055,6,0
0,0,21,21,18,27,45,82,66,148,0.000333,0.270931,18,14630.29665,812.794258,812.794258,203.440613,6,0
0,0,13,13,13,15,28,40,33,73,0.000333,0.116979,12,4211.242912,233.95794,350.936909,106.709075,3,0
0,0,14,14,13,16,29,50,38,88,0.000333,0.142501,12,5130.027931,285.001552,427.502328,112.105716,3,0
0,0,14,14,13,16,29,42,35,77,0.000333,0.124688,12,4488.774439,249.376358,374.064537,112.105716,3,0
0,0,16,16,13,18,31,55,43,98,0.000333,0.161837,12,5826.134861,323.674159,485.511238,123.164366,3,0
0,0,19,19,21,24,45,70,58,128,0.000333,0.234319,20,14059.14393,781.063551,702.957196,202.277766,6,0
0,0,20,20,21,25,46,80,64,144,0.000333,0.265131,20,15907.85843,883.769913,795.392922,208.335071,6,0
0,0,20,20,21,25,46,72,60,132,0.000333,0.243037,20,14582.20356,810.12242,729.110178,208.335071,6,0
0,0,22,22,21,27,48,85,68,153,0.000333,0.284833,20,17089.98525,949.443625,854.499263,220.620628,6,0
0,0,19,19,20,24,44,69,58,127,0.000333,0.231116,20,13866.95631,770.386462,693.347816,196.477662,6,0
0,0,20,20,20,25,45,79,64,143,0.000333,0.261778,20,15706.69986,872.594436,785.334993,202.534967,6,0
0,0,20,20,20,25,45,71,60,131,0.000333,0.239811,20,14388.65511,799.369728,719.432756,202.534967,6,0
0,0,22,22,20,27,47,84,68,152,0.000333,0.281433,20,16885.95011,938.108339,844.297505,214.820524,6,0
0,0,18,18,17,24,41,66,58,124,0.000333,0.221445,16,10629.38318,590.521288,664.336449,179.525968,6,0
0,0,19,19,17,25,42,76,64,140,0.000333,0.251641,16,12078.79103,671.043946,754.924439,185.583273,6,0
0,0,19,19,17,25,42,68,60,128,0.000333,0.230072,16,11043.46608,613.525893,690.21663,185.583273,6,0
0,0,21,21,17,27,44,81,68,149,0.000333,0.271152,16,13015.28498,723.071388,813.455311,197.868831,6,0
0,0,13,13,12,16,28,39,37,76,0.000333,0.121786,12,4384.307689,243.572649,365.358974,107.01955,3,0
0,0,14,14,12,17,29,49,43,92,0.000333,0.148978,12,5363.211019,297.956168,446.934252,112.506418,3,0
0,0,14,14,12,17,29,41,39,80,0.000333,0.129546,12,4663.661755,259.09232,388.63848,112.506418,3,0
0,0,16,16,12,19,31,54,47,101,0.000333,0.166791,12,6004.485928,333.582552,500.373827,123.730173,3,0
0,0,14,14,12,14,26,48,36,84,0.000333,0.131612,12,4738.043236,263.224624,394.836936,96.322519,2,0
0,0,12,12,12,12,24,35,28,63,0.000333,0.096284,12,3466.231651,192.568425,288.852638,86.0391,2,0
0,0,16,16,12,16,28,53,42,95,0.000333,0.152233,12,5480.384611,304.465812,456.698718,107.01955,2,0
0,0,17,17,17,20,37,65,50,115,0.000333,0.199696,16,9585.394193,532.5219,599.087137,155.92543,5,0
0,0,20,20,17,23,40,80,60,140,0.000333,0.248357,16,11921.11893,662.284385,745.069933,173.528793,5,0
0,0,18,18,17,21,38,67,52,119,0.000333,0.208168,16,9992.053986,555.11411,624.503374,161.725534,5,0
0,0,22,22,17,25,42,85,66,151,0.000333,0.271413,16,13027.83889,723.768827,814.239931,185.583273,5,0
0,0,14,14,13,12,25,46,34,80,0.000333,0.123836,12,4458.101942,247.67233,371.508495,91.125266,2,0
0,0,17,17,13,15,28,61,44,105,0.000333,0.168257,12,6057.267202,336.514845,504.772267,106.709075,2,0
0,0,15,15,13,13,26,48,36,84,0.000333,0.131612,12,4738.043236,263.224624,394.836936,96.211433,2,0
0,0,19,19,13,17,30,66,50,116,0.000333,0.189733,12,6830.391709,379.466206,569.199309,117.592585,2,0
0,0,19,19,18,21,39,73,55,128,0.000333,0.22551,18,12177.56671,676.531484,676.531484,167.297316,5,0
0,0,22,22,18,24,42,88,65,153,0.000333,0.275008,18,14850.44218,825.024566,825.024566,185.09775,5,0
0,0,20,20,18,22,40,75,57,132,0.000333,0.234165,18,12644.90115,702.494509,702.494509,173.166146,5,0
0,0,24,24,18,26,44,93,71,164,0.000333,0.298449,18,16116.24214,895.346785,895.346785,197.270083,5,0
0,0,11,11,13,11,24,34,26,60,0.000333,0.091699,12,3301.173001,183.3985,275.09775,86.159464,2,0
0,0,14,14,13,14,27,49,36,85,0.000333,0.134722,12,4849.985252,269.443625,404.165438,101.408685,2,0
0,0,12,12,13,12,25,36,28,64,0.000333,0.099069,12,3566.481554,198.137864,297.206796,91.125266,2,0
0,0,16,16,13,16,29,54,42,96,0.000333,0.155455,12,5596.394106,310.910784,466.366176,112.105716,2,0
0,0,16,16,18,20,38,61,47,108,0.000333,0.188925,18,10201.97109,566.776171,566.776171,161.497212,5,0
0,0,19,19,18,23,41,76,57,133,0.000333,0.237518,18,12825.9795,712.554417,712.554417,179.100575,5,0
0,0,17,17,18,21,39,63,49,112,0.000333,0.197322,18,10655.37087,591.965049,591.965049,167.297316,5,0
0,0,21,21,18,25,43,81,63,144,0.000333,0.260461,18,14064.87824,781.382125,781.382125,191.155055,5,0
0,0,12,12,13,14,27,36,29,65,0.000333,0.103023,12,3708.812252,206.045125,309.067688,101.408685,2,0
0,0,15,15,13,17,30,51,39,90,0.000333,0.147207,12,5299.441843,294.413436,441.620154,117.592585,2,0
0,0,13,13,13,15,28,38,31,69,0.000333,0.110569,12,3980.489875,221.138326,331.70749,106.709075,2,0
0,0,17,17,13,19,32,56,45,101,0.000333,0.168333,12,6060,336.666667,505,128.816339,2,0
0,0,17,17,18,23,41,63,50,113,0.000333,0.201801,18,10897.26078,605.403377,605.403377,179.100575,5,0
0,0,20,20,18,26,44,78,60,138,0.000333,0.251134,18,13561.22814,753.401563,753.401563,197.270083,5,0
0,0,18,18,18,24,42,65,52,117,0.000333,0.2103,18,11356.22049,630.901138,630.901138,185.09775,5,0
0,0,22,22,18,28,46,83,66,149,0.000333,0.274337,18,14814.19317,823.010731,823.010731,209.664588,5,0
0,0,16,16,18,22,40,62,49,111,0.000333,0.196911,18,10633.21233,590.734019,590.734019,173.166146,5,0
0,0,17,17,18,23,41,72,54,126,0.000333,0.225017,18,12150.92795,675.051553,675.051553,179.100575,5,0
0,0,17,17,18,23,41,64,51,115,0.000333,0.205373,18,11090.13265,616.118481,616.118481,179.100575,5,0
0,0,19,19,18,25,43,77,59,136,0.000333,0.245991,18,13283.49612,737.972007,737.972007,191.155055,5,0
0,0,11,11,13,13,26,35,28,63,0.000333,0.098709,12,3553.532427,197.418468,296.127702,96.211433,2,0
0,0,12,12,13,14,27,45,33,78,0.000333,0.123627,12,4450.574702,247.25415,370.881225,101.408685,2,0
0,0,12,12,13,14,27,37,30,67,0.000333,0.106192,12,3822.929552,212.384975,318.577463,101.408685,2,0
0,0,14,14,13,16,29,50,38,88,0.000333,0.142501,12,5130.027931,285.001552,427.502328,112.105716,2,0
0,0,12,12,14,12,26,38,30,68,0.000333,0.106543,14,4474.818612,248.601034,319.629901,96.322519,2,0
0,0,15,15,14,15,29,53,40,93,0.000333,0.150597,14,6325.091256,351.393959,451.792233,111.906328,2,0
0,0,13,13,14,13,27,40,32,72,0.000333,0.114117,14,4792.926602,266.2737,342.3519,101.408685,2,0
0,0,17,17,14,17,31,58,46,104,0.000333,0.171745,14,7213.309828,400.739435,515.236416,122.789837,2,0
0,0,17,17,19,21,40,65,51,116,0.000333,0.205781,18,11112.18586,617.343659,617.343659,172.949289,5,0
0,0,20,20,19,24,43,80,61,141,0.000333,0.255034,18,13771.85995,765.10333,765.10333,190.749723,5,0
0,0,18,18,19,22,41,67,53,120,0.000333,0.214302,18,11572.31233,642.906241,642.906241,178.818118,5,0
0,0,22,22,19,26,45,85,67,152,0.000333,0.278254,18,15025.71007,834.761671,834.761671,202.922055,5,0
0,0,16,16,19,22,41,63,49,112,0.000333,0.200015,18,10800.82484,600.045825,600.045825,178.818118,5,0
0,0,19,19,19,24,43,78,59,137,0.000333,0.247799,18,13381.16889,743.398271,743.398271,190.749723,5,0
0,0,17,17,19,23,42,65,51,116,0.000333,0.208503,18,11259.15878,625.508821,625.508821,184.752548,5,0
0,0,21,21,19,26,45,83,65,148,0.000333,0.270931,18,14630.29665,812.794258,812.794258,202.922055,5,0
0,0,11,11,14,13,27,36,28,64,0.000333,0.101438,14,4260.379202,236.687733,304.3128,101.408685,2,0
0,0,12,12,14,14,28,46,33,79,0.000333,0.126594,14,5316.934544,295.385252,379.781039,106.605938,2,0
0,0,12,12,14,14,28,38,30,68,0.000333,0.108967,14,4576.601886,254.25566,326.900135,106.605938,2,0
0,0,16,16,14,17,31,56,44,100,0.000333,0.16514,14,6935.874835,385.32638,495.419631,122.789837,2,0
0,0,12,12,13,14,27,42,32,74,0.000333,0.117287,12,4222.340102,234.57445,351.861675,101.408685,2,0
0,0,13,13,13,15,28,44,34,78,0.000333,0.124991,12,4499.684207,249.982456,374.973684,106.709075,2,0
0,0,17,17,18,23,41,69,53,122,0.000333,0.217874,18,11765.1842,653.621345,653.621345,179.100575,5,0
0,0,18,18,18,24,42,71,55,126,0.000333,0.226477,18,12229.77592,679.431995,679.431995,185.09775,5,0
0,0,13,13,13,14,27,35,32,67,0.000333,0.106192,12,3822.929552,212.384975,318.577463,101.408685,2,0
0,0,14,14,13,15,28,43,36,79,0.000333,0.126594,12,4557.372466,253.187359,379.781039,106.709075,2,0
0,0,14,14,13,15,28,37,34,71,0.000333,0.113774,12,4095.866394,227.548133,341.322199,106.709075,2,0
0,0,18,18,18,23,41,62,53,115,0.000333,0.205373,18,11090.13265,616.118481,616.118481,179.100575,5,0
0,0,20,20,18,25,43,72,61,133,0.000333,0.240564,18,12990.47782,721.693212,721.693212,191.155055,5,0
0,0,19,19,18,24,42,64,55,119,0.000333,0.213895,18,11550.34392,641.685773,641.685773,185.09775,5,0
0,0,11,11,12,13,25,34,28,62,0.000333,0.095973,12,3455.029005,191.946056,287.919084,91.125266,2,0
0,0,12,12,12,14,26,44,33,77,0.000333,0.120645,12,4343.2063,241.289239,361.933858,96.322519,2,0
0,0,12,12,12,14,26,36,30,66,0.000333,0.10341,12,3722.748257,206.819348,310.229021,96.322519,2,0
0,0,14,14,12,16,28,49,38,87,0.000333,0.139413,12,5018.878539,278.826585,418.239878,107.01955,2,0
0,0,16,16,17,22,39,61,49,110,0.000333,0.193798,16,9302.307905,516.794884,581.394244,167.594364,5,0
0,0,17,17,17,23,40,71,54,125,0.000333,0.221747,16,10643.85619,591.325344,665.241012,173.528793,5,0
0,0,17,17,17,23,40,63,51,114,0.000333,0.202233,16,9707.196845,539.288714,606.699803,173.528793,5,0
0,0,19,19,17,25,42,76,59,135,0.000333,0.242654,16,11647.40563,647.078091,727.962852,185.583273,5,0
0,0,13,13,12,14,26,39,36,75,0.000333,0.117511,12,4230.395746,235.021986,352.532979,96.322519,2,0
0,0,14,14,12,15,27,49,41,90,0.000333,0.142647,12,5135.278502,285.29325,427.939875,101.622909,2,0
0,0,14,14,12,15,27,41,38,79,0.000333,0.125212,12,4507.633352,250.424075,375.636113,101.622909,2,0
0,0,16,16,12,17,29,54,46,100,0.000333,0.161933,12,5829.577194,323.8654,485.7981,112.506418,2,0
0,0,18,18,17,23,40,66,57,123,0.000333,0.218199,16,10473.55449,581.864138,654.597156,173.528793,5,0
0,0,19,19,17,24,41,76,62,138,0.000333,0.246447,16,11829.47483,657.193046,739.342177,179.525968,5,0
0,0,19,19,17,24,41,68,59,127,0.000333,0.226803,16,10886.54567,604.808093,680.409105,179.525968,5,0
0,0,21,21,17,26,43,81,67,148,0.000333,0.267696,16,12849.39494,713.855274,803.087184,191.698301,5,0
0,0,15,15,12,15,27,44,44,88,0.000333,0.139477,12,5021.161202,278.9534,418.4301,101.622909,2,0
0,0,16,16,12,16,28,54,49,103,0.000333,0.165053,18,8912.836025,495.157557,495.157557,107.01955,2,0
0,0,16,16,12,16,28,46,46,92,0.000333,0.147426,12,5307.319834,294.851102,442.276653,107.01955,2,0
0,0,18,18,12,18,30,59,54,113,0.000333,0.184826,18,9980.615471,554.478637,554.478637,118.0782,2,0
0,0,20,20,17,24,41,71,65,136,0.000333,0.242876,16,11658.03316,647.668509,728.627073,179.525968,5,0
0,0,21,21,17,25,42,81,70,151,0.000333,0.271413,16,13027.83889,723.768827,814.239931,185.583273,5,0
0,0,21,21,17,25,42,73,67,140,0.000333,0.251641,16,12078.79103,671.043946,754.924439,185.583273,5,0
0,0,23,23,17,27,44,86,75,161,0.000333,0.292989,16,14063.49585,781.305325,878.968491,197.868831,5,0
0,0,17,17,12,16,28,49,52,101,0.000333,0.161848,18,8739.771248,485.542847,485.542847,107.01955,2,0
0,0,18,18,12,17,29,59,57,116,0.000333,0.187842,18,10143.46432,563.525795,563.525795,112.506418,2,0
0,0,18,18,12,17,29,51,54,105,0.000333,0.170029,18,9181.584081,510.088004,510.088004,112.506418,2,0
0,0,20,20,12,19,31,64,62,126,0.000333,0.208076,18,11236.11723,624.228735,624.228735,123.730173,2,0
0,0,22,22,17,25,42,76,73,149,0.000333,0.267818,16,12855.28474,714.182485,803.455296,185.583273,5,0
0,0,23,23,17,26,43,86,78,164,0.000333,0.296636,24,21357.77808,1186.543226,889.90742,191.698301,5,0
0,0,23,23,17,26,43,78,75,153,0.000333,0.27674,16,13283.49612,737.972007,830.218507,191.698301,5,0
0,0,25,25,17,28,45,91,83,174,0.000333,0.318527,16,15289.31902,849.406612,955.582439,204.092806,5,0
0,0,17,17,18,21,39,64,51,115,0.000333,0.202607,18,10940.78259,607.821255,607.821255,167.297316,5,0
0,0,19,19,18,22,40,78,60,138,0.000333,0.244809,18,13219.66939,734.426077,734.426077,173.166146,5,0
0,0,18,18,18,22,40,66,53,119,0.000333,0.211103,18,11399.56998,633.309443,633.309443,173.166146,5,0
0,0,20,20,18,25,43,79,61,140,0.000333,0.253226,18,13674.18718,759.677066,759.677066,191.155055,5,0
0,0,12,12,13,12,25,37,30,67,0.000333,0.103713,12,3733.660377,207.425576,311.138365,91.125266,2,0
0,0,14,14,13,13,26,50,38,88,0.000333,0.13788,12,4963.664342,275.75913,413.638695,96.211433,2,0
0,0,13,13,13,13,26,39,32,71,0.000333,0.111244,12,4004.77464,222.48748,333.73122,96.211433,2,0
0,0,15,15,13,16,29,52,40,92,0.000333,0.148978,12,5363.211019,297.956168,446.934252,112.105716,2,0
0,0,16,16,18,22,40,62,49,111,0.000333,0.196911,18,10633.21233,590.734019,590.734019,173.166146,5,0
0,0,17,17,18,23,41,72,54,126,0.000333,0.225017,18,12150.92795,675.051553,675.051553,179.100575,5,0
0,0,17,17,18,23,41,64,51,115,0.000333,0.205373,18,11090.13265,616.118481,616.118481,179.100575,5,0
0,0,20,20,18,25,43,79,64,143,0.000333,0.258652,18,13967.20548,775.95586,775.95586,191.155055,5,0
0,0,11,11,13,13,26,35,28,63,0.000333,0.098709,12,3553.532427,197.418468,296.127702,96.211433,2,0
0,0,12,12,13,14,27,45,33,78,0.000333,0.123627,12,4450.574702,247.25415,370.881225,101.408685,2,0
0,0,12,12,13,14,27,37,30,67,0.000333,0.106192,12,3822.929552,212.384975,318.577463,101.408685,2,0
0,0,14,14,12,16,28,49,38,87,0.000333,0.139413,12,5018.878539,278.826585,418.239878,107.01955,2,0
0,0,17,17,18,23,41,66,52,118,0.000333,0.21073,18,11379.44046,632.191137,632.191137,179.100575,5,0
0,0,18,18,18,24,42,76,57,133,0.000333,0.239059,18,12909.20791,717.178217,717.178217,185.09775,5,0
0,0,18,18,18,24,42,68,54,122,0.000333,0.219288,18,11841.52906,657.862726,657.862726,185.09775,5,0
0,0,12,12,13,14,27,39,31,70,0.000333,0.110947,12,3994.105502,221.89475,332.842125,101.408685,2,0
0,0,13,13,12,15,27,48,36,84,0.000333,0.133137,12,4792.926602,266.2737,399.41055,101.622909,2,0
0,0,13,13,13,15,28,41,33,74,0.000333,0.118581,12,4268.931171,237.162843,355.744264,106.709075,2,0
0,0,18,18,18,24,42,74,56,130,0.000333,0.233667,18,12618.02277,701.001265,701.001265,185.09775,5,0
0,0,19,19,18,25,43,84,61,145,0.000333,0.262269,18,14162.55101,786.808389,786.808389,191.155055,5,0
0,0,19,19,18,25,43,76,58,134,0.000333,0.242373,18,13088.15059,727.119477,727.119477,191.155055,5,0
0,0,13,13,13,15,28,47,35,82,0.000333,0.131401,12,4730.437243,262.802069,394.203104,106.709075,2,0
0,0,14,14,13,16,29,57,40,97,0.000333,0.157075,12,5654.689878,314.149438,471.224157,112.105716,2,0
0,0,14,14,13,16,29,49,37,86,0.000333,0.139262,12,5013.436387,278.524244,417.786366,112.105716,2,0
0,0,17,17,17,23,40,68,53,121,0.000333,0.214651,16,10303.25279,572.402933,643.953299,173.528793,5,0
0,0,18,18,17,24,41,70,55,125,0.000333,0.223231,16,10715.10401,595.283556,669.694001,179.525968,5,0
0,0,12,12,12,14,26,41,32,73,0.000333,0.114377,12,4117.585193,228.754733,343.132099,96.322519,2,0
0,0,13,13,12,15,27,43,34,77,0.000333,0.122042,12,4393.516052,244.084225,366.126338,101.622909,2,0
0,0,19,19,17,25,42,74,59,133,0.000333,0.239059,16,11474.85148,637.491749,717.178217,185.583273,5,0
0,0,20,20,17,26,43,84,64,148,0.000333,0.267696,16,12849.39494,713.855274,803.087184,191.698301,5,0
0,0,20,20,17,26,43,76,61,137,0.000333,0.247799,16,11894.37234,660.798463,743.398271,191.698301,5,0
0,0,14,14,12,16,28,47,38,85,0.000333,0.136208,12,4903.50202,272.416779,408.625168,107.01955,2,0
0,0,15,15,12,17,29,57,43,100,0.000333,0.161933,12,5829.577194,323.8654,485.7981,112.506418,2,0
0,0,15,15,12,17,29,49,40,89,0.000333,0.14412,12,5188.323703,288.240206,432.360309,112.506418,2,0
0,0,19,19,18,25,43,68,58,126,0.000333,0.227903,18,12306.76846,683.709359,683.709359,191.155055,5,0
0,0,20,20,18,26,44,78,63,141,0.000333,0.256593,18,13856.03745,769.779858,769.779858,197.270083,5,0
0,0,20,20,18,26,44,70,60,130,0.000333,0.236575,18,12775.06999,709.72611,709.72611,197.270083,5,0
0,0,19,19,18,25,43,68,58,126,0.000333,0.227903,18,12306.76846,683.709359,683.709359,191.155055,5,0
0,0,14,14,13,16,29,41,37,78,0.000333,0.126308,12,4547.070211,252.615012,378.922518,112.105716,2,0
0,0,15,15,13,17,30,51,42,93,0.000333,0.152114,12,5476.089905,304.227217,456.340825,117.592585,2,0
0,0,15,15,13,17,30,43,39,82,0.000333,0.134122,12,4828.380346,268.243353,402.365029,117.592585,2,0
0,0,14,14,13,16,29,41,37,78,0.000333,0.126308,12,4547.070211,252.615012,378.922518,112.105716,2,0
0,0,18,18,17,23,40,61,53,114,0.000333,0.202233,16,9707.196845,539.288714,606.699803,173.528793,5,0
0,0,19,19,17,24,41,69,57,126,0.000333,0.225017,16,10800.82484,600.045825,675.051553,179.525968,5,0
0,0,19,19,17,24,41,63,55,118,0.000333,0.21073,16,10115.05819,561.947677,632.191137,179.525968,5,0
0,0,13,13,12,14,26,34,32,66,0.000333,0.10341,12,3722.748257,206.819348,310.229021,96.322519,2,0
0,0,14,14,12,15,27,42,36,78,0.000333,0.123627,12,4450.574702,247.25415,370.881225,101.622909,2,0
0,0,14,14,12,15,27,36,34,70,0.000333,0.110947,12,3994.105502,221.89475,332.842125,101.622909,2,0
0,0,21,21,18,27,45,91,75,166,0.000333,0.303883,18,16409.65705,911.647614,911.647614,203.440613,5,0
0,0,22,22,18,28,46,103,81,184,0.000333,0.338778,18,18294.0372,1016.3354,1016.3354,209.664588,5,0
0,0,22,22,18,28,46,93,77,170,0.000333,0.313002,18,16902.09959,939.005533,939.005533,209.664588,5,0
0,0,21,21,18,27,45,91,75,166,0.000333,0.303883,18,16409.65705,911.647614,911.647614,203.440613,5,0
0,0,16,16,14,19,33,64,54,118,0.000333,0.198413,14,8333.339085,462.963283,595.238506,134.013592,2,0
0,0,17,17,14,20,34,76,60,136,0.000333,0.230632,21,14529.79388,807.210771,691.894946,139.741531,2,0
0,0,17,17,14,20,34,66,56,122,0.000333,0.20689,14,8689.386533,482.743696,620.670467,139.741531,2,0
0,0,16,16,14,19,33,64,54,118,0.000333,0.198413,14,8333.339085,462.963283,595.238506,134.013592,2,0
0,0,21,21,18,26,44,81,66,147,0.000333,0.267512,18,14445.65606,802.536448,802.536448,197.270083,5,0
0,0,22,22,18,27,45,93,72,165,0.000333,0.302052,18,16310.8037,906.155761,906.155761,203.440613,5,0
0,0,22,22,18,27,45,83,68,151,0.000333,0.276423,18,14926.85672,829.269818,829.269818,203.440613,5,0
0,0,21,21,18,26,44,81,66,147,0.000333,0.267512,18,14445.65606,802.536448,802.536448,197.270083,5,0
0,0,16,16,14,17,31,54,45,99,0.000333,0.163488,14,6866.516086,381.473116,490.465435,122.789837,2,0
0,0,17,17,14,18,32,66,51,117,0.000333,0.195,14,8190,455,585,128.361619,2,0
0,0,17,17,14,18,32,56,47,103,0.000333,0.171667,14,7210,400.555556,515,128.361619,2,0
0,0,16,16,14,17,31,54,45,99,0.000333,0.163488,14,6866.516086,381.473116,490.465435,122.789837,2,0
0,0,21,21,17,26,43,84,68,152,0.000333,0.274931,16,13196.67588,733.14866,824.792243,191.698301,5,0
0,0,22,22,17,27,44,97,75,172,0.000333,0.313007,16,15024.35581,834.686434,939.022238,197.868831,5,0
0,0,22,22,17,27,44,86,70,156,0.000333,0.28389,16,13626.74132,757.041184,851.671333,197.868831,5,0
0,0,21,21,17,26,43,84,68,152,0.000333,0.274931,16,13196.67588,733.14866,824.792243,191.698301,5,0
0,0,16,16,13,18,31,57,47,104,0.000333,0.171745,12,6182.836995,343.490944,515.236416,123.164366,2,0
0,0,17,17,13,19,32,70,54,124,0.000333,0.206667,12,7440,413.333333,620,128.816339,2,0
0,0,17,17,13,19,32,59,49,108,0.000333,0.18,12,6480,360,540,128.816339,2,0
0,0,16,16,13,18,31,57,47,104,0.000333,0.171745,12,6182.836995,343.490944,515.236416,123.164366,2,0
0,0,11,11,15,16,31,47,33,80,0.000333,0.132112,14,5548.699868,308.261104,396.335705,122.603359,4,0
0,0,14,14,15,19,34,62,43,105,0.000333,0.178061,14,7478.570377,415.476132,534.183598,139.313982,4,0
0,0,12,12,15,17,32,49,35,84,0.000333,0.14,14,5880,326.666667,420,128.090227,4,0
0,0,16,16,15,21,36,67,49,116,0.000333,0.199904,14,8395.958202,466.442122,599.7113,150.842025,4,0
0,0,9,9,12,10,22,29,20,49,0.000333,0.072837,12,2622.145792,145.674766,218.512149,76.238831,2,0
0,0,12,12,12,13,25,44,30,74,0.000333,0.114548,12,4123.744297,229.096905,343.645358,91.125266,2,0
0,0,10,10,12,11,23,31,22,53,0.000333,0.079916,12,2876.985404,159.832522,239.748784,81.073298,2,0
0,0,14,14,12,15,27,49,36,85,0.000333,0.134722,12,4849.985252,269.443625,404.165438,101.622909,2,0
0,0,13,13,15,17,32,53,35,88,0.000333,0.146667,14,6160,342.222222,440,128.090227,6,0
0,0,16,16,15,20,35,68,45,113,0.000333,0.193203,14,8114.525733,450.806985,579.608981,145.041921,6,0
0,0,14,14,15,18,33,55,37,92,0.000333,0.154695,14,6497.179626,360.954424,464.084259,133.662009,6,0
0,0,18,18,15,22,37,73,51,124,0.000333,0.215324,14,9043.611043,502.422836,645.972217,156.710855,6,0
0,0,12,12,15,11,26,38,22,60,0.000333,0.094009,14,3948.369363,219.353854,282.026383,96.657107,4,0
0,0,15,15,15,14,29,53,32,85,0.000333,0.137643,14,5780.997384,321.166521,412.928385,111.906328,4,0
0,0,13,13,15,12,27,40,24,64,0.000333,0.101438,14,4260.379202,236.687733,304.3128,101.622909,4,0
0,0,17,17,15,16,31,58,38,96,0.000333,0.158534,14,6658.439841,369.913325,475.602846,122.603359,4,0
0,0,11,11,12,11,23,35,22,57,0.000333,0.085948,12,3094.116378,171.895354,257.843031,81.073298,4,0
0,0,14,14,12,14,26,50,32,82,0.000333,0.128479,12,4625.232683,256.957371,385.436057,96.322519,4,0
0,0,12,12,12,12,24,37,24,61,0.000333,0.093228,12,3356.192551,186.455142,279.682713,86.0391,4,0
0,0,16,16,12,16,28,55,38,93,0.000333,0.149028,12,5365.008093,298.056005,447.084008,107.01955,4,0
0,0,14,14,18,17,35,56,35,91,0.000333,0.155588,18,8401.765582,466.764755,466.764755,144.545518,6,0
0,0,17,17,18,20,38,71,45,116,0.000333,0.20292,18,10957.67265,608.759592,608.759592,161.497212,6,0
0,0,15,15,18,18,36,58,37,95,0.000333,0.163714,18,8840.571752,491.142875,491.142875,150.1173,6,0
0,0,19,19,18,22,40,76,51,127,0.000333,0.225295,18,12165.92763,675.884868,675.884868,173.166146,6,0
0,0,13,13,15,17,32,53,37,90,0.000333,0.15,14,6300,350,450,128.090227,6,0
0,0,16,16,15,20,35,68,47,115,0.000333,0.196623,14,8258.145657,458.78587,589.867547,145.041921,6,0
0,0,14,14,15,18,33,55,39,94,0.000333,0.158058,14,6638.422661,368.801259,474.173047,133.662009,6,0
0,0,18,18,15,21,36,73,53,126,0.000333,0.217137,14,9119.747703,506.65265,651.41055,150.842025,6,0
0,0,12,12,16,11,27,39,24,63,0.000333,0.099853,16,4792.926602,266.2737,299.557913,102.053748,4,0
0,0,15,15,16,14,30,54,34,88,0.000333,0.143935,16,6908.901959,383.827887,431.806372,117.302969,4,0
0,0,13,13,16,12,28,41,26,67,0.000333,0.107364,16,5153.484476,286.304693,322.09278,107.01955,4,0
0,0,17,17,16,15,31,59,40,99,0.000333,0.163488,16,7847.446956,435.969275,490.465435,122.603359,4,0
0,0,14,14,17,11,28,39,26,65,0.000333,0.104159,16,4999.649119,277.758284,312.47807,107.540616,4,0
0,0,11,11,12,11,23,35,24,59,0.000333,0.088963,12,3202.681865,177.92677,266.890155,81.073298,4,0
0,0,14,14,12,14,26,50,34,84,0.000333,0.131612,12,4738.043236,263.224624,394.836936,96.322519,4,0
0,0,12,12,12,12,24,37,26,63,0.000333,0.096284,12,3466.231651,192.568425,288.852638,86.0391,4,0
0,0,16,16,12,15,27,55,40,95,0.000333,0.150571,12,5420.571752,301.142875,451.714313,101.622909,4,0
0,0,13,13,13,11,24,35,26,61,0.000333,0.093228,12,3356.192551,186.455142,279.682713,86.159464,4,0
0,0,14,14,18,17,35,57,37,94,0.000333,0.160718,18,8678.746865,482.152604,482.152604,144.545518,6,0
0,0,17,17,18,20,38,72,47,119,0.000333,0.208168,18,11241.06073,624.503374,624.503374,161.497212,6,0
0,0,15,15,18,18,36,59,39,98,0.000333,0.168884,18,9119.747703,506.65265,506.65265,150.1173,6,0
0,0,19,19,18,21,39,77,53,130,0.000333,0.229034,18,12367.84119,687.102288,687.102288,167.297316,6,0
0,0,13,13,15,17,32,53,35,88,0.000333,0.146667,14,6160,342.222222,440,128.090227,6,0
0,0,16,16,15,20,35,68,45,113,0.000333,0.193203,14,8114.525733,450.806985,579.608981,145.041921,6,0
0,0,14,14,15,18,33,55,37,92,0.000333,0.154695,14,6497.179626,360.954424,464.084259,133.662009,6,0
0,0,18,18,15,22,37,73,51,124,0.000333,0.215324,14,9043.611043,502.422836,645.972217,156.710855,6,0
0,0,12,12,15,12,27,38,22,60,0.000333,0.095098,7,1997.052751,110.947375,285.29325,101.622909,4,0
0,0,15,15,15,15,30,53,32,85,0.000333,0.139029,14,5839.199809,324.399989,417.085701,117.206718,4,0
0,0,13,13,15,13,28,40,24,64,0.000333,0.102557,7,2153.695005,119.649723,307.670715,106.709075,4,0
0,0,17,17,15,17,32,58,38,96,0.000333,0.16,14,6720,373.333333,480,128.090227,4,0
0,0,14,14,16,12,28,38,24,62,0.000333,0.099352,16,4768.896083,264.938671,298.056005,107.01955,4,0
0,0,11,11,12,11,23,35,22,57,0.000333,0.085948,12,3094.116378,171.895354,257.843031,81.073298,4,0
0,0,14,14,12,14,26,50,32,82,0.000333,0.128479,12,4625.232683,256.957371,385.436057,96.322519,4,0
0,0,12,12,12,12,24,37,24,61,0.000333,0.093228,12,3356.192551,186.455142,279.682713,86.0391,4,0
0,0,16,16,12,16,28,55,38,93,0.000333,0.149028,12,5365.008093,298.056005,447.084008,107.01955,4,0
0,0,13,13,13,11,24,35,24,59,0.000333,0.090171,12,3246.153451,180.341858,270.512788,86.159464,4,0
0,0,14,14,18,18,36,56,35,91,0.000333,0.156821,9,4234.168576,235.231588,470.463175,150.1173,6,0
0,0,17,17,18,21,39,71,45,116,0.000333,0.204369,18,11035.91983,613.106657,613.106657,167.297316,6,0
0,0,15,15,18,19,37,58,37,95,0.000333,0.164966,9,4454.082628,247.449035,494.89807,155.769273,6,0
0,0,19,19,18,23,41,76,51,127,0.000333,0.226803,18,12247.36388,680.409105,680.409105,179.100575,6,0
0,0,13,13,15,17,32,53,35,88,0.000333,0.146667,14,6160,342.222222,440,128.090227,6,0
0,0,16,16,15,20,35,68,45,113,0.000333,0.193203,14,8114.525733,450.806985,579.608981,145.041921,6,0
0,0,14,14,15,18,33,55,37,92,0.000333,0.154695,14,6497.179626,360.954424,464.084259,133.662009,6,0
0,0,18,18,15,22,37,73,51,124,0.000333,0.215324,14,9043.611043,502.422836,645.972217,156.710855,6,0
0,0,12,12,15,12,27,38,22,60,0.000333,0.095098,7,1997.052751,110.947375,285.29325,101.622909,4,0
0,0,15,15,15,15,30,53,32,85,0.000333,0.139029,14,5839.199809,324.399989,417.085701,117.206718,4,0
0,0,13,13,15,13,28,40,24,64,0.000333,0.102557,7,2153.695005,119.649723,307.670715,106.709075,4,0
0,0,17,17,15,17,32,58,38,96,0.000333,0.16,14,6720,373.333333,480,128.090227,4,0
0,0,14,14,16,12,28,38,24,62,0.000333,0.099352,16,4768.896083,264.938671,298.056005,107.01955,4,0
0,0,11,11,12,11,23,35,22,57,0.000333,0.085948,12,3094.116378,171.895354,257.843031,81.073298,4,0
0,0,14,14,12,14,26,50,32,82,0.000333,0.128479,12,4625.232683,256.957371,385.436057,96.322519,4,0
0,0,12,12,12,12,24,37,24,61,0.000333,0.093228,12,3356.192551,186.455142,279.682713,86.0391,4,0
0,0,16,16,12,16,28,55,38,93,0.000333,0.149028,12,5365.008093,298.056005,447.084008,107.01955,4,0
0,0,13,13,13,11,24,35,24,59,0.000333,0.090171,12,3246.153451,180.341858,270.512788,86.159464,4,0
0,0,14,14,18,18,36,56,35,91,0.000333,0.156821,9,4234.168576,235.231588,470.463175,150.1173,6,0
0,0,17,17,18,21,39,71,45,116,0.000333,0.204369,18,11035.91983,613.106657,613.106657,167.297316,6,0
0,0,15,15,18,19,37,58,37,95,0.000333,0.164966,9,4454.082628,247.449035,494.89807,155.769273,6,0
0,0,19,19,18,23,41,76,51,127,0.000333,0.226803,18,12247.36388,680.409105,680.409105,179.100575,6,0
0,0,11,11,12,12,24,35,24,59,0.000333,0.090171,12,3246.153451,180.341858,270.512788,86.0391,4,0
0,0,14,14,12,15,27,50,34,84,0.000333,0.133137,12,4792.926602,266.2737,399.41055,101.622909,4,0
0,0,12,12,12,13,25,37,26,63,0.000333,0.097521,12,3510.755279,195.04196,292.56294,91.125266,4,0
0,0,16,16,12,16,28,55,40,95,0.000333,0.152233,12,5480.384611,304.465812,456.698718,107.01955,4,0
0,0,13,13,13,12,25,35,26,61,0.000333,0.094425,12,3399.302731,188.850152,283.275228,91.125266,4,0
0,0,13,13,15,18,33,53,37,90,0.000333,0.151332,14,6355.93659,353.107588,453.995471,133.662009,6,0
0,0,16,16,15,21,36,68,47,115,0.000333,0.19818,14,8323.579252,462.42107,594.541375,150.842025,6,0
0,0,14,14,15,19,34,55,39,94,0.000333,0.159407,14,6695.101099,371.950061,478.221507,139.313982,6,0
0,0,18,18,15,22,37,73,53,126,0.000333,0.218797,14,9189.475737,510.52643,656.391124,156.710855,6,0
0,0,14,14,18,18,36,57,37,94,0.000333,0.161991,18,8747.513102,485.97295,485.97295,150.1173,6,0
0,0,17,17,18,21,39,72,47,119,0.000333,0.209654,18,11321.33155,628.962864,628.962864,167.297316,6,0
0,0,15,15,18,19,37,59,39,98,0.000333,0.170175,18,9189.475737,510.52643,510.52643,155.769273,6,0
0,0,19,19,18,22,40,77,53,130,0.000333,0.230617,18,12453.31174,691.850652,691.850652,173.166146,6,0
0,0,12,12,16,12,28,39,24,63,0.000333,0.100954,16,4845.813761,269.211876,302.86336,107.01955,4,0
0,0,15,15,16,15,31,54,34,88,0.000333,0.145323,16,6975.508405,387.528245,435.969275,122.603359,4,0
0,0,13,13,16,13,29,41,26,67,0.000333,0.108495,16,5207.755627,289.319757,325.484727,112.105716,4,0
0,0,17,17,16,16,32,59,40,99,0.000333,0.165,16,7920,440,495,128,4,0
0,0,14,14,17,12,29,39,26,65,0.000333,0.105256,16,5052.300235,280.683346,315.768765,112.506418,4,0
0,0,11,11,12,12,24,35,24,59,0.000333,0.090171,12,3246.153451,180.341858,270.512788,86.0391,4,0
0,0,14,14,12,15,27,50,34,84,0.000333,0.133137,12,4792.926602,266.2737,399.41055,101.622909,4,0
0,0,12,12,12,13,25,37,26,63,0.000333,0.097521,12,3510.755279,195.04196,292.56294,91.125266,4,0
0,0,16,16,12,16,28,55,40,95,0.000333,0.152233,12,5480.384611,304.465812,456.698718,107.01955,4,0
0,0,13,13,13,12,25,35,26,61,0.000333,0.094425,12,3399.302731,188.850152,283.275228,91.125266,4,0
0,0,13,13,15,18,33,53,37,90,0.000333,0.151332,14,6355.93659,353.107588,453.995471,133.662009,6,0
0,0,16,16,15,21,36,68,47,115,0.000333,0.19818,14,8323.579252,462.42107,594.541375,150.842025,6,0
0,0,14,14,15,19,34,55,39,94,0.000333,0.159407,14,6695.101099,371.950061,478.221507,139.313982,6,0
0,0,18,18,15,22,37,73,53,126,0.000333,0.218797,14,9189.475737,510.52643,656.391124,156.710855,6,0
0,0,14,14,18,18,36,57,37,94,0.000333,0.161991,18,8747.513102,485.97295,485.97295,150.1173,6,0
0,0,17,17,18,21,39,72,47,119,0.000333,0.209654,18,11321.33155,628.962864,628.962864,167.297316,6,0
0,0,15,15,18,19,37,59,39,98,0.000333,0.170175,18,9189.475737,510.52643,510.52643,155.769273,6,0
0,0,19,19,18,22,40,77,53,130,0.000333,0.230617,18,12453.31174,691.850652,691.850652,173.166146,6,0
0,0,12,12,16,12,28,39,24,63,0.000333,0.100954,16,4845.813761,269.211876,302.86336,107.01955,4,0
0,0,15,15,16,15,31,54,34,88,0.000333,0.145323,16,6975.508405,387.528245,435.969275,122.603359,4,0
0,0,13,13,16,13,29,41,26,67,0.000333,0.108495,16,5207.755627,289.319757,325.484727,112.105716,4,0
0,0,17,17,16,16,32,59,40,99,0.000333,0.165,16,7920,440,495,128,4,0
0,0,11,11,12,11,23,35,22,57,0.000333,0.085948,12,3094.116378,171.895354,257.843031,81.073298,4,0
0,0,14,14,12,14,26,50,32,82,0.000333,0.128479,12,4625.232683,256.957371,385.436057,96.322519,4,0
0,0,12,12,12,12,24,37,24,61,0.000333,0.093228,12,3356.192551,186.455142,279.682713,86.0391,4,0
0,0,16,16,12,16,28,55,38,93,0.000333,0.149028,12,5365.008093,298.056005,447.084008,107.01955,4,0
0,0,13,13,13,11,24,35,24,59,0.000333,0.090171,12,3246.153451,180.341858,270.512788,86.159464,4,0
0,0,13,13,15,17,32,53,35,88,0.000333,0.146667,14,6160,342.222222,440,128.090227,6,0
0,0,16,16,15,20,35,68,45,113,0.000333,0.193203,14,8114.525733,450.806985,579.608981,145.041921,6,0
0,0,14,14,15,18,33,55,37,92,0.000333,0.154695,14,6497.179626,360.954424,464.084259,133.662009,6,0
0,0,18,18,15,22,37,73,51,124,0.000333,0.215324,14,9043.611043,502.422836,645.972217,156.710855,6,0
0,0,14,14,18,18,36,56,35,91,0.000333,0.156821,9,4234.168576,235.231588,470.463175,150.1173,6,0
0,0,17,17,18,21,39,71,45,116,0.000333,0.204369,18,11035.91983,613.106657,613.106657,167.297316,6,0
0,0,15,15,18,19,37,58,37,95,0.000333,0.164966,9,4454.082628,247.449035,494.89807,155.769273,6,0
0,0,19,19,18,23,41,76,51,127,0.000333,0.226803,18,12247.36388,680.409105,680.409105,179.100575,6,0
0,0,12,12,15,12,27,38,22,60,0.000333,0.095098,7,1997.052751,110.947375,285.29325,101.622909,4,0
0,0,15,15,15,15,30,53,32,85,0.000333,0.139029,14,5839.199809,324.399989,417.085701,117.206718,4,0
0,0,13,13,15,13,28,40,24,64,0.000333,0.102557,7,2153.695005,119.649723,307.670715,106.709075,4,0
0,0,17,17,15,17,32,58,38,96,0.000333,0.16,14,6720,373.333333,480,128.090227,4,0
0,0,14,14,16,12,28,38,24,62,0.000333,0.099352,16,4768.896083,264.938671,298.056005,107.01955,4,0
0,0,13,13,15,17,32,53,35,88,0.000333,0.146667,14,6160,342.222222,440,128.090227,6,0
0,0,16,16,15,20,35,68,45,113,0.000333,0.193203,14,8114.525733,450.806985,579.608981,145.041921,6,0
0,0,14,14,15,18,33,55,37,92,0.000333,0.154695,14,6497.179626,360.954424,464.084259,133.662009,6,0
0,0,18,18,15,22,37,73,51,124,0.000333,0.215324,14,9043.611043,502.422836,645.972217,156.710855,6,0
0,0,12,12,15,12,27,38,22,60,0.000333,0.095098,7,1997.052751,110.947375,285.29325,101.622909,4,0
0,0,15,15,15,15,30,53,32,85,0.000333,0.139029,14,5839.199809,324.399989,417.085701,117.206718,4,0
0,0,13,13,15,13,28,40,24,64,0.000333,0.102557,7,2153.695005,119.649723,307.670715,106.709075,4,0
0,0,17,17,15,17,32,58,38,96,0.000333,0.16,14,6720,373.333333,480,128.090227,4,0
0,0,14,14,16,12,28,38,24,62,0.000333,0.099352,16,4768.896083,264.938671,298.056005,107.01955,4,0
0,0,11,11,12,11,23,35,22,57,0.000333,0.085948,12,3094.116378,171.895354,257.843031,81.073298,4,0
0,0,14,14,12,14,26,50,32,82,0.000333,0.128479,12,4625.232683,256.957371,385.436057,96.322519,4,0
0,0,12,12,12,12,24,37,24,61,0.000333,0.093228,12,3356.192551,186.455142,279.682713,86.0391,4,0
0,0,16,16,12,16,28,55,38,93,0.000333,0.149028,12,5365.008093,298.056005,447.084008,107.01955,4,0
0,0,13,13,15,11,26,37,24,61,0.000333,0.095576,14,4014.175519,223.009751,286.726823,96.657107,4,0
0,0,14,14,18,18,36,56,35,91,0.000333,0.156821,9,4234.168576,235.231588,470.463175,150.1173,6,0
0,0,17,17,18,21,39,71,45,116,0.000333,0.204369,18,11035.91983,613.106657,613.106657,167.297316,6,0
0,0,15,15,18,19,37,58,37,95,0.000333,0.164966,9,4454.082628,247.449035,494.89807,155.769273,6,0
0,0,19,19,18,23,41,76,51,127,0.000333,0.226803,18,12247.36388,680.409105,680.409105,179.100575,6,0
0,0,13,13,15,17,32,53,35,88,0.000333,0.146667,14,6160,342.222222,440,128.090227,6,0
0,0,16,16,15,20,35,68,45,113,0.000333,0.193203,14,8114.525733,450.806985,579.608981,145.041921,6,0
0,0,14,14,15,18,33,55,37,92,0.000333,0.154695,14,6497.179626,360.954424,464.084259,133.662009,6,0
0,0,18,18,15,22,37,73,51,124,0.000333,0.215324,14,9043.611043,502.422836,645.972217,156.710855,6,0
0,0,12,12,15,12,27,38,22,60,0.000333,0.095098,7,1997.052751,110.947375,285.29325,101.622909,4,0
0,0,15,15,15,15,30,53,32,85,0.000333,0.139029,14,5839.199809,324.399989,417.085701,117.206718,4,0
0,0,13,13,15,13,28,40,24,64,0.000333,0.102557,7,2153.695005,119.649723,307.670715,106.709075,4,0
0,0,17,17,15,17,32,58,38,96,0.000333,0.16,14,6720,373.333333,480,128.090227,4,0
0,0,14,14,16,12,28,38,24,62,0.000333,0.099352,16,4768.896083,264.938671,298.056005,107.01955,4,0
0,0,11,11,12,11,23,35,22,57,0.000333,0.085948,12,3094.116378,171.895354,257.843031,81.073298,4,0
0,0,14,14,12,14,26,50,32,82,0.000333,0.128479,12,4625.232683,256.957371,385.436057,96.322519,4,0
0,0,12,12,12,12,24,37,24,61,0.000333,0.093228,12,3356.192551,186.455142,279.682713,86.0391,4,0
0,0,16,16,12,16,28,55,38,93,0.000333,0.149028,12,5365.008093,298.056005,447.084008,107.01955,4,0
0,0,13,13,13,11,24,35,24,59,0.000333,0.090171,12,3246.153451,180.341858,270.512788,86.159464,4,0
0,0,14,14,18,18,36,56,35,91,0.000333,0.156821,9,4234.168576,235.231588,470.463175,150.1173,6,0
0,0,17,17,18,21,39,71,45,116,0.000333,0.204369,18,11035.91983,613.106657,613.106657,167.297316,6,0
0,0,15,15,18,19,37,58,37,95,0.000333,0.164966,9,4454.082628,247.449035,494.89807,155.769273,6,0
0,0,19,19,18,23,41,76,51,127,0.000333,0.226803,18,12247.36388,680.409105,680.409105,179.100575,6,0
0,0,12,12,15,12,27,38,22,60,0.000333,0.095098,7,1997.052751,110.947375,285.29325,101.622909,4,0
0,0,12,12,15,12,27,38,22,60,0.000333,0.095098,7,1997.052751,110.947375,285.29325,101.622909,4,0
0,0,15,15,15,15,30,53,32,85,0.000333,0.139029,14,5839.199809,324.399989,417.085701,117.206718,4,0
0,0,13,13,15,13,28,40,24,64,0.000333,0.102557,7,2153.695005,119.649723,307.670715,106.709075,4,0
0,0,17,17,15,17,32,58,38,96,0.000333,0.16,14,6720,373.333333,480,128.090227,4,0
0,0,14,14,16,12,28,38,24,62,0.000333,0.099352,16,4768.896083,264.938671,298.056005,107.01955,4,0
0,0,11,11,12,11,23,35,22,57,0.000333,0.085948,12,3094.116378,171.895354,257.843031,81.073298,4,0
0,0,14,14,12,14,26,50,32,82,0.000333,0.128479,12,4625.232683,256.957371,385.436057,96.322519,4,0
0,0,12,12,12,12,24,37,24,61,0.000333,0.093228,12,3356.192551,186.455142,279.682713,86.0391,4,0
0,0,16,16,12,16,28,55,38,93,0.000333,0.149028,12,5365.008093,298.056005,447.084008,107.01955,4,0
0,0,16,16,16,12,28,43,27,70,0.000333,0.112172,16,5384.237513,299.124306,336.514845,107.01955,5,0
0,0,13,13,15,17,32,53,35,88,0.000333,0.146667,14,6160,342.222222,440,128.090227,6,0
0,0,16,16,15,20,35,68,45,113,0.000333,0.193203,14,8114.525733,450.806985,579.608981,145.041921,6,0
0,0,14,14,15,18,33,55,37,92,0.000333,0.154695,14,6497.179626,360.954424,464.084259,133.662009,6,0
0,0,18,18,15,22,37,73,51,124,0.000333,0.215324,14,9043.611043,502.422836,645.972217,156.710855,6,0
0,0,14,14,18,18,36,56,35,91,0.000333,0.156821,9,4234.168576,235.231588,470.463175,150.1173,6,0
0,0,17,17,18,21,39,71,45,116,0.000333,0.204369,18,11035.91983,613.106657,613.106657,167.297316,6,0
0,0,15,15,18,19,37,58,37,95,0.000333,0.164966,9,4454.082628,247.449035,494.89807,155.769273,6,0
0,0,19,19,18,23,41,76,51,127,0.000333,0.226803,18,12247.36388,680.409105,680.409105,179.100575,6,0
0,0,12,12,16,12,28,39,24,63,0.000333,0.100954,16,4845.813761,269.211876,302.86336,107.01955,4,0
0,0,15,15,16,15,31,54,34,88,0.000333,0.145323,16,6975.508405,387.528245,435.969275,122.603359,4,0
0,0,13,13,16,13,29,41,26,67,0.000333,0.108495,16,5207.755627,289.319757,325.484727,112.105716,4,0
0,0,17,17,16,16,32,59,40,99,0.000333,0.165,16,7920,440,495,128,4,0
0,0,14,14,17,13,30,40,27,67,0.000333,0.109587,16,5260.186718,292.232595,328.76167,117.592585,4,0
0,0,11,11,12,12,24,35,24,59,0.000333,0.090171,12,3246.153451,180.341858,270.512788,86.0391,4,0
0,0,14,14,12,15,27,50,34,84,0.000333,0.133137,12,4792.926602,266.2737,399.41055,101.622909,4,0
0,0,12,12,12,13,25,37,26,63,0.000333,0.097521,12,3510.755279,195.04196,292.56294,91.125266,4,0
0,0,16,16,12,16,28,55,40,95,0.000333,0.152233,12,5480.384611,304.465812,456.698718,107.01955,4,0
0,0,13,13,13,13,26,36,27,63,0.000333,0.098709,12,3553.532427,197.418468,296.127702,96.211433,4,0
0,0,13,13,15,18,33,53,37,90,0.000333,0.151332,14,6355.93659,353.107588,453.995471,133.662009,6,0
0,0,16,16,15,21,36,68,47,115,0.000333,0.19818,14,8323.579252,462.42107,594.541375,150.842025,6,0
0,0,14,14,15,19,34,55,39,94,0.000333,0.159407,14,6695.101099,371.950061,478.221507,139.313982,6,0
0,0,18,18,15,22,37,73,53,126,0.000333,0.218797,14,9189.475737,510.52643,656.391124,156.710855,6,0
0,0,14,14,18,18,36,57,37,94,0.000333,0.161991,18,8747.513102,485.97295,485.97295,150.1173,6,0
0,0,17,17,18,21,39,72,47,119,0.000333,0.209654,18,11321.33155,628.962864,628.962864,167.297316,6,0
0,0,15,15,18,19,37,59,39,98,0.000333,0.170175,18,9189.475737,510.52643,510.52643,155.769273,6,0
0,0,19,19,18,22,40,77,53,130,0.000333,0.230617,18,12453.31174,691.850652,691.850652,173.166146,6,0
0,0,12,12,16,12,28,39,24,63,0.000333,0.100954,16,4845.813761,269.211876,302.86336,107.01955,4,0
0,0,15,15,16,15,31,54,34,88,0.000333,0.145323,16,6975.508405,387.528245,435.969275,122.603359,4,0
0,0,13,13,16,13,29,41,26,67,0.000333,0.108495,16,5207.755627,289.319757,325.484727,112.105716,4,0
0,0,17,17,16,16,32,59,40,99,0.000333,0.165,16,7920,440,495,128,4,0
0,0,14,14,17,13,30,40,27,67,0.000333,0.109587,16,5260.186718,292.232595,328.76167,117.592585,4,0
0,0,11,11,12,12,24,35,24,59,0.000333,0.090171,12,3246.153451,180.341858,270.512788,86.0391,4,0
0,0,14,14,12,15,27,50,34,84,0.000333,0.133137,12,4792.926602,266.2737,399.41055,101.622909,4,0
0,0,12,12,12,13,25,37,26,63,0.000333,0.097521,12,3510.755279,195.04196,292.56294,91.125266,4,0
0,0,16,16,12,16,28,55,40,95,0.000333,0.152233,12,5480.384611,304.465812,456.698718,107.01955,4,0
0,0,13,13,13,13,26,36,27,63,0.000333,0.098709,12,3553.532427,197.418468,296.127702,96.211433,4,0
0,0,13,13,15,18,33,53,37,90,0.000333,0.151332,14,6355.93659,353.107588,453.995471,133.662009,6,0
0,0,16,16,15,21,36,68,47,115,0.000333,0.19818,14,8323.579252,462.42107,594.541375,150.842025,6,0
0,0,14,14,15,19,34,55,39,94,0.000333,0.159407,14,6695.101099,371.950061,478.221507,139.313982,6,0
0,0,18,18,15,22,37,73,53,126,0.000333,0.218797,14,9189.475737,510.52643,656.391124,156.710855,6,0
0,0,14,14,18,18,36,57,37,94,0.000333,0.161991,18,8747.513102,485.97295,485.97295,150.1173,6,0
0,0,17,17,18,21,39,72,47,119,0.000333,0.209654,18,11321.33155,628.962864,628.962864,167.297316,6,0
0,0,15,15,18,19,37,59,39,98,0.000333,0.170175,18,9189.475737,510.52643,510.52643,155.769273,6,0
0,0,19,19,18,22,40,77,53,130,0.000333,0.230617,18,12453.31174,691.850652,691.850652,173.166146,6,0
0,0,17,17,17,13,30,49,26,75,0.000333,0.122672,16,5888.268715,327.12604,368.016795,117.592585,4,0
0,0,20,20,17,16,33,64,36,100,0.000333,0.168146,16,8071.030591,448.390588,504.439412,133.486868,4,0
0,0,18,18,17,14,31,51,28,79,0.000333,0.130461,16,6262.104136,347.894674,391.381509,122.789837,4,0
0,0,22,22,17,18,35,69,42,111,0.000333,0.189783,16,9109.606638,506.089258,569.350415,144.545518,4,0
0,0,17,17,17,14,31,49,26,75,0.000333,0.123855,8,2972.517786,165.139877,371.564723,122.789837,4,0
0,0,20,20,17,17,34,64,36,100,0.000333,0.169582,16,8139.940546,452.218919,508.746284,138.973737,4,0
0,0,18,18,17,15,32,51,28,79,0.000333,0.131667,8,3160,175.555556,395,128.090227,4,0
0,0,22,22,17,18,35,69,42,111,0.000333,0.189783,16,9109.606638,506.089258,569.350415,144.545518,4,0
0,0,19,19,20,19,39,67,39,106,0.000333,0.186751,20,11205.0527,622.502928,560.252635,167.149185,6,0
0,0,22,22,20,22,42,82,49,131,0.000333,0.235465,20,14127.87165,784.881758,706.393582,184.546058,6,0
0,0,20,20,20,20,40,69,41,110,0.000333,0.195137,20,11708.24181,650.457878,585.41209,172.877124,6,0
0,0,24,24,20,24,44,87,55,142,0.000333,0.258413,20,15504.7858,861.376989,775.23929,196.477662,6,0
0,0,22,22,20,20,40,75,41,116,0.000333,0.205781,20,12346.87318,685.937399,617.343659,172.877124,6,0
0,0,25,25,20,23,43,90,51,141,0.000333,0.255034,20,15302.06661,850.114812,765.10333,190.480487,6,0
0,0,23,23,20,21,41,77,43,120,0.000333,0.214302,20,12858.12481,714.340267,642.906241,178.677228,6,0
0,0,27,27,20,25,45,95,57,152,0.000333,0.278254,20,16695.23341,927.512967,834.761671,202.534967,6,0
0,0,15,15,17,17,34,57,35,92,0.000333,0.156016,16,7488.745302,416.041406,468.046581,138.973737,6,0
0,0,13,13,14,11,25,39,22,61,0.000333,0.094425,14,3965.853186,220.325177,283.275228,91.356717,4,0
0,0,13,13,17,19,36,63,43,106,0.000333,0.182671,16,8768.192802,487.121822,548.01205,150.197491,6,0
0,0,11,11,15,13,28,45,30,75,0.000333,0.120184,14,5047.722668,280.429037,360.551619,106.709075,4,0
0,0,13,13,14,12,26,35,24,59,0.000333,0.092442,14,3882.563207,215.697956,277.325943,96.322519,2,0
0,0,15,15,17,18,35,53,37,90,0.000333,0.153878,16,7386.167544,410.342641,461.635472,144.545518,4,0
0,0,16,16,19,21,40,61,50,111,0.000333,0.196911,18,10633.21233,590.734019,590.734019,172.949289,5,0
0,0,15,15,16,22,38,58,50,108,0.000333,0.188925,16,9068.418743,503.801041,566.776171,162.107496,5,0
0,0,13,13,13,15,28,40,33,73,0.000333,0.116979,12,4211.242912,233.95794,350.936909,106.709075,3,0
0,0,13,13,12,16,28,39,37,76,0.000333,0.121786,12,4384.307689,243.572649,365.358974,107.01955,3,0
0,0,16,16,18,21,39,60,50,110,0.000333,0.193798,18,10465.09639,581.394244,581.394244,167.297316,5,0
0,0,15,15,15,22,37,57,50,107,0.000333,0.185804,14,7803.761142,433.542286,557.41151,156.710855,5,0
0,0,11,11,12,11,23,33,26,59,0.000333,0.088963,12,3202.681865,177.92677,266.890155,81.073298,2,0
0,0,13,13,15,17,32,51,39,90,0.000333,0.15,14,6300,350,450,128.090227,4,0
0,0,16,16,16,18,34,64,47,111,0.000333,0.188236,16,9035.334006,501.963,564.708375,139.05865,4,0
0,0,14,14,13,12,25,46,34,80,0.000333,0.123836,12,4458.101942,247.67233,371.508495,91.125266,2,0
0,0,11,11,13,11,24,34,26,60,0.000333,0.091699,12,3301.173001,183.3985,275.09775,86.159464,2,0
0,0,13,13,16,17,33,52,39,91,0.000333,0.153013,16,7344.637838,408.035435,459.039865,133.486868,4,0
0,0,12,12,13,14,27,36,29,65,0.000333,0.103023,12,3708.812252,206.045125,309.067688,101.408685,2,0
0,0,14,14,16,20,36,54,42,96,0.000333,0.165438,16,7941.004802,441.166933,496.3128,150.438562,4,0
0,0,11,11,13,13,26,35,28,63,0.000333,0.098709,12,3553.532427,197.418468,296.127702,96.211433,2,0
0,0,13,13,16,19,35,53,41,94,0.000333,0.160718,16,7714.441657,428.580092,482.152604,144.710623,4,0
0,0,14,14,17,18,35,56,43,99,0.000333,0.169266,16,8124.784299,451.376905,507.799019,144.545518,4,0
0,0,12,12,14,12,26,38,30,68,0.000333,0.106543,14,4474.818612,248.601034,319.629901,96.322519,2,0
0,0,13,13,17,19,36,54,41,95,0.000333,0.163714,16,7858.286002,436.571445,491.142875,150.197491,4,0
0,0,11,11,14,13,27,36,28,64,0.000333,0.101438,14,4260.379202,236.687733,304.3128,101.408685,2,0
0,0,14,14,16,20,36,60,45,105,0.000333,0.180947,16,8685.474002,482.526333,542.842125,150.438562,4,0
0,0,12,12,13,14,27,42,32,74,0.000333,0.117287,12,4222.340102,234.57445,351.861675,101.408685,2,0
0,0,13,13,13,14,27,35,32,67,0.000333,0.106192,12,3822.929552,212.384975,318.577463,101.408685,2,0
0,0,15,15,16,20,36,53,45,98,0.000333,0.168884,16,8106.442402,450.357911,506.65265,150.438562,4,0
0,0,11,11,12,13,25,34,28,62,0.000333,0.095973,12,3455.029005,191.946056,287.919084,91.125266,2,0
0,0,13,13,15,19,34,52,41,93,0.000333,0.157711,14,6623.876619,367.993146,473.134044,139.313982,4,0
0,0,13,13,12,14,26,39,36,75,0.000333,0.117511,12,4230.395746,235.021986,352.532979,96.322519,2,0
0,0,15,15,15,20,35,57,49,106,0.000333,0.181235,14,7611.855997,422.880889,543.704,145.041921,4,0
0,0,15,15,12,15,27,44,44,88,0.000333,0.139477,12,5021.161202,278.9534,418.4301,101.622909,2,0
0,0,17,17,15,21,36,62,57,119,0.000333,0.205074,14,8613.095052,478.505281,615.221075,150.842025,4,0
0,0,17,17,12,16,28,49,52,101,0.000333,0.161848,18,8739.771248,485.542847,485.542847,107.01955,2,0
0,0,19,19,15,22,37,67,65,132,0.000333,0.229216,14,9627.06982,534.837212,687.647844,156.710855,4,0
0,0,14,14,16,18,34,55,43,98,0.000333,0.16619,16,7977.141735,443.174541,498.571358,139.05865,4,0
0,0,12,12,13,12,25,37,30,67,0.000333,0.103713,12,3733.660377,207.425576,311.138365,91.125266,2,0
0,0,13,13,16,19,35,53,41,94,0.000333,0.160718,16,7714.441657,428.580092,482.152604,144.710623,4,0
0,0,11,11,13,13,26,35,28,63,0.000333,0.098709,12,3553.532427,197.418468,296.127702,96.211433,2,0
0,0,14,14,16,20,36,57,44,101,0.000333,0.174054,16,8354.598802,464.144378,522.162425,150.438562,4,0
0,0,12,12,13,14,27,39,31,70,0.000333,0.110947,12,3994.105502,221.89475,332.842125,101.408685,2,0
0,0,15,15,16,21,37,65,48,113,0.000333,0.196223,16,9418.691685,523.260649,588.66823,156.238666,4,0
0,0,13,13,13,15,28,47,35,82,0.000333,0.131401,12,4730.437243,262.802069,394.203104,106.709075,2,0
0,0,14,14,15,20,35,59,45,104,0.000333,0.177815,14,7468.236073,414.902004,533.445434,145.041921,4,0
0,0,12,12,12,14,26,41,32,73,0.000333,0.114377,12,4117.585193,228.754733,343.132099,96.322519,2,0
0,0,14,14,12,16,28,47,38,85,0.000333,0.136208,12,4903.50202,272.416779,408.625168,107.01955,2,0
0,0,16,16,15,22,37,65,51,116,0.000333,0.201432,14,8460.152266,470.008459,604.29659,156.710855,4,0
0,0,16,16,16,22,38,59,50,109,0.000333,0.190675,16,9152.385583,508.465866,572.024099,162.107496,4,0
0,0,14,14,13,16,29,41,37,78,0.000333,0.126308,12,4547.070211,252.615012,378.922518,112.105716,2,0
0,0,15,15,15,20,35,52,45,97,0.000333,0.165847,14,6965.566337,386.975908,497.540453,145.041921,4,0
0,0,13,13,12,14,26,34,32,66,0.000333,0.10341,12,3722.748257,206.819348,310.229021,96.322519,2,0
0,0,18,18,16,25,41,82,67,149,0.000333,0.266092,16,12772.40398,709.577999,798.275249,180.096405,4,0
0,0,16,16,14,19,33,64,54,118,0.000333,0.198413,14,8333.339085,462.963283,595.238506,134.013592,2,0
0,0,18,18,16,23,39,72,58,130,0.000333,0.229034,16,10993.63662,610.75759,687.102288,168.041925,4,0
0,0,16,16,14,17,31,54,45,99,0.000333,0.163488,14,6866.516086,381.473116,490.465435,122.789837,2,0
0,0,18,18,15,24,39,75,60,135,0.000333,0.237843,14,9989.410194,554.967233,713.5293,168.642459,4,0
0,0,16,16,13,18,31,57,47,104,0.000333,0.171745,12,6182.836995,343.490944,515.236416,123.164366,2,0
0,0,9,9,16,12,28,36,23,59,0.000333,0.094545,8,2269.071523,126.059529,283.63394,107.01955,3,0
0,0,9,9,12,10,22,29,20,49,0.000333,0.072837,12,2622.145792,145.674766,218.512149,76.238831,2,0
0,0,11,11,12,11,23,35,22,57,0.000333,0.085948,12,3094.116378,171.895354,257.843031,81.073298,4,0
0,0,11,11,16,13,29,42,25,67,0.000333,0.108495,8,2603.877813,144.659879,325.484727,112.105716,5,0
0,0,12,12,15,11,26,38,22,60,0.000333,0.094009,14,3948.369363,219.353854,282.026383,96.657107,4,0
0,0,12,12,19,13,32,45,25,70,0.000333,0.116667,9,3150,175,350,128.816339,5,0
0,0,11,11,12,11,23,35,24,59,0.000333,0.088963,12,3202.681865,177.92677,266.890155,81.073298,4,0
0,0,11,11,16,13,29,42,27,69,0.000333,0.111734,16,5363.211019,297.956168,335.200689,112.105716,5,0
0,0,12,12,16,11,27,39,24,63,0.000333,0.099853,16,4792.926602,266.2737,299.557913,102.053748,4,0
0,0,12,12,20,13,33,46,27,73,0.000333,0.122747,20,7364.815414,409.156412,368.240771,134.544278,5,0
0,0,12,12,15,12,27,38,22,60,0.000333,0.095098,7,1997.052751,110.947375,285.29325,101.622909,4,0
0,0,12,12,19,14,33,45,25,70,0.000333,0.117703,9,3177.968295,176.553794,353.107588,134.013592,5,0
0,0,11,11,12,11,23,35,22,57,0.000333,0.085948,12,3094.116378,171.895354,257.843031,81.073298,4,0
0,0,11,11,16,13,29,42,25,67,0.000333,0.108495,8,2603.877813,144.659879,325.484727,112.105716,5,0
0,0,12,12,15,12,27,38,22,60,0.000333,0.095098,7,1997.052751,110.947375,285.29325,101.622909,4,0
0,0,12,12,19,14,33,45,25,70,0.000333,0.117703,9,3177.968295,176.553794,353.107588,134.013592,5,0
0,0,11,11,12,11,23,35,22,57,0.000333,0.085948,12,3094.116378,171.895354,257.843031,81.073298,4,0
0,0,11,11,16,13,29,42,25,67,0.000333,0.108495,8,2603.877813,144.659879,325.484727,112.105716,5,0
0,0,12,12,20,14,34,46,27,73,0.000333,0.123795,10,3713.847874,206.324882,371.384787,139.741531,5,0
0,0,11,11,16,14,30,42,27,69,0.000333,0.112858,8,2708.603609,150.477978,338.575451,117.302969,5,0
0,0,12,12,16,12,28,39,24,63,0.000333,0.100954,16,4845.813761,269.211876,302.86336,107.01955,4,0
0,0,11,11,12,12,24,35,24,59,0.000333,0.090171,12,3246.153451,180.341858,270.512788,86.0391,4,0
0,0,12,12,20,14,34,46,27,73,0.000333,0.123795,10,3713.847874,206.324882,371.384787,139.741531,5,0
0,0,11,11,16,14,30,42,27,69,0.000333,0.112858,8,2708.603609,150.477978,338.575451,117.302969,5,0
0,0,12,12,16,12,28,39,24,63,0.000333,0.100954,16,4845.813761,269.211876,302.86336,107.01955,4,0
0,0,11,11,12,12,24,35,24,59,0.000333,0.090171,12,3246.153451,180.341858,270.512788,86.0391,4,0
0,0,12,12,19,14,33,45,25,70,0.000333,0.117703,9,3177.968295,176.553794,353.107588,134.013592,5,0
0,0,11,11,16,13,29,42,25,67,0.000333,0.108495,8,2603.877813,144.659879,325.484727,112.105716,5,0
0,0,12,12,15,12,27,38,22,60,0.000333,0.095098,7,1997.052751,110.947375,285.29325,101.622909,4,0
0,0,11,11,12,11,23,35,22,57,0.000333,0.085948,12,3094.116378,171.895354,257.843031,81.073298,4,0
0,0,11,11,12,11,23,35,22,57,0.000333,0.085948,12,3094.116378,171.895354,257.843031,81.073298,4,0
0,0,11,11,16,13,29,42,25,67,0.000333,0.108495,8,2603.877813,144.659879,325.484727,112.105716,5,0
0,0,12,12,15,12,27,38,22,60,0.000333,0.095098,7,1997.052751,110.947375,285.29325,101.622909,4,0
0,0,12,12,19,14,33,45,25,70,0.000333,0.117703,9,3177.968295,176.553794,353.107588,134.013592,5,0
0,0,11,11,12,11,23,35,22,57,0.000333,0.085948,12,3094.116378,171.895354,257.843031,81.073298,4,0
0,0,11,11,16,13,29,42,25,67,0.000333,0.108495,8,2603.877813,144.659879,325.484727,112.105716,5,0
0,0,12,12,15,12,27,38,22,60,0.000333,0.095098,7,1997.052751,110.947375,285.29325,101.622909,4,0
0,0,12,12,19,14,33,45,25,70,0.000333,0.117703,9,3177.968295,176.553794,353.107588,134.013592,5,0
0,0,11,11,12,11,23,35,22,57,0.000333,0.085948,12,3094.116378,171.895354,257.843031,81.073298,4,0
0,0,12,12,19,14,33,45,25,70,0.000333,0.117703,9,3177.968295,176.553794,353.107588,134.013592,5,0
0,0,11,11,16,13,29,42,25,67,0.000333,0.108495,8,2603.877813,144.659879,325.484727,112.105716,5,0
0,0,12,12,15,12,27,38,22,60,0.000333,0.095098,7,1997.052751,110.947375,285.29325,101.622909,4,0
0,0,11,11,12,12,24,35,24,59,0.000333,0.090171,12,3246.153451,180.341858,270.512788,86.0391,4,0
0,0,12,12,20,14,34,46,27,73,0.000333,0.123795,10,3713.847874,206.324882,371.384787,139.741531,5,0
0,0,11,11,16,14,30,42,27,69,0.000333,0.112858,8,2708.603609,150.477978,338.575451,117.302969,5,0
0,0,12,12,16,12,28,39,24,63,0.000333,0.100954,16,4845.813761,269.211876,302.86336,107.01955,4,0
0,0,11,11,12,12,24,35,24,59,0.000333,0.090171,12,3246.153451,180.341858,270.512788,86.0391,4,0
0,0,12,12,20,14,34,46,27,73,0.000333,0.123795,10,3713.847874,206.324882,371.384787,139.741531,5,0
0,0,11,11,16,14,30,42,27,69,0.000333,0.112858,8,2708.603609,150.477978,338.575451,117.302969,5,0
0,0,12,12,16,12,28,39,24,63,0.000333,0.100954,16,4845.813761,269.211876,302.86336,107.01955,4,0
0,0,16,16,21,14,35,52,27,79,0.000333,0.135071,10,4052.133583,225.118532,405.213358,145.541635,5,0
0,0,16,16,17,12,29,45,24,69,0.000333,0.111734,16,5363.211019,297.956168,335.200689,112.506418,4,0
0,0,16,16,17,13,30,45,24,69,0.000333,0.112858,8,2708.603609,150.477978,338.575451,117.592585,4,0
0,0,18,18,21,15,36,56,27,83,0.000333,0.143035,10,4291.037751,238.390986,429.103775,150.842025,5,0
0,0,13,13,18,13,31,46,25,71,0.000333,0.117249,9,3165.731442,175.873969,351.747938,123.164366,5,0
0,0,13,13,14,11,25,39,22,61,0.000333,0.094425,14,3965.853186,220.325177,283.275228,91.356717,4,0
0,0,11,11,18,15,33,52,33,85,0.000333,0.142925,18,7717.923003,428.7735,428.7735,133.662009,5,0
0,0,11,11,15,13,28,45,30,75,0.000333,0.120184,14,5047.722668,280.429037,360.551619,106.709075,4,0
0,0,13,13,14,12,26,35,24,59,0.000333,0.092442,14,3882.563207,215.697956,277.325943,96.322519,2,0
0,0,13,13,18,14,32,42,27,69,0.000333,0.115,9,3105,172.5,345,128.361619,3,0
0,0,14,14,20,17,37,50,40,90,0.000333,0.156284,20,9377.016058,520.945337,468.850803,155.92543,4,0
0,0,13,13,13,15,28,40,33,73,0.000333,0.116979,12,4211.242912,233.95794,350.936909,106.709075,3,0
0,0,13,13,17,18,35,47,40,87,0.000333,0.148749,16,7139.96196,396.664553,446.247622,144.545518,4,0
0,0,14,14,19,17,36,49,40,89,0.000333,0.153374,18,8282.219852,460.123325,460.123325,150.197491,4,0
0,0,13,13,16,18,34,46,40,86,0.000333,0.145841,16,7000.34887,388.908271,437.521804,139.05865,4,0
0,0,13,13,12,16,28,39,37,76,0.000333,0.121786,12,4384.307689,243.572649,365.358974,107.01955,3,0
0,0,11,11,16,13,29,40,29,69,0.000333,0.111734,16,5363.211019,297.956168,335.200689,112.105716,3,0
0,0,11,11,12,11,23,33,26,59,0.000333,0.088963,12,3202.681865,177.92677,266.890155,81.073298,2,0
0,0,14,14,16,14,30,53,37,90,0.000333,0.147207,16,7065.922458,392.551248,441.620154,117.302969,3,0
0,0,14,14,13,12,25,46,34,80,0.000333,0.123836,12,4458.101942,247.67233,371.508495,91.125266,2,0
0,0,11,11,16,13,29,41,29,70,0.000333,0.113353,16,5440.938715,302.274373,340.05867,112.105716,3,0
0,0,11,11,13,11,24,34,26,60,0.000333,0.091699,12,3301.173001,183.3985,275.09775,86.159464,2,0
0,0,12,12,13,14,27,36,29,65,0.000333,0.103023,12,3708.812252,206.045125,309.067688,101.408685,2,0
0,0,12,12,17,16,33,43,32,75,0.000333,0.12611,16,6053.272943,336.292941,378.329559,133.486868,3,0
0,0,11,11,17,15,32,42,31,73,0.000333,0.121667,16,5840,324.444444,365,128.090227,3,0
0,0,11,11,13,13,26,35,28,63,0.000333,0.098709,12,3553.532427,197.418468,296.127702,96.211433,2,0
0,0,12,12,14,12,26,38,30,68,0.000333,0.106543,14,4474.818612,248.601034,319.629901,96.322519,2,0
0,0,12,12,18,14,32,45,33,78,0.000333,0.13,18,7020,390,390,128.361619,3,0
0,0,11,11,17,15,32,43,31,74,0.000333,0.123333,16,5920,328.888889,370,128.090227,3,0
0,0,11,11,14,13,27,36,28,64,0.000333,0.101438,14,4260.379202,236.687733,304.3128,101.408685,2,0
0,0,12,12,13,14,27,42,32,74,0.000333,0.117287,12,4222.340102,234.57445,351.861675,101.408685,2,0
0,0,12,12,17,16,33,49,35,84,0.000333,0.141243,16,6779.665696,376.648094,423.729106,133.486868,3,0
0,0,13,13,17,16,33,42,35,77,0.000333,0.129473,16,6214.693555,345.260753,388.418347,133.486868,3,0
0,0,13,13,13,14,27,35,32,67,0.000333,0.106192,12,3822.929552,212.384975,318.577463,101.408685,2,0
0,0,11,11,12,13,25,34,28,62,0.000333,0.095973,12,3455.029005,191.946056,287.919084,91.125266,2,0
0,0,11,11,16,15,31,41,31,72,0.000333,0.118901,16,5707.23415,317.068564,356.702134,122.603359,3,0
0,0,13,13,12,14,26,39,36,75,0.000333,0.117511,12,4230.395746,235.021986,352.532979,96.322519,2,0
0,0,13,13,16,16,32,46,39,85,0.000333,0.141667,16,6800,377.777778,425,128,3,0
0,0,15,15,12,15,27,44,44,88,0.000333,0.139477,12,5021.161202,278.9534,418.4301,101.622909,2,0
0,0,15,15,16,17,33,51,47,98,0.000333,0.164784,16,7909.609979,439.422777,494.350624,133.486868,3,0
0,0,17,17,12,16,28,49,52,101,0.000333,0.161848,18,8739.771248,485.542847,485.542847,107.01955,2,0
0,0,17,17,16,18,34,56,55,111,0.000333,0.188236,24,13553.00101,752.944501,564.708375,139.05865,3,0
0,0,12,12,13,12,25,37,30,67,0.000333,0.103713,12,3733.660377,207.425576,311.138365,91.125266,2,0
0,0,12,12,17,14,31,44,33,77,0.000333,0.127158,16,6103.569854,339.087214,381.473116,122.789837,3,0
0,0,11,11,13,13,26,35,28,63,0.000333,0.098709,12,3553.532427,197.418468,296.127702,96.211433,2,0
0,0,11,11,16,15,31,42,31,73,0.000333,0.120552,16,5786.501291,321.472294,361.656331,122.603359,3,0
0,0,12,12,16,16,32,46,34,80,0.000333,0.133333,16,6400,355.555556,400,128,3,0
0,0,12,12,13,14,27,39,31,70,0.000333,0.110947,12,3994.105502,221.89475,332.842125,101.408685,2,0
0,0,13,13,16,17,33,54,38,92,0.000333,0.154695,16,7425.348144,412.519341,464.084259,133.486868,3,0
0,0,13,13,13,15,28,47,35,82,0.000333,0.131401,12,4730.437243,262.802069,394.203104,106.709075,2,0
0,0,12,12,16,16,32,48,35,83,0.000333,0.138333,16,6640,368.888889,415,128,3,0
0,0,12,12,12,14,26,41,32,73,0.000333,0.114377,12,4117.585193,228.754733,343.132099,96.322519,2,0
0,0,14,14,16,18,34,54,41,95,0.000333,0.161103,16,7732.943519,429.607973,483.30897,139.05865,3,0
0,0,14,14,12,16,28,47,38,85,0.000333,0.136208,12,4903.50202,272.416779,408.625168,107.01955,2,0
0,0,14,14,13,16,29,41,37,78,0.000333,0.126308,12,4547.070211,252.615012,378.922518,112.105716,2,0
0,0,14,14,17,18,35,48,40,88,0.000333,0.150459,16,7222.030488,401.223916,451.376905,144.545518,3,0
0,0,13,13,16,16,32,41,35,76,0.000333,0.126667,16,6080,337.777778,380,128,3,0
0,0,13,13,12,14,26,34,32,66,0.000333,0.10341,12,3722.748257,206.819348,310.229021,96.322519,2,0
0,0,16,16,14,19,33,64,54,118,0.000333,0.198413,14,8333.339085,462.963283,595.238506,134.013592,2,0
0,0,16,16,17,21,38,71,57,128,0.000333,0.223912,16,10747.75555,597.09753,671.734722,161.725534,3,0
0,0,16,16,14,17,31,54,45,99,0.000333,0.163488,14,6866.516086,381.473116,490.465435,122.789837,2,0
0,0,16,16,17,19,36,61,48,109,0.000333,0.187841,16,9016.349203,500.908289,563.521825,150.197491,3,0
0,0,16,16,13,18,31,57,47,104,0.000333,0.171745,12,6182.836995,343.490944,515.236416,123.164366,2,0
0,0,16,16,16,20,36,64,50,114,0.000333,0.196457,16,9429.943203,523.885733,589.37145,150.438562,3,0
0,0,9,9,12,10,22,29,20,49,0.000333,0.072837,12,2622.145792,145.674766,218.512149,76.238831,2,0
0,0,14,14,17,19,36,56,41,97,0.000333,0.167161,16,8023.723602,445.762422,501.482725,150.197491,5,0
0,0,11,11,12,11,23,35,22,57,0.000333,0.085948,12,3094.116378,171.895354,257.843031,81.073298,4,0
0,0,17,17,20,19,39,65,43,108,0.000333,0.190274,20,11416.46879,634.248266,570.82344,167.149185,7,0
0,0,16,16,17,19,36,62,43,105,0.000333,0.180947,16,8685.474002,482.526333,542.842125,150.197491,7,0
0,0,12,12,15,11,26,38,22,60,0.000333,0.094009,14,3948.369363,219.353854,282.026383,96.657107,4,0
0,0,11,11,12,11,23,35,24,59,0.000333,0.088963,12,3202.681865,177.92677,266.890155,81.073298,4,0
0,0,17,17,21,20,41,66,45,111,0.000333,0.198229,20,11893.76545,660.764747,594.688273,178.677228,7,0
0,0,16,16,17,20,37,62,45,107,0.000333,0.185804,16,8918.584162,495.476898,557.41151,155.92543,7,0
0,0,12,12,16,11,27,39,24,63,0.000333,0.099853,16,4792.926602,266.2737,299.557913,102.053748,4,0
0,0,17,17,20,21,41,65,43,108,0.000333,0.192872,20,11572.31233,642.906241,578.615616,178.677228,7,0
0,0,16,16,17,20,37,62,43,105,0.000333,0.182331,16,8751.881654,486.215647,546.992603,155.92543,7,0
0,0,12,12,15,12,27,38,22,60,0.000333,0.095098,7,1997.052751,110.947375,285.29325,101.622909,4,0
0,0,11,11,12,11,23,35,22,57,0.000333,0.085948,12,3094.116378,171.895354,257.843031,81.073298,4,0
0,0,17,17,20,21,41,65,43,108,0.000333,0.192872,20,11572.31233,642.906241,578.615616,178.677228,7,0
0,0,16,16,17,20,37,62,43,105,0.000333,0.182331,16,8751.881654,486.215647,546.992603,155.92543,7,0
0,0,12,12,15,12,27,38,22,60,0.000333,0.095098,7,1997.052751,110.947375,285.29325,101.622909,4,0
0,0,11,11,12,11,23,35,22,57,0.000333,0.085948,12,3094.116378,171.895354,257.843031,81.073298,4,0
0,0,12,12,16,12,28,39,24,63,0.000333,0.100954,16,4845.813761,269.211876,302.86336,107.01955,4,0
0,0,11,11,12,12,24,35,24,59,0.000333,0.090171,12,3246.153451,180.341858,270.512788,86.0391,4,0
0,0,16,16,17,21,38,62,45,107,0.000333,0.187176,16,8984.451903,499.136217,561.528244,161.725534,7,0
0,0,17,17,21,21,42,66,45,111,0.000333,0.199516,20,11970.94468,665.052482,598.547234,184.477332,7,0
0,0,12,12,16,12,28,39,24,63,0.000333,0.100954,16,4845.813761,269.211876,302.86336,107.01955,4,0
0,0,11,11,12,12,24,35,24,59,0.000333,0.090171,12,3246.153451,180.341858,270.512788,86.0391,4,0
0,0,16,16,17,21,38,62,45,107,0.000333,0.187176,16,8984.451903,499.136217,561.528244,161.725534,7,0
0,0,17,17,21,21,42,66,45,111,0.000333,0.199516,20,11970.94468,665.052482,598.547234,184.477332,7,0
0,0,12,12,15,12,27,38,22,60,0.000333,0.095098,7,1997.052751,110.947375,285.29325,101.622909,4,0
0,0,11,11,12,11,23,35,22,57,0.000333,0.085948,12,3094.116378,171.895354,257.843031,81.073298,4,0
0,0,16,16,17,20,37,62,43,105,0.000333,0.182331,16,8751.881654,486.215647,546.992603,155.92543,7,0
0,0,17,17,20,21,41,65,43,108,0.000333,0.192872,20,11572.31233,642.906241,578.615616,178.677228,7,0
0,0,11,11,12,11,23,35,22,57,0.000333,0.085948,12,3094.116378,171.895354,257.843031,81.073298,4,0
0,0,17,17,20,21,41,65,43,108,0.000333,0.192872,20,11572.31233,642.906241,578.615616,178.677228,7,0
0,0,16,16,17,20,37,62,43,105,0.000333,0.182331,16,8751.881654,486.215647,546.992603,155.92543,7,0
0,0,12,12,15,12,27,38,22,60,0.000333,0.095098,7,1997.052751,110.947375,285.29325,101.622909,4,0
0,0,11,11,12,11,23,35,22,57,0.000333,0.085948,12,3094.116378,171.895354,257.843031,81.073298,4,0
0,0,17,17,20,21,41,65,43,108,0.000333,0.192872,20,11572.31233,642.906241,578.615616,178.677228,7,0
0,0,16,16,17,20,37,62,43,105,0.000333,0.182331,16,8751.881654,486.215647,546.992603,155.92543,7,0
0,0,12,12,15,12,27,38,22,60,0.000333,0.095098,7,1997.052751,110.947375,285.29325,101.622909,4,0
0,0,17,17,20,21,41,65,43,108,0.000333,0.192872,20,11572.31233,642.906241,578.615616,178.677228,7,0
0,0,12,12,15,12,27,38,22,60,0.000333,0.095098,7,1997.052751,110.947375,285.29325,101.622909,4,0
0,0,11,11,12,11,23,35,22,57,0.000333,0.085948,12,3094.116378,171.895354,257.843031,81.073298,4,0
0,0,16,16,17,20,37,62,43,105,0.000333,0.182331,16,8751.881654,486.215647,546.992603,155.92543,7,0
0,0,17,17,21,21,42,66,45,111,0.000333,0.199516,20,11970.94468,665.052482,598.547234,184.477332,7,0
0,0,12,12,16,12,28,39,24,63,0.000333,0.100954,16,4845.813761,269.211876,302.86336,107.01955,4,0
0,0,11,11,12,12,24,35,24,59,0.000333,0.090171,12,3246.153451,180.341858,270.512788,86.0391,4,0
0,0,16,16,17,21,38,62,45,107,0.000333,0.187176,16,8984.451903,499.136217,561.528244,161.725534,7,0
0,0,17,17,21,21,42,66,45,111,0.000333,0.199516,20,11970.94468,665.052482,598.547234,184.477332,7,0
0,0,12,12,16,12,28,39,24,63,0.000333,0.100954,16,4845.813761,269.211876,302.86336,107.01955,4,0
0,0,11,11,12,12,24,35,24,59,0.000333,0.090171,12,3246.153451,180.341858,270.512788,86.0391,4,0
0,0,16,16,17,21,38,62,45,107,0.000333,0.187176,16,8984.451903,499.136217,561.528244,161.725534,7,0
0,0,21,21,21,21,42,72,45,117,0.000333,0.2103,20,12618.02277,701.001265,630.901138,184.477332,7,0
0,0,23,23,21,22,43,76,45,121,0.000333,0.218859,20,13131.56071,729.53115,656.578035,190.346161,7,0
0,0,16,16,17,12,29,45,24,69,0.000333,0.111734,16,5363.211019,297.956168,335.200689,112.506418,4,0
0,0,16,16,17,13,30,45,24,69,0.000333,0.112858,8,2708.603609,150.477978,338.575451,117.592585,4,0
0,0,13,13,14,11,25,39,22,61,0.000333,0.094425,14,3965.853186,220.325177,283.275228,91.356717,4,0
0,0,18,18,18,19,37,66,43,109,0.000333,0.189277,18,10220.9475,567.830417,567.830417,155.769273,7,0
0,0,11,11,15,13,28,45,30,75,0.000333,0.120184,14,5047.722668,280.429037,360.551619,106.709075,4,0
0,0,16,16,19,21,40,72,51,123,0.000333,0.218199,18,11782.7488,654.597156,654.597156,172.949289,7,0
0,0,13,13,14,12,26,35,24,59,0.000333,0.092442,14,3882.563207,215.697956,277.325943,96.322519,2,0
0,0,18,18,19,21,40,62,45,107,0.000333,0.189815,18,10250.03351,569.446306,569.446306,172.949289,5,0
0,0,18,18,18,24,42,67,58,125,0.000333,0.22468,18,12132.7142,674.039678,674.039678,185.09775,6,0
0,0,19,19,21,24,45,70,58,128,0.000333,0.234319,20,14059.14393,781.063551,702.957196,202.277766,6,0
0,0,13,13,13,15,28,40,33,73,0.000333,0.116979,12,4211.242912,233.95794,350.936909,106.709075,3,0
0,0,19,19,20,24,44,69,58,127,0.000333,0.231116,20,13866.95631,770.386462,693.347816,196.477662,6,0
0,0,18,18,17,24,41,66,58,124,0.000333,0.221445,16,10629.38318,590.521288,664.336449,179.525968,6,0
0,0,13,13,12,16,28,39,37,76,0.000333,0.121786,12,4384.307689,243.572649,365.358974,107.01955,3,0
0,0,16,16,17,20,37,60,47,107,0.000333,0.185804,16,8918.584162,495.476898,557.41151,155.92543,5,0
0,0,11,11,12,11,23,33,26,59,0.000333,0.088963,12,3202.681865,177.92677,266.890155,81.073298,2,0
0,0,14,14,13,12,25,46,34,80,0.000333,0.123836,12,4458.101942,247.67233,371.508495,91.125266,2,0
0,0,19,19,18,21,39,73,55,128,0.000333,0.22551,18,12177.56671,676.531484,676.531484,167.297316,5,0
0,0,11,11,13,11,24,34,26,60,0.000333,0.091699,12,3301.173001,183.3985,275.09775,86.159464,2,0
0,0,16,16,18,20,38,61,47,108,0.000333,0.188925,18,10201.97109,566.776171,566.776171,161.497212,5,0
0,0,17,17,18,23,41,63,50,113,0.000333,0.201801,18,10897.26078,605.403377,605.403377,179.100575,5,0
0,0,12,12,13,14,27,36,29,65,0.000333,0.103023,12,3708.812252,206.045125,309.067688,101.408685,2,0
0,0,16,16,18,22,40,62,49,111,0.000333,0.196911,18,10633.21233,590.734019,590.734019,173.166146,5,0
0,0,11,11,13,13,26,35,28,63,0.000333,0.098709,12,3553.532427,197.418468,296.127702,96.211433,2,0
0,0,17,17,19,21,40,65,51,116,0.000333,0.205781,18,11112.18586,617.343659,617.343659,172.949289,5,0
0,0,12,12,14,12,26,38,30,68,0.000333,0.106543,14,4474.818612,248.601034,319.629901,96.322519,2,0
0,0,16,16,19,22,41,63,49,112,0.000333,0.200015,18,10800.82484,600.045825,600.045825,178.818118,5,0
0,0,16,16,16,20,36,60,45,105,0.000333,0.180947,16,8685.474002,482.526333,542.842125,150.438562,4,0
0,0,12,12,13,14,27,42,32,74,0.000333,0.117287,12,4222.340102,234.57445,351.861675,101.408685,2,0
0,0,17,17,18,23,41,69,53,122,0.000333,0.217874,18,11765.1842,653.621345,653.621345,179.100575,5,0
0,0,18,18,18,23,41,62,53,115,0.000333,0.205373,18,11090.13265,616.118481,616.118481,179.100575,5,0
0,0,13,13,13,14,27,35,32,67,0.000333,0.106192,12,3822.929552,212.384975,318.577463,101.408685,2,0
0,0,11,11,12,13,25,34,28,62,0.000333,0.095973,12,3455.029005,191.946056,287.919084,91.125266,2,0
0,0,16,16,17,22,39,61,49,110,0.000333,0.193798,16,9302.307905,516.794884,581.394244,167.594364,5,0
0,0,13,13,12,14,26,39,36,75,0.000333,0.117511,12,4230.395746,235.021986,352.532979,96.322519,2,0
0,0,18,18,17,23,40,66,57,123,0.000333,0.218199,16,10473.55449,581.864138,654.597156,173.528793,5,0
0,0,15,15,12,15,27,44,44,88,0.000333,0.139477,12,5021.161202,278.9534,418.4301,101.622909,2,0
0,0,20,20,17,24,41,71,65,136,0.000333,0.242876,16,11658.03316,647.668509,728.627073,179.525968,5,0
0,0,15,15,12,15,27,44,44,88,0.000333,0.139477,12,5021.161202,278.9534,418.4301,101.622909,2,0
0,0,22,22,17,24,41,76,73,149,0.000333,0.266092,24,19158.60597,1064.366998,798.275249,179.525968,5,0
0,0,17,17,18,21,39,64,51,115,0.000333,0.202607,18,10940.78259,607.821255,607.821255,167.297316,5,0
0,0,12,12,13,12,25,37,30,67,0.000333,0.103713,12,3733.660377,207.425576,311.138365,91.125266,2,0
0,0,16,16,18,22,40,62,49,111,0.000333,0.196911,18,10633.21233,590.734019,590.734019,173.166146,5,0
0,0,11,11,13,13,26,35,28,63,0.000333,0.098709,12,3553.532427,197.418468,296.127702,96.211433,2,0
0,0,12,12,13,14,27,39,31,70,0.000333,0.110947,12,3994.105502,221.89475,332.842125,101.408685,2,0
0,0,17,17,18,23,41,66,52,118,0.000333,0.21073,18,11379.44046,632.191137,632.191137,179.100575,5,0
0,0,18,18,18,24,42,74,56,130,0.000333,0.233667,18,12618.02277,701.001265,701.001265,185.09775,5,0
0,0,13,13,13,15,28,47,35,82,0.000333,0.131401,12,4730.437243,262.802069,394.203104,106.709075,2,0
0,0,17,17,17,23,40,68,53,121,0.000333,0.214651,16,10303.25279,572.402933,643.953299,173.528793,5,0
0,0,12,12,12,14,26,41,32,73,0.000333,0.114377,12,4117.585193,228.754733,343.132099,96.322519,2,0
0,0,19,19,17,25,42,74,59,133,0.000333,0.239059,16,11474.85148,637.491749,717.178217,185.583273,5,0
0,0,14,14,12,16,28,47,38,85,0.000333,0.136208,12,4903.50202,272.416779,408.625168,107.01955,2,0
0,0,19,19,18,25,43,68,58,126,0.000333,0.227903,18,12306.76846,683.709359,683.709359,191.155055,5,0
0,0,14,14,13,16,29,41,37,78,0.000333,0.126308,12,4547.070211,252.615012,378.922518,112.105716,2,0
0,0,13,13,12,14,26,34,32,66,0.000333,0.10341,12,3722.748257,206.819348,310.229021,96.322519,2,0
0,0,18,18,17,23,40,61,53,114,0.000333,0.202233,16,9707.196845,539.288714,606.699803,173.528793,5,0
0,0,21,21,18,27,45,91,75,166,0.000333,0.303883,18,16409.65705,911.647614,911.647614,203.440613,5,0
0,0,16,16,14,19,33,64,54,118,0.000333,0.198413,14,8333.339085,462.963283,595.238506,134.013592,2,0
0,0,21,21,18,26,44,81,66,147,0.000333,0.267512,18,14445.65606,802.536448,802.536448,197.270083,5,0
0,0,16,16,14,17,31,54,45,99,0.000333,0.163488,14,6866.516086,381.473116,490.465435,122.789837,2,0
0,0,21,21,17,26,43,84,68,152,0.000333,0.274931,16,13196.67588,733.14866,824.792243,191.698301,5,0
0,0,16,16,13,18,31,57,47,104,0.000333,0.171745,12,6182.836995,343.490944,515.236416,123.164366,2,0
0,0,9,9,14,11,25,31,22,53,0.000333,0.082041,14,3445.741293,191.430072,246.124378,91.356717,3,0
0,0,9,9,12,10,22,29,20,49,0.000333,0.072837,12,2622.145792,145.674766,218.512149,76.238831,2,0
0,0,11,11,12,11,23,35,22,57,0.000333,0.085948,12,3094.116378,171.895354,257.843031,81.073298,4,0
0,0,11,11,14,12,26,37,24,61,0.000333,0.095576,14,4014.175519,223.009751,286.726823,96.322519,5,0
0,0,12,12,15,11,26,38,22,60,0.000333,0.094009,14,3948.369363,219.353854,282.026383,96.657107,4,0
0,0,12,12,17,12,29,40,24,64,0.000333,0.103637,16,4974.572539,276.365141,310.910784,112.506418,5,0
0,0,11,11,12,11,23,35,24,59,0.000333,0.088963,12,3202.681865,177.92677,266.890155,81.073298,4,0
0,0,11,11,14,12,26,37,26,63,0.000333,0.098709,14,4145.787831,230.321546,296.127702,96.322519,5,0
0,0,12,12,16,11,27,39,24,63,0.000333,0.099853,16,4792.926602,266.2737,299.557913,102.053748,4,0
0,0,12,12,18,12,30,41,26,67,0.000333,0.109587,18,5917.710058,328.76167,328.76167,118.0782,5,0
0,0,12,12,15,12,27,38,22,60,0.000333,0.095098,7,1997.052751,110.947375,285.29325,101.622909,4,0
0,0,12,12,17,13,30,40,24,64,0.000333,0.10468,8,2512.327985,139.573777,314.040998,117.592585,5,0
0,0,11,11,12,11,23,35,22,57,0.000333,0.085948,12,3094.116378,171.895354,257.843031,81.073298,4,0
0,0,11,11,14,12,26,37,24,61,0.000333,0.095576,14,4014.175519,223.009751,286.726823,96.322519,5,0
0,0,12,12,15,12,27,38,22,60,0.000333,0.095098,7,1997.052751,110.947375,285.29325,101.622909,4,0
0,0,12,12,17,13,30,40,24,64,0.000333,0.10468,8,2512.327985,139.573777,314.040998,117.592585,5,0
0,0,11,11,12,11,23,35,22,57,0.000333,0.085948,12,3094.116378,171.895354,257.843031,81.073298,4,0
0,0,11,11,14,12,26,37,24,61,0.000333,0.095576,14,4014.175519,223.009751,286.726823,96.322519,5,0
0,0,12,12,18,13,31,41,26,67,0.000333,0.110644,18,5974.76075,331.931153,331.931153,123.164366,5,0
0,0,11,11,14,13,27,37,26,63,0.000333,0.099853,14,4193.810777,232.989488,299.557913,101.408685,5,0
0,0,12,12,16,12,28,39,24,63,0.000333,0.100954,16,4845.813761,269.211876,302.86336,107.01955,4,0
0,0,11,11,12,12,24,35,24,59,0.000333,0.090171,12,3246.153451,180.341858,270.512788,86.0391,4,0
0,0,12,12,18,13,31,41,26,67,0.000333,0.110644,18,5974.76075,331.931153,331.931153,123.164366,5,0
0,0,11,11,14,13,27,37,26,63,0.000333,0.099853,14,4193.810777,232.989488,299.557913,101.408685,5,0
0,0,12,12,16,12,28,39,24,63,0.000333,0.100954,16,4845.813761,269.211876,302.86336,107.01955,4,0
0,0,11,11,12,12,24,35,24,59,0.000333,0.090171,12,3246.153451,180.341858,270.512788,86.0391,4,0
0,0,12,12,17,13,30,40,24,64,0.000333,0.10468,8,2512.327985,139.573777,314.040998,117.592585,5,0
0,0,11,11,14,12,26,37,24,61,0.000333,0.095576,14,4014.175519,223.009751,286.726823,96.322519,5,0
0,0,12,12,15,12,27,38,22,60,0.000333,0.095098,7,1997.052751,110.947375,285.29325,101.622909,4,0
0,0,11,11,12,11,23,35,22,57,0.000333,0.085948,12,3094.116378,171.895354,257.843031,81.073298,4,0
0,0,11,11,12,11,23,35,22,57,0.000333,0.085948,12,3094.116378,171.895354,257.843031,81.073298,4,0
0,0,11,11,14,12,26,37,24,61,0.000333,0.095576,14,4014.175519,223.009751,286.726823,96.322519,5,0
0,0,12,12,15,12,27,38,22,60,0.000333,0.095098,7,1997.052751,110.947375,285.29325,101.622909,4,0
0,0,12,12,17,13,30,40,24,64,0.000333,0.10468,8,2512.327985,139.573777,314.040998,117.592585,5,0
0,0,11,11,12,11,23,35,22,57,0.000333,0.085948,12,3094.116378,171.895354,257.843031,81.073298,4,0
0,0,11,11,14,12,26,37,24,61,0.000333,0.095576,14,4014.175519,223.009751,286.726823,96.322519,5,0
0,0,12,12,15,12,27,38,22,60,0.000333,0.095098,7,1997.052751,110.947375,285.29325,101.622909,4,0
0,0,12,12,17,13,30,40,24,64,0.000333,0.10468,8,2512.327985,139.573777,314.040998,117.592585,5,0
0,0,11,11,12,11,23,35,22,57,0.000333,0.085948,12,3094.116378,171.895354,257.843031,81.073298,4,0
0,0,12,12,17,13,30,40,24,64,0.000333,0.10468,8,2512.327985,139.573777,314.040998,117.592585,5,0
0,0,11,11,14,12,26,37,24,61,0.000333,0.095576,14,4014.175519,223.009751,286.726823,96.322519,5,0
0,0,12,12,15,12,27,38,22,60,0.000333,0.095098,7,1997.052751,110.947375,285.29325,101.622909,4,0
0,0,11,11,12,12,24,35,24,59,0.000333,0.090171,12,3246.153451,180.341858,270.512788,86.0391,4,0
0,0,12,12,18,13,31,41,26,67,0.000333,0.110644,18,5974.76075,331.931153,331.931153,123.164366,5,0
0,0,11,11,14,13,27,37,26,63,0.000333,0.099853,14,4193.810777,232.989488,299.557913,101.408685,5,0
0,0,12,12,16,12,28,39,24,63,0.000333,0.100954,16,4845.813761,269.211876,302.86336,107.01955,4,0
0,0,11,11,12,12,24,35,24,59,0.000333,0.090171,12,3246.153451,180.341858,270.512788,86.0391,4,0
0,0,12,12,18,13,31,41,26,67,0.000333,0.110644,18,5974.76075,331.931153,331.931153,123.164366,5,0
0,0,11,11,14,13,27,37,26,63,0.000333,0.099853,14,4193.810777,232.989488,299.557913,101.408685,5,0
0,0,12,12,16,12,28,39,24,63,0.000333,0.100954,16,4845.813761,269.211876,302.86336,107.01955,4,0
0,0,16,16,19,13,32,47,26,73,0.000333,0.121667,18,6570,365,365,128.816339,5,0
0,0,16,16,17,12,29,45,24,69,0.000333,0.111734,16,5363.211019,297.956168,335.200689,112.506418,4,0
0,0,16,16,17,13,30,45,24,69,0.000333,0.112858,8,2708.603609,150.477978,338.575451,117.592585,4,0
0,0,18,18,19,14,33,51,26,77,0.000333,0.129473,9,3495.765125,194.209174,388.418347,134.013592,5,0
0,0,13,13,16,12,28,41,24,65,0.000333,0.104159,16,4999.649119,277.758284,312.47807,107.01955,5,0
0,0,13,13,14,11,25,39,22,61,0.000333,0.094425,14,3965.853186,220.325177,283.275228,91.356717,4,0
0,0,11,11,16,14,30,47,32,79,0.000333,0.129215,16,6202.309713,344.572762,387.644357,117.302969,5,0
0,0,11,11,15,13,28,45,30,75,0.000333,0.120184,14,5047.722668,280.429037,360.551619,106.709075,4,0
0,0,13,13,14,12,26,35,24,59,0.000333,0.092442,14,3882.563207,215.697956,277.325943,96.322519,2,0
0,0,13,13,16,13,29,37,26,63,0.000333,0.102018,16,4896.844843,272.046936,306.052803,112.105716,3,0
0,0,14,14,18,16,34,45,39,84,0.000333,0.142449,18,7692.243816,427.346879,427.346879,139.05865,4,0
0,0,13,13,13,15,28,40,33,73,0.000333,0.116979,12,4211.242912,233.95794,350.936909,106.709075,3,0
0,0,13,13,15,17,32,42,39,81,0.000333,0.135,14,5670,315,405,128.090227,4,0
0,0,11,11,17,17,34,60,34,94,0.000333,0.159407,16,7651.544113,425.085784,478.221507,138.973737,3,0
0,0,11,11,17,17,34,60,34,94,0.000333,0.159407,16,7651.544113,425.085784,478.221507,138.973737,3,0
0,0,11,11,17,17,34,60,34,94,0.000333,0.159407,16,7651.544113,425.085784,478.221507,138.973737,3,0
0,0,11,11,17,17,34,60,34,94,0.000333,0.159407,16,7651.544113,425.085784,478.221507,138.973737,3,0
0,0,11,11,17,17,34,60,34,94,0.000333,0.159407,16,7651.544113,425.085784,478.221507,138.973737,3,0
0,0,11,11,17,17,34,60,34,94,0.000333,0.159407,16,7651.544113,425.085784,478.221507,138.973737,3,0
0,0,11,11,17,17,34,60,34,94,0.000333,0.159407,16,7651.544113,425.085784,478.221507,138.973737,3,0
0,0,11,11,17,17,34,60,34,94,0.000333,0.159407,16,7651.544113,425.085784,478.221507,138.973737,3,0
0,0,11,11,17,17,34,60,34,94,0.000333,0.159407,16,7651.544113,425.085784,478.221507,138.973737,3,0
0,0,11,11,17,17,34,60,34,94,0.000333,0.159407,16,7651.544113,425.085784,478.221507,138.973737,3,0
0,0,11,11,17,17,34,60,34,94,0.000333,0.159407,16,7651.544113,425.085784,478.221507,138.973737,3,0
0,0,11,11,17,17,34,60,34,94,0.000333,0.159407,16,7651.544113,425.085784,478.221507,138.973737,3,0
0,0,11,11,17,17,34,60,34,94,0.000333,0.159407,16,7651.544113,425.085784,478.221507,138.973737,3,0
0,0,11,11,17,17,34,60,34,94,0.000333,0.159407,16,7651.544113,425.085784,478.221507,138.973737,3,0
0,0,11,11,17,17,34,60,34,94,0.000333,0.159407,16,7651.544113,425.085784,478.221507,138.973737,3,0
0,0,11,11,17,17,34,60,34,94,0.000333,0.159407,16,7651.544113,425.085784,478.221507,138.973737,3,0
0,0,11,11,17,17,34,60,34,94,0.000333,0.159407,16,7651.544113,425.085784,478.221507,138.973737,3,0
0,0,11,11,17,17,34,60,34,94,0.000333,0.159407,16,7651.544113,425.085784,478.221507,138.973737,3,0
0,0,13,13,18,21,39,67,44,111,0.000333,0.19556,18,10560.23363,586.679646,586.679646,167.297316,3,0
0,0,13,13,18,21,39,67,44,111,0.000333,0.19556,18,10560.23363,586.679646,586.679646,167.297316,3,0
0,0,13,13,17,23,40,65,47,112,0.000333,0.198685,16,9536.895146,529.827508,596.055947,173.528793,3,0
0,0,9,9,14,19,33,43,31,74,0.000333,0.124428,7,2612.996154,145.166453,373.285165,134.013592,3,0
0,0,13,13,17,18,35,66,40,106,0.000333,0.181235,16,8699.263997,483.292444,543.704,144.545518,3,0
0,0,7,7,14,12,26,33,21,54,0.000333,0.084608,7,1776.766213,98.709234,253.823745,96.322519,3,0
0,0,7,7,14,16,30,29,23,52,0.000333,0.085053,7,1786.108177,99.228232,255.158311,117.302969,3,0
0,0,13,13,18,20,38,67,42,109,0.000333,0.190675,18,10296.43378,572.024099,572.024099,161.497212,3,0
0,0,13,13,18,19,37,66,39,105,0.000333,0.182331,18,9845.866861,546.992603,546.992603,155.769273,3,0
0,0,6,6,14,14,28,28,20,48,0.000333,0.076918,7,1615.271254,89.737292,230.753036,106.605938,3,0
0,0,14,14,17,23,40,66,47,113,0.000333,0.200459,16,9622.045996,534.558111,601.377875,173.528793,3,0
0,0,13,13,17,22,39,66,46,112,0.000333,0.197322,16,9471.440776,526.191154,591.965049,167.594364,3,0
0,0,8,8,13,17,30,33,34,67,0.000333,0.109587,12,3945.140039,219.174447,328.76167,117.592585,3,0
0,0,8,8,13,17,30,33,34,67,0.000333,0.109587,12,3945.140039,219.174447,328.76167,117.592585,3,0
0,0,8,8,13,17,30,33,34,67,0.000333,0.109587,12,3945.140039,219.174447,328.76167,117.592585,3,0
0,0,13,13,18,21,39,66,41,107,0.000333,0.188513,9,5089.842337,282.769019,565.538037,167.297316,3,0
0,0,14,14,18,23,41,72,49,121,0.000333,0.216088,18,11668.74827,648.263793,648.263793,179.100575,3,0
0,0,15,15,18,24,42,81,53,134,0.000333,0.240857,18,13006.26962,722.570535,722.570535,185.09775,3,0
0,0,6,6,13,16,29,27,22,49,0.000333,0.079347,6,1428.246413,79.347023,238.041069,112.105716,3,0
0,0,15,15,17,24,41,77,53,130,0.000333,0.232161,16,11143.70817,619.094898,696.481761,179.525968,3,0
0,0,16,16,18,25,43,73,59,132,0.000333,0.238756,18,12892.80506,716.266948,716.266948,191.155055,3,0
0,0,14,14,17,22,39,66,47,113,0.000333,0.199083,16,9556.007212,530.88929,597.250451,167.594364,3,0
0,0,6,6,15,17,32,29,23,52,0.000333,0.086667,7,1820,101.111111,260,128.090227,3,0
0,0,6,6,14,17,31,28,23,51,0.000333,0.084221,7,1768.648083,98.258227,252.664012,122.789837,3,0
0,0,3,3,8,8,16,10,12,22,0.000333,0.029333,4,352,19.555556,88,48,1,0
0,0,3,3,8,7,15,10,11,21,0.000333,0.027348,4,328.17881,18.232156,82.044703,43.651484,1,0
0,0,3,3,8,8,16,10,12,22,0.000333,0.029333,4,352,19.555556,88,48,1,0
0,0,3,3,8,7,15,10,11,21,0.000333,0.027348,4,328.17881,18.232156,82.044703,43.651484,1,0
0,0,2,2,7,7,14,8,13,21,0.000333,0.026651,3,239.86336,13.325742,79.954453,39.302969,1,0
0,0,2,2,7,5,12,8,9,17,0.000333,0.020315,3,182.833088,10.157394,60.944363,31.261125,1,0
0,0,2,2,7,7,14,8,13,21,0.000333,0.026651,3,239.86336,13.325742,79.954453,39.302969,1,0
0,0,2,2,7,5,12,8,9,17,0.000333,0.020315,3,182.833088,10.157394,60.944363,31.261125,1,0
0,0,13,13,18,20,38,72,44,116,0.000333,0.20292,18,10957.67265,608.759592,608.759592,161.497212,4,0
0,0,13,13,18,20,38,72,44,116,0.000333,0.20292,18,10957.67265,608.759592,608.759592,161.497212,4,0
0,0,13,13,18,20,38,72,44,116,0.000333,0.20292,18,10957.67265,608.759592,608.759592,161.497212,4,0
0,0,13,13,18,20,38,72,44,116,0.000333,0.20292,18,10957.67265,608.759592,608.759592,161.497212,4,0
0,0,13,13,18,20,38,72,44,116,0.000333,0.20292,18,10957.67265,608.759592,608.759592,161.497212,4,0
0,0,13,13,18,20,38,72,44,116,0.000333,0.20292,18,10957.67265,608.759592,608.759592,161.497212,4,0
0,0,13,13,18,20,38,72,44,116,0.000333,0.20292,18,10957.67265,608.759592,608.759592,161.497212,4,0
0,0,13,13,18,20,38,72,44,116,0.000333,0.20292,18,10957.67265,608.759592,608.759592,161.497212,4,0
0,0,13,13,18,20,38,72,44,116,0.000333,0.20292,18,10957.67265,608.759592,608.759592,161.497212,4,0
0,0,13,13,18,20,38,72,44,116,0.000333,0.20292,18,10957.67265,608.759592,608.759592,161.497212,4,0
0,0,13,13,18,20,38,72,44,116,0.000333,0.20292,18,10957.67265,608.759592,608.759592,161.497212,4,0
0,0,13,13,18,20,38,72,44,116,0.000333,0.20292,18,10957.67265,608.759592,608.759592,161.497212,4,0
0,0,13,13,18,20,38,72,44,116,0.000333,0.20292,18,10957.67265,608.759592,608.759592,161.497212,4,0
0,0,13,13,18,20,38,72,44,116,0.000333,0.20292,18,10957.67265,608.759592,608.759592,161.497212,4,0
0,0,13,13,18,20,38,72,44,116,0.000333,0.20292,18,10957.67265,608.759592,608.759592,161.497212,4,0
0,0,13,13,18,20,38,72,44,116,0.000333,0.20292,18,10957.67265,608.759592,608.759592,161.497212,4,0
0,0,13,13,18,20,38,72,44,116,0.000333,0.20292,18,10957.67265,608.759592,608.759592,161.497212,4,0
0,0,13,13,18,20,38,72,44,116,0.000333,0.20292,18,10957.67265,608.759592,608.759592,161.497212,4,0
0,0,13,13,18,20,38,72,44,116,0.000333,0.20292,18,10957.67265,608.759592,608.759592,161.497212,4,0
0,0,13,13,18,20,38,72,44,116,0.000333,0.20292,18,10957.67265,608.759592,608.759592,161.497212,4,0
0,0,13,13,18,20,38,72,44,116,0.000333,0.20292,18,10957.67265,608.759592,608.759592,161.497212,4,0
0,0,13,13,18,20,38,72,44,116,0.000333,0.20292,18,10957.67265,608.759592,608.759592,161.497212,4,0
0,0,13,13,18,20,38,72,44,116,0.000333,0.20292,18,10957.67265,608.759592,608.759592,161.497212,4,0
0,0,13,13,18,20,38,72,44,116,0.000333,0.20292,18,10957.67265,608.759592,608.759592,161.497212,4,0
0,0,13,13,18,20,38,72,44,116,0.000333,0.20292,18,10957.67265,608.759592,608.759592,161.497212,4,0
0,0,13,13,18,20,38,72,44,116,0.000333,0.20292,18,10957.67265,608.759592,608.759592,161.497212,4,0
0,0,13,13,18,20,38,72,44,116,0.000333,0.20292,18,10957.67265,608.759592,608.759592,161.497212,4,0
0,0,13,13,18,20,38,72,44,116,0.000333,0.20292,18,10957.67265,608.759592,608.759592,161.497212,4,0
0,0,13,13,18,20,38,72,44,116,0.000333,0.20292,18,10957.67265,608.759592,608.759592,161.497212,4,0
0,0,13,13,18,20,38,72,44,116,0.000333,0.20292,18,10957.67265,608.759592,608.759592,161.497212,4,0
0,0,13,13,18,20,38,72,44,116,0.000333,0.20292,18,10957.67265,608.759592,608.759592,161.497212,4,0
0,0,13,13,18,20,38,72,44,116,0.000333,0.20292,18,10957.67265,608.759592,608.759592,161.497212,4,0
0,0,13,13,18,20,38,72,44,116,0.000333,0.20292,18,10957.67265,608.759592,608.759592,161.497212,4,0
0,0,15,15,19,24,43,79,54,133,0.000333,0.240564,18,12990.47782,721.693212,721.693212,190.749723,4,0
0,0,15,15,19,24,43,79,54,133,0.000333,0.240564,18,12990.47782,721.693212,721.693212,190.749723,4,0
0,0,15,15,18,26,44,78,58,136,0.000333,0.247494,18,13364.6886,742.4827,742.4827,197.270083,4,0
0,0,6,6,13,17,30,27,23,50,0.000333,0.081782,6,1472.067179,81.78151,245.34453,117.592585,3,0
0,0,15,15,18,21,39,78,50,128,0.000333,0.22551,18,12177.56671,676.531484,676.531484,167.297316,4,0
0,0,7,7,14,12,26,33,21,54,0.000333,0.084608,7,1776.766213,98.709234,253.823745,96.322519,3,0
0,0,7,7,14,16,30,29,23,52,0.000333,0.085053,7,1786.108177,99.228232,255.158311,117.302969,3,0
0,0,15,15,19,23,42,79,52,131,0.000333,0.235465,18,12715.08448,706.393582,706.393582,184.752548,4,0
1,0,24,25,20,22,42,117,78,195,0.000333,0.350501,30,31545.05692,1752.503162,1051.501897,184.546058,6,0
0,0,6,6,14,14,28,28,20,48,0.000333,0.076918,7,1615.271254,89.737292,230.753036,106.605938,3,0
0,0,16,16,18,26,44,78,57,135,0.000333,0.245674,18,13266.41883,737.023269,737.023269,197.270083,4,0
0,0,15,15,18,25,43,78,56,134,0.000333,0.242373,18,13088.15059,727.119477,727.119477,191.155055,4,0
0,0,8,8,13,17,30,33,34,67,0.000333,0.109587,12,3945.140039,219.174447,328.76167,117.592585,3,0
0,0,8,8,13,17,30,33,34,67,0.000333,0.109587,12,3945.140039,219.174447,328.76167,117.592585,3,0
0,0,8,8,13,17,30,33,34,67,0.000333,0.109587,12,3945.140039,219.174447,328.76167,117.592585,3,0
1,0,25,26,19,24,43,120,90,210,0.000333,0.379839,27,30766.92116,1709.273398,1139.515598,190.749723,6,0
0,0,16,16,19,26,45,84,59,143,0.000333,0.261778,18,14136.02987,785.334993,785.334993,202.922055,4,0
0,0,17,17,19,27,46,93,63,156,0.000333,0.287225,18,15510.16197,861.675665,861.675665,209.092585,4,0
0,0,6,6,13,16,29,27,22,49,0.000333,0.079347,6,1428.246413,79.347023,238.041069,112.105716,3,0
0,0,17,17,18,27,45,89,63,152,0.000333,0.278254,18,15025.71007,834.761671,834.761671,203.440613,4,0
0,0,18,18,19,28,47,85,69,154,0.000333,0.285136,18,15397.3203,855.406683,855.406683,215.316561,4,0
0,0,16,16,18,25,43,78,57,135,0.000333,0.244182,18,13185.82335,732.545742,732.545742,191.155055,4,0
0,0,6,6,15,17,32,29,23,52,0.000333,0.086667,7,1820,101.111111,260,128.090227,3,0
0,0,6,6,14,17,31,28,23,51,0.000333,0.084221,7,1768.648083,98.258227,252.664012,122.789837,3,0
0,0,3,3,8,8,16,10,12,22,0.000333,0.029333,4,352,19.555556,88,48,1,0
0,0,3,3,8,7,15,10,11,21,0.000333,0.027348,4,328.17881,18.232156,82.044703,43.651484,1,0
0,0,3,3,8,7,15,10,11,21,0.000333,0.027348,4,328.17881,18.232156,82.044703,43.651484,1,0
0,0,3,3,8,8,16,10,12,22,0.000333,0.029333,4,352,19.555556,88,48,1,0
0,0,2,2,7,5,12,8,9,17,0.000333,0.020315,3,182.833088,10.157394,60.944363,31.261125,1,0
0,0,2,2,7,7,14,8,13,21,0.000333,0.026651,3,239.86336,13.325742,79.954453,39.302969,1,0
0,0,2,2,7,7,14,8,13,21,0.000333,0.026651,3,239.86336,13.325742,79.954453,39.302969,1,0
0,0,2,2,7,5,12,8,9,17,0.000333,0.020315,3,182.833088,10.157394,60.944363,31.261125,1,0
0,0,10,10,17,18,35,53,35,88,0.000333,0.150459,8,3611.015244,200.611958,451.376905,144.545518,3,0
0,0,10,10,17,18,35,53,35,88,0.000333,0.150459,8,3611.015244,200.611958,451.376905,144.545518,3,0
0,0,10,10,17,18,35,53,35,88,0.000333,0.150459,8,3611.015244,200.611958,451.376905,144.545518,3,0
0,0,10,10,17,18,35,53,35,88,0.000333,0.150459,8,3611.015244,200.611958,451.376905,144.545518,3,0
0,0,10,10,17,18,35,53,35,88,0.000333,0.150459,8,3611.015244,200.611958,451.376905,144.545518,3,0
0,0,10,10,17,18,35,53,35,88,0.000333,0.150459,8,3611.015244,200.611958,451.376905,144.545518,3,0
0,0,10,10,17,18,35,53,35,88,0.000333,0.150459,8,3611.015244,200.611958,451.376905,144.545518,3,0
0,0,10,10,17,18,35,53,35,88,0.000333,0.150459,8,3611.015244,200.611958,451.376905,144.545518,3,0
0,0,10,10,17,18,35,53,35,88,0.000333,0.150459,8,3611.015244,200.611958,451.376905,144.545518,3,0
0,0,10,10,17,18,35,53,35,88,0.000333,0.150459,8,3611.015244,200.611958,451.376905,144.545518,3,0
0,0,10,10,17,18,35,53,35,88,0.000333,0.150459,8,3611.015244,200.611958,451.376905,144.545518,3,0
0,0,10,10,17,18,35,53,35,88,0.000333,0.150459,8,3611.015244,200.611958,451.376905,144.545518,3,0
0,0,10,10,17,18,35,53,35,88,0.000333,0.150459,8,3611.015244,200.611958,451.376905,144.545518,3,0
0,0,10,10,17,18,35,53,35,88,0.000333,0.150459,8,3611.015244,200.611958,451.376905,144.545518,3,0
0,0,10,10,17,18,35,53,35,88,0.000333,0.150459,8,3611.015244,200.611958,451.376905,144.545518,3,0
0,0,10,10,17,18,35,53,35,88,0.000333,0.150459,8,3611.015244,200.611958,451.376905,144.545518,3,0
0,0,10,10,17,18,35,53,35,88,0.000333,0.150459,8,3611.015244,200.611958,451.376905,144.545518,3,0
0,0,10,10,17,18,35,53,35,88,0.000333,0.150459,8,3611.015244,200.611958,451.376905,144.545518,3,0
0,0,10,10,17,18,35,53,35,88,0.000333,0.150459,8,3611.015244,200.611958,451.376905,144.545518,3,0
0,0,10,10,17,18,35,53,35,88,0.000333,0.150459,8,3611.015244,200.611958,451.376905,144.545518,3,0
0,0,10,10,17,18,35,53,35,88,0.000333,0.150459,8,3611.015244,200.611958,451.376905,144.545518,3,0
0,0,10,10,17,18,35,53,35,88,0.000333,0.150459,8,3611.015244,200.611958,451.376905,144.545518,3,0
0,0,10,10,17,18,35,53,35,88,0.000333,0.150459,8,3611.015244,200.611958,451.376905,144.545518,3,0
0,0,10,10,17,18,35,53,35,88,0.000333,0.150459,8,3611.015244,200.611958,451.376905,144.545518,3,0
0,0,10,10,17,18,35,53,35,88,0.000333,0.150459,8,3611.015244,200.611958,451.376905,144.545518,3,0
0,0,10,10,17,18,35,53,35,88,0.000333,0.150459,8,3611.015244,200.611958,451.376905,144.545518,3,0
0,0,10,10,17,18,35,53,35,88,0.000333,0.150459,8,3611.015244,200.611958,451.376905,144.545518,3,0
0,0,10,10,17,18,35,53,35,88,0.000333,0.150459,8,3611.015244,200.611958,451.376905,144.545518,3,0
0,0,10,10,17,18,35,53,35,88,0.000333,0.150459,8,3611.015244,200.611958,451.376905,144.545518,3,0
0,0,10,10,17,18,35,53,35,88,0.000333,0.150459,8,3611.015244,200.611958,451.376905,144.545518,3,0
0,0,10,10,17,18,35,53,35,88,0.000333,0.150459,8,3611.015244,200.611958,451.376905,144.545518,3,0
0,0,10,10,17,18,35,53,35,88,0.000333,0.150459,8,3611.015244,200.611958,451.376905,144.545518,3,0
0,0,10,10,17,18,35,53,35,88,0.000333,0.150459,8,3611.015244,200.611958,451.376905,144.545518,3,0
0,0,12,12,18,22,40,60,45,105,0.000333,0.186267,18,10058.4441,558.80245,558.80245,173.166146,3,0
0,0,12,12,18,22,40,60,45,105,0.000333,0.186267,18,10058.4441,558.80245,558.80245,173.166146,3,0
0,0,12,12,17,24,41,59,49,108,0.000333,0.192872,16,9257.849864,514.324992,578.615616,179.525968,3,0
0,0,6,6,13,17,30,27,23,50,0.000333,0.081782,6,1472.067179,81.78151,245.34453,117.592585,3,0
0,0,12,12,17,19,36,59,41,100,0.000333,0.172331,16,8271.880002,459.548889,516.9925,150.197491,3,0
0,0,7,7,14,12,26,33,21,54,0.000333,0.084608,7,1776.766213,98.709234,253.823745,96.322519,3,0
0,0,7,7,14,16,30,29,23,52,0.000333,0.085053,7,1786.108177,99.228232,255.158311,117.302969,3,0
0,0,12,12,18,21,39,60,43,103,0.000333,0.181465,18,9799.135714,544.396429,544.396429,167.297316,3,0
0,0,9,9,14,15,29,45,28,73,0.000333,0.118211,7,2482.428289,137.912683,354.632613,111.906328,3,0
0,0,6,6,14,14,28,28,20,48,0.000333,0.076918,7,1615.271254,89.737292,230.753036,106.605938,3,0
0,0,13,13,17,24,41,59,48,107,0.000333,0.191086,16,9172.129032,509.562724,573.258064,179.525968,3,0
0,0,12,12,17,23,40,59,47,106,0.000333,0.188041,16,9025.990049,501.443892,564.124378,173.528793,3,0
0,0,8,8,13,17,30,33,34,67,0.000333,0.109587,12,3945.140039,219.174447,328.76167,117.592585,3,0
0,0,8,8,13,17,30,33,34,67,0.000333,0.109587,12,3945.140039,219.174447,328.76167,117.592585,3,0
0,0,8,8,13,17,30,33,34,67,0.000333,0.109587,12,3945.140039,219.174447,328.76167,117.592585,3,0
0,0,13,13,18,24,42,65,50,115,0.000333,0.206706,18,11162.09707,620.116504,620.116504,185.09775,3,0
0,0,14,14,18,25,43,74,54,128,0.000333,0.231521,18,12502.114,694.561889,694.561889,191.155055,3,0
0,0,6,6,13,16,29,27,22,49,0.000333,0.079347,6,1428.246413,79.347023,238.041069,112.105716,3,0
0,0,14,14,17,25,42,70,54,124,0.000333,0.222882,16,10698.35777,594.353209,668.64736,185.583273,3,0
0,0,15,15,18,26,44,66,60,126,0.000333,0.229296,18,12381.99091,687.888384,687.888384,197.270083,3,0
0,0,13,13,17,23,40,59,48,107,0.000333,0.189815,16,9111.140898,506.174494,569.446306,173.528793,3,0
0,0,6,6,15,17,32,29,23,52,0.000333,0.086667,7,1820,101.111111,260,128.090227,3,0
0,0,6,6,14,17,31,28,23,51,0.000333,0.084221,7,1768.648083,98.258227,252.664012,122.789837,3,0
0,0,3,3,8,7,15,10,11,21,0.000333,0.027348,4,328.17881,18.232156,82.044703,43.651484,1,0
0,0,3,3,8,8,16,10,12,22,0.000333,0.029333,4,352,19.555556,88,48,1,0
0,0,3,3,8,8,16,10,12,22,0.000333,0.029333,4,352,19.555556,88,48,1,0
0,0,3,3,8,7,15,10,11,21,0.000333,0.027348,4,328.17881,18.232156,82.044703,43.651484,1,0
0,0,2,2,7,7,14,8,13,21,0.000333,0.026651,3,239.86336,13.325742,79.954453,39.302969,1,0
0,0,2,2,7,5,12,8,9,17,0.000333,0.020315,3,182.833088,10.157394,60.944363,31.261125,1,0
0,0,2,2,7,7,14,8,13,21,0.000333,0.026651,3,239.86336,13.325742,79.954453,39.302969,1,0
0,0,2,2,7,5,12,8,9,17,0.000333,0.020315,3,182.833088,10.157394,60.944363,31.261125,1,0
0,0,11,11,17,19,36,62,38,100,0.000333,0.172331,16,8271.880002,459.548889,516.9925,150.197491,4,0
0,0,11,11,17,19,36,62,38,100,0.000333,0.172331,16,8271.880002,459.548889,516.9925,150.197491,4,0
0,0,11,11,17,19,36,62,38,100,0.000333,0.172331,16,8271.880002,459.548889,516.9925,150.197491,4,0
0,0,11,11,17,19,36,62,38,100,0.000333,0.172331,16,8271.880002,459.548889,516.9925,150.197491,4,0
0,0,11,11,17,19,36,62,38,100,0.000333,0.172331,16,8271.880002,459.548889,516.9925,150.197491,4,0
0,0,11,11,17,19,36,62,38,100,0.000333,0.172331,16,8271.880002,459.548889,516.9925,150.197491,4,0
0,0,11,11,17,19,36,62,38,100,0.000333,0.172331,16,8271.880002,459.548889,516.9925,150.197491,4,0
0,0,11,11,17,19,36,62,38,100,0.000333,0.172331,16,8271.880002,459.548889,516.9925,150.197491,4,0
0,0,11,11,17,19,36,62,38,100,0.000333,0.172331,16,8271.880002,459.548889,516.9925,150.197491,4,0
0,0,11,11,17,19,36,62,38,100,0.000333,0.172331,16,8271.880002,459.548889,516.9925,150.197491,4,0
0,0,11,11,17,19,36,62,38,100,0.000333,0.172331,16,8271.880002,459.548889,516.9925,150.197491,4,0
0,0,11,11,17,19,36,62,38,100,0.000333,0.172331,16,8271.880002,459.548889,516.9925,150.197491,4,0
0,0,11,11,17,19,36,62,38,100,0.000333,0.172331,16,8271.880002,459.548889,516.9925,150.197491,4,0
0,0,11,11,17,19,36,62,38,100,0.000333,0.172331,16,8271.880002,459.548889,516.9925,150.197491,4,0
0,0,11,11,17,19,36,62,38,100,0.000333,0.172331,16,8271.880002,459.548889,516.9925,150.197491,4,0
0,0,11,11,17,19,36,62,38,100,0.000333,0.172331,16,8271.880002,459.548889,516.9925,150.197491,4,0
0,0,11,11,17,19,36,62,38,100,0.000333,0.172331,16,8271.880002,459.548889,516.9925,150.197491,4,0
0,0,11,11,17,19,36,62,38,100,0.000333,0.172331,16,8271.880002,459.548889,516.9925,150.197491,4,0
0,0,11,11,17,19,36,62,38,100,0.000333,0.172331,16,8271.880002,459.548889,516.9925,150.197491,4,0
0,0,11,11,17,19,36,62,38,100,0.000333,0.172331,16,8271.880002,459.548889,516.9925,150.197491,4,0
0,0,11,11,17,19,36,62,38,100,0.000333,0.172331,16,8271.880002,459.548889,516.9925,150.197491,4,0
0,0,11,11,17,19,36,62,38,100,0.000333,0.172331,16,8271.880002,459.548889,516.9925,150.197491,4,0
0,0,11,11,17,19,36,62,38,100,0.000333,0.172331,16,8271.880002,459.548889,516.9925,150.197491,4,0
0,0,11,11,17,19,36,62,38,100,0.000333,0.172331,16,8271.880002,459.548889,516.9925,150.197491,4,0
0,0,11,11,17,19,36,62,38,100,0.000333,0.172331,16,8271.880002,459.548889,516.9925,150.197491,4,0
0,0,11,11,17,19,36,62,38,100,0.000333,0.172331,16,8271.880002,459.548889,516.9925,150.197491,4,0
0,0,11,11,17,19,36,62,38,100,0.000333,0.172331,16,8271.880002,459.548889,516.9925,150.197491,4,0
0,0,11,11,17,19,36,62,38,100,0.000333,0.172331,16,8271.880002,459.548889,516.9925,150.197491,4,0
0,0,11,11,17,19,36,62,38,100,0.000333,0.172331,16,8271.880002,459.548889,516.9925,150.197491,4,0
0,0,11,11,17,19,36,62,38,100,0.000333,0.172331,16,8271.880002,459.548889,516.9925,150.197491,4,0
0,0,11,11,17,19,36,62,38,100,0.000333,0.172331,16,8271.880002,459.548889,516.9925,150.197491,4,0
0,0,11,11,17,19,36,62,38,100,0.000333,0.172331,16,8271.880002,459.548889,516.9925,150.197491,4,0
0,0,11,11,17,19,36,62,38,100,0.000333,0.172331,16,8271.880002,459.548889,516.9925,150.197491,4,0
0,0,13,13,18,23,41,69,48,117,0.000333,0.208945,18,11283.00452,626.833585,626.833585,179.100575,4,0
0,0,13,13,18,23,41,69,48,117,0.000333,0.208945,18,11283.00452,626.833585,626.833585,179.100575,4,0
0,0,13,13,17,25,42,68,52,120,0.000333,0.215693,16,10353.24945,575.180525,647.078091,185.583273,4,0
0,0,6,6,13,17,30,27,23,50,0.000333,0.081782,6,1472.067179,81.78151,245.34453,117.592585,3,0
0,0,13,13,17,20,37,68,44,112,0.000333,0.194486,16,9335.340431,518.630024,583.458777,155.92543,4,0
0,0,7,7,14,12,26,33,21,54,0.000333,0.084608,7,1776.766213,98.709234,253.823745,96.322519,3,0
0,0,7,7,14,16,30,29,23,52,0.000333,0.085053,7,1786.108177,99.228232,255.158311,117.302969,3,0
0,0,13,13,18,22,40,69,46,115,0.000333,0.204007,18,11016.39116,612.021731,612.021731,173.166146,4,0
0,0,9,9,14,15,29,45,28,73,0.000333,0.118211,7,2482.428289,137.912683,354.632613,111.906328,3,0
0,0,6,6,14,14,28,28,20,48,0.000333,0.076918,7,1615.271254,89.737292,230.753036,106.605938,3,0
0,0,14,14,17,25,42,68,51,119,0.000333,0.213895,16,10266.97237,570.387354,641.685773,185.583273,4,0
0,0,13,13,17,24,41,68,50,118,0.000333,0.21073,16,10115.05819,561.947677,632.191137,179.525968,4,0
0,0,8,8,13,17,30,33,34,67,0.000333,0.109587,12,3945.140039,219.174447,328.76167,117.592585,3,0
0,0,8,8,13,17,30,33,34,67,0.000333,0.109587,12,3945.140039,219.174447,328.76167,117.592585,3,0
0,0,8,8,13,17,30,33,34,67,0.000333,0.109587,12,3945.140039,219.174447,328.76167,117.592585,3,0
0,0,14,14,18,25,43,74,53,127,0.000333,0.229712,18,12404.44123,689.135624,689.135624,191.155055,4,0
0,0,15,15,18,26,44,83,57,140,0.000333,0.254773,18,13757.76768,764.320427,764.320427,197.270083,4,0
0,0,6,6,13,16,29,27,22,49,0.000333,0.079347,6,1428.246413,79.347023,238.041069,112.105716,3,0
0,0,15,15,17,26,43,79,57,136,0.000333,0.245991,16,11807.55211,655.975117,737.972007,191.698301,4,0
0,0,16,16,18,27,45,75,63,138,0.000333,0.252625,18,13641.76309,757.875727,757.875727,203.440613,4,0
0,0,14,14,17,24,41,68,51,119,0.000333,0.212516,16,10200.77902,566.709945,637.548689,179.525968,4,0
0,0,6,6,15,17,32,29,23,52,0.000333,0.086667,7,1820,101.111111,260,128.090227,3,0
0,0,6,6,14,17,31,28,23,51,0.000333,0.084221,7,1768.648083,98.258227,252.664012,122.789837,3,0
0,0,3,3,8,8,16,10,12,22,0.000333,0.029333,4,352,19.555556,88,48,1,0
0,0,3,3,8,7,15,10,11,21,0.000333,0.027348,4,328.17881,18.232156,82.044703,43.651484,1,0
0,0,3,3,8,7,15,10,11,21,0.000333,0.027348,4,328.17881,18.232156,82.044703,43.651484,1,0
0,0,3,3,8,8,16,10,12,22,0.000333,0.029333,4,352,19.555556,88,48,1,0
0,0,2,2,7,5,12,8,9,17,0.000333,0.020315,3,182.833088,10.157394,60.944363,31.261125,1,0
0,0,2,2,7,7,14,8,13,21,0.000333,0.026651,3,239.86336,13.325742,79.954453,39.302969,1,0
0,0,2,2,7,7,14,8,13,21,0.000333,0.026651,3,239.86336,13.325742,79.954453,39.302969,1,0
0,0,2,2,7,5,12,8,9,17,0.000333,0.020315,3,182.833088,10.157394,60.944363,31.261125,1,0
0,0,9,9,15,15,30,45,27,72,0.000333,0.117765,7,2473.07286,137.392937,353.296123,117.206718,3,0
0,0,9,9,15,15,30,45,27,72,0.000333,0.117765,7,2473.07286,137.392937,353.296123,117.206718,3,0
0,0,9,9,15,15,30,45,27,72,0.000333,0.117765,7,2473.07286,137.392937,353.296123,117.206718,3,0
0,0,9,9,15,15,30,45,27,72,0.000333,0.117765,7,2473.07286,137.392937,353.296123,117.206718,3,0
0,0,9,9,15,15,30,45,27,72,0.000333,0.117765,7,2473.07286,137.392937,353.296123,117.206718,3,0
0,0,9,9,15,15,30,45,27,72,0.000333,0.117765,7,2473.07286,137.392937,353.296123,117.206718,3,0
0,0,9,9,15,15,30,45,27,72,0.000333,0.117765,7,2473.07286,137.392937,353.296123,117.206718,3,0
0,0,9,9,15,15,30,45,27,72,0.000333,0.117765,7,2473.07286,137.392937,353.296123,117.206718,3,0
0,0,9,9,15,15,30,45,27,72,0.000333,0.117765,7,2473.07286,137.392937,353.296123,117.206718,3,0
0,0,9,9,15,15,30,45,27,72,0.000333,0.117765,7,2473.07286,137.392937,353.296123,117.206718,3,0
0,0,9,9,15,15,30,45,27,72,0.000333,0.117765,7,2473.07286,137.392937,353.296123,117.206718,3,0
0,0,9,9,15,15,30,45,27,72,0.000333,0.117765,7,2473.07286,137.392937,353.296123,117.206718,3,0
0,0,9,9,15,15,30,45,27,72,0.000333,0.117765,7,2473.07286,137.392937,353.296123,117.206718,3,0
0,0,9,9,15,15,30,45,27,72,0.000333,0.117765,7,2473.07286,137.392937,353.296123,117.206718,3,0
0,0,9,9,15,15,30,45,27,72,0.000333,0.117765,7,2473.07286,137.392937,353.296123,117.206718,3,0
0,0,9,9,15,15,30,45,27,72,0.000333,0.117765,7,2473.07286,137.392937,353.296123,117.206718,3,0
0,0,9,9,15,15,30,45,27,72,0.000333,0.117765,7,2473.07286,137.392937,353.296123,117.206718,3,0
0,0,9,9,15,15,30,45,27,72,0.000333,0.117765,7,2473.07286,137.392937,353.296123,117.206718,3,0
0,0,9,9,15,15,30,45,27,72,0.000333,0.117765,7,2473.07286,137.392937,353.296123,117.206718,3,0
0,0,9,9,15,15,30,45,27,72,0.000333,0.117765,7,2473.07286,137.392937,353.296123,117.206718,3,0
0,0,9,9,15,15,30,45,27,72,0.000333,0.117765,7,2473.07286,137.392937,353.296123,117.206718,3,0
0,0,9,9,15,15,30,45,27,72,0.000333,0.117765,7,2473.07286,137.392937,353.296123,117.206718,3,0
0,0,9,9,15,15,30,45,27,72,0.000333,0.117765,7,2473.07286,137.392937,353.296123,117.206718,3,0
0,0,9,9,15,15,30,45,27,72,0.000333,0.117765,7,2473.07286,137.392937,353.296123,117.206718,3,0
0,0,9,9,15,15,30,45,27,72,0.000333,0.117765,7,2473.07286,137.392937,353.296123,117.206718,3,0
0,0,9,9,15,15,30,45,27,72,0.000333,0.117765,7,2473.07286,137.392937,353.296123,117.206718,3,0
0,0,9,9,15,15,30,45,27,72,0.000333,0.117765,7,2473.07286,137.392937,353.296123,117.206718,3,0
0,0,9,9,15,15,30,45,27,72,0.000333,0.117765,7,2473.07286,137.392937,353.296123,117.206718,3,0
0,0,9,9,15,15,30,45,27,72,0.000333,0.117765,7,2473.07286,137.392937,353.296123,117.206718,3,0
0,0,9,9,15,15,30,45,27,72,0.000333,0.117765,7,2473.07286,137.392937,353.296123,117.206718,3,0
0,0,9,9,15,15,30,45,27,72,0.000333,0.117765,7,2473.07286,137.392937,353.296123,117.206718,3,0
0,0,9,9,15,15,30,45,27,72,0.000333,0.117765,7,2473.07286,137.392937,353.296123,117.206718,3,0
0,0,9,9,15,15,30,45,27,72,0.000333,0.117765,7,2473.07286,137.392937,353.296123,117.206718,3,0
0,0,11,11,16,19,35,52,37,89,0.000333,0.152169,8,3652.049508,202.891639,456.506189,144.710623,3,0
0,0,11,11,16,19,35,52,37,89,0.000333,0.152169,8,3652.049508,202.891639,456.506189,144.710623,3,0
0,0,11,11,15,21,36,51,41,92,0.000333,0.158544,7,3329.431701,184.968428,475.6331,150.842025,3,0
0,0,6,6,13,17,30,27,23,50,0.000333,0.081782,6,1472.067179,81.78151,245.34453,117.592585,3,0
0,0,11,11,15,16,31,51,33,84,0.000333,0.138717,14,5826.134861,323.674159,416.15249,122.603359,3,0
0,0,7,7,14,12,26,33,21,54,0.000333,0.084608,7,1776.766213,98.709234,253.823745,96.322519,3,0
0,0,7,7,14,16,30,29,23,52,0.000333,0.085053,7,1786.108177,99.228232,255.158311,117.302969,3,0
0,0,11,11,16,18,34,52,35,87,0.000333,0.147536,8,3540.874138,196.71523,442.609267,139.05865,3,0
0,0,11,11,15,15,30,54,37,91,0.000333,0.148842,14,6251.378619,347.298812,446.527044,117.206718,3,0
0,0,6,6,14,14,28,28,20,48,0.000333,0.076918,7,1615.271254,89.737292,230.753036,106.605938,3,0
0,0,12,12,15,21,36,51,40,91,0.000333,0.156821,7,3293.242226,182.957901,470.463175,150.842025,3,0
0,0,11,11,15,20,35,51,39,90,0.000333,0.153878,7,3231.448301,179.524906,461.635472,145.041921,3,0
0,0,8,8,13,17,30,33,34,67,0.000333,0.109587,12,3945.140039,219.174447,328.76167,117.592585,3,0
0,0,8,8,13,17,30,33,34,67,0.000333,0.109587,12,3945.140039,219.174447,328.76167,117.592585,3,0
0,0,8,8,13,17,30,33,34,67,0.000333,0.109587,12,3945.140039,219.174447,328.76167,117.592585,3,0
0,0,11,11,14,17,31,53,43,96,0.000333,0.158534,14,6658.439841,369.913325,475.602846,122.789837,3,0
0,0,12,12,16,21,37,57,42,99,0.000333,0.171912,16,8251.774131,458.431896,515.735883,156.238666,3,0
0,0,13,13,16,22,38,66,46,112,0.000333,0.195923,16,9404.286104,522.460339,587.767882,162.107496,3,0
0,0,6,6,13,16,29,27,22,49,0.000333,0.079347,6,1428.246413,79.347023,238.041069,112.105716,3,0
0,0,13,13,15,22,37,62,46,108,0.000333,0.18754,14,7876.693489,437.594083,562.620963,156.710855,3,0
0,0,14,14,16,23,39,58,52,110,0.000333,0.193798,16,9302.307905,516.794884,581.394244,168.041925,3,0
0,0,12,12,15,20,35,51,40,91,0.000333,0.155588,14,6534.706564,363.039254,466.764755,145.041921,3,0
0,0,6,6,15,17,32,29,23,52,0.000333,0.086667,7,1820,101.111111,260,128.090227,3,0
0,0,6,6,14,17,31,28,23,51,0.000333,0.084221,7,1768.648083,98.258227,252.664012,122.789837,3,0
0,0,3,3,8,8,16,10,12,22,0.000333,0.029333,4,352,19.555556,88,48,1,0
0,0,3,3,8,7,15,10,11,21,0.000333,0.027348,4,328.17881,18.232156,82.044703,43.651484,1,0
0,0,3,3,8,8,16,10,12,22,0.000333,0.029333,4,352,19.555556,88,48,1,0
0,0,3,3,8,7,15,10,11,21,0.000333,0.027348,4,328.17881,18.232156,82.044703,43.651484,1,0
0,0,2,2,7,5,12,8,9,17,0.000333,0.020315,3,182.833088,10.157394,60.944363,31.261125,1,0
0,0,2,2,7,7,14,8,13,21,0.000333,0.026651,3,239.86336,13.325742,79.954453,39.302969,1,0
0,0,2,2,7,7,14,8,13,21,0.000333,0.026651,3,239.86336,13.325742,79.954453,39.302969,1,0
0,0,2,2,7,5,12,8,9,17,0.000333,0.020315,3,182.833088,10.157394,60.944363,31.261125,1,0
0,0,11,11,17,17,34,60,34,94,0.000333,0.159407,16,7651.544113,425.085784,478.221507,138.973737,3,0
0,0,11,11,17,17,34,60,34,94,0.000333,0.159407,16,7651.544113,425.085784,478.221507,138.973737,3,0
0,0,11,11,17,17,34,60,34,94,0.000333,0.159407,16,7651.544113,425.085784,478.221507,138.973737,3,0
0,0,11,11,17,17,34,60,34,94,0.000333,0.159407,16,7651.544113,425.085784,478.221507,138.973737,3,0
0,0,11,11,17,17,34,60,34,94,0.000333,0.159407,16,7651.544113,425.085784,478.221507,138.973737,3,0
0,0,11,11,17,17,34,60,34,94,0.000333,0.159407,16,7651.544113,425.085784,478.221507,138.973737,3,0
0,0,11,11,17,17,34,60,34,94,0.000333,0.159407,16,7651.544113,425.085784,478.221507,138.973737,3,0
0,0,11,11,17,17,34,60,34,94,0.000333,0.159407,16,7651.544113,425.085784,478.221507,138.973737,3,0
0,0,11,11,17,17,34,60,34,94,0.000333,0.159407,16,7651.544113,425.085784,478.221507,138.973737,3,0
0,0,11,11,17,17,34,60,34,94,0.000333,0.159407,16,7651.544113,425.085784,478.221507,138.973737,3,0
0,0,11,11,17,17,34,60,34,94,0.000333,0.159407,16,7651.544113,425.085784,478.221507,138.973737,3,0
0,0,11,11,17,17,34,60,34,94,0.000333,0.159407,16,7651.544113,425.085784,478.221507,138.973737,3,0
0,0,11,11,17,17,34,60,34,94,0.000333,0.159407,16,7651.544113,425.085784,478.221507,138.973737,3,0
0,0,11,11,17,17,34,60,34,94,0.000333,0.159407,16,7651.544113,425.085784,478.221507,138.973737,3,0
0,0,11,11,17,17,34,60,34,94,0.000333,0.159407,16,7651.544113,425.085784,478.221507,138.973737,3,0
0,0,11,11,17,17,34,60,34,94,0.000333,0.159407,16,7651.544113,425.085784,478.221507,138.973737,3,0
0,0,11,11,17,17,34,60,34,94,0.000333,0.159407,16,7651.544113,425.085784,478.221507,138.973737,3,0
0,0,11,11,17,17,34,60,34,94,0.000333,0.159407,16,7651.544113,425.085784,478.221507,138.973737,3,0
0,0,11,11,17,17,34,60,34,94,0.000333,0.159407,16,7651.544113,425.085784,478.221507,138.973737,3,0
0,0,11,11,17,17,34,60,34,94,0.000333,0.159407,16,7651.544113,425.085784,478.221507,138.973737,3,0
0,0,11,11,17,17,34,60,34,94,0.000333,0.159407,16,7651.544113,425.085784,478.221507,138.973737,3,0
0,0,11,11,17,17,34,60,34,94,0.000333,0.159407,16,7651.544113,425.085784,478.221507,138.973737,3,0
0,0,11,11,17,17,34,60,34,94,0.000333,0.159407,16,7651.544113,425.085784,478.221507,138.973737,3,0
0,0,11,11,17,17,34,60,34,94,0.000333,0.159407,16,7651.544113,425.085784,478.221507,138.973737,3,0
0,0,11,11,17,17,34,60,34,94,0.000333,0.159407,16,7651.544113,425.085784,478.221507,138.973737,3,0
0,0,11,11,17,17,34,60,34,94,0.000333,0.159407,16,7651.544113,425.085784,478.221507,138.973737,3,0
0,0,11,11,17,17,34,60,34,94,0.000333,0.159407,16,7651.544113,425.085784,478.221507,138.973737,3,0
0,0,11,11,17,17,34,60,34,94,0.000333,0.159407,16,7651.544113,425.085784,478.221507,138.973737,3,0
0,0,11,11,17,17,34,60,34,94,0.000333,0.159407,16,7651.544113,425.085784,478.221507,138.973737,3,0
0,0,11,11,17,17,34,60,34,94,0.000333,0.159407,16,7651.544113,425.085784,478.221507,138.973737,3,0
0,0,11,11,17,17,34,60,34,94,0.000333,0.159407,16,7651.544113,425.085784,478.221507,138.973737,3,0
0,0,11,11,17,17,34,60,34,94,0.000333,0.159407,16,7651.544113,425.085784,478.221507,138.973737,3,0
0,0,11,11,17,17,34,60,34,94,0.000333,0.159407,16,7651.544113,425.085784,478.221507,138.973737,3,0
0,0,13,13,18,21,39,67,44,111,0.000333,0.19556,18,10560.23363,586.679646,586.679646,167.297316,3,0
0,0,13,13,18,21,39,67,44,111,0.000333,0.19556,18,10560.23363,586.679646,586.679646,167.297316,3,0
0,0,13,13,17,23,40,66,48,114,0.000333,0.202233,16,9707.196845,539.288714,606.699803,173.528793,3,0
0,0,6,6,13,17,30,27,23,50,0.000333,0.081782,6,1472.067179,81.78151,245.34453,117.592585,3,0
0,0,13,13,17,18,35,66,40,106,0.000333,0.181235,16,8699.263997,483.292444,543.704,144.545518,3,0
0,0,7,7,14,12,26,33,21,54,0.000333,0.084608,7,1776.766213,98.709234,253.823745,96.322519,3,0
0,0,7,7,14,16,30,29,23,52,0.000333,0.085053,7,1786.108177,99.228232,255.158311,117.302969,3,0
0,0,13,13,18,20,38,67,42,109,0.000333,0.190675,18,10296.43378,572.024099,572.024099,161.497212,3,0
0,0,13,13,18,19,37,66,39,105,0.000333,0.182331,18,9845.866861,546.992603,546.992603,155.769273,3,0
0,0,6,6,14,14,28,28,20,48,0.000333,0.076918,7,1615.271254,89.737292,230.753036,106.605938,3,0
0,0,14,14,17,23,40,66,47,113,0.000333,0.200459,16,9622.045996,534.558111,601.377875,173.528793,3,0
0,0,13,13,17,22,39,66,46,112,0.000333,0.197322,16,9471.440776,526.191154,591.965049,167.594364,3,0
0,0,8,8,13,17,30,33,34,67,0.000333,0.109587,12,3945.140039,219.174447,328.76167,117.592585,3,0
0,0,8,8,13,17,30,33,34,67,0.000333,0.109587,12,3945.140039,219.174447,328.76167,117.592585,3,0
0,0,8,8,13,17,30,33,34,67,0.000333,0.109587,12,3945.140039,219.174447,328.76167,117.592585,3,0
0,0,13,13,18,21,39,66,41,107,0.000333,0.188513,9,5089.842337,282.769019,565.538037,167.297316,3,0
0,0,14,14,18,23,41,72,49,121,0.000333,0.216088,18,11668.74827,648.263793,648.263793,179.100575,3,0
0,0,15,15,18,24,42,81,53,134,0.000333,0.240857,18,13006.26962,722.570535,722.570535,185.09775,3,0
0,0,6,6,13,16,29,27,22,49,0.000333,0.079347,6,1428.246413,79.347023,238.041069,112.105716,3,0
0,0,15,15,17,24,41,77,53,130,0.000333,0.232161,16,11143.70817,619.094898,696.481761,179.525968,3,0
0,0,16,16,18,25,43,73,59,132,0.000333,0.238756,18,12892.80506,716.266948,716.266948,191.155055,3,0
0,0,14,14,17,22,39,66,47,113,0.000333,0.199083,16,9556.007212,530.88929,597.250451,167.594364,3,0
0,0,6,6,15,17,32,29,23,52,0.000333,0.086667,7,1820,101.111111,260,128.090227,3,0
0,0,6,6,14,17,31,28,23,51,0.000333,0.084221,7,1768.648083,98.258227,252.664012,122.789837,3,0
0,0,3,3,8,8,16,10,12,22,0.000333,0.029333,4,352,19.555556,88,48,1,0
0,0,3,3,8,7,15,10,11,21,0.000333,0.027348,4,328.17881,18.232156,82.044703,43.651484,1,0
0,0,3,3,8,7,15,10,11,21,0.000333,0.027348,4,328.17881,18.232156,82.044703,43.651484,1,0
0,0,3,3,8,8,16,10,12,22,0.000333,0.029333,4,352,19.555556,88,48,1,0
0,0,2,2,7,7,14,8,13,21,0.000333,0.026651,3,239.86336,13.325742,79.954453,39.302969,1,0
0,0,2,2,7,5,12,8,9,17,0.000333,0.020315,3,182.833088,10.157394,60.944363,31.261125,1,0
0,0,2,2,7,7,14,8,13,21,0.000333,0.026651,3,239.86336,13.325742,79.954453,39.302969,1,0
0,0,2,2,7,5,12,8,9,17,0.000333,0.020315,3,182.833088,10.157394,60.944363,31.261125,1,0
0,0,3,3,8,8,16,10,12,22,0.000333,0.029333,4,352,19.555556,88,48,1,0
0,0,3,3,8,7,15,10,11,21,0.000333,0.027348,4,328.17881,18.232156,82.044703,43.651484,1,0
0,0,3,3,8,8,16,10,12,22,0.000333,0.029333,4,352,19.555556,88,48,1,0
0,0,3,3,8,7,15,10,11,21,0.000333,0.027348,4,328.17881,18.232156,82.044703,43.651484,1,0
0,0,2,2,7,5,12,8,9,17,0.000333,0.020315,3,182.833088,10.157394,60.944363,31.261125,1,0
0,0,2,2,7,7,14,8,13,21,0.000333,0.026651,3,239.86336,13.325742,79.954453,39.302969,1,0
0,0,2,2,7,5,12,8,9,17,0.000333,0.020315,3,182.833088,10.157394,60.944363,31.261125,1,0
0,0,2,2,7,7,14,8,13,21,0.000333,0.026651,3,239.86336,13.325742,79.954453,39.302969,1,0
0,0,3,3,8,8,16,10,12,22,0.000333,0.029333,4,352,19.555556,88,48,1,0
0,0,3,3,8,7,15,10,11,21,0.000333,0.027348,4,328.17881,18.232156,82.044703,43.651484,1,0
0,0,3,3,8,8,16,10,12,22,0.000333,0.029333,4,352,19.555556,88,48,1,0
0,0,3,3,8,7,15,10,11,21,0.000333,0.027348,4,328.17881,18.232156,82.044703,43.651484,1,0
0,0,2,2,7,7,14,8,13,21,0.000333,0.026651,3,239.86336,13.325742,79.954453,39.302969,1,0
0,0,2,2,7,5,12,8,9,17,0.000333,0.020315,3,182.833088,10.157394,60.944363,31.261125,1,0
0,0,2,2,7,7,14,8,13,21,0.000333,0.026651,3,239.86336,13.325742,79.954453,39.302969,1,0
0,0,2,2,7,5,12,8,9,17,0.000333,0.020315,3,182.833088,10.157394,60.944363,31.261125,1,0
0,0,3,3,8,8,16,10,13,23,0.000333,0.030667,4,368,20.444444,92,48,1,0
0,0,3,3,8,9,17,10,14,24,0.000333,0.0327,4,392.396433,21.799802,98.099108,52.529325,1,0
0,0,3,3,8,9,17,10,14,24,0.000333,0.0327,4,392.396433,21.799802,98.099108,52.529325,1,0
0,0,3,3,8,8,16,10,13,23,0.000333,0.030667,4,368,20.444444,92,48,1,0
0,0,2,2,7,6,13,8,11,19,0.000333,0.023436,3,210.925064,11.718059,70.308355,35.161259,1,0
0,0,2,2,7,8,15,8,15,23,0.000333,0.029953,3,269.575451,14.976414,89.858484,43.651484,1,0
0,0,2,2,7,8,15,8,15,23,0.000333,0.029953,3,269.575451,14.976414,89.858484,43.651484,1,0
0,0,2,2,7,6,13,8,11,19,0.000333,0.023436,3,210.925064,11.718059,70.308355,35.161259,1,0
0,0,3,3,8,8,16,10,12,22,0.000333,0.029333,4,352,19.555556,88,48,1,0
0,0,3,3,8,7,15,10,11,21,0.000333,0.027348,4,328.17881,18.232156,82.044703,43.651484,1,0
0,0,3,3,8,8,16,10,12,22,0.000333,0.029333,4,352,19.555556,88,48,1,0
0,0,3,3,8,7,15,10,11,21,0.000333,0.027348,4,328.17881,18.232156,82.044703,43.651484,1,0
0,0,2,2,7,5,12,8,9,17,0.000333,0.020315,3,182.833088,10.157394,60.944363,31.261125,1,0
0,0,2,2,7,7,14,8,13,21,0.000333,0.026651,3,239.86336,13.325742,79.954453,39.302969,1,0
0,0,2,2,7,5,12,8,9,17,0.000333,0.020315,3,182.833088,10.157394,60.944363,31.261125,1,0
0,0,2,2,7,7,14,8,13,21,0.000333,0.026651,3,239.86336,13.325742,79.954453,39.302969,1,0
0,0,3,3,8,7,15,10,11,21,0.000333,0.027348,4,328.17881,18.232156,82.044703,43.651484,1,0
0,0,3,3,8,8,16,10,12,22,0.000333,0.029333,4,352,19.555556,88,48,1,0
0,0,3,3,8,8,16,10,12,22,0.000333,0.029333,4,352,19.555556,88,48,1,0
0,0,3,3,8,7,15,10,11,21,0.000333,0.027348,4,328.17881,18.232156,82.044703,43.651484,1,0
0,0,2,2,7,7,14,8,13,21,0.000333,0.026651,3,239.86336,13.325742,79.954453,39.302969,1,0
0,0,2,2,7,5,12,8,9,17,0.000333,0.020315,3,182.833088,10.157394,60.944363,31.261125,1,0
0,0,2,2,7,7,14,8,13,21,0.000333,0.026651,3,239.86336,13.325742,79.954453,39.302969,1,0
0,0,2,2,7,5,12,8,9,17,0.000333,0.020315,3,182.833088,10.157394,60.944363,31.261125,1,0
0,0,3,3,8,8,16,10,13,23,0.000333,0.030667,4,368,20.444444,92,48,1,0
0,0,3,3,8,9,17,10,14,24,0.000333,0.0327,4,392.396433,21.799802,98.099108,52.529325,1,0
0,0,3,3,8,9,17,10,14,24,0.000333,0.0327,4,392.396433,21.799802,98.099108,52.529325,1,0
0,0,3,3,8,8,16,10,13,23,0.000333,0.030667,4,368,20.444444,92,48,1,0
0,0,2,2,7,8,15,8,15,23,0.000333,0.029953,3,269.575451,14.976414,89.858484,43.651484,1,0
0,0,2,2,7,6,13,8,11,19,0.000333,0.023436,3,210.925064,11.718059,70.308355,35.161259,1,0
0,0,2,2,7,8,15,8,15,23,0.000333,0.029953,3,269.575451,14.976414,89.858484,43.651484,1,0
0,0,2,2,7,6,13,8,11,19,0.000333,0.023436,3,210.925064,11.718059,70.308355,35.161259,1,0
0,0,7,7,11,15,26,36,24,60,0.000333,0.094009,5,1410.131915,78.340662,282.026383,96.657107,3,0
0,0,9,9,14,19,33,50,34,84,0.000333,0.141243,7,2966.103742,164.783541,423.729106,134.013592,3,0
0,0,7,7,11,15,26,36,24,60,0.000333,0.094009,5,1410.131915,78.340662,282.026383,96.657107,3,0
0,0,7,7,11,15,26,36,24,60,0.000333,0.094009,5,1410.131915,78.340662,282.026383,96.657107,3,0
0,0,8,8,13,15,28,41,26,67,0.000333,0.107364,6,1932.556679,107.36426,322.09278,106.709075,3,0
0,0,8,8,13,15,28,41,26,67,0.000333,0.107364,6,1932.556679,107.36426,322.09278,106.709075,3,0
0,0,7,7,11,15,26,36,24,60,0.000333,0.094009,5,1410.131915,78.340662,282.026383,96.657107,3,0
0,0,7,7,11,15,26,36,24,60,0.000333,0.094009,5,1410.131915,78.340662,282.026383,96.657107,3,0
0,0,8,8,13,15,28,41,26,67,0.000333,0.107364,6,1932.556679,107.36426,322.09278,106.709075,3,0
0,0,8,8,13,15,28,41,26,67,0.000333,0.107364,6,1932.556679,107.36426,322.09278,106.709075,3,0
0,0,7,7,11,15,26,36,24,60,0.000333,0.094009,5,1410.131915,78.340662,282.026383,96.657107,3,0
0,0,7,7,11,15,26,36,24,60,0.000333,0.094009,5,1410.131915,78.340662,282.026383,96.657107,3,0
0,0,8,8,13,15,28,41,26,67,0.000333,0.107364,6,1932.556679,107.36426,322.09278,106.709075,3,0
0,0,8,8,13,15,28,41,26,67,0.000333,0.107364,6,1932.556679,107.36426,322.09278,106.709075,3,0
0,0,7,7,11,15,26,36,24,60,0.000333,0.094009,5,1410.131915,78.340662,282.026383,96.657107,3,0
0,0,7,7,11,15,26,36,24,60,0.000333,0.094009,5,1410.131915,78.340662,282.026383,96.657107,3,0
0,0,8,8,13,15,28,41,26,67,0.000333,0.107364,6,1932.556679,107.36426,322.09278,106.709075,3,0
0,0,8,8,13,15,28,41,26,67,0.000333,0.107364,6,1932.556679,107.36426,322.09278,106.709075,3,0
0,0,7,7,11,15,26,36,24,60,0.000333,0.094009,5,1410.131915,78.340662,282.026383,96.657107,3,0
0,0,7,7,11,15,26,36,24,60,0.000333,0.094009,5,1410.131915,78.340662,282.026383,96.657107,3,0
0,0,8,8,13,15,28,41,26,67,0.000333,0.107364,6,1932.556679,107.36426,322.09278,106.709075,3,0
0,0,8,8,13,15,28,41,26,67,0.000333,0.107364,6,1932.556679,107.36426,322.09278,106.709075,3,0
0,0,7,7,11,15,26,36,24,60,0.000333,0.094009,5,1410.131915,78.340662,282.026383,96.657107,3,0
0,0,7,7,11,15,26,36,24,60,0.000333,0.094009,5,1410.131915,78.340662,282.026383,96.657107,3,0
0,0,8,8,13,15,28,41,26,67,0.000333,0.107364,6,1932.556679,107.36426,322.09278,106.709075,3,0
0,0,8,8,13,15,28,41,26,67,0.000333,0.107364,6,1932.556679,107.36426,322.09278,106.709075,3,0
0,0,7,7,11,15,26,36,24,60,0.000333,0.094009,5,1410.131915,78.340662,282.026383,96.657107,3,0
0,0,7,7,11,15,26,36,24,60,0.000333,0.094009,5,1410.131915,78.340662,282.026383,96.657107,3,0
0,0,8,8,13,15,28,41,26,67,0.000333,0.107364,6,1932.556679,107.36426,322.09278,106.709075,3,0
0,0,8,8,13,15,28,41,26,67,0.000333,0.107364,6,1932.556679,107.36426,322.09278,106.709075,3,0
0,0,7,7,11,15,26,36,24,60,0.000333,0.094009,5,1410.131915,78.340662,282.026383,96.657107,3,0
0,0,7,7,11,15,26,36,24,60,0.000333,0.094009,5,1410.131915,78.340662,282.026383,96.657107,3,0
0,0,8,8,13,15,28,41,26,67,0.000333,0.107364,6,1932.556679,107.36426,322.09278,106.709075,3,0
0,0,8,8,13,15,28,41,26,67,0.000333,0.107364,6,1932.556679,107.36426,322.09278,106.709075,3,0
0,0,7,7,11,15,26,36,24,60,0.000333,0.094009,5,1410.131915,78.340662,282.026383,96.657107,3,0
0,0,7,7,11,15,26,36,24,60,0.000333,0.094009,5,1410.131915,78.340662,282.026383,96.657107,3,0
0,0,8,8,13,15,28,41,26,67,0.000333,0.107364,6,1932.556679,107.36426,322.09278,106.709075,3,0
0,0,8,8,13,15,28,41,26,67,0.000333,0.107364,6,1932.556679,107.36426,322.09278,106.709075,3,0
0,0,7,7,11,15,26,36,24,60,0.000333,0.094009,5,1410.131915,78.340662,282.026383,96.657107,3,0
0,0,7,7,11,15,26,36,24,60,0.000333,0.094009,5,1410.131915,78.340662,282.026383,96.657107,3,0
0,0,8,8,13,15,28,41,26,67,0.000333,0.107364,6,1932.556679,107.36426,322.09278,106.709075,3,0
0,0,8,8,13,15,28,41,26,67,0.000333,0.107364,6,1932.556679,107.36426,322.09278,106.709075,3,0
0,0,7,7,11,15,26,36,24,60,0.000333,0.094009,5,1410.131915,78.340662,282.026383,96.657107,3,0
0,0,7,7,11,15,26,36,24,60,0.000333,0.094009,5,1410.131915,78.340662,282.026383,96.657107,3,0
0,0,10,10,14,20,34,52,36,88,0.000333,0.149232,7,3133.87711,174.104284,447.69673,139.741531,3,0
0,0,11,11,14,19,33,60,41,101,0.000333,0.169828,14,7132.773285,396.265182,509.483806,134.013592,3,0
0,0,7,7,11,15,26,36,24,60,0.000333,0.094009,5,1410.131915,78.340662,282.026383,96.657107,3,0
0,0,7,7,11,15,26,36,24,60,0.000333,0.094009,5,1410.131915,78.340662,282.026383,96.657107,3,0
0,0,8,8,13,15,28,41,26,67,0.000333,0.107364,6,1932.556679,107.36426,322.09278,106.709075,3,0
0,0,8,8,13,15,28,41,26,67,0.000333,0.107364,6,1932.556679,107.36426,322.09278,106.709075,3,0
0,0,7,7,11,15,26,36,24,60,0.000333,0.094009,5,1410.131915,78.340662,282.026383,96.657107,3,0
0,0,7,7,11,15,26,36,24,60,0.000333,0.094009,5,1410.131915,78.340662,282.026383,96.657107,3,0
0,0,8,8,13,15,28,41,26,67,0.000333,0.107364,6,1932.556679,107.36426,322.09278,106.709075,3,0
0,0,8,8,13,15,28,41,26,67,0.000333,0.107364,6,1932.556679,107.36426,322.09278,106.709075,3,0
0,0,7,7,11,15,26,36,24,60,0.000333,0.094009,5,1410.131915,78.340662,282.026383,96.657107,3,0
0,0,7,7,11,15,26,36,24,60,0.000333,0.094009,5,1410.131915,78.340662,282.026383,96.657107,3,0
0,0,8,8,13,15,28,41,26,67,0.000333,0.107364,6,1932.556679,107.36426,322.09278,106.709075,3,0
0,0,8,8,13,15,28,41,26,67,0.000333,0.107364,6,1932.556679,107.36426,322.09278,106.709075,3,0
0,0,7,7,11,15,26,36,24,60,0.000333,0.094009,5,1410.131915,78.340662,282.026383,96.657107,3,0
0,0,7,7,11,12,23,33,21,54,0.000333,0.081424,5,1221.361728,67.853429,244.272346,81.073298,3,0
0,0,7,7,11,15,26,36,24,60,0.000333,0.094009,5,1410.131915,78.340662,282.026383,96.657107,3,0
0,0,7,7,11,12,23,33,21,54,0.000333,0.081424,5,1221.361728,67.853429,244.272346,81.073298,3,0
0,0,7,7,11,15,26,36,24,60,0.000333,0.094009,5,1410.131915,78.340662,282.026383,96.657107,3,0
0,0,6,6,11,11,22,31,19,50,0.000333,0.074324,5,1114.857905,61.93655,222.971581,76.107496,3,0
0,0,7,7,11,15,26,36,24,60,0.000333,0.094009,5,1410.131915,78.340662,282.026383,96.657107,3,0
0,0,7,7,11,15,26,36,24,60,0.000333,0.094009,5,1410.131915,78.340662,282.026383,96.657107,3,0
0,0,11,11,15,24,39,56,44,100,0.000333,0.17618,7,3699.781553,205.54342,528.540222,168.642459,3,0
0,0,11,11,15,24,39,56,44,100,0.000333,0.17618,7,3699.781553,205.54342,528.540222,168.642459,3,0
0,0,7,7,11,15,26,36,24,60,0.000333,0.094009,5,1410.131915,78.340662,282.026383,96.657107,3,0
0,0,7,7,11,15,26,36,24,60,0.000333,0.094009,5,1410.131915,78.340662,282.026383,96.657107,3,0
0,0,6,6,11,17,28,31,25,56,0.000333,0.089737,5,1346.059378,74.781077,269.211876,107.540616,3,0
0,0,6,6,11,17,28,31,25,56,0.000333,0.089737,5,1346.059378,74.781077,269.211876,107.540616,3,0
0,0,7,7,11,15,26,36,24,60,0.000333,0.094009,5,1410.131915,78.340662,282.026383,96.657107,3,0
0,0,11,11,14,21,35,54,40,94,0.000333,0.160718,7,3375.068225,187.50379,482.152604,145.541635,3,0
0,0,7,7,11,15,26,36,24,60,0.000333,0.094009,5,1410.131915,78.340662,282.026383,96.657107,3,0
0,0,7,7,12,12,24,36,23,59,0.000333,0.090171,6,1623.076725,90.170929,270.512788,86.0391,3,0
0,0,7,7,11,15,26,36,24,60,0.000333,0.094009,5,1410.131915,78.340662,282.026383,96.657107,3,0
0,0,7,7,12,16,28,33,25,58,0.000333,0.092942,6,1672.959513,92.942195,278.826585,107.01955,3,0
0,0,7,7,11,15,26,36,24,60,0.000333,0.094009,5,1410.131915,78.340662,282.026383,96.657107,3,0
0,0,11,11,15,23,38,56,42,98,0.000333,0.171432,7,3600.078274,200.004349,514.296896,162.645284,3,0
0,0,7,7,11,15,26,36,24,60,0.000333,0.094009,5,1410.131915,78.340662,282.026383,96.657107,3,0
0,0,11,11,15,21,36,56,39,95,0.000333,0.163714,7,3438.000126,191.000007,491.142875,150.842025,3,0
0,0,7,7,11,15,26,36,24,60,0.000333,0.094009,5,1410.131915,78.340662,282.026383,96.657107,3,0
0,0,6,6,12,14,26,32,22,54,0.000333,0.084608,6,1522.942469,84.607915,253.823745,96.322519,3,0
0,0,7,7,11,15,26,36,24,60,0.000333,0.094009,5,1410.131915,78.340662,282.026383,96.657107,3,0
0,0,12,12,14,26,40,55,47,102,0.000333,0.180946,7,3799.85666,211.103148,542.836666,175.514402,3,0
0,0,7,7,11,15,26,36,24,60,0.000333,0.094009,5,1410.131915,78.340662,282.026383,96.657107,3,0
0,0,11,11,14,25,39,55,46,101,0.000333,0.177942,7,3736.779369,207.598854,533.825624,169.399374,3,0
0,0,7,7,11,15,26,36,24,60,0.000333,0.094009,5,1410.131915,78.340662,282.026383,96.657107,3,0
0,0,8,8,11,17,28,36,36,72,0.000333,0.115377,10,3461.295544,192.294197,346.129554,107.540616,3,0
0,0,7,7,11,15,26,36,24,60,0.000333,0.094009,5,1410.131915,78.340662,282.026383,96.657107,3,0
0,0,8,8,11,17,28,36,36,72,0.000333,0.115377,10,3461.295544,192.294197,346.129554,107.540616,3,0
0,0,7,7,11,15,26,36,24,60,0.000333,0.094009,5,1410.131915,78.340662,282.026383,96.657107,3,0
0,0,8,8,11,17,28,36,36,72,0.000333,0.115377,10,3461.295544,192.294197,346.129554,107.540616,3,0
0,0,7,7,11,15,26,36,24,60,0.000333,0.094009,5,1410.131915,78.340662,282.026383,96.657107,3,0
0,0,11,11,15,23,38,56,41,97,0.000333,0.169683,7,3563.342782,197.963488,509.048969,162.645284,3,0
0,0,7,7,11,15,26,36,24,60,0.000333,0.094009,5,1410.131915,78.340662,282.026383,96.657107,3,0
0,0,12,12,15,26,41,60,49,109,0.000333,0.194658,7,4087.81218,227.100677,583.973169,180.814792,3,0
0,0,7,7,11,15,26,36,24,60,0.000333,0.094009,5,1410.131915,78.340662,282.026383,96.657107,3,0
0,0,13,13,15,27,42,68,53,121,0.000333,0.21749,7,4567.292857,253.738492,652.470408,186.985321,3,0
0,0,7,7,11,15,26,36,24,60,0.000333,0.094009,5,1410.131915,78.340662,282.026383,96.657107,3,0
0,0,6,6,11,16,27,31,24,55,0.000333,0.087173,5,1307.594063,72.644115,261.518813,102.053748,3,0
0,0,6,6,13,13,26,33,21,54,0.000333,0.084608,6,1522.942469,84.607915,253.823745,96.211433,3,0
0,0,13,13,14,27,41,65,53,118,0.000333,0.21073,7,4425.337956,245.852109,632.191137,181.684931,3,0
0,0,7,7,11,15,26,36,24,60,0.000333,0.094009,5,1410.131915,78.340662,282.026383,96.657107,3,0
0,0,12,12,14,24,38,51,49,100,0.000333,0.174931,14,7347.098519,408.17214,524.792751,163.342069,3,0
0,0,3,3,8,8,16,10,12,22,0.000333,0.029333,4,352,19.555556,88,48,1,0
0,0,3,3,8,8,16,10,12,22,0.000333,0.029333,4,352,19.555556,88,48,1,0
0,0,3,3,8,7,15,10,11,21,0.000333,0.027348,4,328.17881,18.232156,82.044703,43.651484,1,0
0,0,3,3,8,7,15,10,11,21,0.000333,0.027348,4,328.17881,18.232156,82.044703,43.651484,1,0
0,0,3,3,8,8,16,10,12,22,0.000333,0.029333,4,352,19.555556,88,48,1,0
0,0,3,3,8,8,16,10,12,22,0.000333,0.029333,4,352,19.555556,88,48,1,0
0,0,2,2,7,7,14,8,13,21,0.000333,0.026651,3,239.86336,13.325742,79.954453,39.302969,1,0
0,0,2,2,7,5,12,8,9,17,0.000333,0.020315,3,182.833088,10.157394,60.944363,31.261125,1,0
0,0,2,2,7,7,14,8,13,21,0.000333,0.026651,3,239.86336,13.325742,79.954453,39.302969,1,0
0,0,2,2,7,7,14,8,13,21,0.000333,0.026651,3,239.86336,13.325742,79.954453,39.302969,1,0
0,0,2,2,7,5,12,8,9,17,0.000333,0.020315,3,182.833088,10.157394,60.944363,31.261125,1,0
0,0,2,2,7,7,14,8,13,21,0.000333,0.026651,3,239.86336,13.325742,79.954453,39.302969,1,0
0,0,7,7,11,15,26,36,24,60,0.000333,0.094009,5,1410.131915,78.340662,282.026383,96.657107,3,0
0,0,9,9,14,17,31,49,32,81,0.000333,0.133763,7,2809.029308,156.057184,401.289901,122.789837,4,0
0,0,7,7,11,15,26,36,24,60,0.000333,0.094009,5,1410.131915,78.340662,282.026383,96.657107,3,0
0,0,7,7,11,15,26,36,24,60,0.000333,0.094009,5,1410.131915,78.340662,282.026383,96.657107,3,0
0,0,9,9,14,17,31,49,32,81,0.000333,0.133763,7,2809.029308,156.057184,401.289901,122.789837,4,0
0,0,9,9,14,17,31,49,32,81,0.000333,0.133763,7,2809.029308,156.057184,401.289901,122.789837,4,0
0,0,7,7,11,15,26,36,24,60,0.000333,0.094009,5,1410.131915,78.340662,282.026383,96.657107,3,0
0,0,7,7,11,15,26,36,24,60,0.000333,0.094009,5,1410.131915,78.340662,282.026383,96.657107,3,0
0,0,9,9,14,17,31,49,32,81,0.000333,0.133763,7,2809.029308,156.057184,401.289901,122.789837,4,0
0,0,9,9,14,17,31,49,32,81,0.000333,0.133763,7,2809.029308,156.057184,401.289901,122.789837,4,0
0,0,7,7,11,15,26,36,24,60,0.000333,0.094009,5,1410.131915,78.340662,282.026383,96.657107,3,0
0,0,7,7,11,15,26,36,24,60,0.000333,0.094009,5,1410.131915,78.340662,282.026383,96.657107,3,0
0,0,9,9,14,17,31,49,32,81,0.000333,0.133763,7,2809.029308,156.057184,401.289901,122.789837,4,0
0,0,9,9,14,17,31,49,32,81,0.000333,0.133763,7,2809.029308,156.057184,401.289901,122.789837,4,0
0,0,7,7,11,15,26,36,24,60,0.000333,0.094009,5,1410.131915,78.340662,282.026383,96.657107,3,0
0,0,7,7,11,15,26,36,24,60,0.000333,0.094009,5,1410.131915,78.340662,282.026383,96.657107,3,0
0,0,9,9,14,17,31,49,32,81,0.000333,0.133763,7,2809.029308,156.057184,401.289901,122.789837,4,0
0,0,9,9,14,17,31,49,32,81,0.000333,0.133763,7,2809.029308,156.057184,401.289901,122.789837,4,0
0,0,7,7,11,15,26,36,24,60,0.000333,0.094009,5,1410.131915,78.340662,282.026383,96.657107,3,0
0,0,7,7,11,15,26,36,24,60,0.000333,0.094009,5,1410.131915,78.340662,282.026383,96.657107,3,0
0,0,9,9,14,17,31,49,32,81,0.000333,0.133763,7,2809.029308,156.057184,401.289901,122.789837,4,0
0,0,9,9,14,17,31,49,32,81,0.000333,0.133763,7,2809.029308,156.057184,401.289901,122.789837,4,0
0,0,7,7,11,15,26,36,24,60,0.000333,0.094009,5,1410.131915,78.340662,282.026383,96.657107,3,0
0,0,7,7,11,15,26,36,24,60,0.000333,0.094009,5,1410.131915,78.340662,282.026383,96.657107,3,0
0,0,9,9,14,17,31,49,32,81,0.000333,0.133763,7,2809.029308,156.057184,401.289901,122.789837,4,0
0,0,9,9,14,17,31,49,32,81,0.000333,0.133763,7,2809.029308,156.057184,401.289901,122.789837,4,0
0,0,7,7,11,15,26,36,24,60,0.000333,0.094009,5,1410.131915,78.340662,282.026383,96.657107,3,0
0,0,7,7,11,15,26,36,24,60,0.000333,0.094009,5,1410.131915,78.340662,282.026383,96.657107,3,0
0,0,9,9,14,17,31,49,32,81,0.000333,0.133763,7,2809.029308,156.057184,401.289901,122.789837,4,0
0,0,9,9,14,17,31,49,32,81,0.000333,0.133763,7,2809.029308,156.057184,401.289901,122.789837,4,0
0,0,7,7,11,15,26,36,24,60,0.000333,0.094009,5,1410.131915,78.340662,282.026383,96.657107,3,0
0,0,7,7,11,15,26,36,24,60,0.000333,0.094009,5,1410.131915,78.340662,282.026383,96.657107,3,0
0,0,9,9,14,17,31,49,32,81,0.000333,0.133763,7,2809.029308,156.057184,401.289901,122.789837,4,0
0,0,9,9,14,17,31,49,32,81,0.000333,0.133763,7,2809.029308,156.057184,401.289901,122.789837,4,0
0,0,7,7,11,15,26,36,24,60,0.000333,0.094009,5,1410.131915,78.340662,282.026383,96.657107,3,0
0,0,7,7,11,15,26,36,24,60,0.000333,0.094009,5,1410.131915,78.340662,282.026383,96.657107,3,0
0,0,9,9,14,17,31,49,32,81,0.000333,0.133763,7,2809.029308,156.057184,401.289901,122.789837,4,0
0,0,9,9,14,17,31,49,32,81,0.000333,0.133763,7,2809.029308,156.057184,401.289901,122.789837,4,0
0,0,7,7,11,15,26,36,24,60,0.000333,0.094009,5,1410.131915,78.340662,282.026383,96.657107,3,0
0,0,7,7,11,15,26,36,24,60,0.000333,0.094009,5,1410.131915,78.340662,282.026383,96.657107,3,0
0,0,9,9,14,17,31,49,32,81,0.000333,0.133763,7,2809.029308,156.057184,401.289901,122.789837,4,0
0,0,9,9,14,17,31,49,32,81,0.000333,0.133763,7,2809.029308,156.057184,401.289901,122.789837,4,0
0,0,7,7,11,15,26,36,24,60,0.000333,0.094009,5,1410.131915,78.340662,282.026383,96.657107,3,0
0,0,7,7,11,15,26,36,24,60,0.000333,0.094009,5,1410.131915,78.340662,282.026383,96.657107,3,0
0,0,7,7,11,15,26,36,24,60,0.000333,0.094009,5,1410.131915,78.340662,282.026383,96.657107,3,0
0,0,12,12,14,17,31,67,45,112,0.000333,0.184957,14,7768.179815,431.565545,554.869987,122.789837,5,0
0,0,12,12,14,17,31,67,45,112,0.000333,0.184957,14,7768.179815,431.565545,554.869987,122.789837,5,0
0,0,10,10,14,18,32,51,34,85,0.000333,0.141667,7,2975,165.277778,425,128.361619,4,0
0,0,7,7,11,15,26,36,24,60,0.000333,0.094009,5,1410.131915,78.340662,282.026383,96.657107,3,0
0,0,7,7,11,15,26,36,24,60,0.000333,0.094009,5,1410.131915,78.340662,282.026383,96.657107,3,0
0,0,9,9,14,17,31,49,32,81,0.000333,0.133763,7,2809.029308,156.057184,401.289901,122.789837,4,0
0,0,9,9,14,17,31,49,32,81,0.000333,0.133763,7,2809.029308,156.057184,401.289901,122.789837,4,0
0,0,7,7,11,15,26,36,24,60,0.000333,0.094009,5,1410.131915,78.340662,282.026383,96.657107,3,0
0,0,7,7,11,15,26,36,24,60,0.000333,0.094009,5,1410.131915,78.340662,282.026383,96.657107,3,0
0,0,9,9,14,17,31,49,32,81,0.000333,0.133763,7,2809.029308,156.057184,401.289901,122.789837,4,0
0,0,9,9,14,17,31,49,32,81,0.000333,0.133763,7,2809.029308,156.057184,401.289901,122.789837,4,0
0,0,7,7,11,15,26,36,24,60,0.000333,0.094009,5,1410.131915,78.340662,282.026383,96.657107,3,0
0,0,7,7,11,15,26,36,24,60,0.000333,0.094009,5,1410.131915,78.340662,282.026383,96.657107,3,0
0,0,9,9,14,17,31,49,32,81,0.000333,0.133763,7,2809.029308,156.057184,401.289901,122.789837,4,0
0,0,9,9,14,17,31,49,32,81,0.000333,0.133763,7,2809.029308,156.057184,401.289901,122.789837,4,0
0,0,7,7,11,15,26,36,24,60,0.000333,0.094009,5,1410.131915,78.340662,282.026383,96.657107,3,0
0,0,7,7,11,12,23,33,21,54,0.000333,0.081424,5,1221.361728,67.853429,244.272346,81.073298,3,0
0,0,7,7,11,15,26,36,24,60,0.000333,0.094009,5,1410.131915,78.340662,282.026383,96.657107,3,0
0,0,7,7,11,12,23,33,21,54,0.000333,0.081424,5,1221.361728,67.853429,244.272346,81.073298,3,0
0,0,7,7,11,15,26,36,24,60,0.000333,0.094009,5,1410.131915,78.340662,282.026383,96.657107,3,0
0,0,6,6,11,11,22,31,19,50,0.000333,0.074324,5,1114.857905,61.93655,222.971581,76.107496,3,0
0,0,7,7,11,15,26,36,24,60,0.000333,0.094009,5,1410.131915,78.340662,282.026383,96.657107,3,0
0,0,7,7,11,15,26,36,24,60,0.000333,0.094009,5,1410.131915,78.340662,282.026383,96.657107,3,0
0,0,11,11,15,22,37,55,42,97,0.000333,0.168439,7,3537.218835,196.512158,505.316976,156.710855,4,0
0,0,11,11,15,22,37,55,42,97,0.000333,0.168439,7,3537.218835,196.512158,505.316976,156.710855,4,0
0,0,7,7,11,15,26,36,24,60,0.000333,0.094009,5,1410.131915,78.340662,282.026383,96.657107,3,0
0,0,7,7,11,15,26,36,24,60,0.000333,0.094009,5,1410.131915,78.340662,282.026383,96.657107,3,0
0,0,6,6,11,17,28,31,25,56,0.000333,0.089737,5,1346.059378,74.781077,269.211876,107.540616,3,0
0,0,6,6,11,17,28,31,25,56,0.000333,0.089737,5,1346.059378,74.781077,269.211876,107.540616,3,0
0,0,7,7,11,15,26,36,24,60,0.000333,0.094009,5,1410.131915,78.340662,282.026383,96.657107,3,0
0,0,11,11,14,19,33,53,38,91,0.000333,0.153013,14,6426.558108,357.031006,459.039865,134.013592,4,0
0,0,7,7,11,15,26,36,24,60,0.000333,0.094009,5,1410.131915,78.340662,282.026383,96.657107,3,0
0,0,7,7,12,12,24,36,23,59,0.000333,0.090171,6,1623.076725,90.170929,270.512788,86.0391,3,0
0,0,7,7,11,15,26,36,24,60,0.000333,0.094009,5,1410.131915,78.340662,282.026383,96.657107,3,0
0,0,7,7,12,16,28,33,25,58,0.000333,0.092942,6,1672.959513,92.942195,278.826585,107.01955,3,0
0,0,7,7,11,15,26,36,24,60,0.000333,0.094009,5,1410.131915,78.340662,282.026383,96.657107,3,0
0,0,11,11,15,21,36,55,40,95,0.000333,0.163714,7,3438.000126,191.000007,491.142875,150.842025,4,0
0,0,7,7,11,15,26,36,24,60,0.000333,0.094009,5,1410.131915,78.340662,282.026383,96.657107,3,0
0,0,19,19,16,20,36,93,64,157,0.000333,0.270559,24,19480.27741,1082.237634,811.678225,150.438562,5,0
0,0,7,7,11,15,26,36,24,60,0.000333,0.094009,5,1410.131915,78.340662,282.026383,96.657107,3,0
0,0,6,6,12,14,26,32,22,54,0.000333,0.084608,6,1522.942469,84.607915,253.823745,96.322519,3,0
0,0,7,7,11,15,26,36,24,60,0.000333,0.094009,5,1410.131915,78.340662,282.026383,96.657107,3,0
0,0,12,12,14,24,38,54,45,99,0.000333,0.173182,7,3636.813767,202.045209,519.544824,163.342069,4,0
0,0,7,7,11,15,26,36,24,60,0.000333,0.094009,5,1410.131915,78.340662,282.026383,96.657107,3,0
0,0,11,11,14,23,37,54,44,98,0.000333,0.170175,7,3573.685009,198.538056,510.52643,157.344894,4,0
0,0,7,7,11,15,26,36,24,60,0.000333,0.094009,5,1410.131915,78.340662,282.026383,96.657107,3,0
0,0,8,8,11,17,28,36,36,72,0.000333,0.115377,10,3461.295544,192.294197,346.129554,107.540616,3,0
0,0,7,7,11,15,26,36,24,60,0.000333,0.094009,5,1410.131915,78.340662,282.026383,96.657107,3,0
0,0,8,8,11,17,28,36,36,72,0.000333,0.115377,10,3461.295544,192.294197,346.129554,107.540616,3,0
0,0,7,7,11,15,26,36,24,60,0.000333,0.094009,5,1410.131915,78.340662,282.026383,96.657107,3,0
0,0,8,8,11,17,28,36,36,72,0.000333,0.115377,10,3461.295544,192.294197,346.129554,107.540616,3,0
0,0,7,7,11,15,26,36,24,60,0.000333,0.094009,5,1410.131915,78.340662,282.026383,96.657107,3,0
0,0,20,20,15,22,37,96,76,172,0.000333,0.298675,21,18816.54556,1045.363642,896.025979,156.710855,5,0
0,0,7,7,11,15,26,36,24,60,0.000333,0.094009,5,1410.131915,78.340662,282.026383,96.657107,3,0
0,0,12,12,15,24,39,59,47,106,0.000333,0.186751,7,3921.768446,217.876025,560.252635,168.642459,4,0
0,0,7,7,11,15,26,36,24,60,0.000333,0.094009,5,1410.131915,78.340662,282.026383,96.657107,3,0
0,0,13,13,15,25,40,67,51,118,0.000333,0.209329,14,8791.825213,488.434734,627.987515,174.699764,4,0
0,0,7,7,11,15,26,36,24,60,0.000333,0.094009,5,1410.131915,78.340662,282.026383,96.657107,3,0
0,0,6,6,11,16,27,31,24,55,0.000333,0.087173,5,1307.594063,72.644115,261.518813,102.053748,3,0
0,0,6,6,13,13,26,33,21,54,0.000333,0.084608,6,1522.942469,84.607915,253.823745,96.211433,3,0
0,0,13,13,14,25,39,64,51,115,0.000333,0.202607,14,8509.497572,472.749865,607.821255,169.399374,4,0
0,0,7,7,11,15,26,36,24,60,0.000333,0.094009,5,1410.131915,78.340662,282.026383,96.657107,3,0
0,0,14,14,15,26,41,61,57,118,0.000333,0.21073,14,8850.675912,491.704217,632.191137,180.814792,4,0
0,0,3,3,8,8,16,10,12,22,0.000333,0.029333,4,352,19.555556,88,48,1,0
0,0,3,3,8,7,15,10,11,21,0.000333,0.027348,4,328.17881,18.232156,82.044703,43.651484,1,0
0,0,3,3,8,8,16,10,12,22,0.000333,0.029333,4,352,19.555556,88,48,1,0
0,0,3,3,8,7,15,10,11,21,0.000333,0.027348,4,328.17881,18.232156,82.044703,43.651484,1,0
0,0,3,3,8,8,16,10,12,22,0.000333,0.029333,4,352,19.555556,88,48,1,0
0,0,3,3,8,8,16,10,12,22,0.000333,0.029333,4,352,19.555556,88,48,1,0
0,0,2,2,7,7,14,8,13,21,0.000333,0.026651,3,239.86336,13.325742,79.954453,39.302969,1,0
0,0,2,2,7,5,12,8,9,17,0.000333,0.020315,3,182.833088,10.157394,60.944363,31.261125,1,0
0,0,2,2,7,7,14,8,13,21,0.000333,0.026651,3,239.86336,13.325742,79.954453,39.302969,1,0
0,0,2,2,7,7,14,8,13,21,0.000333,0.026651,3,239.86336,13.325742,79.954453,39.302969,1,0
0,0,2,2,7,5,12,8,9,17,0.000333,0.020315,3,182.833088,10.157394,60.944363,31.261125,1,0
0,0,2,2,7,7,14,8,13,21,0.000333,0.026651,3,239.86336,13.325742,79.954453,39.302969,1,0
0,0,7,7,11,15,26,36,24,60,0.000333,0.094009,5,1410.131915,78.340662,282.026383,96.657107,3,0
0,0,7,7,13,13,26,38,22,60,0.000333,0.094009,6,1692.158299,94.008794,282.026383,96.211433,3,0
0,0,7,7,11,15,26,36,24,60,0.000333,0.094009,5,1410.131915,78.340662,282.026383,96.657107,3,0
0,0,7,7,11,15,26,36,24,60,0.000333,0.094009,5,1410.131915,78.340662,282.026383,96.657107,3,0
0,0,7,7,13,13,26,38,22,60,0.000333,0.094009,6,1692.158299,94.008794,282.026383,96.211433,3,0
0,0,7,7,13,13,26,38,22,60,0.000333,0.094009,6,1692.158299,94.008794,282.026383,96.211433,3,0
0,0,7,7,11,15,26,36,24,60,0.000333,0.094009,5,1410.131915,78.340662,282.026383,96.657107,3,0
0,0,7,7,11,15,26,36,24,60,0.000333,0.094009,5,1410.131915,78.340662,282.026383,96.657107,3,0
0,0,7,7,13,13,26,38,22,60,0.000333,0.094009,6,1692.158299,94.008794,282.026383,96.211433,3,0
0,0,7,7,13,13,26,38,22,60,0.000333,0.094009,6,1692.158299,94.008794,282.026383,96.211433,3,0
0,0,7,7,11,15,26,36,24,60,0.000333,0.094009,5,1410.131915,78.340662,282.026383,96.657107,3,0
0,0,7,7,11,15,26,36,24,60,0.000333,0.094009,5,1410.131915,78.340662,282.026383,96.657107,3,0
0,0,7,7,13,13,26,38,22,60,0.000333,0.094009,6,1692.158299,94.008794,282.026383,96.211433,3,0
0,0,7,7,13,13,26,38,22,60,0.000333,0.094009,6,1692.158299,94.008794,282.026383,96.211433,3,0
0,0,7,7,11,15,26,36,24,60,0.000333,0.094009,5,1410.131915,78.340662,282.026383,96.657107,3,0
0,0,7,7,11,15,26,36,24,60,0.000333,0.094009,5,1410.131915,78.340662,282.026383,96.657107,3,0
0,0,7,7,13,13,26,38,22,60,0.000333,0.094009,6,1692.158299,94.008794,282.026383,96.211433,3,0
0,0,7,7,13,13,26,38,22,60,0.000333,0.094009,6,1692.158299,94.008794,282.026383,96.211433,3,0
0,0,7,7,11,15,26,36,24,60,0.000333,0.094009,5,1410.131915,78.340662,282.026383,96.657107,3,0
0,0,7,7,11,15,26,36,24,60,0.000333,0.094009,5,1410.131915,78.340662,282.026383,96.657107,3,0
0,0,7,7,13,13,26,38,22,60,0.000333,0.094009,6,1692.158299,94.008794,282.026383,96.211433,3,0
0,0,7,7,13,13,26,38,22,60,0.000333,0.094009,6,1692.158299,94.008794,282.026383,96.211433,3,0
0,0,7,7,11,15,26,36,24,60,0.000333,0.094009,5,1410.131915,78.340662,282.026383,96.657107,3,0
0,0,7,7,11,15,26,36,24,60,0.000333,0.094009,5,1410.131915,78.340662,282.026383,96.657107,3,0
0,0,7,7,13,13,26,38,22,60,0.000333,0.094009,6,1692.158299,94.008794,282.026383,96.211433,3,0
0,0,7,7,13,13,26,38,22,60,0.000333,0.094009,6,1692.158299,94.008794,282.026383,96.211433,3,0
0,0,7,7,11,15,26,36,24,60,0.000333,0.094009,5,1410.131915,78.340662,282.026383,96.657107,3,0
0,0,7,7,11,15,26,36,24,60,0.000333,0.094009,5,1410.131915,78.340662,282.026383,96.657107,3,0
0,0,7,7,13,13,26,38,22,60,0.000333,0.094009,6,1692.158299,94.008794,282.026383,96.211433,3,0
0,0,7,7,13,13,26,38,22,60,0.000333,0.094009,6,1692.158299,94.008794,282.026383,96.211433,3,0
0,0,7,7,11,15,26,36,24,60,0.000333,0.094009,5,1410.131915,78.340662,282.026383,96.657107,3,0
0,0,7,7,11,15,26,36,24,60,0.000333,0.094009,5,1410.131915,78.340662,282.026383,96.657107,3,0
0,0,7,7,13,13,26,38,22,60,0.000333,0.094009,6,1692.158299,94.008794,282.026383,96.211433,3,0
0,0,7,7,13,13,26,38,22,60,0.000333,0.094009,6,1692.158299,94.008794,282.026383,96.211433,3,0
0,0,7,7,11,15,26,36,24,60,0.000333,0.094009,5,1410.131915,78.340662,282.026383,96.657107,3,0
0,0,7,7,11,15,26,36,24,60,0.000333,0.094009,5,1410.131915,78.340662,282.026383,96.657107,3,0
0,0,7,7,13,13,26,38,22,60,0.000333,0.094009,6,1692.158299,94.008794,282.026383,96.211433,3,0
0,0,7,7,13,13,26,38,22,60,0.000333,0.094009,6,1692.158299,94.008794,282.026383,96.211433,3,0
0,0,7,7,11,15,26,36,24,60,0.000333,0.094009,5,1410.131915,78.340662,282.026383,96.657107,3,0
0,0,7,7,11,15,26,36,24,60,0.000333,0.094009,5,1410.131915,78.340662,282.026383,96.657107,3,0
0,0,7,7,13,13,26,38,22,60,0.000333,0.094009,6,1692.158299,94.008794,282.026383,96.211433,3,0
0,0,7,7,13,13,26,38,22,60,0.000333,0.094009,6,1692.158299,94.008794,282.026383,96.211433,3,0
0,0,7,7,11,15,26,36,24,60,0.000333,0.094009,5,1410.131915,78.340662,282.026383,96.657107,3,0
0,0,7,7,11,15,26,36,24,60,0.000333,0.094009,5,1410.131915,78.340662,282.026383,96.657107,3,0
0,0,7,7,11,15,26,36,24,60,0.000333,0.094009,5,1410.131915,78.340662,282.026383,96.657107,3,0
0,0,8,8,13,14,27,40,24,64,0.000333,0.101438,6,1825.876801,101.4376,304.3128,101.408685,3,0
0,0,8,8,13,13,26,45,25,70,0.000333,0.109677,6,1974.184682,109.676927,329.03078,96.211433,3,0
0,0,8,8,13,13,26,45,25,70,0.000333,0.109677,6,1974.184682,109.676927,329.03078,96.211433,3,0
0,0,7,7,11,15,26,36,24,60,0.000333,0.094009,5,1410.131915,78.340662,282.026383,96.657107,3,0
0,0,7,7,11,15,26,36,24,60,0.000333,0.094009,5,1410.131915,78.340662,282.026383,96.657107,3,0
0,0,7,7,13,13,26,38,22,60,0.000333,0.094009,6,1692.158299,94.008794,282.026383,96.211433,3,0
0,0,7,7,13,13,26,38,22,60,0.000333,0.094009,6,1692.158299,94.008794,282.026383,96.211433,3,0
0,0,7,7,11,15,26,36,24,60,0.000333,0.094009,5,1410.131915,78.340662,282.026383,96.657107,3,0
0,0,7,7,11,15,26,36,24,60,0.000333,0.094009,5,1410.131915,78.340662,282.026383,96.657107,3,0
0,0,7,7,13,13,26,38,22,60,0.000333,0.094009,6,1692.158299,94.008794,282.026383,96.211433,3,0
0,0,7,7,13,13,26,38,22,60,0.000333,0.094009,6,1692.158299,94.008794,282.026383,96.211433,3,0
0,0,7,7,11,15,26,36,24,60,0.000333,0.094009,5,1410.131915,78.340662,282.026383,96.657107,3,0
0,0,7,7,11,15,26,36,24,60,0.000333,0.094009,5,1410.131915,78.340662,282.026383,96.657107,3,0
0,0,7,7,13,13,26,38,22,60,0.000333,0.094009,6,1692.158299,94.008794,282.026383,96.211433,3,0
0,0,7,7,13,13,26,38,22,60,0.000333,0.094009,6,1692.158299,94.008794,282.026383,96.211433,3,0
0,0,7,7,11,15,26,36,24,60,0.000333,0.094009,5,1410.131915,78.340662,282.026383,96.657107,3,0
0,0,7,7,11,12,23,33,21,54,0.000333,0.081424,5,1221.361728,67.853429,244.272346,81.073298,3,0
0,0,7,7,11,15,26,36,24,60,0.000333,0.094009,5,1410.131915,78.340662,282.026383,96.657107,3,0
0,0,7,7,11,12,23,33,21,54,0.000333,0.081424,5,1221.361728,67.853429,244.272346,81.073298,3,0
0,0,7,7,11,15,26,36,24,60,0.000333,0.094009,5,1410.131915,78.340662,282.026383,96.657107,3,0
0,0,6,6,11,11,22,31,19,50,0.000333,0.074324,5,1114.857905,61.93655,222.971581,76.107496,3,0
0,0,7,7,11,15,26,36,24,60,0.000333,0.094009,5,1410.131915,78.340662,282.026383,96.657107,3,0
0,0,7,7,11,15,26,36,24,60,0.000333,0.094009,5,1410.131915,78.340662,282.026383,96.657107,3,0
0,0,9,9,14,18,32,44,32,76,0.000333,0.126667,7,2660,147.777778,380,128.361619,3,0
0,0,9,9,14,18,32,44,32,76,0.000333,0.126667,7,2660,147.777778,380,128.361619,3,0
0,0,7,7,11,15,26,36,24,60,0.000333,0.094009,5,1410.131915,78.340662,282.026383,96.657107,3,0
0,0,7,7,11,15,26,36,24,60,0.000333,0.094009,5,1410.131915,78.340662,282.026383,96.657107,3,0
0,0,6,6,11,17,28,31,25,56,0.000333,0.089737,5,1346.059378,74.781077,269.211876,107.540616,3,0
0,0,6,6,11,17,28,31,25,56,0.000333,0.089737,5,1346.059378,74.781077,269.211876,107.540616,3,0
0,0,7,7,11,15,26,36,24,60,0.000333,0.094009,5,1410.131915,78.340662,282.026383,96.657107,3,0
0,0,9,9,13,15,28,42,28,70,0.000333,0.112172,6,2019.089067,112.171615,336.514845,106.709075,3,0
0,0,7,7,11,15,26,36,24,60,0.000333,0.094009,5,1410.131915,78.340662,282.026383,96.657107,3,0
0,0,7,7,12,12,24,36,23,59,0.000333,0.090171,6,1623.076725,90.170929,270.512788,86.0391,3,0
0,0,7,7,11,15,26,36,24,60,0.000333,0.094009,5,1410.131915,78.340662,282.026383,96.657107,3,0
0,0,7,7,12,16,28,33,25,58,0.000333,0.092942,6,1672.959513,92.942195,278.826585,107.01955,3,0
0,0,7,7,11,15,26,36,24,60,0.000333,0.094009,5,1410.131915,78.340662,282.026383,96.657107,3,0
0,0,9,9,14,17,31,44,30,74,0.000333,0.122204,7,2566.273689,142.57076,366.610527,122.789837,3,0
0,0,7,7,11,15,26,36,24,60,0.000333,0.094009,5,1410.131915,78.340662,282.026383,96.657107,3,0
0,0,16,16,15,16,31,74,49,123,0.000333,0.203122,21,12796.68907,710.927171,609.366146,122.603359,3,0
0,0,7,7,11,15,26,36,24,60,0.000333,0.094009,5,1410.131915,78.340662,282.026383,96.657107,3,0
0,0,6,6,12,14,26,32,22,54,0.000333,0.084608,6,1522.942469,84.607915,253.823745,96.322519,3,0
0,0,7,7,11,15,26,36,24,60,0.000333,0.094009,5,1410.131915,78.340662,282.026383,96.657107,3,0
0,0,10,10,13,20,33,43,35,78,0.000333,0.131154,6,2360.776448,131.154247,393.462741,134.544278,3,0
0,0,7,7,11,15,26,36,24,60,0.000333,0.094009,5,1410.131915,78.340662,282.026383,96.657107,3,0
0,0,9,9,13,19,32,43,34,77,0.000333,0.128333,6,2310,128.333333,385,128.816339,3,0
0,0,7,7,11,15,26,36,24,60,0.000333,0.094009,5,1410.131915,78.340662,282.026383,96.657107,3,0
0,0,8,8,11,17,28,36,36,72,0.000333,0.115377,10,3461.295544,192.294197,346.129554,107.540616,3,0
0,0,7,7,11,15,26,36,24,60,0.000333,0.094009,5,1410.131915,78.340662,282.026383,96.657107,3,0
0,0,8,8,11,17,28,36,36,72,0.000333,0.115377,10,3461.295544,192.294197,346.129554,107.540616,3,0
0,0,7,7,11,15,26,36,24,60,0.000333,0.094009,5,1410.131915,78.340662,282.026383,96.657107,3,0
0,0,8,8,11,17,28,36,36,72,0.000333,0.115377,10,3461.295544,192.294197,346.129554,107.540616,3,0
0,0,7,7,11,15,26,36,24,60,0.000333,0.094009,5,1410.131915,78.340662,282.026383,96.657107,3,0
0,0,17,17,14,18,32,77,61,138,0.000333,0.23,21,14490,805,690,128.361619,3,0
0,0,7,7,11,15,26,36,24,60,0.000333,0.094009,5,1410.131915,78.340662,282.026383,96.657107,3,0
0,0,10,10,13,20,33,48,37,85,0.000333,0.142925,6,2572.641001,142.9245,428.7735,134.544278,3,0
0,0,7,7,11,15,26,36,24,60,0.000333,0.094009,5,1410.131915,78.340662,282.026383,96.657107,3,0
0,0,11,11,13,21,34,56,41,97,0.000333,0.164495,6,2960.903374,164.494632,493.483896,140.344382,3,0
0,0,7,7,11,15,26,36,24,60,0.000333,0.094009,5,1410.131915,78.340662,282.026383,96.657107,3,0
0,0,6,6,11,16,27,31,24,55,0.000333,0.087173,5,1307.594063,72.644115,261.518813,102.053748,3,0
0,0,6,6,13,13,26,33,21,54,0.000333,0.084608,6,1522.942469,84.607915,253.823745,96.211433,3,0
0,0,11,11,15,21,36,53,41,94,0.000333,0.161991,7,3401.810651,188.989481,485.97295,150.842025,3,0
0,0,7,7,11,15,26,36,24,60,0.000333,0.094009,5,1410.131915,78.340662,282.026383,96.657107,3,0
0,0,12,12,14,22,36,50,47,97,0.000333,0.167161,14,7020.758152,390.04212,501.482725,151.410465,3,0
0,0,7,7,11,15,26,36,24,60,0.000333,0.094009,5,1410.131915,78.340662,282.026383,96.657107,3,0
0,0,10,10,13,20,33,43,37,80,0.000333,0.134517,6,2421.309177,134.517177,403.55153,134.544278,3,0
0,0,3,3,8,7,15,10,11,21,0.000333,0.027348,4,328.17881,18.232156,82.044703,43.651484,1,0
0,0,3,3,8,8,16,10,12,22,0.000333,0.029333,4,352,19.555556,88,48,1,0
0,0,3,3,8,8,16,10,12,22,0.000333,0.029333,4,352,19.555556,88,48,1,0
0,0,3,3,8,7,15,10,11,21,0.000333,0.027348,4,328.17881,18.232156,82.044703,43.651484,1,0
0,0,3,3,8,8,16,10,12,22,0.000333,0.029333,4,352,19.555556,88,48,1,0
0,0,3,3,8,8,16,10,12,22,0.000333,0.029333,4,352,19.555556,88,48,1,0
0,0,2,2,7,7,14,8,13,21,0.000333,0.026651,3,239.86336,13.325742,79.954453,39.302969,1,0
0,0,2,2,7,5,12,8,9,17,0.000333,0.020315,3,182.833088,10.157394,60.944363,31.261125,1,0
0,0,2,2,7,7,14,8,13,21,0.000333,0.026651,3,239.86336,13.325742,79.954453,39.302969,1,0
0,0,2,2,7,7,14,8,13,21,0.000333,0.026651,3,239.86336,13.325742,79.954453,39.302969,1,0
0,0,2,2,7,5,12,8,9,17,0.000333,0.020315,3,182.833088,10.157394,60.944363,31.261125,1,0
0,0,2,2,7,7,14,8,13,21,0.000333,0.026651,3,239.86336,13.325742,79.954453,39.302969,1,0
0,0,7,7,11,15,26,36,24,60,0.000333,0.094009,5,1410.131915,78.340662,282.026383,96.657107,3,0
0,0,9,9,14,19,33,50,34,84,0.000333,0.141243,7,2966.103742,164.783541,423.729106,134.013592,3,0
0,0,7,7,11,15,26,36,24,60,0.000333,0.094009,5,1410.131915,78.340662,282.026383,96.657107,3,0
0,0,7,7,11,15,26,36,24,60,0.000333,0.094009,5,1410.131915,78.340662,282.026383,96.657107,3,0
0,0,8,8,13,15,28,41,26,67,0.000333,0.107364,6,1932.556679,107.36426,322.09278,106.709075,3,0
0,0,8,8,13,15,28,41,26,67,0.000333,0.107364,6,1932.556679,107.36426,322.09278,106.709075,3,0
0,0,7,7,11,15,26,36,24,60,0.000333,0.094009,5,1410.131915,78.340662,282.026383,96.657107,3,0
0,0,7,7,11,15,26,36,24,60,0.000333,0.094009,5,1410.131915,78.340662,282.026383,96.657107,3,0
0,0,8,8,13,15,28,41,26,67,0.000333,0.107364,6,1932.556679,107.36426,322.09278,106.709075,3,0
0,0,8,8,13,15,28,41,26,67,0.000333,0.107364,6,1932.556679,107.36426,322.09278,106.709075,3,0
0,0,7,7,11,15,26,36,24,60,0.000333,0.094009,5,1410.131915,78.340662,282.026383,96.657107,3,0
0,0,7,7,11,15,26,36,24,60,0.000333,0.094009,5,1410.131915,78.340662,282.026383,96.657107,3,0
0,0,8,8,13,15,28,41,26,67,0.000333,0.107364,6,1932.556679,107.36426,322.09278,106.709075,3,0
0,0,8,8,13,15,28,41,26,67,0.000333,0.107364,6,1932.556679,107.36426,322.09278,106.709075,3,0
0,0,7,7,11,15,26,36,24,60,0.000333,0.094009,5,1410.131915,78.340662,282.026383,96.657107,3,0
0,0,7,7,11,15,26,36,24,60,0.000333,0.094009,5,1410.131915,78.340662,282.026383,96.657107,3,0
0,0,8,8,13,15,28,41,26,67,0.000333,0.107364,6,1932.556679,107.36426,322.09278,106.709075,3,0
0,0,8,8,13,15,28,41,26,67,0.000333,0.107364,6,1932.556679,107.36426,322.09278,106.709075,3,0
0,0,7,7,11,15,26,36,24,60,0.000333,0.094009,5,1410.131915,78.340662,282.026383,96.657107,3,0
0,0,7,7,11,15,26,36,24,60,0.000333,0.094009,5,1410.131915,78.340662,282.026383,96.657107,3,0
0,0,8,8,13,15,28,41,26,67,0.000333,0.107364,6,1932.556679,107.36426,322.09278,106.709075,3,0
0,0,8,8,13,15,28,41,26,67,0.000333,0.107364,6,1932.556679,107.36426,322.09278,106.709075,3,0
0,0,7,7,11,15,26,36,24,60,0.000333,0.094009,5,1410.131915,78.340662,282.026383,96.657107,3,0
0,0,7,7,11,15,26,36,24,60,0.000333,0.094009,5,1410.131915,78.340662,282.026383,96.657107,3,0
0,0,8,8,13,15,28,41,26,67,0.000333,0.107364,6,1932.556679,107.36426,322.09278,106.709075,3,0
0,0,8,8,13,15,28,41,26,67,0.000333,0.107364,6,1932.556679,107.36426,322.09278,106.709075,3,0
0,0,7,7,11,15,26,36,24,60,0.000333,0.094009,5,1410.131915,78.340662,282.026383,96.657107,3,0
0,0,7,7,11,15,26,36,24,60,0.000333,0.094009,5,1410.131915,78.340662,282.026383,96.657107,3,0
0,0,8,8,13,15,28,41,26,67,0.000333,0.107364,6,1932.556679,107.36426,322.09278,106.709075,3,0
0,0,8,8,13,15,28,41,26,67,0.000333,0.107364,6,1932.556679,107.36426,322.09278,106.709075,3,0
0,0,7,7,11,15,26,36,24,60,0.000333,0.094009,5,1410.131915,78.340662,282.026383,96.657107,3,0
0,0,7,7,11,15,26,36,24,60,0.000333,0.094009,5,1410.131915,78.340662,282.026383,96.657107,3,0
0,0,8,8,13,15,28,41,26,67,0.000333,0.107364,6,1932.556679,107.36426,322.09278,106.709075,3,0
0,0,8,8,13,15,28,41,26,67,0.000333,0.107364,6,1932.556679,107.36426,322.09278,106.709075,3,0
0,0,7,7,11,15,26,36,24,60,0.000333,0.094009,5,1410.131915,78.340662,282.026383,96.657107,3,0
0,0,7,7,11,15,26,36,24,60,0.000333,0.094009,5,1410.131915,78.340662,282.026383,96.657107,3,0
0,0,8,8,13,15,28,41,26,67,0.000333,0.107364,6,1932.556679,107.36426,322.09278,106.709075,3,0
0,0,8,8,13,15,28,41,26,67,0.000333,0.107364,6,1932.556679,107.36426,322.09278,106.709075,3,0
0,0,7,7,11,15,26,36,24,60,0.000333,0.094009,5,1410.131915,78.340662,282.026383,96.657107,3,0
0,0,7,7,11,15,26,36,24,60,0.000333,0.094009,5,1410.131915,78.340662,282.026383,96.657107,3,0
0,0,8,8,13,15,28,41,26,67,0.000333,0.107364,6,1932.556679,107.36426,322.09278,106.709075,3,0
0,0,8,8,13,15,28,41,26,67,0.000333,0.107364,6,1932.556679,107.36426,322.09278,106.709075,3,0
0,0,7,7,11,15,26,36,24,60,0.000333,0.094009,5,1410.131915,78.340662,282.026383,96.657107,3,0
0,0,7,7,11,15,26,36,24,60,0.000333,0.094009,5,1410.131915,78.340662,282.026383,96.657107,3,0
0,0,7,7,11,15,26,36,24,60,0.000333,0.094009,5,1410.131915,78.340662,282.026383,96.657107,3,0
0,0,11,11,14,19,33,60,41,101,0.000333,0.169828,14,7132.773285,396.265182,509.483806,134.013592,3,0
0,0,11,11,14,19,33,60,41,101,0.000333,0.169828,14,7132.773285,396.265182,509.483806,134.013592,3,0
0,0,10,10,14,20,34,52,36,88,0.000333,0.149232,7,3133.87711,174.104284,447.69673,139.741531,3,0
0,0,7,7,11,15,26,36,24,60,0.000333,0.094009,5,1410.131915,78.340662,282.026383,96.657107,3,0
0,0,7,7,11,15,26,36,24,60,0.000333,0.094009,5,1410.131915,78.340662,282.026383,96.657107,3,0
0,0,8,8,13,15,28,41,26,67,0.000333,0.107364,6,1932.556679,107.36426,322.09278,106.709075,3,0
0,0,8,8,13,15,28,41,26,67,0.000333,0.107364,6,1932.556679,107.36426,322.09278,106.709075,3,0
0,0,7,7,11,15,26,36,24,60,0.000333,0.094009,5,1410.131915,78.340662,282.026383,96.657107,3,0
0,0,7,7,11,15,26,36,24,60,0.000333,0.094009,5,1410.131915,78.340662,282.026383,96.657107,3,0
0,0,8,8,13,15,28,41,26,67,0.000333,0.107364,6,1932.556679,107.36426,322.09278,106.709075,3,0
0,0,8,8,13,15,28,41,26,67,0.000333,0.107364,6,1932.556679,107.36426,322.09278,106.709075,3,0
0,0,7,7,11,15,26,36,24,60,0.000333,0.094009,5,1410.131915,78.340662,282.026383,96.657107,3,0
0,0,7,7,11,15,26,36,24,60,0.000333,0.094009,5,1410.131915,78.340662,282.026383,96.657107,3,0
0,0,8,8,13,15,28,41,26,67,0.000333,0.107364,6,1932.556679,107.36426,322.09278,106.709075,3,0
0,0,8,8,13,15,28,41,26,67,0.000333,0.107364,6,1932.556679,107.36426,322.09278,106.709075,3,0
0,0,7,7,11,15,26,36,24,60,0.000333,0.094009,5,1410.131915,78.340662,282.026383,96.657107,3,0
0,0,7,7,11,12,23,33,21,54,0.000333,0.081424,5,1221.361728,67.853429,244.272346,81.073298,3,0
0,0,7,7,11,15,26,36,24,60,0.000333,0.094009,5,1410.131915,78.340662,282.026383,96.657107,3,0
0,0,7,7,11,12,23,33,21,54,0.000333,0.081424,5,1221.361728,67.853429,244.272346,81.073298,3,0
0,0,7,7,11,15,26,36,24,60,0.000333,0.094009,5,1410.131915,78.340662,282.026383,96.657107,3,0
0,0,6,6,11,11,22,31,19,50,0.000333,0.074324,5,1114.857905,61.93655,222.971581,76.107496,3,0
0,0,7,7,11,15,26,36,24,60,0.000333,0.094009,5,1410.131915,78.340662,282.026383,96.657107,3,0
0,0,7,7,11,15,26,36,24,60,0.000333,0.094009,5,1410.131915,78.340662,282.026383,96.657107,3,0
0,0,11,11,15,24,39,56,44,100,0.000333,0.17618,7,3699.781553,205.54342,528.540222,168.642459,3,0
0,0,11,11,15,24,39,56,44,100,0.000333,0.17618,7,3699.781553,205.54342,528.540222,168.642459,3,0
0,0,7,7,11,15,26,36,24,60,0.000333,0.094009,5,1410.131915,78.340662,282.026383,96.657107,3,0
0,0,7,7,11,15,26,36,24,60,0.000333,0.094009,5,1410.131915,78.340662,282.026383,96.657107,3,0
0,0,6,6,11,17,28,31,25,56,0.000333,0.089737,5,1346.059378,74.781077,269.211876,107.540616,3,0
0,0,6,6,11,17,28,31,25,56,0.000333,0.089737,5,1346.059378,74.781077,269.211876,107.540616,3,0
0,0,7,7,11,15,26,36,24,60,0.000333,0.094009,5,1410.131915,78.340662,282.026383,96.657107,3,0
0,0,11,11,14,21,35,54,40,94,0.000333,0.160718,7,3375.068225,187.50379,482.152604,145.541635,3,0
0,0,7,7,11,15,26,36,24,60,0.000333,0.094009,5,1410.131915,78.340662,282.026383,96.657107,3,0
0,0,7,7,12,12,24,36,23,59,0.000333,0.090171,6,1623.076725,90.170929,270.512788,86.0391,3,0
0,0,7,7,11,15,26,36,24,60,0.000333,0.094009,5,1410.131915,78.340662,282.026383,96.657107,3,0
0,0,7,7,12,16,28,33,25,58,0.000333,0.092942,6,1672.959513,92.942195,278.826585,107.01955,3,0
0,0,7,7,11,15,26,36,24,60,0.000333,0.094009,5,1410.131915,78.340662,282.026383,96.657107,3,0
0,0,11,11,15,23,38,56,42,98,0.000333,0.171432,7,3600.078274,200.004349,514.296896,162.645284,3,0
0,0,7,7,11,15,26,36,24,60,0.000333,0.094009,5,1410.131915,78.340662,282.026383,96.657107,3,0
0,0,11,11,15,21,36,56,39,95,0.000333,0.163714,7,3438.000126,191.000007,491.142875,150.842025,3,0
0,0,7,7,11,15,26,36,24,60,0.000333,0.094009,5,1410.131915,78.340662,282.026383,96.657107,3,0
0,0,6,6,12,14,26,32,22,54,0.000333,0.084608,6,1522.942469,84.607915,253.823745,96.322519,3,0
0,0,7,7,11,15,26,36,24,60,0.000333,0.094009,5,1410.131915,78.340662,282.026383,96.657107,3,0
0,0,12,12,14,26,40,55,47,102,0.000333,0.180946,7,3799.85666,211.103148,542.836666,175.514402,3,0
0,0,7,7,11,15,26,36,24,60,0.000333,0.094009,5,1410.131915,78.340662,282.026383,96.657107,3,0
0,0,11,11,14,25,39,55,46,101,0.000333,0.177942,7,3736.779369,207.598854,533.825624,169.399374,3,0
0,0,7,7,11,15,26,36,24,60,0.000333,0.094009,5,1410.131915,78.340662,282.026383,96.657107,3,0
0,0,8,8,11,17,28,36,36,72,0.000333,0.115377,10,3461.295544,192.294197,346.129554,107.540616,3,0
0,0,7,7,11,15,26,36,24,60,0.000333,0.094009,5,1410.131915,78.340662,282.026383,96.657107,3,0
0,0,8,8,11,17,28,36,36,72,0.000333,0.115377,10,3461.295544,192.294197,346.129554,107.540616,3,0
0,0,7,7,11,15,26,36,24,60,0.000333,0.094009,5,1410.131915,78.340662,282.026383,96.657107,3,0
0,0,8,8,11,17,28,36,36,72,0.000333,0.115377,10,3461.295544,192.294197,346.129554,107.540616,3,0
0,0,7,7,11,15,26,36,24,60,0.000333,0.094009,5,1410.131915,78.340662,282.026383,96.657107,3,0
0,0,11,11,15,23,38,56,41,97,0.000333,0.169683,7,3563.342782,197.963488,509.048969,162.645284,3,0
0,0,7,7,11,15,26,36,24,60,0.000333,0.094009,5,1410.131915,78.340662,282.026383,96.657107,3,0
0,0,12,12,15,26,41,60,49,109,0.000333,0.194658,7,4087.81218,227.100677,583.973169,180.814792,3,0
0,0,7,7,11,15,26,36,24,60,0.000333,0.094009,5,1410.131915,78.340662,282.026383,96.657107,3,0
0,0,13,13,15,27,42,68,53,121,0.000333,0.21749,7,4567.292857,253.738492,652.470408,186.985321,3,0
0,0,7,7,11,15,26,36,24,60,0.000333,0.094009,5,1410.131915,78.340662,282.026383,96.657107,3,0
0,0,6,6,11,16,27,31,24,55,0.000333,0.087173,5,1307.594063,72.644115,261.518813,102.053748,3,0
0,0,6,6,13,13,26,33,21,54,0.000333,0.084608,6,1522.942469,84.607915,253.823745,96.211433,3,0
0,0,13,13,14,27,41,65,53,118,0.000333,0.21073,7,4425.337956,245.852109,632.191137,181.684931,3,0
0,0,7,7,11,15,26,36,24,60,0.000333,0.094009,5,1410.131915,78.340662,282.026383,96.657107,3,0
0,0,12,12,14,24,38,51,49,100,0.000333,0.174931,14,7347.098519,408.17214,524.792751,163.342069,3,0
0,0,7,7,11,15,26,36,24,60,0.000333,0.094009,5,1410.131915,78.340662,282.026383,96.657107,3,0
0,0,12,12,14,26,40,55,49,104,0.000333,0.184494,7,3874.363653,215.242425,553.480522,175.514402,3,0
0,0,3,3,8,8,16,10,12,22,0.000333,0.029333,4,352,19.555556,88,48,1,0
0,0,3,3,8,7,15,10,11,21,0.000333,0.027348,4,328.17881,18.232156,82.044703,43.651484,1,0
0,0,3,3,8,8,16,10,12,22,0.000333,0.029333,4,352,19.555556,88,48,1,0
0,0,3,3,8,8,16,10,12,22,0.000333,0.029333,4,352,19.555556,88,48,1,0
0,0,3,3,8,7,15,10,11,21,0.000333,0.027348,4,328.17881,18.232156,82.044703,43.651484,1,0
0,0,3,3,8,8,16,10,12,22,0.000333,0.029333,4,352,19.555556,88,48,1,0
0,0,2,2,7,5,12,8,9,17,0.000333,0.020315,3,182.833088,10.157394,60.944363,31.261125,1,0
0,0,2,2,7,7,14,8,13,21,0.000333,0.026651,3,239.86336,13.325742,79.954453,39.302969,1,0
0,0,2,2,7,7,14,8,13,21,0.000333,0.026651,3,239.86336,13.325742,79.954453,39.302969,1,0
0,0,2,2,7,7,14,8,13,21,0.000333,0.026651,3,239.86336,13.325742,79.954453,39.302969,1,0
0,0,2,2,7,5,12,8,9,17,0.000333,0.020315,3,182.833088,10.157394,60.944363,31.261125,1,0
0,0,2,2,7,7,14,8,13,21,0.000333,0.026651,3,239.86336,13.325742,79.954453,39.302969,1,0
0,0,7,7,11,15,26,36,24,60,0.000333,0.094009,5,1410.131915,78.340662,282.026383,96.657107,3,0
0,0,6,6,11,11,22,31,19,50,0.000333,0.074324,5,1114.857905,61.93655,222.971581,76.107496,3,0
0,0,7,7,11,15,26,36,24,60,0.000333,0.094009,5,1410.131915,78.340662,282.026383,96.657107,3,0
0,0,7,7,11,15,26,36,24,60,0.000333,0.094009,5,1410.131915,78.340662,282.026383,96.657107,3,0
0,0,7,7,11,12,23,33,21,54,0.000333,0.081424,5,1221.361728,67.853429,244.272346,81.073298,3,0
0,0,7,7,11,12,23,33,21,54,0.000333,0.081424,5,1221.361728,67.853429,244.272346,81.073298,3,0
0,0,7,7,11,15,26,36,24,60,0.000333,0.094009,5,1410.131915,78.340662,282.026383,96.657107,3,0
0,0,7,7,11,15,26,36,24,60,0.000333,0.094009,5,1410.131915,78.340662,282.026383,96.657107,3,0
0,0,7,7,11,12,23,33,21,54,0.000333,0.081424,5,1221.361728,67.853429,244.272346,81.073298,3,0
0,0,7,7,11,12,23,33,21,54,0.000333,0.081424,5,1221.361728,67.853429,244.272346,81.073298,3,0
0,0,7,7,11,15,26,36,24,60,0.000333,0.094009,5,1410.131915,78.340662,282.026383,96.657107,3,0
0,0,7,7,11,15,26,36,24,60,0.000333,0.094009,5,1410.131915,78.340662,282.026383,96.657107,3,0
0,0,7,7,11,12,23,33,21,54,0.000333,0.081424,5,1221.361728,67.853429,244.272346,81.073298,3,0
0,0,7,7,11,12,23,33,21,54,0.000333,0.081424,5,1221.361728,67.853429,244.272346,81.073298,3,0
0,0,7,7,11,15,26,36,24,60,0.000333,0.094009,5,1410.131915,78.340662,282.026383,96.657107,3,0
0,0,7,7,11,15,26,36,24,60,0.000333,0.094009,5,1410.131915,78.340662,282.026383,96.657107,3,0
0,0,7,7,11,12,23,33,21,54,0.000333,0.081424,5,1221.361728,67.853429,244.272346,81.073298,3,0
0,0,7,7,11,12,23,33,21,54,0.000333,0.081424,5,1221.361728,67.853429,244.272346,81.073298,3,0
0,0,7,7,11,15,26,36,24,60,0.000333,0.094009,5,1410.131915,78.340662,282.026383,96.657107,3,0
0,0,7,7,11,15,26,36,24,60,0.000333,0.094009,5,1410.131915,78.340662,282.026383,96.657107,3,0
0,0,7,7,11,12,23,33,21,54,0.000333,0.081424,5,1221.361728,67.853429,244.272346,81.073298,3,0
0,0,7,7,11,12,23,33,21,54,0.000333,0.081424,5,1221.361728,67.853429,244.272346,81.073298,3,0
0,0,7,7,11,15,26,36,24,60,0.000333,0.094009,5,1410.131915,78.340662,282.026383,96.657107,3,0
0,0,7,7,11,15,26,36,24,60,0.000333,0.094009,5,1410.131915,78.340662,282.026383,96.657107,3,0
0,0,7,7,11,12,23,33,21,54,0.000333,0.081424,5,1221.361728,67.853429,244.272346,81.073298,3,0
0,0,7,7,11,12,23,33,21,54,0.000333,0.081424,5,1221.361728,67.853429,244.272346,81.073298,3,0
0,0,7,7,11,15,26,36,24,60,0.000333,0.094009,5,1410.131915,78.340662,282.026383,96.657107,3,0
0,0,7,7,11,15,26,36,24,60,0.000333,0.094009,5,1410.131915,78.340662,282.026383,96.657107,3,0
0,0,7,7,11,12,23,33,21,54,0.000333,0.081424,5,1221.361728,67.853429,244.272346,81.073298,3,0
0,0,7,7,11,12,23,33,21,54,0.000333,0.081424,5,1221.361728,67.853429,244.272346,81.073298,3,0
0,0,7,7,11,15,26,36,24,60,0.000333,0.094009,5,1410.131915,78.340662,282.026383,96.657107,3,0
0,0,7,7,11,15,26,36,24,60,0.000333,0.094009,5,1410.131915,78.340662,282.026383,96.657107,3,0
0,0,7,7,11,12,23,33,21,54,0.000333,0.081424,5,1221.361728,67.853429,244.272346,81.073298,3,0
0,0,7,7,11,12,23,33,21,54,0.000333,0.081424,5,1221.361728,67.853429,244.272346,81.073298,3,0
0,0,7,7,11,15,26,36,24,60,0.000333,0.094009,5,1410.131915,78.340662,282.026383,96.657107,3,0
0,0,7,7,11,15,26,36,24,60,0.000333,0.094009,5,1410.131915,78.340662,282.026383,96.657107,3,0
0,0,7,7,11,12,23,33,21,54,0.000333,0.081424,5,1221.361728,67.853429,244.272346,81.073298,3,0
0,0,7,7,11,12,23,33,21,54,0.000333,0.081424,5,1221.361728,67.853429,244.272346,81.073298,3,0
0,0,7,7,11,15,26,36,24,60,0.000333,0.094009,5,1410.131915,78.340662,282.026383,96.657107,3,0
0,0,7,7,11,15,26,36,24,60,0.000333,0.094009,5,1410.131915,78.340662,282.026383,96.657107,3,0
0,0,7,7,11,12,23,33,21,54,0.000333,0.081424,5,1221.361728,67.853429,244.272346,81.073298,3,0
0,0,7,7,11,12,23,33,21,54,0.000333,0.081424,5,1221.361728,67.853429,244.272346,81.073298,3,0
0,0,7,7,11,15,26,36,24,60,0.000333,0.094009,5,1410.131915,78.340662,282.026383,96.657107,3,0
0,0,7,7,11,15,26,36,24,60,0.000333,0.094009,5,1410.131915,78.340662,282.026383,96.657107,3,0
0,0,7,7,11,15,26,36,24,60,0.000333,0.094009,5,1410.131915,78.340662,282.026383,96.657107,3,0
0,0,7,7,11,12,23,33,21,54,0.000333,0.081424,5,1221.361728,67.853429,244.272346,81.073298,3,0
0,0,7,7,11,11,22,33,21,54,0.000333,0.08027,5,1204.046537,66.891474,240.809307,76.107496,3,0
0,0,7,7,11,11,22,33,21,54,0.000333,0.08027,5,1204.046537,66.891474,240.809307,76.107496,3,0
0,0,7,7,11,15,26,36,24,60,0.000333,0.094009,5,1410.131915,78.340662,282.026383,96.657107,3,0
0,0,7,7,11,15,26,36,24,60,0.000333,0.094009,5,1410.131915,78.340662,282.026383,96.657107,3,0
0,0,7,7,11,12,23,33,21,54,0.000333,0.081424,5,1221.361728,67.853429,244.272346,81.073298,3,0
0,0,7,7,11,12,23,33,21,54,0.000333,0.081424,5,1221.361728,67.853429,244.272346,81.073298,3,0
0,0,7,7,11,15,26,36,24,60,0.000333,0.094009,5,1410.131915,78.340662,282.026383,96.657107,3,0
0,0,7,7,11,15,26,36,24,60,0.000333,0.094009,5,1410.131915,78.340662,282.026383,96.657107,3,0
0,0,7,7,11,12,23,33,21,54,0.000333,0.081424,5,1221.361728,67.853429,244.272346,81.073298,3,0
0,0,7,7,11,12,23,33,21,54,0.000333,0.081424,5,1221.361728,67.853429,244.272346,81.073298,3,0
0,0,7,7,11,15,26,36,24,60,0.000333,0.094009,5,1410.131915,78.340662,282.026383,96.657107,3,0
0,0,7,7,11,15,26,36,24,60,0.000333,0.094009,5,1410.131915,78.340662,282.026383,96.657107,3,0
0,0,7,7,11,12,23,33,21,54,0.000333,0.081424,5,1221.361728,67.853429,244.272346,81.073298,3,0
0,0,7,7,11,12,23,33,21,54,0.000333,0.081424,5,1221.361728,67.853429,244.272346,81.073298,3,0
0,0,7,7,11,15,26,36,24,60,0.000333,0.094009,5,1410.131915,78.340662,282.026383,96.657107,3,0
0,0,7,7,11,12,23,33,21,54,0.000333,0.081424,5,1221.361728,67.853429,244.272346,81.073298,3,0
0,0,7,7,11,15,26,36,24,60,0.000333,0.094009,5,1410.131915,78.340662,282.026383,96.657107,3,0
0,0,7,7,11,12,23,33,21,54,0.000333,0.081424,5,1221.361728,67.853429,244.272346,81.073298,3,0
0,0,7,7,11,15,26,36,24,60,0.000333,0.094009,5,1410.131915,78.340662,282.026383,96.657107,3,0
0,0,6,6,11,11,22,31,19,50,0.000333,0.074324,5,1114.857905,61.93655,222.971581,76.107496,3,0
0,0,7,7,11,15,26,36,24,60,0.000333,0.094009,5,1410.131915,78.340662,282.026383,96.657107,3,0
0,0,7,7,11,15,26,36,24,60,0.000333,0.094009,5,1410.131915,78.340662,282.026383,96.657107,3,0
0,0,8,8,12,16,28,37,29,66,0.000333,0.105762,6,1903.712549,105.761808,317.285425,107.01955,3,0
0,0,8,8,12,16,28,37,29,66,0.000333,0.105762,6,1903.712549,105.761808,317.285425,107.01955,3,0
0,0,7,7,11,15,26,36,24,60,0.000333,0.094009,5,1410.131915,78.340662,282.026383,96.657107,3,0
0,0,7,7,11,15,26,36,24,60,0.000333,0.094009,5,1410.131915,78.340662,282.026383,96.657107,3,0
0,0,6,6,11,17,28,31,25,56,0.000333,0.089737,5,1346.059378,74.781077,269.211876,107.540616,3,0
0,0,6,6,11,17,28,31,25,56,0.000333,0.089737,5,1346.059378,74.781077,269.211876,107.540616,3,0
0,0,7,7,11,15,26,36,24,60,0.000333,0.094009,5,1410.131915,78.340662,282.026383,96.657107,3,0
0,0,8,8,11,13,24,35,25,60,0.000333,0.091699,5,1375.48875,76.416042,275.09775,86.159464,3,0
0,0,7,7,11,15,26,36,24,60,0.000333,0.094009,5,1410.131915,78.340662,282.026383,96.657107,3,0
0,0,7,7,12,12,24,36,23,59,0.000333,0.090171,6,1623.076725,90.170929,270.512788,86.0391,3,0
0,0,7,7,11,15,26,36,24,60,0.000333,0.094009,5,1410.131915,78.340662,282.026383,96.657107,3,0
0,0,7,7,12,16,28,33,25,58,0.000333,0.092942,6,1672.959513,92.942195,278.826585,107.01955,3,0
0,0,7,7,11,15,26,36,24,60,0.000333,0.094009,5,1410.131915,78.340662,282.026383,96.657107,3,0
0,0,8,8,12,15,27,37,27,64,0.000333,0.101438,6,1825.876801,101.4376,304.3128,101.622909,3,0
0,0,7,7,11,15,26,36,24,60,0.000333,0.094009,5,1410.131915,78.340662,282.026383,96.657107,3,0
0,0,8,8,12,13,25,37,24,61,0.000333,0.094425,6,1699.651365,94.425076,283.275228,91.125266,3,0
0,0,7,7,11,15,26,36,24,60,0.000333,0.094009,5,1410.131915,78.340662,282.026383,96.657107,3,0
0,0,6,6,12,14,26,32,22,54,0.000333,0.084608,6,1522.942469,84.607915,253.823745,96.322519,3,0
0,0,7,7,11,15,26,36,24,60,0.000333,0.094009,5,1410.131915,78.340662,282.026383,96.657107,3,0
0,0,9,9,11,18,29,36,32,68,0.000333,0.110114,5,1651.713538,91.761863,330.342708,113.112398,3,0
0,0,7,7,11,15,26,36,24,60,0.000333,0.094009,5,1410.131915,78.340662,282.026383,96.657107,3,0
0,0,8,8,11,17,28,36,31,67,0.000333,0.107364,5,1610.463899,89.470217,322.09278,107.540616,3,0
0,0,7,7,11,15,26,36,24,60,0.000333,0.094009,5,1410.131915,78.340662,282.026383,96.657107,3,0
0,0,8,8,11,17,28,36,36,72,0.000333,0.115377,10,3461.295544,192.294197,346.129554,107.540616,3,0
0,0,7,7,11,15,26,36,24,60,0.000333,0.094009,5,1410.131915,78.340662,282.026383,96.657107,3,0
0,0,8,8,11,17,28,36,36,72,0.000333,0.115377,10,3461.295544,192.294197,346.129554,107.540616,3,0
0,0,7,7,11,15,26,36,24,60,0.000333,0.094009,5,1410.131915,78.340662,282.026383,96.657107,3,0
0,0,8,8,11,17,28,36,36,72,0.000333,0.115377,10,3461.295544,192.294197,346.129554,107.540616,3,0
0,0,7,7,11,15,26,36,24,60,0.000333,0.094009,5,1410.131915,78.340662,282.026383,96.657107,3,0
0,0,8,8,12,15,27,37,26,63,0.000333,0.099853,6,1797.347476,99.852638,299.557913,101.622909,3,0
0,0,7,7,11,15,26,36,24,60,0.000333,0.094009,5,1410.131915,78.340662,282.026383,96.657107,3,0
0,0,9,9,12,18,30,41,34,75,0.000333,0.122672,6,2208.100768,122.672265,368.016795,118.0782,3,0
0,0,7,7,11,15,26,36,24,60,0.000333,0.094009,5,1410.131915,78.340662,282.026383,96.657107,3,0
0,0,10,10,12,19,31,49,38,87,0.000333,0.143672,12,5172.180948,287.343386,431.015079,123.730173,3,0
0,0,6,6,13,13,26,33,21,54,0.000333,0.084608,6,1522.942469,84.607915,253.823745,96.211433,3,0
0,0,6,6,11,16,27,31,24,55,0.000333,0.087173,5,1307.594063,72.644115,261.518813,102.053748,3,0
0,0,6,6,13,13,26,33,21,54,0.000333,0.084608,6,1522.942469,84.607915,253.823745,96.211433,3,0
0,0,10,10,13,19,32,46,38,84,0.000333,0.14,12,5040,280,420,128.816339,3,0
0,0,7,7,11,15,26,36,24,60,0.000333,0.094009,5,1410.131915,78.340662,282.026383,96.657107,3,0
0,0,11,11,12,20,32,43,44,87,0.000333,0.145,12,5220,290,435,129.458112,3,0
0,0,7,7,11,15,26,36,24,60,0.000333,0.094009,5,1410.131915,78.340662,282.026383,96.657107,3,0
0,0,9,9,11,18,29,36,34,70,0.000333,0.113353,5,1700.293348,94.460742,340.05867,113.112398,3,0
0,0,3,3,8,8,16,10,12,22,0.000333,0.029333,4,352,19.555556,88,48,1,0
0,0,3,3,8,7,15,10,11,21,0.000333,0.027348,4,328.17881,18.232156,82.044703,43.651484,1,0
0,0,3,3,8,8,16,10,12,22,0.000333,0.029333,4,352,19.555556,88,48,1,0
0,0,3,3,8,7,15,10,11,21,0.000333,0.027348,4,328.17881,18.232156,82.044703,43.651484,1,0
0,0,3,3,8,8,16,10,12,22,0.000333,0.029333,4,352,19.555556,88,48,1,0
0,0,3,3,8,8,16,10,12,22,0.000333,0.029333,4,352,19.555556,88,48,1,0
0,0,2,2,7,7,14,8,13,21,0.000333,0.026651,3,239.86336,13.325742,79.954453,39.302969,1,0
0,0,2,2,7,5,12,8,9,17,0.000333,0.020315,3,182.833088,10.157394,60.944363,31.261125,1,0
0,0,2,2,7,7,14,8,13,21,0.000333,0.026651,3,239.86336,13.325742,79.954453,39.302969,1,0
0,0,2,2,7,7,14,8,13,21,0.000333,0.026651,3,239.86336,13.325742,79.954453,39.302969,1,0
0,0,2,2,7,5,12,8,9,17,0.000333,0.020315,3,182.833088,10.157394,60.944363,31.261125,1,0
0,0,2,2,7,7,14,8,13,21,0.000333,0.026651,3,239.86336,13.325742,79.954453,39.302969,1,0
0,0,7,7,11,15,26,36,24,60,0.000333,0.094009,5,1410.131915,78.340662,282.026383,96.657107,3,0
0,0,9,9,14,20,34,50,34,84,0.000333,0.142449,7,2991.428151,166.190453,427.346879,139.741531,3,0
0,0,7,7,11,15,26,36,24,60,0.000333,0.094009,5,1410.131915,78.340662,282.026383,96.657107,3,0
0,0,7,7,11,15,26,36,24,60,0.000333,0.094009,5,1410.131915,78.340662,282.026383,96.657107,3,0
0,0,8,8,13,15,28,41,26,67,0.000333,0.107364,6,1932.556679,107.36426,322.09278,106.709075,3,0
0,0,8,8,13,15,28,41,26,67,0.000333,0.107364,6,1932.556679,107.36426,322.09278,106.709075,3,0
0,0,7,7,11,15,26,36,24,60,0.000333,0.094009,5,1410.131915,78.340662,282.026383,96.657107,3,0
0,0,7,7,11,15,26,36,24,60,0.000333,0.094009,5,1410.131915,78.340662,282.026383,96.657107,3,0
0,0,8,8,13,15,28,41,26,67,0.000333,0.107364,6,1932.556679,107.36426,322.09278,106.709075,3,0
0,0,8,8,13,15,28,41,26,67,0.000333,0.107364,6,1932.556679,107.36426,322.09278,106.709075,3,0
0,0,7,7,11,15,26,36,24,60,0.000333,0.094009,5,1410.131915,78.340662,282.026383,96.657107,3,0
0,0,7,7,11,15,26,36,24,60,0.000333,0.094009,5,1410.131915,78.340662,282.026383,96.657107,3,0
0,0,8,8,13,15,28,41,26,67,0.000333,0.107364,6,1932.556679,107.36426,322.09278,106.709075,3,0
0,0,8,8,13,15,28,41,26,67,0.000333,0.107364,6,1932.556679,107.36426,322.09278,106.709075,3,0
0,0,7,7,11,15,26,36,24,60,0.000333,0.094009,5,1410.131915,78.340662,282.026383,96.657107,3,0
0,0,7,7,11,15,26,36,24,60,0.000333,0.094009,5,1410.131915,78.340662,282.026383,96.657107,3,0
0,0,8,8,13,15,28,41,26,67,0.000333,0.107364,6,1932.556679,107.36426,322.09278,106.709075,3,0
0,0,8,8,13,15,28,41,26,67,0.000333,0.107364,6,1932.556679,107.36426,322.09278,106.709075,3,0
0,0,7,7,11,15,26,36,24,60,0.000333,0.094009,5,1410.131915,78.340662,282.026383,96.657107,3,0
0,0,7,7,11,15,26,36,24,60,0.000333,0.094009,5,1410.131915,78.340662,282.026383,96.657107,3,0
0,0,8,8,13,15,28,41,26,67,0.000333,0.107364,6,1932.556679,107.36426,322.09278,106.709075,3,0
0,0,8,8,13,15,28,41,26,67,0.000333,0.107364,6,1932.556679,107.36426,322.09278,106.709075,3,0
0,0,7,7,11,15,26,36,24,60,0.000333,0.094009,5,1410.131915,78.340662,282.026383,96.657107,3,0
0,0,7,7,11,15,26,36,24,60,0.000333,0.094009,5,1410.131915,78.340662,282.026383,96.657107,3,0
0,0,8,8,13,15,28,41,26,67,0.000333,0.107364,6,1932.556679,107.36426,322.09278,106.709075,3,0
0,0,8,8,13,15,28,41,26,67,0.000333,0.107364,6,1932.556679,107.36426,322.09278,106.709075,3,0
0,0,7,7,11,15,26,36,24,60,0.000333,0.094009,5,1410.131915,78.340662,282.026383,96.657107,3,0
0,0,7,7,11,15,26,36,24,60,0.000333,0.094009,5,1410.131915,78.340662,282.026383,96.657107,3,0
0,0,8,8,13,15,28,41,26,67,0.000333,0.107364,6,1932.556679,107.36426,322.09278,106.709075,3,0
0,0,8,8,13,15,28,41,26,67,0.000333,0.107364,6,1932.556679,107.36426,322.09278,106.709075,3,0
0,0,7,7,11,15,26,36,24,60,0.000333,0.094009,5,1410.131915,78.340662,282.026383,96.657107,3,0
0,0,7,7,11,15,26,36,24,60,0.000333,0.094009,5,1410.131915,78.340662,282.026383,96.657107,3,0
0,0,8,8,13,15,28,41,26,67,0.000333,0.107364,6,1932.556679,107.36426,322.09278,106.709075,3,0
0,0,8,8,13,15,28,41,26,67,0.000333,0.107364,6,1932.556679,107.36426,322.09278,106.709075,3,0
0,0,7,7,11,15,26,36,24,60,0.000333,0.094009,5,1410.131915,78.340662,282.026383,96.657107,3,0
0,0,7,7,11,15,26,36,24,60,0.000333,0.094009,5,1410.131915,78.340662,282.026383,96.657107,3,0
0,0,8,8,13,15,28,41,26,67,0.000333,0.107364,6,1932.556679,107.36426,322.09278,106.709075,3,0
0,0,8,8,13,15,28,41,26,67,0.000333,0.107364,6,1932.556679,107.36426,322.09278,106.709075,3,0
0,0,7,7,11,15,26,36,24,60,0.000333,0.094009,5,1410.131915,78.340662,282.026383,96.657107,3,0
0,0,7,7,11,15,26,36,24,60,0.000333,0.094009,5,1410.131915,78.340662,282.026383,96.657107,3,0
0,0,8,8,13,15,28,41,26,67,0.000333,0.107364,6,1932.556679,107.36426,322.09278,106.709075,3,0
0,0,8,8,13,15,28,41,26,67,0.000333,0.107364,6,1932.556679,107.36426,322.09278,106.709075,3,0
0,0,7,7,11,15,26,36,24,60,0.000333,0.094009,5,1410.131915,78.340662,282.026383,96.657107,3,0
0,0,7,7,11,15,26,36,24,60,0.000333,0.094009,5,1410.131915,78.340662,282.026383,96.657107,3,0
0,0,7,7,11,15,26,36,24,60,0.000333,0.094009,5,1410.131915,78.340662,282.026383,96.657107,3,0
0,0,10,10,14,21,35,52,36,88,0.000333,0.150459,7,3159.638338,175.535463,451.376905,145.541635,3,0
0,0,11,11,14,20,34,60,41,101,0.000333,0.171278,14,7193.672458,399.64847,513.833747,139.741531,3,0
0,0,11,11,14,20,34,60,41,101,0.000333,0.171278,14,7193.672458,399.64847,513.833747,139.741531,3,0
0,0,7,7,11,15,26,36,24,60,0.000333,0.094009,5,1410.131915,78.340662,282.026383,96.657107,3,0
0,0,7,7,11,15,26,36,24,60,0.000333,0.094009,5,1410.131915,78.340662,282.026383,96.657107,3,0
0,0,8,8,13,15,28,41,26,67,0.000333,0.107364,6,1932.556679,107.36426,322.09278,106.709075,3,0
0,0,8,8,13,15,28,41,26,67,0.000333,0.107364,6,1932.556679,107.36426,322.09278,106.709075,3,0
0,0,7,7,11,15,26,36,24,60,0.000333,0.094009,5,1410.131915,78.340662,282.026383,96.657107,3,0
0,0,7,7,11,15,26,36,24,60,0.000333,0.094009,5,1410.131915,78.340662,282.026383,96.657107,3,0
0,0,8,8,13,15,28,41,26,67,0.000333,0.107364,6,1932.556679,107.36426,322.09278,106.709075,3,0
0,0,8,8,13,15,28,41,26,67,0.000333,0.107364,6,1932.556679,107.36426,322.09278,106.709075,3,0
0,0,7,7,11,15,26,36,24,60,0.000333,0.094009,5,1410.131915,78.340662,282.026383,96.657107,3,0
0,0,7,7,11,15,26,36,24,60,0.000333,0.094009,5,1410.131915,78.340662,282.026383,96.657107,3,0
0,0,8,8,13,15,28,41,26,67,0.000333,0.107364,6,1932.556679,107.36426,322.09278,106.709075,3,0
0,0,8,8,13,15,28,41,26,67,0.000333,0.107364,6,1932.556679,107.36426,322.09278,106.709075,3,0
0,0,7,7,11,15,26,36,24,60,0.000333,0.094009,5,1410.131915,78.340662,282.026383,96.657107,3,0
0,0,7,7,11,12,23,33,21,54,0.000333,0.081424,5,1221.361728,67.853429,244.272346,81.073298,3,0
0,0,7,7,11,15,26,36,24,60,0.000333,0.094009,5,1410.131915,78.340662,282.026383,96.657107,3,0
0,0,7,7,11,12,23,33,21,54,0.000333,0.081424,5,1221.361728,67.853429,244.272346,81.073298,3,0
0,0,7,7,11,15,26,36,24,60,0.000333,0.094009,5,1410.131915,78.340662,282.026383,96.657107,3,0
0,0,6,6,11,11,22,31,19,50,0.000333,0.074324,5,1114.857905,61.93655,222.971581,76.107496,3,0
0,0,7,7,11,15,26,36,24,60,0.000333,0.094009,5,1410.131915,78.340662,282.026383,96.657107,3,0
0,0,7,7,11,15,26,36,24,60,0.000333,0.094009,5,1410.131915,78.340662,282.026383,96.657107,3,0
0,0,11,11,15,25,40,56,44,100,0.000333,0.177398,7,3725.349666,206.96387,532.192809,174.699764,3,0
0,0,11,11,15,25,40,56,44,100,0.000333,0.177398,7,3725.349666,206.96387,532.192809,174.699764,3,0
0,0,7,7,11,15,26,36,24,60,0.000333,0.094009,5,1410.131915,78.340662,282.026383,96.657107,3,0
0,0,7,7,11,15,26,36,24,60,0.000333,0.094009,5,1410.131915,78.340662,282.026383,96.657107,3,0
0,0,6,6,11,17,28,31,25,56,0.000333,0.089737,5,1346.059378,74.781077,269.211876,107.540616,3,0
0,0,6,6,11,17,28,31,25,56,0.000333,0.089737,5,1346.059378,74.781077,269.211876,107.540616,3,0
0,0,7,7,11,15,26,36,24,60,0.000333,0.094009,5,1410.131915,78.340662,282.026383,96.657107,3,0
0,0,11,11,14,22,36,54,40,94,0.000333,0.161991,7,3401.810651,188.989481,485.97295,151.410465,3,0
0,0,7,7,11,15,26,36,24,60,0.000333,0.094009,5,1410.131915,78.340662,282.026383,96.657107,3,0
0,0,7,7,12,12,24,36,23,59,0.000333,0.090171,6,1623.076725,90.170929,270.512788,86.0391,3,0
0,0,7,7,11,15,26,36,24,60,0.000333,0.094009,5,1410.131915,78.340662,282.026383,96.657107,3,0
0,0,7,7,12,16,28,33,25,58,0.000333,0.092942,6,1672.959513,92.942195,278.826585,107.01955,3,0
0,0,7,7,11,15,26,36,24,60,0.000333,0.094009,5,1410.131915,78.340662,282.026383,96.657107,3,0
0,0,11,11,15,24,39,56,42,98,0.000333,0.172656,7,3625.785922,201.432551,517.969417,168.642459,3,0
0,0,7,7,11,15,26,36,24,60,0.000333,0.094009,5,1410.131915,78.340662,282.026383,96.657107,3,0
0,0,11,11,15,22,37,56,39,95,0.000333,0.164966,7,3464.286488,192.46036,494.89807,156.710855,3,0
0,0,7,7,11,15,26,36,24,60,0.000333,0.094009,5,1410.131915,78.340662,282.026383,96.657107,3,0
0,0,6,6,12,14,26,32,22,54,0.000333,0.084608,6,1522.942469,84.607915,253.823745,96.322519,3,0
0,0,7,7,11,15,26,36,24,60,0.000333,0.094009,5,1410.131915,78.340662,282.026383,96.657107,3,0
0,0,12,12,14,27,41,55,47,102,0.000333,0.182157,7,3825.292131,212.51623,546.470304,181.684931,3,0
0,0,7,7,11,15,26,36,24,60,0.000333,0.094009,5,1410.131915,78.340662,282.026383,96.657107,3,0
0,0,11,11,14,26,40,55,46,101,0.000333,0.179172,7,3762.603163,209.033509,537.514738,175.514402,3,0
0,0,7,7,11,15,26,36,24,60,0.000333,0.094009,5,1410.131915,78.340662,282.026383,96.657107,3,0
0,0,8,8,11,17,28,36,36,72,0.000333,0.115377,10,3461.295544,192.294197,346.129554,107.540616,3,0
0,0,7,7,11,15,26,36,24,60,0.000333,0.094009,5,1410.131915,78.340662,282.026383,96.657107,3,0
0,0,8,8,11,17,28,36,36,72,0.000333,0.115377,10,3461.295544,192.294197,346.129554,107.540616,3,0
0,0,7,7,11,15,26,36,24,60,0.000333,0.094009,5,1410.131915,78.340662,282.026383,96.657107,3,0
0,0,8,8,11,17,28,36,36,72,0.000333,0.115377,10,3461.295544,192.294197,346.129554,107.540616,3,0
0,0,7,7,11,15,26,36,24,60,0.000333,0.094009,5,1410.131915,78.340662,282.026383,96.657107,3,0
0,0,11,11,15,24,39,56,41,97,0.000333,0.170895,7,3588.788107,199.377117,512.684015,168.642459,3,0
0,0,7,7,11,15,26,36,24,60,0.000333,0.094009,5,1410.131915,78.340662,282.026383,96.657107,3,0
0,0,12,12,15,27,42,60,49,109,0.000333,0.195921,7,4114.338194,228.574344,587.762599,186.985321,3,0
0,0,7,7,11,15,26,36,24,60,0.000333,0.094009,5,1410.131915,78.340662,282.026383,96.657107,3,0
0,0,13,13,15,28,43,68,53,121,0.000333,0.218859,7,4596.046247,255.335903,656.578035,193.209297,3,0
0,0,7,7,11,15,26,36,24,60,0.000333,0.094009,5,1410.131915,78.340662,282.026383,96.657107,3,0
0,0,6,6,11,16,27,31,24,55,0.000333,0.087173,5,1307.594063,72.644115,261.518813,102.053748,3,0
0,0,6,6,13,13,26,33,21,54,0.000333,0.084608,6,1522.942469,84.607915,253.823745,96.211433,3,0
0,0,9,9,14,17,31,49,32,81,0.000333,0.133763,7,2809.029308,156.057184,401.289901,122.789837,4,0
0,0,12,12,14,21,35,64,42,106,0.000333,0.181235,14,7611.855997,422.880889,543.704,145.541635,4,0
0,0,10,10,14,18,32,51,34,85,0.000333,0.141667,7,2975,165.277778,425,128.361619,4,0
0,0,14,14,14,23,37,69,48,117,0.000333,0.203169,14,8533.084613,474.060256,609.506044,157.344894,4,0
0,0,9,9,14,17,31,49,32,81,0.000333,0.133763,7,2809.029308,156.057184,401.289901,122.789837,4,0
0,0,12,12,14,21,35,64,42,106,0.000333,0.181235,14,7611.855997,422.880889,543.704,145.541635,4,0
0,0,10,10,14,18,32,51,34,85,0.000333,0.141667,7,2975,165.277778,425,128.361619,4,0
0,0,14,14,14,23,37,69,48,117,0.000333,0.203169,14,8533.084613,474.060256,609.506044,157.344894,4,0
0,0,7,7,11,15,26,36,24,60,0.000333,0.094009,5,1410.131915,78.340662,282.026383,96.657107,3,0
0,0,10,10,11,18,29,51,34,85,0.000333,0.137643,5,2064.641923,114.702329,412.928385,113.112398,3,0
0,0,8,8,11,16,27,38,26,64,0.000333,0.101438,5,1521.564001,84.531333,304.3128,102.053748,3,0
0,0,12,12,13,20,33,56,40,96,0.000333,0.161421,12,5811.142026,322.841224,484.261835,134.544278,3,0
0,0,7,7,11,15,26,36,24,60,0.000333,0.094009,5,1410.131915,78.340662,282.026383,96.657107,3,0
0,0,10,10,11,18,29,51,34,85,0.000333,0.137643,5,2064.641923,114.702329,412.928385,113.112398,3,0
0,0,8,8,11,16,27,38,26,64,0.000333,0.101438,5,1521.564001,84.531333,304.3128,102.053748,3,0
0,0,12,12,13,20,33,56,40,96,0.000333,0.161421,12,5811.142026,322.841224,484.261835,134.544278,3,0
0,0,9,9,14,17,31,49,32,81,0.000333,0.133763,7,2809.029308,156.057184,401.289901,122.789837,4,0
0,0,12,12,14,21,35,64,42,106,0.000333,0.181235,14,7611.855997,422.880889,543.704,145.541635,4,0
0,0,10,10,14,18,32,51,34,85,0.000333,0.141667,7,2975,165.277778,425,128.361619,4,0
0,0,14,14,14,23,37,69,48,117,0.000333,0.203169,14,8533.084613,474.060256,609.506044,157.344894,4,0
0,0,9,9,14,17,31,49,32,81,0.000333,0.133763,7,2809.029308,156.057184,401.289901,122.789837,4,0
0,0,12,12,14,21,35,64,42,106,0.000333,0.181235,14,7611.855997,422.880889,543.704,145.541635,4,0
0,0,10,10,14,18,32,51,34,85,0.000333,0.141667,7,2975,165.277778,425,128.361619,4,0
0,0,14,14,14,23,37,69,48,117,0.000333,0.203169,14,8533.084613,474.060256,609.506044,157.344894,4,0
0,0,7,7,11,15,26,36,24,60,0.000333,0.094009,5,1410.131915,78.340662,282.026383,96.657107,3,0
0,0,10,10,11,18,29,51,34,85,0.000333,0.137643,5,2064.641923,114.702329,412.928385,113.112398,3,0
0,0,8,8,11,16,27,38,26,64,0.000333,0.101438,5,1521.564001,84.531333,304.3128,102.053748,3,0
0,0,12,12,13,20,33,56,40,96,0.000333,0.161421,12,5811.142026,322.841224,484.261835,134.544278,3,0
0,0,7,7,11,15,26,36,24,60,0.000333,0.094009,5,1410.131915,78.340662,282.026383,96.657107,3,0
0,0,10,10,11,18,29,51,34,85,0.000333,0.137643,5,2064.641923,114.702329,412.928385,113.112398,3,0
0,0,8,8,11,16,27,38,26,64,0.000333,0.101438,5,1521.564001,84.531333,304.3128,102.053748,3,0
0,0,12,12,13,20,33,56,40,96,0.000333,0.161421,12,5811.142026,322.841224,484.261835,134.544278,3,0
0,0,9,9,14,17,31,49,32,81,0.000333,0.133763,7,2809.029308,156.057184,401.289901,122.789837,4,0
0,0,12,12,14,21,35,64,42,106,0.000333,0.181235,14,7611.855997,422.880889,543.704,145.541635,4,0
0,0,10,10,14,18,32,51,34,85,0.000333,0.141667,7,2975,165.277778,425,128.361619,4,0
0,0,14,14,14,23,37,69,48,117,0.000333,0.203169,14,8533.084613,474.060256,609.506044,157.344894,4,0
0,0,9,9,14,17,31,49,32,81,0.000333,0.133763,7,2809.029308,156.057184,401.289901,122.789837,4,0
0,0,12,12,14,21,35,64,42,106,0.000333,0.181235,14,7611.855997,422.880889,543.704,145.541635,4,0
0,0,10,10,14,18,32,53,35,88,0.000333,0.146667,7,3080,171.111111,440,128.361619,4,0
0,0,14,14,14,23,37,69,48,117,0.000333,0.203169,14,8533.084613,474.060256,609.506044,157.344894,4,0
0,0,7,7,11,15,26,36,24,60,0.000333,0.094009,5,1410.131915,78.340662,282.026383,96.657107,3,0
0,0,10,10,11,18,29,51,34,85,0.000333,0.137643,5,2064.641923,114.702329,412.928385,113.112398,3,0
0,0,8,8,11,16,27,38,26,64,0.000333,0.101438,5,1521.564001,84.531333,304.3128,102.053748,3,0
0,0,12,12,13,20,33,56,40,96,0.000333,0.161421,12,5811.142026,322.841224,484.261835,134.544278,3,0
0,0,7,7,11,15,26,36,24,60,0.000333,0.094009,5,1410.131915,78.340662,282.026383,96.657107,3,0
0,0,10,10,11,18,29,51,34,85,0.000333,0.137643,5,2064.641923,114.702329,412.928385,113.112398,3,0
0,0,8,8,11,16,27,38,26,64,0.000333,0.101438,5,1521.564001,84.531333,304.3128,102.053748,3,0
0,0,12,12,13,20,33,56,40,96,0.000333,0.161421,12,5811.142026,322.841224,484.261835,134.544278,3,0
0,0,9,9,14,17,31,49,32,81,0.000333,0.133763,7,2809.029308,156.057184,401.289901,122.789837,4,0
0,0,12,12,14,21,35,71,46,117,0.000333,0.200042,14,8401.765582,466.764755,600.126113,145.541635,4,0
0,0,10,10,14,18,32,51,34,85,0.000333,0.141667,7,2975,165.277778,425,128.361619,4,0
0,0,14,14,14,23,37,69,48,117,0.000333,0.203169,14,8533.084613,474.060256,609.506044,157.344894,4,0
0,0,9,9,14,17,31,49,32,81,0.000333,0.133763,7,2809.029308,156.057184,401.289901,122.789837,4,0
0,0,12,12,14,21,35,64,42,106,0.000333,0.181235,14,7611.855997,422.880889,543.704,145.541635,4,0
0,0,10,10,14,18,32,51,34,85,0.000333,0.141667,7,2975,165.277778,425,128.361619,4,0
0,0,14,14,14,23,37,69,48,117,0.000333,0.203169,14,8533.084613,474.060256,609.506044,157.344894,4,0
0,0,7,7,11,15,26,36,24,60,0.000333,0.094009,5,1410.131915,78.340662,282.026383,96.657107,3,0
0,0,10,10,11,18,29,51,34,85,0.000333,0.137643,5,2064.641923,114.702329,412.928385,113.112398,3,0
0,0,8,8,11,16,27,38,26,64,0.000333,0.101438,5,1521.564001,84.531333,304.3128,102.053748,3,0
0,0,12,12,13,20,33,56,40,96,0.000333,0.161421,12,5811.142026,322.841224,484.261835,134.544278,3,0
0,0,7,7,11,15,26,36,24,60,0.000333,0.094009,5,1410.131915,78.340662,282.026383,96.657107,3,0
0,0,10,10,11,18,29,51,34,85,0.000333,0.137643,5,2064.641923,114.702329,412.928385,113.112398,3,0
0,0,8,8,11,16,27,38,26,64,0.000333,0.101438,5,1521.564001,84.531333,304.3128,102.053748,3,0
0,0,12,12,13,20,33,56,40,96,0.000333,0.161421,12,5811.142026,322.841224,484.261835,134.544278,3,0
0,0,9,9,14,17,31,49,32,81,0.000333,0.133763,7,2809.029308,156.057184,401.289901,122.789837,4,0
0,0,12,12,14,21,35,64,42,106,0.000333,0.181235,14,7611.855997,422.880889,543.704,145.541635,4,0
0,0,10,10,14,18,32,51,34,85,0.000333,0.141667,7,2975,165.277778,425,128.361619,4,0
0,0,14,14,14,23,37,69,48,117,0.000333,0.203169,14,8533.084613,474.060256,609.506044,157.344894,4,0
0,0,9,9,14,17,31,49,32,81,0.000333,0.133763,7,2809.029308,156.057184,401.289901,122.789837,4,0
0,0,12,12,14,21,35,64,42,106,0.000333,0.181235,14,7611.855997,422.880889,543.704,145.541635,4,0
0,0,10,10,14,18,32,51,34,85,0.000333,0.141667,7,2975,165.277778,425,128.361619,4,0
0,0,14,14,14,23,37,69,48,117,0.000333,0.203169,14,8533.084613,474.060256,609.506044,157.344894,4,0
0,0,7,7,11,15,26,36,24,60,0.000333,0.094009,5,1410.131915,78.340662,282.026383,96.657107,3,0
0,0,10,10,11,18,29,51,34,85,0.000333,0.137643,5,2064.641923,114.702329,412.928385,113.112398,3,0
0,0,8,8,11,16,27,38,26,64,0.000333,0.101438,5,1521.564001,84.531333,304.3128,102.053748,3,0
0,0,12,12,13,20,33,56,40,96,0.000333,0.161421,12,5811.142026,322.841224,484.261835,134.544278,3,0
0,0,7,7,11,15,26,36,24,60,0.000333,0.094009,5,1410.131915,78.340662,282.026383,96.657107,3,0
0,0,10,10,11,18,29,51,34,85,0.000333,0.137643,5,2064.641923,114.702329,412.928385,113.112398,3,0
0,0,8,8,11,16,27,38,26,64,0.000333,0.101438,5,1521.564001,84.531333,304.3128,102.053748,3,0
0,0,12,12,13,20,33,56,40,96,0.000333,0.161421,12,5811.142026,322.841224,484.261835,134.544278,3,0
0,0,9,9,14,17,31,49,32,81,0.000333,0.133763,7,2809.029308,156.057184,401.289901,122.789837,4,0
0,0,12,12,14,21,35,64,42,106,0.000333,0.181235,14,7611.855997,422.880889,543.704,145.541635,4,0
0,0,10,10,14,18,32,51,34,85,0.000333,0.141667,7,2975,165.277778,425,128.361619,4,0
0,0,14,14,14,23,37,69,48,117,0.000333,0.203169,14,8533.084613,474.060256,609.506044,157.344894,4,0
0,0,9,9,14,17,31,49,32,81,0.000333,0.133763,7,2809.029308,156.057184,401.289901,122.789837,4,0
0,0,12,12,14,21,35,64,42,106,0.000333,0.181235,14,7611.855997,422.880889,543.704,145.541635,4,0
0,0,10,10,14,18,32,51,34,85,0.000333,0.141667,7,2975,165.277778,425,128.361619,4,0
0,0,14,14,14,23,37,69,48,117,0.000333,0.203169,14,8533.084613,474.060256,609.506044,157.344894,4,0
0,0,7,7,11,15,26,36,24,60,0.000333,0.094009,5,1410.131915,78.340662,282.026383,96.657107,3,0
0,0,10,10,11,18,29,51,34,85,0.000333,0.137643,5,2064.641923,114.702329,412.928385,113.112398,3,0
0,0,8,8,11,16,27,38,26,64,0.000333,0.101438,5,1521.564001,84.531333,304.3128,102.053748,3,0
0,0,12,12,13,20,33,56,40,96,0.000333,0.161421,12,5811.142026,322.841224,484.261835,134.544278,3,0
0,0,7,7,11,15,26,36,24,60,0.000333,0.094009,5,1410.131915,78.340662,282.026383,96.657107,3,0
0,0,10,10,11,18,29,51,34,85,0.000333,0.137643,5,2064.641923,114.702329,412.928385,113.112398,3,0
0,0,8,8,11,16,27,38,26,64,0.000333,0.101438,5,1521.564001,84.531333,304.3128,102.053748,3,0
0,0,12,12,13,20,33,56,40,96,0.000333,0.161421,12,5811.142026,322.841224,484.261835,134.544278,3,0
0,0,9,9,14,17,31,49,32,81,0.000333,0.133763,7,2809.029308,156.057184,401.289901,122.789837,4,0
0,0,12,12,14,21,35,64,42,106,0.000333,0.181235,14,7611.855997,422.880889,543.704,145.541635,4,0
0,0,10,10,14,18,32,51,34,85,0.000333,0.141667,7,2975,165.277778,425,128.361619,4,0
0,0,14,14,14,23,37,69,48,117,0.000333,0.203169,14,8533.084613,474.060256,609.506044,157.344894,4,0
0,0,9,9,14,17,31,49,32,81,0.000333,0.133763,7,2809.029308,156.057184,401.289901,122.789837,4,0
0,0,12,12,14,21,35,64,42,106,0.000333,0.181235,14,7611.855997,422.880889,543.704,145.541635,4,0
0,0,10,10,14,18,32,51,34,85,0.000333,0.141667,7,2975,165.277778,425,128.361619,4,0
0,0,14,14,14,23,37,69,48,117,0.000333,0.203169,14,8533.084613,474.060256,609.506044,157.344894,4,0
0,0,7,7,11,15,26,36,24,60,0.000333,0.094009,5,1410.131915,78.340662,282.026383,96.657107,3,0
0,0,10,10,11,18,29,51,34,85,0.000333,0.137643,5,2064.641923,114.702329,412.928385,113.112398,3,0
0,0,8,8,11,16,27,38,26,64,0.000333,0.101438,5,1521.564001,84.531333,304.3128,102.053748,3,0
0,0,12,12,13,20,33,56,40,96,0.000333,0.161421,12,5811.142026,322.841224,484.261835,134.544278,3,0
0,0,7,7,11,15,26,36,24,60,0.000333,0.094009,5,1410.131915,78.340662,282.026383,96.657107,3,0
0,0,10,10,11,18,29,51,34,85,0.000333,0.137643,5,2064.641923,114.702329,412.928385,113.112398,3,0
0,0,8,8,11,16,27,38,26,64,0.000333,0.101438,5,1521.564001,84.531333,304.3128,102.053748,3,0
0,0,12,12,13,20,33,56,40,96,0.000333,0.161421,12,5811.142026,322.841224,484.261835,134.544278,3,0
0,0,9,9,14,17,31,49,32,81,0.000333,0.133763,7,2809.029308,156.057184,401.289901,122.789837,4,0
0,0,12,12,14,21,35,64,42,106,0.000333,0.181235,14,7611.855997,422.880889,543.704,145.541635,4,0
0,0,10,10,14,18,32,51,34,85,0.000333,0.141667,7,2975,165.277778,425,128.361619,4,0
0,0,14,14,14,23,37,69,48,117,0.000333,0.203169,14,8533.084613,474.060256,609.506044,157.344894,4,0
0,0,9,9,14,17,31,49,32,81,0.000333,0.133763,7,2809.029308,156.057184,401.289901,122.789837,4,0
0,0,12,12,14,21,35,64,42,106,0.000333,0.181235,14,7611.855997,422.880889,543.704,145.541635,4,0
0,0,10,10,14,18,32,51,34,85,0.000333,0.141667,7,2975,165.277778,425,128.361619,4,0
0,0,14,14,14,23,37,69,48,117,0.000333,0.203169,14,8533.084613,474.060256,609.506044,157.344894,4,0
0,0,7,7,11,15,26,36,24,60,0.000333,0.094009,5,1410.131915,78.340662,282.026383,96.657107,3,0
0,0,10,10,11,18,29,51,34,85,0.000333,0.137643,5,2064.641923,114.702329,412.928385,113.112398,3,0
0,0,8,8,11,16,27,38,26,64,0.000333,0.101438,5,1521.564001,84.531333,304.3128,102.053748,3,0
0,0,12,12,13,20,33,56,40,96,0.000333,0.161421,12,5811.142026,322.841224,484.261835,134.544278,3,0
0,0,7,7,11,15,26,36,24,60,0.000333,0.094009,5,1410.131915,78.340662,282.026383,96.657107,3,0
0,0,10,10,11,18,29,51,34,85,0.000333,0.137643,5,2064.641923,114.702329,412.928385,113.112398,3,0
0,0,8,8,11,16,27,38,26,64,0.000333,0.101438,5,1521.564001,84.531333,304.3128,102.053748,3,0
0,0,12,12,13,20,33,56,40,96,0.000333,0.161421,12,5811.142026,322.841224,484.261835,134.544278,3,0
0,0,7,7,11,15,26,36,24,60,0.000333,0.094009,5,1410.131915,78.340662,282.026383,96.657107,3,0
0,0,10,10,11,18,29,51,34,85,0.000333,0.137643,5,2064.641923,114.702329,412.928385,113.112398,3,0
0,0,8,8,11,16,27,38,26,64,0.000333,0.101438,5,1521.564001,84.531333,304.3128,102.053748,3,0
0,0,12,12,13,20,33,56,40,96,0.000333,0.161421,12,5811.142026,322.841224,484.261835,134.544278,3,0
0,0,12,12,14,17,31,67,45,112,0.000333,0.184957,14,7768.179815,431.565545,554.869987,122.789837,5,0
0,0,15,15,14,21,35,82,55,137,0.000333,0.234237,14,9837.964827,546.553601,702.711773,145.541635,5,0
0,0,13,13,14,18,32,69,47,116,0.000333,0.193333,14,8120,451.111111,580,128.361619,5,0
0,0,17,17,14,23,37,87,61,148,0.000333,0.257,14,10793.98737,599.665965,770.999098,157.344894,5,0
0,0,12,12,14,17,31,67,45,112,0.000333,0.184957,14,7768.179815,431.565545,554.869987,122.789837,5,0
0,0,15,15,14,21,35,82,55,137,0.000333,0.234237,14,9837.964827,546.553601,702.711773,145.541635,5,0
0,0,13,13,14,18,32,69,47,116,0.000333,0.193333,14,8120,451.111111,580,128.361619,5,0
0,0,17,17,14,23,37,87,61,148,0.000333,0.257,14,10793.98737,599.665965,770.999098,157.344894,5,0
0,0,10,10,14,18,32,51,34,85,0.000333,0.141667,7,2975,165.277778,425,128.361619,4,0
0,0,13,13,14,22,36,66,44,110,0.000333,0.189564,14,7961.684502,442.315806,568.69175,151.410465,4,0
0,0,11,11,14,19,33,53,36,89,0.000333,0.14965,7,3142.657536,174.592085,448.951077,134.013592,4,0
0,0,15,15,14,24,38,71,50,121,0.000333,0.211666,14,8889.989208,493.888289,634.999229,163.342069,4,0
0,0,7,7,11,15,26,36,24,60,0.000333,0.094009,5,1410.131915,78.340662,282.026383,96.657107,3,0
0,0,10,10,11,18,29,51,34,85,0.000333,0.137643,5,2064.641923,114.702329,412.928385,113.112398,3,0
0,0,8,8,11,16,27,38,26,64,0.000333,0.101438,5,1521.564001,84.531333,304.3128,102.053748,3,0
0,0,12,12,13,20,33,56,40,96,0.000333,0.161421,12,5811.142026,322.841224,484.261835,134.544278,3,0
0,0,7,7,11,15,26,36,24,60,0.000333,0.094009,5,1410.131915,78.340662,282.026383,96.657107,3,0
0,0,10,10,11,18,29,51,34,85,0.000333,0.137643,5,2064.641923,114.702329,412.928385,113.112398,3,0
0,0,8,8,11,16,27,38,26,64,0.000333,0.101438,5,1521.564001,84.531333,304.3128,102.053748,3,0
0,0,12,12,13,20,33,56,40,96,0.000333,0.161421,12,5811.142026,322.841224,484.261835,134.544278,3,0
0,0,9,9,14,17,31,49,32,81,0.000333,0.133763,7,2809.029308,156.057184,401.289901,122.789837,4,0
0,0,12,12,14,21,35,64,42,106,0.000333,0.181235,14,7611.855997,422.880889,543.704,145.541635,4,0
0,0,10,10,14,18,32,51,34,85,0.000333,0.141667,7,2975,165.277778,425,128.361619,4,0
0,0,14,14,14,23,37,69,48,117,0.000333,0.203169,14,8533.084613,474.060256,609.506044,157.344894,4,0
0,0,9,9,14,17,31,49,32,81,0.000333,0.133763,7,2809.029308,156.057184,401.289901,122.789837,4,0
0,0,12,12,14,21,35,64,42,106,0.000333,0.181235,14,7611.855997,422.880889,543.704,145.541635,4,0
0,0,10,10,14,18,32,51,34,85,0.000333,0.141667,7,2975,165.277778,425,128.361619,4,0
0,0,14,14,14,23,37,69,48,117,0.000333,0.203169,14,8533.084613,474.060256,609.506044,157.344894,4,0
0,0,7,7,11,15,26,36,24,60,0.000333,0.094009,5,1410.131915,78.340662,282.026383,96.657107,3,0
0,0,10,10,11,18,29,51,34,85,0.000333,0.137643,5,2064.641923,114.702329,412.928385,113.112398,3,0
0,0,8,8,11,16,27,38,26,64,0.000333,0.101438,5,1521.564001,84.531333,304.3128,102.053748,3,0
0,0,12,12,13,20,33,56,40,96,0.000333,0.161421,12,5811.142026,322.841224,484.261835,134.544278,3,0
0,0,7,7,11,15,26,36,24,60,0.000333,0.094009,5,1410.131915,78.340662,282.026383,96.657107,3,0
0,0,10,10,11,18,29,51,34,85,0.000333,0.137643,5,2064.641923,114.702329,412.928385,113.112398,3,0
0,0,8,8,11,16,27,38,26,64,0.000333,0.101438,5,1521.564001,84.531333,304.3128,102.053748,3,0
0,0,12,12,13,20,33,56,40,96,0.000333,0.161421,12,5811.142026,322.841224,484.261835,134.544278,3,0
0,0,9,9,14,17,31,49,32,81,0.000333,0.133763,7,2809.029308,156.057184,401.289901,122.789837,4,0
0,0,12,12,14,21,35,64,42,106,0.000333,0.181235,14,7611.855997,422.880889,543.704,145.541635,4,0
0,0,10,10,14,18,32,51,34,85,0.000333,0.141667,7,2975,165.277778,425,128.361619,4,0
0,0,14,14,14,23,37,69,48,117,0.000333,0.203169,14,8533.084613,474.060256,609.506044,157.344894,4,0
0,0,9,9,14,17,31,49,32,81,0.000333,0.133763,7,2809.029308,156.057184,401.289901,122.789837,4,0
0,0,12,12,14,21,35,64,42,106,0.000333,0.181235,14,7611.855997,422.880889,543.704,145.541635,4,0
0,0,10,10,14,18,32,51,34,85,0.000333,0.141667,7,2975,165.277778,425,128.361619,4,0
0,0,14,14,14,23,37,69,48,117,0.000333,0.203169,14,8533.084613,474.060256,609.506044,157.344894,4,0
0,0,7,7,11,15,26,36,24,60,0.000333,0.094009,5,1410.131915,78.340662,282.026383,96.657107,3,0
0,0,10,10,11,18,29,51,34,85,0.000333,0.137643,5,2064.641923,114.702329,412.928385,113.112398,3,0
0,0,8,8,11,16,27,38,26,64,0.000333,0.101438,5,1521.564001,84.531333,304.3128,102.053748,3,0
0,0,12,12,13,20,33,56,40,96,0.000333,0.161421,12,5811.142026,322.841224,484.261835,134.544278,3,0
0,0,7,7,11,15,26,36,24,60,0.000333,0.094009,5,1410.131915,78.340662,282.026383,96.657107,3,0
0,0,10,10,11,18,29,51,34,85,0.000333,0.137643,5,2064.641923,114.702329,412.928385,113.112398,3,0
0,0,8,8,11,16,27,38,26,64,0.000333,0.101438,5,1521.564001,84.531333,304.3128,102.053748,3,0
0,0,12,12,13,20,33,56,40,96,0.000333,0.161421,12,5811.142026,322.841224,484.261835,134.544278,3,0
0,0,9,9,14,17,31,49,32,81,0.000333,0.133763,7,2809.029308,156.057184,401.289901,122.789837,4,0
0,0,12,12,14,21,35,64,42,106,0.000333,0.181235,14,7611.855997,422.880889,543.704,145.541635,4,0
0,0,10,10,14,18,32,51,34,85,0.000333,0.141667,7,2975,165.277778,425,128.361619,4,0
0,0,14,14,14,23,37,69,48,117,0.000333,0.203169,14,8533.084613,474.060256,609.506044,157.344894,4,0
0,0,9,9,14,17,31,49,32,81,0.000333,0.133763,7,2809.029308,156.057184,401.289901,122.789837,4,0
0,0,12,12,14,21,35,64,42,106,0.000333,0.181235,14,7611.855997,422.880889,543.704,145.541635,4,0
0,0,10,10,14,18,32,51,34,85,0.000333,0.141667,7,2975,165.277778,425,128.361619,4,0
0,0,14,14,14,23,37,69,48,117,0.000333,0.203169,14,8533.084613,474.060256,609.506044,157.344894,4,0
0,0,7,7,11,15,26,36,24,60,0.000333,0.094009,5,1410.131915,78.340662,282.026383,96.657107,3,0
0,0,10,10,11,18,29,51,34,85,0.000333,0.137643,5,2064.641923,114.702329,412.928385,113.112398,3,0
0,0,8,8,11,16,27,38,26,64,0.000333,0.101438,5,1521.564001,84.531333,304.3128,102.053748,3,0
0,0,12,12,13,20,33,56,40,96,0.000333,0.161421,12,5811.142026,322.841224,484.261835,134.544278,3,0
0,0,7,7,11,12,23,33,21,54,0.000333,0.081424,5,1221.361728,67.853429,244.272346,81.073298,3,0
0,0,10,10,11,16,27,48,31,79,0.000333,0.125212,5,1878.180563,104.343365,375.636113,102.053748,3,0
0,0,8,8,11,13,24,35,23,58,0.000333,0.088643,5,1329.639125,73.86884,265.927825,86.159464,3,0
0,0,12,12,13,18,31,53,37,90,0.000333,0.148626,12,5350.532015,297.251779,445.877668,123.164366,3,0
0,0,7,7,11,15,26,36,24,60,0.000333,0.094009,5,1410.131915,78.340662,282.026383,96.657107,3,0
0,0,10,10,11,18,29,51,34,85,0.000333,0.137643,5,2064.641923,114.702329,412.928385,113.112398,3,0
0,0,8,8,11,16,27,38,26,64,0.000333,0.101438,5,1521.564001,84.531333,304.3128,102.053748,3,0
0,0,12,12,13,20,33,56,40,96,0.000333,0.161421,12,5811.142026,322.841224,484.261835,134.544278,3,0
0,0,7,7,11,12,23,33,21,54,0.000333,0.081424,5,1221.361728,67.853429,244.272346,81.073298,3,0
0,0,10,10,11,16,27,48,31,79,0.000333,0.125212,5,1878.180563,104.343365,375.636113,102.053748,3,0
0,0,8,8,11,13,24,35,23,58,0.000333,0.088643,5,1329.639125,73.86884,265.927825,86.159464,3,0
0,0,12,12,13,18,31,53,37,90,0.000333,0.148626,12,5350.532015,297.251779,445.877668,123.164366,3,0
0,0,7,7,11,15,26,36,24,60,0.000333,0.094009,5,1410.131915,78.340662,282.026383,96.657107,3,0
0,0,10,10,11,18,29,51,34,85,0.000333,0.137643,5,2064.641923,114.702329,412.928385,113.112398,3,0
0,0,8,8,11,16,27,38,26,64,0.000333,0.101438,5,1521.564001,84.531333,304.3128,102.053748,3,0
0,0,12,12,13,20,33,56,40,96,0.000333,0.161421,12,5811.142026,322.841224,484.261835,134.544278,3,0
0,0,6,6,11,11,22,31,19,50,0.000333,0.074324,5,1114.857905,61.93655,222.971581,76.107496,3,0
0,0,9,9,11,15,26,46,29,75,0.000333,0.117511,5,1762.664894,97.925827,352.532979,96.657107,3,0
0,0,7,7,11,12,23,33,21,54,0.000333,0.081424,5,1221.361728,67.853429,244.272346,81.073298,3,0
0,0,11,11,13,17,30,51,35,86,0.000333,0.140664,12,5063.911095,281.328394,421.992591,117.592585,3,0
0,0,7,7,11,15,26,36,24,60,0.000333,0.094009,5,1410.131915,78.340662,282.026383,96.657107,3,0
0,0,10,10,11,18,29,51,34,85,0.000333,0.137643,5,2064.641923,114.702329,412.928385,113.112398,3,0
0,0,8,8,11,16,27,38,26,64,0.000333,0.101438,5,1521.564001,84.531333,304.3128,102.053748,3,0
0,0,12,12,13,20,33,56,40,96,0.000333,0.161421,12,5811.142026,322.841224,484.261835,134.544278,3,0
0,0,7,7,11,15,26,36,24,60,0.000333,0.094009,5,1410.131915,78.340662,282.026383,96.657107,3,0
0,0,10,10,11,18,29,51,34,85,0.000333,0.137643,5,2064.641923,114.702329,412.928385,113.112398,3,0
0,0,8,8,11,16,27,38,26,64,0.000333,0.101438,5,1521.564001,84.531333,304.3128,102.053748,3,0
0,0,12,12,13,20,33,56,40,96,0.000333,0.161421,12,5811.142026,322.841224,484.261835,134.544278,3,0
0,0,11,11,15,22,37,55,42,97,0.000333,0.168439,7,3537.218835,196.512158,505.316976,156.710855,4,0
0,0,14,14,15,24,39,70,52,122,0.000333,0.21494,14,9027.46699,501.525944,644.819071,168.642459,4,0
0,0,12,12,15,23,38,57,44,101,0.000333,0.17668,7,3710.284752,206.126931,530.040679,162.645284,4,0
0,0,16,16,15,26,41,75,58,133,0.000333,0.237518,14,9975.761833,554.208991,712.554417,180.814792,4,0
0,0,11,11,15,22,37,55,42,97,0.000333,0.168439,7,3537.218835,196.512158,505.316976,156.710855,4,0
0,0,14,14,15,24,39,70,52,122,0.000333,0.21494,14,9027.46699,501.525944,644.819071,168.642459,4,0
0,0,12,12,15,23,38,57,44,101,0.000333,0.17668,7,3710.284752,206.126931,530.040679,162.645284,4,0
0,0,16,16,15,26,41,75,58,133,0.000333,0.237518,14,9975.761833,554.208991,712.554417,180.814792,4,0
0,0,7,7,11,15,26,36,24,60,0.000333,0.094009,5,1410.131915,78.340662,282.026383,96.657107,3,0
0,0,10,10,11,18,29,51,34,85,0.000333,0.137643,5,2064.641923,114.702329,412.928385,113.112398,3,0
0,0,8,8,11,16,27,38,26,64,0.000333,0.101438,5,1521.564001,84.531333,304.3128,102.053748,3,0
0,0,12,12,13,20,33,56,40,96,0.000333,0.161421,12,5811.142026,322.841224,484.261835,134.544278,3,0
0,0,7,7,11,15,26,36,24,60,0.000333,0.094009,5,1410.131915,78.340662,282.026383,96.657107,3,0
0,0,10,10,11,18,29,51,34,85,0.000333,0.137643,5,2064.641923,114.702329,412.928385,113.112398,3,0
0,0,8,8,11,16,27,38,26,64,0.000333,0.101438,5,1521.564001,84.531333,304.3128,102.053748,3,0
0,0,12,12,13,20,33,56,40,96,0.000333,0.161421,12,5811.142026,322.841224,484.261835,134.544278,3,0
0,0,6,6,11,17,28,31,25,56,0.000333,0.089737,5,1346.059378,74.781077,269.211876,107.540616,3,0
0,0,9,9,11,19,30,46,35,81,0.000333,0.132486,5,1987.290691,110.405038,397.458138,118.764371,3,0
0,0,7,7,11,18,29,33,27,60,0.000333,0.09716,5,1457.394299,80.96635,291.47886,113.112398,3,0
0,0,11,11,13,21,34,51,41,92,0.000333,0.156016,6,2808.279488,156.015527,468.046581,140.344382,3,0
0,0,6,6,11,17,28,31,25,56,0.000333,0.089737,5,1346.059378,74.781077,269.211876,107.540616,3,0
0,0,9,9,11,19,30,46,35,81,0.000333,0.132486,5,1987.290691,110.405038,397.458138,118.764371,3,0
0,0,7,7,11,18,29,33,27,60,0.000333,0.09716,5,1457.394299,80.96635,291.47886,113.112398,3,0
0,0,11,11,13,21,34,51,41,92,0.000333,0.156016,6,2808.279488,156.015527,468.046581,140.344382,3,0
0,0,7,7,11,15,26,36,24,60,0.000333,0.094009,5,1410.131915,78.340662,282.026383,96.657107,3,0
0,0,10,10,11,18,29,51,34,85,0.000333,0.137643,5,2064.641923,114.702329,412.928385,113.112398,3,0
0,0,8,8,11,16,27,38,26,64,0.000333,0.101438,5,1521.564001,84.531333,304.3128,102.053748,3,0
0,0,12,12,13,20,33,56,40,96,0.000333,0.161421,12,5811.142026,322.841224,484.261835,134.544278,3,0
0,0,11,11,14,19,33,53,38,91,0.000333,0.153013,14,6426.558108,357.031006,459.039865,134.013592,4,0
0,0,14,14,14,22,36,68,48,116,0.000333,0.199904,14,8395.958202,466.442122,599.7113,151.410465,4,0
0,0,12,12,14,20,34,55,40,95,0.000333,0.161103,14,6766.325579,375.906977,483.30897,139.741531,4,0
0,0,16,16,14,24,38,73,54,127,0.000333,0.222162,14,9330.815119,518.378618,666.486794,163.342069,4,0
0,0,7,7,11,15,26,36,24,60,0.000333,0.094009,5,1410.131915,78.340662,282.026383,96.657107,3,0
0,0,10,10,11,18,29,51,34,85,0.000333,0.137643,5,2064.641923,114.702329,412.928385,113.112398,3,0
0,0,8,8,11,16,27,38,26,64,0.000333,0.101438,5,1521.564001,84.531333,304.3128,102.053748,3,0
0,0,12,12,13,20,33,56,40,96,0.000333,0.161421,12,5811.142026,322.841224,484.261835,134.544278,3,0
0,0,7,7,12,12,24,36,23,59,0.000333,0.090171,6,1623.076725,90.170929,270.512788,86.0391,3,0
0,0,10,10,12,15,27,51,33,84,0.000333,0.133137,12,4792.926602,266.2737,399.41055,101.622909,3,0
0,0,8,8,12,13,25,38,25,63,0.000333,0.097521,6,1755.37764,97.52098,292.56294,91.125266,3,0
0,0,12,12,14,17,31,56,39,95,0.000333,0.156883,14,6589.081093,366.060061,470.648649,122.789837,3,0
0,0,7,7,11,15,26,36,24,60,0.000333,0.094009,5,1410.131915,78.340662,282.026383,96.657107,3,0
0,0,10,10,11,18,29,51,34,85,0.000333,0.137643,5,2064.641923,114.702329,412.928385,113.112398,3,0
0,0,8,8,11,16,27,38,26,64,0.000333,0.101438,5,1521.564001,84.531333,304.3128,102.053748,3,0
0,0,12,12,13,20,33,56,40,96,0.000333,0.161421,12,5811.142026,322.841224,484.261835,134.544278,3,0
0,0,7,7,12,16,28,33,25,58,0.000333,0.092942,6,1672.959513,92.942195,278.826585,107.01955,3,0
0,0,10,10,12,19,31,48,35,83,0.000333,0.137066,6,2467.189763,137.066098,411.198294,123.730173,3,0
0,0,8,8,12,17,29,35,27,62,0.000333,0.100398,6,1807.16893,100.398274,301.194822,112.506418,3,0
0,0,12,12,14,21,35,53,41,94,0.000333,0.160718,7,3375.068225,187.50379,482.152604,145.541635,3,0
0,0,7,7,11,15,26,36,24,60,0.000333,0.094009,5,1410.131915,78.340662,282.026383,96.657107,3,0
0,0,10,10,11,18,29,51,34,85,0.000333,0.137643,5,2064.641923,114.702329,412.928385,113.112398,3,0
0,0,8,8,11,16,27,38,26,64,0.000333,0.101438,5,1521.564001,84.531333,304.3128,102.053748,3,0
0,0,12,12,13,20,33,56,40,96,0.000333,0.161421,12,5811.142026,322.841224,484.261835,134.544278,3,0
0,0,11,11,15,21,36,55,40,95,0.000333,0.163714,7,3438.000126,191.000007,491.142875,150.842025,4,0
0,0,12,12,15,22,37,65,45,110,0.000333,0.191013,14,8022.558183,445.697677,573.03987,156.710855,4,0
0,0,12,12,15,22,37,57,42,99,0.000333,0.171912,7,3610.151182,200.563955,515.735883,156.710855,4,0
0,0,14,14,14,24,38,69,50,119,0.000333,0.208168,14,8743.047237,485.724847,624.503374,163.342069,4,0
0,0,7,7,11,15,26,36,24,60,0.000333,0.094009,5,1410.131915,78.340662,282.026383,96.657107,3,0
0,0,10,10,11,18,29,51,34,85,0.000333,0.137643,5,2064.641923,114.702329,412.928385,113.112398,3,0
0,0,8,8,11,16,27,38,26,64,0.000333,0.101438,5,1521.564001,84.531333,304.3128,102.053748,3,0
0,0,12,12,13,20,33,56,40,96,0.000333,0.161421,12,5811.142026,322.841224,484.261835,134.544278,3,0
0,0,19,19,16,20,36,93,64,157,0.000333,0.270559,24,19480.27741,1082.237634,811.678225,150.438562,5,0
0,0,22,22,16,23,39,108,74,182,0.000333,0.320648,24,23086.63689,1282.590938,961.943204,168.041925,5,0
0,0,20,20,16,21,37,95,66,161,0.000333,0.279574,24,20129.32781,1118.295989,838.721992,156.238666,5,0
0,0,24,24,16,25,41,113,80,193,0.000333,0.344669,24,24816.18089,1378.676716,1034.007537,180.096405,5,0
0,0,7,7,11,15,26,36,24,60,0.000333,0.094009,5,1410.131915,78.340662,282.026383,96.657107,3,0
0,0,10,10,11,18,29,51,34,85,0.000333,0.137643,5,2064.641923,114.702329,412.928385,113.112398,3,0
0,0,8,8,11,16,27,38,26,64,0.000333,0.101438,5,1521.564001,84.531333,304.3128,102.053748,3,0
0,0,12,12,13,20,33,56,40,96,0.000333,0.161421,12,5811.142026,322.841224,484.261835,134.544278,3,0
0,0,6,6,12,14,26,32,22,54,0.000333,0.084608,6,1522.942469,84.607915,253.823745,96.322519,3,0
0,0,7,7,12,15,27,34,24,58,0.000333,0.091928,6,1654.700851,91.927825,275.783475,101.622909,3,0
0,0,7,7,11,15,26,36,24,60,0.000333,0.094009,5,1410.131915,78.340662,282.026383,96.657107,3,0
0,0,10,10,11,18,29,51,34,85,0.000333,0.137643,5,2064.641923,114.702329,412.928385,113.112398,3,0
0,0,8,8,11,16,27,38,26,64,0.000333,0.101438,5,1521.564001,84.531333,304.3128,102.053748,3,0
0,0,12,12,13,20,33,56,40,96,0.000333,0.161421,12,5811.142026,322.841224,484.261835,134.544278,3,0
0,0,12,12,14,24,38,54,45,99,0.000333,0.173182,7,3636.813767,202.045209,519.544824,163.342069,4,0
0,0,15,15,14,27,41,69,55,124,0.000333,0.221445,14,9300.71028,516.706127,664.336449,181.684931,4,0
0,0,13,13,14,25,39,56,47,103,0.000333,0.181465,7,3810.775,211.709722,544.396429,169.399374,4,0
0,0,17,17,14,29,43,74,61,135,0.000333,0.244182,14,10255.64039,569.757799,732.545742,194.184418,4,0
0,0,7,7,11,15,26,36,24,60,0.000333,0.094009,5,1410.131915,78.340662,282.026383,96.657107,3,0
0,0,10,10,11,18,29,51,34,85,0.000333,0.137643,5,2064.641923,114.702329,412.928385,113.112398,3,0
0,0,8,8,11,16,27,38,26,64,0.000333,0.101438,5,1521.564001,84.531333,304.3128,102.053748,3,0
0,0,12,12,13,20,33,56,40,96,0.000333,0.161421,12,5811.142026,322.841224,484.261835,134.544278,3,0
0,0,11,11,14,23,37,54,44,98,0.000333,0.170175,7,3573.685009,198.538056,510.52643,157.344894,4,0
0,0,14,14,14,25,39,69,54,123,0.000333,0.216701,14,9101.462621,505.636812,650.104473,169.399374,4,0
0,0,12,12,14,24,38,56,46,102,0.000333,0.17843,7,3747.020245,208.167791,535.288606,163.342069,4,0
0,0,16,16,14,27,41,74,60,134,0.000333,0.239304,14,10050.76756,558.375976,717.911969,181.684931,4,0
0,0,7,7,11,15,26,36,24,60,0.000333,0.094009,5,1410.131915,78.340662,282.026383,96.657107,3,0
0,0,10,10,11,18,29,51,34,85,0.000333,0.137643,5,2064.641923,114.702329,412.928385,113.112398,3,0
0,0,8,8,11,16,27,38,26,64,0.000333,0.101438,5,1521.564001,84.531333,304.3128,102.053748,3,0
0,0,12,12,13,20,33,56,40,96,0.000333,0.161421,12,5811.142026,322.841224,484.261835,134.544278,3,0
0,0,8,8,11,17,28,36,36,72,0.000333,0.115377,10,3461.295544,192.294197,346.129554,107.540616,3,0
0,0,11,11,11,19,30,51,46,97,0.000333,0.158656,10,4759.683878,264.426882,475.968388,118.764371,3,0
0,0,9,9,11,18,29,38,38,76,0.000333,0.123069,10,3692.065556,205.114753,369.206556,113.112398,3,0
0,0,13,13,13,21,34,56,52,108,0.000333,0.183149,12,6593.351842,366.297325,549.445987,140.344382,3,0
0,0,7,7,11,15,26,36,24,60,0.000333,0.094009,5,1410.131915,78.340662,282.026383,96.657107,3,0
0,0,10,10,11,18,29,51,34,85,0.000333,0.137643,5,2064.641923,114.702329,412.928385,113.112398,3,0
0,0,8,8,11,16,27,38,26,64,0.000333,0.101438,5,1521.564001,84.531333,304.3128,102.053748,3,0
0,0,12,12,13,20,33,56,40,96,0.000333,0.161421,12,5811.142026,322.841224,484.261835,134.544278,3,0
0,0,8,8,11,17,28,36,36,72,0.000333,0.115377,10,3461.295544,192.294197,346.129554,107.540616,3,0
0,0,11,11,11,19,30,51,46,97,0.000333,0.158656,10,4759.683878,264.426882,475.968388,118.764371,3,0
0,0,9,9,11,18,29,38,38,76,0.000333,0.123069,10,3692.065556,205.114753,369.206556,113.112398,3,0
0,0,13,13,13,21,34,56,52,108,0.000333,0.183149,12,6593.351842,366.297325,549.445987,140.344382,3,0
0,0,7,7,11,15,26,36,24,60,0.000333,0.094009,5,1410.131915,78.340662,282.026383,96.657107,3,0
0,0,10,10,11,18,29,51,34,85,0.000333,0.137643,5,2064.641923,114.702329,412.928385,113.112398,3,0
0,0,8,8,11,16,27,38,26,64,0.000333,0.101438,5,1521.564001,84.531333,304.3128,102.053748,3,0
0,0,12,12,13,20,33,56,40,96,0.000333,0.161421,12,5811.142026,322.841224,484.261835,134.544278,3,0
0,0,8,8,11,17,28,36,36,72,0.000333,0.115377,10,3461.295544,192.294197,346.129554,107.540616,3,0
0,0,11,11,11,19,30,51,46,97,0.000333,0.158656,10,4759.683878,264.426882,475.968388,118.764371,3,0
0,0,9,9,11,18,29,38,38,76,0.000333,0.123069,10,3692.065556,205.114753,369.206556,113.112398,3,0
0,0,13,13,13,21,34,56,52,108,0.000333,0.183149,12,6593.351842,366.297325,549.445987,140.344382,3,0
0,0,7,7,11,15,26,36,24,60,0.000333,0.094009,5,1410.131915,78.340662,282.026383,96.657107,3,0
0,0,10,10,11,18,29,51,34,85,0.000333,0.137643,5,2064.641923,114.702329,412.928385,113.112398,3,0
0,0,8,8,11,16,27,38,26,64,0.000333,0.101438,5,1521.564001,84.531333,304.3128,102.053748,3,0
0,0,12,12,13,20,33,56,40,96,0.000333,0.161421,12,5811.142026,322.841224,484.261835,134.544278,3,0
0,0,20,20,15,22,37,96,76,172,0.000333,0.298675,21,18816.54556,1045.363642,896.025979,156.710855,5,0
0,0,23,23,15,25,40,111,86,197,0.000333,0.349473,21,22016.81653,1223.156474,1048.419835,174.699764,5,0
0,0,21,21,15,23,38,98,78,176,0.000333,0.307878,21,19396.34009,1077.574449,923.635242,162.645284,5,0
0,0,25,25,15,27,42,116,92,208,0.000333,0.373867,21,23553.6425,1308.535695,1121.602024,186.985321,5,0
0,0,7,7,11,15,26,36,24,60,0.000333,0.094009,5,1410.131915,78.340662,282.026383,96.657107,3,0
0,0,10,10,11,18,29,51,34,85,0.000333,0.137643,5,2064.641923,114.702329,412.928385,113.112398,3,0
0,0,8,8,11,16,27,38,26,64,0.000333,0.101438,5,1521.564001,84.531333,304.3128,102.053748,3,0
0,0,12,12,13,20,33,56,40,96,0.000333,0.161421,12,5811.142026,322.841224,484.261835,134.544278,3,0
0,0,12,12,15,24,39,59,47,106,0.000333,0.186751,7,3921.768446,217.876025,560.252635,168.642459,4,0
0,0,15,15,15,26,41,74,57,131,0.000333,0.233946,14,9825.750376,545.875021,701.839313,180.814792,4,0
0,0,13,13,15,25,40,61,49,110,0.000333,0.195137,7,4097.884633,227.660257,585.41209,174.699764,4,0
0,0,17,17,15,28,43,79,63,142,0.000333,0.256843,14,10787.41433,599.300796,770.529595,193.209297,4,0
0,0,7,7,11,15,26,36,24,60,0.000333,0.094009,5,1410.131915,78.340662,282.026383,96.657107,3,0
0,0,10,10,11,18,29,51,34,85,0.000333,0.137643,5,2064.641923,114.702329,412.928385,113.112398,3,0
0,0,8,8,11,16,27,38,26,64,0.000333,0.101438,5,1521.564001,84.531333,304.3128,102.053748,3,0
0,0,12,12,13,20,33,56,40,96,0.000333,0.161421,12,5811.142026,322.841224,484.261835,134.544278,3,0
0,0,13,13,15,25,40,67,51,118,0.000333,0.209329,14,8791.825213,488.434734,627.987515,174.699764,4,0
0,0,16,16,15,27,42,82,61,143,0.000333,0.257034,14,10795.41948,599.745527,771.101391,186.985321,4,0
0,0,14,14,15,26,41,69,53,122,0.000333,0.217874,14,9150.698824,508.372157,653.621345,180.814792,4,0
0,0,18,18,15,29,44,87,67,154,0.000333,0.280251,14,11770.53457,653.918587,840.752469,199.484808,4,0
0,0,7,7,11,15,26,36,24,60,0.000333,0.094009,5,1410.131915,78.340662,282.026383,96.657107,3,0
0,0,10,10,11,18,29,51,34,85,0.000333,0.137643,5,2064.641923,114.702329,412.928385,113.112398,3,0
0,0,8,8,11,16,27,38,26,64,0.000333,0.101438,5,1521.564001,84.531333,304.3128,102.053748,3,0
0,0,12,12,13,20,33,56,40,96,0.000333,0.161421,12,5811.142026,322.841224,484.261835,134.544278,3,0
0,0,6,6,11,16,27,31,24,55,0.000333,0.087173,5,1307.594063,72.644115,261.518813,102.053748,3,0
0,0,9,9,11,18,29,46,34,80,0.000333,0.129546,5,1943.192398,107.955133,388.63848,113.112398,3,0
0,0,7,7,11,17,28,33,26,59,0.000333,0.094545,5,1418.169702,78.787206,283.63394,107.540616,3,0
0,0,11,11,13,20,33,51,40,91,0.000333,0.153013,12,5508.478378,306.026577,459.039865,134.544278,3,0
0,0,6,6,13,13,26,33,21,54,0.000333,0.084608,6,1522.942469,84.607915,253.823745,96.211433,3,0
0,0,9,9,13,16,29,48,31,79,0.000333,0.127927,6,2302.682992,127.926833,383.780499,112.105716,3,0
0,0,7,7,13,14,27,35,23,58,0.000333,0.091928,6,1654.700851,91.927825,275.783475,101.408685,3,0
0,0,11,11,13,16,29,53,37,90,0.000333,0.145739,12,5246.619475,291.47886,437.21829,112.105716,3,0
0,0,13,13,14,25,39,64,51,115,0.000333,0.202607,14,8509.497572,472.749865,607.821255,169.399374,4,0
0,0,16,16,14,27,41,79,61,140,0.000333,0.250019,14,10500.80193,583.377885,750.057281,181.684931,4,0
0,0,14,14,14,26,40,66,53,119,0.000333,0.211103,14,8866.332206,492.574011,633.309443,175.514402,4,0
0,0,18,18,14,27,41,84,67,151,0.000333,0.269663,14,11325.86494,629.214719,808.990353,181.684931,4,0
0,0,7,7,11,15,26,36,24,60,0.000333,0.094009,5,1410.131915,78.340662,282.026383,96.657107,3,0
0,0,10,10,11,18,29,51,34,85,0.000333,0.137643,5,2064.641923,114.702329,412.928385,113.112398,3,0
0,0,8,8,11,16,27,38,26,64,0.000333,0.101438,5,1521.564001,84.531333,304.3128,102.053748,3,0
0,0,12,12,13,20,33,56,40,96,0.000333,0.161421,12,5811.142026,322.841224,484.261835,134.544278,3,0
0,0,14,14,15,26,41,61,57,118,0.000333,0.21073,14,8850.675912,491.704217,632.191137,180.814792,4,0
0,0,17,17,15,28,43,76,67,143,0.000333,0.258652,14,10863.38204,603.521224,775.95586,193.209297,4,0
0,0,15,15,15,27,42,63,59,122,0.000333,0.219288,14,9210.078158,511.671009,657.862726,186.985321,4,0
0,0,3,3,8,8,16,10,12,22,0.000333,0.029333,4,352,19.555556,88,48,1,0
0,0,3,3,8,7,15,10,11,21,0.000333,0.027348,4,328.17881,18.232156,82.044703,43.651484,1,0
0,0,3,3,8,8,16,10,12,22,0.000333,0.029333,4,352,19.555556,88,48,1,0
0,0,3,3,8,7,15,10,11,21,0.000333,0.027348,4,328.17881,18.232156,82.044703,43.651484,1,0
0,0,3,3,8,8,16,10,12,22,0.000333,0.029333,4,352,19.555556,88,48,1,0
0,0,3,3,8,8,16,10,12,22,0.000333,0.029333,4,352,19.555556,88,48,1,0
0,0,2,2,7,7,14,8,13,21,0.000333,0.026651,3,239.86336,13.325742,79.954453,39.302969,1,0
0,0,2,2,7,5,12,8,9,17,0.000333,0.020315,3,182.833088,10.157394,60.944363,31.261125,1,0
0,0,2,2,7,7,14,8,13,21,0.000333,0.026651,3,239.86336,13.325742,79.954453,39.302969,1,0
0,0,2,2,7,7,14,8,13,21,0.000333,0.026651,3,239.86336,13.325742,79.954453,39.302969,1,0
0,0,2,2,7,5,12,8,9,17,0.000333,0.020315,3,182.833088,10.157394,60.944363,31.261125,1,0
0,0,2,2,7,7,14,8,13,21,0.000333,0.026651,3,239.86336,13.325742,79.954453,39.302969,1,0
0,0,7,7,11,15,26,36,24,60,0.000333,0.094009,5,1410.131915,78.340662,282.026383,96.657107,3,0
0,0,10,10,11,18,29,51,34,85,0.000333,0.137643,5,2064.641923,114.702329,412.928385,113.112398,3,0
0,0,8,8,11,16,27,38,26,64,0.000333,0.101438,5,1521.564001,84.531333,304.3128,102.053748,3,0
0,0,12,12,13,20,33,56,40,96,0.000333,0.161421,12,5811.142026,322.841224,484.261835,134.544278,3,0
0,0,7,7,13,13,26,38,22,60,0.000333,0.094009,6,1692.158299,94.008794,282.026383,96.211433,3,0
0,0,10,10,13,17,30,53,32,85,0.000333,0.139029,6,2502.514204,139.028567,417.085701,117.592585,3,0
0,0,8,8,13,14,27,40,24,64,0.000333,0.101438,6,1825.876801,101.4376,304.3128,101.408685,3,0
0,0,12,12,15,19,34,58,38,96,0.000333,0.162799,14,6837.550059,379.863892,488.396433,139.313982,3,0
0,0,7,7,11,15,26,36,24,60,0.000333,0.094009,5,1410.131915,78.340662,282.026383,96.657107,3,0
0,0,10,10,11,18,29,51,34,85,0.000333,0.137643,5,2064.641923,114.702329,412.928385,113.112398,3,0
0,0,8,8,11,16,27,38,26,64,0.000333,0.101438,5,1521.564001,84.531333,304.3128,102.053748,3,0
0,0,12,12,13,20,33,56,40,96,0.000333,0.161421,12,5811.142026,322.841224,484.261835,134.544278,3,0
0,0,7,7,11,15,26,36,24,60,0.000333,0.094009,5,1410.131915,78.340662,282.026383,96.657107,3,0
0,0,10,10,11,18,29,51,34,85,0.000333,0.137643,5,2064.641923,114.702329,412.928385,113.112398,3,0
0,0,8,8,11,16,27,38,26,64,0.000333,0.101438,5,1521.564001,84.531333,304.3128,102.053748,3,0
0,0,12,12,13,20,33,56,40,96,0.000333,0.161421,12,5811.142026,322.841224,484.261835,134.544278,3,0
0,0,7,7,13,13,26,38,22,60,0.000333,0.094009,6,1692.158299,94.008794,282.026383,96.211433,3,0
0,0,10,10,13,17,30,53,32,85,0.000333,0.139029,6,2502.514204,139.028567,417.085701,117.592585,3,0
0,0,8,8,13,14,27,40,24,64,0.000333,0.101438,6,1825.876801,101.4376,304.3128,101.408685,3,0
0,0,12,12,15,19,34,58,38,96,0.000333,0.162799,14,6837.550059,379.863892,488.396433,139.313982,3,0
0,0,7,7,13,13,26,38,22,60,0.000333,0.094009,6,1692.158299,94.008794,282.026383,96.211433,3,0
0,0,10,10,13,17,30,53,32,85,0.000333,0.139029,6,2502.514204,139.028567,417.085701,117.592585,3,0
0,0,8,8,13,14,27,40,24,64,0.000333,0.101438,6,1825.876801,101.4376,304.3128,101.408685,3,0
0,0,12,12,15,19,34,58,38,96,0.000333,0.162799,14,6837.550059,379.863892,488.396433,139.313982,3,0
0,0,7,7,11,15,26,36,24,60,0.000333,0.094009,5,1410.131915,78.340662,282.026383,96.657107,3,0
0,0,10,10,11,18,29,51,34,85,0.000333,0.137643,5,2064.641923,114.702329,412.928385,113.112398,3,0
0,0,8,8,11,16,27,38,26,64,0.000333,0.101438,5,1521.564001,84.531333,304.3128,102.053748,3,0
0,0,12,12,13,20,33,56,40,96,0.000333,0.161421,12,5811.142026,322.841224,484.261835,134.544278,3,0
0,0,7,7,11,15,26,36,24,60,0.000333,0.094009,5,1410.131915,78.340662,282.026383,96.657107,3,0
0,0,10,10,11,18,29,51,34,85,0.000333,0.137643,5,2064.641923,114.702329,412.928385,113.112398,3,0
0,0,8,8,11,16,27,38,26,64,0.000333,0.101438,5,1521.564001,84.531333,304.3128,102.053748,3,0
0,0,12,12,13,20,33,56,40,96,0.000333,0.161421,12,5811.142026,322.841224,484.261835,134.544278,3,0
0,0,7,7,13,13,26,38,22,60,0.000333,0.094009,6,1692.158299,94.008794,282.026383,96.211433,3,0
0,0,10,10,13,17,30,53,32,85,0.000333,0.139029,6,2502.514204,139.028567,417.085701,117.592585,3,0
0,0,8,8,13,14,27,40,24,64,0.000333,0.101438,6,1825.876801,101.4376,304.3128,101.408685,3,0
0,0,12,12,15,19,34,58,38,96,0.000333,0.162799,14,6837.550059,379.863892,488.396433,139.313982,3,0
0,0,7,7,13,13,26,38,22,60,0.000333,0.094009,6,1692.158299,94.008794,282.026383,96.211433,3,0
0,0,10,10,13,17,30,53,32,85,0.000333,0.139029,6,2502.514204,139.028567,417.085701,117.592585,3,0
0,0,8,8,13,14,27,40,24,64,0.000333,0.101438,6,1825.876801,101.4376,304.3128,101.408685,3,0
0,0,12,12,15,19,34,58,38,96,0.000333,0.162799,14,6837.550059,379.863892,488.396433,139.313982,3,0
0,0,7,7,11,15,26,36,24,60,0.000333,0.094009,5,1410.131915,78.340662,282.026383,96.657107,3,0
0,0,10,10,11,18,29,51,34,85,0.000333,0.137643,5,2064.641923,114.702329,412.928385,113.112398,3,0
0,0,8,8,11,16,27,38,26,64,0.000333,0.101438,5,1521.564001,84.531333,304.3128,102.053748,3,0
0,0,12,12,13,20,33,56,40,96,0.000333,0.161421,12,5811.142026,322.841224,484.261835,134.544278,3,0
0,0,7,7,11,15,26,36,24,60,0.000333,0.094009,5,1410.131915,78.340662,282.026383,96.657107,3,0
0,0,10,10,11,18,29,51,34,85,0.000333,0.137643,5,2064.641923,114.702329,412.928385,113.112398,3,0
0,0,8,8,11,16,27,38,26,64,0.000333,0.101438,5,1521.564001,84.531333,304.3128,102.053748,3,0
0,0,12,12,13,20,33,56,40,96,0.000333,0.161421,12,5811.142026,322.841224,484.261835,134.544278,3,0
0,0,7,7,13,13,26,38,22,60,0.000333,0.094009,6,1692.158299,94.008794,282.026383,96.211433,3,0
0,0,10,10,13,17,30,53,32,85,0.000333,0.139029,6,2502.514204,139.028567,417.085701,117.592585,3,0
0,0,8,8,13,14,27,40,24,64,0.000333,0.101438,6,1825.876801,101.4376,304.3128,101.408685,3,0
0,0,12,12,15,19,34,58,38,96,0.000333,0.162799,14,6837.550059,379.863892,488.396433,139.313982,3,0
0,0,7,7,13,13,26,38,22,60,0.000333,0.094009,6,1692.158299,94.008794,282.026383,96.211433,3,0
0,0,10,10,13,17,30,53,32,85,0.000333,0.139029,6,2502.514204,139.028567,417.085701,117.592585,3,0
0,0,8,8,13,14,27,40,24,64,0.000333,0.101438,6,1825.876801,101.4376,304.3128,101.408685,3,0
0,0,12,12,15,19,34,58,38,96,0.000333,0.162799,14,6837.550059,379.863892,488.396433,139.313982,3,0
0,0,7,7,11,15,26,36,24,60,0.000333,0.094009,5,1410.131915,78.340662,282.026383,96.657107,3,0
0,0,10,10,11,18,29,51,34,85,0.000333,0.137643,5,2064.641923,114.702329,412.928385,113.112398,3,0
0,0,8,8,11,16,27,38,26,64,0.000333,0.101438,5,1521.564001,84.531333,304.3128,102.053748,3,0
0,0,12,12,13,20,33,56,40,96,0.000333,0.161421,12,5811.142026,322.841224,484.261835,134.544278,3,0
0,0,7,7,11,15,26,36,24,60,0.000333,0.094009,5,1410.131915,78.340662,282.026383,96.657107,3,0
0,0,10,10,11,18,29,51,34,85,0.000333,0.137643,5,2064.641923,114.702329,412.928385,113.112398,3,0
0,0,8,8,11,16,27,38,26,64,0.000333,0.101438,5,1521.564001,84.531333,304.3128,102.053748,3,0
0,0,12,12,13,20,33,56,40,96,0.000333,0.161421,12,5811.142026,322.841224,484.261835,134.544278,3,0
0,0,7,7,13,13,26,38,22,60,0.000333,0.094009,6,1692.158299,94.008794,282.026383,96.211433,3,0
0,0,10,10,13,17,30,53,32,85,0.000333,0.139029,6,2502.514204,139.028567,417.085701,117.592585,3,0
0,0,8,8,13,14,27,40,24,64,0.000333,0.101438,6,1825.876801,101.4376,304.3128,101.408685,3,0
0,0,12,12,15,19,34,58,38,96,0.000333,0.162799,14,6837.550059,379.863892,488.396433,139.313982,3,0
0,0,7,7,13,13,26,38,22,60,0.000333,0.094009,6,1692.158299,94.008794,282.026383,96.211433,3,0
0,0,10,10,13,17,30,53,32,85,0.000333,0.139029,6,2502.514204,139.028567,417.085701,117.592585,3,0
0,0,8,8,13,14,27,40,24,64,0.000333,0.101438,6,1825.876801,101.4376,304.3128,101.408685,3,0
0,0,12,12,15,19,34,58,38,96,0.000333,0.162799,14,6837.550059,379.863892,488.396433,139.313982,3,0
0,0,7,7,11,15,26,36,24,60,0.000333,0.094009,5,1410.131915,78.340662,282.026383,96.657107,3,0
0,0,10,10,11,18,29,51,34,85,0.000333,0.137643,5,2064.641923,114.702329,412.928385,113.112398,3,0
0,0,8,8,11,16,27,38,26,64,0.000333,0.101438,5,1521.564001,84.531333,304.3128,102.053748,3,0
0,0,12,12,13,20,33,56,40,96,0.000333,0.161421,12,5811.142026,322.841224,484.261835,134.544278,3,0
0,0,7,7,11,15,26,36,24,60,0.000333,0.094009,5,1410.131915,78.340662,282.026383,96.657107,3,0
0,0,10,10,11,18,29,51,34,85,0.000333,0.137643,5,2064.641923,114.702329,412.928385,113.112398,3,0
0,0,8,8,11,16,27,38,26,64,0.000333,0.101438,5,1521.564001,84.531333,304.3128,102.053748,3,0
0,0,12,12,13,20,33,56,40,96,0.000333,0.161421,12,5811.142026,322.841224,484.261835,134.544278,3,0
0,0,7,7,13,13,26,38,22,60,0.000333,0.094009,6,1692.158299,94.008794,282.026383,96.211433,3,0
0,0,10,10,13,17,30,53,32,85,0.000333,0.139029,6,2502.514204,139.028567,417.085701,117.592585,3,0
0,0,8,8,13,14,27,40,24,64,0.000333,0.101438,6,1825.876801,101.4376,304.3128,101.408685,3,0
0,0,12,12,15,19,34,58,38,96,0.000333,0.162799,14,6837.550059,379.863892,488.396433,139.313982,3,0
0,0,7,7,13,13,26,38,22,60,0.000333,0.094009,6,1692.158299,94.008794,282.026383,96.211433,3,0
0,0,10,10,13,17,30,53,32,85,0.000333,0.139029,6,2502.514204,139.028567,417.085701,117.592585,3,0
0,0,8,8,13,14,27,40,24,64,0.000333,0.101438,6,1825.876801,101.4376,304.3128,101.408685,3,0
0,0,12,12,15,19,34,58,38,96,0.000333,0.162799,14,6837.550059,379.863892,488.396433,139.313982,3,0
0,0,7,7,11,15,26,36,24,60,0.000333,0.094009,5,1410.131915,78.340662,282.026383,96.657107,3,0
0,0,10,10,11,18,29,51,34,85,0.000333,0.137643,5,2064.641923,114.702329,412.928385,113.112398,3,0
0,0,8,8,11,16,27,38,26,64,0.000333,0.101438,5,1521.564001,84.531333,304.3128,102.053748,3,0
0,0,12,12,13,20,33,56,40,96,0.000333,0.161421,12,5811.142026,322.841224,484.261835,134.544278,3,0
0,0,7,7,11,15,26,36,24,60,0.000333,0.094009,5,1410.131915,78.340662,282.026383,96.657107,3,0
0,0,10,10,11,18,29,51,34,85,0.000333,0.137643,5,2064.641923,114.702329,412.928385,113.112398,3,0
0,0,8,8,11,16,27,38,26,64,0.000333,0.101438,5,1521.564001,84.531333,304.3128,102.053748,3,0
0,0,12,12,13,20,33,56,40,96,0.000333,0.161421,12,5811.142026,322.841224,484.261835,134.544278,3,0
0,0,7,7,13,13,26,38,22,60,0.000333,0.094009,6,1692.158299,94.008794,282.026383,96.211433,3,0
0,0,10,10,13,17,30,53,32,85,0.000333,0.139029,6,2502.514204,139.028567,417.085701,117.592585,3,0
0,0,8,8,13,14,27,40,24,64,0.000333,0.101438,6,1825.876801,101.4376,304.3128,101.408685,3,0
0,0,12,12,15,19,34,58,38,96,0.000333,0.162799,14,6837.550059,379.863892,488.396433,139.313982,3,0
0,0,7,7,13,13,26,38,22,60,0.000333,0.094009,6,1692.158299,94.008794,282.026383,96.211433,3,0
0,0,10,10,13,17,30,53,32,85,0.000333,0.139029,6,2502.514204,139.028567,417.085701,117.592585,3,0
0,0,8,8,13,14,27,40,24,64,0.000333,0.101438,6,1825.876801,101.4376,304.3128,101.408685,3,0
0,0,12,12,15,19,34,58,38,96,0.000333,0.162799,14,6837.550059,379.863892,488.396433,139.313982,3,0
0,0,7,7,11,15,26,36,24,60,0.000333,0.094009,5,1410.131915,78.340662,282.026383,96.657107,3,0
0,0,10,10,11,18,29,51,34,85,0.000333,0.137643,5,2064.641923,114.702329,412.928385,113.112398,3,0
0,0,8,8,11,16,27,38,26,64,0.000333,0.101438,5,1521.564001,84.531333,304.3128,102.053748,3,0
0,0,12,12,13,20,33,56,40,96,0.000333,0.161421,12,5811.142026,322.841224,484.261835,134.544278,3,0
0,0,7,7,11,15,26,36,24,60,0.000333,0.094009,5,1410.131915,78.340662,282.026383,96.657107,3,0
0,0,10,10,11,18,29,51,34,85,0.000333,0.137643,5,2064.641923,114.702329,412.928385,113.112398,3,0
0,0,8,8,11,16,27,38,26,64,0.000333,0.101438,5,1521.564001,84.531333,304.3128,102.053748,3,0
0,0,12,12,13,20,33,56,40,96,0.000333,0.161421,12,5811.142026,322.841224,484.261835,134.544278,3,0
0,0,7,7,13,13,26,38,22,60,0.000333,0.094009,6,1692.158299,94.008794,282.026383,96.211433,3,0
0,0,10,10,13,17,30,53,32,85,0.000333,0.139029,6,2502.514204,139.028567,417.085701,117.592585,3,0
0,0,8,8,13,14,27,40,24,64,0.000333,0.101438,6,1825.876801,101.4376,304.3128,101.408685,3,0
0,0,12,12,15,19,34,58,38,96,0.000333,0.162799,14,6837.550059,379.863892,488.396433,139.313982,3,0
0,0,7,7,13,13,26,38,22,60,0.000333,0.094009,6,1692.158299,94.008794,282.026383,96.211433,3,0
0,0,10,10,13,17,30,53,32,85,0.000333,0.139029,6,2502.514204,139.028567,417.085701,117.592585,3,0
0,0,8,8,13,14,27,40,24,64,0.000333,0.101438,6,1825.876801,101.4376,304.3128,101.408685,3,0
0,0,12,12,15,19,34,58,38,96,0.000333,0.162799,14,6837.550059,379.863892,488.396433,139.313982,3,0
0,0,7,7,11,15,26,36,24,60,0.000333,0.094009,5,1410.131915,78.340662,282.026383,96.657107,3,0
0,0,10,10,11,18,29,51,34,85,0.000333,0.137643,5,2064.641923,114.702329,412.928385,113.112398,3,0
0,0,8,8,11,16,27,38,26,64,0.000333,0.101438,5,1521.564001,84.531333,304.3128,102.053748,3,0
0,0,12,12,13,20,33,56,40,96,0.000333,0.161421,12,5811.142026,322.841224,484.261835,134.544278,3,0
0,0,7,7,11,15,26,36,24,60,0.000333,0.094009,5,1410.131915,78.340662,282.026383,96.657107,3,0
0,0,10,10,11,18,29,51,34,85,0.000333,0.137643,5,2064.641923,114.702329,412.928385,113.112398,3,0
0,0,8,8,11,16,27,38,26,64,0.000333,0.101438,5,1521.564001,84.531333,304.3128,102.053748,3,0
0,0,12,12,13,20,33,56,40,96,0.000333,0.161421,12,5811.142026,322.841224,484.261835,134.544278,3,0
0,0,7,7,13,13,26,38,22,60,0.000333,0.094009,6,1692.158299,94.008794,282.026383,96.211433,3,0
0,0,10,10,13,17,30,53,32,85,0.000333,0.139029,6,2502.514204,139.028567,417.085701,117.592585,3,0
0,0,8,8,13,14,27,40,24,64,0.000333,0.101438,6,1825.876801,101.4376,304.3128,101.408685,3,0
0,0,12,12,15,19,34,58,38,96,0.000333,0.162799,14,6837.550059,379.863892,488.396433,139.313982,3,0
0,0,7,7,13,13,26,38,22,60,0.000333,0.094009,6,1692.158299,94.008794,282.026383,96.211433,3,0
0,0,10,10,13,17,30,53,32,85,0.000333,0.139029,6,2502.514204,139.028567,417.085701,117.592585,3,0
0,0,8,8,13,14,27,40,24,64,0.000333,0.101438,6,1825.876801,101.4376,304.3128,101.408685,3,0
0,0,12,12,15,19,34,58,38,96,0.000333,0.162799,14,6837.550059,379.863892,488.396433,139.313982,3,0
0,0,7,7,11,15,26,36,24,60,0.000333,0.094009,5,1410.131915,78.340662,282.026383,96.657107,3,0
0,0,10,10,11,18,29,51,34,85,0.000333,0.137643,5,2064.641923,114.702329,412.928385,113.112398,3,0
0,0,8,8,11,16,27,38,26,64,0.000333,0.101438,5,1521.564001,84.531333,304.3128,102.053748,3,0
0,0,12,12,13,20,33,56,40,96,0.000333,0.161421,12,5811.142026,322.841224,484.261835,134.544278,3,0
0,0,7,7,11,15,26,36,24,60,0.000333,0.094009,5,1410.131915,78.340662,282.026383,96.657107,3,0
0,0,10,10,11,18,29,51,34,85,0.000333,0.137643,5,2064.641923,114.702329,412.928385,113.112398,3,0
0,0,8,8,11,16,27,38,26,64,0.000333,0.101438,5,1521.564001,84.531333,304.3128,102.053748,3,0
0,0,12,12,13,20,33,56,40,96,0.000333,0.161421,12,5811.142026,322.841224,484.261835,134.544278,3,0
0,0,7,7,13,13,26,38,22,60,0.000333,0.094009,6,1692.158299,94.008794,282.026383,96.211433,3,0
0,0,10,10,13,17,30,53,32,85,0.000333,0.139029,6,2502.514204,139.028567,417.085701,117.592585,3,0
0,0,8,8,13,14,27,40,24,64,0.000333,0.101438,6,1825.876801,101.4376,304.3128,101.408685,3,0
0,0,12,12,15,19,34,58,38,96,0.000333,0.162799,14,6837.550059,379.863892,488.396433,139.313982,3,0
0,0,7,7,13,13,26,38,22,60,0.000333,0.094009,6,1692.158299,94.008794,282.026383,96.211433,3,0
0,0,10,10,13,17,30,53,32,85,0.000333,0.139029,6,2502.514204,139.028567,417.085701,117.592585,3,0
0,0,8,8,13,14,27,40,24,64,0.000333,0.101438,6,1825.876801,101.4376,304.3128,101.408685,3,0
0,0,12,12,15,19,34,58,38,96,0.000333,0.162799,14,6837.550059,379.863892,488.396433,139.313982,3,0
0,0,7,7,11,15,26,36,24,60,0.000333,0.094009,5,1410.131915,78.340662,282.026383,96.657107,3,0
0,0,10,10,11,18,29,51,34,85,0.000333,0.137643,5,2064.641923,114.702329,412.928385,113.112398,3,0
0,0,8,8,11,16,27,38,26,64,0.000333,0.101438,5,1521.564001,84.531333,304.3128,102.053748,3,0
0,0,12,12,13,20,33,56,40,96,0.000333,0.161421,12,5811.142026,322.841224,484.261835,134.544278,3,0
0,0,7,7,11,15,26,36,24,60,0.000333,0.094009,5,1410.131915,78.340662,282.026383,96.657107,3,0
0,0,10,10,11,18,29,51,34,85,0.000333,0.137643,5,2064.641923,114.702329,412.928385,113.112398,3,0
0,0,8,8,11,16,27,38,26,64,0.000333,0.101438,5,1521.564001,84.531333,304.3128,102.053748,3,0
0,0,12,12,13,20,33,56,40,96,0.000333,0.161421,12,5811.142026,322.841224,484.261835,134.544278,3,0
0,0,7,7,13,13,26,38,22,60,0.000333,0.094009,6,1692.158299,94.008794,282.026383,96.211433,3,0
0,0,10,10,13,17,30,53,32,85,0.000333,0.139029,6,2502.514204,139.028567,417.085701,117.592585,3,0
0,0,8,8,13,14,27,40,24,64,0.000333,0.101438,6,1825.876801,101.4376,304.3128,101.408685,3,0
0,0,12,12,15,19,34,58,38,96,0.000333,0.162799,14,6837.550059,379.863892,488.396433,139.313982,3,0
0,0,7,7,13,13,26,38,22,60,0.000333,0.094009,6,1692.158299,94.008794,282.026383,96.211433,3,0
0,0,10,10,13,17,30,53,32,85,0.000333,0.139029,6,2502.514204,139.028567,417.085701,117.592585,3,0
0,0,8,8,13,14,27,40,24,64,0.000333,0.101438,6,1825.876801,101.4376,304.3128,101.408685,3,0
0,0,12,12,15,19,34,58,38,96,0.000333,0.162799,14,6837.550059,379.863892,488.396433,139.313982,3,0
0,0,7,7,11,15,26,36,24,60,0.000333,0.094009,5,1410.131915,78.340662,282.026383,96.657107,3,0
0,0,10,10,11,18,29,51,34,85,0.000333,0.137643,5,2064.641923,114.702329,412.928385,113.112398,3,0
0,0,8,8,11,16,27,38,26,64,0.000333,0.101438,5,1521.564001,84.531333,304.3128,102.053748,3,0
0,0,12,12,13,20,33,56,40,96,0.000333,0.161421,12,5811.142026,322.841224,484.261835,134.544278,3,0
0,0,7,7,11,15,26,36,24,60,0.000333,0.094009,5,1410.131915,78.340662,282.026383,96.657107,3,0
0,0,10,10,11,18,29,51,34,85,0.000333,0.137643,5,2064.641923,114.702329,412.928385,113.112398,3,0
0,0,8,8,11,16,27,38,26,64,0.000333,0.101438,5,1521.564001,84.531333,304.3128,102.053748,3,0
0,0,12,12,13,20,33,56,40,96,0.000333,0.161421,12,5811.142026,322.841224,484.261835,134.544278,3,0
0,0,7,7,11,15,26,36,24,60,0.000333,0.094009,5,1410.131915,78.340662,282.026383,96.657107,3,0
0,0,10,10,11,18,29,51,34,85,0.000333,0.137643,5,2064.641923,114.702329,412.928385,113.112398,3,0
0,0,8,8,11,16,27,38,26,64,0.000333,0.101438,5,1521.564001,84.531333,304.3128,102.053748,3,0
0,0,12,12,13,20,33,56,40,96,0.000333,0.161421,12,5811.142026,322.841224,484.261835,134.544278,3,0
0,0,8,8,13,14,27,40,24,64,0.000333,0.101438,6,1825.876801,101.4376,304.3128,101.408685,3,0
0,0,11,11,13,18,31,55,34,89,0.000333,0.146974,6,2645.54083,146.974491,440.923472,123.164366,3,0
0,0,9,9,13,15,28,42,26,68,0.000333,0.108967,6,1961.400808,108.966712,326.900135,106.709075,3,0
0,0,13,13,15,20,35,60,40,100,0.000333,0.170976,14,7180.996224,398.944235,512.928302,145.041921,3,0
0,0,8,8,13,13,26,45,25,70,0.000333,0.109677,6,1974.184682,109.676927,329.03078,96.211433,3,0
0,0,11,11,13,17,30,60,35,95,0.000333,0.155385,12,5593.855279,310.769738,466.154607,117.592585,3,0
0,0,9,9,13,14,27,47,27,74,0.000333,0.117287,6,2111.170051,117.287225,351.861675,101.408685,3,0
0,0,13,13,15,19,34,65,41,106,0.000333,0.179757,14,7549.794856,419.433048,539.271061,139.313982,3,0
0,0,8,8,13,13,26,45,25,70,0.000333,0.109677,6,1974.184682,109.676927,329.03078,96.211433,3,0
0,0,11,11,13,17,30,60,35,95,0.000333,0.155385,12,5593.855279,310.769738,466.154607,117.592585,3,0
0,0,9,9,13,14,27,47,27,74,0.000333,0.117287,6,2111.170051,117.287225,351.861675,101.408685,3,0
0,0,13,13,15,19,34,65,41,106,0.000333,0.179757,14,7549.794856,419.433048,539.271061,139.313982,3,0
0,0,7,7,11,15,26,36,24,60,0.000333,0.094009,5,1410.131915,78.340662,282.026383,96.657107,3,0
0,0,10,10,11,18,29,51,34,85,0.000333,0.137643,5,2064.641923,114.702329,412.928385,113.112398,3,0
0,0,8,8,11,16,27,38,26,64,0.000333,0.101438,5,1521.564001,84.531333,304.3128,102.053748,3,0
0,0,12,12,13,20,33,56,40,96,0.000333,0.161421,12,5811.142026,322.841224,484.261835,134.544278,3,0
0,0,7,7,11,15,26,36,24,60,0.000333,0.094009,5,1410.131915,78.340662,282.026383,96.657107,3,0
0,0,10,10,11,18,29,51,34,85,0.000333,0.137643,5,2064.641923,114.702329,412.928385,113.112398,3,0
0,0,8,8,11,16,27,38,26,64,0.000333,0.101438,5,1521.564001,84.531333,304.3128,102.053748,3,0
0,0,12,12,13,20,33,56,40,96,0.000333,0.161421,12,5811.142026,322.841224,484.261835,134.544278,3,0
0,0,7,7,13,13,26,38,22,60,0.000333,0.094009,6,1692.158299,94.008794,282.026383,96.211433,3,0
0,0,10,10,13,17,30,53,32,85,0.000333,0.139029,6,2502.514204,139.028567,417.085701,117.592585,3,0
0,0,8,8,13,14,27,40,24,64,0.000333,0.101438,6,1825.876801,101.4376,304.3128,101.408685,3,0
0,0,12,12,15,19,34,58,38,96,0.000333,0.162799,14,6837.550059,379.863892,488.396433,139.313982,3,0
0,0,7,7,13,13,26,38,22,60,0.000333,0.094009,6,1692.158299,94.008794,282.026383,96.211433,3,0
0,0,10,10,13,17,30,53,32,85,0.000333,0.139029,6,2502.514204,139.028567,417.085701,117.592585,3,0
0,0,8,8,13,14,27,40,24,64,0.000333,0.101438,6,1825.876801,101.4376,304.3128,101.408685,3,0
0,0,12,12,15,19,34,58,38,96,0.000333,0.162799,14,6837.550059,379.863892,488.396433,139.313982,3,0
0,0,7,7,11,15,26,36,24,60,0.000333,0.094009,5,1410.131915,78.340662,282.026383,96.657107,3,0
0,0,10,10,11,18,29,51,34,85,0.000333,0.137643,5,2064.641923,114.702329,412.928385,113.112398,3,0
0,0,8,8,11,16,27,38,26,64,0.000333,0.101438,5,1521.564001,84.531333,304.3128,102.053748,3,0
0,0,12,12,13,20,33,56,40,96,0.000333,0.161421,12,5811.142026,322.841224,484.261835,134.544278,3,0
0,0,7,7,11,15,26,36,24,60,0.000333,0.094009,5,1410.131915,78.340662,282.026383,96.657107,3,0
0,0,10,10,11,18,29,51,34,85,0.000333,0.137643,5,2064.641923,114.702329,412.928385,113.112398,3,0
0,0,8,8,11,16,27,38,26,64,0.000333,0.101438,5,1521.564001,84.531333,304.3128,102.053748,3,0
0,0,12,12,13,20,33,56,40,96,0.000333,0.161421,12,5811.142026,322.841224,484.261835,134.544278,3,0
0,0,7,7,13,13,26,38,22,60,0.000333,0.094009,6,1692.158299,94.008794,282.026383,96.211433,3,0
0,0,10,10,13,17,30,53,32,85,0.000333,0.139029,6,2502.514204,139.028567,417.085701,117.592585,3,0
0,0,8,8,13,14,27,40,24,64,0.000333,0.101438,6,1825.876801,101.4376,304.3128,101.408685,3,0
0,0,12,12,15,19,34,58,38,96,0.000333,0.162799,14,6837.550059,379.863892,488.396433,139.313982,3,0
0,0,7,7,13,13,26,38,22,60,0.000333,0.094009,6,1692.158299,94.008794,282.026383,96.211433,3,0
0,0,10,10,13,17,30,53,32,85,0.000333,0.139029,6,2502.514204,139.028567,417.085701,117.592585,3,0
0,0,8,8,13,14,27,40,24,64,0.000333,0.101438,6,1825.876801,101.4376,304.3128,101.408685,3,0
0,0,12,12,15,19,34,58,38,96,0.000333,0.162799,14,6837.550059,379.863892,488.396433,139.313982,3,0
0,0,7,7,11,15,26,36,24,60,0.000333,0.094009,5,1410.131915,78.340662,282.026383,96.657107,3,0
0,0,10,10,11,18,29,51,34,85,0.000333,0.137643,5,2064.641923,114.702329,412.928385,113.112398,3,0
0,0,8,8,11,16,27,38,26,64,0.000333,0.101438,5,1521.564001,84.531333,304.3128,102.053748,3,0
0,0,12,12,13,20,33,56,40,96,0.000333,0.161421,12,5811.142026,322.841224,484.261835,134.544278,3,0
0,0,7,7,11,15,26,36,24,60,0.000333,0.094009,5,1410.131915,78.340662,282.026383,96.657107,3,0
0,0,10,10,11,18,29,51,34,85,0.000333,0.137643,5,2064.641923,114.702329,412.928385,113.112398,3,0
0,0,8,8,11,16,27,38,26,64,0.000333,0.101438,5,1521.564001,84.531333,304.3128,102.053748,3,0
0,0,12,12,13,20,33,56,40,96,0.000333,0.161421,12,5811.142026,322.841224,484.261835,134.544278,3,0
0,0,7,7,13,13,26,38,22,60,0.000333,0.094009,6,1692.158299,94.008794,282.026383,96.211433,3,0
0,0,10,10,13,17,30,53,32,85,0.000333,0.139029,6,2502.514204,139.028567,417.085701,117.592585,3,0
0,0,8,8,13,14,27,40,24,64,0.000333,0.101438,6,1825.876801,101.4376,304.3128,101.408685,3,0
0,0,12,12,15,19,34,58,38,96,0.000333,0.162799,14,6837.550059,379.863892,488.396433,139.313982,3,0
0,0,7,7,13,13,26,38,22,60,0.000333,0.094009,6,1692.158299,94.008794,282.026383,96.211433,3,0
0,0,10,10,13,17,30,53,32,85,0.000333,0.139029,6,2502.514204,139.028567,417.085701,117.592585,3,0
0,0,8,8,13,14,27,40,24,64,0.000333,0.101438,6,1825.876801,101.4376,304.3128,101.408685,3,0
0,0,12,12,15,19,34,58,38,96,0.000333,0.162799,14,6837.550059,379.863892,488.396433,139.313982,3,0
0,0,7,7,11,15,26,36,24,60,0.000333,0.094009,5,1410.131915,78.340662,282.026383,96.657107,3,0
0,0,10,10,11,18,29,51,34,85,0.000333,0.137643,5,2064.641923,114.702329,412.928385,113.112398,3,0
0,0,8,8,11,16,27,38,26,64,0.000333,0.101438,5,1521.564001,84.531333,304.3128,102.053748,3,0
0,0,12,12,13,20,33,56,40,96,0.000333,0.161421,12,5811.142026,322.841224,484.261835,134.544278,3,0
0,0,7,7,11,12,23,33,21,54,0.000333,0.081424,5,1221.361728,67.853429,244.272346,81.073298,3,0
0,0,10,10,11,16,27,48,31,79,0.000333,0.125212,5,1878.180563,104.343365,375.636113,102.053748,3,0
0,0,8,8,11,13,24,35,23,58,0.000333,0.088643,5,1329.639125,73.86884,265.927825,86.159464,3,0
0,0,12,12,13,18,31,53,37,90,0.000333,0.148626,12,5350.532015,297.251779,445.877668,123.164366,3,0
0,0,7,7,11,15,26,36,24,60,0.000333,0.094009,5,1410.131915,78.340662,282.026383,96.657107,3,0
0,0,10,10,11,18,29,51,34,85,0.000333,0.137643,5,2064.641923,114.702329,412.928385,113.112398,3,0
0,0,8,8,11,16,27,38,26,64,0.000333,0.101438,5,1521.564001,84.531333,304.3128,102.053748,3,0
0,0,12,12,13,20,33,56,40,96,0.000333,0.161421,12,5811.142026,322.841224,484.261835,134.544278,3,0
0,0,7,7,11,12,23,33,21,54,0.000333,0.081424,5,1221.361728,67.853429,244.272346,81.073298,3,0
0,0,10,10,11,16,27,48,31,79,0.000333,0.125212,5,1878.180563,104.343365,375.636113,102.053748,3,0
0,0,8,8,11,13,24,35,23,58,0.000333,0.088643,5,1329.639125,73.86884,265.927825,86.159464,3,0
0,0,12,12,13,18,31,53,37,90,0.000333,0.148626,12,5350.532015,297.251779,445.877668,123.164366,3,0
0,0,7,7,11,15,26,36,24,60,0.000333,0.094009,5,1410.131915,78.340662,282.026383,96.657107,3,0
0,0,10,10,11,18,29,51,34,85,0.000333,0.137643,5,2064.641923,114.702329,412.928385,113.112398,3,0
0,0,8,8,11,16,27,38,26,64,0.000333,0.101438,5,1521.564001,84.531333,304.3128,102.053748,3,0
0,0,12,12,13,20,33,56,40,96,0.000333,0.161421,12,5811.142026,322.841224,484.261835,134.544278,3,0
0,0,6,6,11,11,22,31,19,50,0.000333,0.074324,5,1114.857905,61.93655,222.971581,76.107496,3,0
0,0,9,9,11,15,26,46,29,75,0.000333,0.117511,5,1762.664894,97.925827,352.532979,96.657107,3,0
0,0,7,7,11,12,23,33,21,54,0.000333,0.081424,5,1221.361728,67.853429,244.272346,81.073298,3,0
0,0,11,11,13,17,30,51,35,86,0.000333,0.140664,12,5063.911095,281.328394,421.992591,117.592585,3,0
0,0,7,7,11,15,26,36,24,60,0.000333,0.094009,5,1410.131915,78.340662,282.026383,96.657107,3,0
0,0,10,10,11,18,29,51,34,85,0.000333,0.137643,5,2064.641923,114.702329,412.928385,113.112398,3,0
0,0,8,8,11,16,27,38,26,64,0.000333,0.101438,5,1521.564001,84.531333,304.3128,102.053748,3,0
0,0,12,12,13,20,33,56,40,96,0.000333,0.161421,12,5811.142026,322.841224,484.261835,134.544278,3,0
0,0,7,7,11,15,26,36,24,60,0.000333,0.094009,5,1410.131915,78.340662,282.026383,96.657107,3,0
0,0,10,10,11,18,29,51,34,85,0.000333,0.137643,5,2064.641923,114.702329,412.928385,113.112398,3,0
0,0,8,8,11,16,27,38,26,64,0.000333,0.101438,5,1521.564001,84.531333,304.3128,102.053748,3,0
0,0,12,12,13,20,33,56,40,96,0.000333,0.161421,12,5811.142026,322.841224,484.261835,134.544278,3,0
0,0,9,9,14,18,32,44,32,76,0.000333,0.126667,7,2660,147.777778,380,128.361619,3,0
0,0,10,10,14,19,33,54,38,92,0.000333,0.154695,14,6497.179626,360.954424,464.084259,134.013592,3,0
0,0,10,10,14,19,33,46,34,80,0.000333,0.134517,7,2824.860707,156.936706,403.55153,134.013592,3,0
0,0,12,12,16,21,37,59,42,101,0.000333,0.175385,16,8418.476639,467.693147,526.15479,156.238666,3,0
0,0,9,9,14,18,32,44,32,76,0.000333,0.126667,7,2660,147.777778,380,128.361619,3,0
0,0,10,10,14,20,34,54,36,90,0.000333,0.152624,7,3205.10159,178.061199,457.871656,139.741531,3,0
0,0,10,10,14,19,33,46,34,80,0.000333,0.134517,7,2824.860707,156.936706,403.55153,134.013592,3,0
0,0,12,12,16,20,36,59,40,99,0.000333,0.170608,16,8189.161202,454.9534,511.822575,150.438562,3,0
0,0,7,7,11,15,26,36,24,60,0.000333,0.094009,5,1410.131915,78.340662,282.026383,96.657107,3,0
0,0,10,10,11,18,29,51,34,85,0.000333,0.137643,5,2064.641923,114.702329,412.928385,113.112398,3,0
0,0,8,8,11,16,27,38,26,64,0.000333,0.101438,5,1521.564001,84.531333,304.3128,102.053748,3,0
0,0,12,12,13,20,33,56,40,96,0.000333,0.161421,12,5811.142026,322.841224,484.261835,134.544278,3,0
0,0,7,7,11,15,26,36,24,60,0.000333,0.094009,5,1410.131915,78.340662,282.026383,96.657107,3,0
0,0,10,10,11,18,29,51,34,85,0.000333,0.137643,5,2064.641923,114.702329,412.928385,113.112398,3,0
0,0,8,8,11,16,27,38,26,64,0.000333,0.101438,5,1521.564001,84.531333,304.3128,102.053748,3,0
0,0,12,12,13,20,33,56,40,96,0.000333,0.161421,12,5811.142026,322.841224,484.261835,134.544278,3,0
0,0,6,6,11,17,28,31,25,56,0.000333,0.089737,5,1346.059378,74.781077,269.211876,107.540616,3,0
0,0,9,9,11,19,30,46,35,81,0.000333,0.132486,5,1987.290691,110.405038,397.458138,118.764371,3,0
0,0,7,7,11,18,29,33,27,60,0.000333,0.09716,5,1457.394299,80.96635,291.47886,113.112398,3,0
0,0,11,11,13,21,34,51,41,92,0.000333,0.156016,6,2808.279488,156.015527,468.046581,140.344382,3,0
0,0,6,6,11,17,28,31,25,56,0.000333,0.089737,5,1346.059378,74.781077,269.211876,107.540616,3,0
0,0,9,9,11,19,30,46,35,81,0.000333,0.132486,5,1987.290691,110.405038,397.458138,118.764371,3,0
0,0,7,7,11,18,29,33,27,60,0.000333,0.09716,5,1457.394299,80.96635,291.47886,113.112398,3,0
0,0,11,11,13,21,34,51,41,92,0.000333,0.156016,6,2808.279488,156.015527,468.046581,140.344382,3,0
0,0,7,7,11,15,26,36,24,60,0.000333,0.094009,5,1410.131915,78.340662,282.026383,96.657107,3,0
0,0,10,10,11,18,29,51,34,85,0.000333,0.137643,5,2064.641923,114.702329,412.928385,113.112398,3,0
0,0,8,8,11,16,27,38,26,64,0.000333,0.101438,5,1521.564001,84.531333,304.3128,102.053748,3,0
0,0,12,12,13,20,33,56,40,96,0.000333,0.161421,12,5811.142026,322.841224,484.261835,134.544278,3,0
0,0,9,9,13,15,28,42,28,70,0.000333,0.112172,6,2019.089067,112.171615,336.514845,106.709075,3,0
0,0,12,12,13,18,31,57,38,95,0.000333,0.156883,12,5647.783794,313.765766,470.648649,123.164366,3,0
0,0,10,10,13,16,29,44,30,74,0.000333,0.11983,6,2156.943562,119.830198,359.490594,112.105716,3,0
0,0,14,14,15,20,35,62,44,106,0.000333,0.181235,14,7611.855997,422.880889,543.704,145.041921,3,0
0,0,7,7,11,15,26,36,24,60,0.000333,0.094009,5,1410.131915,78.340662,282.026383,96.657107,3,0
0,0,10,10,11,18,29,51,34,85,0.000333,0.137643,5,2064.641923,114.702329,412.928385,113.112398,3,0
0,0,8,8,11,16,27,38,26,64,0.000333,0.101438,5,1521.564001,84.531333,304.3128,102.053748,3,0
0,0,12,12,13,20,33,56,40,96,0.000333,0.161421,12,5811.142026,322.841224,484.261835,134.544278,3,0
0,0,7,7,12,12,24,36,23,59,0.000333,0.090171,6,1623.076725,90.170929,270.512788,86.0391,3,0
0,0,10,10,12,15,27,51,33,84,0.000333,0.133137,12,4792.926602,266.2737,399.41055,101.622909,3,0
0,0,8,8,12,13,25,38,25,63,0.000333,0.097521,6,1755.37764,97.52098,292.56294,91.125266,3,0
0,0,7,7,11,15,26,36,24,60,0.000333,0.094009,5,1410.131915,78.340662,282.026383,96.657107,3,0
0,0,10,10,11,18,29,51,34,85,0.000333,0.137643,5,2064.641923,114.702329,412.928385,113.112398,3,0
0,0,8,8,11,16,27,38,26,64,0.000333,0.101438,5,1521.564001,84.531333,304.3128,102.053748,3,0
0,0,12,12,13,20,33,56,40,96,0.000333,0.161421,12,5811.142026,322.841224,484.261835,134.544278,3,0
0,0,7,7,12,16,28,33,25,58,0.000333,0.092942,6,1672.959513,92.942195,278.826585,107.01955,3,0
0,0,10,10,12,19,31,48,35,83,0.000333,0.137066,6,2467.189763,137.066098,411.198294,123.730173,3,0
0,0,8,8,12,17,29,35,27,62,0.000333,0.100398,6,1807.16893,100.398274,301.194822,112.506418,3,0
0,0,7,7,11,15,26,36,24,60,0.000333,0.094009,5,1410.131915,78.340662,282.026383,96.657107,3,0
0,0,10,10,11,18,29,51,34,85,0.000333,0.137643,5,2064.641923,114.702329,412.928385,113.112398,3,0
0,0,8,8,11,16,27,38,26,64,0.000333,0.101438,5,1521.564001,84.531333,304.3128,102.053748,3,0
0,0,12,12,13,20,33,56,40,96,0.000333,0.161421,12,5811.142026,322.841224,484.261835,134.544278,3,0
0,0,9,9,14,17,31,44,30,74,0.000333,0.122204,7,2566.273689,142.57076,366.610527,122.789837,3,0
0,0,10,10,14,18,32,54,35,89,0.000333,0.148333,7,3115,173.055556,445,128.361619,3,0
0,0,10,10,14,18,32,46,32,78,0.000333,0.13,7,2730,151.666667,390,128.361619,3,0
0,0,12,12,16,20,36,59,40,99,0.000333,0.170608,16,8189.161202,454.9534,511.822575,150.438562,3,0
0,0,7,7,11,15,26,36,24,60,0.000333,0.094009,5,1410.131915,78.340662,282.026383,96.657107,3,0
0,0,10,10,11,18,29,51,34,85,0.000333,0.137643,5,2064.641923,114.702329,412.928385,113.112398,3,0
0,0,8,8,11,16,27,38,26,64,0.000333,0.101438,5,1521.564001,84.531333,304.3128,102.053748,3,0
0,0,12,12,13,20,33,56,40,96,0.000333,0.161421,12,5811.142026,322.841224,484.261835,134.544278,3,0
0,0,16,16,15,16,31,74,49,123,0.000333,0.203122,21,12796.68907,710.927171,609.366146,122.603359,3,0
0,0,19,19,15,19,34,89,59,148,0.000333,0.250982,21,15811.83451,878.435251,752.944501,139.313982,3,0
0,0,17,17,15,17,32,76,51,127,0.000333,0.211667,21,13335,740.833333,635,128.090227,3,0
0,0,21,21,17,21,38,94,65,159,0.000333,0.27814,24,20026.09139,1112.560633,834.420475,161.725534,3,0
0,0,7,7,11,15,26,36,24,60,0.000333,0.094009,5,1410.131915,78.340662,282.026383,96.657107,3,0
0,0,10,10,11,18,29,51,34,85,0.000333,0.137643,5,2064.641923,114.702329,412.928385,113.112398,3,0
0,0,8,8,11,16,27,38,26,64,0.000333,0.101438,5,1521.564001,84.531333,304.3128,102.053748,3,0
0,0,12,12,13,20,33,56,40,96,0.000333,0.161421,12,5811.142026,322.841224,484.261835,134.544278,3,0
0,0,6,6,12,14,26,32,22,54,0.000333,0.084608,6,1522.942469,84.607915,253.823745,96.322519,3,0
0,0,7,7,12,15,27,34,24,58,0.000333,0.091928,6,1654.700851,91.927825,275.783475,101.622909,3,0
0,0,7,7,11,15,26,36,24,60,0.000333,0.094009,5,1410.131915,78.340662,282.026383,96.657107,3,0
0,0,10,10,11,18,29,51,34,85,0.000333,0.137643,5,2064.641923,114.702329,412.928385,113.112398,3,0
0,0,8,8,11,16,27,38,26,64,0.000333,0.101438,5,1521.564001,84.531333,304.3128,102.053748,3,0
0,0,12,12,13,20,33,56,40,96,0.000333,0.161421,12,5811.142026,322.841224,484.261835,134.544278,3,0
0,0,10,10,13,20,33,43,35,78,0.000333,0.131154,6,2360.776448,131.154247,393.462741,134.544278,3,0
0,0,13,13,13,23,36,58,45,103,0.000333,0.177501,6,3195.013651,177.500758,532.502275,152.147641,3,0
0,0,11,11,13,21,34,45,37,82,0.000333,0.139057,6,2503.031718,139.057318,417.171953,140.344382,3,0
0,0,15,15,15,25,40,63,51,114,0.000333,0.202233,14,8493.797239,471.877624,606.699803,174.699764,3,0
0,0,7,7,11,15,26,36,24,60,0.000333,0.094009,5,1410.131915,78.340662,282.026383,96.657107,3,0
0,0,10,10,11,18,29,51,34,85,0.000333,0.137643,5,2064.641923,114.702329,412.928385,113.112398,3,0
0,0,8,8,11,16,27,38,26,64,0.000333,0.101438,5,1521.564001,84.531333,304.3128,102.053748,3,0
0,0,12,12,13,20,33,56,40,96,0.000333,0.161421,12,5811.142026,322.841224,484.261835,134.544278,3,0
0,0,9,9,13,19,32,43,34,77,0.000333,0.128333,6,2310,128.333333,385,128.816339,3,0
0,0,10,10,13,20,33,53,41,94,0.000333,0.158058,12,5690.076567,316.115365,474.173047,134.544278,3,0
0,0,10,10,13,20,33,45,36,81,0.000333,0.136199,6,2451.575542,136.198641,408.595924,134.544278,3,0
0,0,12,12,15,22,37,58,44,102,0.000333,0.177121,14,7439.099406,413.2833,531.364243,156.710855,3,0
0,0,7,7,11,15,26,36,24,60,0.000333,0.094009,5,1410.131915,78.340662,282.026383,96.657107,3,0
0,0,10,10,11,18,29,51,34,85,0.000333,0.137643,5,2064.641923,114.702329,412.928385,113.112398,3,0
0,0,8,8,11,16,27,38,26,64,0.000333,0.101438,5,1521.564001,84.531333,304.3128,102.053748,3,0
0,0,12,12,13,20,33,56,40,96,0.000333,0.161421,12,5811.142026,322.841224,484.261835,134.544278,3,0
0,0,8,8,11,17,28,36,36,72,0.000333,0.115377,10,3461.295544,192.294197,346.129554,107.540616,3,0
0,0,11,11,11,19,30,51,46,97,0.000333,0.158656,10,4759.683878,264.426882,475.968388,118.764371,3,0
0,0,9,9,11,18,29,38,38,76,0.000333,0.123069,10,3692.065556,205.114753,369.206556,113.112398,3,0
0,0,13,13,13,21,34,56,52,108,0.000333,0.183149,12,6593.351842,366.297325,549.445987,140.344382,3,0
0,0,7,7,11,15,26,36,24,60,0.000333,0.094009,5,1410.131915,78.340662,282.026383,96.657107,3,0
0,0,10,10,11,18,29,51,34,85,0.000333,0.137643,5,2064.641923,114.702329,412.928385,113.112398,3,0
0,0,8,8,11,16,27,38,26,64,0.000333,0.101438,5,1521.564001,84.531333,304.3128,102.053748,3,0
0,0,12,12,13,20,33,56,40,96,0.000333,0.161421,12,5811.142026,322.841224,484.261835,134.544278,3,0
0,0,8,8,11,17,28,36,36,72,0.000333,0.115377,10,3461.295544,192.294197,346.129554,107.540616,3,0
0,0,11,11,11,19,30,51,46,97,0.000333,0.158656,10,4759.683878,264.426882,475.968388,118.764371,3,0
0,0,9,9,11,18,29,38,38,76,0.000333,0.123069,10,3692.065556,205.114753,369.206556,113.112398,3,0
0,0,13,13,13,21,34,56,52,108,0.000333,0.183149,12,6593.351842,366.297325,549.445987,140.344382,3,0
0,0,7,7,11,15,26,36,24,60,0.000333,0.094009,5,1410.131915,78.340662,282.026383,96.657107,3,0
0,0,10,10,11,18,29,51,34,85,0.000333,0.137643,5,2064.641923,114.702329,412.928385,113.112398,3,0
0,0,8,8,11,16,27,38,26,64,0.000333,0.101438,5,1521.564001,84.531333,304.3128,102.053748,3,0
0,0,12,12,13,20,33,56,40,96,0.000333,0.161421,12,5811.142026,322.841224,484.261835,134.544278,3,0
0,0,8,8,11,17,28,36,36,72,0.000333,0.115377,10,3461.295544,192.294197,346.129554,107.540616,3,0
0,0,11,11,11,19,30,51,46,97,0.000333,0.158656,10,4759.683878,264.426882,475.968388,118.764371,3,0
0,0,9,9,11,18,29,38,38,76,0.000333,0.123069,10,3692.065556,205.114753,369.206556,113.112398,3,0
0,0,13,13,13,21,34,56,52,108,0.000333,0.183149,12,6593.351842,366.297325,549.445987,140.344382,3,0
0,0,7,7,11,15,26,36,24,60,0.000333,0.094009,5,1410.131915,78.340662,282.026383,96.657107,3,0
0,0,10,10,11,18,29,51,34,85,0.000333,0.137643,5,2064.641923,114.702329,412.928385,113.112398,3,0
0,0,8,8,11,16,27,38,26,64,0.000333,0.101438,5,1521.564001,84.531333,304.3128,102.053748,3,0
0,0,12,12,13,20,33,56,40,96,0.000333,0.161421,12,5811.142026,322.841224,484.261835,134.544278,3,0
0,0,17,17,14,18,32,77,61,138,0.000333,0.23,21,14490,805,690,128.361619,3,0
0,0,20,20,14,21,35,92,71,163,0.000333,0.278691,21,17557.53577,975.418654,836.073132,145.541635,3,0
0,0,18,18,14,19,33,79,63,142,0.000333,0.238768,21,15042.38326,835.687959,716.303965,134.013592,3,0
0,0,22,22,16,23,39,97,77,174,0.000333,0.306553,24,22071.83967,1226.213315,919.659986,168.041925,3,0
0,0,7,7,11,15,26,36,24,60,0.000333,0.094009,5,1410.131915,78.340662,282.026383,96.657107,3,0
0,0,10,10,11,18,29,51,34,85,0.000333,0.137643,5,2064.641923,114.702329,412.928385,113.112398,3,0
0,0,8,8,11,16,27,38,26,64,0.000333,0.101438,5,1521.564001,84.531333,304.3128,102.053748,3,0
0,0,12,12,13,20,33,56,40,96,0.000333,0.161421,12,5811.142026,322.841224,484.261835,134.544278,3,0
0,0,10,10,13,20,33,48,37,85,0.000333,0.142925,6,2572.641001,142.9245,428.7735,134.544278,3,0
0,0,12,12,13,21,34,61,49,110,0.000333,0.18654,12,6715.45095,373.080608,559.620913,140.344382,3,0
0,0,11,11,13,21,34,50,39,89,0.000333,0.150928,6,2716.705157,150.928064,452.784193,140.344382,3,0
0,0,13,13,15,23,38,61,47,108,0.000333,0.188925,14,7934.8664,440.825911,566.776171,162.645284,3,0
0,0,7,7,11,15,26,36,24,60,0.000333,0.094009,5,1410.131915,78.340662,282.026383,96.657107,3,0
0,0,10,10,11,18,29,51,34,85,0.000333,0.137643,5,2064.641923,114.702329,412.928385,113.112398,3,0
0,0,8,8,11,16,27,38,26,64,0.000333,0.101438,5,1521.564001,84.531333,304.3128,102.053748,3,0
0,0,12,12,13,20,33,56,40,96,0.000333,0.161421,12,5811.142026,322.841224,484.261835,134.544278,3,0
0,0,11,11,13,21,34,56,41,97,0.000333,0.164495,6,2960.903374,164.494632,493.483896,140.344382,3,0
0,0,12,12,13,22,35,66,48,114,0.000333,0.194913,12,7016.859167,389.825509,584.738264,146.213212,3,0
0,0,12,12,13,22,35,58,43,101,0.000333,0.172686,6,3108.345508,172.685862,518.057585,146.213212,3,0
0,0,7,7,11,15,26,36,24,60,0.000333,0.094009,5,1410.131915,78.340662,282.026383,96.657107,3,0
0,0,10,10,11,18,29,51,34,85,0.000333,0.137643,5,2064.641923,114.702329,412.928385,113.112398,3,0
0,0,8,8,11,16,27,38,26,64,0.000333,0.101438,5,1521.564001,84.531333,304.3128,102.053748,3,0
0,0,12,12,13,20,33,56,40,96,0.000333,0.161421,12,5811.142026,322.841224,484.261835,134.544278,3,0
0,0,6,6,11,16,27,31,24,55,0.000333,0.087173,5,1307.594063,72.644115,261.518813,102.053748,3,0
0,0,9,9,11,18,29,46,34,80,0.000333,0.129546,5,1943.192398,107.955133,388.63848,113.112398,3,0
0,0,7,7,11,17,28,33,26,59,0.000333,0.094545,5,1418.169702,78.787206,283.63394,107.540616,3,0
0,0,11,11,13,20,33,51,40,91,0.000333,0.153013,12,5508.478378,306.026577,459.039865,134.544278,3,0
0,0,6,6,13,13,26,33,21,54,0.000333,0.084608,6,1522.942469,84.607915,253.823745,96.211433,3,0
0,0,9,9,13,16,29,48,31,79,0.000333,0.127927,6,2302.682992,127.926833,383.780499,112.105716,3,0
0,0,7,7,13,14,27,35,23,58,0.000333,0.091928,6,1654.700851,91.927825,275.783475,101.408685,3,0
0,0,11,11,13,16,29,53,37,90,0.000333,0.145739,12,5246.619475,291.47886,437.21829,112.105716,3,0
0,0,11,11,15,21,36,53,41,94,0.000333,0.161991,7,3401.810651,188.989481,485.97295,150.842025,3,0
0,0,12,12,15,22,37,63,48,111,0.000333,0.19275,14,8095.49053,449.749474,578.249324,156.710855,3,0
0,0,12,12,15,22,37,55,43,98,0.000333,0.170175,7,3573.685009,198.538056,510.52643,156.710855,3,0
0,0,7,7,11,15,26,36,24,60,0.000333,0.094009,5,1410.131915,78.340662,282.026383,96.657107,3,0
0,0,10,10,11,18,29,51,34,85,0.000333,0.137643,5,2064.641923,114.702329,412.928385,113.112398,3,0
0,0,8,8,11,16,27,38,26,64,0.000333,0.101438,5,1521.564001,84.531333,304.3128,102.053748,3,0
0,0,12,12,13,20,33,56,40,96,0.000333,0.161421,12,5811.142026,322.841224,484.261835,134.544278,3,0
0,0,12,12,14,22,36,50,47,97,0.000333,0.167161,14,7020.758152,390.04212,501.482725,151.410465,3,0
0,0,13,13,14,23,37,60,56,116,0.000333,0.201432,14,8460.152266,470.008459,604.29659,157.344894,3,0
0,0,13,13,14,23,37,52,49,101,0.000333,0.175385,14,7366.167059,409.231503,526.15479,157.344894,3,0
0,0,7,7,11,15,26,36,24,60,0.000333,0.094009,5,1410.131915,78.340662,282.026383,96.657107,3,0
0,0,10,10,11,18,29,51,34,85,0.000333,0.137643,5,2064.641923,114.702329,412.928385,113.112398,3,0
0,0,8,8,11,16,27,38,26,64,0.000333,0.101438,5,1521.564001,84.531333,304.3128,102.053748,3,0
0,0,12,12,13,20,33,56,40,96,0.000333,0.161421,12,5811.142026,322.841224,484.261835,134.544278,3,0
0,0,10,10,13,20,33,43,37,80,0.000333,0.134517,6,2421.309177,134.517177,403.55153,134.544278,3,0
0,0,13,13,13,23,36,58,47,105,0.000333,0.180947,12,6514.105502,361.89475,542.842125,152.147641,3,0
0,0,11,11,13,21,34,45,39,84,0.000333,0.142449,6,2564.081272,142.44896,427.346879,140.344382,3,0
0,0,15,15,15,25,40,63,53,116,0.000333,0.205781,14,8642.811226,480.156179,617.343659,174.699764,3,0
0,0,3,3,8,7,15,10,11,21,0.000333,0.027348,4,328.17881,18.232156,82.044703,43.651484,1,0
0,0,3,3,8,8,16,10,12,22,0.000333,0.029333,4,352,19.555556,88,48,1,0
0,0,3,3,8,8,16,10,12,22,0.000333,0.029333,4,352,19.555556,88,48,1,0
0,0,3,3,8,7,15,10,11,21,0.000333,0.027348,4,328.17881,18.232156,82.044703,43.651484,1,0
0,0,3,3,8,8,16,10,12,22,0.000333,0.029333,4,352,19.555556,88,48,1,0
0,0,3,3,8,8,16,10,12,22,0.000333,0.029333,4,352,19.555556,88,48,1,0
0,0,2,2,7,7,14,8,13,21,0.000333,0.026651,3,239.86336,13.325742,79.954453,39.302969,1,0
0,0,2,2,7,5,12,8,9,17,0.000333,0.020315,3,182.833088,10.157394,60.944363,31.261125,1,0
0,0,2,2,7,7,14,8,13,21,0.000333,0.026651,3,239.86336,13.325742,79.954453,39.302969,1,0
0,0,2,2,7,7,14,8,13,21,0.000333,0.026651,3,239.86336,13.325742,79.954453,39.302969,1,0
0,0,2,2,7,5,12,8,9,17,0.000333,0.020315,3,182.833088,10.157394,60.944363,31.261125,1,0
0,0,2,2,7,7,14,8,13,21,0.000333,0.026651,3,239.86336,13.325742,79.954453,39.302969,1,0
0,0,7,7,11,15,26,36,24,60,0.000333,0.094009,5,1410.131915,78.340662,282.026383,96.657107,3,0
0,0,10,10,11,18,29,51,34,85,0.000333,0.137643,5,2064.641923,114.702329,412.928385,113.112398,3,0
0,0,8,8,11,16,27,38,26,64,0.000333,0.101438,5,1521.564001,84.531333,304.3128,102.053748,3,0
0,0,12,12,13,20,33,56,40,96,0.000333,0.161421,12,5811.142026,322.841224,484.261835,134.544278,3,0
0,0,9,9,14,19,33,50,34,84,0.000333,0.141243,7,2966.103742,164.783541,423.729106,134.013592,3,0
0,0,12,12,14,23,37,65,44,109,0.000333,0.189277,7,3974.812918,220.82294,567.830417,157.344894,3,0
0,0,10,10,14,20,34,52,36,88,0.000333,0.149232,7,3133.87711,174.104284,447.69673,139.741531,3,0
0,0,14,14,14,25,39,70,50,120,0.000333,0.211416,14,8879.475728,493.304207,634.248266,169.399374,3,0
0,0,7,7,11,15,26,36,24,60,0.000333,0.094009,5,1410.131915,78.340662,282.026383,96.657107,3,0
0,0,10,10,11,18,29,51,34,85,0.000333,0.137643,5,2064.641923,114.702329,412.928385,113.112398,3,0
0,0,8,8,11,16,27,38,26,64,0.000333,0.101438,5,1521.564001,84.531333,304.3128,102.053748,3,0
0,0,12,12,13,20,33,56,40,96,0.000333,0.161421,12,5811.142026,322.841224,484.261835,134.544278,3,0
0,0,7,7,11,15,26,36,24,60,0.000333,0.094009,5,1410.131915,78.340662,282.026383,96.657107,3,0
0,0,10,10,11,18,29,51,34,85,0.000333,0.137643,5,2064.641923,114.702329,412.928385,113.112398,3,0
0,0,8,8,11,16,27,38,26,64,0.000333,0.101438,5,1521.564001,84.531333,304.3128,102.053748,3,0
0,0,12,12,13,20,33,56,40,96,0.000333,0.161421,12,5811.142026,322.841224,484.261835,134.544278,3,0
0,0,8,8,13,15,28,41,26,67,0.000333,0.107364,6,1932.556679,107.36426,322.09278,106.709075,3,0
0,0,11,11,13,19,32,56,36,92,0.000333,0.153333,6,2760,153.333333,460,128.816339,3,0
0,0,9,9,13,16,29,43,28,71,0.000333,0.114972,6,2069.499904,114.972217,344.916651,112.105716,3,0
0,0,13,13,13,21,34,61,42,103,0.000333,0.17467,12,6288.104072,349.339115,524.008673,140.344382,3,0
0,0,8,8,13,15,28,41,26,67,0.000333,0.107364,6,1932.556679,107.36426,322.09278,106.709075,3,0
0,0,11,11,13,19,32,56,36,92,0.000333,0.153333,6,2760,153.333333,460,128.816339,3,0
0,0,9,9,13,16,29,43,28,71,0.000333,0.114972,6,2069.499904,114.972217,344.916651,112.105716,3,0
0,0,13,13,13,21,34,61,42,103,0.000333,0.17467,12,6288.104072,349.339115,524.008673,140.344382,3,0
0,0,7,7,11,15,26,36,24,60,0.000333,0.094009,5,1410.131915,78.340662,282.026383,96.657107,3,0
0,0,10,10,11,18,29,51,34,85,0.000333,0.137643,5,2064.641923,114.702329,412.928385,113.112398,3,0
0,0,8,8,11,16,27,38,26,64,0.000333,0.101438,5,1521.564001,84.531333,304.3128,102.053748,3,0
0,0,12,12,13,20,33,56,40,96,0.000333,0.161421,12,5811.142026,322.841224,484.261835,134.544278,3,0
0,0,7,7,11,15,26,36,24,60,0.000333,0.094009,5,1410.131915,78.340662,282.026383,96.657107,3,0
0,0,10,10,11,18,29,51,34,85,0.000333,0.137643,5,2064.641923,114.702329,412.928385,113.112398,3,0
0,0,8,8,11,16,27,38,26,64,0.000333,0.101438,5,1521.564001,84.531333,304.3128,102.053748,3,0
0,0,12,12,13,20,33,56,40,96,0.000333,0.161421,12,5811.142026,322.841224,484.261835,134.544278,3,0
0,0,8,8,13,15,28,41,26,67,0.000333,0.107364,6,1932.556679,107.36426,322.09278,106.709075,3,0
0,0,11,11,13,19,32,56,36,92,0.000333,0.153333,6,2760,153.333333,460,128.816339,3,0
0,0,9,9,13,16,29,43,28,71,0.000333,0.114972,6,2069.499904,114.972217,344.916651,112.105716,3,0
0,0,13,13,13,21,34,61,42,103,0.000333,0.17467,12,6288.104072,349.339115,524.008673,140.344382,3,0
0,0,8,8,13,15,28,41,26,67,0.000333,0.107364,6,1932.556679,107.36426,322.09278,106.709075,3,0
0,0,11,11,13,19,32,56,36,92,0.000333,0.153333,6,2760,153.333333,460,128.816339,3,0
0,0,9,9,13,16,29,43,28,71,0.000333,0.114972,6,2069.499904,114.972217,344.916651,112.105716,3,0
0,0,13,13,13,21,34,61,42,103,0.000333,0.17467,12,6288.104072,349.339115,524.008673,140.344382,3,0
0,0,7,7,11,15,26,36,24,60,0.000333,0.094009,5,1410.131915,78.340662,282.026383,96.657107,3,0
0,0,10,10,11,18,29,51,34,85,0.000333,0.137643,5,2064.641923,114.702329,412.928385,113.112398,3,0
0,0,8,8,11,16,27,38,26,64,0.000333,0.101438,5,1521.564001,84.531333,304.3128,102.053748,3,0
0,0,12,12,13,20,33,56,40,96,0.000333,0.161421,12,5811.142026,322.841224,484.261835,134.544278,3,0
0,0,7,7,11,15,26,36,24,60,0.000333,0.094009,5,1410.131915,78.340662,282.026383,96.657107,3,0
0,0,10,10,11,18,29,51,34,85,0.000333,0.137643,5,2064.641923,114.702329,412.928385,113.112398,3,0
0,0,8,8,11,16,27,38,26,64,0.000333,0.101438,5,1521.564001,84.531333,304.3128,102.053748,3,0
0,0,12,12,13,20,33,56,40,96,0.000333,0.161421,12,5811.142026,322.841224,484.261835,134.544278,3,0
0,0,8,8,13,15,28,41,26,67,0.000333,0.107364,6,1932.556679,107.36426,322.09278,106.709075,3,0
0,0,11,11,13,19,32,56,36,92,0.000333,0.153333,6,2760,153.333333,460,128.816339,3,0
0,0,9,9,13,16,29,43,28,71,0.000333,0.114972,6,2069.499904,114.972217,344.916651,112.105716,3,0
0,0,13,13,13,21,34,61,42,103,0.000333,0.17467,12,6288.104072,349.339115,524.008673,140.344382,3,0
0,0,8,8,13,15,28,41,26,67,0.000333,0.107364,6,1932.556679,107.36426,322.09278,106.709075,3,0
0,0,11,11,13,19,32,56,36,92,0.000333,0.153333,6,2760,153.333333,460,128.816339,3,0
0,0,9,9,13,16,29,43,28,71,0.000333,0.114972,6,2069.499904,114.972217,344.916651,112.105716,3,0
0,0,13,13,13,21,34,61,42,103,0.000333,0.17467,12,6288.104072,349.339115,524.008673,140.344382,3,0
0,0,7,7,11,15,26,36,24,60,0.000333,0.094009,5,1410.131915,78.340662,282.026383,96.657107,3,0
0,0,10,10,11,18,29,51,34,85,0.000333,0.137643,5,2064.641923,114.702329,412.928385,113.112398,3,0
0,0,8,8,11,16,27,38,26,64,0.000333,0.101438,5,1521.564001,84.531333,304.3128,102.053748,3,0
0,0,12,12,13,20,33,56,40,96,0.000333,0.161421,12,5811.142026,322.841224,484.261835,134.544278,3,0
0,0,7,7,11,15,26,36,24,60,0.000333,0.094009,5,1410.131915,78.340662,282.026383,96.657107,3,0
0,0,10,10,11,18,29,51,34,85,0.000333,0.137643,5,2064.641923,114.702329,412.928385,113.112398,3,0
0,0,8,8,11,16,27,38,26,64,0.000333,0.101438,5,1521.564001,84.531333,304.3128,102.053748,3,0
0,0,12,12,13,20,33,56,40,96,0.000333,0.161421,12,5811.142026,322.841224,484.261835,134.544278,3,0
0,0,8,8,13,15,28,41,26,67,0.000333,0.107364,6,1932.556679,107.36426,322.09278,106.709075,3,0
0,0,11,11,13,19,32,56,36,92,0.000333,0.153333,6,2760,153.333333,460,128.816339,3,0
0,0,9,9,13,16,29,43,28,71,0.000333,0.114972,6,2069.499904,114.972217,344.916651,112.105716,3,0
0,0,13,13,13,21,34,61,42,103,0.000333,0.17467,12,6288.104072,349.339115,524.008673,140.344382,3,0
0,0,8,8,13,15,28,41,26,67,0.000333,0.107364,6,1932.556679,107.36426,322.09278,106.709075,3,0
0,0,11,11,13,19,32,56,36,92,0.000333,0.153333,6,2760,153.333333,460,128.816339,3,0
0,0,9,9,13,16,29,43,28,71,0.000333,0.114972,6,2069.499904,114.972217,344.916651,112.105716,3,0
0,0,13,13,13,21,34,61,42,103,0.000333,0.17467,12,6288.104072,349.339115,524.008673,140.344382,3,0
0,0,7,7,11,15,26,36,24,60,0.000333,0.094009,5,1410.131915,78.340662,282.026383,96.657107,3,0
0,0,10,10,11,18,29,51,34,85,0.000333,0.137643,5,2064.641923,114.702329,412.928385,113.112398,3,0
0,0,8,8,11,16,27,38,26,64,0.000333,0.101438,5,1521.564001,84.531333,304.3128,102.053748,3,0
0,0,12,12,13,20,33,56,40,96,0.000333,0.161421,12,5811.142026,322.841224,484.261835,134.544278,3,0
0,0,7,7,11,15,26,36,24,60,0.000333,0.094009,5,1410.131915,78.340662,282.026383,96.657107,3,0
0,0,10,10,11,18,29,51,34,85,0.000333,0.137643,5,2064.641923,114.702329,412.928385,113.112398,3,0
0,0,8,8,11,16,27,38,26,64,0.000333,0.101438,5,1521.564001,84.531333,304.3128,102.053748,3,0
0,0,12,12,13,20,33,56,40,96,0.000333,0.161421,12,5811.142026,322.841224,484.261835,134.544278,3,0
0,0,8,8,13,15,28,41,26,67,0.000333,0.107364,6,1932.556679,107.36426,322.09278,106.709075,3,0
0,0,11,11,13,19,32,56,36,92,0.000333,0.153333,6,2760,153.333333,460,128.816339,3,0
0,0,9,9,13,16,29,43,28,71,0.000333,0.114972,6,2069.499904,114.972217,344.916651,112.105716,3,0
0,0,13,13,13,21,34,61,42,103,0.000333,0.17467,12,6288.104072,349.339115,524.008673,140.344382,3,0
0,0,8,8,13,15,28,41,26,67,0.000333,0.107364,6,1932.556679,107.36426,322.09278,106.709075,3,0
0,0,11,11,13,19,32,56,36,92,0.000333,0.153333,6,2760,153.333333,460,128.816339,3,0
0,0,9,9,13,16,29,43,28,71,0.000333,0.114972,6,2069.499904,114.972217,344.916651,112.105716,3,0
0,0,13,13,13,21,34,61,42,103,0.000333,0.17467,12,6288.104072,349.339115,524.008673,140.344382,3,0
0,0,7,7,11,15,26,36,24,60,0.000333,0.094009,5,1410.131915,78.340662,282.026383,96.657107,3,0
0,0,10,10,11,18,29,51,34,85,0.000333,0.137643,5,2064.641923,114.702329,412.928385,113.112398,3,0
0,0,8,8,11,16,27,38,26,64,0.000333,0.101438,5,1521.564001,84.531333,304.3128,102.053748,3,0
0,0,12,12,13,20,33,56,40,96,0.000333,0.161421,12,5811.142026,322.841224,484.261835,134.544278,3,0
0,0,7,7,11,15,26,36,24,60,0.000333,0.094009,5,1410.131915,78.340662,282.026383,96.657107,3,0
0,0,10,10,11,18,29,51,34,85,0.000333,0.137643,5,2064.641923,114.702329,412.928385,113.112398,3,0
0,0,8,8,11,16,27,38,26,64,0.000333,0.101438,5,1521.564001,84.531333,304.3128,102.053748,3,0
0,0,12,12,13,20,33,56,40,96,0.000333,0.161421,12,5811.142026,322.841224,484.261835,134.544278,3,0
0,0,8,8,13,15,28,41,26,67,0.000333,0.107364,6,1932.556679,107.36426,322.09278,106.709075,3,0
0,0,11,11,13,19,32,56,36,92,0.000333,0.153333,6,2760,153.333333,460,128.816339,3,0
0,0,9,9,13,16,29,43,28,71,0.000333,0.114972,6,2069.499904,114.972217,344.916651,112.105716,3,0
0,0,13,13,13,21,34,61,42,103,0.000333,0.17467,12,6288.104072,349.339115,524.008673,140.344382,3,0
0,0,8,8,13,15,28,41,26,67,0.000333,0.107364,6,1932.556679,107.36426,322.09278,106.709075,3,0
0,0,11,11,13,19,32,56,36,92,0.000333,0.153333,6,2760,153.333333,460,128.816339,3,0
0,0,9,9,13,16,29,43,28,71,0.000333,0.114972,6,2069.499904,114.972217,344.916651,112.105716,3,0
0,0,13,13,13,21,34,61,42,103,0.000333,0.17467,12,6288.104072,349.339115,524.008673,140.344382,3,0
0,0,7,7,11,15,26,36,24,60,0.000333,0.094009,5,1410.131915,78.340662,282.026383,96.657107,3,0
0,0,10,10,11,18,29,51,34,85,0.000333,0.137643,5,2064.641923,114.702329,412.928385,113.112398,3,0
0,0,8,8,11,16,27,38,26,64,0.000333,0.101438,5,1521.564001,84.531333,304.3128,102.053748,3,0
0,0,12,12,13,20,33,56,40,96,0.000333,0.161421,12,5811.142026,322.841224,484.261835,134.544278,3,0
0,0,7,7,11,15,26,36,24,60,0.000333,0.094009,5,1410.131915,78.340662,282.026383,96.657107,3,0
0,0,10,10,11,18,29,51,34,85,0.000333,0.137643,5,2064.641923,114.702329,412.928385,113.112398,3,0
0,0,8,8,11,16,27,38,26,64,0.000333,0.101438,5,1521.564001,84.531333,304.3128,102.053748,3,0
0,0,12,12,13,20,33,56,40,96,0.000333,0.161421,12,5811.142026,322.841224,484.261835,134.544278,3,0
0,0,8,8,13,15,28,41,26,67,0.000333,0.107364,6,1932.556679,107.36426,322.09278,106.709075,3,0
0,0,11,11,13,19,32,56,36,92,0.000333,0.153333,6,2760,153.333333,460,128.816339,3,0
0,0,9,9,13,16,29,43,28,71,0.000333,0.114972,6,2069.499904,114.972217,344.916651,112.105716,3,0
0,0,13,13,13,21,34,61,42,103,0.000333,0.17467,12,6288.104072,349.339115,524.008673,140.344382,3,0
0,0,8,8,13,15,28,41,26,67,0.000333,0.107364,6,1932.556679,107.36426,322.09278,106.709075,3,0
0,0,11,11,13,19,32,56,36,92,0.000333,0.153333,6,2760,153.333333,460,128.816339,3,0
0,0,9,9,13,16,29,43,28,71,0.000333,0.114972,6,2069.499904,114.972217,344.916651,112.105716,3,0
0,0,13,13,13,21,34,61,42,103,0.000333,0.17467,12,6288.104072,349.339115,524.008673,140.344382,3,0
0,0,7,7,11,15,26,36,24,60,0.000333,0.094009,5,1410.131915,78.340662,282.026383,96.657107,3,0
0,0,10,10,11,18,29,51,34,85,0.000333,0.137643,5,2064.641923,114.702329,412.928385,113.112398,3,0
0,0,8,8,11,16,27,38,26,64,0.000333,0.101438,5,1521.564001,84.531333,304.3128,102.053748,3,0
0,0,12,12,13,20,33,56,40,96,0.000333,0.161421,12,5811.142026,322.841224,484.261835,134.544278,3,0
0,0,7,7,11,15,26,36,24,60,0.000333,0.094009,5,1410.131915,78.340662,282.026383,96.657107,3,0
0,0,10,10,11,18,29,51,34,85,0.000333,0.137643,5,2064.641923,114.702329,412.928385,113.112398,3,0
0,0,8,8,11,16,27,38,26,64,0.000333,0.101438,5,1521.564001,84.531333,304.3128,102.053748,3,0
0,0,12,12,13,20,33,56,40,96,0.000333,0.161421,12,5811.142026,322.841224,484.261835,134.544278,3,0
0,0,8,8,13,15,28,41,26,67,0.000333,0.107364,6,1932.556679,107.36426,322.09278,106.709075,3,0
0,0,11,11,13,19,32,56,36,92,0.000333,0.153333,6,2760,153.333333,460,128.816339,3,0
0,0,9,9,13,16,29,43,28,71,0.000333,0.114972,6,2069.499904,114.972217,344.916651,112.105716,3,0
0,0,13,13,13,21,34,61,42,103,0.000333,0.17467,12,6288.104072,349.339115,524.008673,140.344382,3,0
0,0,8,8,13,15,28,41,26,67,0.000333,0.107364,6,1932.556679,107.36426,322.09278,106.709075,3,0
0,0,11,11,13,19,32,56,36,92,0.000333,0.153333,6,2760,153.333333,460,128.816339,3,0
0,0,9,9,13,16,29,43,28,71,0.000333,0.114972,6,2069.499904,114.972217,344.916651,112.105716,3,0
0,0,13,13,13,21,34,61,42,103,0.000333,0.17467,12,6288.104072,349.339115,524.008673,140.344382,3,0
0,0,7,7,11,15,26,36,24,60,0.000333,0.094009,5,1410.131915,78.340662,282.026383,96.657107,3,0
0,0,10,10,11,18,29,51,34,85,0.000333,0.137643,5,2064.641923,114.702329,412.928385,113.112398,3,0
0,0,8,8,11,16,27,38,26,64,0.000333,0.101438,5,1521.564001,84.531333,304.3128,102.053748,3,0
0,0,12,12,13,20,33,56,40,96,0.000333,0.161421,12,5811.142026,322.841224,484.261835,134.544278,3,0
0,0,7,7,11,15,26,36,24,60,0.000333,0.094009,5,1410.131915,78.340662,282.026383,96.657107,3,0
0,0,10,10,11,18,29,51,34,85,0.000333,0.137643,5,2064.641923,114.702329,412.928385,113.112398,3,0
0,0,8,8,11,16,27,38,26,64,0.000333,0.101438,5,1521.564001,84.531333,304.3128,102.053748,3,0
0,0,12,12,13,20,33,56,40,96,0.000333,0.161421,12,5811.142026,322.841224,484.261835,134.544278,3,0
0,0,8,8,13,15,28,41,26,67,0.000333,0.107364,6,1932.556679,107.36426,322.09278,106.709075,3,0
0,0,11,11,13,19,32,56,36,92,0.000333,0.153333,6,2760,153.333333,460,128.816339,3,0
0,0,9,9,13,16,29,43,28,71,0.000333,0.114972,6,2069.499904,114.972217,344.916651,112.105716,3,0
0,0,13,13,13,21,34,61,42,103,0.000333,0.17467,12,6288.104072,349.339115,524.008673,140.344382,3,0
0,0,8,8,13,15,28,41,26,67,0.000333,0.107364,6,1932.556679,107.36426,322.09278,106.709075,3,0
0,0,11,11,13,19,32,56,36,92,0.000333,0.153333,6,2760,153.333333,460,128.816339,3,0
0,0,9,9,13,16,29,43,28,71,0.000333,0.114972,6,2069.499904,114.972217,344.916651,112.105716,3,0
0,0,13,13,13,21,34,61,42,103,0.000333,0.17467,12,6288.104072,349.339115,524.008673,140.344382,3,0
0,0,7,7,11,15,26,36,24,60,0.000333,0.094009,5,1410.131915,78.340662,282.026383,96.657107,3,0
0,0,10,10,11,18,29,51,34,85,0.000333,0.137643,5,2064.641923,114.702329,412.928385,113.112398,3,0
0,0,8,8,11,16,27,38,26,64,0.000333,0.101438,5,1521.564001,84.531333,304.3128,102.053748,3,0
0,0,12,12,13,20,33,56,40,96,0.000333,0.161421,12,5811.142026,322.841224,484.261835,134.544278,3,0
0,0,7,7,11,15,26,36,24,60,0.000333,0.094009,5,1410.131915,78.340662,282.026383,96.657107,3,0
0,0,10,10,11,18,29,51,34,85,0.000333,0.137643,5,2064.641923,114.702329,412.928385,113.112398,3,0
0,0,8,8,11,16,27,38,26,64,0.000333,0.101438,5,1521.564001,84.531333,304.3128,102.053748,3,0
0,0,12,12,13,20,33,56,40,96,0.000333,0.161421,12,5811.142026,322.841224,484.261835,134.544278,3,0
0,0,8,8,13,15,28,41,26,67,0.000333,0.107364,6,1932.556679,107.36426,322.09278,106.709075,3,0
0,0,11,11,13,19,32,56,36,92,0.000333,0.153333,6,2760,153.333333,460,128.816339,3,0
0,0,9,9,13,16,29,43,28,71,0.000333,0.114972,6,2069.499904,114.972217,344.916651,112.105716,3,0
0,0,13,13,13,21,34,61,42,103,0.000333,0.17467,12,6288.104072,349.339115,524.008673,140.344382,3,0
0,0,8,8,13,15,28,41,26,67,0.000333,0.107364,6,1932.556679,107.36426,322.09278,106.709075,3,0
0,0,11,11,13,19,32,56,36,92,0.000333,0.153333,6,2760,153.333333,460,128.816339,3,0
0,0,9,9,13,16,29,43,28,71,0.000333,0.114972,6,2069.499904,114.972217,344.916651,112.105716,3,0
0,0,13,13,13,21,34,61,42,103,0.000333,0.17467,12,6288.104072,349.339115,524.008673,140.344382,3,0
0,0,7,7,11,15,26,36,24,60,0.000333,0.094009,5,1410.131915,78.340662,282.026383,96.657107,3,0
0,0,10,10,11,18,29,51,34,85,0.000333,0.137643,5,2064.641923,114.702329,412.928385,113.112398,3,0
0,0,8,8,11,16,27,38,26,64,0.000333,0.101438,5,1521.564001,84.531333,304.3128,102.053748,3,0
0,0,12,12,13,20,33,56,40,96,0.000333,0.161421,12,5811.142026,322.841224,484.261835,134.544278,3,0
0,0,7,7,11,15,26,36,24,60,0.000333,0.094009,5,1410.131915,78.340662,282.026383,96.657107,3,0
0,0,10,10,11,18,29,51,34,85,0.000333,0.137643,5,2064.641923,114.702329,412.928385,113.112398,3,0
0,0,8,8,11,16,27,38,26,64,0.000333,0.101438,5,1521.564001,84.531333,304.3128,102.053748,3,0
0,0,12,12,13,20,33,56,40,96,0.000333,0.161421,12,5811.142026,322.841224,484.261835,134.544278,3,0
0,0,7,7,11,15,26,36,24,60,0.000333,0.094009,5,1410.131915,78.340662,282.026383,96.657107,3,0
0,0,10,10,11,18,29,51,34,85,0.000333,0.137643,5,2064.641923,114.702329,412.928385,113.112398,3,0
0,0,8,8,11,16,27,38,26,64,0.000333,0.101438,5,1521.564001,84.531333,304.3128,102.053748,3,0
0,0,12,12,13,20,33,56,40,96,0.000333,0.161421,12,5811.142026,322.841224,484.261835,134.544278,3,0
0,0,11,11,14,19,33,60,41,101,0.000333,0.169828,14,7132.773285,396.265182,509.483806,134.013592,3,0
0,0,14,14,14,23,37,75,51,126,0.000333,0.218797,14,9189.475737,510.52643,656.391124,157.344894,3,0
0,0,12,12,14,20,34,62,43,105,0.000333,0.178061,14,7478.570377,415.476132,534.183598,139.741531,3,0
0,0,16,16,14,25,39,80,57,137,0.000333,0.241367,14,10137.40146,563.18897,724.100104,169.399374,3,0
0,0,11,11,14,19,33,60,41,101,0.000333,0.169828,14,7132.773285,396.265182,509.483806,134.013592,3,0
0,0,14,14,14,23,37,75,51,126,0.000333,0.218797,14,9189.475737,510.52643,656.391124,157.344894,3,0
0,0,12,12,14,20,34,62,43,105,0.000333,0.178061,14,7478.570377,415.476132,534.183598,139.741531,3,0
0,0,16,16,14,25,39,80,57,137,0.000333,0.241367,14,10137.40146,563.18897,724.100104,169.399374,3,0
0,0,10,10,14,20,34,52,36,88,0.000333,0.149232,7,3133.87711,174.104284,447.69673,139.741531,3,0
0,0,13,13,14,24,38,67,46,113,0.000333,0.197672,7,4151.110663,230.617259,593.015809,163.342069,3,0
0,0,11,11,14,21,35,54,38,92,0.000333,0.157298,7,3303.258263,183.514348,471.894038,145.541635,3,0
0,0,15,15,14,26,40,72,52,124,0.000333,0.219973,14,9238.867173,513.270398,659.919084,175.514402,3,0
0,0,7,7,11,15,26,36,24,60,0.000333,0.094009,5,1410.131915,78.340662,282.026383,96.657107,3,0
0,0,10,10,11,18,29,51,34,85,0.000333,0.137643,5,2064.641923,114.702329,412.928385,113.112398,3,0
0,0,8,8,11,16,27,38,26,64,0.000333,0.101438,5,1521.564001,84.531333,304.3128,102.053748,3,0
0,0,12,12,13,20,33,56,40,96,0.000333,0.161421,12,5811.142026,322.841224,484.261835,134.544278,3,0
0,0,7,7,11,15,26,36,24,60,0.000333,0.094009,5,1410.131915,78.340662,282.026383,96.657107,3,0
0,0,10,10,11,18,29,51,34,85,0.000333,0.137643,5,2064.641923,114.702329,412.928385,113.112398,3,0
0,0,8,8,11,16,27,38,26,64,0.000333,0.101438,5,1521.564001,84.531333,304.3128,102.053748,3,0
0,0,12,12,13,20,33,56,40,96,0.000333,0.161421,12,5811.142026,322.841224,484.261835,134.544278,3,0
0,0,8,8,13,15,28,41,26,67,0.000333,0.107364,6,1932.556679,107.36426,322.09278,106.709075,3,0
0,0,11,11,13,19,32,56,36,92,0.000333,0.153333,6,2760,153.333333,460,128.816339,3,0
0,0,9,9,13,16,29,43,28,71,0.000333,0.114972,6,2069.499904,114.972217,344.916651,112.105716,3,0
0,0,13,13,13,21,34,61,42,103,0.000333,0.17467,12,6288.104072,349.339115,524.008673,140.344382,3,0
0,0,8,8,13,15,28,41,26,67,0.000333,0.107364,6,1932.556679,107.36426,322.09278,106.709075,3,0
0,0,11,11,13,19,32,56,36,92,0.000333,0.153333,6,2760,153.333333,460,128.816339,3,0
0,0,9,9,13,16,29,43,28,71,0.000333,0.114972,6,2069.499904,114.972217,344.916651,112.105716,3,0
0,0,13,13,13,21,34,61,42,103,0.000333,0.17467,12,6288.104072,349.339115,524.008673,140.344382,3,0
0,0,7,7,11,15,26,36,24,60,0.000333,0.094009,5,1410.131915,78.340662,282.026383,96.657107,3,0
0,0,10,10,11,18,29,51,34,85,0.000333,0.137643,5,2064.641923,114.702329,412.928385,113.112398,3,0
0,0,8,8,11,16,27,38,26,64,0.000333,0.101438,5,1521.564001,84.531333,304.3128,102.053748,3,0
0,0,12,12,13,20,33,56,40,96,0.000333,0.161421,12,5811.142026,322.841224,484.261835,134.544278,3,0
0,0,7,7,11,15,26,36,24,60,0.000333,0.094009,5,1410.131915,78.340662,282.026383,96.657107,3,0
0,0,10,10,11,18,29,51,34,85,0.000333,0.137643,5,2064.641923,114.702329,412.928385,113.112398,3,0
0,0,8,8,11,16,27,38,26,64,0.000333,0.101438,5,1521.564001,84.531333,304.3128,102.053748,3,0
0,0,12,12,13,20,33,56,40,96,0.000333,0.161421,12,5811.142026,322.841224,484.261835,134.544278,3,0
0,0,8,8,13,15,28,41,26,67,0.000333,0.107364,6,1932.556679,107.36426,322.09278,106.709075,3,0
0,0,11,11,13,19,32,56,36,92,0.000333,0.153333,6,2760,153.333333,460,128.816339,3,0
0,0,9,9,13,16,29,43,28,71,0.000333,0.114972,6,2069.499904,114.972217,344.916651,112.105716,3,0
0,0,13,13,13,21,34,61,42,103,0.000333,0.17467,12,6288.104072,349.339115,524.008673,140.344382,3,0
0,0,8,8,13,15,28,41,26,67,0.000333,0.107364,6,1932.556679,107.36426,322.09278,106.709075,3,0
0,0,11,11,13,19,32,56,36,92,0.000333,0.153333,6,2760,153.333333,460,128.816339,3,0
0,0,9,9,13,16,29,43,28,71,0.000333,0.114972,6,2069.499904,114.972217,344.916651,112.105716,3,0
0,0,13,13,13,21,34,61,42,103,0.000333,0.17467,12,6288.104072,349.339115,524.008673,140.344382,3,0
0,0,7,7,11,15,26,36,24,60,0.000333,0.094009,5,1410.131915,78.340662,282.026383,96.657107,3,0
0,0,10,10,11,18,29,51,34,85,0.000333,0.137643,5,2064.641923,114.702329,412.928385,113.112398,3,0
0,0,8,8,11,16,27,38,26,64,0.000333,0.101438,5,1521.564001,84.531333,304.3128,102.053748,3,0
0,0,12,12,13,20,33,56,40,96,0.000333,0.161421,12,5811.142026,322.841224,484.261835,134.544278,3,0
0,0,7,7,11,15,26,36,24,60,0.000333,0.094009,5,1410.131915,78.340662,282.026383,96.657107,3,0
0,0,10,10,11,18,29,51,34,85,0.000333,0.137643,5,2064.641923,114.702329,412.928385,113.112398,3,0
0,0,8,8,11,16,27,38,26,64,0.000333,0.101438,5,1521.564001,84.531333,304.3128,102.053748,3,0
0,0,12,12,13,20,33,56,40,96,0.000333,0.161421,12,5811.142026,322.841224,484.261835,134.544278,3,0
0,0,8,8,13,15,28,41,26,67,0.000333,0.107364,6,1932.556679,107.36426,322.09278,106.709075,3,0
0,0,11,11,13,19,32,56,36,92,0.000333,0.153333,6,2760,153.333333,460,128.816339,3,0
0,0,9,9,13,16,29,43,28,71,0.000333,0.114972,6,2069.499904,114.972217,344.916651,112.105716,3,0
0,0,13,13,13,21,34,61,42,103,0.000333,0.17467,12,6288.104072,349.339115,524.008673,140.344382,3,0
0,0,8,8,13,15,28,41,26,67,0.000333,0.107364,6,1932.556679,107.36426,322.09278,106.709075,3,0
0,0,11,11,13,19,32,56,36,92,0.000333,0.153333,6,2760,153.333333,460,128.816339,3,0
0,0,9,9,13,16,29,43,28,71,0.000333,0.114972,6,2069.499904,114.972217,344.916651,112.105716,3,0
0,0,13,13,13,21,34,61,42,103,0.000333,0.17467,12,6288.104072,349.339115,524.008673,140.344382,3,0
0,0,7,7,11,15,26,36,24,60,0.000333,0.094009,5,1410.131915,78.340662,282.026383,96.657107,3,0
0,0,10,10,11,18,29,51,34,85,0.000333,0.137643,5,2064.641923,114.702329,412.928385,113.112398,3,0
0,0,8,8,11,16,27,38,26,64,0.000333,0.101438,5,1521.564001,84.531333,304.3128,102.053748,3,0
0,0,12,12,13,20,33,56,40,96,0.000333,0.161421,12,5811.142026,322.841224,484.261835,134.544278,3,0
0,0,7,7,11,12,23,33,21,54,0.000333,0.081424,5,1221.361728,67.853429,244.272346,81.073298,3,0
0,0,10,10,11,16,27,48,31,79,0.000333,0.125212,5,1878.180563,104.343365,375.636113,102.053748,3,0
0,0,8,8,11,13,24,35,23,58,0.000333,0.088643,5,1329.639125,73.86884,265.927825,86.159464,3,0
0,0,12,12,13,18,31,53,37,90,0.000333,0.148626,12,5350.532015,297.251779,445.877668,123.164366,3,0
0,0,7,7,11,15,26,36,24,60,0.000333,0.094009,5,1410.131915,78.340662,282.026383,96.657107,3,0
0,0,10,10,11,18,29,51,34,85,0.000333,0.137643,5,2064.641923,114.702329,412.928385,113.112398,3,0
0,0,8,8,11,16,27,38,26,64,0.000333,0.101438,5,1521.564001,84.531333,304.3128,102.053748,3,0
0,0,12,12,13,20,33,56,40,96,0.000333,0.161421,12,5811.142026,322.841224,484.261835,134.544278,3,0
0,0,7,7,11,12,23,33,21,54,0.000333,0.081424,5,1221.361728,67.853429,244.272346,81.073298,3,0
0,0,10,10,11,16,27,48,31,79,0.000333,0.125212,5,1878.180563,104.343365,375.636113,102.053748,3,0
0,0,8,8,11,13,24,35,23,58,0.000333,0.088643,5,1329.639125,73.86884,265.927825,86.159464,3,0
0,0,12,12,13,18,31,53,37,90,0.000333,0.148626,12,5350.532015,297.251779,445.877668,123.164366,3,0
0,0,7,7,11,15,26,36,24,60,0.000333,0.094009,5,1410.131915,78.340662,282.026383,96.657107,3,0
0,0,10,10,11,18,29,51,34,85,0.000333,0.137643,5,2064.641923,114.702329,412.928385,113.112398,3,0
0,0,8,8,11,16,27,38,26,64,0.000333,0.101438,5,1521.564001,84.531333,304.3128,102.053748,3,0
0,0,12,12,13,20,33,56,40,96,0.000333,0.161421,12,5811.142026,322.841224,484.261835,134.544278,3,0
0,0,6,6,11,11,22,31,19,50,0.000333,0.074324,5,1114.857905,61.93655,222.971581,76.107496,3,0
0,0,9,9,11,15,26,46,29,75,0.000333,0.117511,5,1762.664894,97.925827,352.532979,96.657107,3,0
0,0,7,7,11,12,23,33,21,54,0.000333,0.081424,5,1221.361728,67.853429,244.272346,81.073298,3,0
0,0,11,11,13,17,30,51,35,86,0.000333,0.140664,12,5063.911095,281.328394,421.992591,117.592585,3,0
0,0,7,7,11,15,26,36,24,60,0.000333,0.094009,5,1410.131915,78.340662,282.026383,96.657107,3,0
0,0,10,10,11,18,29,51,34,85,0.000333,0.137643,5,2064.641923,114.702329,412.928385,113.112398,3,0
0,0,8,8,11,16,27,38,26,64,0.000333,0.101438,5,1521.564001,84.531333,304.3128,102.053748,3,0
0,0,12,12,13,20,33,56,40,96,0.000333,0.161421,12,5811.142026,322.841224,484.261835,134.544278,3,0
0,0,7,7,11,15,26,36,24,60,0.000333,0.094009,5,1410.131915,78.340662,282.026383,96.657107,3,0
0,0,10,10,11,18,29,51,34,85,0.000333,0.137643,5,2064.641923,114.702329,412.928385,113.112398,3,0
0,0,8,8,11,16,27,38,26,64,0.000333,0.101438,5,1521.564001,84.531333,304.3128,102.053748,3,0
0,0,12,12,13,20,33,56,40,96,0.000333,0.161421,12,5811.142026,322.841224,484.261835,134.544278,3,0
0,0,11,11,15,24,39,56,44,100,0.000333,0.17618,7,3699.781553,205.54342,528.540222,168.642459,3,0
0,0,11,11,15,24,39,56,44,100,0.000333,0.17618,7,3699.781553,205.54342,528.540222,168.642459,3,0
0,0,7,7,11,15,26,36,24,60,0.000333,0.094009,5,1410.131915,78.340662,282.026383,96.657107,3,0
0,0,7,7,11,15,26,36,24,60,0.000333,0.094009,5,1410.131915,78.340662,282.026383,96.657107,3,0
0,0,6,6,11,17,28,31,25,56,0.000333,0.089737,5,1346.059378,74.781077,269.211876,107.540616,3,0
0,0,6,6,11,17,28,31,25,56,0.000333,0.089737,5,1346.059378,74.781077,269.211876,107.540616,3,0
0,0,7,7,11,15,26,36,24,60,0.000333,0.094009,5,1410.131915,78.340662,282.026383,96.657107,3,0
0,0,11,11,14,21,35,54,40,94,0.000333,0.160718,7,3375.068225,187.50379,482.152604,145.541635,3,0
0,0,7,7,11,15,26,36,24,60,0.000333,0.094009,5,1410.131915,78.340662,282.026383,96.657107,3,0
0,0,7,7,12,12,24,36,23,59,0.000333,0.090171,6,1623.076725,90.170929,270.512788,86.0391,3,0
0,0,7,7,11,15,26,36,24,60,0.000333,0.094009,5,1410.131915,78.340662,282.026383,96.657107,3,0
0,0,7,7,12,16,28,33,25,58,0.000333,0.092942,6,1672.959513,92.942195,278.826585,107.01955,3,0
0,0,7,7,11,15,26,36,24,60,0.000333,0.094009,5,1410.131915,78.340662,282.026383,96.657107,3,0
0,0,11,11,15,23,38,56,42,98,0.000333,0.171432,7,3600.078274,200.004349,514.296896,162.645284,3,0
0,0,7,7,11,15,26,36,24,60,0.000333,0.094009,5,1410.131915,78.340662,282.026383,96.657107,3,0
0,0,11,11,15,21,36,56,39,95,0.000333,0.163714,7,3438.000126,191.000007,491.142875,150.842025,3,0
0,0,7,7,11,15,26,36,24,60,0.000333,0.094009,5,1410.131915,78.340662,282.026383,96.657107,3,0
0,0,6,6,12,14,26,32,22,54,0.000333,0.084608,6,1522.942469,84.607915,253.823745,96.322519,3,0
0,0,7,7,11,15,26,36,24,60,0.000333,0.094009,5,1410.131915,78.340662,282.026383,96.657107,3,0
0,0,12,12,14,26,40,55,47,102,0.000333,0.180946,7,3799.85666,211.103148,542.836666,175.514402,3,0
0,0,7,7,11,15,26,36,24,60,0.000333,0.094009,5,1410.131915,78.340662,282.026383,96.657107,3,0
0,0,11,11,14,25,39,55,46,101,0.000333,0.177942,7,3736.779369,207.598854,533.825624,169.399374,3,0
0,0,7,7,11,15,26,36,24,60,0.000333,0.094009,5,1410.131915,78.340662,282.026383,96.657107,3,0
0,0,8,8,11,17,28,36,36,72,0.000333,0.115377,10,3461.295544,192.294197,346.129554,107.540616,3,0
0,0,7,7,11,15,26,36,24,60,0.000333,0.094009,5,1410.131915,78.340662,282.026383,96.657107,3,0
0,0,8,8,11,17,28,36,36,72,0.000333,0.115377,10,3461.295544,192.294197,346.129554,107.540616,3,0
0,0,7,7,11,15,26,36,24,60,0.000333,0.094009,5,1410.131915,78.340662,282.026383,96.657107,3,0
0,0,8,8,11,17,28,36,36,72,0.000333,0.115377,10,3461.295544,192.294197,346.129554,107.540616,3,0
0,0,7,7,11,15,26,36,24,60,0.000333,0.094009,5,1410.131915,78.340662,282.026383,96.657107,3,0
0,0,11,11,15,23,38,56,41,97,0.000333,0.169683,7,3563.342782,197.963488,509.048969,162.645284,3,0
0,0,7,7,11,15,26,36,24,60,0.000333,0.094009,5,1410.131915,78.340662,282.026383,96.657107,3,0
0,0,12,12,15,26,41,60,49,109,0.000333,0.194658,7,4087.81218,227.100677,583.973169,180.814792,3,0
0,0,7,7,11,15,26,36,24,60,0.000333,0.094009,5,1410.131915,78.340662,282.026383,96.657107,3,0
0,0,13,13,15,27,42,68,53,121,0.000333,0.21749,7,4567.292857,253.738492,652.470408,186.985321,3,0
0,0,7,7,11,15,26,36,24,60,0.000333,0.094009,5,1410.131915,78.340662,282.026383,96.657107,3,0
0,0,6,6,11,16,27,31,24,55,0.000333,0.087173,5,1307.594063,72.644115,261.518813,102.053748,3,0
0,0,6,6,13,13,26,33,21,54,0.000333,0.084608,6,1522.942469,84.607915,253.823745,96.211433,3,0
0,0,13,13,14,27,41,65,53,118,0.000333,0.21073,7,4425.337956,245.852109,632.191137,181.684931,3,0
0,0,7,7,11,15,26,36,24,60,0.000333,0.094009,5,1410.131915,78.340662,282.026383,96.657107,3,0
0,0,12,12,14,24,38,51,49,100,0.000333,0.174931,14,7347.098519,408.17214,524.792751,163.342069,3,0
0,0,7,7,11,15,26,36,24,60,0.000333,0.094009,5,1410.131915,78.340662,282.026383,96.657107,3,0
0,0,12,12,14,26,40,55,49,104,0.000333,0.184494,7,3874.363653,215.242425,553.480522,175.514402,3,0
0,0,3,3,8,8,16,10,12,22,0.000333,0.029333,4,352,19.555556,88,48,1,0
0,0,3,3,8,7,15,10,11,21,0.000333,0.027348,4,328.17881,18.232156,82.044703,43.651484,1,0
0,0,3,3,8,8,16,10,12,22,0.000333,0.029333,4,352,19.555556,88,48,1,0
0,0,3,3,8,8,16,10,12,22,0.000333,0.029333,4,352,19.555556,88,48,1,0
0,0,3,3,8,7,15,10,11,21,0.000333,0.027348,4,328.17881,18.232156,82.044703,43.651484,1,0
0,0,3,3,8,8,16,10,12,22,0.000333,0.029333,4,352,19.555556,88,48,1,0
0,0,2,2,7,5,12,8,9,17,0.000333,0.020315,3,182.833088,10.157394,60.944363,31.261125,1,0
0,0,2,2,7,7,14,8,13,21,0.000333,0.026651,3,239.86336,13.325742,79.954453,39.302969,1,0
0,0,2,2,7,7,14,8,13,21,0.000333,0.026651,3,239.86336,13.325742,79.954453,39.302969,1,0
0,0,2,2,7,7,14,8,13,21,0.000333,0.026651,3,239.86336,13.325742,79.954453,39.302969,1,0
0,0,2,2,7,5,12,8,9,17,0.000333,0.020315,3,182.833088,10.157394,60.944363,31.261125,1,0
0,0,2,2,7,7,14,8,13,21,0.000333,0.026651,3,239.86336,13.325742,79.954453,39.302969,1,0
0,0,7,7,11,15,26,36,24,60,0.000333,0.094009,5,1410.131915,78.340662,282.026383,96.657107,3,0
0,0,6,6,11,11,22,31,19,50,0.000333,0.074324,5,1114.857905,61.93655,222.971581,76.107496,3,0
0,0,7,7,11,15,26,36,24,60,0.000333,0.094009,5,1410.131915,78.340662,282.026383,96.657107,3,0
0,0,7,7,11,15,26,36,24,60,0.000333,0.094009,5,1410.131915,78.340662,282.026383,96.657107,3,0
0,0,7,7,11,12,23,33,21,54,0.000333,0.081424,5,1221.361728,67.853429,244.272346,81.073298,3,0
0,0,7,7,11,12,23,33,21,54,0.000333,0.081424,5,1221.361728,67.853429,244.272346,81.073298,3,0
0,0,7,7,11,15,26,36,24,60,0.000333,0.094009,5,1410.131915,78.340662,282.026383,96.657107,3,0
0,0,7,7,11,15,26,36,24,60,0.000333,0.094009,5,1410.131915,78.340662,282.026383,96.657107,3,0
0,0,7,7,11,12,23,33,21,54,0.000333,0.081424,5,1221.361728,67.853429,244.272346,81.073298,3,0
0,0,7,7,11,12,23,33,21,54,0.000333,0.081424,5,1221.361728,67.853429,244.272346,81.073298,3,0
0,0,7,7,11,15,26,36,24,60,0.000333,0.094009,5,1410.131915,78.340662,282.026383,96.657107,3,0
0,0,7,7,11,15,26,36,24,60,0.000333,0.094009,5,1410.131915,78.340662,282.026383,96.657107,3,0
0,0,7,7,11,12,23,33,21,54,0.000333,0.081424,5,1221.361728,67.853429,244.272346,81.073298,3,0
0,0,7,7,11,12,23,33,21,54,0.000333,0.081424,5,1221.361728,67.853429,244.272346,81.073298,3,0
0,0,7,7,11,15,26,36,24,60,0.000333,0.094009,5,1410.131915,78.340662,282.026383,96.657107,3,0
0,0,7,7,11,15,26,36,24,60,0.000333,0.094009,5,1410.131915,78.340662,282.026383,96.657107,3,0
0,0,7,7,11,12,23,33,21,54,0.000333,0.081424,5,1221.361728,67.853429,244.272346,81.073298,3,0
0,0,7,7,11,12,23,33,21,54,0.000333,0.081424,5,1221.361728,67.853429,244.272346,81.073298,3,0
0,0,7,7,11,15,26,36,24,60,0.000333,0.094009,5,1410.131915,78.340662,282.026383,96.657107,3,0
0,0,7,7,11,15,26,36,24,60,0.000333,0.094009,5,1410.131915,78.340662,282.026383,96.657107,3,0
0,0,7,7,11,12,23,33,21,54,0.000333,0.081424,5,1221.361728,67.853429,244.272346,81.073298,3,0
0,0,7,7,11,12,23,33,21,54,0.000333,0.081424,5,1221.361728,67.853429,244.272346,81.073298,3,0
0,0,7,7,11,15,26,36,24,60,0.000333,0.094009,5,1410.131915,78.340662,282.026383,96.657107,3,0
0,0,7,7,11,15,26,36,24,60,0.000333,0.094009,5,1410.131915,78.340662,282.026383,96.657107,3,0
0,0,7,7,11,12,23,33,21,54,0.000333,0.081424,5,1221.361728,67.853429,244.272346,81.073298,3,0
0,0,7,7,11,12,23,33,21,54,0.000333,0.081424,5,1221.361728,67.853429,244.272346,81.073298,3,0
0,0,7,7,11,15,26,36,24,60,0.000333,0.094009,5,1410.131915,78.340662,282.026383,96.657107,3,0
0,0,7,7,11,15,26,36,24,60,0.000333,0.094009,5,1410.131915,78.340662,282.026383,96.657107,3,0
0,0,7,7,11,12,23,33,21,54,0.000333,0.081424,5,1221.361728,67.853429,244.272346,81.073298,3,0
0,0,7,7,11,12,23,33,21,54,0.000333,0.081424,5,1221.361728,67.853429,244.272346,81.073298,3,0
0,0,7,7,11,15,26,36,24,60,0.000333,0.094009,5,1410.131915,78.340662,282.026383,96.657107,3,0
0,0,7,7,11,15,26,36,24,60,0.000333,0.094009,5,1410.131915,78.340662,282.026383,96.657107,3,0
0,0,7,7,11,12,23,33,21,54,0.000333,0.081424,5,1221.361728,67.853429,244.272346,81.073298,3,0
0,0,7,7,11,12,23,33,21,54,0.000333,0.081424,5,1221.361728,67.853429,244.272346,81.073298,3,0
0,0,7,7,11,15,26,36,24,60,0.000333,0.094009,5,1410.131915,78.340662,282.026383,96.657107,3,0
0,0,7,7,11,15,26,36,24,60,0.000333,0.094009,5,1410.131915,78.340662,282.026383,96.657107,3,0
0,0,7,7,11,12,23,33,21,54,0.000333,0.081424,5,1221.361728,67.853429,244.272346,81.073298,3,0
0,0,7,7,11,12,23,33,21,54,0.000333,0.081424,5,1221.361728,67.853429,244.272346,81.073298,3,0
0,0,7,7,11,15,26,36,24,60,0.000333,0.094009,5,1410.131915,78.340662,282.026383,96.657107,3,0
0,0,7,7,11,15,26,36,24,60,0.000333,0.094009,5,1410.131915,78.340662,282.026383,96.657107,3,0
0,0,7,7,11,12,23,33,21,54,0.000333,0.081424,5,1221.361728,67.853429,244.272346,81.073298,3,0
0,0,7,7,11,12,23,33,21,54,0.000333,0.081424,5,1221.361728,67.853429,244.272346,81.073298,3,0
0,0,7,7,11,15,26,36,24,60,0.000333,0.094009,5,1410.131915,78.340662,282.026383,96.657107,3,0
0,0,7,7,11,15,26,36,24,60,0.000333,0.094009,5,1410.131915,78.340662,282.026383,96.657107,3,0
0,0,7,7,11,15,26,36,24,60,0.000333,0.094009,5,1410.131915,78.340662,282.026383,96.657107,3,0
0,0,7,7,11,12,23,33,21,54,0.000333,0.081424,5,1221.361728,67.853429,244.272346,81.073298,3,0
0,0,7,7,11,11,22,33,21,54,0.000333,0.08027,5,1204.046537,66.891474,240.809307,76.107496,3,0
0,0,7,7,11,11,22,33,21,54,0.000333,0.08027,5,1204.046537,66.891474,240.809307,76.107496,3,0
0,0,7,7,11,15,26,36,24,60,0.000333,0.094009,5,1410.131915,78.340662,282.026383,96.657107,3,0
0,0,7,7,11,15,26,36,24,60,0.000333,0.094009,5,1410.131915,78.340662,282.026383,96.657107,3,0
0,0,7,7,11,12,23,33,21,54,0.000333,0.081424,5,1221.361728,67.853429,244.272346,81.073298,3,0
0,0,7,7,11,12,23,33,21,54,0.000333,0.081424,5,1221.361728,67.853429,244.272346,81.073298,3,0
0,0,7,7,11,15,26,36,24,60,0.000333,0.094009,5,1410.131915,78.340662,282.026383,96.657107,3,0
0,0,7,7,11,15,26,36,24,60,0.000333,0.094009,5,1410.131915,78.340662,282.026383,96.657107,3,0
0,0,7,7,11,12,23,33,21,54,0.000333,0.081424,5,1221.361728,67.853429,244.272346,81.073298,3,0
0,0,7,7,11,12,23,33,21,54,0.000333,0.081424,5,1221.361728,67.853429,244.272346,81.073298,3,0
0,0,7,7,11,15,26,36,24,60,0.000333,0.094009,5,1410.131915,78.340662,282.026383,96.657107,3,0
0,0,7,7,11,15,26,36,24,60,0.000333,0.094009,5,1410.131915,78.340662,282.026383,96.657107,3,0
0,0,7,7,11,12,23,33,21,54,0.000333,0.081424,5,1221.361728,67.853429,244.272346,81.073298,3,0
0,0,7,7,11,12,23,33,21,54,0.000333,0.081424,5,1221.361728,67.853429,244.272346,81.073298,3,0
0,0,7,7,11,15,26,36,24,60,0.000333,0.094009,5,1410.131915,78.340662,282.026383,96.657107,3,0
0,0,7,7,11,12,23,33,21,54,0.000333,0.081424,5,1221.361728,67.853429,244.272346,81.073298,3,0
0,0,7,7,11,15,26,36,24,60,0.000333,0.094009,5,1410.131915,78.340662,282.026383,96.657107,3,0
0,0,7,7,11,12,23,33,21,54,0.000333,0.081424,5,1221.361728,67.853429,244.272346,81.073298,3,0
0,0,7,7,11,15,26,36,24,60,0.000333,0.094009,5,1410.131915,78.340662,282.026383,96.657107,3,0
0,0,6,6,11,11,22,31,19,50,0.000333,0.074324,5,1114.857905,61.93655,222.971581,76.107496,3,0
0,0,7,7,11,15,26,36,24,60,0.000333,0.094009,5,1410.131915,78.340662,282.026383,96.657107,3,0
0,0,7,7,11,15,26,36,24,60,0.000333,0.094009,5,1410.131915,78.340662,282.026383,96.657107,3,0
0,0,8,8,12,16,28,37,29,66,0.000333,0.105762,6,1903.712549,105.761808,317.285425,107.01955,3,0
0,0,8,8,12,16,28,37,29,66,0.000333,0.105762,6,1903.712549,105.761808,317.285425,107.01955,3,0
0,0,7,7,11,15,26,36,24,60,0.000333,0.094009,5,1410.131915,78.340662,282.026383,96.657107,3,0
0,0,7,7,11,15,26,36,24,60,0.000333,0.094009,5,1410.131915,78.340662,282.026383,96.657107,3,0
0,0,6,6,11,17,28,31,25,56,0.000333,0.089737,5,1346.059378,74.781077,269.211876,107.540616,3,0
0,0,6,6,11,17,28,31,25,56,0.000333,0.089737,5,1346.059378,74.781077,269.211876,107.540616,3,0
0,0,7,7,11,15,26,36,24,60,0.000333,0.094009,5,1410.131915,78.340662,282.026383,96.657107,3,0
0,0,8,8,11,13,24,35,25,60,0.000333,0.091699,5,1375.48875,76.416042,275.09775,86.159464,3,0
0,0,7,7,11,15,26,36,24,60,0.000333,0.094009,5,1410.131915,78.340662,282.026383,96.657107,3,0
0,0,7,7,12,12,24,36,23,59,0.000333,0.090171,6,1623.076725,90.170929,270.512788,86.0391,3,0
0,0,7,7,11,15,26,36,24,60,0.000333,0.094009,5,1410.131915,78.340662,282.026383,96.657107,3,0
0,0,7,7,12,16,28,33,25,58,0.000333,0.092942,6,1672.959513,92.942195,278.826585,107.01955,3,0
0,0,7,7,11,15,26,36,24,60,0.000333,0.094009,5,1410.131915,78.340662,282.026383,96.657107,3,0
0,0,8,8,12,15,27,37,27,64,0.000333,0.101438,6,1825.876801,101.4376,304.3128,101.622909,3,0
0,0,7,7,11,15,26,36,24,60,0.000333,0.094009,5,1410.131915,78.340662,282.026383,96.657107,3,0
0,0,8,8,12,13,25,37,24,61,0.000333,0.094425,6,1699.651365,94.425076,283.275228,91.125266,3,0
0,0,7,7,11,15,26,36,24,60,0.000333,0.094009,5,1410.131915,78.340662,282.026383,96.657107,3,0
0,0,6,6,12,14,26,32,22,54,0.000333,0.084608,6,1522.942469,84.607915,253.823745,96.322519,3,0
0,0,7,7,11,15,26,36,24,60,0.000333,0.094009,5,1410.131915,78.340662,282.026383,96.657107,3,0
0,0,9,9,11,18,29,36,32,68,0.000333,0.110114,5,1651.713538,91.761863,330.342708,113.112398,3,0
0,0,7,7,11,15,26,36,24,60,0.000333,0.094009,5,1410.131915,78.340662,282.026383,96.657107,3,0
0,0,8,8,11,17,28,36,31,67,0.000333,0.107364,5,1610.463899,89.470217,322.09278,107.540616,3,0
0,0,7,7,11,15,26,36,24,60,0.000333,0.094009,5,1410.131915,78.340662,282.026383,96.657107,3,0
0,0,8,8,11,17,28,36,36,72,0.000333,0.115377,10,3461.295544,192.294197,346.129554,107.540616,3,0
0,0,7,7,11,15,26,36,24,60,0.000333,0.094009,5,1410.131915,78.340662,282.026383,96.657107,3,0
0,0,8,8,11,17,28,36,36,72,0.000333,0.115377,10,3461.295544,192.294197,346.129554,107.540616,3,0
0,0,7,7,11,15,26,36,24,60,0.000333,0.094009,5,1410.131915,78.340662,282.026383,96.657107,3,0
0,0,8,8,11,17,28,36,36,72,0.000333,0.115377,10,3461.295544,192.294197,346.129554,107.540616,3,0
0,0,7,7,11,15,26,36,24,60,0.000333,0.094009,5,1410.131915,78.340662,282.026383,96.657107,3,0
0,0,8,8,12,15,27,37,26,63,0.000333,0.099853,6,1797.347476,99.852638,299.557913,101.622909,3,0
0,0,7,7,11,15,26,36,24,60,0.000333,0.094009,5,1410.131915,78.340662,282.026383,96.657107,3,0
0,0,9,9,12,18,30,41,34,75,0.000333,0.122672,6,2208.100768,122.672265,368.016795,118.0782,3,0
0,0,7,7,11,15,26,36,24,60,0.000333,0.094009,5,1410.131915,78.340662,282.026383,96.657107,3,0
0,0,10,10,12,19,31,49,38,87,0.000333,0.143672,12,5172.180948,287.343386,431.015079,123.730173,3,0
0,0,6,6,13,13,26,33,21,54,0.000333,0.084608,6,1522.942469,84.607915,253.823745,96.211433,3,0
0,0,6,6,11,16,27,31,24,55,0.000333,0.087173,5,1307.594063,72.644115,261.518813,102.053748,3,0
0,0,6,6,13,13,26,33,21,54,0.000333,0.084608,6,1522.942469,84.607915,253.823745,96.211433,3,0
0,0,10,10,13,19,32,46,38,84,0.000333,0.14,12,5040,280,420,128.816339,3,0
0,0,7,7,11,15,26,36,24,60,0.000333,0.094009,5,1410.131915,78.340662,282.026383,96.657107,3,0
0,0,11,11,12,20,32,43,44,87,0.000333,0.145,12,5220,290,435,129.458112,3,0
0,0,7,7,11,15,26,36,24,60,0.000333,0.094009,5,1410.131915,78.340662,282.026383,96.657107,3,0
0,0,9,9,11,18,29,36,34,70,0.000333,0.113353,5,1700.293348,94.460742,340.05867,113.112398,3,0
0,0,3,3,8,8,16,10,12,22,0.000333,0.029333,4,352,19.555556,88,48,1,0
0,0,3,3,8,7,15,10,11,21,0.000333,0.027348,4,328.17881,18.232156,82.044703,43.651484,1,0
0,0,3,3,8,8,16,10,12,22,0.000333,0.029333,4,352,19.555556,88,48,1,0
0,0,3,3,8,7,15,10,11,21,0.000333,0.027348,4,328.17881,18.232156,82.044703,43.651484,1,0
0,0,3,3,8,8,16,10,12,22,0.000333,0.029333,4,352,19.555556,88,48,1,0
0,0,3,3,8,8,16,10,12,22,0.000333,0.029333,4,352,19.555556,88,48,1,0
0,0,2,2,7,7,14,8,13,21,0.000333,0.026651,3,239.86336,13.325742,79.954453,39.302969,1,0
0,0,2,2,7,5,12,8,9,17,0.000333,0.020315,3,182.833088,10.157394,60.944363,31.261125,1,0
0,0,2,2,7,7,14,8,13,21,0.000333,0.026651,3,239.86336,13.325742,79.954453,39.302969,1,0
0,0,2,2,7,7,14,8,13,21,0.000333,0.026651,3,239.86336,13.325742,79.954453,39.302969,1,0
0,0,2,2,7,5,12,8,9,17,0.000333,0.020315,3,182.833088,10.157394,60.944363,31.261125,1,0
0,0,2,2,7,7,14,8,13,21,0.000333,0.026651,3,239.86336,13.325742,79.954453,39.302969,1,0
0,0,7,7,11,15,26,36,24,60,0.000333,0.094009,5,1410.131915,78.340662,282.026383,96.657107,3,0
0,0,9,9,14,20,34,50,34,84,0.000333,0.142449,7,2991.428151,166.190453,427.346879,139.741531,3,0
0,0,7,7,11,15,26,36,24,60,0.000333,0.094009,5,1410.131915,78.340662,282.026383,96.657107,3,0
0,0,7,7,11,15,26,36,24,60,0.000333,0.094009,5,1410.131915,78.340662,282.026383,96.657107,3,0
0,0,8,8,13,15,28,41,26,67,0.000333,0.107364,6,1932.556679,107.36426,322.09278,106.709075,3,0
0,0,8,8,13,15,28,41,26,67,0.000333,0.107364,6,1932.556679,107.36426,322.09278,106.709075,3,0
0,0,7,7,11,15,26,36,24,60,0.000333,0.094009,5,1410.131915,78.340662,282.026383,96.657107,3,0
0,0,7,7,11,15,26,36,24,60,0.000333,0.094009,5,1410.131915,78.340662,282.026383,96.657107,3,0
0,0,8,8,13,15,28,41,26,67,0.000333,0.107364,6,1932.556679,107.36426,322.09278,106.709075,3,0
0,0,8,8,13,15,28,41,26,67,0.000333,0.107364,6,1932.556679,107.36426,322.09278,106.709075,3,0
0,0,7,7,11,15,26,36,24,60,0.000333,0.094009,5,1410.131915,78.340662,282.026383,96.657107,3,0
0,0,7,7,11,15,26,36,24,60,0.000333,0.094009,5,1410.131915,78.340662,282.026383,96.657107,3,0
0,0,8,8,13,15,28,41,26,67,0.000333,0.107364,6,1932.556679,107.36426,322.09278,106.709075,3,0
0,0,8,8,13,15,28,41,26,67,0.000333,0.107364,6,1932.556679,107.36426,322.09278,106.709075,3,0
0,0,7,7,11,15,26,36,24,60,0.000333,0.094009,5,1410.131915,78.340662,282.026383,96.657107,3,0
0,0,7,7,11,15,26,36,24,60,0.000333,0.094009,5,1410.131915,78.340662,282.026383,96.657107,3,0
0,0,8,8,13,15,28,41,26,67,0.000333,0.107364,6,1932.556679,107.36426,322.09278,106.709075,3,0
0,0,8,8,13,15,28,41,26,67,0.000333,0.107364,6,1932.556679,107.36426,322.09278,106.709075,3,0
0,0,7,7,11,15,26,36,24,60,0.000333,0.094009,5,1410.131915,78.340662,282.026383,96.657107,3,0
0,0,7,7,11,15,26,36,24,60,0.000333,0.094009,5,1410.131915,78.340662,282.026383,96.657107,3,0
0,0,8,8,13,15,28,41,26,67,0.000333,0.107364,6,1932.556679,107.36426,322.09278,106.709075,3,0
0,0,8,8,13,15,28,41,26,67,0.000333,0.107364,6,1932.556679,107.36426,322.09278,106.709075,3,0
0,0,7,7,11,15,26,36,24,60,0.000333,0.094009,5,1410.131915,78.340662,282.026383,96.657107,3,0
0,0,7,7,11,15,26,36,24,60,0.000333,0.094009,5,1410.131915,78.340662,282.026383,96.657107,3,0
0,0,8,8,13,15,28,41,26,67,0.000333,0.107364,6,1932.556679,107.36426,322.09278,106.709075,3,0
0,0,8,8,13,15,28,41,26,67,0.000333,0.107364,6,1932.556679,107.36426,322.09278,106.709075,3,0
0,0,7,7,11,15,26,36,24,60,0.000333,0.094009,5,1410.131915,78.340662,282.026383,96.657107,3,0
0,0,7,7,11,15,26,36,24,60,0.000333,0.094009,5,1410.131915,78.340662,282.026383,96.657107,3,0
0,0,8,8,13,15,28,41,26,67,0.000333,0.107364,6,1932.556679,107.36426,322.09278,106.709075,3,0
0,0,8,8,13,15,28,41,26,67,0.000333,0.107364,6,1932.556679,107.36426,322.09278,106.709075,3,0
0,0,7,7,11,15,26,36,24,60,0.000333,0.094009,5,1410.131915,78.340662,282.026383,96.657107,3,0
0,0,7,7,11,15,26,36,24,60,0.000333,0.094009,5,1410.131915,78.340662,282.026383,96.657107,3,0
0,0,8,8,13,15,28,41,26,67,0.000333,0.107364,6,1932.556679,107.36426,322.09278,106.709075,3,0
0,0,8,8,13,15,28,41,26,67,0.000333,0.107364,6,1932.556679,107.36426,322.09278,106.709075,3,0
0,0,7,7,11,15,26,36,24,60,0.000333,0.094009,5,1410.131915,78.340662,282.026383,96.657107,3,0
0,0,7,7,11,15,26,36,24,60,0.000333,0.094009,5,1410.131915,78.340662,282.026383,96.657107,3,0
0,0,8,8,13,15,28,41,26,67,0.000333,0.107364,6,1932.556679,107.36426,322.09278,106.709075,3,0
0,0,8,8,13,15,28,41,26,67,0.000333,0.107364,6,1932.556679,107.36426,322.09278,106.709075,3,0
0,0,7,7,11,15,26,36,24,60,0.000333,0.094009,5,1410.131915,78.340662,282.026383,96.657107,3,0
0,0,7,7,11,15,26,36,24,60,0.000333,0.094009,5,1410.131915,78.340662,282.026383,96.657107,3,0
0,0,8,8,13,15,28,41,26,67,0.000333,0.107364,6,1932.556679,107.36426,322.09278,106.709075,3,0
0,0,8,8,13,15,28,41,26,67,0.000333,0.107364,6,1932.556679,107.36426,322.09278,106.709075,3,0
0,0,7,7,11,15,26,36,24,60,0.000333,0.094009,5,1410.131915,78.340662,282.026383,96.657107,3,0
0,0,7,7,11,15,26,36,24,60,0.000333,0.094009,5,1410.131915,78.340662,282.026383,96.657107,3,0
0,0,7,7,11,15,26,36,24,60,0.000333,0.094009,5,1410.131915,78.340662,282.026383,96.657107,3,0
0,0,10,10,14,21,35,52,36,88,0.000333,0.150459,7,3159.638338,175.535463,451.376905,145.541635,3,0
0,0,11,11,14,20,34,60,41,101,0.000333,0.171278,14,7193.672458,399.64847,513.833747,139.741531,3,0
0,0,11,11,14,20,34,60,41,101,0.000333,0.171278,14,7193.672458,399.64847,513.833747,139.741531,3,0
0,0,7,7,11,15,26,36,24,60,0.000333,0.094009,5,1410.131915,78.340662,282.026383,96.657107,3,0
0,0,7,7,11,15,26,36,24,60,0.000333,0.094009,5,1410.131915,78.340662,282.026383,96.657107,3,0
0,0,8,8,13,15,28,41,26,67,0.000333,0.107364,6,1932.556679,107.36426,322.09278,106.709075,3,0
0,0,8,8,13,15,28,41,26,67,0.000333,0.107364,6,1932.556679,107.36426,322.09278,106.709075,3,0
0,0,7,7,11,15,26,36,24,60,0.000333,0.094009,5,1410.131915,78.340662,282.026383,96.657107,3,0
0,0,7,7,11,15,26,36,24,60,0.000333,0.094009,5,1410.131915,78.340662,282.026383,96.657107,3,0
0,0,8,8,13,15,28,41,26,67,0.000333,0.107364,6,1932.556679,107.36426,322.09278,106.709075,3,0
0,0,8,8,13,15,28,41,26,67,0.000333,0.107364,6,1932.556679,107.36426,322.09278,106.709075,3,0
0,0,7,7,11,15,26,36,24,60,0.000333,0.094009,5,1410.131915,78.340662,282.026383,96.657107,3,0
0,0,7,7,11,15,26,36,24,60,0.000333,0.094009,5,1410.131915,78.340662,282.026383,96.657107,3,0
0,0,8,8,13,15,28,41,26,67,0.000333,0.107364,6,1932.556679,107.36426,322.09278,106.709075,3,0
0,0,8,8,13,15,28,41,26,67,0.000333,0.107364,6,1932.556679,107.36426,322.09278,106.709075,3,0
0,0,7,7,11,15,26,36,24,60,0.000333,0.094009,5,1410.131915,78.340662,282.026383,96.657107,3,0
0,0,7,7,11,12,23,33,21,54,0.000333,0.081424,5,1221.361728,67.853429,244.272346,81.073298,3,0
0,0,7,7,11,15,26,36,24,60,0.000333,0.094009,5,1410.131915,78.340662,282.026383,96.657107,3,0
0,0,7,7,11,12,23,33,21,54,0.000333,0.081424,5,1221.361728,67.853429,244.272346,81.073298,3,0
0,0,7,7,11,15,26,36,24,60,0.000333,0.094009,5,1410.131915,78.340662,282.026383,96.657107,3,0
0,0,6,6,11,11,22,31,19,50,0.000333,0.074324,5,1114.857905,61.93655,222.971581,76.107496,3,0
0,0,7,7,11,15,26,36,24,60,0.000333,0.094009,5,1410.131915,78.340662,282.026383,96.657107,3,0
0,0,7,7,11,15,26,36,24,60,0.000333,0.094009,5,1410.131915,78.340662,282.026383,96.657107,3,0
0,0,11,11,15,25,40,56,44,100,0.000333,0.177398,7,3725.349666,206.96387,532.192809,174.699764,3,0
0,0,11,11,15,25,40,56,44,100,0.000333,0.177398,7,3725.349666,206.96387,532.192809,174.699764,3,0
0,0,7,7,11,15,26,36,24,60,0.000333,0.094009,5,1410.131915,78.340662,282.026383,96.657107,3,0
0,0,7,7,11,15,26,36,24,60,0.000333,0.094009,5,1410.131915,78.340662,282.026383,96.657107,3,0
0,0,6,6,11,17,28,31,25,56,0.000333,0.089737,5,1346.059378,74.781077,269.211876,107.540616,3,0
0,0,6,6,11,17,28,31,25,56,0.000333,0.089737,5,1346.059378,74.781077,269.211876,107.540616,3,0
0,0,7,7,11,15,26,36,24,60,0.000333,0.094009,5,1410.131915,78.340662,282.026383,96.657107,3,0
0,0,11,11,14,22,36,54,40,94,0.000333,0.161991,7,3401.810651,188.989481,485.97295,151.410465,3,0
0,0,7,7,11,15,26,36,24,60,0.000333,0.094009,5,1410.131915,78.340662,282.026383,96.657107,3,0
0,0,7,7,12,12,24,36,23,59,0.000333,0.090171,6,1623.076725,90.170929,270.512788,86.0391,3,0
0,0,7,7,11,15,26,36,24,60,0.000333,0.094009,5,1410.131915,78.340662,282.026383,96.657107,3,0
0,0,7,7,12,16,28,33,25,58,0.000333,0.092942,6,1672.959513,92.942195,278.826585,107.01955,3,0
0,0,7,7,11,15,26,36,24,60,0.000333,0.094009,5,1410.131915,78.340662,282.026383,96.657107,3,0
0,0,11,11,15,24,39,56,42,98,0.000333,0.172656,7,3625.785922,201.432551,517.969417,168.642459,3,0
0,0,7,7,11,15,26,36,24,60,0.000333,0.094009,5,1410.131915,78.340662,282.026383,96.657107,3,0
0,0,11,11,15,22,37,56,39,95,0.000333,0.164966,7,3464.286488,192.46036,494.89807,156.710855,3,0
0,0,7,7,11,15,26,36,24,60,0.000333,0.094009,5,1410.131915,78.340662,282.026383,96.657107,3,0
0,0,6,6,12,14,26,32,22,54,0.000333,0.084608,6,1522.942469,84.607915,253.823745,96.322519,3,0
0,0,7,7,11,15,26,36,24,60,0.000333,0.094009,5,1410.131915,78.340662,282.026383,96.657107,3,0
0,0,12,12,14,27,41,55,47,102,0.000333,0.182157,7,3825.292131,212.51623,546.470304,181.684931,3,0
0,0,7,7,11,15,26,36,24,60,0.000333,0.094009,5,1410.131915,78.340662,282.026383,96.657107,3,0
0,0,11,11,14,26,40,55,46,101,0.000333,0.179172,7,3762.603163,209.033509,537.514738,175.514402,3,0
0,0,7,7,11,15,26,36,24,60,0.000333,0.094009,5,1410.131915,78.340662,282.026383,96.657107,3,0
0,0,8,8,11,17,28,36,36,72,0.000333,0.115377,10,3461.295544,192.294197,346.129554,107.540616,3,0
0,0,7,7,11,15,26,36,24,60,0.000333,0.094009,5,1410.131915,78.340662,282.026383,96.657107,3,0
0,0,8,8,11,17,28,36,36,72,0.000333,0.115377,10,3461.295544,192.294197,346.129554,107.540616,3,0
0,0,7,7,11,15,26,36,24,60,0.000333,0.094009,5,1410.131915,78.340662,282.026383,96.657107,3,0
0,0,8,8,11,17,28,36,36,72,0.000333,0.115377,10,3461.295544,192.294197,346.129554,107.540616,3,0
0,0,7,7,11,15,26,36,24,60,0.000333,0.094009,5,1410.131915,78.340662,282.026383,96.657107,3,0
0,0,11,11,15,24,39,56,41,97,0.000333,0.170895,7,3588.788107,199.377117,512.684015,168.642459,3,0
0,0,7,7,11,15,26,36,24,60,0.000333,0.094009,5,1410.131915,78.340662,282.026383,96.657107,3,0
0,0,12,12,15,27,42,60,49,109,0.000333,0.195921,7,4114.338194,228.574344,587.762599,186.985321,3,0
0,0,7,7,11,15,26,36,24,60,0.000333,0.094009,5,1410.131915,78.340662,282.026383,96.657107,3,0
0,0,13,13,15,28,43,68,53,121,0.000333,0.218859,7,4596.046247,255.335903,656.578035,193.209297,3,0
0,0,7,7,11,15,26,36,24,60,0.000333,0.094009,5,1410.131915,78.340662,282.026383,96.657107,3,0
0,0,6,6,11,16,27,31,24,55,0.000333,0.087173,5,1307.594063,72.644115,261.518813,102.053748,3,0
0,0,6,6,13,13,26,33,21,54,0.000333,0.084608,6,1522.942469,84.607915,253.823745,96.211433,3,0
0,0,13,13,14,28,42,65,53,118,0.000333,0.212098,7,4454.054191,247.447455,636.293456,187.908907,3,0
0,0,7,7,11,15,26,36,24,60,0.000333,0.094009,5,1410.131915,78.340662,282.026383,96.657107,3,0
0,0,12,12,14,24,38,51,49,100,0.000333,0.174931,14,7347.098519,408.17214,524.792751,163.342069,3,0
0,0,7,7,11,15,26,36,24,60,0.000333,0.094009,5,1410.131915,78.340662,282.026383,96.657107,3,0
0,0,12,12,14,27,41,55,49,104,0.000333,0.185728,7,3900.297859,216.683214,557.185408,181.684931,3,0
0,0,3,3,8,8,16,10,12,22,0.000333,0.029333,4,352,19.555556,88,48,1,0
0,0,3,3,8,7,15,10,11,21,0.000333,0.027348,4,328.17881,18.232156,82.044703,43.651484,1,0
0,0,3,3,8,8,16,10,12,22,0.000333,0.029333,4,352,19.555556,88,48,1,0
0,0,3,3,8,7,15,10,11,21,0.000333,0.027348,4,328.17881,18.232156,82.044703,43.651484,1,0
0,0,3,3,8,8,16,10,12,22,0.000333,0.029333,4,352,19.555556,88,48,1,0
0,0,3,3,8,8,16,10,12,22,0.000333,0.029333,4,352,19.555556,88,48,1,0
0,0,2,2,7,5,12,8,9,17,0.000333,0.020315,3,182.833088,10.157394,60.944363,31.261125,1,0
0,0,2,2,7,7,14,8,13,21,0.000333,0.026651,3,239.86336,13.325742,79.954453,39.302969,1,0
0,0,2,2,7,7,14,8,13,21,0.000333,0.026651,3,239.86336,13.325742,79.954453,39.302969,1,0
0,0,2,2,7,7,14,8,13,21,0.000333,0.026651,3,239.86336,13.325742,79.954453,39.302969,1,0
0,0,2,2,7,5,12,8,9,17,0.000333,0.020315,3,182.833088,10.157394,60.944363,31.261125,1,0
0,0,2,2,7,7,14,8,13,21,0.000333,0.026651,3,239.86336,13.325742,79.954453,39.302969,1,0
0,0,7,7,11,15,26,36,24,60,0.000333,0.094009,5,1410.131915,78.340662,282.026383,96.657107,3,0
0,0,9,9,14,18,32,49,32,81,0.000333,0.135,7,2835,157.5,405,128.361619,4,0
0,0,7,7,11,15,26,36,24,60,0.000333,0.094009,5,1410.131915,78.340662,282.026383,96.657107,3,0
0,0,7,7,11,15,26,36,24,60,0.000333,0.094009,5,1410.131915,78.340662,282.026383,96.657107,3,0
0,0,9,9,14,18,32,49,32,81,0.000333,0.135,7,2835,157.5,405,128.361619,4,0
0,0,9,9,14,18,32,49,32,81,0.000333,0.135,7,2835,157.5,405,128.361619,4,0
0,0,7,7,11,15,26,36,24,60,0.000333,0.094009,5,1410.131915,78.340662,282.026383,96.657107,3,0
0,0,7,7,11,15,26,36,24,60,0.000333,0.094009,5,1410.131915,78.340662,282.026383,96.657107,3,0
0,0,9,9,14,18,32,49,32,81,0.000333,0.135,7,2835,157.5,405,128.361619,4,0
0,0,9,9,14,18,32,49,32,81,0.000333,0.135,7,2835,157.5,405,128.361619,4,0
0,0,7,7,11,15,26,36,24,60,0.000333,0.094009,5,1410.131915,78.340662,282.026383,96.657107,3,0
0,0,7,7,11,15,26,36,24,60,0.000333,0.094009,5,1410.131915,78.340662,282.026383,96.657107,3,0
0,0,9,9,14,18,32,49,32,81,0.000333,0.135,7,2835,157.5,405,128.361619,4,0
0,0,9,9,14,18,32,49,32,81,0.000333,0.135,7,2835,157.5,405,128.361619,4,0
0,0,7,7,11,15,26,36,24,60,0.000333,0.094009,5,1410.131915,78.340662,282.026383,96.657107,3,0
0,0,7,7,11,15,26,36,24,60,0.000333,0.094009,5,1410.131915,78.340662,282.026383,96.657107,3,0
0,0,9,9,14,18,32,49,32,81,0.000333,0.135,7,2835,157.5,405,128.361619,4,0
0,0,9,9,14,18,32,49,32,81,0.000333,0.135,7,2835,157.5,405,128.361619,4,0
0,0,7,7,11,15,26,36,24,60,0.000333,0.094009,5,1410.131915,78.340662,282.026383,96.657107,3,0
0,0,7,7,11,15,26,36,24,60,0.000333,0.094009,5,1410.131915,78.340662,282.026383,96.657107,3,0
0,0,9,9,14,18,32,49,32,81,0.000333,0.135,7,2835,157.5,405,128.361619,4,0
0,0,9,9,14,18,32,49,32,81,0.000333,0.135,7,2835,157.5,405,128.361619,4,0
0,0,7,7,11,15,26,36,24,60,0.000333,0.094009,5,1410.131915,78.340662,282.026383,96.657107,3,0
0,0,7,7,11,15,26,36,24,60,0.000333,0.094009,5,1410.131915,78.340662,282.026383,96.657107,3,0
0,0,9,9,14,18,32,49,32,81,0.000333,0.135,7,2835,157.5,405,128.361619,4,0
0,0,9,9,14,18,32,49,32,81,0.000333,0.135,7,2835,157.5,405,128.361619,4,0
0,0,7,7,11,15,26,36,24,60,0.000333,0.094009,5,1410.131915,78.340662,282.026383,96.657107,3,0
0,0,7,7,11,15,26,36,24,60,0.000333,0.094009,5,1410.131915,78.340662,282.026383,96.657107,3,0
0,0,9,9,14,18,32,49,32,81,0.000333,0.135,7,2835,157.5,405,128.361619,4,0
0,0,9,9,14,18,32,49,32,81,0.000333,0.135,7,2835,157.5,405,128.361619,4,0
0,0,7,7,11,15,26,36,24,60,0.000333,0.094009,5,1410.131915,78.340662,282.026383,96.657107,3,0
0,0,7,7,11,15,26,36,24,60,0.000333,0.094009,5,1410.131915,78.340662,282.026383,96.657107,3,0
0,0,9,9,14,18,32,49,32,81,0.000333,0.135,7,2835,157.5,405,128.361619,4,0
0,0,9,9,14,18,32,49,32,81,0.000333,0.135,7,2835,157.5,405,128.361619,4,0
0,0,7,7,11,15,26,36,24,60,0.000333,0.094009,5,1410.131915,78.340662,282.026383,96.657107,3,0
0,0,7,7,11,15,26,36,24,60,0.000333,0.094009,5,1410.131915,78.340662,282.026383,96.657107,3,0
0,0,9,9,14,18,32,49,32,81,0.000333,0.135,7,2835,157.5,405,128.361619,4,0
0,0,9,9,14,18,32,49,32,81,0.000333,0.135,7,2835,157.5,405,128.361619,4,0
0,0,7,7,11,15,26,36,24,60,0.000333,0.094009,5,1410.131915,78.340662,282.026383,96.657107,3,0
0,0,7,7,11,15,26,36,24,60,0.000333,0.094009,5,1410.131915,78.340662,282.026383,96.657107,3,0
0,0,9,9,14,18,32,49,32,81,0.000333,0.135,7,2835,157.5,405,128.361619,4,0
0,0,9,9,14,18,32,49,32,81,0.000333,0.135,7,2835,157.5,405,128.361619,4,0
0,0,7,7,11,15,26,36,24,60,0.000333,0.094009,5,1410.131915,78.340662,282.026383,96.657107,3,0
0,0,7,7,11,15,26,36,24,60,0.000333,0.094009,5,1410.131915,78.340662,282.026383,96.657107,3,0
0,0,7,7,11,15,26,36,24,60,0.000333,0.094009,5,1410.131915,78.340662,282.026383,96.657107,3,0
0,0,12,12,14,18,32,67,45,112,0.000333,0.186667,14,7840,435.555556,560,128.361619,5,0
0,0,12,12,14,18,32,67,45,112,0.000333,0.186667,14,7840,435.555556,560,128.361619,5,0
0,0,10,10,14,19,33,51,34,85,0.000333,0.142925,7,3001.414501,166.74525,428.7735,134.013592,4,0
0,0,7,7,11,15,26,36,24,60,0.000333,0.094009,5,1410.131915,78.340662,282.026383,96.657107,3,0
0,0,7,7,11,15,26,36,24,60,0.000333,0.094009,5,1410.131915,78.340662,282.026383,96.657107,3,0
0,0,9,9,14,18,32,49,32,81,0.000333,0.135,7,2835,157.5,405,128.361619,4,0
0,0,9,9,14,18,32,49,32,81,0.000333,0.135,7,2835,157.5,405,128.361619,4,0
0,0,7,7,11,15,26,36,24,60,0.000333,0.094009,5,1410.131915,78.340662,282.026383,96.657107,3,0
0,0,7,7,11,15,26,36,24,60,0.000333,0.094009,5,1410.131915,78.340662,282.026383,96.657107,3,0
0,0,9,9,14,18,32,49,32,81,0.000333,0.135,7,2835,157.5,405,128.361619,4,0
0,0,9,9,14,18,32,49,32,81,0.000333,0.135,7,2835,157.5,405,128.361619,4,0
0,0,7,7,11,15,26,36,24,60,0.000333,0.094009,5,1410.131915,78.340662,282.026383,96.657107,3,0
0,0,7,7,11,15,26,36,24,60,0.000333,0.094009,5,1410.131915,78.340662,282.026383,96.657107,3,0
0,0,9,9,14,18,32,49,32,81,0.000333,0.135,7,2835,157.5,405,128.361619,4,0
0,0,9,9,14,18,32,49,32,81,0.000333,0.135,7,2835,157.5,405,128.361619,4,0
0,0,7,7,11,15,26,36,24,60,0.000333,0.094009,5,1410.131915,78.340662,282.026383,96.657107,3,0
0,0,7,7,11,12,23,33,21,54,0.000333,0.081424,5,1221.361728,67.853429,244.272346,81.073298,3,0
0,0,7,7,11,15,26,36,24,60,0.000333,0.094009,5,1410.131915,78.340662,282.026383,96.657107,3,0
0,0,7,7,11,12,23,33,21,54,0.000333,0.081424,5,1221.361728,67.853429,244.272346,81.073298,3,0
0,0,7,7,11,15,26,36,24,60,0.000333,0.094009,5,1410.131915,78.340662,282.026383,96.657107,3,0
0,0,6,6,11,11,22,31,19,50,0.000333,0.074324,5,1114.857905,61.93655,222.971581,76.107496,3,0
0,0,7,7,11,15,26,36,24,60,0.000333,0.094009,5,1410.131915,78.340662,282.026383,96.657107,3,0
0,0,7,7,11,15,26,36,24,60,0.000333,0.094009,5,1410.131915,78.340662,282.026383,96.657107,3,0
0,0,11,11,15,23,38,55,42,97,0.000333,0.169683,7,3563.342782,197.963488,509.048969,162.645284,4,0
0,0,11,11,15,23,38,55,42,97,0.000333,0.169683,7,3563.342782,197.963488,509.048969,162.645284,4,0
0,0,7,7,11,15,26,36,24,60,0.000333,0.094009,5,1410.131915,78.340662,282.026383,96.657107,3,0
0,0,7,7,11,15,26,36,24,60,0.000333,0.094009,5,1410.131915,78.340662,282.026383,96.657107,3,0
0,0,6,6,11,17,28,31,25,56,0.000333,0.089737,5,1346.059378,74.781077,269.211876,107.540616,3,0
0,0,6,6,11,17,28,31,25,56,0.000333,0.089737,5,1346.059378,74.781077,269.211876,107.540616,3,0
0,0,7,7,11,15,26,36,24,60,0.000333,0.094009,5,1410.131915,78.340662,282.026383,96.657107,3,0
0,0,11,11,14,20,34,53,38,91,0.000333,0.15432,7,3240.71383,180.039657,462.959119,139.741531,4,0
0,0,7,7,11,15,26,36,24,60,0.000333,0.094009,5,1410.131915,78.340662,282.026383,96.657107,3,0
0,0,7,7,12,12,24,36,23,59,0.000333,0.090171,6,1623.076725,90.170929,270.512788,86.0391,3,0
0,0,7,7,11,15,26,36,24,60,0.000333,0.094009,5,1410.131915,78.340662,282.026383,96.657107,3,0
0,0,7,7,12,16,28,33,25,58,0.000333,0.092942,6,1672.959513,92.942195,278.826585,107.01955,3,0
0,0,7,7,11,15,26,36,24,60,0.000333,0.094009,5,1410.131915,78.340662,282.026383,96.657107,3,0
0,0,11,11,15,22,37,55,40,95,0.000333,0.164966,7,3464.286488,192.46036,494.89807,156.710855,4,0
0,0,7,7,11,15,26,36,24,60,0.000333,0.094009,5,1410.131915,78.340662,282.026383,96.657107,3,0
0,0,19,19,16,21,37,93,64,157,0.000333,0.272628,24,19629.22028,1090.512238,817.884178,156.238666,5,0
0,0,7,7,11,15,26,36,24,60,0.000333,0.094009,5,1410.131915,78.340662,282.026383,96.657107,3,0
0,0,6,6,12,14,26,32,22,54,0.000333,0.084608,6,1522.942469,84.607915,253.823745,96.322519,3,0
0,0,7,7,11,15,26,36,24,60,0.000333,0.094009,5,1410.131915,78.340662,282.026383,96.657107,3,0
0,0,12,12,14,25,39,54,45,99,0.000333,0.174418,7,3662.783738,203.487985,523.25482,169.399374,4,0
0,0,7,7,11,15,26,36,24,60,0.000333,0.094009,5,1410.131915,78.340662,282.026383,96.657107,3,0
0,0,11,11,14,24,38,54,44,98,0.000333,0.171432,7,3600.078274,200.004349,514.296896,163.342069,4,0
0,0,7,7,11,15,26,36,24,60,0.000333,0.094009,5,1410.131915,78.340662,282.026383,96.657107,3,0
0,0,8,8,11,17,28,36,36,72,0.000333,0.115377,10,3461.295544,192.294197,346.129554,107.540616,3,0
0,0,7,7,11,15,26,36,24,60,0.000333,0.094009,5,1410.131915,78.340662,282.026383,96.657107,3,0
0,0,8,8,11,17,28,36,36,72,0.000333,0.115377,10,3461.295544,192.294197,346.129554,107.540616,3,0
0,0,7,7,11,15,26,36,24,60,0.000333,0.094009,5,1410.131915,78.340662,282.026383,96.657107,3,0
0,0,8,8,11,17,28,36,36,72,0.000333,0.115377,10,3461.295544,192.294197,346.129554,107.540616,3,0
0,0,7,7,11,15,26,36,24,60,0.000333,0.094009,5,1410.131915,78.340662,282.026383,96.657107,3,0
0,0,20,20,15,23,38,96,76,172,0.000333,0.300881,21,18955.51418,1053.084121,902.643532,162.645284,5,0
0,0,7,7,11,15,26,36,24,60,0.000333,0.094009,5,1410.131915,78.340662,282.026383,96.657107,3,0
0,0,12,12,15,25,40,59,47,106,0.000333,0.188041,7,3948.870646,219.381703,564.124378,174.699764,4,0
0,0,7,7,11,15,26,36,24,60,0.000333,0.094009,5,1410.131915,78.340662,282.026383,96.657107,3,0
0,0,13,13,15,26,41,67,51,118,0.000333,0.21073,7,4425.337956,245.852109,632.191137,180.814792,4,0
0,0,7,7,11,15,26,36,24,60,0.000333,0.094009,5,1410.131915,78.340662,282.026383,96.657107,3,0
0,0,6,6,11,16,27,31,24,55,0.000333,0.087173,5,1307.594063,72.644115,261.518813,102.053748,3,0
0,0,7,7,11,15,26,36,24,60,0.000333,0.094009,5,1410.131915,78.340662,282.026383,96.657107,3,0
0,0,13,13,14,26,40,64,51,115,0.000333,0.204007,7,4284.152116,238.008451,612.021731,175.514402,4,0
0,0,7,7,11,15,26,36,24,60,0.000333,0.094009,5,1410.131915,78.340662,282.026383,96.657107,3,0
0,0,14,14,15,27,42,61,57,118,0.000333,0.212098,14,8908.108382,494.89491,636.293456,186.985321,4,0
0,0,7,7,11,15,26,36,24,60,0.000333,0.094009,5,1410.131915,78.340662,282.026383,96.657107,3,0
0,0,12,12,14,25,39,54,47,101,0.000333,0.177942,7,3736.779369,207.598854,533.825624,169.399374,4,0
0,0,3,3,8,8,16,10,12,22,0.000333,0.029333,4,352,19.555556,88,48,1,0
0,0,3,3,8,7,15,10,11,21,0.000333,0.027348,4,328.17881,18.232156,82.044703,43.651484,1,0
0,0,3,3,8,8,16,10,12,22,0.000333,0.029333,4,352,19.555556,88,48,1,0
0,0,3,3,8,7,15,10,11,21,0.000333,0.027348,4,328.17881,18.232156,82.044703,43.651484,1,0
0,0,3,3,8,8,16,10,12,22,0.000333,0.029333,4,352,19.555556,88,48,1,0
0,0,3,3,8,8,16,10,12,22,0.000333,0.029333,4,352,19.555556,88,48,1,0
0,0,2,2,7,7,14,8,13,21,0.000333,0.026651,3,239.86336,13.325742,79.954453,39.302969,1,0
0,0,2,2,7,7,14,8,13,21,0.000333,0.026651,3,239.86336,13.325742,79.954453,39.302969,1,0
0,0,2,2,7,5,12,8,9,17,0.000333,0.020315,3,182.833088,10.157394,60.944363,31.261125,1,0
0,0,2,2,7,7,14,8,13,21,0.000333,0.026651,3,239.86336,13.325742,79.954453,39.302969,1,0
0,0,2,2,7,5,12,8,9,17,0.000333,0.020315,3,182.833088,10.157394,60.944363,31.261125,1,0
0,0,2,2,7,7,14,8,13,21,0.000333,0.026651,3,239.86336,13.325742,79.954453,39.302969,1,0
0,0,7,7,11,15,26,36,24,60,0.000333,0.094009,5,1410.131915,78.340662,282.026383,96.657107,3,0
0,0,7,7,13,13,26,38,22,60,0.000333,0.094009,6,1692.158299,94.008794,282.026383,96.211433,3,0
0,0,7,7,11,15,26,36,24,60,0.000333,0.094009,5,1410.131915,78.340662,282.026383,96.657107,3,0
0,0,7,7,11,15,26,36,24,60,0.000333,0.094009,5,1410.131915,78.340662,282.026383,96.657107,3,0
0,0,7,7,13,13,26,38,22,60,0.000333,0.094009,6,1692.158299,94.008794,282.026383,96.211433,3,0
0,0,7,7,13,13,26,38,22,60,0.000333,0.094009,6,1692.158299,94.008794,282.026383,96.211433,3,0
0,0,7,7,11,15,26,36,24,60,0.000333,0.094009,5,1410.131915,78.340662,282.026383,96.657107,3,0
0,0,7,7,11,15,26,36,24,60,0.000333,0.094009,5,1410.131915,78.340662,282.026383,96.657107,3,0
0,0,7,7,13,13,26,38,22,60,0.000333,0.094009,6,1692.158299,94.008794,282.026383,96.211433,3,0
0,0,7,7,13,13,26,38,22,60,0.000333,0.094009,6,1692.158299,94.008794,282.026383,96.211433,3,0
0,0,7,7,11,15,26,36,24,60,0.000333,0.094009,5,1410.131915,78.340662,282.026383,96.657107,3,0
0,0,7,7,11,15,26,36,24,60,0.000333,0.094009,5,1410.131915,78.340662,282.026383,96.657107,3,0
0,0,7,7,13,13,26,38,22,60,0.000333,0.094009,6,1692.158299,94.008794,282.026383,96.211433,3,0
0,0,7,7,13,13,26,38,22,60,0.000333,0.094009,6,1692.158299,94.008794,282.026383,96.211433,3,0
0,0,7,7,11,15,26,36,24,60,0.000333,0.094009,5,1410.131915,78.340662,282.026383,96.657107,3,0
0,0,7,7,11,15,26,36,24,60,0.000333,0.094009,5,1410.131915,78.340662,282.026383,96.657107,3,0
0,0,7,7,13,13,26,38,22,60,0.000333,0.094009,6,1692.158299,94.008794,282.026383,96.211433,3,0
0,0,7,7,13,13,26,38,22,60,0.000333,0.094009,6,1692.158299,94.008794,282.026383,96.211433,3,0
0,0,7,7,11,15,26,36,24,60,0.000333,0.094009,5,1410.131915,78.340662,282.026383,96.657107,3,0
0,0,7,7,11,15,26,36,24,60,0.000333,0.094009,5,1410.131915,78.340662,282.026383,96.657107,3,0
0,0,7,7,13,13,26,38,22,60,0.000333,0.094009,6,1692.158299,94.008794,282.026383,96.211433,3,0
0,0,7,7,13,13,26,38,22,60,0.000333,0.094009,6,1692.158299,94.008794,282.026383,96.211433,3,0
0,0,7,7,11,15,26,36,24,60,0.000333,0.094009,5,1410.131915,78.340662,282.026383,96.657107,3,0
0,0,7,7,11,15,26,36,24,60,0.000333,0.094009,5,1410.131915,78.340662,282.026383,96.657107,3,0
0,0,7,7,13,13,26,38,22,60,0.000333,0.094009,6,1692.158299,94.008794,282.026383,96.211433,3,0
0,0,7,7,13,13,26,38,22,60,0.000333,0.094009,6,1692.158299,94.008794,282.026383,96.211433,3,0
0,0,7,7,11,15,26,36,24,60,0.000333,0.094009,5,1410.131915,78.340662,282.026383,96.657107,3,0
0,0,7,7,11,15,26,36,24,60,0.000333,0.094009,5,1410.131915,78.340662,282.026383,96.657107,3,0
0,0,7,7,13,13,26,38,22,60,0.000333,0.094009,6,1692.158299,94.008794,282.026383,96.211433,3,0
0,0,7,7,13,13,26,38,22,60,0.000333,0.094009,6,1692.158299,94.008794,282.026383,96.211433,3,0
0,0,7,7,11,15,26,36,24,60,0.000333,0.094009,5,1410.131915,78.340662,282.026383,96.657107,3,0
0,0,7,7,11,15,26,36,24,60,0.000333,0.094009,5,1410.131915,78.340662,282.026383,96.657107,3,0
0,0,7,7,13,13,26,38,22,60,0.000333,0.094009,6,1692.158299,94.008794,282.026383,96.211433,3,0
0,0,7,7,13,13,26,38,22,60,0.000333,0.094009,6,1692.158299,94.008794,282.026383,96.211433,3,0
0,0,7,7,11,15,26,36,24,60,0.000333,0.094009,5,1410.131915,78.340662,282.026383,96.657107,3,0
0,0,7,7,11,15,26,36,24,60,0.000333,0.094009,5,1410.131915,78.340662,282.026383,96.657107,3,0
0,0,7,7,13,13,26,38,22,60,0.000333,0.094009,6,1692.158299,94.008794,282.026383,96.211433,3,0
0,0,7,7,13,13,26,38,22,60,0.000333,0.094009,6,1692.158299,94.008794,282.026383,96.211433,3,0
0,0,7,7,11,15,26,36,24,60,0.000333,0.094009,5,1410.131915,78.340662,282.026383,96.657107,3,0
0,0,7,7,11,15,26,36,24,60,0.000333,0.094009,5,1410.131915,78.340662,282.026383,96.657107,3,0
0,0,7,7,13,13,26,38,22,60,0.000333,0.094009,6,1692.158299,94.008794,282.026383,96.211433,3,0
0,0,7,7,13,13,26,38,22,60,0.000333,0.094009,6,1692.158299,94.008794,282.026383,96.211433,3,0
0,0,7,7,11,15,26,36,24,60,0.000333,0.094009,5,1410.131915,78.340662,282.026383,96.657107,3,0
0,0,7,7,11,15,26,36,24,60,0.000333,0.094009,5,1410.131915,78.340662,282.026383,96.657107,3,0
0,0,7,7,11,15,26,36,24,60,0.000333,0.094009,5,1410.131915,78.340662,282.026383,96.657107,3,0
0,0,8,8,13,14,27,40,24,64,0.000333,0.101438,6,1825.876801,101.4376,304.3128,101.408685,3,0
0,0,8,8,13,13,26,45,25,70,0.000333,0.109677,6,1974.184682,109.676927,329.03078,96.211433,3,0
0,0,8,8,13,13,26,45,25,70,0.000333,0.109677,6,1974.184682,109.676927,329.03078,96.211433,3,0
0,0,7,7,11,15,26,36,24,60,0.000333,0.094009,5,1410.131915,78.340662,282.026383,96.657107,3,0
0,0,7,7,11,15,26,36,24,60,0.000333,0.094009,5,1410.131915,78.340662,282.026383,96.657107,3,0
0,0,7,7,13,13,26,38,22,60,0.000333,0.094009,6,1692.158299,94.008794,282.026383,96.211433,3,0
0,0,7,7,13,13,26,38,22,60,0.000333,0.094009,6,1692.158299,94.008794,282.026383,96.211433,3,0
0,0,7,7,11,15,26,36,24,60,0.000333,0.094009,5,1410.131915,78.340662,282.026383,96.657107,3,0
0,0,7,7,11,15,26,36,24,60,0.000333,0.094009,5,1410.131915,78.340662,282.026383,96.657107,3,0
0,0,7,7,13,13,26,38,22,60,0.000333,0.094009,6,1692.158299,94.008794,282.026383,96.211433,3,0
0,0,7,7,13,13,26,38,22,60,0.000333,0.094009,6,1692.158299,94.008794,282.026383,96.211433,3,0
0,0,7,7,11,15,26,36,24,60,0.000333,0.094009,5,1410.131915,78.340662,282.026383,96.657107,3,0
0,0,7,7,11,15,26,36,24,60,0.000333,0.094009,5,1410.131915,78.340662,282.026383,96.657107,3,0
0,0,7,7,13,13,26,38,22,60,0.000333,0.094009,6,1692.158299,94.008794,282.026383,96.211433,3,0
0,0,7,7,13,13,26,38,22,60,0.000333,0.094009,6,1692.158299,94.008794,282.026383,96.211433,3,0
0,0,7,7,11,15,26,36,24,60,0.000333,0.094009,5,1410.131915,78.340662,282.026383,96.657107,3,0
0,0,7,7,11,12,23,33,21,54,0.000333,0.081424,5,1221.361728,67.853429,244.272346,81.073298,3,0
0,0,7,7,11,15,26,36,24,60,0.000333,0.094009,5,1410.131915,78.340662,282.026383,96.657107,3,0
0,0,7,7,11,12,23,33,21,54,0.000333,0.081424,5,1221.361728,67.853429,244.272346,81.073298,3,0
0,0,7,7,11,15,26,36,24,60,0.000333,0.094009,5,1410.131915,78.340662,282.026383,96.657107,3,0
0,0,6,6,11,11,22,31,19,50,0.000333,0.074324,5,1114.857905,61.93655,222.971581,76.107496,3,0
0,0,7,7,11,15,26,36,24,60,0.000333,0.094009,5,1410.131915,78.340662,282.026383,96.657107,3,0
0,0,7,7,11,15,26,36,24,60,0.000333,0.094009,5,1410.131915,78.340662,282.026383,96.657107,3,0
0,0,9,9,14,18,32,44,32,76,0.000333,0.126667,7,2660,147.777778,380,128.361619,3,0
0,0,9,9,14,18,32,44,32,76,0.000333,0.126667,7,2660,147.777778,380,128.361619,3,0
0,0,7,7,11,15,26,36,24,60,0.000333,0.094009,5,1410.131915,78.340662,282.026383,96.657107,3,0
0,0,7,7,11,15,26,36,24,60,0.000333,0.094009,5,1410.131915,78.340662,282.026383,96.657107,3,0
0,0,6,6,11,17,28,31,25,56,0.000333,0.089737,5,1346.059378,74.781077,269.211876,107.540616,3,0
0,0,6,6,11,17,28,31,25,56,0.000333,0.089737,5,1346.059378,74.781077,269.211876,107.540616,3,0
0,0,7,7,11,15,26,36,24,60,0.000333,0.094009,5,1410.131915,78.340662,282.026383,96.657107,3,0
0,0,9,9,13,15,28,42,28,70,0.000333,0.112172,6,2019.089067,112.171615,336.514845,106.709075,3,0
0,0,7,7,11,15,26,36,24,60,0.000333,0.094009,5,1410.131915,78.340662,282.026383,96.657107,3,0
0,0,7,7,12,12,24,36,23,59,0.000333,0.090171,6,1623.076725,90.170929,270.512788,86.0391,3,0
0,0,7,7,11,15,26,36,24,60,0.000333,0.094009,5,1410.131915,78.340662,282.026383,96.657107,3,0
0,0,7,7,12,16,28,33,25,58,0.000333,0.092942,6,1672.959513,92.942195,278.826585,107.01955,3,0
0,0,7,7,11,15,26,36,24,60,0.000333,0.094009,5,1410.131915,78.340662,282.026383,96.657107,3,0
0,0,9,9,14,17,31,44,30,74,0.000333,0.122204,7,2566.273689,142.57076,366.610527,122.789837,3,0
0,0,7,7,11,15,26,36,24,60,0.000333,0.094009,5,1410.131915,78.340662,282.026383,96.657107,3,0
0,0,16,16,15,16,31,74,49,123,0.000333,0.203122,21,12796.68907,710.927171,609.366146,122.603359,3,0
0,0,7,7,11,15,26,36,24,60,0.000333,0.094009,5,1410.131915,78.340662,282.026383,96.657107,3,0
0,0,6,6,12,14,26,32,22,54,0.000333,0.084608,6,1522.942469,84.607915,253.823745,96.322519,3,0
0,0,7,7,11,15,26,36,24,60,0.000333,0.094009,5,1410.131915,78.340662,282.026383,96.657107,3,0
0,0,10,10,13,20,33,43,35,78,0.000333,0.131154,6,2360.776448,131.154247,393.462741,134.544278,3,0
0,0,7,7,11,15,26,36,24,60,0.000333,0.094009,5,1410.131915,78.340662,282.026383,96.657107,3,0
0,0,9,9,13,19,32,43,34,77,0.000333,0.128333,6,2310,128.333333,385,128.816339,3,0
0,0,7,7,11,15,26,36,24,60,0.000333,0.094009,5,1410.131915,78.340662,282.026383,96.657107,3,0
0,0,8,8,11,17,28,36,36,72,0.000333,0.115377,10,3461.295544,192.294197,346.129554,107.540616,3,0
0,0,7,7,11,15,26,36,24,60,0.000333,0.094009,5,1410.131915,78.340662,282.026383,96.657107,3,0
0,0,8,8,11,17,28,36,36,72,0.000333,0.115377,10,3461.295544,192.294197,346.129554,107.540616,3,0
0,0,7,7,11,15,26,36,24,60,0.000333,0.094009,5,1410.131915,78.340662,282.026383,96.657107,3,0
0,0,8,8,11,17,28,36,36,72,0.000333,0.115377,10,3461.295544,192.294197,346.129554,107.540616,3,0
0,0,7,7,11,15,26,36,24,60,0.000333,0.094009,5,1410.131915,78.340662,282.026383,96.657107,3,0
0,0,17,17,14,18,32,77,61,138,0.000333,0.23,21,14490,805,690,128.361619,3,0
0,0,7,7,11,15,26,36,24,60,0.000333,0.094009,5,1410.131915,78.340662,282.026383,96.657107,3,0
0,0,10,10,13,20,33,48,37,85,0.000333,0.142925,6,2572.641001,142.9245,428.7735,134.544278,3,0
0,0,7,7,11,15,26,36,24,60,0.000333,0.094009,5,1410.131915,78.340662,282.026383,96.657107,3,0
0,0,11,11,13,21,34,56,41,97,0.000333,0.164495,6,2960.903374,164.494632,493.483896,140.344382,3,0
0,0,7,7,11,15,26,36,24,60,0.000333,0.094009,5,1410.131915,78.340662,282.026383,96.657107,3,0
0,0,6,6,11,16,27,31,24,55,0.000333,0.087173,5,1307.594063,72.644115,261.518813,102.053748,3,0
0,0,7,7,11,15,26,36,24,60,0.000333,0.094009,5,1410.131915,78.340662,282.026383,96.657107,3,0
0,0,11,11,15,21,36,53,41,94,0.000333,0.161991,7,3401.810651,188.989481,485.97295,150.842025,3,0
0,0,7,7,11,15,26,36,24,60,0.000333,0.094009,5,1410.131915,78.340662,282.026383,96.657107,3,0
0,0,12,12,14,22,36,50,47,97,0.000333,0.167161,14,7020.758152,390.04212,501.482725,151.410465,3,0
0,0,7,7,11,15,26,36,24,60,0.000333,0.094009,5,1410.131915,78.340662,282.026383,96.657107,3,0
0,0,10,10,13,20,33,43,37,80,0.000333,0.134517,6,2421.309177,134.517177,403.55153,134.544278,3,0
0,0,3,3,8,7,15,10,11,21,0.000333,0.027348,4,328.17881,18.232156,82.044703,43.651484,1,0
0,0,3,3,8,8,16,10,12,22,0.000333,0.029333,4,352,19.555556,88,48,1,0
0,0,3,3,8,8,16,10,12,22,0.000333,0.029333,4,352,19.555556,88,48,1,0
0,0,3,3,8,7,15,10,11,21,0.000333,0.027348,4,328.17881,18.232156,82.044703,43.651484,1,0
0,0,3,3,8,8,16,10,12,22,0.000333,0.029333,4,352,19.555556,88,48,1,0
0,0,3,3,8,8,16,10,12,22,0.000333,0.029333,4,352,19.555556,88,48,1,0
0,0,2,2,7,7,14,8,13,21,0.000333,0.026651,3,239.86336,13.325742,79.954453,39.302969,1,0
0,0,2,2,7,5,12,8,9,17,0.000333,0.020315,3,182.833088,10.157394,60.944363,31.261125,1,0
0,0,2,2,7,7,14,8,13,21,0.000333,0.026651,3,239.86336,13.325742,79.954453,39.302969,1,0
0,0,2,2,7,7,14,8,13,21,0.000333,0.026651,3,239.86336,13.325742,79.954453,39.302969,1,0
0,0,2,2,7,5,12,8,9,17,0.000333,0.020315,3,182.833088,10.157394,60.944363,31.261125,1,0
0,0,2,2,7,7,14,8,13,21,0.000333,0.026651,3,239.86336,13.325742,79.954453,39.302969,1,0
0,0,7,7,11,15,26,36,24,60,0.000333,0.094009,5,1410.131915,78.340662,282.026383,96.657107,3,0
0,0,9,9,14,20,34,50,34,84,0.000333,0.142449,7,2991.428151,166.190453,427.346879,139.741531,3,0
0,0,7,7,11,15,26,36,24,60,0.000333,0.094009,5,1410.131915,78.340662,282.026383,96.657107,3,0
0,0,7,7,11,15,26,36,24,60,0.000333,0.094009,5,1410.131915,78.340662,282.026383,96.657107,3,0
0,0,8,8,13,15,28,41,26,67,0.000333,0.107364,6,1932.556679,107.36426,322.09278,106.709075,3,0
0,0,8,8,13,15,28,41,26,67,0.000333,0.107364,6,1932.556679,107.36426,322.09278,106.709075,3,0
0,0,7,7,11,15,26,36,24,60,0.000333,0.094009,5,1410.131915,78.340662,282.026383,96.657107,3,0
0,0,7,7,11,15,26,36,24,60,0.000333,0.094009,5,1410.131915,78.340662,282.026383,96.657107,3,0
0,0,8,8,13,15,28,41,26,67,0.000333,0.107364,6,1932.556679,107.36426,322.09278,106.709075,3,0
0,0,8,8,13,15,28,41,26,67,0.000333,0.107364,6,1932.556679,107.36426,322.09278,106.709075,3,0
0,0,7,7,11,15,26,36,24,60,0.000333,0.094009,5,1410.131915,78.340662,282.026383,96.657107,3,0
0,0,7,7,11,15,26,36,24,60,0.000333,0.094009,5,1410.131915,78.340662,282.026383,96.657107,3,0
0,0,8,8,13,15,28,41,26,67,0.000333,0.107364,6,1932.556679,107.36426,322.09278,106.709075,3,0
0,0,8,8,13,15,28,41,26,67,0.000333,0.107364,6,1932.556679,107.36426,322.09278,106.709075,3,0
0,0,7,7,11,15,26,36,24,60,0.000333,0.094009,5,1410.131915,78.340662,282.026383,96.657107,3,0
0,0,7,7,11,15,26,36,24,60,0.000333,0.094009,5,1410.131915,78.340662,282.026383,96.657107,3,0
0,0,8,8,13,15,28,41,26,67,0.000333,0.107364,6,1932.556679,107.36426,322.09278,106.709075,3,0
0,0,8,8,13,15,28,41,26,67,0.000333,0.107364,6,1932.556679,107.36426,322.09278,106.709075,3,0
0,0,7,7,11,15,26,36,24,60,0.000333,0.094009,5,1410.131915,78.340662,282.026383,96.657107,3,0
0,0,7,7,11,15,26,36,24,60,0.000333,0.094009,5,1410.131915,78.340662,282.026383,96.657107,3,0
0,0,8,8,13,15,28,41,26,67,0.000333,0.107364,6,1932.556679,107.36426,322.09278,106.709075,3,0
0,0,8,8,13,15,28,41,26,67,0.000333,0.107364,6,1932.556679,107.36426,322.09278,106.709075,3,0
0,0,7,7,11,15,26,36,24,60,0.000333,0.094009,5,1410.131915,78.340662,282.026383,96.657107,3,0
0,0,7,7,11,15,26,36,24,60,0.000333,0.094009,5,1410.131915,78.340662,282.026383,96.657107,3,0
0,0,8,8,13,15,28,41,26,67,0.000333,0.107364,6,1932.556679,107.36426,322.09278,106.709075,3,0
0,0,8,8,13,15,28,41,26,67,0.000333,0.107364,6,1932.556679,107.36426,322.09278,106.709075,3,0
0,0,7,7,11,15,26,36,24,60,0.000333,0.094009,5,1410.131915,78.340662,282.026383,96.657107,3,0
0,0,7,7,11,15,26,36,24,60,0.000333,0.094009,5,1410.131915,78.340662,282.026383,96.657107,3,0
0,0,8,8,13,15,28,41,26,67,0.000333,0.107364,6,1932.556679,107.36426,322.09278,106.709075,3,0
0,0,8,8,13,15,28,41,26,67,0.000333,0.107364,6,1932.556679,107.36426,322.09278,106.709075,3,0
0,0,7,7,11,15,26,36,24,60,0.000333,0.094009,5,1410.131915,78.340662,282.026383,96.657107,3,0
0,0,7,7,11,15,26,36,24,60,0.000333,0.094009,5,1410.131915,78.340662,282.026383,96.657107,3,0
0,0,8,8,13,15,28,41,26,67,0.000333,0.107364,6,1932.556679,107.36426,322.09278,106.709075,3,0
0,0,8,8,13,15,28,41,26,67,0.000333,0.107364,6,1932.556679,107.36426,322.09278,106.709075,3,0
0,0,7,7,11,15,26,36,24,60,0.000333,0.094009,5,1410.131915,78.340662,282.026383,96.657107,3,0
0,0,7,7,11,15,26,36,24,60,0.000333,0.094009,5,1410.131915,78.340662,282.026383,96.657107,3,0
0,0,8,8,13,15,28,41,26,67,0.000333,0.107364,6,1932.556679,107.36426,322.09278,106.709075,3,0
0,0,8,8,13,15,28,41,26,67,0.000333,0.107364,6,1932.556679,107.36426,322.09278,106.709075,3,0
0,0,7,7,11,15,26,36,24,60,0.000333,0.094009,5,1410.131915,78.340662,282.026383,96.657107,3,0
0,0,7,7,11,15,26,36,24,60,0.000333,0.094009,5,1410.131915,78.340662,282.026383,96.657107,3,0
0,0,8,8,13,15,28,41,26,67,0.000333,0.107364,6,1932.556679,107.36426,322.09278,106.709075,3,0
0,0,8,8,13,15,28,41,26,67,0.000333,0.107364,6,1932.556679,107.36426,322.09278,106.709075,3,0
0,0,7,7,11,15,26,36,24,60,0.000333,0.094009,5,1410.131915,78.340662,282.026383,96.657107,3,0
0,0,7,7,11,15,26,36,24,60,0.000333,0.094009,5,1410.131915,78.340662,282.026383,96.657107,3,0
0,0,7,7,11,15,26,36,24,60,0.000333,0.094009,5,1410.131915,78.340662,282.026383,96.657107,3,0
0,0,11,11,14,20,34,60,41,101,0.000333,0.171278,14,7193.672458,399.64847,513.833747,139.741531,3,0
0,0,11,11,14,20,34,60,41,101,0.000333,0.171278,14,7193.672458,399.64847,513.833747,139.741531,3,0
0,0,10,10,14,21,35,52,36,88,0.000333,0.150459,7,3159.638338,175.535463,451.376905,145.541635,3,0
0,0,7,7,11,15,26,36,24,60,0.000333,0.094009,5,1410.131915,78.340662,282.026383,96.657107,3,0
0,0,7,7,11,15,26,36,24,60,0.000333,0.094009,5,1410.131915,78.340662,282.026383,96.657107,3,0
0,0,8,8,13,15,28,41,26,67,0.000333,0.107364,6,1932.556679,107.36426,322.09278,106.709075,3,0
0,0,8,8,13,15,28,41,26,67,0.000333,0.107364,6,1932.556679,107.36426,322.09278,106.709075,3,0
0,0,7,7,11,15,26,36,24,60,0.000333,0.094009,5,1410.131915,78.340662,282.026383,96.657107,3,0
0,0,7,7,11,15,26,36,24,60,0.000333,0.094009,5,1410.131915,78.340662,282.026383,96.657107,3,0
0,0,8,8,13,15,28,41,26,67,0.000333,0.107364,6,1932.556679,107.36426,322.09278,106.709075,3,0
0,0,8,8,13,15,28,41,26,67,0.000333,0.107364,6,1932.556679,107.36426,322.09278,106.709075,3,0
0,0,7,7,11,15,26,36,24,60,0.000333,0.094009,5,1410.131915,78.340662,282.026383,96.657107,3,0
0,0,7,7,11,15,26,36,24,60,0.000333,0.094009,5,1410.131915,78.340662,282.026383,96.657107,3,0
0,0,8,8,13,15,28,41,26,67,0.000333,0.107364,6,1932.556679,107.36426,322.09278,106.709075,3,0
0,0,8,8,13,15,28,41,26,67,0.000333,0.107364,6,1932.556679,107.36426,322.09278,106.709075,3,0
0,0,7,7,11,15,26,36,24,60,0.000333,0.094009,5,1410.131915,78.340662,282.026383,96.657107,3,0
0,0,7,7,11,12,23,33,21,54,0.000333,0.081424,5,1221.361728,67.853429,244.272346,81.073298,3,0
0,0,7,7,11,15,26,36,24,60,0.000333,0.094009,5,1410.131915,78.340662,282.026383,96.657107,3,0
0,0,7,7,11,12,23,33,21,54,0.000333,0.081424,5,1221.361728,67.853429,244.272346,81.073298,3,0
0,0,7,7,11,15,26,36,24,60,0.000333,0.094009,5,1410.131915,78.340662,282.026383,96.657107,3,0
0,0,6,6,11,11,22,31,19,50,0.000333,0.074324,5,1114.857905,61.93655,222.971581,76.107496,3,0
0,0,7,7,11,15,26,36,24,60,0.000333,0.094009,5,1410.131915,78.340662,282.026383,96.657107,3,0
0,0,7,7,11,15,26,36,24,60,0.000333,0.094009,5,1410.131915,78.340662,282.026383,96.657107,3,0
0,0,11,11,15,25,40,56,44,100,0.000333,0.177398,7,3725.349666,206.96387,532.192809,174.699764,3,0
0,0,11,11,15,25,40,56,44,100,0.000333,0.177398,7,3725.349666,206.96387,532.192809,174.699764,3,0
0,0,7,7,11,15,26,36,24,60,0.000333,0.094009,5,1410.131915,78.340662,282.026383,96.657107,3,0
0,0,7,7,11,15,26,36,24,60,0.000333,0.094009,5,1410.131915,78.340662,282.026383,96.657107,3,0
0,0,6,6,11,17,28,31,25,56,0.000333,0.089737,5,1346.059378,74.781077,269.211876,107.540616,3,0
0,0,6,6,11,17,28,31,25,56,0.000333,0.089737,5,1346.059378,74.781077,269.211876,107.540616,3,0
0,0,7,7,11,15,26,36,24,60,0.000333,0.094009,5,1410.131915,78.340662,282.026383,96.657107,3,0
0,0,11,11,14,22,36,54,40,94,0.000333,0.161991,7,3401.810651,188.989481,485.97295,151.410465,3,0
0,0,7,7,11,15,26,36,24,60,0.000333,0.094009,5,1410.131915,78.340662,282.026383,96.657107,3,0
0,0,7,7,12,12,24,36,23,59,0.000333,0.090171,6,1623.076725,90.170929,270.512788,86.0391,3,0
0,0,7,7,11,15,26,36,24,60,0.000333,0.094009,5,1410.131915,78.340662,282.026383,96.657107,3,0
0,0,7,7,12,16,28,33,25,58,0.000333,0.092942,6,1672.959513,92.942195,278.826585,107.01955,3,0
0,0,7,7,11,15,26,36,24,60,0.000333,0.094009,5,1410.131915,78.340662,282.026383,96.657107,3,0
0,0,11,11,15,24,39,56,42,98,0.000333,0.172656,7,3625.785922,201.432551,517.969417,168.642459,3,0
0,0,7,7,11,15,26,36,24,60,0.000333,0.094009,5,1410.131915,78.340662,282.026383,96.657107,3,0
0,0,11,11,15,22,37,56,39,95,0.000333,0.164966,7,3464.286488,192.46036,494.89807,156.710855,3,0
0,0,7,7,11,15,26,36,24,60,0.000333,0.094009,5,1410.131915,78.340662,282.026383,96.657107,3,0
0,0,6,6,12,14,26,32,22,54,0.000333,0.084608,6,1522.942469,84.607915,253.823745,96.322519,3,0
0,0,7,7,11,15,26,36,24,60,0.000333,0.094009,5,1410.131915,78.340662,282.026383,96.657107,3,0
0,0,12,12,14,27,41,55,47,102,0.000333,0.182157,7,3825.292131,212.51623,546.470304,181.684931,3,0
0,0,7,7,11,15,26,36,24,60,0.000333,0.094009,5,1410.131915,78.340662,282.026383,96.657107,3,0
0,0,11,11,14,26,40,55,46,101,0.000333,0.179172,7,3762.603163,209.033509,537.514738,175.514402,3,0
0,0,7,7,11,15,26,36,24,60,0.000333,0.094009,5,1410.131915,78.340662,282.026383,96.657107,3,0
0,0,8,8,11,17,28,36,36,72,0.000333,0.115377,10,3461.295544,192.294197,346.129554,107.540616,3,0
0,0,7,7,11,15,26,36,24,60,0.000333,0.094009,5,1410.131915,78.340662,282.026383,96.657107,3,0
0,0,8,8,11,17,28,36,36,72,0.000333,0.115377,10,3461.295544,192.294197,346.129554,107.540616,3,0
0,0,7,7,11,15,26,36,24,60,0.000333,0.094009,5,1410.131915,78.340662,282.026383,96.657107,3,0
0,0,8,8,11,17,28,36,36,72,0.000333,0.115377,10,3461.295544,192.294197,346.129554,107.540616,3,0
0,0,7,7,11,15,26,36,24,60,0.000333,0.094009,5,1410.131915,78.340662,282.026383,96.657107,3,0
0,0,11,11,15,24,39,56,41,97,0.000333,0.170895,7,3588.788107,199.377117,512.684015,168.642459,3,0
0,0,7,7,11,15,26,36,24,60,0.000333,0.094009,5,1410.131915,78.340662,282.026383,96.657107,3,0
0,0,12,12,15,27,42,60,49,109,0.000333,0.195921,7,4114.338194,228.574344,587.762599,186.985321,3,0
0,0,7,7,11,15,26,36,24,60,0.000333,0.094009,5,1410.131915,78.340662,282.026383,96.657107,3,0
0,0,13,13,15,28,43,68,53,121,0.000333,0.218859,7,4596.046247,255.335903,656.578035,193.209297,3,0
0,0,7,7,11,15,26,36,24,60,0.000333,0.094009,5,1410.131915,78.340662,282.026383,96.657107,3,0
0,0,6,6,11,16,27,31,24,55,0.000333,0.087173,5,1307.594063,72.644115,261.518813,102.053748,3,0
0,0,6,6,13,13,26,33,21,54,0.000333,0.084608,6,1522.942469,84.607915,253.823745,96.211433,3,0
0,0,13,13,14,28,42,65,53,118,0.000333,0.212098,7,4454.054191,247.447455,636.293456,187.908907,3,0
0,0,7,7,11,15,26,36,24,60,0.000333,0.094009,5,1410.131915,78.340662,282.026383,96.657107,3,0
0,0,12,12,14,24,38,51,49,100,0.000333,0.174931,14,7347.098519,408.17214,524.792751,163.342069,3,0
0,0,7,7,11,15,26,36,24,60,0.000333,0.094009,5,1410.131915,78.340662,282.026383,96.657107,3,0
0,0,12,12,14,27,41,55,49,104,0.000333,0.185728,7,3900.297859,216.683214,557.185408,181.684931,3,0
0,0,3,3,8,7,15,10,11,21,0.000333,0.027348,4,328.17881,18.232156,82.044703,43.651484,1,0
0,0,3,3,8,8,16,10,12,22,0.000333,0.029333,4,352,19.555556,88,48,1,0
0,0,3,3,8,8,16,10,12,22,0.000333,0.029333,4,352,19.555556,88,48,1,0
0,0,3,3,8,8,16,10,12,22,0.000333,0.029333,4,352,19.555556,88,48,1,0
0,0,3,3,8,7,15,10,11,21,0.000333,0.027348,4,328.17881,18.232156,82.044703,43.651484,1,0
0,0,3,3,8,8,16,10,12,22,0.000333,0.029333,4,352,19.555556,88,48,1,0
0,0,2,2,7,7,14,8,13,21,0.000333,0.026651,3,239.86336,13.325742,79.954453,39.302969,1,0
0,0,2,2,7,7,14,8,13,21,0.000333,0.026651,3,239.86336,13.325742,79.954453,39.302969,1,0
0,0,2,2,7,5,12,8,9,17,0.000333,0.020315,3,182.833088,10.157394,60.944363,31.261125,1,0
0,0,2,2,7,7,14,8,13,21,0.000333,0.026651,3,239.86336,13.325742,79.954453,39.302969,1,0
0,0,2,2,7,5,12,8,9,17,0.000333,0.020315,3,182.833088,10.157394,60.944363,31.261125,1,0
0,0,2,2,7,7,14,8,13,21,0.000333,0.026651,3,239.86336,13.325742,79.954453,39.302969,1,0
0,0,7,7,11,15,26,36,24,60,0.000333,0.094009,5,1410.131915,78.340662,282.026383,96.657107,3,0
0,0,6,6,11,11,22,31,19,50,0.000333,0.074324,5,1114.857905,61.93655,222.971581,76.107496,3,0
0,0,7,7,11,15,26,36,24,60,0.000333,0.094009,5,1410.131915,78.340662,282.026383,96.657107,3,0
0,0,7,7,11,15,26,36,24,60,0.000333,0.094009,5,1410.131915,78.340662,282.026383,96.657107,3,0
0,0,7,7,11,12,23,33,21,54,0.000333,0.081424,5,1221.361728,67.853429,244.272346,81.073298,3,0
0,0,7,7,11,12,23,33,21,54,0.000333,0.081424,5,1221.361728,67.853429,244.272346,81.073298,3,0
0,0,7,7,11,15,26,36,24,60,0.000333,0.094009,5,1410.131915,78.340662,282.026383,96.657107,3,0
0,0,6,6,11,11,22,31,19,50,0.000333,0.074324,5,1114.857905,61.93655,222.971581,76.107496,3,0
0,0,7,7,11,15,26,36,24,60,0.000333,0.094009,5,1410.131915,78.340662,282.026383,96.657107,3,0
0,0,7,7,11,15,26,36,24,60,0.000333,0.094009,5,1410.131915,78.340662,282.026383,96.657107,3,0
0,0,7,7,11,12,23,33,21,54,0.000333,0.081424,5,1221.361728,67.853429,244.272346,81.073298,3,0
0,0,7,7,11,12,23,33,21,54,0.000333,0.081424,5,1221.361728,67.853429,244.272346,81.073298,3,0
0,0,7,7,11,15,26,36,24,60,0.000333,0.094009,5,1410.131915,78.340662,282.026383,96.657107,3,0
0,0,14,14,17,16,33,44,39,83,0.000333,0.139562,16,6698.955391,372.164188,418.684712,133.486868,4,0
0,0,13,13,14,17,31,41,39,80,0.000333,0.132112,14,5548.699868,308.261104,396.335705,122.789837,4,0
0,0,13,13,12,16,28,39,37,76,0.000333,0.121786,12,4384.307689,243.572649,365.358974,107.01955,3,0
0,0,11,11,14,12,26,35,28,63,0.000333,0.098709,14,4145.787831,230.321546,296.127702,96.322519,3,0
0,0,11,11,12,11,23,33,26,59,0.000333,0.088963,12,3202.681865,177.92677,266.890155,81.073298,2,0
0,0,14,14,15,13,28,48,36,84,0.000333,0.134606,14,5653.449388,314.080522,403.817813,106.709075,3,0
0,0,14,14,13,12,25,46,34,80,0.000333,0.123836,12,4458.101942,247.67233,371.508495,91.125266,2,0
0,0,11,11,15,12,27,36,28,64,0.000333,0.101438,14,4260.379202,236.687733,304.3128,101.622909,3,0
0,0,11,11,13,11,24,34,26,60,0.000333,0.091699,12,3301.173001,183.3985,275.09775,86.159464,2,0
0,0,12,12,13,14,27,36,29,65,0.000333,0.103023,12,3708.812252,206.045125,309.067688,101.408685,2,0
0,0,12,12,15,15,30,38,31,69,0.000333,0.112858,14,4740.056315,263.336462,338.575451,117.206718,3,0
0,0,11,11,15,14,29,37,30,67,0.000333,0.108495,14,4556.786173,253.154787,325.484727,111.906328,3,0
0,0,11,11,13,13,26,35,28,63,0.000333,0.098709,12,3553.532427,197.418468,296.127702,96.211433,2,0
0,0,12,12,14,12,26,38,30,68,0.000333,0.106543,14,4474.818612,248.601034,319.629901,96.322519,2,0
0,0,12,12,16,13,29,40,32,72,0.000333,0.116592,16,5596.394106,310.910784,349.774632,112.105716,3,0
0,0,11,11,16,14,30,38,30,68,0.000333,0.111223,16,5338.696968,296.594276,333.668561,117.302969,3,0
0,0,11,11,14,13,27,36,28,64,0.000333,0.101438,14,4260.379202,236.687733,304.3128,101.408685,2,0
0,0,12,12,13,14,27,42,32,74,0.000333,0.117287,12,4222.340102,234.57445,351.861675,101.408685,2,0
0,0,12,12,15,15,30,44,34,78,0.000333,0.127579,14,5358.32453,297.684696,382.737466,117.206718,3,0
0,0,13,13,15,15,30,37,34,71,0.000333,0.11613,14,4877.449252,270.969403,348.389232,117.206718,3,0
0,0,13,13,13,14,27,35,32,67,0.000333,0.106192,12,3822.929552,212.384975,318.577463,101.408685,2,0
0,0,11,11,12,13,25,34,28,62,0.000333,0.095973,12,3455.029005,191.946056,287.919084,91.125266,2,0
0,0,11,11,14,14,28,36,30,66,0.000333,0.105762,14,4441.995948,246.777553,317.285425,106.605938,3,0
0,0,13,13,12,14,26,39,36,75,0.000333,0.117511,12,4230.395746,235.021986,352.532979,96.322519,2,0
0,0,13,13,14,15,29,41,38,79,0.000333,0.127927,14,5372.926981,298.495943,383.780499,111.906328,3,0
0,0,15,15,12,15,27,44,44,88,0.000333,0.139477,12,5021.161202,278.9534,418.4301,101.622909,2,0
0,0,15,15,14,16,30,46,46,92,0.000333,0.150478,14,6320.075087,351.115283,451.433935,117.302969,3,0
0,0,17,17,12,16,28,49,52,101,0.000333,0.161848,18,8739.771248,485.542847,485.542847,107.01955,2,0
0,0,17,17,14,17,31,51,54,105,0.000333,0.173397,21,10924.00286,606.889048,520.190613,122.789837,3,0
0,0,12,12,13,12,25,37,30,67,0.000333,0.103713,12,3733.660377,207.425576,311.138365,91.125266,2,0
0,0,12,12,15,13,28,39,32,71,0.000333,0.113774,14,4778.510793,265.472822,341.322199,106.709075,3,0
0,0,11,11,13,13,26,35,28,63,0.000333,0.098709,12,3553.532427,197.418468,296.127702,96.211433,2,0
0,0,11,11,15,14,29,37,30,67,0.000333,0.108495,14,4556.786173,253.154787,325.484727,111.906328,3,0
0,0,12,12,15,15,30,41,33,74,0.000333,0.121037,14,5083.538657,282.418814,363.109904,117.206718,3,0
0,0,12,12,13,14,27,39,31,70,0.000333,0.110947,12,3994.105502,221.89475,332.842125,101.408685,2,0
0,0,13,13,15,16,31,49,37,86,0.000333,0.14202,14,5964.852358,331.380687,426.060883,122.603359,3,0
0,0,13,13,13,15,28,47,35,82,0.000333,0.131401,12,4730.437243,262.802069,394.203104,106.709075,2,0
0,0,12,12,14,15,29,43,34,77,0.000333,0.124688,14,5236.903513,290.939084,374.064537,111.906328,3,0
0,0,12,12,12,14,26,41,32,73,0.000333,0.114377,12,4117.585193,228.754733,343.132099,96.322519,2,0
0,0,14,14,14,17,31,49,40,89,0.000333,0.146974,14,6172.928603,342.940478,440.923472,122.789837,3,0
0,0,14,14,12,16,28,47,38,85,0.000333,0.136208,12,4903.50202,272.416779,408.625168,107.01955,2,0
0,0,14,14,13,16,29,41,37,78,0.000333,0.126308,12,4547.070211,252.615012,378.922518,112.105716,2,0
0,0,14,14,15,17,32,43,39,82,0.000333,0.136667,14,5740,318.888889,410,128.090227,3,0
0,0,13,13,14,15,29,36,34,70,0.000333,0.113353,14,4760.821375,264.490076,340.05867,111.906328,3,0
0,0,13,13,12,14,26,34,32,66,0.000333,0.10341,12,3722.748257,206.819348,310.229021,96.322519,2,0
0,0,16,16,14,19,33,64,54,118,0.000333,0.198413,14,8333.339085,462.963283,595.238506,134.013592,2,0
0,0,16,16,15,20,35,66,56,122,0.000333,0.208591,14,8760.815393,486.711966,625.772528,145.041921,3,0
0,0,16,16,14,17,31,54,45,99,0.000333,0.163488,14,6866.516086,381.473116,490.465435,122.789837,2,0
0,0,16,16,15,18,33,56,47,103,0.000333,0.173191,14,7274.01632,404.112018,519.572594,133.662009,3,0
0,0,16,16,13,18,31,57,47,104,0.000333,0.171745,12,6182.836995,343.490944,515.236416,123.164366,2,0
0,0,16,16,14,19,33,59,49,108,0.000333,0.181598,14,7627.123908,423.729106,544.794565,134.013592,3,0
0,0,14,14,17,20,37,56,41,97,0.000333,0.168439,16,8085.071623,449.170646,505.316976,155.92543,5,0
0,0,9,9,12,10,22,29,20,49,0.000333,0.072837,12,2622.145792,145.674766,218.512149,76.238831,2,0
0,0,16,16,17,20,37,62,43,105,0.000333,0.182331,16,8751.881654,486.215647,546.992603,155.92543,7,0
0,0,11,11,12,11,23,35,22,57,0.000333,0.085948,12,3094.116378,171.895354,257.843031,81.073298,4,0
0,0,17,17,20,20,40,65,43,108,0.000333,0.191589,20,11495.36469,638.631371,574.768234,172.877124,7,0
0,0,12,12,15,11,26,38,22,60,0.000333,0.094009,14,3948.369363,219.353854,282.026383,96.657107,4,0
0,0,16,16,17,21,38,62,45,107,0.000333,0.187176,16,8984.451903,499.136217,561.528244,161.725534,7,0
0,0,11,11,12,11,23,35,24,59,0.000333,0.088963,12,3202.681865,177.92677,266.890155,81.073298,4,0
0,0,17,17,21,21,42,66,45,111,0.000333,0.199516,20,11970.94468,665.052482,598.547234,184.477332,7,0
0,0,12,12,16,11,27,39,24,63,0.000333,0.099853,16,4792.926602,266.2737,299.557913,102.053748,4,0
0,0,17,17,20,22,42,65,43,108,0.000333,0.194123,10,5823.702817,323.539045,582.370282,184.546058,7,0
0,0,11,11,12,11,23,35,22,57,0.000333,0.085948,12,3094.116378,171.895354,257.843031,81.073298,4,0
0,0,16,16,17,21,38,62,43,105,0.000333,0.183677,16,8816.518223,489.806568,551.032389,161.725534,7,0
0,0,12,12,15,12,27,38,22,60,0.000333,0.095098,7,1997.052751,110.947375,285.29325,101.622909,4,0
0,0,17,17,20,22,42,65,43,108,0.000333,0.194123,10,5823.702817,323.539045,582.370282,184.546058,7,0
0,0,11,11,12,11,23,35,22,57,0.000333,0.085948,12,3094.116378,171.895354,257.843031,81.073298,4,0
0,0,16,16,17,21,38,62,43,105,0.000333,0.183677,16,8816.518223,489.806568,551.032389,161.725534,7,0
0,0,12,12,15,12,27,38,22,60,0.000333,0.095098,7,1997.052751,110.947375,285.29325,101.622909,4,0
0,0,12,12,16,12,28,39,24,63,0.000333,0.100954,16,4845.813761,269.211876,302.86336,107.01955,4,0
0,0,11,11,12,12,24,35,24,59,0.000333,0.090171,12,3246.153451,180.341858,270.512788,86.0391,4,0
0,0,17,17,21,22,43,66,45,111,0.000333,0.200772,20,12046.30776,669.23932,602.315388,190.346161,7,0
0,0,16,16,17,22,39,62,45,107,0.000333,0.188513,16,9048.608599,502.700478,565.538037,167.594364,7,0
0,0,12,12,16,12,28,39,24,63,0.000333,0.100954,16,4845.813761,269.211876,302.86336,107.01955,4,0
0,0,11,11,12,12,24,35,24,59,0.000333,0.090171,12,3246.153451,180.341858,270.512788,86.0391,4,0
0,0,17,17,21,22,43,66,45,111,0.000333,0.200772,20,12046.30776,669.23932,602.315388,190.346161,7,0
0,0,16,16,17,22,39,62,45,107,0.000333,0.188513,16,9048.608599,502.700478,565.538037,167.594364,7,0
0,0,11,11,12,11,23,35,22,57,0.000333,0.085948,12,3094.116378,171.895354,257.843031,81.073298,4,0
0,0,12,12,15,12,27,38,22,60,0.000333,0.095098,7,1997.052751,110.947375,285.29325,101.622909,4,0
0,0,16,16,17,21,38,62,43,105,0.000333,0.183677,16,8816.518223,489.806568,551.032389,161.725534,7,0
0,0,17,17,20,22,42,65,43,108,0.000333,0.194123,10,5823.702817,323.539045,582.370282,184.546058,7,0
0,0,16,16,17,21,38,62,43,105,0.000333,0.183677,16,8816.518223,489.806568,551.032389,161.725534,7,0
0,0,12,12,15,12,27,38,22,60,0.000333,0.095098,7,1997.052751,110.947375,285.29325,101.622909,4,0
0,0,17,17,20,22,42,65,43,108,0.000333,0.194123,10,5823.702817,323.539045,582.370282,184.546058,7,0
0,0,11,11,12,11,23,35,22,57,0.000333,0.085948,12,3094.116378,171.895354,257.843031,81.073298,4,0
0,0,16,16,17,21,38,62,43,105,0.000333,0.183677,16,8816.518223,489.806568,551.032389,161.725534,7,0
0,0,11,11,12,11,23,35,22,57,0.000333,0.085948,12,3094.116378,171.895354,257.843031,81.073298,4,0
0,0,17,17,20,22,42,65,43,108,0.000333,0.194123,10,5823.702817,323.539045,582.370282,184.546058,7,0
0,0,12,12,15,12,27,38,22,60,0.000333,0.095098,7,1997.052751,110.947375,285.29325,101.622909,4,0
0,0,12,12,15,12,27,38,22,60,0.000333,0.095098,7,1997.052751,110.947375,285.29325,101.622909,4,0
0,0,17,17,20,22,42,65,43,108,0.000333,0.194123,10,5823.702817,323.539045,582.370282,184.546058,7,0
0,0,16,16,17,21,38,62,43,105,0.000333,0.183677,16,8816.518223,489.806568,551.032389,161.725534,7,0
0,0,11,11,12,11,23,35,22,57,0.000333,0.085948,12,3094.116378,171.895354,257.843031,81.073298,4,0
0,0,11,11,12,12,24,35,24,59,0.000333,0.090171,12,3246.153451,180.341858,270.512788,86.0391,4,0
0,0,17,17,21,22,43,66,45,111,0.000333,0.200772,20,12046.30776,669.23932,602.315388,190.346161,7,0
0,0,16,16,17,22,39,62,45,107,0.000333,0.188513,16,9048.608599,502.700478,565.538037,167.594364,7,0
0,0,12,12,16,12,28,39,24,63,0.000333,0.100954,16,4845.813761,269.211876,302.86336,107.01955,4,0
0,0,11,11,12,12,24,35,24,59,0.000333,0.090171,12,3246.153451,180.341858,270.512788,86.0391,4,0
0,0,17,17,21,22,43,66,45,111,0.000333,0.200772,20,12046.30776,669.23932,602.315388,190.346161,7,0
0,0,16,16,17,22,39,62,45,107,0.000333,0.188513,16,9048.608599,502.700478,565.538037,167.594364,7,0
0,0,12,12,16,12,28,39,24,63,0.000333,0.100954,16,4845.813761,269.211876,302.86336,107.01955,4,0
0,0,21,21,21,22,43,72,45,117,0.000333,0.211624,20,12697.45953,705.414418,634.872976,190.346161,7,0
0,0,16,16,17,13,30,45,24,69,0.000333,0.112858,8,2708.603609,150.477978,338.575451,117.592585,4,0
0,0,16,16,17,12,29,45,24,69,0.000333,0.111734,16,5363.211019,297.956168,335.200689,112.506418,4,0
0,0,23,23,21,23,44,76,45,121,0.000333,0.220197,10,6605.912259,366.995125,660.591226,196.280591,7,0
0,0,13,13,14,11,25,39,22,61,0.000333,0.094425,14,3965.853186,220.325177,283.275228,91.356717,4,0
0,0,18,18,18,20,38,66,43,109,0.000333,0.190675,18,10296.43378,572.024099,572.024099,161.497212,7,0
0,0,11,11,15,13,28,45,30,75,0.000333,0.120184,14,5047.722668,280.429037,360.551619,106.709075,4,0
0,0,16,16,19,22,41,72,51,123,0.000333,0.21966,18,11861.62014,658.978897,658.978897,178.818118,7,0
0,0,13,13,14,12,26,35,24,59,0.000333,0.092442,14,3882.563207,215.697956,277.325943,96.322519,2,0
0,0,18,18,19,22,41,62,45,107,0.000333,0.191086,18,10318.64516,573.258064,573.258064,178.818118,5,0
0,0,18,18,18,25,43,67,58,125,0.000333,0.226094,18,12209.0957,678.283094,678.283094,191.155055,6,0
0,0,19,19,21,25,46,70,58,128,0.000333,0.235672,20,14140.31861,785.573256,707.01593,208.335071,6,0
0,0,13,13,13,15,28,40,33,73,0.000333,0.116979,12,4211.242912,233.95794,350.936909,106.709075,3,0
0,0,18,18,17,25,42,66,58,124,0.000333,0.222882,16,10698.35777,594.353209,668.64736,185.583273,6,0
0,0,19,19,20,25,45,69,58,127,0.000333,0.232488,20,13949.30687,774.961492,697.465343,202.534967,6,0
0,0,13,13,12,16,28,39,37,76,0.000333,0.121786,12,4384.307689,243.572649,365.358974,107.01955,3,0
0,0,11,11,12,11,23,33,26,59,0.000333,0.088963,12,3202.681865,177.92677,266.890155,81.073298,2,0
0,0,16,16,17,21,38,60,47,107,0.000333,0.187176,16,8984.451903,499.136217,561.528244,161.725534,5,0
0,0,19,19,18,22,40,73,55,128,0.000333,0.227069,18,12261.72233,681.206796,681.206796,173.166146,5,0
0,0,14,14,13,12,25,46,34,80,0.000333,0.123836,12,4458.101942,247.67233,371.508495,91.125266,2,0
0,0,11,11,13,11,24,34,26,60,0.000333,0.091699,12,3301.173001,183.3985,275.09775,86.159464,2,0
0,0,16,16,18,21,39,61,47,108,0.000333,0.190274,18,10274.82191,570.82344,570.82344,167.297316,5,0
0,0,17,17,18,24,42,63,50,113,0.000333,0.203111,18,10967.97364,609.331869,609.331869,185.09775,5,0
0,0,12,12,13,14,27,36,29,65,0.000333,0.103023,12,3708.812252,206.045125,309.067688,101.408685,2,0
0,0,11,11,13,13,26,35,28,63,0.000333,0.098709,12,3553.532427,197.418468,296.127702,96.211433,2,0
0,0,16,16,18,23,41,62,49,111,0.000333,0.198229,18,10704.38891,594.688273,594.688273,179.100575,5,0
0,0,12,12,14,12,26,38,30,68,0.000333,0.106543,14,4474.818612,248.601034,319.629901,96.322519,2,0
0,0,17,17,19,22,41,65,51,116,0.000333,0.207159,18,11186.56859,621.476033,621.476033,178.818118,5,0
0,0,11,11,14,13,27,36,28,64,0.000333,0.101438,14,4260.379202,236.687733,304.3128,101.408685,2,0
0,0,16,16,19,23,42,63,49,112,0.000333,0.201313,18,10870.91192,603.939551,603.939551,184.752548,5,0
0,0,17,17,18,24,42,69,53,122,0.000333,0.219288,18,11841.52906,657.862726,657.862726,185.09775,5,0
0,0,12,12,13,14,27,42,32,74,0.000333,0.117287,12,4222.340102,234.57445,351.861675,101.408685,2,0
0,0,18,18,18,24,42,62,53,115,0.000333,0.206706,18,11162.09707,620.116504,620.116504,185.09775,5,0
0,0,13,13,13,14,27,35,32,67,0.000333,0.106192,12,3822.929552,212.384975,318.577463,101.408685,2,0
0,0,16,16,17,23,40,61,49,110,0.000333,0.195137,16,9366.593447,520.366303,585.41209,173.528793,5,0
0,0,11,11,12,13,25,34,28,62,0.000333,0.095973,12,3455.029005,191.946056,287.919084,91.125266,2,0
0,0,18,18,17,24,41,66,57,123,0.000333,0.21966,16,10543.66235,585.759019,658.978897,179.525968,5,0
0,0,13,13,12,14,26,39,36,75,0.000333,0.117511,12,4230.395746,235.021986,352.532979,96.322519,2,0
0,0,20,20,17,25,42,71,65,136,0.000333,0.244452,16,11733.68271,651.871262,733.355169,185.583273,5,0
0,0,15,15,12,15,27,44,44,88,0.000333,0.139477,12,5021.161202,278.9534,418.4301,101.622909,2,0
0,0,22,22,17,26,43,76,73,149,0.000333,0.269504,16,12936.21518,718.678621,808.513448,191.698301,5,0
0,0,17,17,12,16,28,49,52,101,0.000333,0.161848,18,8739.771248,485.542847,485.542847,107.01955,2,0
0,0,12,12,13,12,25,37,30,67,0.000333,0.103713,12,3733.660377,207.425576,311.138365,91.125266,2,0
0,0,17,17,18,22,40,64,51,115,0.000333,0.204007,18,11016.39116,612.021731,612.021731,173.166146,5,0
0,0,11,11,13,13,26,35,28,63,0.000333,0.098709,12,3553.532427,197.418468,296.127702,96.211433,2,0
0,0,16,16,18,23,41,62,49,111,0.000333,0.198229,18,10704.38891,594.688273,594.688273,179.100575,5,0
0,0,12,12,13,14,27,39,31,70,0.000333,0.110947,12,3994.105502,221.89475,332.842125,101.408685,2,0
0,0,17,17,18,24,42,66,52,118,0.000333,0.212098,18,11453.28221,636.293456,636.293456,185.09775,5,0
0,0,18,18,18,25,43,74,56,130,0.000333,0.235138,18,12697.45953,705.414418,705.414418,191.155055,5,0
0,0,13,13,13,15,28,47,35,82,0.000333,0.131401,12,4730.437243,262.802069,394.203104,106.709075,2,0
0,0,17,17,17,24,41,68,53,121,0.000333,0.216088,16,10372.22068,576.234482,648.263793,179.525968,5,0
0,0,12,12,12,14,26,41,32,73,0.000333,0.114377,12,4117.585193,228.754733,343.132099,96.322519,2,0
0,0,14,14,12,16,28,47,38,85,0.000333,0.136208,12,4903.50202,272.416779,408.625168,107.01955,2,0
0,0,19,19,17,26,43,74,59,133,0.000333,0.240564,16,11547.0914,641.505078,721.693212,191.698301,5,0
0,0,14,14,13,16,29,41,37,78,0.000333,0.126308,12,4547.070211,252.615012,378.922518,112.105716,2,0
0,0,19,19,18,26,44,68,58,126,0.000333,0.229296,18,12381.99091,687.888384,687.888384,197.270083,5,0
0,0,18,18,17,24,41,61,53,114,0.000333,0.203587,16,9772.174856,542.898603,610.760929,179.525968,5,0
0,0,13,13,12,14,26,34,32,66,0.000333,0.10341,12,3722.748257,206.819348,310.229021,96.322519,2,0
0,0,16,16,14,19,33,64,54,118,0.000333,0.198413,14,8333.339085,462.963283,595.238506,134.013592,2,0
0,0,21,21,18,28,46,91,75,166,0.000333,0.305637,18,16504.40313,916.911285,916.911285,209.664588,5,0
0,0,16,16,14,17,31,54,45,99,0.000333,0.163488,14,6866.516086,381.473116,490.465435,122.789837,2,0
0,0,21,21,18,27,45,81,66,147,0.000333,0.269101,18,14531.44329,807.302405,807.302405,203.440613,5,0
0,0,16,16,13,18,31,57,47,104,0.000333,0.171745,12,6182.836995,343.490944,515.236416,123.164366,2,0
0,0,21,21,17,27,44,84,68,152,0.000333,0.276611,16,13277.3377,737.629872,829.833606,197.868831,5,0
0,0,9,9,12,10,22,29,20,49,0.000333,0.072837,12,2622.145792,145.674766,218.512149,76.238831,2,0
0,0,11,11,15,17,32,47,33,80,0.000333,0.133333,7,2800,155.555556,400,128.090227,4,0
0,0,14,14,18,18,36,56,35,91,0.000333,0.156821,9,4234.168576,235.231588,470.463175,150.1173,6,0
0,0,13,13,15,18,33,53,35,88,0.000333,0.147969,7,3107.346778,172.630377,443.906683,133.662009,6,0
0,0,12,12,15,11,26,38,22,60,0.000333,0.094009,14,3948.369363,219.353854,282.026383,96.657107,4,0
0,0,11,11,12,11,23,35,22,57,0.000333,0.085948,12,3094.116378,171.895354,257.843031,81.073298,4,0
0,0,14,14,18,18,36,57,37,94,0.000333,0.161991,18,8747.513102,485.97295,485.97295,150.1173,6,0
0,0,11,11,12,11,23,35,24,59,0.000333,0.088963,12,3202.681865,177.92677,266.890155,81.073298,4,0
0,0,12,12,16,11,27,39,24,63,0.000333,0.099853,16,4792.926602,266.2737,299.557913,102.053748,4,0
0,0,13,13,15,18,33,53,37,90,0.000333,0.151332,14,6355.93659,353.107588,453.995471,133.662009,6,0
0,0,12,12,15,12,27,38,22,60,0.000333,0.095098,7,1997.052751,110.947375,285.29325,101.622909,4,0
0,0,13,13,15,18,33,53,35,88,0.000333,0.147969,7,3107.346778,172.630377,443.906683,133.662009,6,0
0,0,14,14,18,19,37,56,35,91,0.000333,0.15802,9,4266.542306,237.030128,474.060256,155.769273,6,0
0,0,11,11,12,11,23,35,22,57,0.000333,0.085948,12,3094.116378,171.895354,257.843031,81.073298,4,0
0,0,12,12,15,12,27,38,22,60,0.000333,0.095098,7,1997.052751,110.947375,285.29325,101.622909,4,0
0,0,13,13,15,18,33,53,35,88,0.000333,0.147969,7,3107.346778,172.630377,443.906683,133.662009,6,0
0,0,14,14,18,19,37,56,35,91,0.000333,0.15802,9,4266.542306,237.030128,474.060256,155.769273,6,0
0,0,11,11,12,11,23,35,22,57,0.000333,0.085948,12,3094.116378,171.895354,257.843031,81.073298,4,0
0,0,13,13,15,19,34,53,37,90,0.000333,0.152624,7,3205.10159,178.061199,457.871656,139.313982,6,0
0,0,11,11,12,12,24,35,24,59,0.000333,0.090171,12,3246.153451,180.341858,270.512788,86.0391,4,0
0,0,12,12,16,12,28,39,24,63,0.000333,0.100954,16,4845.813761,269.211876,302.86336,107.01955,4,0
0,0,14,14,18,19,37,57,37,94,0.000333,0.16323,9,4407.197547,244.844308,489.688616,155.769273,6,0
0,0,13,13,15,19,34,53,37,90,0.000333,0.152624,7,3205.10159,178.061199,457.871656,139.313982,6,0
0,0,11,11,12,12,24,35,24,59,0.000333,0.090171,12,3246.153451,180.341858,270.512788,86.0391,4,0
0,0,12,12,16,12,28,39,24,63,0.000333,0.100954,16,4845.813761,269.211876,302.86336,107.01955,4,0
0,0,14,14,18,19,37,57,37,94,0.000333,0.16323,9,4407.197547,244.844308,489.688616,155.769273,6,0
0,0,13,13,15,18,33,53,35,88,0.000333,0.147969,7,3107.346778,172.630377,443.906683,133.662009,6,0
0,0,11,11,12,11,23,35,22,57,0.000333,0.085948,12,3094.116378,171.895354,257.843031,81.073298,4,0
0,0,12,12,15,12,27,38,22,60,0.000333,0.095098,7,1997.052751,110.947375,285.29325,101.622909,4,0
0,0,14,14,18,19,37,56,35,91,0.000333,0.15802,9,4266.542306,237.030128,474.060256,155.769273,6,0
0,0,14,14,18,19,37,56,35,91,0.000333,0.15802,9,4266.542306,237.030128,474.060256,155.769273,6,0
0,0,11,11,12,11,23,35,22,57,0.000333,0.085948,12,3094.116378,171.895354,257.843031,81.073298,4,0
0,0,12,12,15,12,27,38,22,60,0.000333,0.095098,7,1997.052751,110.947375,285.29325,101.622909,4,0
0,0,13,13,15,18,33,53,35,88,0.000333,0.147969,7,3107.346778,172.630377,443.906683,133.662009,6,0
0,0,14,14,18,19,37,56,35,91,0.000333,0.15802,9,4266.542306,237.030128,474.060256,155.769273,6,0
0,0,11,11,12,11,23,35,22,57,0.000333,0.085948,12,3094.116378,171.895354,257.843031,81.073298,4,0
0,0,12,12,15,12,27,38,22,60,0.000333,0.095098,7,1997.052751,110.947375,285.29325,101.622909,4,0
0,0,13,13,15,18,33,53,35,88,0.000333,0.147969,7,3107.346778,172.630377,443.906683,133.662009,6,0
0,0,12,12,15,12,27,38,22,60,0.000333,0.095098,7,1997.052751,110.947375,285.29325,101.622909,4,0
0,0,14,14,18,19,37,56,35,91,0.000333,0.15802,9,4266.542306,237.030128,474.060256,155.769273,6,0
0,0,13,13,15,18,33,53,35,88,0.000333,0.147969,7,3107.346778,172.630377,443.906683,133.662009,6,0
0,0,11,11,12,11,23,35,22,57,0.000333,0.085948,12,3094.116378,171.895354,257.843031,81.073298,4,0
0,0,12,12,16,12,28,39,24,63,0.000333,0.100954,16,4845.813761,269.211876,302.86336,107.01955,4,0
0,0,14,14,18,19,37,57,37,94,0.000333,0.16323,9,4407.197547,244.844308,489.688616,155.769273,6,0
0,0,13,13,15,19,34,53,37,90,0.000333,0.152624,7,3205.10159,178.061199,457.871656,139.313982,6,0
0,0,11,11,12,12,24,35,24,59,0.000333,0.090171,12,3246.153451,180.341858,270.512788,86.0391,4,0
0,0,12,12,16,12,28,39,24,63,0.000333,0.100954,16,4845.813761,269.211876,302.86336,107.01955,4,0
0,0,14,14,18,19,37,57,37,94,0.000333,0.16323,9,4407.197547,244.844308,489.688616,155.769273,6,0
0,0,13,13,15,19,34,53,37,90,0.000333,0.152624,7,3205.10159,178.061199,457.871656,139.313982,6,0
0,0,11,11,12,12,24,35,24,59,0.000333,0.090171,12,3246.153451,180.341858,270.512788,86.0391,4,0
0,0,16,16,17,12,29,45,24,69,0.000333,0.111734,16,5363.211019,297.956168,335.200689,112.506418,4,0
0,0,20,20,20,20,40,67,37,104,0.000333,0.184494,10,5534.805219,307.489179,553.480522,172.877124,6,0
0,0,18,18,20,19,39,63,37,100,0.000333,0.17618,10,5285.402219,293.633457,528.540222,167.149185,6,0
0,0,16,16,17,13,30,45,24,69,0.000333,0.112858,8,2708.603609,150.477978,338.575451,117.592585,4,0
0,0,13,13,14,11,25,39,22,61,0.000333,0.094425,14,3965.853186,220.325177,283.275228,91.356717,4,0
0,0,15,15,17,18,35,57,35,92,0.000333,0.157298,8,3775.1523,209.730683,471.894038,144.545518,6,0
0,0,11,11,15,13,28,45,30,75,0.000333,0.120184,14,5047.722668,280.429037,360.551619,106.709075,4,0
0,0,13,13,17,20,37,63,43,106,0.000333,0.184067,16,8835.232908,490.846273,552.202057,155.92543,6,0
0,0,15,15,17,19,36,53,37,90,0.000333,0.155098,8,3722.346001,206.797,465.29325,150.197491,4,0
0,0,13,13,14,12,26,35,24,59,0.000333,0.092442,14,3882.563207,215.697956,277.325943,96.322519,2,0
0,0,16,16,19,22,41,61,50,111,0.000333,0.198229,18,10704.38891,594.688273,594.688273,178.818118,5,0
0,0,13,13,13,15,28,40,33,73,0.000333,0.116979,12,4211.242912,233.95794,350.936909,106.709075,3,0
0,0,15,15,16,23,39,58,50,108,0.000333,0.190274,16,9133.175034,507.398613,570.82344,168.041925,5,0
0,0,15,15,13,24,37,55,48,103,0.000333,0.178858,12,6438.88436,357.715798,536.573697,158.144816,4,0
0,0,13,13,14,19,33,41,39,80,0.000333,0.134517,14,5649.721414,313.873412,403.55153,134.013592,4,0
0,0,16,16,18,22,40,60,50,110,0.000333,0.195137,18,10537.41763,585.41209,585.41209,173.166146,5,0
0,0,13,13,15,18,33,51,39,90,0.000333,0.151332,14,6355.93659,353.107588,453.995471,133.662009,4,0
0,0,11,11,12,11,23,33,26,59,0.000333,0.088963,12,3202.681865,177.92677,266.890155,81.073298,2,0
0,0,14,14,13,12,25,46,34,80,0.000333,0.123836,12,4458.101942,247.67233,371.508495,91.125266,2,0
0,0,16,16,16,19,35,64,47,111,0.000333,0.189783,16,9109.606638,506.089258,569.350415,144.710623,4,0
0,0,13,13,16,18,34,52,39,91,0.000333,0.15432,16,7407.345897,411.519216,462.959119,139.05865,4,0
0,0,11,11,13,11,24,34,26,60,0.000333,0.091699,12,3301.173001,183.3985,275.09775,86.159464,2,0
0,0,14,14,16,21,37,54,42,96,0.000333,0.166703,16,8001.72037,444.540021,500.107523,156.238666,4,0
0,0,12,12,13,14,27,36,29,65,0.000333,0.103023,12,3708.812252,206.045125,309.067688,101.408685,2,0
0,0,11,11,13,13,26,35,28,63,0.000333,0.098709,12,3553.532427,197.418468,296.127702,96.211433,2,0
0,0,13,13,16,20,36,53,41,94,0.000333,0.161991,16,7775.567202,431.975956,485.97295,150.438562,4,0
0,0,12,12,14,12,26,38,30,68,0.000333,0.106543,14,4474.818612,248.601034,319.629901,96.322519,2,0
0,0,14,14,17,19,36,56,43,99,0.000333,0.170608,16,8189.161202,454.9534,511.822575,150.197491,4,0
0,0,13,13,17,20,37,54,41,95,0.000333,0.164966,16,7918.369116,439.909395,494.89807,155.92543,4,0
0,0,11,11,14,13,27,36,28,64,0.000333,0.101438,14,4260.379202,236.687733,304.3128,101.408685,2,0
0,0,14,14,16,21,37,60,45,105,0.000333,0.182331,16,8751.881654,486.215647,546.992603,156.238666,4,0
0,0,12,12,13,14,27,42,32,74,0.000333,0.117287,12,4222.340102,234.57445,351.861675,101.408685,2,0
0,0,15,15,16,21,37,53,45,98,0.000333,0.170175,16,8168.422877,453.801271,510.52643,156.238666,4,0
0,0,13,13,13,14,27,35,32,67,0.000333,0.106192,12,3822.929552,212.384975,318.577463,101.408685,2,0
0,0,13,13,15,20,35,52,41,93,0.000333,0.159008,14,6678.326488,371.018138,477.023321,145.041921,4,0
0,0,11,11,12,13,25,34,28,62,0.000333,0.095973,12,3455.029005,191.946056,287.919084,91.125266,2,0
0,0,15,15,15,21,36,57,49,106,0.000333,0.182671,14,7672.168702,426.231595,548.01205,150.842025,4,0
0,0,13,13,12,14,26,39,36,75,0.000333,0.117511,12,4230.395746,235.021986,352.532979,96.322519,2,0
0,0,17,17,15,22,37,62,57,119,0.000333,0.206642,14,8678.949307,482.16385,619.924951,156.710855,4,0
0,0,15,15,12,15,27,44,44,88,0.000333,0.139477,12,5021.161202,278.9534,418.4301,101.622909,2,0
0,0,19,19,15,23,38,67,65,132,0.000333,0.230909,14,9698.170045,538.787225,692.726432,162.645284,4,0
0,0,17,17,12,16,28,49,52,101,0.000333,0.161848,18,8739.771248,485.542847,485.542847,107.01955,2,0
0,0,14,14,16,19,35,55,43,98,0.000333,0.167557,16,8042.715771,446.817543,502.669736,144.710623,4,0
0,0,12,12,13,12,25,37,30,67,0.000333,0.103713,12,3733.660377,207.425576,311.138365,91.125266,2,0
0,0,13,13,16,20,36,53,41,94,0.000333,0.161991,16,7775.567202,431.975956,485.97295,150.438562,4,0
0,0,11,11,13,13,26,35,28,63,0.000333,0.098709,12,3553.532427,197.418468,296.127702,96.211433,2,0
0,0,14,14,16,21,37,57,44,101,0.000333,0.175385,16,8418.476639,467.693147,526.15479,156.238666,4,0
0,0,12,12,13,14,27,39,31,70,0.000333,0.110947,12,3994.105502,221.89475,332.842125,101.408685,2,0
0,0,13,13,13,15,28,47,35,82,0.000333,0.131401,12,4730.437243,262.802069,394.203104,106.709075,2,0
0,0,15,15,16,22,38,65,48,113,0.000333,0.197672,16,9488.252944,527.125164,593.015809,162.107496,4,0
0,0,12,12,12,14,26,41,32,73,0.000333,0.114377,12,4117.585193,228.754733,343.132099,96.322519,2,0
0,0,14,14,15,21,36,59,45,104,0.000333,0.179224,14,7527.410802,418.189489,537.6722,150.842025,4,0
0,0,14,14,12,16,28,47,38,85,0.000333,0.136208,12,4903.50202,272.416779,408.625168,107.01955,2,0
0,0,16,16,15,23,38,65,51,116,0.000333,0.20292,14,8522.634282,473.479682,608.759592,162.645284,4,0
0,0,16,16,16,23,39,59,50,109,0.000333,0.192036,16,9217.74147,512.096748,576.108842,168.041925,4,0
0,0,14,14,13,16,29,41,37,78,0.000333,0.126308,12,4547.070211,252.615012,378.922518,112.105716,2,0
0,0,13,13,12,14,26,34,32,66,0.000333,0.10341,12,3722.748257,206.819348,310.229021,96.322519,2,0
0,0,15,15,15,21,36,52,45,97,0.000333,0.167161,14,7020.758152,390.04212,501.482725,150.842025,4,0
0,0,16,16,14,19,33,64,54,118,0.000333,0.198413,14,8333.339085,462.963283,595.238506,134.013592,2,0
0,0,18,18,16,26,42,82,67,149,0.000333,0.267818,16,12855.28474,714.182485,803.455296,186.211433,4,0
0,0,16,16,14,17,31,54,45,99,0.000333,0.163488,14,6866.516086,381.473116,490.465435,122.789837,2,0
0,0,18,18,16,24,40,72,58,130,0.000333,0.230617,16,11069.61044,614.978358,691.850652,174.0391,4,0
0,0,16,16,13,18,31,57,47,104,0.000333,0.171745,12,6182.836995,343.490944,515.236416,123.164366,2,0
0,0,18,18,15,25,40,75,60,135,0.000333,0.239487,14,10058.4441,558.80245,718.460293,174.699764,4,0
0,0,9,9,12,10,22,29,20,49,0.000333,0.072837,12,2622.145792,145.674766,218.512149,76.238831,2,0
0,0,9,9,16,12,28,36,23,59,0.000333,0.094545,8,2269.071523,126.059529,283.63394,107.01955,3,0
0,0,11,11,16,13,29,42,25,67,0.000333,0.108495,8,2603.877813,144.659879,325.484727,112.105716,5,0
0,0,11,11,12,11,23,35,22,57,0.000333,0.085948,12,3094.116378,171.895354,257.843031,81.073298,4,0
0,0,12,12,19,13,32,45,25,70,0.000333,0.116667,9,3150,175,350,128.816339,5,0
0,0,12,12,15,11,26,38,22,60,0.000333,0.094009,14,3948.369363,219.353854,282.026383,96.657107,4,0
0,0,11,11,16,13,29,42,27,69,0.000333,0.111734,16,5363.211019,297.956168,335.200689,112.105716,5,0
0,0,11,11,12,11,23,35,24,59,0.000333,0.088963,12,3202.681865,177.92677,266.890155,81.073298,4,0
0,0,12,12,20,13,33,46,27,73,0.000333,0.122747,20,7364.815414,409.156412,368.240771,134.544278,5,0
0,0,12,12,16,11,27,39,24,63,0.000333,0.099853,16,4792.926602,266.2737,299.557913,102.053748,4,0
0,0,11,11,16,13,29,42,25,67,0.000333,0.108495,8,2603.877813,144.659879,325.484727,112.105716,5,0
0,0,11,11,12,11,23,35,22,57,0.000333,0.085948,12,3094.116378,171.895354,257.843031,81.073298,4,0
0,0,12,12,19,14,33,45,25,70,0.000333,0.117703,9,3177.968295,176.553794,353.107588,134.013592,5,0
0,0,12,12,15,12,27,38,22,60,0.000333,0.095098,7,1997.052751,110.947375,285.29325,101.622909,4,0
0,0,11,11,16,13,29,42,25,67,0.000333,0.108495,8,2603.877813,144.659879,325.484727,112.105716,5,0
0,0,11,11,12,11,23,35,22,57,0.000333,0.085948,12,3094.116378,171.895354,257.843031,81.073298,4,0
0,0,12,12,19,14,33,45,25,70,0.000333,0.117703,9,3177.968295,176.553794,353.107588,134.013592,5,0
0,0,12,12,15,12,27,38,22,60,0.000333,0.095098,7,1997.052751,110.947375,285.29325,101.622909,4,0
0,0,11,11,12,12,24,35,24,59,0.000333,0.090171,12,3246.153451,180.341858,270.512788,86.0391,4,0
0,0,12,12,16,12,28,39,24,63,0.000333,0.100954,16,4845.813761,269.211876,302.86336,107.01955,4,0
0,0,11,11,16,14,30,42,27,69,0.000333,0.112858,8,2708.603609,150.477978,338.575451,117.302969,5,0
0,0,12,12,20,14,34,46,27,73,0.000333,0.123795,10,3713.847874,206.324882,371.384787,139.741531,5,0
0,0,11,11,12,12,24,35,24,59,0.000333,0.090171,12,3246.153451,180.341858,270.512788,86.0391,4,0
0,0,12,12,16,12,28,39,24,63,0.000333,0.100954,16,4845.813761,269.211876,302.86336,107.01955,4,0
0,0,11,11,16,14,30,42,27,69,0.000333,0.112858,8,2708.603609,150.477978,338.575451,117.302969,5,0
0,0,12,12,20,14,34,46,27,73,0.000333,0.123795,10,3713.847874,206.324882,371.384787,139.741531,5,0
0,0,11,11,12,11,23,35,22,57,0.000333,0.085948,12,3094.116378,171.895354,257.843031,81.073298,4,0
0,0,12,12,15,12,27,38,22,60,0.000333,0.095098,7,1997.052751,110.947375,285.29325,101.622909,4,0
0,0,11,11,16,13,29,42,25,67,0.000333,0.108495,8,2603.877813,144.659879,325.484727,112.105716,5,0
0,0,12,12,19,14,33,45,25,70,0.000333,0.117703,9,3177.968295,176.553794,353.107588,134.013592,5,0
0,0,11,11,16,13,29,42,25,67,0.000333,0.108495,8,2603.877813,144.659879,325.484727,112.105716,5,0
0,0,11,11,12,11,23,35,22,57,0.000333,0.085948,12,3094.116378,171.895354,257.843031,81.073298,4,0
0,0,12,12,19,14,33,45,25,70,0.000333,0.117703,9,3177.968295,176.553794,353.107588,134.013592,5,0
0,0,12,12,15,12,27,38,22,60,0.000333,0.095098,7,1997.052751,110.947375,285.29325,101.622909,4,0
0,0,11,11,16,13,29,42,25,67,0.000333,0.108495,8,2603.877813,144.659879,325.484727,112.105716,5,0
0,0,11,11,12,11,23,35,22,57,0.000333,0.085948,12,3094.116378,171.895354,257.843031,81.073298,4,0
0,0,12,12,19,14,33,45,25,70,0.000333,0.117703,9,3177.968295,176.553794,353.107588,134.013592,5,0
0,0,12,12,15,12,27,38,22,60,0.000333,0.095098,7,1997.052751,110.947375,285.29325,101.622909,4,0
0,0,11,11,12,11,23,35,22,57,0.000333,0.085948,12,3094.116378,171.895354,257.843031,81.073298,4,0
0,0,12,12,15,12,27,38,22,60,0.000333,0.095098,7,1997.052751,110.947375,285.29325,101.622909,4,0
0,0,11,11,16,13,29,42,25,67,0.000333,0.108495,8,2603.877813,144.659879,325.484727,112.105716,5,0
0,0,12,12,19,14,33,45,25,70,0.000333,0.117703,9,3177.968295,176.553794,353.107588,134.013592,5,0
0,0,11,11,12,12,24,35,24,59,0.000333,0.090171,12,3246.153451,180.341858,270.512788,86.0391,4,0
0,0,12,12,16,12,28,39,24,63,0.000333,0.100954,16,4845.813761,269.211876,302.86336,107.01955,4,0
0,0,11,11,16,14,30,42,27,69,0.000333,0.112858,8,2708.603609,150.477978,338.575451,117.302969,5,0
0,0,12,12,20,14,34,46,27,73,0.000333,0.123795,10,3713.847874,206.324882,371.384787,139.741531,5,0
0,0,11,11,12,12,24,35,24,59,0.000333,0.090171,12,3246.153451,180.341858,270.512788,86.0391,4,0
0,0,12,12,16,12,28,39,24,63,0.000333,0.100954,16,4845.813761,269.211876,302.86336,107.01955,4,0
0,0,11,11,16,14,30,42,27,69,0.000333,0.112858,8,2708.603609,150.477978,338.575451,117.302969,5,0
0,0,12,12,20,14,34,46,27,73,0.000333,0.123795,10,3713.847874,206.324882,371.384787,139.741531,5,0
0,0,18,18,21,15,36,56,27,83,0.000333,0.143035,10,4291.037751,238.390986,429.103775,150.842025,5,0
0,0,16,16,17,13,30,45,24,69,0.000333,0.112858,8,2708.603609,150.477978,338.575451,117.592585,4,0
0,0,16,16,17,12,29,45,24,69,0.000333,0.111734,16,5363.211019,297.956168,335.200689,112.506418,4,0
0,0,16,16,21,14,35,52,27,79,0.000333,0.135071,10,4052.133583,225.118532,405.213358,145.541635,5,0
0,0,13,13,14,11,25,39,22,61,0.000333,0.094425,14,3965.853186,220.325177,283.275228,91.356717,4,0
0,0,13,13,18,13,31,46,25,71,0.000333,0.117249,9,3165.731442,175.873969,351.747938,123.164366,5,0
0,0,11,11,15,13,28,45,30,75,0.000333,0.120184,14,5047.722668,280.429037,360.551619,106.709075,4,0
0,0,11,11,18,15,33,52,33,85,0.000333,0.142925,18,7717.923003,428.7735,428.7735,133.662009,5,0
0,0,13,13,18,14,32,42,27,69,0.000333,0.115,9,3105,172.5,345,128.361619,3,0
0,0,13,13,14,12,26,35,24,59,0.000333,0.092442,14,3882.563207,215.697956,277.325943,96.322519,2,0
0,0,14,14,20,17,37,50,40,90,0.000333,0.156284,20,9377.016058,520.945337,468.850803,155.92543,4,0
0,0,13,13,17,18,35,47,40,87,0.000333,0.148749,16,7139.96196,396.664553,446.247622,144.545518,4,0
0,0,13,13,13,15,28,40,33,73,0.000333,0.116979,12,4211.242912,233.95794,350.936909,106.709075,3,0
0,0,13,13,12,16,28,39,37,76,0.000333,0.121786,12,4384.307689,243.572649,365.358974,107.01955,3,0
0,0,13,13,16,18,34,46,40,86,0.000333,0.145841,16,7000.34887,388.908271,437.521804,139.05865,4,0
0,0,14,14,19,17,36,49,40,89,0.000333,0.153374,18,8282.219852,460.123325,460.123325,150.197491,4,0
0,0,11,11,12,11,23,33,26,59,0.000333,0.088963,12,3202.681865,177.92677,266.890155,81.073298,2,0
0,0,11,11,16,13,29,40,29,69,0.000333,0.111734,16,5363.211019,297.956168,335.200689,112.105716,3,0
0,0,14,14,13,12,25,46,34,80,0.000333,0.123836,12,4458.101942,247.67233,371.508495,91.125266,2,0
0,0,14,14,16,14,30,53,37,90,0.000333,0.147207,16,7065.922458,392.551248,441.620154,117.302969,3,0
0,0,11,11,13,11,24,34,26,60,0.000333,0.091699,12,3301.173001,183.3985,275.09775,86.159464,2,0
0,0,11,11,16,13,29,41,29,70,0.000333,0.113353,16,5440.938715,302.274373,340.05867,112.105716,3,0
0,0,12,12,17,16,33,43,32,75,0.000333,0.12611,16,6053.272943,336.292941,378.329559,133.486868,3,0
0,0,12,12,13,14,27,36,29,65,0.000333,0.103023,12,3708.812252,206.045125,309.067688,101.408685,2,0
0,0,11,11,13,13,26,35,28,63,0.000333,0.098709,12,3553.532427,197.418468,296.127702,96.211433,2,0
0,0,11,11,17,15,32,42,31,73,0.000333,0.121667,16,5840,324.444444,365,128.090227,3,0
0,0,12,12,18,14,32,45,33,78,0.000333,0.13,18,7020,390,390,128.361619,3,0
0,0,12,12,14,12,26,38,30,68,0.000333,0.106543,14,4474.818612,248.601034,319.629901,96.322519,2,0
0,0,11,11,14,13,27,36,28,64,0.000333,0.101438,14,4260.379202,236.687733,304.3128,101.408685,2,0
0,0,11,11,17,15,32,43,31,74,0.000333,0.123333,16,5920,328.888889,370,128.090227,3,0
0,0,12,12,13,14,27,42,32,74,0.000333,0.117287,12,4222.340102,234.57445,351.861675,101.408685,2,0
0,0,12,12,17,16,33,49,35,84,0.000333,0.141243,16,6779.665696,376.648094,423.729106,133.486868,3,0
0,0,13,13,17,16,33,42,35,77,0.000333,0.129473,16,6214.693555,345.260753,388.418347,133.486868,3,0
0,0,13,13,13,14,27,35,32,67,0.000333,0.106192,12,3822.929552,212.384975,318.577463,101.408685,2,0
0,0,11,11,16,15,31,41,31,72,0.000333,0.118901,16,5707.23415,317.068564,356.702134,122.603359,3,0
0,0,11,11,12,13,25,34,28,62,0.000333,0.095973,12,3455.029005,191.946056,287.919084,91.125266,2,0
0,0,13,13,16,16,32,46,39,85,0.000333,0.141667,16,6800,377.777778,425,128,3,0
0,0,13,13,12,14,26,39,36,75,0.000333,0.117511,12,4230.395746,235.021986,352.532979,96.322519,2,0
0,0,15,15,16,17,33,51,47,98,0.000333,0.164784,16,7909.609979,439.422777,494.350624,133.486868,3,0
0,0,15,15,12,15,27,44,44,88,0.000333,0.139477,12,5021.161202,278.9534,418.4301,101.622909,2,0
0,0,17,17,16,18,34,56,55,111,0.000333,0.188236,24,13553.00101,752.944501,564.708375,139.05865,3,0
0,0,17,17,12,16,28,49,52,101,0.000333,0.161848,18,8739.771248,485.542847,485.542847,107.01955,2,0
0,0,12,12,13,12,25,37,30,67,0.000333,0.103713,12,3733.660377,207.425576,311.138365,91.125266,2,0
0,0,12,12,17,14,31,44,33,77,0.000333,0.127158,16,6103.569854,339.087214,381.473116,122.789837,3,0
0,0,11,11,13,13,26,35,28,63,0.000333,0.098709,12,3553.532427,197.418468,296.127702,96.211433,2,0
0,0,11,11,16,15,31,42,31,73,0.000333,0.120552,16,5786.501291,321.472294,361.656331,122.603359,3,0
0,0,12,12,13,14,27,39,31,70,0.000333,0.110947,12,3994.105502,221.89475,332.842125,101.408685,2,0
0,0,12,12,16,16,32,46,34,80,0.000333,0.133333,16,6400,355.555556,400,128,3,0
0,0,13,13,16,17,33,54,38,92,0.000333,0.154695,16,7425.348144,412.519341,464.084259,133.486868,3,0
0,0,13,13,13,15,28,47,35,82,0.000333,0.131401,12,4730.437243,262.802069,394.203104,106.709075,2,0
0,0,12,12,16,16,32,48,35,83,0.000333,0.138333,16,6640,368.888889,415,128,3,0
0,0,12,12,12,14,26,41,32,73,0.000333,0.114377,12,4117.585193,228.754733,343.132099,96.322519,2,0
0,0,14,14,12,16,28,47,38,85,0.000333,0.136208,12,4903.50202,272.416779,408.625168,107.01955,2,0
0,0,14,14,16,18,34,54,41,95,0.000333,0.161103,16,7732.943519,429.607973,483.30897,139.05865,3,0
0,0,14,14,17,18,35,48,40,88,0.000333,0.150459,16,7222.030488,401.223916,451.376905,144.545518,3,0
0,0,14,14,13,16,29,41,37,78,0.000333,0.126308,12,4547.070211,252.615012,378.922518,112.105716,2,0
0,0,13,13,12,14,26,34,32,66,0.000333,0.10341,12,3722.748257,206.819348,310.229021,96.322519,2,0
0,0,13,13,16,16,32,41,35,76,0.000333,0.126667,16,6080,337.777778,380,128,3,0
0,0,16,16,17,21,38,71,57,128,0.000333,0.223912,16,10747.75555,597.09753,671.734722,161.725534,3,0
0,0,16,16,14,19,33,64,54,118,0.000333,0.198413,14,8333.339085,462.963283,595.238506,134.013592,2,0
0,0,16,16,17,19,36,61,48,109,0.000333,0.187841,16,9016.349203,500.908289,563.521825,150.197491,3,0
0,0,16,16,14,17,31,54,45,99,0.000333,0.163488,14,6866.516086,381.473116,490.465435,122.789837,2,0
0,0,16,16,16,20,36,64,50,114,0.000333,0.196457,16,9429.943203,523.885733,589.37145,150.438562,3,0
0,0,16,16,13,18,31,57,47,104,0.000333,0.171745,12,6182.836995,343.490944,515.236416,123.164366,2,0
0,0,14,14,17,20,37,56,41,97,0.000333,0.168439,16,8085.071623,449.170646,505.316976,155.92543,5,0
0,0,9,9,12,10,22,29,20,49,0.000333,0.072837,12,2622.145792,145.674766,218.512149,76.238831,2,0
0,0,11,11,12,11,23,35,22,57,0.000333,0.085948,12,3094.116378,171.895354,257.843031,81.073298,4,0
0,0,12,12,15,11,26,38,22,60,0.000333,0.094009,14,3948.369363,219.353854,282.026383,96.657107,4,0
0,0,16,16,17,20,37,62,43,105,0.000333,0.182331,16,8751.881654,486.215647,546.992603,155.92543,7,0
0,0,17,17,20,20,40,65,43,108,0.000333,0.191589,20,11495.36469,638.631371,574.768234,172.877124,7,0
0,0,11,11,12,11,23,35,24,59,0.000333,0.088963,12,3202.681865,177.92677,266.890155,81.073298,4,0
0,0,12,12,16,11,27,39,24,63,0.000333,0.099853,16,4792.926602,266.2737,299.557913,102.053748,4,0
0,0,16,16,17,21,38,62,45,107,0.000333,0.187176,16,8984.451903,499.136217,561.528244,161.725534,7,0
0,0,17,17,21,21,42,66,45,111,0.000333,0.199516,20,11970.94468,665.052482,598.547234,184.477332,7,0
0,0,17,17,20,22,42,65,43,108,0.000333,0.194123,10,5823.702817,323.539045,582.370282,184.546058,7,0
0,0,11,11,12,11,23,35,22,57,0.000333,0.085948,12,3094.116378,171.895354,257.843031,81.073298,4,0
0,0,12,12,15,12,27,38,22,60,0.000333,0.095098,7,1997.052751,110.947375,285.29325,101.622909,4,0
0,0,16,16,17,21,38,62,43,105,0.000333,0.183677,16,8816.518223,489.806568,551.032389,161.725534,7,0
0,0,17,17,20,22,42,65,43,108,0.000333,0.194123,10,5823.702817,323.539045,582.370282,184.546058,7,0
0,0,11,11,12,11,23,35,22,57,0.000333,0.085948,12,3094.116378,171.895354,257.843031,81.073298,4,0
0,0,12,12,15,12,27,38,22,60,0.000333,0.095098,7,1997.052751,110.947375,285.29325,101.622909,4,0
0,0,16,16,17,21,38,62,43,105,0.000333,0.183677,16,8816.518223,489.806568,551.032389,161.725534,7,0
0,0,17,17,21,22,43,66,45,111,0.000333,0.200772,20,12046.30776,669.23932,602.315388,190.346161,7,0
0,0,16,16,17,22,39,62,45,107,0.000333,0.188513,16,9048.608599,502.700478,565.538037,167.594364,7,0
0,0,11,11,12,12,24,35,24,59,0.000333,0.090171,12,3246.153451,180.341858,270.512788,86.0391,4,0
0,0,12,12,16,12,28,39,24,63,0.000333,0.100954,16,4845.813761,269.211876,302.86336,107.01955,4,0
0,0,17,17,21,22,43,66,45,111,0.000333,0.200772,20,12046.30776,669.23932,602.315388,190.346161,7,0
0,0,16,16,17,22,39,62,45,107,0.000333,0.188513,16,9048.608599,502.700478,565.538037,167.594364,7,0
0,0,11,11,12,12,24,35,24,59,0.000333,0.090171,12,3246.153451,180.341858,270.512788,86.0391,4,0
0,0,12,12,16,12,28,39,24,63,0.000333,0.100954,16,4845.813761,269.211876,302.86336,107.01955,4,0
0,0,17,17,20,22,42,65,43,108,0.000333,0.194123,10,5823.702817,323.539045,582.370282,184.546058,7,0
0,0,16,16,17,21,38,62,43,105,0.000333,0.183677,16,8816.518223,489.806568,551.032389,161.725534,7,0
0,0,11,11,12,11,23,35,22,57,0.000333,0.085948,12,3094.116378,171.895354,257.843031,81.073298,4,0
0,0,12,12,15,12,27,38,22,60,0.000333,0.095098,7,1997.052751,110.947375,285.29325,101.622909,4,0
0,0,11,11,12,11,23,35,22,57,0.000333,0.085948,12,3094.116378,171.895354,257.843031,81.073298,4,0
0,0,12,12,15,12,27,38,22,60,0.000333,0.095098,7,1997.052751,110.947375,285.29325,101.622909,4,0
0,0,16,16,17,21,38,62,43,105,0.000333,0.183677,16,8816.518223,489.806568,551.032389,161.725534,7,0
0,0,17,17,20,22,42,65,43,108,0.000333,0.194123,10,5823.702817,323.539045,582.370282,184.546058,7,0
0,0,11,11,12,11,23,35,22,57,0.000333,0.085948,12,3094.116378,171.895354,257.843031,81.073298,4,0
0,0,12,12,15,12,27,38,22,60,0.000333,0.095098,7,1997.052751,110.947375,285.29325,101.622909,4,0
0,0,16,16,17,21,38,62,43,105,0.000333,0.183677,16,8816.518223,489.806568,551.032389,161.725534,7,0
0,0,17,17,20,22,42,65,43,108,0.000333,0.194123,10,5823.702817,323.539045,582.370282,184.546058,7,0
0,0,17,17,20,22,42,65,43,108,0.000333,0.194123,10,5823.702817,323.539045,582.370282,184.546058,7,0
0,0,16,16,17,21,38,62,43,105,0.000333,0.183677,16,8816.518223,489.806568,551.032389,161.725534,7,0
0,0,11,11,12,11,23,35,22,57,0.000333,0.085948,12,3094.116378,171.895354,257.843031,81.073298,4,0
0,0,12,12,15,12,27,38,22,60,0.000333,0.095098,7,1997.052751,110.947375,285.29325,101.622909,4,0
0,0,17,17,21,22,43,66,45,111,0.000333,0.200772,20,12046.30776,669.23932,602.315388,190.346161,7,0
0,0,16,16,17,22,39,62,45,107,0.000333,0.188513,16,9048.608599,502.700478,565.538037,167.594364,7,0
0,0,11,11,12,12,24,35,24,59,0.000333,0.090171,12,3246.153451,180.341858,270.512788,86.0391,4,0
0,0,12,12,16,12,28,39,24,63,0.000333,0.100954,16,4845.813761,269.211876,302.86336,107.01955,4,0
0,0,16,16,17,22,39,62,45,107,0.000333,0.188513,16,9048.608599,502.700478,565.538037,167.594364,7,0
0,0,17,17,21,22,43,66,45,111,0.000333,0.200772,20,12046.30776,669.23932,602.315388,190.346161,7,0
0,0,11,11,12,12,24,35,24,59,0.000333,0.090171,12,3246.153451,180.341858,270.512788,86.0391,4,0
0,0,12,12,16,12,28,39,24,63,0.000333,0.100954,16,4845.813761,269.211876,302.86336,107.01955,4,0
0,0,21,21,21,22,43,72,45,117,0.000333,0.211624,20,12697.45953,705.414418,634.872976,190.346161,7,0
0,0,16,16,17,13,30,45,24,69,0.000333,0.112858,8,2708.603609,150.477978,338.575451,117.592585,4,0
0,0,16,16,17,12,29,45,24,69,0.000333,0.111734,16,5363.211019,297.956168,335.200689,112.506418,4,0
0,0,23,23,21,23,44,76,45,121,0.000333,0.220197,10,6605.912259,366.995125,660.591226,196.280591,7,0
0,0,18,18,18,20,38,66,43,109,0.000333,0.190675,18,10296.43378,572.024099,572.024099,161.497212,7,0
0,0,13,13,14,11,25,39,22,61,0.000333,0.094425,14,3965.853186,220.325177,283.275228,91.356717,4,0
0,0,11,11,15,13,28,45,30,75,0.000333,0.120184,14,5047.722668,280.429037,360.551619,106.709075,4,0
0,0,16,16,19,22,41,72,51,123,0.000333,0.21966,18,11861.62014,658.978897,658.978897,178.818118,7,0
0,0,13,13,14,12,26,35,24,59,0.000333,0.092442,14,3882.563207,215.697956,277.325943,96.322519,2,0
0,0,18,18,19,22,41,62,45,107,0.000333,0.191086,18,10318.64516,573.258064,573.258064,178.818118,5,0
0,0,13,13,13,15,28,40,33,73,0.000333,0.116979,12,4211.242912,233.95794,350.936909,106.709075,3,0
0,0,18,18,18,25,43,67,58,125,0.000333,0.226094,18,12209.0957,678.283094,678.283094,191.155055,6,0
0,0,19,19,21,25,46,70,58,128,0.000333,0.235672,20,14140.31861,785.573256,707.01593,208.335071,6,0
0,0,19,19,20,25,45,69,58,127,0.000333,0.232488,20,13949.30687,774.961492,697.465343,202.534967,6,0
0,0,13,13,12,16,28,39,37,76,0.000333,0.121786,12,4384.307689,243.572649,365.358974,107.01955,3,0
0,0,18,18,17,25,42,66,58,124,0.000333,0.222882,16,10698.35777,594.353209,668.64736,185.583273,6,0
0,0,16,16,17,21,38,60,47,107,0.000333,0.187176,16,8984.451903,499.136217,561.528244,161.725534,5,0
0,0,11,11,12,11,23,33,26,59,0.000333,0.088963,12,3202.681865,177.92677,266.890155,81.073298,2,0
0,0,14,14,13,12,25,46,34,80,0.000333,0.123836,12,4458.101942,247.67233,371.508495,91.125266,2,0
0,0,19,19,18,22,40,73,55,128,0.000333,0.227069,18,12261.72233,681.206796,681.206796,173.166146,5,0
0,0,16,16,18,21,39,61,47,108,0.000333,0.190274,18,10274.82191,570.82344,570.82344,167.297316,5,0
0,0,11,11,13,11,24,34,26,60,0.000333,0.091699,12,3301.173001,183.3985,275.09775,86.159464,2,0
0,0,12,12,13,14,27,36,29,65,0.000333,0.103023,12,3708.812252,206.045125,309.067688,101.408685,2,0
0,0,17,17,18,24,42,63,50,113,0.000333,0.203111,18,10967.97364,609.331869,609.331869,185.09775,5,0
0,0,16,16,18,23,41,62,49,111,0.000333,0.198229,18,10704.38891,594.688273,594.688273,179.100575,5,0
0,0,11,11,13,13,26,35,28,63,0.000333,0.098709,12,3553.532427,197.418468,296.127702,96.211433,2,0
0,0,17,17,19,22,41,65,51,116,0.000333,0.207159,18,11186.56859,621.476033,621.476033,178.818118,5,0
0,0,12,12,14,12,26,38,30,68,0.000333,0.106543,14,4474.818612,248.601034,319.629901,96.322519,2,0
0,0,11,11,14,13,27,36,28,64,0.000333,0.101438,14,4260.379202,236.687733,304.3128,101.408685,2,0
0,0,16,16,19,23,42,63,49,112,0.000333,0.201313,18,10870.91192,603.939551,603.939551,184.752548,5,0
0,0,17,17,18,24,42,69,53,122,0.000333,0.219288,18,11841.52906,657.862726,657.862726,185.09775,5,0
0,0,12,12,13,14,27,42,32,74,0.000333,0.117287,12,4222.340102,234.57445,351.861675,101.408685,2,0
0,0,18,18,18,24,42,62,53,115,0.000333,0.206706,18,11162.09707,620.116504,620.116504,185.09775,5,0
0,0,13,13,13,14,27,35,32,67,0.000333,0.106192,12,3822.929552,212.384975,318.577463,101.408685,2,0
0,0,16,16,17,23,40,61,49,110,0.000333,0.195137,16,9366.593447,520.366303,585.41209,173.528793,5,0
0,0,11,11,12,13,25,34,28,62,0.000333,0.095973,12,3455.029005,191.946056,287.919084,91.125266,2,0
0,0,18,18,17,24,41,66,57,123,0.000333,0.21966,16,10543.66235,585.759019,658.978897,179.525968,5,0
0,0,13,13,12,14,26,39,36,75,0.000333,0.117511,12,4230.395746,235.021986,352.532979,96.322519,2,0
0,0,20,20,17,25,42,71,65,136,0.000333,0.244452,16,11733.68271,651.871262,733.355169,185.583273,5,0
0,0,15,15,12,15,27,44,44,88,0.000333,0.139477,12,5021.161202,278.9534,418.4301,101.622909,2,0
0,0,22,22,17,26,43,76,73,149,0.000333,0.269504,16,12936.21518,718.678621,808.513448,191.698301,5,0
0,0,17,17,12,16,28,49,52,101,0.000333,0.161848,18,8739.771248,485.542847,485.542847,107.01955,2,0
0,0,12,12,13,12,25,37,30,67,0.000333,0.103713,12,3733.660377,207.425576,311.138365,91.125266,2,0
0,0,17,17,18,22,40,64,51,115,0.000333,0.204007,18,11016.39116,612.021731,612.021731,173.166146,5,0
0,0,11,11,13,13,26,35,28,63,0.000333,0.098709,12,3553.532427,197.418468,296.127702,96.211433,2,0
0,0,16,16,18,23,41,62,49,111,0.000333,0.198229,18,10704.38891,594.688273,594.688273,179.100575,5,0
0,0,12,12,13,14,27,39,31,70,0.000333,0.110947,12,3994.105502,221.89475,332.842125,101.408685,2,0
0,0,17,17,18,24,42,66,52,118,0.000333,0.212098,18,11453.28221,636.293456,636.293456,185.09775,5,0
0,0,13,13,13,15,28,47,35,82,0.000333,0.131401,12,4730.437243,262.802069,394.203104,106.709075,2,0
0,0,18,18,18,25,43,74,56,130,0.000333,0.235138,18,12697.45953,705.414418,705.414418,191.155055,5,0
0,0,12,12,12,14,26,41,32,73,0.000333,0.114377,12,4117.585193,228.754733,343.132099,96.322519,2,0
0,0,17,17,17,24,41,68,53,121,0.000333,0.216088,16,10372.22068,576.234482,648.263793,179.525968,5,0
0,0,19,19,17,26,43,74,59,133,0.000333,0.240564,16,11547.0914,641.505078,721.693212,191.698301,5,0
0,0,14,14,12,16,28,47,38,85,0.000333,0.136208,12,4903.50202,272.416779,408.625168,107.01955,2,0
0,0,19,19,18,26,44,68,58,126,0.000333,0.229296,18,12381.99091,687.888384,687.888384,197.270083,5,0
0,0,14,14,13,16,29,41,37,78,0.000333,0.126308,12,4547.070211,252.615012,378.922518,112.105716,2,0
0,0,18,18,17,24,41,61,53,114,0.000333,0.203587,16,9772.174856,542.898603,610.760929,179.525968,5,0
0,0,13,13,12,14,26,34,32,66,0.000333,0.10341,12,3722.748257,206.819348,310.229021,96.322519,2,0
0,0,16,16,14,19,33,64,54,118,0.000333,0.198413,14,8333.339085,462.963283,595.238506,134.013592,2,0
0,0,21,21,18,28,46,91,75,166,0.000333,0.305637,18,16504.40313,916.911285,916.911285,209.664588,5,0
0,0,16,16,14,17,31,54,45,99,0.000333,0.163488,14,6866.516086,381.473116,490.465435,122.789837,2,0
0,0,21,21,18,27,45,81,66,147,0.000333,0.269101,18,14531.44329,807.302405,807.302405,203.440613,5,0
0,0,16,16,13,18,31,57,47,104,0.000333,0.171745,12,6182.836995,343.490944,515.236416,123.164366,2,0
0,0,21,21,17,27,44,84,68,152,0.000333,0.276611,16,13277.3377,737.629872,829.833606,197.868831,5,0
0,0,9,9,12,10,22,29,20,49,0.000333,0.072837,12,2622.145792,145.674766,218.512149,76.238831,2,0
0,0,9,9,14,11,25,31,22,53,0.000333,0.082041,14,3445.741293,191.430072,246.124378,91.356717,3,0
0,0,11,11,14,12,26,37,24,61,0.000333,0.095576,14,4014.175519,223.009751,286.726823,96.322519,5,0
0,0,11,11,12,11,23,35,22,57,0.000333,0.085948,12,3094.116378,171.895354,257.843031,81.073298,4,0
0,0,12,12,17,12,29,40,24,64,0.000333,0.103637,16,4974.572539,276.365141,310.910784,112.506418,5,0
0,0,12,12,15,11,26,38,22,60,0.000333,0.094009,14,3948.369363,219.353854,282.026383,96.657107,4,0
0,0,11,11,14,12,26,37,26,63,0.000333,0.098709,14,4145.787831,230.321546,296.127702,96.322519,5,0
0,0,11,11,12,11,23,35,24,59,0.000333,0.088963,12,3202.681865,177.92677,266.890155,81.073298,4,0
0,0,12,12,18,12,30,41,26,67,0.000333,0.109587,18,5917.710058,328.76167,328.76167,118.0782,5,0
0,0,12,12,16,11,27,39,24,63,0.000333,0.099853,16,4792.926602,266.2737,299.557913,102.053748,4,0
0,0,11,11,14,12,26,37,24,61,0.000333,0.095576,14,4014.175519,223.009751,286.726823,96.322519,5,0
0,0,11,11,12,11,23,35,22,57,0.000333,0.085948,12,3094.116378,171.895354,257.843031,81.073298,4,0
0,0,12,12,17,13,30,40,24,64,0.000333,0.10468,8,2512.327985,139.573777,314.040998,117.592585,5,0
0,0,12,12,15,12,27,38,22,60,0.000333,0.095098,7,1997.052751,110.947375,285.29325,101.622909,4,0
0,0,11,11,14,12,26,37,24,61,0.000333,0.095576,14,4014.175519,223.009751,286.726823,96.322519,5,0
0,0,11,11,12,11,23,35,22,57,0.000333,0.085948,12,3094.116378,171.895354,257.843031,81.073298,4,0
0,0,12,12,17,13,30,40,24,64,0.000333,0.10468,8,2512.327985,139.573777,314.040998,117.592585,5,0
0,0,12,12,15,12,27,38,22,60,0.000333,0.095098,7,1997.052751,110.947375,285.29325,101.622909,4,0
0,0,6,6,11,8,19,24,14,38,0.000333,0.053807,5,807.106228,44.839235,161.421246,62.053748,2,0
0,0,9,9,12,12,24,39,24,63,0.000333,0.096284,12,3466.231651,192.568425,288.852638,86.0391,2,0
0,0,7,7,11,9,20,26,16,42,0.000333,0.060507,5,907.6049,50.422494,181.52098,66.583073,2,0
0,0,11,11,12,14,26,44,30,74,0.000333,0.115944,12,4173.99047,231.888359,347.832539,96.322519,2,0
0,0,6,6,11,8,19,24,14,38,0.000333,0.053807,5,807.106228,44.839235,161.421246,62.053748,2,0
0,0,9,9,12,12,24,39,24,63,0.000333,0.096284,12,3466.231651,192.568425,288.852638,86.0391,2,0
0,0,7,7,11,9,20,26,16,42,0.000333,0.060507,5,907.6049,50.422494,181.52098,66.583073,2,0
0,0,11,11,12,14,26,44,30,74,0.000333,0.115944,12,4173.99047,231.888359,347.832539,96.322519,2,0
0,0,6,6,13,9,22,26,16,42,0.000333,0.062432,6,1123.776768,62.432043,187.296128,76.635041,3,0
0,0,9,9,14,13,27,41,26,67,0.000333,0.106192,14,4460.084477,247.782471,318.577463,101.408685,3,0
0,0,7,7,13,10,23,28,18,46,0.000333,0.069361,6,1248.5031,69.361283,208.08385,81.324997,3,0
0,0,11,11,14,15,29,46,32,78,0.000333,0.126308,14,5304.915247,294.717514,378.922518,111.906328,3,0
0,0,6,6,13,9,22,26,16,42,0.000333,0.062432,6,1123.776768,62.432043,187.296128,76.635041,3,0
0,0,9,9,14,13,27,41,26,67,0.000333,0.106192,14,4460.084477,247.782471,318.577463,101.408685,3,0
0,0,7,7,13,10,23,28,18,46,0.000333,0.069361,6,1248.5031,69.361283,208.08385,81.324997,3,0
0,0,11,11,14,15,29,46,32,78,0.000333,0.126308,14,5304.915247,294.717514,378.922518,111.906328,3,0
0,0,6,6,11,8,19,24,14,38,0.000333,0.053807,5,807.106228,44.839235,161.421246,62.053748,2,0
0,0,9,9,12,12,24,39,24,63,0.000333,0.096284,12,3466.231651,192.568425,288.852638,86.0391,2,0
0,0,7,7,11,9,20,26,16,42,0.000333,0.060507,5,907.6049,50.422494,181.52098,66.583073,2,0
0,0,11,11,12,14,26,44,30,74,0.000333,0.115944,12,4173.99047,231.888359,347.832539,96.322519,2,0
0,0,6,6,11,8,19,24,14,38,0.000333,0.053807,5,807.106228,44.839235,161.421246,62.053748,2,0
0,0,9,9,12,12,24,39,24,63,0.000333,0.096284,12,3466.231651,192.568425,288.852638,86.0391,2,0
0,0,7,7,11,9,20,26,16,42,0.000333,0.060507,5,907.6049,50.422494,181.52098,66.583073,2,0
0,0,11,11,12,14,26,44,30,74,0.000333,0.115944,12,4173.99047,231.888359,347.832539,96.322519,2,0
0,0,6,6,11,8,19,24,14,38,0.000333,0.053807,5,807.106228,44.839235,161.421246,62.053748,2,0
0,0,9,9,12,12,24,39,24,63,0.000333,0.096284,12,3466.231651,192.568425,288.852638,86.0391,2,0
0,0,7,7,11,9,20,26,16,42,0.000333,0.060507,5,907.6049,50.422494,181.52098,66.583073,2,0
0,0,11,11,12,14,26,44,30,74,0.000333,0.115944,12,4173.99047,231.888359,347.832539,96.322519,2,0
0,0,6,6,13,9,22,26,16,42,0.000333,0.062432,6,1123.776768,62.432043,187.296128,76.635041,3,0
0,0,9,9,14,13,27,41,26,67,0.000333,0.106192,14,4460.084477,247.782471,318.577463,101.408685,3,0
0,0,7,7,13,10,23,28,18,46,0.000333,0.069361,6,1248.5031,69.361283,208.08385,81.324997,3,0
0,0,11,11,14,15,29,46,32,78,0.000333,0.126308,14,5304.915247,294.717514,378.922518,111.906328,3,0
0,0,6,6,13,9,22,26,16,42,0.000333,0.062432,6,1123.776768,62.432043,187.296128,76.635041,3,0
0,0,9,9,14,13,27,41,26,67,0.000333,0.106192,14,4460.084477,247.782471,318.577463,101.408685,3,0
0,0,7,7,13,10,23,28,18,46,0.000333,0.069361,6,1248.5031,69.361283,208.08385,81.324997,3,0
0,0,11,11,14,15,29,46,32,78,0.000333,0.126308,14,5304.915247,294.717514,378.922518,111.906328,3,0
0,0,6,6,11,8,19,24,14,38,0.000333,0.053807,5,807.106228,44.839235,161.421246,62.053748,2,0
0,0,9,9,12,12,24,39,24,63,0.000333,0.096284,12,3466.231651,192.568425,288.852638,86.0391,2,0
0,0,7,7,11,9,20,26,16,42,0.000333,0.060507,5,907.6049,50.422494,181.52098,66.583073,2,0
0,0,11,11,12,14,26,44,30,74,0.000333,0.115944,12,4173.99047,231.888359,347.832539,96.322519,2,0
0,0,6,6,11,8,19,24,14,38,0.000333,0.053807,5,807.106228,44.839235,161.421246,62.053748,2,0
0,0,9,9,12,12,24,39,24,63,0.000333,0.096284,12,3466.231651,192.568425,288.852638,86.0391,2,0
0,0,7,7,11,9,20,26,16,42,0.000333,0.060507,5,907.6049,50.422494,181.52098,66.583073,2,0
0,0,11,11,12,14,26,44,30,74,0.000333,0.115944,12,4173.99047,231.888359,347.832539,96.322519,2,0
0,0,6,6,13,9,22,26,16,42,0.000333,0.062432,6,1123.776768,62.432043,187.296128,76.635041,3,0
0,0,9,9,14,13,27,41,26,67,0.000333,0.106192,14,4460.084477,247.782471,318.577463,101.408685,3,0
0,0,7,7,13,10,23,28,18,46,0.000333,0.069361,6,1248.5031,69.361283,208.08385,81.324997,3,0
0,0,11,11,14,15,29,46,32,78,0.000333,0.126308,14,5304.915247,294.717514,378.922518,111.906328,3,0
0,0,6,6,13,9,22,26,16,42,0.000333,0.062432,6,1123.776768,62.432043,187.296128,76.635041,3,0
0,0,9,9,14,13,27,41,26,67,0.000333,0.106192,14,4460.084477,247.782471,318.577463,101.408685,3,0
0,0,7,7,13,10,23,28,18,46,0.000333,0.069361,6,1248.5031,69.361283,208.08385,81.324997,3,0
0,0,11,11,14,15,29,46,32,78,0.000333,0.126308,14,5304.915247,294.717514,378.922518,111.906328,3,0
0,0,6,6,11,8,19,24,14,38,0.000333,0.053807,5,807.106228,44.839235,161.421246,62.053748,2,0
0,0,9,9,12,12,24,39,24,63,0.000333,0.096284,12,3466.231651,192.568425,288.852638,86.0391,2,0
0,0,7,7,11,9,20,26,16,42,0.000333,0.060507,5,907.6049,50.422494,181.52098,66.583073,2,0
0,0,11,11,12,14,26,44,30,74,0.000333,0.115944,12,4173.99047,231.888359,347.832539,96.322519,2,0
0,0,6,6,11,8,19,24,14,38,0.000333,0.053807,5,807.106228,44.839235,161.421246,62.053748,2,0
0,0,9,9,12,12,24,39,24,63,0.000333,0.096284,12,3466.231651,192.568425,288.852638,86.0391,2,0
0,0,7,7,11,9,20,26,16,42,0.000333,0.060507,5,907.6049,50.422494,181.52098,66.583073,2,0
0,0,11,11,12,14,26,44,30,74,0.000333,0.115944,12,4173.99047,231.888359,347.832539,96.322519,2,0
0,0,6,6,13,9,22,26,16,42,0.000333,0.062432,6,1123.776768,62.432043,187.296128,76.635041,3,0
0,0,9,9,14,13,27,41,26,67,0.000333,0.106192,14,4460.084477,247.782471,318.577463,101.408685,3,0
0,0,7,7,13,10,23,28,18,46,0.000333,0.069361,6,1248.5031,69.361283,208.08385,81.324997,3,0
0,0,11,11,14,15,29,46,32,78,0.000333,0.126308,14,5304.915247,294.717514,378.922518,111.906328,3,0
0,0,6,6,13,9,22,26,16,42,0.000333,0.062432,6,1123.776768,62.432043,187.296128,76.635041,3,0
0,0,9,9,14,13,27,41,26,67,0.000333,0.106192,14,4460.084477,247.782471,318.577463,101.408685,3,0
0,0,7,7,13,10,23,28,18,46,0.000333,0.069361,6,1248.5031,69.361283,208.08385,81.324997,3,0
0,0,11,11,14,15,29,46,32,78,0.000333,0.126308,14,5304.915247,294.717514,378.922518,111.906328,3,0
0,0,6,6,11,8,19,24,14,38,0.000333,0.053807,5,807.106228,44.839235,161.421246,62.053748,2,0
0,0,9,9,12,12,24,39,24,63,0.000333,0.096284,12,3466.231651,192.568425,288.852638,86.0391,2,0
0,0,7,7,11,9,20,26,16,42,0.000333,0.060507,5,907.6049,50.422494,181.52098,66.583073,2,0
0,0,11,11,12,14,26,44,30,74,0.000333,0.115944,12,4173.99047,231.888359,347.832539,96.322519,2,0
0,0,6,6,11,8,19,24,14,38,0.000333,0.053807,5,807.106228,44.839235,161.421246,62.053748,2,0
0,0,9,9,12,12,24,39,24,63,0.000333,0.096284,12,3466.231651,192.568425,288.852638,86.0391,2,0
0,0,7,7,11,9,20,26,16,42,0.000333,0.060507,5,907.6049,50.422494,181.52098,66.583073,2,0
0,0,11,11,12,14,26,44,30,74,0.000333,0.115944,12,4173.99047,231.888359,347.832539,96.322519,2,0
0,0,6,6,13,9,22,26,16,42,0.000333,0.062432,6,1123.776768,62.432043,187.296128,76.635041,3,0
0,0,9,9,14,13,27,41,26,67,0.000333,0.106192,14,4460.084477,247.782471,318.577463,101.408685,3,0
0,0,7,7,13,10,23,28,18,46,0.000333,0.069361,6,1248.5031,69.361283,208.08385,81.324997,3,0
0,0,11,11,14,15,29,46,32,78,0.000333,0.126308,14,5304.915247,294.717514,378.922518,111.906328,3,0
0,0,6,6,13,9,22,26,16,42,0.000333,0.062432,6,1123.776768,62.432043,187.296128,76.635041,3,0
0,0,9,9,14,13,27,41,26,67,0.000333,0.106192,14,4460.084477,247.782471,318.577463,101.408685,3,0
0,0,7,7,13,10,23,28,18,46,0.000333,0.069361,6,1248.5031,69.361283,208.08385,81.324997,3,0
0,0,11,11,14,15,29,46,32,78,0.000333,0.126308,14,5304.915247,294.717514,378.922518,111.906328,3,0
0,0,6,6,11,8,19,24,14,38,0.000333,0.053807,5,807.106228,44.839235,161.421246,62.053748,2,0
0,0,9,9,12,12,24,39,24,63,0.000333,0.096284,12,3466.231651,192.568425,288.852638,86.0391,2,0
0,0,7,7,11,9,20,26,16,42,0.000333,0.060507,5,907.6049,50.422494,181.52098,66.583073,2,0
0,0,11,11,12,14,26,44,30,74,0.000333,0.115944,12,4173.99047,231.888359,347.832539,96.322519,2,0
0,0,6,6,11,8,19,24,14,38,0.000333,0.053807,5,807.106228,44.839235,161.421246,62.053748,2,0
0,0,9,9,12,12,24,39,24,63,0.000333,0.096284,12,3466.231651,192.568425,288.852638,86.0391,2,0
0,0,7,7,11,9,20,26,16,42,0.000333,0.060507,5,907.6049,50.422494,181.52098,66.583073,2,0
0,0,11,11,12,14,26,44,30,74,0.000333,0.115944,12,4173.99047,231.888359,347.832539,96.322519,2,0
0,0,6,6,13,9,22,26,16,42,0.000333,0.062432,6,1123.776768,62.432043,187.296128,76.635041,3,0
0,0,9,9,14,13,27,41,26,67,0.000333,0.106192,14,4460.084477,247.782471,318.577463,101.408685,3,0
0,0,7,7,13,10,23,28,18,46,0.000333,0.069361,6,1248.5031,69.361283,208.08385,81.324997,3,0
0,0,11,11,14,15,29,46,32,78,0.000333,0.126308,14,5304.915247,294.717514,378.922518,111.906328,3,0
0,0,6,6,13,9,22,26,16,42,0.000333,0.062432,6,1123.776768,62.432043,187.296128,76.635041,3,0
0,0,9,9,14,13,27,41,26,67,0.000333,0.106192,14,4460.084477,247.782471,318.577463,101.408685,3,0
0,0,7,7,13,10,23,28,18,46,0.000333,0.069361,6,1248.5031,69.361283,208.08385,81.324997,3,0
0,0,11,11,14,15,29,46,32,78,0.000333,0.126308,14,5304.915247,294.717514,378.922518,111.906328,3,0
0,0,6,6,11,8,19,24,14,38,0.000333,0.053807,5,807.106228,44.839235,161.421246,62.053748,2,0
0,0,9,9,12,12,24,39,24,63,0.000333,0.096284,12,3466.231651,192.568425,288.852638,86.0391,2,0
0,0,7,7,11,9,20,26,16,42,0.000333,0.060507,5,907.6049,50.422494,181.52098,66.583073,2,0
0,0,11,11,12,14,26,44,30,74,0.000333,0.115944,12,4173.99047,231.888359,347.832539,96.322519,2,0
0,0,6,6,11,8,19,24,14,38,0.000333,0.053807,5,807.106228,44.839235,161.421246,62.053748,2,0
0,0,9,9,12,12,24,39,24,63,0.000333,0.096284,12,3466.231651,192.568425,288.852638,86.0391,2,0
0,0,7,7,11,9,20,26,16,42,0.000333,0.060507,5,907.6049,50.422494,181.52098,66.583073,2,0
0,0,11,11,12,14,26,44,30,74,0.000333,0.115944,12,4173.99047,231.888359,347.832539,96.322519,2,0
0,0,6,6,13,9,22,26,16,42,0.000333,0.062432,6,1123.776768,62.432043,187.296128,76.635041,3,0
0,0,9,9,14,13,27,41,26,67,0.000333,0.106192,14,4460.084477,247.782471,318.577463,101.408685,3,0
0,0,7,7,13,10,23,28,18,46,0.000333,0.069361,6,1248.5031,69.361283,208.08385,81.324997,3,0
0,0,11,11,14,15,29,46,32,78,0.000333,0.126308,14,5304.915247,294.717514,378.922518,111.906328,3,0
0,0,6,6,13,9,22,26,16,42,0.000333,0.062432,6,1123.776768,62.432043,187.296128,76.635041,3,0
0,0,9,9,14,13,27,41,26,67,0.000333,0.106192,14,4460.084477,247.782471,318.577463,101.408685,3,0
0,0,7,7,13,10,23,28,18,46,0.000333,0.069361,6,1248.5031,69.361283,208.08385,81.324997,3,0
0,0,11,11,14,15,29,46,32,78,0.000333,0.126308,14,5304.915247,294.717514,378.922518,111.906328,3,0
0,0,6,6,13,9,22,26,16,42,0.000333,0.062432,6,1123.776768,62.432043,187.296128,76.635041,3,0
0,0,9,9,14,13,27,41,26,67,0.000333,0.106192,14,4460.084477,247.782471,318.577463,101.408685,3,0
0,0,7,7,13,10,23,28,18,46,0.000333,0.069361,6,1248.5031,69.361283,208.08385,81.324997,3,0
0,0,11,11,14,15,29,46,32,78,0.000333,0.126308,14,5304.915247,294.717514,378.922518,111.906328,3,0
0,0,6,6,11,8,19,24,14,38,0.000333,0.053807,5,807.106228,44.839235,161.421246,62.053748,2,0
0,0,9,9,12,12,24,39,24,63,0.000333,0.096284,12,3466.231651,192.568425,288.852638,86.0391,2,0
0,0,7,7,11,9,20,26,16,42,0.000333,0.060507,5,907.6049,50.422494,181.52098,66.583073,2,0
0,0,11,11,12,14,26,44,30,74,0.000333,0.115944,12,4173.99047,231.888359,347.832539,96.322519,2,0
0,0,6,6,13,9,22,26,16,42,0.000333,0.062432,6,1123.776768,62.432043,187.296128,76.635041,3,0
0,0,9,9,14,13,27,41,26,67,0.000333,0.106192,14,4460.084477,247.782471,318.577463,101.408685,3,0
0,0,7,7,13,10,23,28,18,46,0.000333,0.069361,6,1248.5031,69.361283,208.08385,81.324997,3,0
0,0,11,11,14,15,29,46,32,78,0.000333,0.126308,14,5304.915247,294.717514,378.922518,111.906328,3,0
0,0,6,6,11,8,19,24,14,38,0.000333,0.053807,5,807.106228,44.839235,161.421246,62.053748,2,0
0,0,9,9,12,12,24,39,24,63,0.000333,0.096284,12,3466.231651,192.568425,288.852638,86.0391,2,0
0,0,7,7,11,9,20,26,16,42,0.000333,0.060507,5,907.6049,50.422494,181.52098,66.583073,2,0
0,0,11,11,12,14,26,44,30,74,0.000333,0.115944,12,4173.99047,231.888359,347.832539,96.322519,2,0
0,0,6,6,11,8,19,24,14,38,0.000333,0.053807,5,807.106228,44.839235,161.421246,62.053748,2,0
0,0,9,9,12,12,24,39,24,63,0.000333,0.096284,12,3466.231651,192.568425,288.852638,86.0391,2,0
0,0,7,7,11,9,20,26,16,42,0.000333,0.060507,5,907.6049,50.422494,181.52098,66.583073,2,0
0,0,11,11,12,14,26,44,30,74,0.000333,0.115944,12,4173.99047,231.888359,347.832539,96.322519,2,0
0,0,6,6,11,8,19,24,14,38,0.000333,0.053807,5,807.106228,44.839235,161.421246,62.053748,2,0
0,0,9,9,12,12,24,39,24,63,0.000333,0.096284,12,3466.231651,192.568425,288.852638,86.0391,2,0
0,0,7,7,11,9,20,26,16,42,0.000333,0.060507,5,907.6049,50.422494,181.52098,66.583073,2,0
0,0,11,11,12,14,26,44,30,74,0.000333,0.115944,12,4173.99047,231.888359,347.832539,96.322519,2,0
0,0,6,6,13,9,22,26,16,42,0.000333,0.062432,6,1123.776768,62.432043,187.296128,76.635041,3,0
0,0,9,9,14,13,27,41,26,67,0.000333,0.106192,14,4460.084477,247.782471,318.577463,101.408685,3,0
0,0,7,7,13,10,23,28,18,46,0.000333,0.069361,6,1248.5031,69.361283,208.08385,81.324997,3,0
0,0,11,11,14,15,29,46,32,78,0.000333,0.126308,14,5304.915247,294.717514,378.922518,111.906328,3,0
0,0,6,6,13,9,22,26,16,42,0.000333,0.062432,6,1123.776768,62.432043,187.296128,76.635041,3,0
0,0,9,9,14,13,27,41,26,67,0.000333,0.106192,14,4460.084477,247.782471,318.577463,101.408685,3,0
0,0,7,7,13,10,23,28,18,46,0.000333,0.069361,6,1248.5031,69.361283,208.08385,81.324997,3,0
0,0,11,11,14,15,29,46,32,78,0.000333,0.126308,14,5304.915247,294.717514,378.922518,111.906328,3,0
0,0,6,6,13,9,22,26,16,42,0.000333,0.062432,6,1123.776768,62.432043,187.296128,76.635041,3,0
0,0,9,9,14,13,27,41,26,67,0.000333,0.106192,14,4460.084477,247.782471,318.577463,101.408685,3,0
0,0,7,7,13,10,23,28,18,46,0.000333,0.069361,6,1248.5031,69.361283,208.08385,81.324997,3,0
0,0,11,11,14,15,29,46,32,78,0.000333,0.126308,14,5304.915247,294.717514,378.922518,111.906328,3,0
0,0,6,6,11,8,19,24,14,38,0.000333,0.053807,5,807.106228,44.839235,161.421246,62.053748,2,0
0,0,9,9,12,12,24,39,24,63,0.000333,0.096284,12,3466.231651,192.568425,288.852638,86.0391,2,0
0,0,7,7,11,9,20,26,16,42,0.000333,0.060507,5,907.6049,50.422494,181.52098,66.583073,2,0
0,0,11,11,12,14,26,44,30,74,0.000333,0.115944,12,4173.99047,231.888359,347.832539,96.322519,2,0
0,0,6,6,13,9,22,26,16,42,0.000333,0.062432,6,1123.776768,62.432043,187.296128,76.635041,3,0
0,0,9,9,14,13,27,41,26,67,0.000333,0.106192,14,4460.084477,247.782471,318.577463,101.408685,3,0
0,0,7,7,13,10,23,28,18,46,0.000333,0.069361,6,1248.5031,69.361283,208.08385,81.324997,3,0
0,0,11,11,14,15,29,46,32,78,0.000333,0.126308,14,5304.915247,294.717514,378.922518,111.906328,3,0
0,0,6,6,11,8,19,24,14,38,0.000333,0.053807,5,807.106228,44.839235,161.421246,62.053748,2,0
0,0,9,9,12,12,24,39,24,63,0.000333,0.096284,12,3466.231651,192.568425,288.852638,86.0391,2,0
0,0,7,7,11,9,20,26,16,42,0.000333,0.060507,5,907.6049,50.422494,181.52098,66.583073,2,0
0,0,11,11,12,14,26,44,30,74,0.000333,0.115944,12,4173.99047,231.888359,347.832539,96.322519,2,0
0,0,6,6,11,8,19,24,14,38,0.000333,0.053807,5,807.106228,44.839235,161.421246,62.053748,2,0
0,0,9,9,12,12,24,39,24,63,0.000333,0.096284,12,3466.231651,192.568425,288.852638,86.0391,2,0
0,0,7,7,11,9,20,26,16,42,0.000333,0.060507,5,907.6049,50.422494,181.52098,66.583073,2,0
0,0,11,11,12,14,26,44,30,74,0.000333,0.115944,12,4173.99047,231.888359,347.832539,96.322519,2,0
0,0,6,6,11,8,19,24,14,38,0.000333,0.053807,5,807.106228,44.839235,161.421246,62.053748,2,0
0,0,9,9,12,12,24,39,24,63,0.000333,0.096284,12,3466.231651,192.568425,288.852638,86.0391,2,0
0,0,7,7,11,9,20,26,16,42,0.000333,0.060507,5,907.6049,50.422494,181.52098,66.583073,2,0
0,0,11,11,12,14,26,44,30,74,0.000333,0.115944,12,4173.99047,231.888359,347.832539,96.322519,2,0
0,0,6,6,13,9,22,26,16,42,0.000333,0.062432,6,1123.776768,62.432043,187.296128,76.635041,3,0
0,0,9,9,14,13,27,41,26,67,0.000333,0.106192,14,4460.084477,247.782471,318.577463,101.408685,3,0
0,0,7,7,13,10,23,28,18,46,0.000333,0.069361,6,1248.5031,69.361283,208.08385,81.324997,3,0
0,0,11,11,14,15,29,46,32,78,0.000333,0.126308,14,5304.915247,294.717514,378.922518,111.906328,3,0
0,0,6,6,13,9,22,26,16,42,0.000333,0.062432,6,1123.776768,62.432043,187.296128,76.635041,3,0
0,0,9,9,14,13,27,41,26,67,0.000333,0.106192,14,4460.084477,247.782471,318.577463,101.408685,3,0
0,0,7,7,13,10,23,28,18,46,0.000333,0.069361,6,1248.5031,69.361283,208.08385,81.324997,3,0
0,0,11,11,14,15,29,46,32,78,0.000333,0.126308,14,5304.915247,294.717514,378.922518,111.906328,3,0
0,0,6,6,11,8,19,24,14,38,0.000333,0.053807,5,807.106228,44.839235,161.421246,62.053748,2,0
0,0,9,9,12,12,24,39,24,63,0.000333,0.096284,12,3466.231651,192.568425,288.852638,86.0391,2,0
0,0,7,7,11,9,20,26,16,42,0.000333,0.060507,5,907.6049,50.422494,181.52098,66.583073,2,0
0,0,11,11,12,14,26,44,30,74,0.000333,0.115944,12,4173.99047,231.888359,347.832539,96.322519,2,0
0,0,6,6,11,8,19,24,14,38,0.000333,0.053807,5,807.106228,44.839235,161.421246,62.053748,2,0
0,0,9,9,12,12,24,39,24,63,0.000333,0.096284,12,3466.231651,192.568425,288.852638,86.0391,2,0
0,0,7,7,11,9,20,26,16,42,0.000333,0.060507,5,907.6049,50.422494,181.52098,66.583073,2,0
0,0,11,11,12,14,26,44,30,74,0.000333,0.115944,12,4173.99047,231.888359,347.832539,96.322519,2,0
0,0,6,6,13,9,22,26,16,42,0.000333,0.062432,6,1123.776768,62.432043,187.296128,76.635041,3,0
0,0,9,9,14,13,27,41,26,67,0.000333,0.106192,14,4460.084477,247.782471,318.577463,101.408685,3,0
0,0,7,7,13,10,23,28,18,46,0.000333,0.069361,6,1248.5031,69.361283,208.08385,81.324997,3,0
0,0,11,11,14,15,29,46,32,78,0.000333,0.126308,14,5304.915247,294.717514,378.922518,111.906328,3,0
0,0,6,6,13,9,22,26,16,42,0.000333,0.062432,6,1123.776768,62.432043,187.296128,76.635041,3,0
0,0,9,9,14,13,27,41,26,67,0.000333,0.106192,14,4460.084477,247.782471,318.577463,101.408685,3,0
0,0,7,7,13,10,23,28,18,46,0.000333,0.069361,6,1248.5031,69.361283,208.08385,81.324997,3,0
0,0,11,11,14,15,29,46,32,78,0.000333,0.126308,14,5304.915247,294.717514,378.922518,111.906328,3,0
0,0,6,6,13,9,22,26,16,42,0.000333,0.062432,6,1123.776768,62.432043,187.296128,76.635041,3,0
0,0,9,9,14,13,27,41,26,67,0.000333,0.106192,14,4460.084477,247.782471,318.577463,101.408685,3,0
0,0,7,7,13,10,23,28,18,46,0.000333,0.069361,6,1248.5031,69.361283,208.08385,81.324997,3,0
0,0,11,11,14,15,29,46,32,78,0.000333,0.126308,14,5304.915247,294.717514,378.922518,111.906328,3,0
0,0,6,6,11,8,19,24,14,38,0.000333,0.053807,5,807.106228,44.839235,161.421246,62.053748,2,0
0,0,9,9,12,12,24,39,24,63,0.000333,0.096284,12,3466.231651,192.568425,288.852638,86.0391,2,0
0,0,7,7,11,9,20,26,16,42,0.000333,0.060507,5,907.6049,50.422494,181.52098,66.583073,2,0
0,0,11,11,12,14,26,44,30,74,0.000333,0.115944,12,4173.99047,231.888359,347.832539,96.322519,2,0
0,0,6,6,11,8,19,24,14,38,0.000333,0.053807,5,807.106228,44.839235,161.421246,62.053748,2,0
0,0,9,9,12,12,24,39,24,63,0.000333,0.096284,12,3466.231651,192.568425,288.852638,86.0391,2,0
0,0,7,7,11,9,20,26,16,42,0.000333,0.060507,5,907.6049,50.422494,181.52098,66.583073,2,0
0,0,11,11,12,14,26,44,30,74,0.000333,0.115944,12,4173.99047,231.888359,347.832539,96.322519,2,0
0,0,6,6,13,9,22,26,16,42,0.000333,0.062432,6,1123.776768,62.432043,187.296128,76.635041,3,0
0,0,9,9,14,13,27,41,26,67,0.000333,0.106192,14,4460.084477,247.782471,318.577463,101.408685,3,0
0,0,7,7,13,10,23,28,18,46,0.000333,0.069361,6,1248.5031,69.361283,208.08385,81.324997,3,0
0,0,11,11,14,15,29,46,32,78,0.000333,0.126308,14,5304.915247,294.717514,378.922518,111.906328,3,0
0,0,6,6,11,8,19,24,14,38,0.000333,0.053807,5,807.106228,44.839235,161.421246,62.053748,2,0
0,0,9,9,12,12,24,39,24,63,0.000333,0.096284,12,3466.231651,192.568425,288.852638,86.0391,2,0
0,0,7,7,11,9,20,26,16,42,0.000333,0.060507,5,907.6049,50.422494,181.52098,66.583073,2,0
0,0,11,11,12,14,26,44,30,74,0.000333,0.115944,12,4173.99047,231.888359,347.832539,96.322519,2,0
0,0,6,6,13,9,22,26,16,42,0.000333,0.062432,6,1123.776768,62.432043,187.296128,76.635041,3,0
0,0,9,9,14,13,27,41,26,67,0.000333,0.106192,14,4460.084477,247.782471,318.577463,101.408685,3,0
0,0,7,7,13,10,23,28,18,46,0.000333,0.069361,6,1248.5031,69.361283,208.08385,81.324997,3,0
0,0,11,11,14,15,29,46,32,78,0.000333,0.126308,14,5304.915247,294.717514,378.922518,111.906328,3,0
0,0,6,6,13,9,22,26,16,42,0.000333,0.062432,6,1123.776768,62.432043,187.296128,76.635041,3,0
0,0,9,9,14,13,27,41,26,67,0.000333,0.106192,14,4460.084477,247.782471,318.577463,101.408685,3,0
0,0,7,7,13,10,23,28,18,46,0.000333,0.069361,6,1248.5031,69.361283,208.08385,81.324997,3,0
0,0,11,11,14,15,29,46,32,78,0.000333,0.126308,14,5304.915247,294.717514,378.922518,111.906328,3,0
0,0,6,6,13,9,22,26,16,42,0.000333,0.062432,6,1123.776768,62.432043,187.296128,76.635041,3,0
0,0,9,9,14,13,27,41,26,67,0.000333,0.106192,14,4460.084477,247.782471,318.577463,101.408685,3,0
0,0,7,7,13,10,23,29,18,47,0.000333,0.070869,6,1275.644472,70.869137,212.607412,81.324997,3,0
0,0,11,11,14,15,29,46,32,78,0.000333,0.126308,14,5304.915247,294.717514,378.922518,111.906328,3,0
0,0,6,6,11,8,19,24,14,38,0.000333,0.053807,5,807.106228,44.839235,161.421246,62.053748,2,0
0,0,9,9,12,12,24,39,24,63,0.000333,0.096284,12,3466.231651,192.568425,288.852638,86.0391,2,0
0,0,7,7,11,9,20,26,16,42,0.000333,0.060507,5,907.6049,50.422494,181.52098,66.583073,2,0
0,0,11,11,12,14,26,44,30,74,0.000333,0.115944,12,4173.99047,231.888359,347.832539,96.322519,2,0
0,0,6,6,11,8,19,24,14,38,0.000333,0.053807,5,807.106228,44.839235,161.421246,62.053748,2,0
0,0,9,9,12,12,24,39,24,63,0.000333,0.096284,12,3466.231651,192.568425,288.852638,86.0391,2,0
0,0,7,7,11,9,20,26,16,42,0.000333,0.060507,5,907.6049,50.422494,181.52098,66.583073,2,0
0,0,11,11,12,14,26,44,30,74,0.000333,0.115944,12,4173.99047,231.888359,347.832539,96.322519,2,0
0,0,6,6,13,9,22,26,16,42,0.000333,0.062432,6,1123.776768,62.432043,187.296128,76.635041,3,0
0,0,9,9,14,13,27,41,26,67,0.000333,0.106192,14,4460.084477,247.782471,318.577463,101.408685,3,0
0,0,7,7,13,10,23,28,18,46,0.000333,0.069361,6,1248.5031,69.361283,208.08385,81.324997,3,0
0,0,11,11,14,15,29,46,32,78,0.000333,0.126308,14,5304.915247,294.717514,378.922518,111.906328,3,0
0,0,6,6,11,8,19,24,14,38,0.000333,0.053807,5,807.106228,44.839235,161.421246,62.053748,2,0
0,0,9,9,12,12,24,39,24,63,0.000333,0.096284,12,3466.231651,192.568425,288.852638,86.0391,2,0
0,0,7,7,11,9,20,26,16,42,0.000333,0.060507,5,907.6049,50.422494,181.52098,66.583073,2,0
0,0,11,11,12,14,26,44,30,74,0.000333,0.115944,12,4173.99047,231.888359,347.832539,96.322519,2,0
0,0,6,6,13,9,22,26,16,42,0.000333,0.062432,6,1123.776768,62.432043,187.296128,76.635041,3,0
0,0,9,9,14,13,27,41,26,67,0.000333,0.106192,14,4460.084477,247.782471,318.577463,101.408685,3,0
0,0,7,7,13,10,23,28,18,46,0.000333,0.069361,6,1248.5031,69.361283,208.08385,81.324997,3,0
0,0,11,11,14,15,29,46,32,78,0.000333,0.126308,14,5304.915247,294.717514,378.922518,111.906328,3,0
0,0,6,6,13,9,22,26,16,42,0.000333,0.062432,6,1123.776768,62.432043,187.296128,76.635041,3,0
0,0,9,9,14,13,27,41,26,67,0.000333,0.106192,14,4460.084477,247.782471,318.577463,101.408685,3,0
0,0,7,7,13,10,23,28,18,46,0.000333,0.069361,6,1248.5031,69.361283,208.08385,81.324997,3,0
0,0,11,11,14,15,29,46,32,78,0.000333,0.126308,14,5304.915247,294.717514,378.922518,111.906328,3,0
0,0,6,6,11,8,19,24,14,38,0.000333,0.053807,5,807.106228,44.839235,161.421246,62.053748,2,0
0,0,9,9,12,12,24,39,24,63,0.000333,0.096284,12,3466.231651,192.568425,288.852638,86.0391,2,0
0,0,7,7,11,9,20,26,16,42,0.000333,0.060507,5,907.6049,50.422494,181.52098,66.583073,2,0
0,0,11,11,12,14,26,44,30,74,0.000333,0.115944,12,4173.99047,231.888359,347.832539,96.322519,2,0
0,0,6,6,11,8,19,24,14,38,0.000333,0.053807,5,807.106228,44.839235,161.421246,62.053748,2,0
0,0,9,9,12,12,24,39,24,63,0.000333,0.096284,12,3466.231651,192.568425,288.852638,86.0391,2,0
0,0,7,7,11,9,20,26,16,42,0.000333,0.060507,5,907.6049,50.422494,181.52098,66.583073,2,0
0,0,11,11,12,14,26,44,30,74,0.000333,0.115944,12,4173.99047,231.888359,347.832539,96.322519,2,0
0,0,6,6,13,9,22,26,16,42,0.000333,0.062432,6,1123.776768,62.432043,187.296128,76.635041,3,0
0,0,9,9,14,13,27,41,26,67,0.000333,0.106192,14,4460.084477,247.782471,318.577463,101.408685,3,0
0,0,7,7,13,10,23,28,18,46,0.000333,0.069361,6,1248.5031,69.361283,208.08385,81.324997,3,0
0,0,11,11,14,15,29,46,32,78,0.000333,0.126308,14,5304.915247,294.717514,378.922518,111.906328,3,0
0,0,6,6,13,9,22,26,16,42,0.000333,0.062432,6,1123.776768,62.432043,187.296128,76.635041,3,0
0,0,9,9,14,13,27,41,26,67,0.000333,0.106192,14,4460.084477,247.782471,318.577463,101.408685,3,0
0,0,7,7,13,10,23,28,18,46,0.000333,0.069361,6,1248.5031,69.361283,208.08385,81.324997,3,0
0,0,11,11,14,15,29,46,32,78,0.000333,0.126308,14,5304.915247,294.717514,378.922518,111.906328,3,0
0,0,6,6,13,9,22,26,16,42,0.000333,0.062432,6,1123.776768,62.432043,187.296128,76.635041,3,0
0,0,9,9,14,13,27,41,26,67,0.000333,0.106192,14,4460.084477,247.782471,318.577463,101.408685,3,0
0,0,7,7,13,10,23,28,18,46,0.000333,0.069361,6,1248.5031,69.361283,208.08385,81.324997,3,0
0,0,11,11,14,15,29,46,32,78,0.000333,0.126308,14,5304.915247,294.717514,378.922518,111.906328,3,0
0,0,6,6,11,8,19,24,14,38,0.000333,0.053807,5,807.106228,44.839235,161.421246,62.053748,2,0
0,0,9,9,12,12,24,39,24,63,0.000333,0.096284,12,3466.231651,192.568425,288.852638,86.0391,2,0
0,0,7,7,11,9,20,26,16,42,0.000333,0.060507,5,907.6049,50.422494,181.52098,66.583073,2,0
0,0,11,11,12,14,26,44,30,74,0.000333,0.115944,12,4173.99047,231.888359,347.832539,96.322519,2,0
0,0,6,6,11,8,19,24,14,38,0.000333,0.053807,5,807.106228,44.839235,161.421246,62.053748,2,0
0,0,9,9,12,12,24,39,24,63,0.000333,0.096284,12,3466.231651,192.568425,288.852638,86.0391,2,0
0,0,7,7,11,9,20,26,16,42,0.000333,0.060507,5,907.6049,50.422494,181.52098,66.583073,2,0
0,0,11,11,12,14,26,44,30,74,0.000333,0.115944,12,4173.99047,231.888359,347.832539,96.322519,2,0
0,0,6,6,13,9,22,26,16,42,0.000333,0.062432,6,1123.776768,62.432043,187.296128,76.635041,3,0
0,0,9,9,14,13,27,41,26,67,0.000333,0.106192,14,4460.084477,247.782471,318.577463,101.408685,3,0
0,0,7,7,13,10,23,28,18,46,0.000333,0.069361,6,1248.5031,69.361283,208.08385,81.324997,3,0
0,0,11,11,14,15,29,46,32,78,0.000333,0.126308,14,5304.915247,294.717514,378.922518,111.906328,3,0
0,0,6,6,11,8,19,24,14,38,0.000333,0.053807,5,807.106228,44.839235,161.421246,62.053748,2,0
0,0,9,9,12,12,24,39,24,63,0.000333,0.096284,12,3466.231651,192.568425,288.852638,86.0391,2,0
0,0,7,7,11,9,20,26,16,42,0.000333,0.060507,5,907.6049,50.422494,181.52098,66.583073,2,0
0,0,11,11,12,14,26,44,30,74,0.000333,0.115944,12,4173.99047,231.888359,347.832539,96.322519,2,0
0,0,6,6,11,8,19,24,14,38,0.000333,0.053807,5,807.106228,44.839235,161.421246,62.053748,2,0
0,0,9,9,12,12,24,39,24,63,0.000333,0.096284,12,3466.231651,192.568425,288.852638,86.0391,2,0
0,0,7,7,11,9,20,26,16,42,0.000333,0.060507,5,907.6049,50.422494,181.52098,66.583073,2,0
0,0,11,11,12,14,26,44,30,74,0.000333,0.115944,12,4173.99047,231.888359,347.832539,96.322519,2,0
0,0,6,6,13,9,22,26,16,42,0.000333,0.062432,6,1123.776768,62.432043,187.296128,76.635041,3,0
0,0,9,9,14,13,27,41,26,67,0.000333,0.106192,14,4460.084477,247.782471,318.577463,101.408685,3,0
0,0,7,7,13,10,23,28,18,46,0.000333,0.069361,6,1248.5031,69.361283,208.08385,81.324997,3,0
0,0,11,11,14,15,29,46,32,78,0.000333,0.126308,14,5304.915247,294.717514,378.922518,111.906328,3,0
0,0,6,6,13,9,22,26,16,42,0.000333,0.062432,6,1123.776768,62.432043,187.296128,76.635041,3,0
0,0,9,9,14,13,27,41,26,67,0.000333,0.106192,14,4460.084477,247.782471,318.577463,101.408685,3,0
0,0,7,7,13,10,23,28,18,46,0.000333,0.069361,6,1248.5031,69.361283,208.08385,81.324997,3,0
0,0,11,11,14,15,29,46,32,78,0.000333,0.126308,14,5304.915247,294.717514,378.922518,111.906328,3,0
0,0,6,6,13,9,22,26,16,42,0.000333,0.062432,6,1123.776768,62.432043,187.296128,76.635041,3,0
0,0,9,9,14,13,27,41,26,67,0.000333,0.106192,14,4460.084477,247.782471,318.577463,101.408685,3,0
0,0,7,7,13,10,23,29,18,47,0.000333,0.070869,6,1275.644472,70.869137,212.607412,81.324997,3,0
0,0,11,11,14,15,29,46,32,78,0.000333,0.126308,14,5304.915247,294.717514,378.922518,111.906328,3,0
0,0,6,6,11,8,19,24,14,38,0.000333,0.053807,5,807.106228,44.839235,161.421246,62.053748,2,0
0,0,9,9,12,12,24,39,24,63,0.000333,0.096284,12,3466.231651,192.568425,288.852638,86.0391,2,0
0,0,7,7,11,9,20,26,16,42,0.000333,0.060507,5,907.6049,50.422494,181.52098,66.583073,2,0
0,0,11,11,12,14,26,44,30,74,0.000333,0.115944,12,4173.99047,231.888359,347.832539,96.322519,2,0
0,0,6,6,11,8,19,24,14,38,0.000333,0.053807,5,807.106228,44.839235,161.421246,62.053748,2,0
0,0,9,9,12,12,24,39,24,63,0.000333,0.096284,12,3466.231651,192.568425,288.852638,86.0391,2,0
0,0,7,7,11,9,20,26,16,42,0.000333,0.060507,5,907.6049,50.422494,181.52098,66.583073,2,0
0,0,11,11,12,14,26,44,30,74,0.000333,0.115944,12,4173.99047,231.888359,347.832539,96.322519,2,0
0,0,6,6,13,9,22,26,16,42,0.000333,0.062432,6,1123.776768,62.432043,187.296128,76.635041,3,0
0,0,9,9,14,13,27,41,26,67,0.000333,0.106192,14,4460.084477,247.782471,318.577463,101.408685,3,0
0,0,7,7,13,10,23,28,18,46,0.000333,0.069361,6,1248.5031,69.361283,208.08385,81.324997,3,0
0,0,11,11,14,15,29,46,32,78,0.000333,0.126308,14,5304.915247,294.717514,378.922518,111.906328,3,0
0,0,6,6,13,9,22,26,16,42,0.000333,0.062432,6,1123.776768,62.432043,187.296128,76.635041,3,0
0,0,9,9,14,13,27,41,26,67,0.000333,0.106192,14,4460.084477,247.782471,318.577463,101.408685,3,0
0,0,7,7,13,10,23,28,18,46,0.000333,0.069361,6,1248.5031,69.361283,208.08385,81.324997,3,0
0,0,11,11,14,15,29,46,32,78,0.000333,0.126308,14,5304.915247,294.717514,378.922518,111.906328,3,0
0,0,6,6,11,8,19,24,14,38,0.000333,0.053807,5,807.106228,44.839235,161.421246,62.053748,2,0
0,0,9,9,12,12,24,39,24,63,0.000333,0.096284,12,3466.231651,192.568425,288.852638,86.0391,2,0
0,0,7,7,11,9,20,26,16,42,0.000333,0.060507,5,907.6049,50.422494,181.52098,66.583073,2,0
0,0,11,11,12,14,26,44,30,74,0.000333,0.115944,12,4173.99047,231.888359,347.832539,96.322519,2,0
0,0,6,6,11,8,19,24,14,38,0.000333,0.053807,5,807.106228,44.839235,161.421246,62.053748,2,0
0,0,9,9,12,12,24,39,24,63,0.000333,0.096284,12,3466.231651,192.568425,288.852638,86.0391,2,0
0,0,7,7,11,9,20,26,16,42,0.000333,0.060507,5,907.6049,50.422494,181.52098,66.583073,2,0
0,0,11,11,12,14,26,44,30,74,0.000333,0.115944,12,4173.99047,231.888359,347.832539,96.322519,2,0
0,0,6,6,13,9,22,26,16,42,0.000333,0.062432,6,1123.776768,62.432043,187.296128,76.635041,3,0
0,0,9,9,14,13,27,41,26,67,0.000333,0.106192,14,4460.084477,247.782471,318.577463,101.408685,3,0
0,0,7,7,13,10,23,28,18,46,0.000333,0.069361,6,1248.5031,69.361283,208.08385,81.324997,3,0
0,0,11,11,14,15,29,46,32,78,0.000333,0.126308,14,5304.915247,294.717514,378.922518,111.906328,3,0
0,0,6,6,11,8,19,24,14,38,0.000333,0.053807,5,807.106228,44.839235,161.421246,62.053748,2,0
0,0,9,9,12,12,24,39,24,63,0.000333,0.096284,12,3466.231651,192.568425,288.852638,86.0391,2,0
0,0,7,7,11,9,20,26,16,42,0.000333,0.060507,5,907.6049,50.422494,181.52098,66.583073,2,0
0,0,11,11,12,14,26,44,30,74,0.000333,0.115944,12,4173.99047,231.888359,347.832539,96.322519,2,0
0,0,6,6,13,9,22,26,16,42,0.000333,0.062432,6,1123.776768,62.432043,187.296128,76.635041,3,0
0,0,9,9,14,13,27,41,26,67,0.000333,0.106192,14,4460.084477,247.782471,318.577463,101.408685,3,0
0,0,7,7,13,10,23,28,18,46,0.000333,0.069361,6,1248.5031,69.361283,208.08385,81.324997,3,0
0,0,11,11,14,15,29,46,32,78,0.000333,0.126308,14,5304.915247,294.717514,378.922518,111.906328,3,0
0,0,6,6,13,9,22,26,16,42,0.000333,0.062432,6,1123.776768,62.432043,187.296128,76.635041,3,0
0,0,9,9,14,13,27,41,26,67,0.000333,0.106192,14,4460.084477,247.782471,318.577463,101.408685,3,0
0,0,7,7,13,10,23,28,18,46,0.000333,0.069361,6,1248.5031,69.361283,208.08385,81.324997,3,0
0,0,11,11,14,15,29,46,32,78,0.000333,0.126308,14,5304.915247,294.717514,378.922518,111.906328,3,0
0,0,6,6,11,8,19,24,14,38,0.000333,0.053807,5,807.106228,44.839235,161.421246,62.053748,2,0
0,0,9,9,12,12,24,39,24,63,0.000333,0.096284,12,3466.231651,192.568425,288.852638,86.0391,2,0
0,0,7,7,11,9,20,26,16,42,0.000333,0.060507,5,907.6049,50.422494,181.52098,66.583073,2,0
0,0,11,11,12,14,26,44,30,74,0.000333,0.115944,12,4173.99047,231.888359,347.832539,96.322519,2,0
0,0,6,6,11,8,19,24,14,38,0.000333,0.053807,5,807.106228,44.839235,161.421246,62.053748,2,0
0,0,9,9,12,12,24,39,24,63,0.000333,0.096284,12,3466.231651,192.568425,288.852638,86.0391,2,0
0,0,7,7,11,9,20,26,16,42,0.000333,0.060507,5,907.6049,50.422494,181.52098,66.583073,2,0
0,0,11,11,12,14,26,44,30,74,0.000333,0.115944,12,4173.99047,231.888359,347.832539,96.322519,2,0
0,0,6,6,13,9,22,26,16,42,0.000333,0.062432,6,1123.776768,62.432043,187.296128,76.635041,3,0
0,0,9,9,14,13,27,41,26,67,0.000333,0.106192,14,4460.084477,247.782471,318.577463,101.408685,3,0
0,0,7,7,13,10,23,29,18,47,0.000333,0.070869,6,1275.644472,70.869137,212.607412,81.324997,3,0
0,0,11,11,14,15,29,46,32,78,0.000333,0.126308,14,5304.915247,294.717514,378.922518,111.906328,3,0
0,0,6,6,11,8,19,24,14,38,0.000333,0.053807,5,807.106228,44.839235,161.421246,62.053748,2,0
0,0,9,9,12,12,24,39,24,63,0.000333,0.096284,12,3466.231651,192.568425,288.852638,86.0391,2,0
0,0,7,7,11,9,20,26,16,42,0.000333,0.060507,5,907.6049,50.422494,181.52098,66.583073,2,0
0,0,11,11,12,14,26,44,30,74,0.000333,0.115944,12,4173.99047,231.888359,347.832539,96.322519,2,0
0,0,6,6,13,9,22,26,16,42,0.000333,0.062432,6,1123.776768,62.432043,187.296128,76.635041,3,0
0,0,9,9,14,13,27,41,26,67,0.000333,0.106192,14,4460.084477,247.782471,318.577463,101.408685,3,0
0,0,7,7,13,10,23,28,18,46,0.000333,0.069361,6,1248.5031,69.361283,208.08385,81.324997,3,0
0,0,11,11,14,15,29,46,32,78,0.000333,0.126308,14,5304.915247,294.717514,378.922518,111.906328,3,0
0,0,6,6,11,8,19,24,14,38,0.000333,0.053807,5,807.106228,44.839235,161.421246,62.053748,2,0
0,0,9,9,12,12,24,39,24,63,0.000333,0.096284,12,3466.231651,192.568425,288.852638,86.0391,2,0
0,0,7,7,11,9,20,26,16,42,0.000333,0.060507,5,907.6049,50.422494,181.52098,66.583073,2,0
0,0,11,11,12,14,26,44,30,74,0.000333,0.115944,12,4173.99047,231.888359,347.832539,96.322519,2,0
0,0,6,6,13,9,22,26,16,42,0.000333,0.062432,6,1123.776768,62.432043,187.296128,76.635041,3,0
0,0,9,9,14,13,27,41,26,67,0.000333,0.106192,14,4460.084477,247.782471,318.577463,101.408685,3,0
0,0,7,7,13,10,23,28,18,46,0.000333,0.069361,6,1248.5031,69.361283,208.08385,81.324997,3,0
0,0,11,11,14,15,29,46,32,78,0.000333,0.126308,14,5304.915247,294.717514,378.922518,111.906328,3,0
0,0,6,6,13,9,22,26,16,42,0.000333,0.062432,6,1123.776768,62.432043,187.296128,76.635041,3,0
0,0,9,9,14,13,27,41,26,67,0.000333,0.106192,14,4460.084477,247.782471,318.577463,101.408685,3,0
0,0,7,7,13,10,23,28,18,46,0.000333,0.069361,6,1248.5031,69.361283,208.08385,81.324997,3,0
0,0,11,11,14,15,29,46,32,78,0.000333,0.126308,14,5304.915247,294.717514,378.922518,111.906328,3,0
0,0,6,6,11,8,19,24,14,38,0.000333,0.053807,5,807.106228,44.839235,161.421246,62.053748,2,0
0,0,9,9,12,12,24,39,24,63,0.000333,0.096284,12,3466.231651,192.568425,288.852638,86.0391,2,0
0,0,7,7,11,9,20,26,16,42,0.000333,0.060507,5,907.6049,50.422494,181.52098,66.583073,2,0
0,0,11,11,12,14,26,44,30,74,0.000333,0.115944,12,4173.99047,231.888359,347.832539,96.322519,2,0
0,0,6,6,13,9,22,26,16,42,0.000333,0.062432,6,1123.776768,62.432043,187.296128,76.635041,3,0
0,0,9,9,14,13,27,41,26,67,0.000333,0.106192,14,4460.084477,247.782471,318.577463,101.408685,3,0
0,0,7,7,13,10,23,28,18,46,0.000333,0.069361,6,1248.5031,69.361283,208.08385,81.324997,3,0
0,0,11,11,14,15,29,46,32,78,0.000333,0.126308,14,5304.915247,294.717514,378.922518,111.906328,3,0
0,0,6,6,11,8,19,24,14,38,0.000333,0.053807,5,807.106228,44.839235,161.421246,62.053748,2,0
0,0,9,9,12,12,24,39,24,63,0.000333,0.096284,12,3466.231651,192.568425,288.852638,86.0391,2,0
0,0,7,7,11,9,20,26,16,42,0.000333,0.060507,5,907.6049,50.422494,181.52098,66.583073,2,0
0,0,11,11,12,14,26,44,30,74,0.000333,0.115944,12,4173.99047,231.888359,347.832539,96.322519,2,0
0,0,6,6,13,9,22,26,16,42,0.000333,0.062432,6,1123.776768,62.432043,187.296128,76.635041,3,0
0,0,9,9,14,13,27,41,26,67,0.000333,0.106192,14,4460.084477,247.782471,318.577463,101.408685,3,0
0,0,7,7,13,10,23,28,18,46,0.000333,0.069361,6,1248.5031,69.361283,208.08385,81.324997,3,0
0,0,11,11,14,15,29,46,32,78,0.000333,0.126308,14,5304.915247,294.717514,378.922518,111.906328,3,0
0,0,6,6,11,8,19,24,14,38,0.000333,0.053807,5,807.106228,44.839235,161.421246,62.053748,2,0
0,0,9,9,12,12,24,39,24,63,0.000333,0.096284,12,3466.231651,192.568425,288.852638,86.0391,2,0
0,0,7,7,11,9,20,26,16,42,0.000333,0.060507,5,907.6049,50.422494,181.52098,66.583073,2,0
0,0,11,11,12,14,26,44,30,74,0.000333,0.115944,12,4173.99047,231.888359,347.832539,96.322519,2,0
0,0,8,8,14,14,28,32,26,58,0.000333,0.092942,7,1951.786098,108.432561,278.826585,106.605938,3,0
0,0,9,9,15,15,30,42,32,74,0.000333,0.121037,14,5083.538657,282.418814,363.109904,117.206718,3,0
0,0,9,9,14,15,29,34,28,62,0.000333,0.100398,7,2108.363752,117.13132,301.194822,111.906328,3,0
0,0,11,11,15,17,32,45,36,81,0.000333,0.135,14,5670,315,405,128.090227,3,0
0,0,8,8,14,14,28,32,26,58,0.000333,0.092942,7,1951.786098,108.432561,278.826585,106.605938,3,0
0,0,9,9,15,15,30,42,32,74,0.000333,0.121037,14,5083.538657,282.418814,363.109904,117.206718,3,0
0,0,9,9,14,15,29,34,28,62,0.000333,0.100398,7,2108.363752,117.13132,301.194822,111.906328,3,0
0,0,11,11,15,17,32,45,36,81,0.000333,0.135,14,5670,315,405,128.090227,3,0
0,0,8,8,12,12,24,30,22,52,0.000333,0.079473,6,1430.5083,79.472683,238.41805,86.0391,2,0
0,0,9,9,13,15,28,40,28,68,0.000333,0.108967,6,1961.400808,108.966712,326.900135,106.709075,2,0
0,0,9,9,12,13,25,32,24,56,0.000333,0.086685,6,1560.33568,86.685316,260.055947,91.125266,2,0
0,0,11,11,13,15,28,43,32,75,0.000333,0.120184,12,4326.61943,240.367746,360.551619,106.709075,2,0
0,0,8,8,14,14,28,32,26,58,0.000333,0.092942,7,1951.786098,108.432561,278.826585,106.605938,3,0
0,0,9,9,15,15,30,42,32,74,0.000333,0.121037,14,5083.538657,282.418814,363.109904,117.206718,3,0
0,0,9,9,14,15,29,34,28,62,0.000333,0.100398,7,2108.363752,117.13132,301.194822,111.906328,3,0
0,0,11,11,15,17,32,45,36,81,0.000333,0.135,14,5670,315,405,128.090227,3,0
0,0,8,8,14,14,28,32,26,58,0.000333,0.092942,7,1951.786098,108.432561,278.826585,106.605938,3,0
0,0,9,9,15,15,30,42,32,74,0.000333,0.121037,14,5083.538657,282.418814,363.109904,117.206718,3,0
0,0,9,9,14,15,29,34,28,62,0.000333,0.100398,7,2108.363752,117.13132,301.194822,111.906328,3,0
0,0,11,11,15,17,32,45,36,81,0.000333,0.135,14,5670,315,405,128.090227,3,0
0,0,8,8,12,12,24,30,22,52,0.000333,0.079473,6,1430.5083,79.472683,238.41805,86.0391,2,0
0,0,9,9,13,13,26,40,27,67,0.000333,0.104976,12,3779.153533,209.952974,314.929461,96.211433,2,0
0,0,9,9,12,13,25,32,24,56,0.000333,0.086685,6,1560.33568,86.685316,260.055947,91.125266,2,0
0,0,11,11,13,15,28,43,32,75,0.000333,0.120184,12,4326.61943,240.367746,360.551619,106.709075,2,0
0,0,8,8,11,13,24,29,24,53,0.000333,0.081001,5,1215.015063,67.500837,243.003013,86.159464,2,0
0,0,9,9,12,15,27,39,28,67,0.000333,0.106192,6,1911.464776,106.192488,318.577463,101.622909,2,0
0,0,9,9,11,14,25,31,26,57,0.000333,0.088233,5,1323.499014,73.527723,264.699803,91.356717,2,0
0,0,11,11,13,16,29,43,34,77,0.000333,0.124688,12,4488.774439,249.376358,374.064537,112.105716,2,0
0,0,8,8,13,14,27,31,26,57,0.000333,0.090343,6,1626.171526,90.342863,271.028588,101.408685,3,0
0,0,9,9,14,15,29,41,32,73,0.000333,0.118211,14,4964.856577,275.825365,354.632613,111.906328,3,0
0,0,9,9,13,15,28,33,28,61,0.000333,0.09775,6,1759.491901,97.74955,293.24865,106.709075,3,0
0,0,11,11,15,17,32,45,36,81,0.000333,0.135,14,5670,315,405,128.090227,3,0
0,0,8,8,13,14,27,31,26,57,0.000333,0.090343,6,1626.171526,90.342863,271.028588,101.408685,3,0
0,0,9,9,14,15,29,41,32,73,0.000333,0.118211,14,4964.856577,275.825365,354.632613,111.906328,3,0
0,0,9,9,13,15,28,33,28,61,0.000333,0.09775,6,1759.491901,97.74955,293.24865,106.709075,3,0
0,0,11,11,15,17,32,45,36,81,0.000333,0.135,14,5670,315,405,128.090227,3,0
0,0,8,8,13,14,27,31,26,57,0.000333,0.090343,6,1626.171526,90.342863,271.028588,101.408685,3,0
0,0,9,9,14,15,29,41,32,73,0.000333,0.118211,14,4964.856577,275.825365,354.632613,111.906328,3,0
0,0,9,9,13,15,28,33,28,61,0.000333,0.09775,6,1759.491901,97.74955,293.24865,106.709075,3,0
0,0,11,11,15,17,32,45,36,81,0.000333,0.135,14,5670,315,405,128.090227,3,0
0,0,8,8,13,14,27,31,26,57,0.000333,0.090343,6,1626.171526,90.342863,271.028588,101.408685,3,0
0,0,9,9,14,15,29,41,32,73,0.000333,0.118211,14,4964.856577,275.825365,354.632613,111.906328,3,0
0,0,9,9,13,15,28,33,28,61,0.000333,0.09775,6,1759.491901,97.74955,293.24865,106.709075,3,0
0,0,11,11,15,17,32,45,36,81,0.000333,0.135,14,5670,315,405,128.090227,3,0
0,0,8,8,11,13,24,29,24,53,0.000333,0.081001,5,1215.015063,67.500837,243.003013,86.159464,2,0
0,0,9,9,12,14,26,39,30,69,0.000333,0.10811,12,3891.964087,216.220227,324.330341,96.322519,2,0
0,0,9,9,11,14,25,31,26,57,0.000333,0.088233,5,1323.499014,73.527723,264.699803,91.356717,2,0
0,0,11,11,13,16,29,43,34,77,0.000333,0.124688,12,4488.774439,249.376358,374.064537,112.105716,2,0
0,0,8,8,11,10,21,28,20,48,0.000333,0.070277,10,2108.312363,117.128465,210.831236,71.273029,2,0
0,0,11,11,12,13,25,43,30,73,0.000333,0.113001,12,4068.018022,226.001001,339.001502,91.125266,2,0
0,0,9,9,11,11,22,32,23,55,0.000333,0.081756,10,2452.68739,136.260411,245.268739,76.107496,2,0
0,0,13,13,13,15,28,47,36,83,0.000333,0.133003,12,4788.125502,266.006972,399.010459,106.709075,2,0
0,0,8,8,13,11,24,30,22,52,0.000333,0.079473,12,2861.0166,158.945367,238.41805,86.159464,3,0
0,0,11,11,14,14,28,45,32,77,0.000333,0.123389,14,5182.328606,287.907145,370.166329,106.605938,3,0
0,0,9,9,13,12,25,32,24,56,0.000333,0.086685,12,3120.67136,173.370631,260.055947,91.125266,3,0
0,0,13,13,15,16,31,49,38,87,0.000333,0.143672,14,6034.211106,335.23395,431.015079,122.603359,3,0
0,0,8,8,11,10,21,28,20,48,0.000333,0.070277,10,2108.312363,117.128465,210.831236,71.273029,2,0
0,0,11,11,12,13,25,43,30,73,0.000333,0.113001,12,4068.018022,226.001001,339.001502,91.125266,2,0
0,0,9,9,11,11,22,30,22,52,0.000333,0.077297,10,2318.904442,128.828025,231.890444,76.107496,2,0
0,0,13,13,13,15,28,47,36,83,0.000333,0.133003,12,4788.125502,266.006972,399.010459,106.709075,2,0
0,0,8,8,13,11,24,30,22,52,0.000333,0.079473,12,2861.0166,158.945367,238.41805,86.159464,3,0
0,0,11,11,14,14,28,45,32,77,0.000333,0.123389,14,5182.328606,287.907145,370.166329,106.605938,3,0
0,0,9,9,13,12,25,32,24,56,0.000333,0.086685,12,3120.67136,173.370631,260.055947,91.125266,3,0
0,0,13,13,15,16,31,49,38,87,0.000333,0.143672,14,6034.211106,335.23395,431.015079,122.603359,3,0
0,0,8,8,13,9,22,30,20,50,0.000333,0.074324,12,2675.658971,148.647721,222.971581,76.635041,2,0
0,0,11,11,13,12,25,45,30,75,0.000333,0.116096,12,4179.470571,232.192809,348.289214,91.125266,2,0
0,0,9,9,13,10,23,32,22,54,0.000333,0.081424,12,2931.268148,162.84823,244.272346,81.324997,2,0
0,0,13,13,14,14,28,49,36,85,0.000333,0.136208,14,5720.752357,317.819575,408.625168,106.605938,2,0
0,0,8,8,15,10,25,32,22,54,0.000333,0.083589,14,3510.755279,195.04196,250.768234,91.82264,3,0
0,0,11,11,15,13,28,47,32,79,0.000333,0.126594,14,5316.934544,295.385252,379.781039,106.709075,3,0
0,0,9,9,15,11,26,34,24,58,0.000333,0.090875,14,3816.757051,212.042058,272.625504,96.657107,3,0
0,0,13,13,16,15,31,51,38,89,0.000333,0.146974,16,7054.775546,391.931975,440.923472,122.603359,3,0
0,0,8,8,13,9,22,30,20,50,0.000333,0.074324,12,2675.658971,148.647721,222.971581,76.635041,2,0
0,0,11,11,13,12,25,45,30,75,0.000333,0.116096,12,4179.470571,232.192809,348.289214,91.125266,2,0
0,0,9,9,13,10,23,32,22,54,0.000333,0.081424,12,2931.268148,162.84823,244.272346,81.324997,2,0
0,0,13,13,14,14,28,49,36,85,0.000333,0.136208,14,5720.752357,317.819575,408.625168,106.605938,2,0
0,0,8,8,15,10,25,32,22,54,0.000333,0.083589,14,3510.755279,195.04196,250.768234,91.82264,3,0
0,0,11,11,15,13,28,47,32,79,0.000333,0.126594,14,5316.934544,295.385252,379.781039,106.709075,3,0
0,0,9,9,15,11,26,34,24,58,0.000333,0.090875,14,3816.757051,212.042058,272.625504,96.657107,3,0
0,0,13,13,16,15,31,51,38,89,0.000333,0.146974,16,7054.775546,391.931975,440.923472,122.603359,3,0
0,0,8,8,12,9,21,28,20,48,0.000333,0.070277,12,2529.974836,140.554158,210.831236,71.548875,2,0
0,0,11,11,13,12,25,43,30,73,0.000333,0.113001,12,4068.018022,226.001001,339.001502,91.125266,2,0
0,0,9,9,12,10,22,30,22,52,0.000333,0.077297,12,2782.68533,154.593629,231.890444,76.238831,2,0
0,0,13,13,14,14,28,47,36,83,0.000333,0.133003,14,5586.146419,310.341468,399.010459,106.605938,2,0
0,0,8,8,14,10,24,30,22,52,0.000333,0.079473,14,3337.852701,185.436261,238.41805,86.52225,3,0
0,0,11,11,15,13,28,45,32,77,0.000333,0.123389,14,5182.328606,287.907145,370.166329,106.709075,3,0
0,0,9,9,14,11,25,32,24,56,0.000333,0.086685,14,3640.783253,202.265736,260.055947,91.356717,3,0
0,0,13,13,16,15,31,49,38,87,0.000333,0.143672,16,6896.241264,383.124515,431.015079,122.603359,3,0
0,0,8,8,12,9,21,28,20,48,0.000333,0.070277,12,2529.974836,140.554158,210.831236,71.548875,2,0
0,0,11,11,13,12,25,43,30,73,0.000333,0.113001,12,4068.018022,226.001001,339.001502,91.125266,2,0
0,0,9,9,12,10,22,30,22,52,0.000333,0.077297,12,2782.68533,154.593629,231.890444,76.238831,2,0
0,0,13,13,14,14,28,47,36,83,0.000333,0.133003,14,5586.146419,310.341468,399.010459,106.605938,2,0
0,0,8,8,14,10,24,30,22,52,0.000333,0.079473,14,3337.852701,185.436261,238.41805,86.52225,3,0
0,0,11,11,15,13,28,45,32,77,0.000333,0.123389,14,5182.328606,287.907145,370.166329,106.709075,3,0
0,0,9,9,14,11,25,32,24,56,0.000333,0.086685,14,3640.783253,202.265736,260.055947,91.356717,3,0
0,0,13,13,16,15,31,49,38,87,0.000333,0.143672,16,6896.241264,383.124515,431.015079,122.603359,3,0
0,0,8,8,14,13,27,32,23,55,0.000333,0.087173,7,1830.631688,101.70176,261.518813,101.408685,3,0
0,0,11,11,15,16,31,47,33,80,0.000333,0.132112,14,5548.699868,308.261104,396.335705,122.603359,3,0
0,0,9,9,14,14,28,34,25,59,0.000333,0.094545,7,1985.437583,110.302088,283.63394,106.605938,3,0
0,0,13,13,16,18,34,51,39,90,0.000333,0.152624,16,7325.946491,406.997027,457.871656,139.05865,3,0
0,0,8,8,12,12,24,30,21,51,0.000333,0.077944,6,1402.998525,77.944363,233.833088,86.0391,2,0
0,0,11,11,13,15,28,45,31,76,0.000333,0.121786,12,4384.307689,243.572649,365.358974,106.709075,2,0
0,0,9,9,12,13,25,32,23,55,0.000333,0.085137,6,1532.472543,85.137363,255.41209,91.125266,2,0
0,0,13,13,14,17,31,49,37,86,0.000333,0.14202,14,5964.852358,331.380687,426.060883,122.789837,2,0
0,0,8,8,14,13,27,32,23,55,0.000333,0.087173,7,1830.631688,101.70176,261.518813,101.408685,3,0
0,0,11,11,15,16,31,47,33,80,0.000333,0.132112,14,5548.699868,308.261104,396.335705,122.603359,3,0
0,0,9,9,14,14,28,34,25,59,0.000333,0.094545,7,1985.437583,110.302088,283.63394,106.605938,3,0
0,0,13,13,16,18,34,51,39,90,0.000333,0.152624,16,7325.946491,406.997027,457.871656,139.05865,3,0
0,0,8,8,12,12,24,30,21,51,0.000333,0.077944,6,1402.998525,77.944363,233.833088,86.0391,2,0
0,0,11,11,13,15,28,45,31,76,0.000333,0.121786,12,4384.307689,243.572649,365.358974,106.709075,2,0
0,0,9,9,12,13,25,32,23,55,0.000333,0.085137,6,1532.472543,85.137363,255.41209,91.125266,2,0
0,0,13,13,14,17,31,49,37,86,0.000333,0.14202,14,5964.852358,331.380687,426.060883,122.789837,2,0
0,0,8,8,12,12,24,30,22,52,0.000333,0.079473,6,1430.5083,79.472683,238.41805,86.0391,2,0
0,0,9,9,13,13,26,40,27,67,0.000333,0.104976,12,3779.153533,209.952974,314.929461,96.211433,2,0
0,0,9,9,12,13,25,32,24,56,0.000333,0.086685,6,1560.33568,86.685316,260.055947,91.125266,2,0
0,0,11,11,13,15,28,43,32,75,0.000333,0.120184,12,4326.61943,240.367746,360.551619,106.709075,2,0
0,0,8,8,14,13,27,32,24,56,0.000333,0.088758,7,1863.915901,103.550883,266.2737,101.408685,3,0
0,0,9,9,15,14,29,42,29,71,0.000333,0.114972,14,4828.833109,268.268506,344.916651,111.906328,3,0
0,0,9,9,14,14,28,34,26,60,0.000333,0.096147,7,2019.089067,112.171615,288.441295,106.605938,3,0
0,0,11,11,15,16,31,45,34,79,0.000333,0.130461,14,5479.341119,304.40784,391.381509,122.603359,3,0
0,0,8,8,14,13,27,32,24,56,0.000333,0.088758,7,1863.915901,103.550883,266.2737,101.408685,3,0
0,0,9,9,15,14,29,42,29,71,0.000333,0.114972,14,4828.833109,268.268506,344.916651,111.906328,3,0
0,0,9,9,14,14,28,34,26,60,0.000333,0.096147,7,2019.089067,112.171615,288.441295,106.605938,3,0
0,0,11,11,15,16,31,45,34,79,0.000333,0.130461,14,5479.341119,304.40784,391.381509,122.603359,3,0
0,0,8,8,12,12,24,30,22,52,0.000333,0.079473,6,1430.5083,79.472683,238.41805,86.0391,2,0
0,0,9,9,13,13,26,40,27,67,0.000333,0.104976,12,3779.153533,209.952974,314.929461,96.211433,2,0
0,0,9,9,12,13,25,32,24,56,0.000333,0.086685,6,1560.33568,86.685316,260.055947,91.125266,2,0
0,0,11,11,13,15,28,43,32,75,0.000333,0.120184,12,4326.61943,240.367746,360.551619,106.709075,2,0
0,0,7,7,13,11,24,30,20,50,0.000333,0.076416,6,1375.48875,76.416042,229.248125,86.159464,3,0
0,0,8,8,14,13,27,40,25,65,0.000333,0.103023,7,2163.473813,120.19299,309.067688,101.408685,3,0
0,0,8,8,13,12,25,32,22,54,0.000333,0.083589,6,1504.609405,83.589411,250.768234,91.125266,3,0
0,0,12,12,15,17,32,49,36,85,0.000333,0.141667,14,5950,330.555556,425,128.090227,3,0
0,0,7,7,11,10,21,28,18,46,0.000333,0.067349,5,1010.233007,56.124056,202.046601,71.273029,2,0
0,0,8,8,12,12,24,38,23,61,0.000333,0.093228,6,1678.096275,93.227571,279.682713,86.0391,2,0
0,0,8,8,11,11,22,30,20,50,0.000333,0.074324,5,1114.857905,61.93655,222.971581,76.107496,2,0
0,0,12,12,13,16,29,47,34,81,0.000333,0.131165,12,4721.957527,262.330974,393.496461,112.105716,2,0
0,0,7,7,11,10,21,28,18,46,0.000333,0.067349,5,1010.233007,56.124056,202.046601,71.273029,2,0
0,0,9,9,12,12,24,41,26,67,0.000333,0.102397,12,3686.309851,204.794992,307.192488,86.0391,2,0
0,0,8,8,11,11,22,30,20,50,0.000333,0.074324,5,1114.857905,61.93655,222.971581,76.107496,2,0
0,0,12,12,13,16,29,47,34,81,0.000333,0.131165,12,4721.957527,262.330974,393.496461,112.105716,2,0
0,0,7,7,13,11,24,30,20,50,0.000333,0.076416,6,1375.48875,76.416042,229.248125,86.159464,3,0
0,0,8,8,14,13,27,40,25,65,0.000333,0.103023,7,2163.473813,120.19299,309.067688,101.408685,3,0
0,0,8,8,13,12,25,32,22,54,0.000333,0.083589,6,1504.609405,83.589411,250.768234,91.125266,3,0
0,0,12,12,15,17,32,49,36,85,0.000333,0.141667,14,5950,330.555556,425,128.090227,3,0
0,0,7,7,11,10,21,27,17,44,0.000333,0.064421,5,966.309833,53.68388,193.261967,71.273029,2,0
0,0,8,8,12,13,25,37,22,59,0.000333,0.091329,6,1643.925091,91.329172,273.987515,91.125266,2,0
0,0,8,8,11,11,22,29,19,48,0.000333,0.071351,5,1070.263588,59.459088,214.052718,76.107496,2,0
0,0,12,12,13,16,29,46,33,79,0.000333,0.127927,12,4605.365983,255.853666,383.780499,112.105716,2,0
0,0,7,7,13,11,24,29,19,48,0.000333,0.073359,6,1320.4692,73.3594,220.0782,86.159464,3,0
0,0,8,8,14,14,28,39,24,63,0.000333,0.100954,7,2120.043521,117.780196,302.86336,106.605938,3,0
0,0,8,8,13,12,25,31,21,52,0.000333,0.080494,6,1448.883131,80.493507,241.480522,91.125266,3,0
0,0,12,12,15,17,32,48,35,83,0.000333,0.138333,14,5810,322.777778,415,128.090227,3,0
0,0,7,7,13,11,24,29,19,48,0.000333,0.073359,6,1320.4692,73.3594,220.0782,86.159464,3,0
0,0,8,8,14,14,28,39,24,63,0.000333,0.100954,7,2120.043521,117.780196,302.86336,106.605938,3,0
0,0,8,8,13,12,25,31,21,52,0.000333,0.080494,6,1448.883131,80.493507,241.480522,91.125266,3,0
0,0,12,12,15,17,32,48,35,83,0.000333,0.138333,14,5810,322.777778,415,128.090227,3,0
0,0,7,7,11,10,21,27,17,44,0.000333,0.064421,5,966.309833,53.68388,193.261967,71.273029,2,0
0,0,8,8,12,13,25,37,22,59,0.000333,0.091329,6,1643.925091,91.329172,273.987515,91.125266,2,0
0,0,8,8,11,11,22,29,19,48,0.000333,0.071351,5,1070.263588,59.459088,214.052718,76.107496,2,0
0,0,12,12,13,16,29,46,33,79,0.000333,0.127927,12,4605.365983,255.853666,383.780499,112.105716,2,0
0,0,9,9,13,13,26,37,26,63,0.000333,0.098709,12,3553.532427,197.418468,296.127702,96.211433,2,0
0,0,10,10,13,14,27,39,28,67,0.000333,0.106192,12,3822.929552,212.384975,318.577463,101.408685,2,0
0,0,12,12,13,16,29,51,36,87,0.000333,0.140881,12,5071.732159,281.762898,422.644347,112.105716,2,0
0,0,9,9,15,14,29,39,28,67,0.000333,0.108495,14,4556.786173,253.154787,325.484727,111.906328,3,0
0,0,10,10,15,15,30,41,30,71,0.000333,0.11613,14,4877.449252,270.969403,348.389232,117.206718,3,0
0,0,12,12,15,17,32,53,38,91,0.000333,0.151667,14,6370,353.888889,455,128.090227,3,0
0,0,9,9,15,14,29,39,28,67,0.000333,0.108495,14,4556.786173,253.154787,325.484727,111.906328,3,0
0,0,10,10,15,15,30,41,30,71,0.000333,0.11613,14,4877.449252,270.969403,348.389232,117.206718,3,0
0,0,12,12,15,17,32,53,38,91,0.000333,0.151667,14,6370,353.888889,455,128.090227,3,0
0,0,9,9,13,13,26,37,26,63,0.000333,0.098709,12,3553.532427,197.418468,296.127702,96.211433,2,0
0,0,10,10,13,14,27,39,28,67,0.000333,0.106192,12,3822.929552,212.384975,318.577463,101.408685,2,0
0,0,12,12,13,17,30,51,35,86,0.000333,0.140664,12,5063.911095,281.328394,421.992591,117.592585,2,0
0,0,6,6,13,11,24,26,18,44,0.000333,0.067246,6,1210.4301,67.246117,201.73835,86.159464,3,0
0,0,9,9,14,14,28,41,28,69,0.000333,0.110569,14,4643.904855,257.994714,331.70749,106.605938,3,0
0,0,7,7,13,12,25,27,20,47,0.000333,0.072754,6,1309.567446,72.753747,218.261241,91.125266,3,0
0,0,11,11,14,16,30,46,34,80,0.000333,0.13085,14,5495.717467,305.317637,392.551248,117.302969,3,0
0,0,6,6,11,10,21,24,16,40,0.000333,0.058564,5,878.463485,48.803527,175.692697,71.273029,2,0
0,0,9,9,12,13,25,39,26,65,0.000333,0.100617,12,3622.207828,201.233768,301.850652,91.125266,2,0
0,0,7,7,11,11,22,25,18,43,0.000333,0.063919,5,958.777798,53.265433,191.75556,76.107496,2,0
0,0,11,11,12,15,27,44,32,76,0.000333,0.120457,12,4336.457402,240.9143,361.37145,101.622909,2,0
0,0,6,6,13,11,24,26,18,44,0.000333,0.067246,6,1210.4301,67.246117,201.73835,86.159464,3,0
0,0,9,9,14,14,28,41,28,69,0.000333,0.110569,14,4643.904855,257.994714,331.70749,106.605938,3,0
0,0,7,7,13,12,25,27,20,47,0.000333,0.072754,6,1309.567446,72.753747,218.261241,91.125266,3,0
0,0,11,11,14,16,30,46,34,80,0.000333,0.13085,14,5495.717467,305.317637,392.551248,117.302969,3,0
0,0,6,6,11,10,21,24,16,40,0.000333,0.058564,5,878.463485,48.803527,175.692697,71.273029,2,0
0,0,9,9,12,13,25,39,26,65,0.000333,0.100617,12,3622.207828,201.233768,301.850652,91.125266,2,0
0,0,7,7,11,11,22,25,18,43,0.000333,0.063919,5,958.777798,53.265433,191.75556,76.107496,2,0
0,0,11,11,12,15,27,44,32,76,0.000333,0.120457,12,4336.457402,240.9143,361.37145,101.622909,2,0
0,0,8,8,13,13,26,31,24,55,0.000333,0.086175,6,1551.145107,86.174728,258.524184,96.211433,3,0
0,0,9,9,14,14,28,41,29,70,0.000333,0.112172,14,4711.207824,261.733768,336.514845,106.605938,3,0
0,0,9,9,13,14,27,32,26,58,0.000333,0.091928,6,1654.700851,91.927825,275.783475,101.408685,3,0
0,0,11,11,14,16,30,46,34,80,0.000333,0.13085,14,5495.717467,305.317637,392.551248,117.302969,3,0
0,0,8,8,11,12,23,29,22,51,0.000333,0.076901,5,1153.508299,64.083794,230.70166,81.073298,2,0
0,0,9,9,12,15,27,39,27,66,0.000333,0.104608,6,1882.935451,104.607525,313.822575,101.622909,2,0
0,0,9,9,11,13,24,30,24,54,0.000333,0.082529,5,1237.939875,68.774438,247.587975,86.159464,2,0
0,0,11,11,12,15,27,44,32,76,0.000333,0.120457,12,4336.457402,240.9143,361.37145,101.622909,2,0
0,0,8,8,13,13,26,31,24,55,0.000333,0.086175,6,1551.145107,86.174728,258.524184,96.211433,3,0
0,0,9,9,14,14,28,41,29,70,0.000333,0.112172,14,4711.207824,261.733768,336.514845,106.605938,3,0
0,0,9,9,13,14,27,32,26,58,0.000333,0.091928,6,1654.700851,91.927825,275.783475,101.408685,3,0
0,0,11,11,14,16,30,46,34,80,0.000333,0.13085,14,5495.717467,305.317637,392.551248,117.302969,3,0
0,0,8,8,11,12,23,29,22,51,0.000333,0.076901,5,1153.508299,64.083794,230.70166,81.073298,2,0
0,0,9,9,12,15,27,39,27,66,0.000333,0.104608,6,1882.935451,104.607525,313.822575,101.622909,2,0
0,0,9,9,11,13,24,30,24,54,0.000333,0.082529,5,1237.939875,68.774438,247.587975,86.159464,2,0
0,0,11,11,12,15,27,44,32,76,0.000333,0.120457,12,4336.457402,240.9143,361.37145,101.622909,2,0
0,0,9,9,13,14,27,34,27,61,0.000333,0.096683,6,1740.288826,96.682713,290.048138,101.408685,3,0
0,0,10,10,14,15,29,44,32,76,0.000333,0.123069,14,5168.891779,287.160654,369.206556,111.906328,3,0
0,0,10,10,13,15,28,35,29,64,0.000333,0.102557,6,1846.02429,102.556905,307.670715,106.709075,3,0
0,0,12,12,14,17,31,49,37,86,0.000333,0.14202,14,5964.852358,331.380687,426.060883,122.789837,3,0
0,0,9,9,11,13,24,32,25,57,0.000333,0.087114,5,1306.714313,72.59524,261.342863,86.159464,2,0
0,0,10,10,12,16,28,42,30,72,0.000333,0.115377,6,2076.777326,115.376518,346.129554,107.01955,2,0
0,0,10,10,11,14,25,33,27,60,0.000333,0.092877,5,1393.156857,77.397603,278.631371,91.356717,2,0
0,0,12,12,12,17,29,47,35,82,0.000333,0.132785,12,4780.253299,265.569628,398.354442,112.506418,2,0
0,0,9,9,13,14,27,34,27,61,0.000333,0.096683,6,1740.288826,96.682713,290.048138,101.408685,3,0
0,0,10,10,14,15,29,44,32,76,0.000333,0.123069,14,5168.891779,287.160654,369.206556,111.906328,3,0
0,0,10,10,13,15,28,35,29,64,0.000333,0.102557,6,1846.02429,102.556905,307.670715,106.709075,3,0
0,0,12,12,14,17,31,49,37,86,0.000333,0.14202,14,5964.852358,331.380687,426.060883,122.789837,3,0
0,0,9,9,11,13,24,32,25,57,0.000333,0.087114,5,1306.714313,72.59524,261.342863,86.159464,2,0
0,0,10,10,12,16,28,42,30,72,0.000333,0.115377,6,2076.777326,115.376518,346.129554,107.01955,2,0
0,0,10,10,11,14,25,33,27,60,0.000333,0.092877,5,1393.156857,77.397603,278.631371,91.356717,2,0
0,0,12,12,12,17,29,47,35,82,0.000333,0.132785,12,4780.253299,265.569628,398.354442,112.506418,2,0
0,0,10,10,13,15,28,37,30,67,0.000333,0.107364,12,3865.113357,214.72852,322.09278,106.709075,3,0
0,0,11,11,14,16,30,47,35,82,0.000333,0.134122,14,5633.110404,312.950578,402.365029,117.302969,3,0
0,0,11,11,13,16,29,38,32,70,0.000333,0.113353,12,4080.704036,226.70578,340.05867,112.105716,3,0
0,0,14,14,14,18,32,55,43,98,0.000333,0.163333,14,6860,381.111111,490,128.361619,3,0
0,0,10,10,11,14,25,35,28,63,0.000333,0.097521,10,2925.6294,162.534967,292.56294,91.356717,2,0
0,0,11,11,12,17,29,45,33,78,0.000333,0.126308,6,2273.535106,126.307506,378.922518,112.506418,2,0
0,0,11,11,11,15,26,36,30,66,0.000333,0.10341,10,3102.290214,172.349456,310.229021,96.657107,2,0
0,0,13,13,12,18,30,50,38,88,0.000333,0.143935,12,5181.676469,287.870915,431.806372,118.0782,2,0
0,0,10,10,13,15,28,37,30,67,0.000333,0.107364,12,3865.113357,214.72852,322.09278,106.709075,3,0
0,0,11,11,14,16,30,47,35,82,0.000333,0.134122,14,5633.110404,312.950578,402.365029,117.302969,3,0
0,0,11,11,13,16,29,38,32,70,0.000333,0.113353,12,4080.704036,226.70578,340.05867,112.105716,3,0
0,0,13,13,14,18,32,52,40,92,0.000333,0.153333,14,6440,357.777778,460,128.361619,3,0
0,0,10,10,11,14,25,35,28,63,0.000333,0.097521,10,2925.6294,162.534967,292.56294,91.356717,2,0
0,0,11,11,12,17,29,45,33,78,0.000333,0.126308,6,2273.535106,126.307506,378.922518,112.506418,2,0
0,0,11,11,11,15,26,36,30,66,0.000333,0.10341,10,3102.290214,172.349456,310.229021,96.657107,2,0
0,0,14,14,12,19,31,53,41,94,0.000333,0.155231,12,5588.333438,310.462969,465.694453,123.730173,2,0
0,0,11,11,13,16,29,40,33,73,0.000333,0.118211,12,4255.591352,236.421742,354.632613,112.105716,3,0
0,0,12,12,14,17,31,50,38,88,0.000333,0.145323,14,6103.569854,339.087214,435.969275,122.789837,3,0
0,0,12,12,13,17,30,41,35,76,0.000333,0.124308,12,4475.084223,248.61579,372.923685,117.592585,3,0
0,0,14,14,14,19,33,55,43,98,0.000333,0.164784,14,6920.908732,384.49493,494.350624,134.013592,3,0
0,0,11,11,11,15,26,38,31,69,0.000333,0.10811,10,3243.303406,180.183523,324.330341,96.657107,2,0
0,0,12,12,12,19,31,48,36,84,0.000333,0.138717,6,2496.91494,138.717497,416.15249,123.730173,2,0
0,0,12,12,11,16,27,39,33,72,0.000333,0.114117,10,3423.519002,190.1955,342.3519,102.053748,2,0
0,0,14,14,12,19,31,53,41,94,0.000333,0.155231,12,5588.333438,310.462969,465.694453,123.730173,2,0
0,0,11,11,13,16,29,40,33,73,0.000333,0.118211,12,4255.591352,236.421742,354.632613,112.105716,3,0
0,0,12,12,14,17,31,50,38,88,0.000333,0.145323,14,6103.569854,339.087214,435.969275,122.789837,3,0
0,0,12,12,13,17,30,41,35,76,0.000333,0.124308,12,4475.084223,248.61579,372.923685,117.592585,3,0
0,0,14,14,14,19,33,55,43,98,0.000333,0.164784,14,6920.908732,384.49493,494.350624,134.013592,3,0
0,0,11,11,11,15,26,38,31,69,0.000333,0.10811,10,3243.303406,180.183523,324.330341,96.657107,2,0
0,0,12,12,12,18,30,48,36,84,0.000333,0.137393,12,4946.14572,274.785873,412.17881,118.0782,2,0
0,0,12,12,11,16,27,39,33,72,0.000333,0.114117,10,3423.519002,190.1955,342.3519,102.053748,2,0
0,0,14,14,12,19,31,53,41,94,0.000333,0.155231,12,5588.333438,310.462969,465.694453,123.730173,2,0
0,0,7,7,11,10,21,28,18,46,0.000333,0.067349,5,1010.233007,56.124056,202.046601,71.273029,2,0
0,0,8,8,12,12,24,38,23,61,0.000333,0.093228,6,1678.096275,93.227571,279.682713,86.0391,2,0
0,0,8,8,11,11,22,29,20,49,0.000333,0.072837,5,1092.560747,60.697819,218.512149,76.107496,2,0
0,0,12,12,12,16,28,48,34,82,0.000333,0.131401,12,4730.437243,262.802069,394.203104,107.01955,2,0
0,0,7,7,13,11,24,30,20,50,0.000333,0.076416,6,1375.48875,76.416042,229.248125,86.159464,3,0
0,0,8,8,14,14,28,40,25,65,0.000333,0.104159,7,2187.34649,121.519249,312.47807,106.605938,3,0
0,0,8,8,13,12,25,31,22,53,0.000333,0.082041,6,1476.746268,82.041459,246.124378,91.125266,3,0
0,0,12,12,14,17,31,50,36,86,0.000333,0.14202,14,5964.852358,331.380687,426.060883,122.789837,3,0
0,0,7,7,11,10,21,28,18,46,0.000333,0.067349,5,1010.233007,56.124056,202.046601,71.273029,2,0
0,0,8,8,12,14,26,38,23,61,0.000333,0.095576,6,1720.360937,95.575608,286.726823,96.322519,2,0
0,0,8,8,11,11,22,29,20,49,0.000333,0.072837,5,1092.560747,60.697819,218.512149,76.107496,2,0
0,0,12,12,12,16,28,48,34,82,0.000333,0.131401,12,4730.437243,262.802069,394.203104,107.01955,2,0
0,0,7,7,13,11,24,30,20,50,0.000333,0.076416,6,1375.48875,76.416042,229.248125,86.159464,3,0
0,0,8,8,14,13,27,40,25,65,0.000333,0.103023,7,2163.473813,120.19299,309.067688,101.408685,3,0
0,0,8,8,13,12,25,31,22,53,0.000333,0.082041,6,1476.746268,82.041459,246.124378,91.125266,3,0
0,0,12,12,14,17,31,50,36,86,0.000333,0.14202,14,5964.852358,331.380687,426.060883,122.789837,3,0
0,0,7,7,11,10,21,27,17,44,0.000333,0.064421,5,966.309833,53.68388,193.261967,71.273029,2,0
0,0,8,8,12,13,25,37,22,59,0.000333,0.091329,6,1643.925091,91.329172,273.987515,91.125266,2,0
0,0,8,8,11,11,22,28,19,47,0.000333,0.069864,5,1047.96643,58.220357,209.593286,76.107496,2,0
0,0,12,12,12,16,28,47,33,80,0.000333,0.128196,12,4615.060725,256.392263,384.588394,107.01955,2,0
0,0,7,7,13,11,24,29,19,48,0.000333,0.073359,6,1320.4692,73.3594,220.0782,86.159464,3,0
0,0,8,8,14,14,28,39,24,63,0.000333,0.100954,7,2120.043521,117.780196,302.86336,106.605938,3,0
0,0,8,8,13,12,25,30,21,51,0.000333,0.078946,6,1421.019994,78.945555,236.836666,91.125266,3,0
0,0,12,12,14,17,31,49,35,84,0.000333,0.138717,14,5826.134861,323.674159,416.15249,122.789837,3,0
0,0,7,7,11,10,21,27,17,44,0.000333,0.064421,5,966.309833,53.68388,193.261967,71.273029,2,0
0,0,8,8,12,15,27,37,22,59,0.000333,0.093513,6,1683.230176,93.512788,280.538363,101.622909,2,0
0,0,8,8,11,11,22,28,19,47,0.000333,0.069864,5,1047.96643,58.220357,209.593286,76.107496,2,0
0,0,12,12,12,16,28,47,33,80,0.000333,0.128196,12,4615.060725,256.392263,384.588394,107.01955,2,0
0,0,7,7,13,11,24,29,19,48,0.000333,0.073359,6,1320.4692,73.3594,220.0782,86.159464,3,0
0,0,8,8,14,14,28,39,24,63,0.000333,0.100954,7,2120.043521,117.780196,302.86336,106.605938,3,0
0,0,8,8,13,12,25,30,21,51,0.000333,0.078946,6,1421.019994,78.945555,236.836666,91.125266,3,0
0,0,12,12,14,17,31,49,35,84,0.000333,0.138717,14,5826.134861,323.674159,416.15249,122.789837,3,0
0,0,9,9,13,13,26,34,25,59,0.000333,0.092442,6,1663.95566,92.441981,277.325943,96.211433,2,0
0,0,12,12,13,15,28,49,35,84,0.000333,0.134606,12,4845.813761,269.211876,403.817813,106.709075,2,0
0,0,10,10,13,14,27,35,27,62,0.000333,0.098268,6,1768.818151,98.267675,294.803025,101.408685,2,0
0,0,14,14,13,17,30,54,41,95,0.000333,0.155385,12,5593.855279,310.769738,466.154607,117.592585,2,0
0,0,9,9,15,14,29,36,27,63,0.000333,0.102018,7,2142.369619,119.020534,306.052803,111.906328,3,0
0,0,11,11,15,16,31,49,33,82,0.000333,0.135415,14,5687.417364,315.967631,406.244097,122.603359,3,0
0,0,10,10,15,15,30,37,29,66,0.000333,0.107952,7,2266.983455,125.943525,323.854779,117.206718,3,0
0,0,14,14,15,18,33,56,43,99,0.000333,0.166465,14,6991.530249,388.418347,499.395018,133.662009,3,0
0,0,9,9,13,13,26,34,25,59,0.000333,0.092442,6,1663.95566,92.441981,277.325943,96.211433,2,0
0,0,12,12,13,15,28,49,35,84,0.000333,0.134606,12,4845.813761,269.211876,403.817813,106.709075,2,0
0,0,10,10,13,14,27,35,27,62,0.000333,0.098268,6,1768.818151,98.267675,294.803025,101.408685,2,0
0,0,14,14,13,17,30,54,41,95,0.000333,0.155385,12,5593.855279,310.769738,466.154607,117.592585,2,0
0,0,9,9,15,14,29,36,27,63,0.000333,0.102018,7,2142.369619,119.020534,306.052803,111.906328,3,0
0,0,12,12,15,16,31,51,37,88,0.000333,0.145323,14,6103.569854,339.087214,435.969275,122.603359,3,0
0,0,10,10,15,15,30,37,29,66,0.000333,0.107952,7,2266.983455,125.943525,323.854779,117.206718,3,0
0,0,14,14,15,18,33,56,43,99,0.000333,0.166465,14,6991.530249,388.418347,499.395018,133.662009,3,0
0,0,10,10,15,15,30,44,31,75,0.000333,0.122672,14,5152.235125,286.235285,368.016795,117.206718,3,0
0,0,11,11,15,16,31,55,36,91,0.000333,0.150277,14,6311.646099,350.647006,450.831864,122.603359,3,0
0,0,11,11,15,16,31,45,33,78,0.000333,0.128809,14,5409.982371,300.554576,386.427312,122.603359,3,0
0,0,15,15,15,19,34,64,47,111,0.000333,0.188236,14,7905.917255,439.217625,564.708375,139.313982,3,0
0,0,10,10,13,14,27,42,29,71,0.000333,0.112532,12,4051.164152,225.064675,337.597013,101.408685,2,0
0,0,11,11,13,16,29,53,34,87,0.000333,0.140881,12,5071.732159,281.762898,422.644347,112.105716,2,0
0,0,11,11,13,15,28,43,31,74,0.000333,0.118581,12,4268.931171,237.162843,355.744264,106.709075,2,0
0,0,15,15,13,18,31,62,45,107,0.000333,0.1767,12,6361.188063,353.399337,530.099005,123.164366,2,0
0,0,10,10,15,15,30,44,31,75,0.000333,0.122672,14,5152.235125,286.235285,368.016795,117.206718,3,0
0,0,11,11,15,16,31,54,36,90,0.000333,0.148626,14,6242.287351,346.793742,445.877668,122.603359,3,0
0,0,11,11,15,16,31,45,33,78,0.000333,0.128809,14,5409.982371,300.554576,386.427312,122.603359,3,0
0,0,15,15,15,19,34,64,47,111,0.000333,0.188236,14,7905.917255,439.217625,564.708375,139.313982,3,0
0,0,10,10,13,14,27,42,29,71,0.000333,0.112532,12,4051.164152,225.064675,337.597013,101.408685,2,0
0,0,11,11,13,17,30,53,34,87,0.000333,0.1423,12,5122.793782,284.599655,426.899482,117.592585,2,0
0,0,11,11,13,15,28,43,31,74,0.000333,0.118581,12,4268.931171,237.162843,355.744264,106.709075,2,0
0,0,15,15,13,18,31,62,45,107,0.000333,0.1767,12,6361.188063,353.399337,530.099005,123.164366,2,0
0,0,8,8,14,13,27,34,26,60,0.000333,0.095098,14,3994.105502,221.89475,285.29325,101.408685,3,0
0,0,9,9,14,14,28,35,28,63,0.000333,0.100954,14,4240.087041,235.560391,302.86336,106.605938,3,0
0,0,12,12,14,16,30,53,39,92,0.000333,0.150478,14,6320.075087,351.115283,451.433935,117.302969,3,0
0,0,10,10,12,13,25,37,28,65,0.000333,0.100617,12,3622.207828,201.233768,301.850652,91.125266,2,0
0,0,11,11,12,14,26,38,30,68,0.000333,0.106543,12,3835.55881,213.086601,319.629901,96.322519,2,0
0,0,13,13,12,17,29,53,38,91,0.000333,0.147359,12,5304.915247,294.717514,442.076271,112.506418,2,0
0,0,10,10,12,13,25,37,28,65,0.000333,0.100617,12,3622.207828,201.233768,301.850652,91.125266,2,0
0,0,11,11,12,14,26,38,30,68,0.000333,0.106543,12,3835.55881,213.086601,319.629901,96.322519,2,0
0,0,13,13,12,18,30,53,38,91,0.000333,0.148842,12,5358.32453,297.684696,446.527044,118.0782,2,0
0,0,8,8,14,13,27,34,26,60,0.000333,0.095098,14,3994.105502,221.89475,285.29325,101.408685,3,0
0,0,9,9,14,14,28,35,28,63,0.000333,0.100954,14,4240.087041,235.560391,302.86336,106.605938,3,0
0,0,12,12,14,16,30,53,39,92,0.000333,0.150478,14,6320.075087,351.115283,451.433935,117.302969,3,0
0,0,10,10,11,14,25,39,29,68,0.000333,0.105261,10,3157.822209,175.434567,315.782221,91.356717,2,0
0,0,11,11,11,15,26,40,31,71,0.000333,0.111244,10,3337.3122,185.406233,333.73122,96.657107,2,0
0,0,11,11,12,17,29,49,34,83,0.000333,0.134404,12,4838.549071,268.808282,403.212423,112.506418,2,0
0,0,10,10,13,15,28,41,31,72,0.000333,0.115377,12,4153.554653,230.753036,346.129554,106.709075,3,0
0,0,11,11,14,16,30,51,36,87,0.000333,0.1423,14,5976.592745,332.03293,426.899482,117.302969,3,0
0,0,11,11,13,16,29,43,33,76,0.000333,0.123069,12,4430.478668,246.137704,369.206556,112.105716,3,0
0,0,10,10,11,14,25,39,29,68,0.000333,0.105261,10,3157.822209,175.434567,315.782221,91.356717,2,0
0,0,11,11,11,15,26,40,31,71,0.000333,0.111244,10,3337.3122,185.406233,333.73122,96.657107,2,0
0,0,12,12,12,17,29,52,37,89,0.000333,0.14412,12,5188.323703,288.240206,432.360309,112.506418,2,0
0,0,10,10,13,15,28,41,31,72,0.000333,0.115377,12,4153.554653,230.753036,346.129554,106.709075,3,0
0,0,11,11,13,16,29,43,33,76,0.000333,0.123069,12,4430.478668,246.137704,369.206556,112.105716,3,0
0,0,11,11,14,16,30,51,36,87,0.000333,0.1423,14,5976.592745,332.03293,426.899482,117.302969,3,0
0,0,10,10,14,16,30,37,31,68,0.000333,0.111223,7,2335.679924,129.759996,333.668561,117.302969,3,0
0,0,11,11,15,17,32,47,36,83,0.000333,0.138333,14,5810,322.777778,415,128.090227,3,0
0,0,11,11,14,17,31,38,33,71,0.000333,0.117249,7,2462.235566,136.790865,351.747938,122.789837,3,0
0,0,10,10,12,15,27,35,29,64,0.000333,0.101438,6,1825.876801,101.4376,304.3128,101.622909,2,0
0,0,11,11,13,16,29,45,34,79,0.000333,0.127927,12,4605.365983,255.853666,383.780499,112.105716,2,0
0,0,11,11,12,16,28,36,31,67,0.000333,0.107364,6,1932.556679,107.36426,322.09278,107.01955,2,0
0,0,10,10,12,15,27,35,29,64,0.000333,0.101438,6,1825.876801,101.4376,304.3128,101.622909,2,0
0,0,11,11,13,18,31,45,34,79,0.000333,0.130461,6,2348.289051,130.460503,391.381509,123.164366,2,0
0,0,11,11,12,16,28,36,31,67,0.000333,0.107364,6,1932.556679,107.36426,322.09278,107.01955,2,0
0,0,10,10,14,16,30,37,31,68,0.000333,0.111223,7,2335.679924,129.759996,333.668561,117.302969,3,0
0,0,11,11,15,17,32,47,36,83,0.000333,0.138333,14,5810,322.777778,415,128.090227,3,0
0,0,11,11,14,17,31,38,33,71,0.000333,0.117249,7,2462.235566,136.790865,351.747938,122.789837,3,0
0,0,6,6,11,10,21,24,16,40,0.000333,0.058564,5,878.463485,48.803527,175.692697,71.273029,2,0
0,0,9,9,12,13,25,39,26,65,0.000333,0.100617,12,3622.207828,201.233768,301.850652,91.125266,2,0
0,0,7,7,11,11,22,25,18,43,0.000333,0.063919,5,958.777798,53.265433,191.75556,76.107496,2,0
0,0,11,11,12,15,27,44,32,76,0.000333,0.120457,12,4336.457402,240.9143,361.37145,101.622909,2,0
0,0,6,6,13,11,24,26,18,44,0.000333,0.067246,6,1210.4301,67.246117,201.73835,86.159464,3,0
0,0,9,9,14,14,28,41,28,69,0.000333,0.110569,14,4643.904855,257.994714,331.70749,106.605938,3,0
0,0,7,7,13,12,25,27,20,47,0.000333,0.072754,6,1309.567446,72.753747,218.261241,91.125266,3,0
0,0,11,11,14,16,30,46,34,80,0.000333,0.13085,14,5495.717467,305.317637,392.551248,117.302969,3,0
0,0,6,6,13,11,24,26,18,44,0.000333,0.067246,6,1210.4301,67.246117,201.73835,86.159464,3,0
0,0,9,9,14,14,28,41,28,69,0.000333,0.110569,14,4643.904855,257.994714,331.70749,106.605938,3,0
0,0,7,7,13,12,25,27,20,47,0.000333,0.072754,6,1309.567446,72.753747,218.261241,91.125266,3,0
0,0,11,11,14,16,30,46,34,80,0.000333,0.13085,14,5495.717467,305.317637,392.551248,117.302969,3,0
0,0,6,6,11,10,21,24,16,40,0.000333,0.058564,5,878.463485,48.803527,175.692697,71.273029,2,0
0,0,9,9,12,13,25,39,26,65,0.000333,0.100617,12,3622.207828,201.233768,301.850652,91.125266,2,0
0,0,7,7,11,11,22,25,18,43,0.000333,0.063919,5,958.777798,53.265433,191.75556,76.107496,2,0
0,0,11,11,12,15,27,44,32,76,0.000333,0.120457,12,4336.457402,240.9143,361.37145,101.622909,2,0
0,0,12,12,14,19,33,58,47,105,0.000333,0.176554,14,7415.259355,411.958853,529.661383,134.013592,3,0
0,0,15,15,15,21,36,73,57,130,0.000333,0.22403,14,9409.263503,522.736861,672.09025,150.842025,3,0
0,0,13,13,14,20,34,59,49,108,0.000333,0.183149,14,7692.243816,427.346879,549.445987,139.741531,3,0
0,0,12,12,13,18,31,56,45,101,0.000333,0.166791,12,6004.485928,333.582552,500.373827,123.164366,2,0
0,0,13,13,14,19,33,68,51,119,0.000333,0.200094,14,8403.960603,466.8867,600.2829,134.013592,2,0
0,0,13,13,13,19,32,57,47,104,0.000333,0.173333,12,6240,346.666667,520,128.816339,2,0
0,0,12,12,14,19,33,58,47,105,0.000333,0.176554,14,7415.259355,411.958853,529.661383,134.013592,3,0
0,0,13,13,15,20,35,70,53,123,0.000333,0.210301,14,8832.625355,490.701409,630.901811,145.041921,3,0
0,0,13,13,14,20,34,59,49,108,0.000333,0.183149,14,7692.243816,427.346879,549.445987,139.741531,3,0
0,0,12,12,13,18,31,56,45,101,0.000333,0.166791,12,6004.485928,333.582552,500.373827,123.164366,2,0
0,0,13,13,14,19,33,68,51,119,0.000333,0.200094,14,8403.960603,466.8867,600.2829,134.013592,2,0
0,0,13,13,13,19,32,57,47,104,0.000333,0.173333,12,6240,346.666667,520,128.816339,2,0
0,0,12,12,14,17,31,48,38,86,0.000333,0.14202,14,5964.852358,331.380687,426.060883,122.789837,3,0
0,0,13,13,15,18,33,58,43,101,0.000333,0.169828,14,7132.773285,396.265182,509.483806,133.662009,3,0
0,0,13,13,14,18,32,49,40,89,0.000333,0.148333,14,6230,346.111111,445,128.361619,3,0
0,0,12,12,13,16,29,46,36,82,0.000333,0.132785,12,4780.253299,265.569628,398.354442,112.105716,2,0
0,0,13,13,14,17,31,58,42,100,0.000333,0.16514,14,6935.874835,385.32638,495.419631,122.789837,2,0
0,0,13,13,13,17,30,47,38,85,0.000333,0.139029,12,5005.028408,278.057134,417.085701,117.592585,2,0
0,0,12,12,14,17,31,48,38,86,0.000333,0.14202,14,5964.852358,331.380687,426.060883,122.789837,3,0
0,0,13,13,15,18,33,60,44,104,0.000333,0.174872,14,7344.637838,408.035435,524.616988,133.662009,3,0
0,0,13,13,14,18,32,49,40,89,0.000333,0.148333,14,6230,346.111111,445,128.361619,3,0
0,0,12,12,13,16,29,46,36,82,0.000333,0.132785,12,4780.253299,265.569628,398.354442,112.105716,2,0
0,0,13,13,14,17,31,58,42,100,0.000333,0.16514,14,6935.874835,385.32638,495.419631,122.789837,2,0
0,0,13,13,13,17,30,47,38,85,0.000333,0.139029,12,5005.028408,278.057134,417.085701,117.592585,2,0
0,0,12,12,13,19,32,50,39,89,0.000333,0.148333,12,5340,296.666667,445,128.816339,3,0
0,0,13,13,14,20,34,63,46,109,0.000333,0.184844,14,7763.468296,431.303794,554.53345,139.741531,3,0
0,0,12,12,11,19,30,46,38,84,0.000333,0.137393,10,4121.7881,228.988228,412.17881,118.764371,2,0
0,0,12,12,12,18,30,48,37,85,0.000333,0.139029,12,5005.028408,278.057134,417.085701,118.0782,2,0
0,0,13,13,13,19,32,60,44,104,0.000333,0.173333,12,6240,346.666667,520,128.816339,2,0
0,0,13,13,12,19,31,49,39,88,0.000333,0.145323,12,5231.631304,290.646184,435.969275,123.730173,2,0
0,0,12,12,13,19,32,50,39,89,0.000333,0.148333,12,5340,296.666667,445,128.816339,3,0
0,0,13,13,14,20,34,63,46,109,0.000333,0.184844,14,7763.468296,431.303794,554.53345,139.741531,3,0
0,0,13,13,13,20,33,51,41,92,0.000333,0.154695,12,5569.011108,309.389506,464.084259,134.544278,3,0
0,0,12,12,12,18,30,48,37,85,0.000333,0.139029,12,5005.028408,278.057134,417.085701,118.0782,2,0
0,0,13,13,13,19,32,61,44,105,0.000333,0.175,12,6300,350,525,128.816339,2,0
0,0,13,13,12,19,31,49,39,88,0.000333,0.145323,12,5231.631304,290.646184,435.969275,123.730173,2,0
0,0,6,6,11,8,19,24,14,38,0.000333,0.053807,5,807.106228,44.839235,161.421246,62.053748,2,0
0,0,6,6,11,8,19,24,14,38,0.000333,0.053807,5,807.106228,44.839235,161.421246,62.053748,2,0
0,0,6,6,13,9,22,26,16,42,0.000333,0.062432,6,1123.776768,62.432043,187.296128,76.635041,3,0
0,0,6,6,13,9,22,26,16,42,0.000333,0.062432,6,1123.776768,62.432043,187.296128,76.635041,3,0
0,0,6,6,11,8,19,24,14,38,0.000333,0.053807,5,807.106228,44.839235,161.421246,62.053748,2,0
0,0,6,6,11,8,19,24,14,38,0.000333,0.053807,5,807.106228,44.839235,161.421246,62.053748,2,0
0,0,6,6,11,8,19,24,14,38,0.000333,0.053807,5,807.106228,44.839235,161.421246,62.053748,2,0
0,0,6,6,13,9,22,26,16,42,0.000333,0.062432,6,1123.776768,62.432043,187.296128,76.635041,3,0
0,0,6,6,13,9,22,26,16,42,0.000333,0.062432,6,1123.776768,62.432043,187.296128,76.635041,3,0
0,0,6,6,11,8,19,24,14,38,0.000333,0.053807,5,807.106228,44.839235,161.421246,62.053748,2,0
0,0,6,6,11,8,19,24,14,38,0.000333,0.053807,5,807.106228,44.839235,161.421246,62.053748,2,0
0,0,6,6,13,9,22,26,16,42,0.000333,0.062432,6,1123.776768,62.432043,187.296128,76.635041,3,0
0,0,6,6,13,9,22,26,16,42,0.000333,0.062432,6,1123.776768,62.432043,187.296128,76.635041,3,0
0,0,6,6,11,8,19,24,14,38,0.000333,0.053807,5,807.106228,44.839235,161.421246,62.053748,2,0
0,0,6,6,11,8,19,24,14,38,0.000333,0.053807,5,807.106228,44.839235,161.421246,62.053748,2,0
0,0,6,6,13,9,22,26,16,42,0.000333,0.062432,6,1123.776768,62.432043,187.296128,76.635041,3,0
0,0,6,6,13,9,22,26,16,42,0.000333,0.062432,6,1123.776768,62.432043,187.296128,76.635041,3,0
0,0,6,6,11,8,19,24,14,38,0.000333,0.053807,5,807.106228,44.839235,161.421246,62.053748,2,0
0,0,6,6,11,8,19,24,14,38,0.000333,0.053807,5,807.106228,44.839235,161.421246,62.053748,2,0
0,0,6,6,13,9,22,26,16,42,0.000333,0.062432,6,1123.776768,62.432043,187.296128,76.635041,3,0
0,0,6,6,13,9,22,26,16,42,0.000333,0.062432,6,1123.776768,62.432043,187.296128,76.635041,3,0
0,0,6,6,11,8,19,24,14,38,0.000333,0.053807,5,807.106228,44.839235,161.421246,62.053748,2,0
0,0,6,6,11,8,19,24,14,38,0.000333,0.053807,5,807.106228,44.839235,161.421246,62.053748,2,0
0,0,6,6,13,9,22,26,16,42,0.000333,0.062432,6,1123.776768,62.432043,187.296128,76.635041,3,0
0,0,6,6,13,9,22,26,16,42,0.000333,0.062432,6,1123.776768,62.432043,187.296128,76.635041,3,0
0,0,6,6,11,8,19,24,14,38,0.000333,0.053807,5,807.106228,44.839235,161.421246,62.053748,2,0
0,0,6,6,11,8,19,24,14,38,0.000333,0.053807,5,807.106228,44.839235,161.421246,62.053748,2,0
0,0,6,6,13,9,22,26,16,42,0.000333,0.062432,6,1123.776768,62.432043,187.296128,76.635041,3,0
0,0,6,6,13,9,22,26,16,42,0.000333,0.062432,6,1123.776768,62.432043,187.296128,76.635041,3,0
0,0,6,6,13,9,22,26,16,42,0.000333,0.062432,6,1123.776768,62.432043,187.296128,76.635041,3,0
0,0,6,6,11,8,19,24,14,38,0.000333,0.053807,5,807.106228,44.839235,161.421246,62.053748,2,0
0,0,6,6,13,9,22,26,16,42,0.000333,0.062432,6,1123.776768,62.432043,187.296128,76.635041,3,0
0,0,6,6,11,8,19,24,14,38,0.000333,0.053807,5,807.106228,44.839235,161.421246,62.053748,2,0
0,0,6,6,11,8,19,24,14,38,0.000333,0.053807,5,807.106228,44.839235,161.421246,62.053748,2,0
0,0,6,6,11,8,19,24,14,38,0.000333,0.053807,5,807.106228,44.839235,161.421246,62.053748,2,0
0,0,6,6,13,9,22,26,16,42,0.000333,0.062432,6,1123.776768,62.432043,187.296128,76.635041,3,0
0,0,6,6,13,9,22,26,16,42,0.000333,0.062432,6,1123.776768,62.432043,187.296128,76.635041,3,0
0,0,6,6,13,9,22,26,16,42,0.000333,0.062432,6,1123.776768,62.432043,187.296128,76.635041,3,0
0,0,6,6,11,8,19,24,14,38,0.000333,0.053807,5,807.106228,44.839235,161.421246,62.053748,2,0
0,0,6,6,13,9,22,26,16,42,0.000333,0.062432,6,1123.776768,62.432043,187.296128,76.635041,3,0
0,0,6,6,11,8,19,24,14,38,0.000333,0.053807,5,807.106228,44.839235,161.421246,62.053748,2,0
0,0,6,6,11,8,19,24,14,38,0.000333,0.053807,5,807.106228,44.839235,161.421246,62.053748,2,0
0,0,6,6,11,8,19,24,14,38,0.000333,0.053807,5,807.106228,44.839235,161.421246,62.053748,2,0
0,0,6,6,13,9,22,26,16,42,0.000333,0.062432,6,1123.776768,62.432043,187.296128,76.635041,3,0
0,0,6,6,13,9,22,26,16,42,0.000333,0.062432,6,1123.776768,62.432043,187.296128,76.635041,3,0
0,0,6,6,11,8,19,24,14,38,0.000333,0.053807,5,807.106228,44.839235,161.421246,62.053748,2,0
0,0,6,6,11,8,19,24,14,38,0.000333,0.053807,5,807.106228,44.839235,161.421246,62.053748,2,0
0,0,6,6,13,9,22,26,16,42,0.000333,0.062432,6,1123.776768,62.432043,187.296128,76.635041,3,0
0,0,6,6,13,9,22,26,16,42,0.000333,0.062432,6,1123.776768,62.432043,187.296128,76.635041,3,0
0,0,6,6,13,9,22,26,16,42,0.000333,0.062432,6,1123.776768,62.432043,187.296128,76.635041,3,0
0,0,6,6,11,8,19,24,14,38,0.000333,0.053807,5,807.106228,44.839235,161.421246,62.053748,2,0
0,0,6,6,11,8,19,24,14,38,0.000333,0.053807,5,807.106228,44.839235,161.421246,62.053748,2,0
0,0,6,6,13,9,22,26,16,42,0.000333,0.062432,6,1123.776768,62.432043,187.296128,76.635041,3,0
0,0,6,6,11,8,19,24,14,38,0.000333,0.053807,5,807.106228,44.839235,161.421246,62.053748,2,0
0,0,6,6,13,9,22,26,16,42,0.000333,0.062432,6,1123.776768,62.432043,187.296128,76.635041,3,0
0,0,6,6,13,9,22,26,16,42,0.000333,0.062432,6,1123.776768,62.432043,187.296128,76.635041,3,0
0,0,6,6,13,9,22,26,16,42,0.000333,0.062432,6,1123.776768,62.432043,187.296128,76.635041,3,0
0,0,6,6,11,8,19,24,14,38,0.000333,0.053807,5,807.106228,44.839235,161.421246,62.053748,2,0
0,0,6,6,11,8,19,24,14,38,0.000333,0.053807,5,807.106228,44.839235,161.421246,62.053748,2,0
0,0,6,6,13,9,22,26,16,42,0.000333,0.062432,6,1123.776768,62.432043,187.296128,76.635041,3,0
0,0,6,6,11,8,19,24,14,38,0.000333,0.053807,5,807.106228,44.839235,161.421246,62.053748,2,0
0,0,6,6,13,9,22,26,16,42,0.000333,0.062432,6,1123.776768,62.432043,187.296128,76.635041,3,0
0,0,6,6,13,9,22,26,16,42,0.000333,0.062432,6,1123.776768,62.432043,187.296128,76.635041,3,0
0,0,6,6,11,8,19,24,14,38,0.000333,0.053807,5,807.106228,44.839235,161.421246,62.053748,2,0
0,0,6,6,11,8,19,24,14,38,0.000333,0.053807,5,807.106228,44.839235,161.421246,62.053748,2,0
0,0,6,6,13,9,22,26,16,42,0.000333,0.062432,6,1123.776768,62.432043,187.296128,76.635041,3,0
0,0,6,6,13,9,22,26,16,42,0.000333,0.062432,6,1123.776768,62.432043,187.296128,76.635041,3,0
0,0,6,6,13,9,22,26,16,42,0.000333,0.062432,6,1123.776768,62.432043,187.296128,76.635041,3,0
0,0,6,6,11,8,19,24,14,38,0.000333,0.053807,5,807.106228,44.839235,161.421246,62.053748,2,0
0,0,6,6,11,8,19,24,14,38,0.000333,0.053807,5,807.106228,44.839235,161.421246,62.053748,2,0
0,0,6,6,13,9,22,26,16,42,0.000333,0.062432,6,1123.776768,62.432043,187.296128,76.635041,3,0
0,0,6,6,11,8,19,24,14,38,0.000333,0.053807,5,807.106228,44.839235,161.421246,62.053748,2,0
0,0,6,6,11,8,19,24,14,38,0.000333,0.053807,5,807.106228,44.839235,161.421246,62.053748,2,0
0,0,6,6,13,9,22,26,16,42,0.000333,0.062432,6,1123.776768,62.432043,187.296128,76.635041,3,0
0,0,6,6,13,9,22,26,16,42,0.000333,0.062432,6,1123.776768,62.432043,187.296128,76.635041,3,0
0,0,6,6,13,9,22,26,16,42,0.000333,0.062432,6,1123.776768,62.432043,187.296128,76.635041,3,0
0,0,6,6,11,8,19,24,14,38,0.000333,0.053807,5,807.106228,44.839235,161.421246,62.053748,2,0
0,0,6,6,11,8,19,24,14,38,0.000333,0.053807,5,807.106228,44.839235,161.421246,62.053748,2,0
0,0,6,6,13,9,22,26,16,42,0.000333,0.062432,6,1123.776768,62.432043,187.296128,76.635041,3,0
0,0,6,6,13,9,22,26,16,42,0.000333,0.062432,6,1123.776768,62.432043,187.296128,76.635041,3,0
0,0,6,6,11,8,19,24,14,38,0.000333,0.053807,5,807.106228,44.839235,161.421246,62.053748,2,0
0,0,6,6,11,8,19,24,14,38,0.000333,0.053807,5,807.106228,44.839235,161.421246,62.053748,2,0
0,0,6,6,13,9,22,26,16,42,0.000333,0.062432,6,1123.776768,62.432043,187.296128,76.635041,3,0
0,0,6,6,11,8,19,24,14,38,0.000333,0.053807,5,807.106228,44.839235,161.421246,62.053748,2,0
0,0,6,6,13,9,22,26,16,42,0.000333,0.062432,6,1123.776768,62.432043,187.296128,76.635041,3,0
0,0,6,6,13,9,22,26,16,42,0.000333,0.062432,6,1123.776768,62.432043,187.296128,76.635041,3,0
0,0,6,6,11,8,19,24,14,38,0.000333,0.053807,5,807.106228,44.839235,161.421246,62.053748,2,0
0,0,6,6,11,8,19,24,14,38,0.000333,0.053807,5,807.106228,44.839235,161.421246,62.053748,2,0
0,0,6,6,13,9,22,26,16,42,0.000333,0.062432,6,1123.776768,62.432043,187.296128,76.635041,3,0
0,0,6,6,11,8,19,24,14,38,0.000333,0.053807,5,807.106228,44.839235,161.421246,62.053748,2,0
0,0,6,6,13,9,22,26,16,42,0.000333,0.062432,6,1123.776768,62.432043,187.296128,76.635041,3,0
0,0,6,6,11,8,19,24,14,38,0.000333,0.053807,5,807.106228,44.839235,161.421246,62.053748,2,0
0,0,6,6,13,9,22,26,16,42,0.000333,0.062432,6,1123.776768,62.432043,187.296128,76.635041,3,0
0,0,6,6,13,9,22,26,16,42,0.000333,0.062432,6,1123.776768,62.432043,187.296128,76.635041,3,0
0,0,6,6,11,8,19,24,14,38,0.000333,0.053807,5,807.106228,44.839235,161.421246,62.053748,2,0
0,0,6,6,13,9,22,26,16,42,0.000333,0.062432,6,1123.776768,62.432043,187.296128,76.635041,3,0
0,0,6,6,11,8,19,24,14,38,0.000333,0.053807,5,807.106228,44.839235,161.421246,62.053748,2,0
0,0,6,6,13,9,22,26,16,42,0.000333,0.062432,6,1123.776768,62.432043,187.296128,76.635041,3,0
0,0,6,6,11,8,19,24,14,38,0.000333,0.053807,5,807.106228,44.839235,161.421246,62.053748,2,0
0,0,8,8,14,14,28,32,26,58,0.000333,0.092942,7,1951.786098,108.432561,278.826585,106.605938,3,0
0,0,8,8,14,14,28,32,26,58,0.000333,0.092942,7,1951.786098,108.432561,278.826585,106.605938,3,0
0,0,8,8,12,12,24,30,22,52,0.000333,0.079473,6,1430.5083,79.472683,238.41805,86.0391,2,0
0,0,8,8,14,14,28,32,26,58,0.000333,0.092942,7,1951.786098,108.432561,278.826585,106.605938,3,0
0,0,8,8,14,14,28,32,26,58,0.000333,0.092942,7,1951.786098,108.432561,278.826585,106.605938,3,0
0,0,8,8,12,12,24,30,22,52,0.000333,0.079473,6,1430.5083,79.472683,238.41805,86.0391,2,0
0,0,8,8,11,13,24,29,24,53,0.000333,0.081001,5,1215.015063,67.500837,243.003013,86.159464,2,0
0,0,8,8,13,14,27,31,26,57,0.000333,0.090343,6,1626.171526,90.342863,271.028588,101.408685,3,0
0,0,8,8,13,14,27,31,26,57,0.000333,0.090343,6,1626.171526,90.342863,271.028588,101.408685,3,0
0,0,8,8,13,14,27,31,26,57,0.000333,0.090343,6,1626.171526,90.342863,271.028588,101.408685,3,0
0,0,8,8,13,14,27,31,26,57,0.000333,0.090343,6,1626.171526,90.342863,271.028588,101.408685,3,0
0,0,8,8,11,13,24,29,24,53,0.000333,0.081001,5,1215.015063,67.500837,243.003013,86.159464,2,0
0,0,8,8,11,10,21,28,20,48,0.000333,0.070277,10,2108.312363,117.128465,210.831236,71.273029,2,0
0,0,8,8,13,11,24,30,22,52,0.000333,0.079473,12,2861.0166,158.945367,238.41805,86.159464,3,0
0,0,8,8,11,10,21,28,20,48,0.000333,0.070277,10,2108.312363,117.128465,210.831236,71.273029,2,0
0,0,8,8,13,11,24,30,22,52,0.000333,0.079473,12,2861.0166,158.945367,238.41805,86.159464,3,0
0,0,8,8,13,9,22,30,20,50,0.000333,0.074324,12,2675.658971,148.647721,222.971581,76.635041,2,0
0,0,8,8,15,10,25,32,22,54,0.000333,0.083589,14,3510.755279,195.04196,250.768234,91.82264,3,0
0,0,8,8,13,9,22,30,20,50,0.000333,0.074324,12,2675.658971,148.647721,222.971581,76.635041,2,0
0,0,8,8,15,10,25,32,22,54,0.000333,0.083589,14,3510.755279,195.04196,250.768234,91.82264,3,0
0,0,8,8,12,9,21,28,20,48,0.000333,0.070277,12,2529.974836,140.554158,210.831236,71.548875,2,0
0,0,8,8,14,10,24,30,22,52,0.000333,0.079473,14,3337.852701,185.436261,238.41805,86.52225,3,0
0,0,8,8,12,9,21,28,20,48,0.000333,0.070277,12,2529.974836,140.554158,210.831236,71.548875,2,0
0,0,8,8,14,10,24,30,22,52,0.000333,0.079473,14,3337.852701,185.436261,238.41805,86.52225,3,0
0,0,8,8,14,13,27,32,23,55,0.000333,0.087173,7,1830.631688,101.70176,261.518813,101.408685,3,0
0,0,8,8,12,12,24,30,21,51,0.000333,0.077944,6,1402.998525,77.944363,233.833088,86.0391,2,0
0,0,8,8,14,13,27,32,23,55,0.000333,0.087173,7,1830.631688,101.70176,261.518813,101.408685,3,0
0,0,8,8,12,12,24,30,21,51,0.000333,0.077944,6,1402.998525,77.944363,233.833088,86.0391,2,0
0,0,8,8,12,12,24,30,22,52,0.000333,0.079473,6,1430.5083,79.472683,238.41805,86.0391,2,0
0,0,8,8,14,13,27,32,24,56,0.000333,0.088758,7,1863.915901,103.550883,266.2737,101.408685,3,0
0,0,8,8,14,13,27,32,24,56,0.000333,0.088758,7,1863.915901,103.550883,266.2737,101.408685,3,0
0,0,8,8,12,12,24,30,22,52,0.000333,0.079473,6,1430.5083,79.472683,238.41805,86.0391,2,0
0,0,7,7,13,11,24,30,20,50,0.000333,0.076416,6,1375.48875,76.416042,229.248125,86.159464,3,0
0,0,7,7,11,10,21,28,18,46,0.000333,0.067349,5,1010.233007,56.124056,202.046601,71.273029,2,0
0,0,7,7,11,10,21,28,18,46,0.000333,0.067349,5,1010.233007,56.124056,202.046601,71.273029,2,0
0,0,7,7,13,11,24,30,20,50,0.000333,0.076416,6,1375.48875,76.416042,229.248125,86.159464,3,0
0,0,7,7,11,10,21,27,17,44,0.000333,0.064421,5,966.309833,53.68388,193.261967,71.273029,2,0
0,0,7,7,13,11,24,29,19,48,0.000333,0.073359,6,1320.4692,73.3594,220.0782,86.159464,3,0
0,0,7,7,13,11,24,29,19,48,0.000333,0.073359,6,1320.4692,73.3594,220.0782,86.159464,3,0
0,0,7,7,11,10,21,27,17,44,0.000333,0.064421,5,966.309833,53.68388,193.261967,71.273029,2,0
0,0,9,9,13,13,26,37,26,63,0.000333,0.098709,12,3553.532427,197.418468,296.127702,96.211433,2,0
0,0,9,9,15,14,29,39,28,67,0.000333,0.108495,14,4556.786173,253.154787,325.484727,111.906328,3,0
0,0,9,9,15,14,29,39,28,67,0.000333,0.108495,14,4556.786173,253.154787,325.484727,111.906328,3,0
0,0,9,9,13,13,26,37,26,63,0.000333,0.098709,12,3553.532427,197.418468,296.127702,96.211433,2,0
0,0,6,6,13,11,24,26,18,44,0.000333,0.067246,6,1210.4301,67.246117,201.73835,86.159464,3,0
0,0,6,6,11,10,21,24,16,40,0.000333,0.058564,5,878.463485,48.803527,175.692697,71.273029,2,0
0,0,6,6,13,11,24,26,18,44,0.000333,0.067246,6,1210.4301,67.246117,201.73835,86.159464,3,0
0,0,6,6,11,10,21,24,16,40,0.000333,0.058564,5,878.463485,48.803527,175.692697,71.273029,2,0
0,0,8,8,13,13,26,31,24,55,0.000333,0.086175,6,1551.145107,86.174728,258.524184,96.211433,3,0
0,0,8,8,11,12,23,29,22,51,0.000333,0.076901,5,1153.508299,64.083794,230.70166,81.073298,2,0
0,0,8,8,13,13,26,31,24,55,0.000333,0.086175,6,1551.145107,86.174728,258.524184,96.211433,3,0
0,0,8,8,11,12,23,29,22,51,0.000333,0.076901,5,1153.508299,64.083794,230.70166,81.073298,2,0
0,0,9,9,13,14,27,34,27,61,0.000333,0.096683,6,1740.288826,96.682713,290.048138,101.408685,3,0
0,0,9,9,11,13,24,32,25,57,0.000333,0.087114,5,1306.714313,72.59524,261.342863,86.159464,2,0
0,0,9,9,13,14,27,34,27,61,0.000333,0.096683,6,1740.288826,96.682713,290.048138,101.408685,3,0
0,0,9,9,11,13,24,32,25,57,0.000333,0.087114,5,1306.714313,72.59524,261.342863,86.159464,2,0
0,0,10,10,13,15,28,37,30,67,0.000333,0.107364,12,3865.113357,214.72852,322.09278,106.709075,3,0
0,0,10,10,11,14,25,35,28,63,0.000333,0.097521,10,2925.6294,162.534967,292.56294,91.356717,2,0
0,0,10,10,13,15,28,37,30,67,0.000333,0.107364,12,3865.113357,214.72852,322.09278,106.709075,3,0
0,0,10,10,11,14,25,35,28,63,0.000333,0.097521,10,2925.6294,162.534967,292.56294,91.356717,2,0
0,0,11,11,13,16,29,40,33,73,0.000333,0.118211,12,4255.591352,236.421742,354.632613,112.105716,3,0
0,0,11,11,11,15,26,38,31,69,0.000333,0.10811,10,3243.303406,180.183523,324.330341,96.657107,2,0
0,0,11,11,13,16,29,40,33,73,0.000333,0.118211,12,4255.591352,236.421742,354.632613,112.105716,3,0
0,0,11,11,11,15,26,38,31,69,0.000333,0.10811,10,3243.303406,180.183523,324.330341,96.657107,2,0
0,0,7,7,11,10,21,28,18,46,0.000333,0.067349,5,1010.233007,56.124056,202.046601,71.273029,2,0
0,0,7,7,13,11,24,30,20,50,0.000333,0.076416,6,1375.48875,76.416042,229.248125,86.159464,3,0
0,0,7,7,11,10,21,28,18,46,0.000333,0.067349,5,1010.233007,56.124056,202.046601,71.273029,2,0
0,0,7,7,13,11,24,30,20,50,0.000333,0.076416,6,1375.48875,76.416042,229.248125,86.159464,3,0
0,0,7,7,11,10,21,27,17,44,0.000333,0.064421,5,966.309833,53.68388,193.261967,71.273029,2,0
0,0,7,7,13,11,24,29,19,48,0.000333,0.073359,6,1320.4692,73.3594,220.0782,86.159464,3,0
0,0,7,7,11,10,21,27,17,44,0.000333,0.064421,5,966.309833,53.68388,193.261967,71.273029,2,0
0,0,7,7,13,11,24,29,19,48,0.000333,0.073359,6,1320.4692,73.3594,220.0782,86.159464,3,0
0,0,9,9,13,13,26,34,25,59,0.000333,0.092442,6,1663.95566,92.441981,277.325943,96.211433,2,0
0,0,9,9,15,14,29,36,27,63,0.000333,0.102018,7,2142.369619,119.020534,306.052803,111.906328,3,0
0,0,9,9,13,13,26,34,25,59,0.000333,0.092442,6,1663.95566,92.441981,277.325943,96.211433,2,0
0,0,9,9,15,14,29,36,27,63,0.000333,0.102018,7,2142.369619,119.020534,306.052803,111.906328,3,0
0,0,10,10,15,15,30,44,31,75,0.000333,0.122672,14,5152.235125,286.235285,368.016795,117.206718,3,0
0,0,10,10,13,14,27,42,29,71,0.000333,0.112532,12,4051.164152,225.064675,337.597013,101.408685,2,0
0,0,10,10,15,15,30,44,31,75,0.000333,0.122672,14,5152.235125,286.235285,368.016795,117.206718,3,0
0,0,10,10,13,14,27,42,29,71,0.000333,0.112532,12,4051.164152,225.064675,337.597013,101.408685,2,0
0,0,8,8,14,13,27,34,26,60,0.000333,0.095098,14,3994.105502,221.89475,285.29325,101.408685,3,0
0,0,10,10,12,13,25,37,28,65,0.000333,0.100617,12,3622.207828,201.233768,301.850652,91.125266,2,0
0,0,10,10,12,13,25,37,28,65,0.000333,0.100617,12,3622.207828,201.233768,301.850652,91.125266,2,0
0,0,8,8,14,13,27,34,26,60,0.000333,0.095098,14,3994.105502,221.89475,285.29325,101.408685,3,0
0,0,10,10,11,14,25,39,29,68,0.000333,0.105261,10,3157.822209,175.434567,315.782221,91.356717,2,0
0,0,10,10,13,15,28,41,31,72,0.000333,0.115377,12,4153.554653,230.753036,346.129554,106.709075,3,0
0,0,10,10,11,14,25,39,29,68,0.000333,0.105261,10,3157.822209,175.434567,315.782221,91.356717,2,0
0,0,10,10,13,15,28,41,31,72,0.000333,0.115377,12,4153.554653,230.753036,346.129554,106.709075,3,0
0,0,10,10,14,16,30,37,31,68,0.000333,0.111223,7,2335.679924,129.759996,333.668561,117.302969,3,0
0,0,10,10,12,15,27,35,29,64,0.000333,0.101438,6,1825.876801,101.4376,304.3128,101.622909,2,0
0,0,10,10,12,15,27,35,29,64,0.000333,0.101438,6,1825.876801,101.4376,304.3128,101.622909,2,0
0,0,10,10,14,16,30,37,31,68,0.000333,0.111223,7,2335.679924,129.759996,333.668561,117.302969,3,0
0,0,6,6,11,10,21,24,16,40,0.000333,0.058564,5,878.463485,48.803527,175.692697,71.273029,2,0
0,0,6,6,13,11,24,26,18,44,0.000333,0.067246,6,1210.4301,67.246117,201.73835,86.159464,3,0
0,0,6,6,13,11,24,26,18,44,0.000333,0.067246,6,1210.4301,67.246117,201.73835,86.159464,3,0
0,0,6,6,11,10,21,24,16,40,0.000333,0.058564,5,878.463485,48.803527,175.692697,71.273029,2,0
0,0,12,12,14,19,33,58,47,105,0.000333,0.176554,14,7415.259355,411.958853,529.661383,134.013592,3,0
0,0,12,12,13,18,31,56,45,101,0.000333,0.166791,12,6004.485928,333.582552,500.373827,123.164366,2,0
0,0,12,12,14,19,33,58,47,105,0.000333,0.176554,14,7415.259355,411.958853,529.661383,134.013592,3,0
0,0,12,12,13,18,31,56,45,101,0.000333,0.166791,12,6004.485928,333.582552,500.373827,123.164366,2,0
0,0,12,12,14,17,31,48,38,86,0.000333,0.14202,14,5964.852358,331.380687,426.060883,122.789837,3,0
0,0,12,12,13,16,29,46,36,82,0.000333,0.132785,12,4780.253299,265.569628,398.354442,112.105716,2,0
0,0,12,12,14,17,31,48,38,86,0.000333,0.14202,14,5964.852358,331.380687,426.060883,122.789837,3,0
0,0,12,12,13,16,29,46,36,82,0.000333,0.132785,12,4780.253299,265.569628,398.354442,112.105716,2,0
0,0,12,12,13,19,32,50,39,89,0.000333,0.148333,12,5340,296.666667,445,128.816339,3,0
0,0,12,12,12,18,30,48,37,85,0.000333,0.139029,12,5005.028408,278.057134,417.085701,118.0782,2,0
0,0,12,12,13,19,32,50,39,89,0.000333,0.148333,12,5340,296.666667,445,128.816339,3,0
0,0,12,12,12,18,30,48,37,85,0.000333,0.139029,12,5005.028408,278.057134,417.085701,118.0782,2,0
0,0,4,4,9,24,33,34,36,70,0.000333,0.117703,4,1412.430353,78.468353,353.107588,138.568425,2,0
0,0,3,3,8,18,26,28,23,51,0.000333,0.079907,4,958.889703,53.27165,239.722426,99.05865,1,0
0,0,4,4,10,19,29,42,31,73,0.000333,0.118211,5,1773.163063,98.509059,354.632613,113.929904,2,0
0,0,8,8,9,18,27,53,41,94,0.000333,0.148986,8,3575.675402,198.648633,446.959425,103.587975,1,0
0,0,2,2,7,5,12,10,6,16,0.000333,0.01912,3,172.0782,9.5599,57.3594,31.261125,1,0
0,0,7,7,9,14,23,36,22,58,0.000333,0.087456,4,1049.466374,58.303687,262.366593,81.832294,2,0
0,0,4,4,9,10,19,39,17,56,0.000333,0.079295,4,951.535763,52.863098,237.883941,61.748606,5,0
0,0,6,6,9,13,22,58,27,85,0.000333,0.126351,8,3032.413501,168.467417,379.051688,76.635041,6,0
0,0,7,7,9,13,22,61,29,90,0.000333,0.133783,8,3210.790765,178.377265,401.348846,76.635041,6,0
0,0,6,6,9,12,21,57,26,83,0.000333,0.121521,8,2916.498769,162.027709,364.562346,71.548875,6,0
0,0,3,3,9,8,17,27,12,39,0.000333,0.053137,4,637.644203,35.424678,159.411051,52.529325,3,0
0,0,5,5,13,16,29,47,31,78,0.000333,0.126308,6,2273.535106,126.307506,378.922518,112.105716,3,0
0,0,18,18,19,48,67,241,149,390,0.000333,0.788592,27,63875.91918,3548.662176,2365.774784,348.788823,2,0
0,0,17,17,17,25,42,109,68,177,0.000333,0.318147,16,15271.04294,848.391275,954.440184,185.583273,7,0
0,0,2,2,6,6,12,11,7,18,0.000333,0.02151,3,193.587975,10.754888,64.529325,31.01955,1,0
0,0,2,2,7,10,17,18,10,28,0.000333,0.03815,3,343.346879,19.074827,114.44896,52.870765,1,0
0,0,2,2,7,8,15,16,8,24,0.000333,0.031255,3,281.296123,15.627562,93.765374,43.651484,1,0
0,0,2,2,6,6,12,15,6,21,0.000333,0.025095,3,225.852638,12.547369,75.284213,31.01955,1,0
0,0,4,4,18,22,40,48,33,81,0.000333,0.143692,9,3879.685581,215.538088,431.076176,173.166146,4,0
0,0,3,3,15,8,23,26,15,41,0.000333,0.061822,7,1298.262281,72.125682,185.46604,82.603359,2,0
0,0,5,5,14,13,27,49,18,67,0.000333,0.106192,7,2230.042239,123.891235,318.577463,101.408685,4,0
0,0,29,29,24,64,88,217,137,354,0.000333,0.762213,24,54879.33103,3048.851724,2286.638793,494.0391,11,0
0,0,8,8,10,13,23,35,20,55,0.000333,0.082932,5,1243.979538,69.109974,248.795908,81.324997,1,0
0,0,3,3,14,12,26,26,18,44,0.000333,0.06894,7,1447.735433,80.429746,206.819348,96.322519,2,0
0,0,1,1,4,2,6,4,2,6,0.000333,0.00517,2,31.01955,1.723308,15.509775,10,1,0
0,0,4,4,10,10,20,25,13,38,0.000333,0.054744,5,821.166338,45.620352,164.233268,66.438562,1,0
0,0,3,3,17,11,28,29,17,46,0.000333,0.073713,8,1769.106611,98.283701,221.138326,107.540616,3,0
0,0,4,4,9,24,33,34,36,70,0.000333,0.117703,4,1412.430353,78.468353,353.107588,138.568425,2,0
0,0,3,3,8,18,26,28,23,51,0.000333,0.079907,4,958.889703,53.27165,239.722426,99.05865,1,0
0,0,4,4,10,19,29,42,31,73,0.000333,0.118211,5,1773.163063,98.509059,354.632613,113.929904,2,0
0,0,8,8,9,18,27,53,41,94,0.000333,0.148986,8,3575.675402,198.648633,446.959425,103.587975,1,0
0,0,2,2,7,5,12,10,6,16,0.000333,0.01912,3,172.0782,9.5599,57.3594,31.261125,1,0
0,0,7,7,9,14,23,36,22,58,0.000333,0.087456,4,1049.466374,58.303687,262.366593,81.832294,2,0
0,0,4,4,9,10,19,39,17,56,0.000333,0.079295,4,951.535763,52.863098,237.883941,61.748606,5,0
0,0,6,6,9,13,22,58,27,85,0.000333,0.126351,8,3032.413501,168.467417,379.051688,76.635041,6,0
0,0,7,7,9,13,22,61,29,90,0.000333,0.133783,8,3210.790765,178.377265,401.348846,76.635041,6,0
0,0,6,6,9,12,21,57,26,83,0.000333,0.121521,8,2916.498769,162.027709,364.562346,71.548875,6,0
0,0,3,3,9,8,17,27,12,39,0.000333,0.053137,4,637.644203,35.424678,159.411051,52.529325,3,0
0,0,7,7,7,20,27,49,40,89,0.000333,0.141062,6,2539.109926,141.061663,423.184988,106.090046,1,0
0,0,2,2,8,5,13,13,5,18,0.000333,0.022203,4,266.43166,14.801759,66.607915,35.60964,1,0
0,0,2,2,11,6,17,15,9,24,0.000333,0.0327,5,490.495541,27.249752,98.099108,53.563523,2,0
0,0,16,16,25,39,64,119,67,186,0.000333,0.372,12,13392,744,1116,322.227091,9,0
0,0,4,4,15,13,28,30,22,52,0.000333,0.083327,7,1749.877192,97.2154,249.982456,106.709075,2,0
0,0,2,2,7,5,12,30,12,42,0.000333,0.050189,6,903.41055,50.189475,150.568425,31.261125,1,0
0,0,1,1,11,10,21,19,12,31,0.000333,0.045387,5,680.809201,37.822733,136.16184,71.273029,1,0
0,0,1,1,11,10,21,19,12,31,0.000333,0.045387,5,680.809201,37.822733,136.16184,71.273029,1,0
0,0,3,3,12,10,22,23,14,37,0.000333,0.055,6,989.993819,54.999657,164.99897,76.238831,2,0
0,0,2,2,10,16,26,29,22,51,0.000333,0.079907,5,1198.612128,66.589563,239.722426,97.219281,1,0
0,0,4,4,16,12,28,32,18,50,0.000333,0.080123,8,1922.941969,106.830109,240.367746,107.01955,2,0
0,0,4,4,13,13,26,25,17,42,0.000333,0.065806,6,1184.510809,65.806156,197.418468,96.211433,1,0
0,0,10,10,21,25,46,93,61,154,0.000333,0.283543,20,17012.57083,945.142824,850.628541,208.335071,6,0
0,0,20,20,22,30,52,140,76,216,0.000333,0.410432,22,27088.48954,1504.916086,1231.294979,245.314213,11,0
0,0,1,1,9,5,14,10,7,17,0.000333,0.021575,4,258.900135,14.383341,64.725034,40.138965,1,0
0,0,6,6,15,21,36,38,30,68,0.000333,0.117185,7,2460.884301,136.715794,351.5549,150.842025,2,0
0,0,6,6,16,9,25,35,19,54,0.000333,0.083589,16,4012.291748,222.905097,250.768234,92.529325,4,0
0,0,2,2,6,5,11,8,6,14,0.000333,0.016144,3,145.296128,8.072007,48.432043,27.119415,2,0
0,0,8,8,17,10,27,43,22,65,0.000333,0.103023,16,4945.083002,274.726833,309.067688,102.706149,4,0
0,0,1,1,9,5,14,10,7,17,0.000333,0.021575,4,258.900135,14.383341,64.725034,40.138965,1,0
0,0,6,6,10,12,22,24,18,42,0.000333,0.062432,5,936.48064,52.026702,187.296128,76.238831,1,0
0,0,6,6,16,18,34,43,27,70,0.000333,0.118707,8,2848.979191,158.276622,356.122399,139.05865,4,0
0,0,3,3,7,6,13,13,10,23,0.000333,0.02837,3,255.330341,14.185019,85.110114,35.161259,1,0
0,0,47,47,19,23,42,237,167,404,0.000333,0.726165,63,137245.263,7624.736836,2178.496239,184.752548,3,0
0,0,47,47,19,23,42,238,167,405,0.000333,0.727963,63,137584.979,7643.609947,2183.888556,184.752548,3,0
0,0,47,47,19,23,42,237,167,404,0.000333,0.726165,63,137245.263,7624.736836,2178.496239,184.752548,3,0
0,0,47,47,19,23,42,237,167,404,0.000333,0.726165,63,137245.263,7624.736836,2178.496239,184.752548,3,0
0,0,22,22,17,32,49,117,62,179,0.000333,0.335011,8,8040.264497,446.681361,1005.033062,229.486868,9,0
0,0,7,7,14,16,30,63,29,92,0.000333,0.150478,7,3160.037544,175.557641,451.433935,117.302969,4,0
0,0,13,13,14,21,35,57,32,89,0.000333,0.152169,7,3195.54332,177.530184,456.506189,145.541635,5,0
0,0,3,3,9,8,17,23,13,36,0.000333,0.04905,4,588.594649,32.699703,147.148662,52.529325,1,0
0,0,9,9,15,19,34,68,35,103,0.000333,0.17467,7,3668.060709,203.78115,524.008673,139.313982,2,0
0,0,2,2,6,5,11,9,7,16,0.000333,0.01845,3,166.052718,9.225151,55.350906,27.119415,1,0
0,0,5,5,11,12,23,33,21,54,0.000333,0.081424,5,1221.361728,67.853429,244.272346,81.073298,1,0
0,0,11,11,15,21,36,84,43,127,0.000333,0.21886,14,9192.126653,510.673703,656.580475,150.842025,2,0
0,0,20,20,16,24,40,152,83,235,0.000333,0.416884,24,30015.67446,1667.53747,1250.653102,174.0391,3,0
0,0,6,6,16,13,29,44,28,72,0.000333,0.116592,16,5596.394106,310.910784,349.774632,112.105716,2,0
0,0,4,4,10,15,25,32,21,53,0.000333,0.082041,5,1230.62189,68.367883,246.124378,91.82264,1,0
0,0,25,25,12,35,47,382,213,595,0.000333,1.10166,36,118979.2932,6609.960733,3304.980367,222.544456,4,0
0,0,8,8,13,16,29,74,39,113,0.000333,0.182984,12,6587.422229,365.967902,548.951852,112.105716,3,0
0,0,7,7,14,16,30,63,29,92,0.000333,0.150478,7,3160.037544,175.557641,451.433935,117.302969,4,0
0,0,3,3,9,8,17,23,13,36,0.000333,0.04905,4,588.594649,32.699703,147.148662,52.529325,1,0
0,0,6,6,10,11,21,37,21,58,0.000333,0.084918,5,1273.772053,70.765114,254.754411,71.273029,3,0
0,0,8,8,15,18,33,80,41,121,0.000333,0.203457,14,8545.203638,474.733535,610.371688,133.662009,8,0
0,0,2,2,6,7,13,17,9,26,0.000333,0.03207,3,288.634298,16.035239,96.211433,35.161259,1,0
0,0,19,19,17,25,42,154,83,237,0.000333,0.425993,24,30671.5015,1703.972306,1277.979229,185.583273,8,0
0,0,6,6,16,13,29,44,28,72,0.000333,0.116592,16,5596.394106,310.910784,349.774632,112.105716,2,0
0,0,2,2,6,5,11,9,7,16,0.000333,0.01845,3,166.052718,9.225151,55.350906,27.119415,1,0
0,0,6,6,7,11,18,41,25,66,0.000333,0.091738,6,1651.290301,91.73835,275.21505,57.705232,1,0
0,0,23,23,17,43,60,131,77,208,0.000333,0.409544,8,9829.065951,546.05922,1228.633244,302.816253,7,0
0,0,6,6,10,13,23,36,23,59,0.000333,0.088963,5,1334.450777,74.136154,266.890155,81.324997,2,0
0,0,13,13,17,29,46,85,50,135,0.000333,0.24856,8,5965.446913,331.413717,745.680864,210.368317,5,0
0,0,14,14,14,32,46,71,47,118,0.000333,0.21726,7,4562.462176,253.470121,651.780311,213.302969,3,0
0,0,11,11,15,21,36,84,43,127,0.000333,0.21886,14,9192.126653,510.673703,656.580475,150.842025,2,0
0,0,9,9,15,19,34,68,35,103,0.000333,0.17467,7,3668.060709,203.78115,524.008673,139.313982,2,0
0,0,2,2,5,7,12,12,9,21,0.000333,0.025095,2,150.568425,8.364913,75.284213,31.261125,1,0
0,0,14,14,16,22,38,93,46,139,0.000333,0.243154,16,11671.39079,648.410599,729.461924,162.107496,6,0
0,0,5,5,12,11,23,33,16,49,0.000333,0.073885,6,1329.927215,73.884845,221.654536,81.073298,2,0
0,0,11,11,15,21,36,84,43,127,0.000333,0.21886,14,9192.126653,510.673703,656.580475,150.842025,2,0
0,0,9,9,15,19,34,68,35,103,0.000333,0.17467,7,3668.060709,203.78115,524.008673,139.313982,2,0
0,0,5,5,12,11,23,33,16,49,0.000333,0.073885,6,1329.927215,73.884845,221.654536,81.073298,2,0
0,0,14,14,16,22,38,93,46,139,0.000333,0.243154,16,11671.39079,648.410599,729.461924,162.107496,6,0
0,0,9,9,15,19,34,68,35,103,0.000333,0.17467,7,3668.060709,203.78115,524.008673,139.313982,2,0
0,0,1,1,5,4,9,12,4,16,0.000333,0.016906,2,101.4376,5.635422,50.7188,19.60964,1,0
0,0,11,11,15,21,36,84,43,127,0.000333,0.21886,14,9192.126653,510.673703,656.580475,150.842025,2,0
0,0,3,3,9,8,17,23,13,36,0.000333,0.04905,4,588.594649,32.699703,147.148662,52.529325,1,0
0,0,7,7,14,16,30,63,29,92,0.000333,0.150478,7,3160.037544,175.557641,451.433935,117.302969,4,0
0,0,14,14,15,23,38,62,34,96,0.000333,0.167934,7,3526.607289,195.922627,503.801041,162.645284,5,0
0,0,23,23,17,34,51,122,64,186,0.000333,0.35169,8,8440.568909,468.920495,1055.071114,242.460605,9,0
0,0,2,2,6,5,11,9,7,16,0.000333,0.01845,3,166.052718,9.225151,55.350906,27.119415,1,0
0,0,10,10,15,20,35,80,41,121,0.000333,0.206881,14,8689.005431,482.722524,620.643245,145.041921,2,0
0,0,16,16,12,25,37,93,56,149,0.000333,0.258736,12,9314.502618,517.472368,776.208551,159.115955,1,0
0,0,36,36,19,42,61,249,143,392,0.000333,0.77495,27,62770.92398,3487.273554,2324.849036,307.187955,3,0
0,0,32,32,17,35,52,247,138,385,0.000333,0.731556,24,52672.063,2926.225722,2194.669291,249.011774,4,0
0,0,9,9,15,19,34,68,35,103,0.000333,0.17467,7,3668.060709,203.78115,524.008673,139.313982,2,0
0,0,6,6,16,13,29,44,28,72,0.000333,0.116592,16,5596.394106,310.910784,349.774632,112.105716,2,0
0,0,15,15,14,27,41,64,39,103,0.000333,0.183943,7,3862.794995,214.599722,551.827856,181.684931,6,0
0,0,24,24,17,38,55,124,69,193,0.000333,0.371934,8,8926.419398,495.912189,1115.802425,268.908114,10,0
0,0,9,9,15,19,34,68,35,103,0.000333,0.17467,7,3668.060709,203.78115,524.008673,139.313982,2,0
0,0,9,9,15,20,35,72,36,108,0.000333,0.184654,7,3877.737961,215.429887,553.962566,145.041921,2,0
0,0,15,15,15,26,41,64,37,101,0.000333,0.180371,7,3787.789267,210.432737,541.112752,180.814792,5,0
0,0,24,24,17,37,54,124,67,191,0.000333,0.366395,8,8793.468103,488.526006,1099.183513,262.236643,9,0
0,0,11,11,15,21,36,84,43,127,0.000333,0.21886,14,9192.126653,510.673703,656.580475,150.842025,2,0
0,0,1,1,6,5,11,15,5,20,0.000333,0.023063,3,207.565897,11.531439,69.188632,27.119415,1,0
0,0,9,9,15,19,34,68,35,103,0.000333,0.17467,7,3668.060709,203.78115,524.008673,139.313982,2,0
0,0,6,6,10,11,21,37,21,58,0.000333,0.084918,5,1273.772053,70.765114,254.754411,71.273029,2,0
0,0,6,6,7,11,18,41,25,66,0.000333,0.091738,6,1651.290301,91.73835,275.21505,57.705232,1,0
0,0,2,2,5,4,9,11,6,17,0.000333,0.017963,2,107.77745,5.987636,53.888725,19.60964,1,0
0,0,5,5,12,11,23,33,16,49,0.000333,0.073885,6,1329.927215,73.884845,221.654536,81.073298,2,0
0,0,14,14,16,22,38,93,46,139,0.000333,0.243154,16,11671.39079,648.410599,729.461924,162.107496,6,0
0,0,1,1,5,4,9,9,4,13,0.000333,0.013736,2,82.41805,4.578781,41.209025,19.60964,1,0
0,0,11,11,15,21,36,84,43,127,0.000333,0.21886,14,9192.126653,510.673703,656.580475,150.842025,2,0
0,0,9,9,15,19,34,68,35,103,0.000333,0.17467,7,3668.060709,203.78115,524.008673,139.313982,2,0
0,0,13,13,17,29,46,85,50,135,0.000333,0.24856,8,5965.446913,331.413717,745.680864,210.368317,5,0
0,0,18,18,15,30,45,80,46,126,0.000333,0.230658,7,4843.814431,269.100802,691.97349,205.810077,7,0
0,0,27,27,17,40,57,140,76,216,0.000333,0.419968,8,10079.23394,559.957441,1259.904243,282.363992,11,0
0,0,11,11,15,21,36,84,43,127,0.000333,0.21886,14,9192.126653,510.673703,656.580475,150.842025,2,0
0,0,18,18,14,27,41,126,68,194,0.000333,0.346455,14,14551.11125,808.395069,1039.365089,181.684931,7,0
0,0,9,9,15,19,34,68,35,103,0.000333,0.17467,7,3668.060709,203.78115,524.008673,139.313982,2,0
0,0,15,15,15,26,41,66,37,103,0.000333,0.183943,7,3862.794995,214.599722,551.827856,180.814792,5,0
0,0,7,7,14,16,30,63,29,92,0.000333,0.150478,7,3160.037544,175.557641,451.433935,117.302969,4,0
0,0,3,3,9,8,17,23,13,36,0.000333,0.04905,4,588.594649,32.699703,147.148662,52.529325,1,0
0,0,24,24,17,37,54,126,67,193,0.000333,0.370231,8,8885.546303,493.641461,1110.693288,262.236643,9,0
0,0,32,32,19,39,58,213,123,336,0.000333,0.656094,27,53143.60359,2952.422422,1968.281614,286.841309,3,0
0,0,6,6,16,13,29,44,28,72,0.000333,0.116592,16,5596.394106,310.910784,349.774632,112.105716,2,0
0,0,40,40,20,46,66,257,150,407,0.000333,0.820023,30,73802.0522,4100.114011,2460.068407,340.522412,3,0
0,0,9,9,15,19,34,68,35,103,0.000333,0.17467,7,3668.060709,203.78115,524.008673,139.313982,2,0
0,0,21,21,14,29,43,114,70,184,0.000333,0.332811,14,13978.05801,776.558778,998.432715,194.184418,1,0
0,0,11,11,15,21,36,84,43,127,0.000333,0.21886,14,9192.126653,510.673703,656.580475,150.842025,2,0
0,0,2,2,6,5,11,9,7,16,0.000333,0.01845,3,166.052718,9.225151,55.350906,27.119415,1,0
0,0,7,7,14,16,30,63,29,92,0.000333,0.150478,7,3160.037544,175.557641,451.433935,117.302969,4,0
0,0,3,3,9,8,17,23,13,36,0.000333,0.04905,4,588.594649,32.699703,147.148662,52.529325,1,0
0,0,6,6,10,11,21,37,21,58,0.000333,0.084918,5,1273.772053,70.765114,254.754411,71.273029,3,0
0,0,12,12,14,21,35,101,54,155,0.000333,0.265013,14,11130.54415,618.363564,795.038868,145.541635,5,0
0,0,5,5,6,8,14,35,18,53,0.000333,0.067263,6,1210.738865,67.26327,201.789811,39.509775,3,0
0,0,6,6,16,13,29,44,28,72,0.000333,0.116592,16,5596.394106,310.910784,349.774632,112.105716,2,0
0,0,6,6,7,11,18,41,25,66,0.000333,0.091738,6,1651.290301,91.73835,275.21505,57.705232,1,0
0,0,23,23,17,28,45,175,96,271,0.000333,0.496097,24,35719.01254,1984.389585,1488.292189,204.092806,5,0
0,0,2,2,6,5,11,9,7,16,0.000333,0.01845,3,166.052718,9.225151,55.350906,27.119415,1,0
0,0,14,14,16,22,38,93,46,139,0.000333,0.243154,16,11671.39079,648.410599,729.461924,162.107496,6,0
0,0,5,5,12,11,23,33,16,49,0.000333,0.073885,6,1329.927215,73.884845,221.654536,81.073298,2,0
0,0,3,3,9,8,17,23,13,36,0.000333,0.04905,4,588.594649,32.699703,147.148662,52.529325,1,0
0,0,7,7,14,16,30,63,29,92,0.000333,0.150478,7,3160.037544,175.557641,451.433935,117.302969,4,0
0,0,9,9,15,19,34,68,35,103,0.000333,0.17467,7,3668.060709,203.78115,524.008673,139.313982,2,0
0,0,2,2,6,5,11,9,7,16,0.000333,0.01845,3,166.052718,9.225151,55.350906,27.119415,1,0
0,0,11,11,15,21,36,84,43,127,0.000333,0.21886,14,9192.126653,510.673703,656.580475,150.842025,2,0
0,0,6,6,16,13,29,44,28,72,0.000333,0.116592,16,5596.394106,310.910784,349.774632,112.105716,2,0
0,0,8,8,14,17,31,105,40,145,0.000333,0.239453,14,10057.01851,558.723251,718.358465,122.789837,3,0
0,0,19,19,17,24,41,179,82,261,0.000333,0.466107,24,33559.70576,1864.428098,1398.321073,179.525968,3,0
0,0,13,13,14,22,36,56,33,89,0.000333,0.153374,7,3220.863276,178.936849,460.123325,151.410465,5,0
0,0,22,22,17,33,50,116,63,179,0.000333,0.33675,8,8082.002064,449.000115,1010.250258,235.951874,9,0
0,0,9,9,15,20,35,72,36,108,0.000333,0.184654,7,3877.737961,215.429887,553.962566,145.041921,2,0
0,0,9,9,15,19,34,68,35,103,0.000333,0.17467,7,3668.060709,203.78115,524.008673,139.313982,2,0
0,0,14,14,16,22,38,93,46,139,0.000333,0.243154,16,11671.39079,648.410599,729.461924,162.107496,6,0
0,0,5,5,12,11,23,33,16,49,0.000333,0.073885,6,1329.927215,73.884845,221.654536,81.073298,2,0
0,0,9,9,15,19,34,68,35,103,0.000333,0.17467,7,3668.060709,203.78115,524.008673,139.313982,2,0
0,0,20,20,17,34,51,130,84,214,0.000333,0.404633,16,19422.38437,1079.021354,1213.899023,242.460605,3,0
0,0,11,11,15,21,36,84,43,127,0.000333,0.21886,14,9192.126653,510.673703,656.580475,150.842025,2,0
0,0,7,7,14,16,30,63,29,92,0.000333,0.150478,7,3160.037544,175.557641,451.433935,117.302969,4,0
0,0,5,5,12,11,23,33,16,49,0.000333,0.073885,6,1329.927215,73.884845,221.654536,81.073298,2,0
0,0,14,14,16,22,38,93,46,139,0.000333,0.243154,16,11671.39079,648.410599,729.461924,162.107496,6,0
0,0,3,3,9,8,17,23,13,36,0.000333,0.04905,4,588.594649,32.699703,147.148662,52.529325,1,0
0,0,1,1,5,4,9,9,4,13,0.000333,0.013736,2,82.41805,4.578781,41.209025,19.60964,1,0
0,0,6,6,16,13,29,44,28,72,0.000333,0.116592,16,5596.394106,310.910784,349.774632,112.105716,2,0
0,0,19,19,17,24,41,149,82,231,0.000333,0.412532,24,29702.26831,1650.126017,1237.594513,179.525968,3,0
0,0,8,8,14,17,31,75,40,115,0.000333,0.189911,14,7976.25606,443.125337,569.732576,122.789837,3,0
0,0,9,9,15,19,34,68,35,103,0.000333,0.17467,7,3668.060709,203.78115,524.008673,139.313982,2,0
0,0,11,11,15,21,36,84,43,127,0.000333,0.21886,14,9192.126653,510.673703,656.580475,150.842025,2,0
0,0,2,2,6,5,11,9,7,16,0.000333,0.01845,3,166.052718,9.225151,55.350906,27.119415,1,0
0,0,25,25,17,39,56,134,71,205,0.000333,0.396836,8,9524.062072,529.11456,1190.507759,275.617555,9,0
0,0,3,3,9,8,17,23,13,36,0.000333,0.04905,4,588.594649,32.699703,147.148662,52.529325,1,0
0,0,16,16,15,28,43,74,41,115,0.000333,0.208007,7,4368.143128,242.674618,624.020447,193.209297,5,0
0,0,7,7,14,16,30,63,29,92,0.000333,0.150478,7,3160.037544,175.557641,451.433935,117.302969,4,0
0,0,19,19,17,24,41,152,82,234,0.000333,0.417889,24,30088.01206,1671.556225,1253.667169,179.525968,3,0
0,0,6,6,16,13,29,44,28,72,0.000333,0.116592,16,5596.394106,310.910784,349.774632,112.105716,2,0
0,0,9,9,15,19,34,68,35,103,0.000333,0.17467,7,3668.060709,203.78115,524.008673,139.313982,2,0
0,0,2,2,6,5,11,9,7,16,0.000333,0.01845,3,166.052718,9.225151,55.350906,27.119415,1,0
0,0,8,8,14,17,31,78,40,118,0.000333,0.194865,14,8184.332305,454.685128,584.595165,122.789837,3,0
0,0,11,11,15,21,36,84,43,127,0.000333,0.21886,14,9192.126653,510.673703,656.580475,150.842025,2,0
0,0,23,23,17,34,51,122,64,186,0.000333,0.35169,8,8440.568909,468.920495,1055.071114,242.460605,9,0
0,0,3,3,9,8,17,23,13,36,0.000333,0.04905,4,588.594649,32.699703,147.148662,52.529325,1,0
0,0,14,14,15,23,38,62,34,96,0.000333,0.167934,7,3526.607289,195.922627,503.801041,162.645284,5,0
0,0,7,7,14,16,30,63,29,92,0.000333,0.150478,7,3160.037544,175.557641,451.433935,117.302969,4,0
0,0,14,14,11,23,34,85,48,133,0.000333,0.225544,10,6766.325579,375.906977,676.632558,142.095673,1,0
0,0,9,9,15,19,34,68,35,103,0.000333,0.17467,7,3668.060709,203.78115,524.008673,139.313982,2,0
0,0,34,34,18,40,58,241,135,376,0.000333,0.7342,27,59470.22306,3303.901281,2202.600854,287.935774,3,0
0,0,25,25,12,35,47,382,213,595,0.000333,1.10166,36,118979.2932,6609.960733,3304.980367,222.544456,4,0
0,0,30,30,16,33,49,239,130,369,0.000333,0.690609,24,49723.87038,2762.437243,2071.827932,230.465006,4,0
0,0,5,5,11,12,23,33,21,54,0.000333,0.081424,5,1221.361728,67.853429,244.272346,81.073298,1,0
0,0,11,11,15,21,36,84,43,127,0.000333,0.21886,14,9192.126653,510.673703,656.580475,150.842025,2,0
0,0,6,6,16,13,29,44,28,72,0.000333,0.116592,16,5596.394106,310.910784,349.774632,112.105716,2,0
0,0,2,2,6,5,11,9,7,16,0.000333,0.01845,3,166.052718,9.225151,55.350906,27.119415,1,0
0,0,4,4,10,15,25,32,21,53,0.000333,0.082041,5,1230.62189,68.367883,246.124378,91.82264,1,0
0,0,12,12,17,29,46,81,49,130,0.000333,0.239354,8,5744.504434,319.139135,718.063054,210.368317,4,0
0,0,26,26,11,26,37,173,97,270,0.000333,0.468851,15,21098.28613,1172.127007,1406.552409,160.26518,1,0
0,0,12,12,7,18,25,72,44,116,0.000333,0.179562,6,3232.123908,179.562439,538.687318,94.710134,1,0
0,0,7,7,12,18,30,44,29,73,0.000333,0.119401,6,2149.218081,119.401004,358.203013,118.0782,4,0
0,0,3,3,9,8,17,23,13,36,0.000333,0.04905,4,588.594649,32.699703,147.148662,52.529325,1,0
0,0,13,13,14,29,43,71,41,112,0.000333,0.202581,7,4254.191568,236.343976,607.741653,194.184418,6,0
0,0,22,22,17,38,55,131,71,202,0.000333,0.389278,8,9342.677297,519.037628,1167.834662,268.908114,10,0
0,0,2,2,10,4,14,13,6,19,0.000333,0.024113,5,361.698718,20.094373,72.339744,41.219281,2,0
0,0,9,9,15,19,34,68,35,103,0.000333,0.17467,7,3668.060709,203.78115,524.008673,139.313982,2,0
0,0,6,6,16,13,29,44,28,72,0.000333,0.116592,16,5596.394106,310.910784,349.774632,112.105716,2,0
0,0,2,2,7,5,12,13,8,21,0.000333,0.025095,3,225.852638,12.547369,75.284213,31.261125,1,0
0,0,3,3,12,6,18,19,7,26,0.000333,0.036139,6,650.5083,36.13935,108.41805,58.529325,3,0
0,0,4,4,7,8,15,24,15,39,0.000333,0.05079,3,457.1062,25.394789,152.368733,43.651484,2,0
0,0,3,3,12,6,18,15,7,22,0.000333,0.030579,6,550.4301,30.57945,91.73835,58.529325,3,0
0,0,2,2,6,5,11,9,7,16,0.000333,0.01845,3,166.052718,9.225151,55.350906,27.119415,1,0
0,0,3,3,9,5,14,12,6,18,0.000333,0.022844,4,274.129554,15.22942,68.532389,40.138965,2,0
0,0,2,2,12,7,19,19,11,30,0.000333,0.042479,6,764.626952,42.479275,127.437825,62.671034,2,0
0,0,3,3,4,5,9,7,6,13,0.000333,0.013736,2,82.41805,4.578781,41.209025,19.60964,1,0
0,0,9,9,15,25,40,65,38,103,0.000333,0.18272,7,3837.110156,213.172786,548.158594,174.699764,2,0
0,0,11,11,15,21,36,84,43,127,0.000333,0.21886,14,9192.126653,510.673703,656.580475,150.842025,2,0
0,0,3,3,4,5,9,7,6,13,0.000333,0.013736,2,82.41805,4.578781,41.209025,19.60964,1,0
0,0,1,1,7,5,12,8,6,14,0.000333,0.01673,3,150.568425,8.364913,50.189475,31.261125,1,0
0,0,2,2,7,6,13,15,9,24,0.000333,0.029604,3,266.43166,14.801759,88.810553,35.161259,2,0
0,0,7,7,14,16,30,63,29,92,0.000333,0.150478,7,3160.037544,175.557641,451.433935,117.302969,4,0
0,0,14,14,16,22,38,93,46,139,0.000333,0.243154,16,11671.39079,648.410599,729.461924,162.107496,6,0
0,0,3,3,9,8,17,23,13,36,0.000333,0.04905,4,588.594649,32.699703,147.148662,52.529325,1,0
0,0,5,5,12,11,23,33,16,49,0.000333,0.073885,6,1329.927215,73.884845,221.654536,81.073298,2,0
0,0,2,2,6,5,11,9,7,16,0.000333,0.01845,3,166.052718,9.225151,55.350906,27.119415,1,0
0,0,11,11,15,21,36,84,43,127,0.000333,0.21886,14,9192.126653,510.673703,656.580475,150.842025,2,0
0,0,23,23,17,30,47,169,98,267,0.000333,0.494358,24,35593.80536,1977.433631,1483.075223,216.693586,6,0
0,0,9,9,15,19,34,68,35,103,0.000333,0.17467,7,3668.060709,203.78115,524.008673,139.313982,2,0
0,0,5,5,6,10,16,29,20,49,0.000333,0.065333,6,1176,65.333333,196,48.729056,4,0
0,0,6,6,16,13,29,44,28,72,0.000333,0.116592,16,5596.394106,310.910784,349.774632,112.105716,2,0
0,0,12,12,14,23,37,95,56,151,0.000333,0.262209,14,11012.78442,611.821356,786.627458,157.344894,6,0
0,0,14,14,15,25,40,62,36,98,0.000333,0.17385,7,3650.842673,202.824593,521.548953,174.699764,5,0
0,0,23,23,17,36,53,122,66,188,0.000333,0.35895,8,8614.792364,478.599576,1076.849045,255.604168,9,0
0,0,11,11,15,21,36,84,43,127,0.000333,0.21886,14,9192.126653,510.673703,656.580475,150.842025,2,0
0,0,20,20,17,26,43,125,70,195,0.000333,0.352707,16,16929.94604,940.552557,1058.121627,191.698301,2,0
0,0,9,9,15,19,34,68,35,103,0.000333,0.17467,7,3668.060709,203.78115,524.008673,139.313982,2,0
0,0,14,14,15,35,50,84,49,133,0.000333,0.250211,7,5254.430113,291.912784,750.632873,238.128265,7,0
0,0,7,7,12,18,30,44,29,73,0.000333,0.119401,6,2149.218081,119.401004,358.203013,118.0782,4,0
0,0,23,23,17,44,61,144,79,223,0.000333,0.440851,8,10580.43541,587.801967,1322.554426,309.70186,11,0
0,0,3,3,9,8,17,23,13,36,0.000333,0.04905,4,588.594649,32.699703,147.148662,52.529325,1,0
0,0,9,9,15,19,34,68,35,103,0.000333,0.17467,7,3668.060709,203.78115,524.008673,139.313982,2,0
0,0,3,3,4,5,9,7,6,13,0.000333,0.013736,2,82.41805,4.578781,41.209025,19.60964,1,0
0,0,2,2,12,7,19,19,11,30,0.000333,0.042479,6,764.626952,42.479275,127.437825,62.671034,2,0
0,0,1,1,7,5,12,8,6,14,0.000333,0.01673,3,150.568425,8.364913,50.189475,31.261125,1,0
0,0,3,3,4,5,9,7,6,13,0.000333,0.013736,2,82.41805,4.578781,41.209025,19.60964,1,0
0,0,11,11,15,21,36,84,43,127,0.000333,0.21886,14,9192.126653,510.673703,656.580475,150.842025,2,0
0,0,3,3,9,5,14,12,6,18,0.000333,0.022844,4,274.129554,15.22942,68.532389,40.138965,2,0
0,0,24,24,18,36,54,185,103,288,0.000333,0.552469,18,29833.33681,1657.407601,1657.407601,261.17595,4,0
0,0,3,3,12,6,18,19,7,26,0.000333,0.036139,6,650.5083,36.13935,108.41805,58.529325,3,0
0,0,4,4,7,8,15,24,15,39,0.000333,0.05079,3,457.1062,25.394789,152.368733,43.651484,2,0
0,0,2,2,6,5,11,9,7,16,0.000333,0.01845,3,166.052718,9.225151,55.350906,27.119415,1,0
0,0,2,2,8,6,14,15,9,24,0.000333,0.030459,4,365.506073,20.305893,91.376518,39.509775,2,0
0,0,2,2,7,5,12,13,8,21,0.000333,0.025095,3,225.852638,12.547369,75.284213,31.261125,1,0
0,0,2,2,7,6,13,15,9,24,0.000333,0.029604,3,266.43166,14.801759,88.810553,35.161259,2,0
0,0,6,6,16,13,29,44,28,72,0.000333,0.116592,16,5596.394106,310.910784,349.774632,112.105716,2,0
0,0,3,3,12,6,18,15,7,22,0.000333,0.030579,6,550.4301,30.57945,91.73835,58.529325,3,0
0,0,21,21,15,44,59,109,73,182,0.000333,0.35688,7,7494.487245,416.360402,1070.641035,298.81835,6,0
0,0,30,30,17,55,72,169,103,272,0.000333,0.559407,8,13425.7568,745.875378,1678.2196,387.461653,10,0
0,0,24,24,13,34,47,125,81,206,0.000333,0.381415,12,13730.94364,762.830202,1144.245303,221.079453,4,0
0,0,11,11,15,21,36,84,43,127,0.000333,0.21886,14,9192.126653,510.673703,656.580475,150.842025,2,0
0,0,9,9,15,19,34,68,35,103,0.000333,0.17467,7,3668.060709,203.78115,524.008673,139.313982,2,0
0,0,7,7,12,18,30,44,29,73,0.000333,0.119401,6,2149.218081,119.401004,358.203013,118.0782,4,0
0,0,3,3,9,8,17,23,13,36,0.000333,0.04905,4,588.594649,32.699703,147.148662,52.529325,1,0
0,0,14,14,15,35,50,84,49,133,0.000333,0.250211,7,5254.430113,291.912784,750.632873,238.128265,7,0
0,0,23,23,17,44,61,144,79,223,0.000333,0.440851,8,10580.43541,587.801967,1322.554426,309.70186,11,0
0,0,2,2,7,5,12,13,8,21,0.000333,0.025095,3,225.852638,12.547369,75.284213,31.261125,1,0
0,0,3,3,4,5,9,7,6,13,0.000333,0.013736,2,82.41805,4.578781,41.209025,19.60964,1,0
0,0,2,2,12,7,19,19,11,30,0.000333,0.042479,6,764.626952,42.479275,127.437825,62.671034,2,0
0,0,1,1,7,5,12,8,6,14,0.000333,0.01673,3,150.568425,8.364913,50.189475,31.261125,1,0
0,0,2,2,7,6,13,15,9,24,0.000333,0.029604,3,266.43166,14.801759,88.810553,35.161259,2,0
0,0,3,3,4,5,9,7,6,13,0.000333,0.013736,2,82.41805,4.578781,41.209025,19.60964,1,0
0,0,3,3,9,5,14,12,6,18,0.000333,0.022844,4,274.129554,15.22942,68.532389,40.138965,2,0
0,0,9,9,15,19,34,68,35,103,0.000333,0.17467,7,3668.060709,203.78115,524.008673,139.313982,2,0
0,0,3,3,12,6,18,19,7,26,0.000333,0.036139,6,650.5083,36.13935,108.41805,58.529325,3,0
0,0,4,4,7,8,15,24,15,39,0.000333,0.05079,3,457.1062,25.394789,152.368733,43.651484,2,0
0,0,2,2,6,5,11,9,7,16,0.000333,0.01845,3,166.052718,9.225151,55.350906,27.119415,1,0
0,0,2,2,8,6,14,15,9,24,0.000333,0.030459,4,365.506073,20.305893,91.376518,39.509775,2,0
0,0,11,11,15,21,36,84,43,127,0.000333,0.21886,14,9192.126653,510.673703,656.580475,150.842025,2,0
0,0,30,30,17,40,57,221,123,344,0.000333,0.668838,24,48156.33996,2675.35222,2006.514165,282.363992,3,0
0,0,6,6,16,13,29,44,28,72,0.000333,0.116592,16,5596.394106,310.910784,349.774632,112.105716,2,0
0,0,3,3,12,6,18,15,7,22,0.000333,0.030579,6,550.4301,30.57945,91.73835,58.529325,3,0
0,0,6,6,10,11,21,37,21,58,0.000333,0.084918,5,1273.772053,70.765114,254.754411,71.273029,2,0
0,0,6,6,7,11,18,41,25,66,0.000333,0.091738,6,1651.290301,91.73835,275.21505,57.705232,1,0
0,0,15,15,16,30,46,108,66,174,0.000333,0.320367,16,15377.59649,854.310916,961.09978,211.206718,4,0
0,0,1,1,5,4,9,9,4,13,0.000333,0.013736,2,82.41805,4.578781,41.209025,19.60964,2,0
0,0,14,14,15,24,39,63,35,98,0.000333,0.172656,7,3625.785922,201.432551,517.969417,168.642459,7,0
0,0,7,7,14,16,30,63,29,92,0.000333,0.150478,7,3160.037544,175.557641,451.433935,117.302969,4,0
0,0,23,23,17,35,52,123,65,188,0.000333,0.357228,8,8573.461336,476.303408,1071.682667,249.011774,11,0
0,0,3,3,9,8,17,23,13,36,0.000333,0.04905,4,588.594649,32.699703,147.148662,52.529325,1,0
0,0,2,2,6,5,11,9,7,16,0.000333,0.01845,3,166.052718,9.225151,55.350906,27.119415,1,0
0,0,9,9,15,19,34,68,35,103,0.000333,0.17467,7,3668.060709,203.78115,524.008673,139.313982,2,0
0,0,39,39,21,43,64,277,151,428,0.000333,0.856,30,77040,4280,2568,325.56805,12,0
0,0,11,11,15,21,36,84,43,127,0.000333,0.21886,14,9192.126653,510.673703,656.580475,150.842025,2,0
0,0,19,19,15,24,39,121,64,185,0.000333,0.325933,14,13689.19175,760.510653,977.79941,168.642459,10,0
0,0,32,32,19,36,55,254,134,388,0.000333,0.747723,27,60565.52436,3364.751353,2243.167569,266.827923,13,0
0,0,6,6,16,13,29,44,28,72,0.000333,0.116592,16,5596.394106,310.910784,349.774632,112.105716,2,0
0,0,26,26,18,47,65,137,90,227,0.000333,0.455692,9,12303.69744,683.538747,1367.077494,336.124326,5,0
0,0,36,36,20,58,78,201,123,324,0.000333,0.678823,20,40729.40638,2262.744799,2036.470319,426.20146,9,0
0,0,9,9,15,19,34,68,35,103,0.000333,0.17467,7,3668.060709,203.78115,524.008673,139.313982,2,0
0,0,24,24,12,35,47,159,90,249,0.000333,0.461031,12,16597.11149,922.061749,1383.092624,222.544456,1,0
0,0,11,11,15,21,36,84,43,127,0.000333,0.21886,14,9192.126653,510.673703,656.580475,150.842025,2,0
0,0,3,3,9,8,17,23,13,36,0.000333,0.04905,4,588.594649,32.699703,147.148662,52.529325,1,0
0,0,9,9,15,19,34,68,35,103,0.000333,0.17467,7,3668.060709,203.78115,524.008673,139.313982,2,0
0,0,14,14,14,21,35,120,62,182,0.000333,0.311177,14,13069.41313,726.078507,933.529509,145.541635,3,0
0,0,2,2,6,5,11,9,7,16,0.000333,0.01845,3,166.052718,9.225151,55.350906,27.119415,1,0
0,0,11,11,15,21,36,84,43,127,0.000333,0.21886,14,9192.126653,510.673703,656.580475,150.842025,2,0
0,0,6,6,16,13,29,44,28,72,0.000333,0.116592,16,5596.394106,310.910784,349.774632,112.105716,2,0
0,0,24,24,17,38,55,124,69,193,0.000333,0.371934,8,8926.419398,495.912189,1115.802425,268.908114,9,0
0,0,13,13,17,29,46,85,50,135,0.000333,0.24856,8,5965.446913,331.413717,745.680864,210.368317,5,0
0,0,15,15,14,27,41,64,39,103,0.000333,0.183943,7,3862.794995,214.599722,551.827856,181.684931,5,0
0,0,9,9,15,19,34,68,35,103,0.000333,0.17467,7,3668.060709,203.78115,524.008673,139.313982,2,0
0,0,11,11,15,21,36,84,43,127,0.000333,0.21886,14,9192.126653,510.673703,656.580475,150.842025,2,0
0,0,24,24,16,37,53,143,94,237,0.000333,0.452506,16,21720.27436,1206.681909,1357.517148,256.749775,3,0
0,0,22,22,17,33,50,116,63,179,0.000333,0.33675,8,8082.002064,449.000115,1010.250258,235.951874,9,0
0,0,13,13,17,29,46,85,50,135,0.000333,0.24856,8,5965.446913,331.413717,745.680864,210.368317,5,0
0,0,13,13,14,22,36,56,33,89,0.000333,0.153374,7,3220.863276,178.936849,460.123325,151.410465,5,0
0,0,9,9,15,19,34,68,35,103,0.000333,0.17467,7,3668.060709,203.78115,524.008673,139.313982,2,0
0,0,5,5,11,12,23,33,21,54,0.000333,0.081424,5,1221.361728,67.853429,244.272346,81.073298,1,0
0,0,11,11,15,21,36,84,43,127,0.000333,0.21886,14,9192.126653,510.673703,656.580475,150.842025,2,0
0,0,25,25,12,35,47,382,213,595,0.000333,1.10166,36,118979.2932,6609.960733,3304.980367,222.544456,4,0
0,0,4,4,10,15,25,32,21,53,0.000333,0.082041,5,1230.62189,68.367883,246.124378,91.82264,1,0
0,0,16,16,16,30,46,111,67,178,0.000333,0.327731,16,15731.10445,873.950247,983.194028,211.206718,3,0
0,0,25,25,20,66,86,171,115,286,0.000333,0.612637,10,18379.1172,1021.062067,1837.91172,485.368574,5,0
0,0,37,37,20,74,94,243,154,397,0.000333,0.867391,20,52043.43548,2891.301971,2602.171774,545.938111,9,0
0,0,9,9,15,19,34,68,35,103,0.000333,0.17467,7,3668.060709,203.78115,524.008673,139.313982,2,0
0,0,11,11,15,21,36,84,43,127,0.000333,0.21886,14,9192.126653,510.673703,656.580475,150.842025,2,0
0,0,15,15,14,21,35,677,52,729,0.000333,1.246416,14,52349.46247,2908.303471,3739.247319,145.541635,2,0
0,0,7,7,14,16,30,63,29,92,0.000333,0.150478,7,3160.037544,175.557641,451.433935,117.302969,4,0
0,0,27,27,16,37,53,239,126,365,0.000333,0.696897,24,50176.58318,2787.587955,2090.690966,256.749775,13,0
0,0,4,4,10,11,21,30,18,48,0.000333,0.070277,5,1054.156181,58.564232,210.831236,71.273029,1,0
0,0,36,36,17,42,59,291,151,442,0.000333,0.866709,24,62403.07747,3466.837637,2600.128228,295.9642,17,0
0,0,3,3,8,6,14,17,11,28,0.000333,0.035535,4,426.423751,23.690208,106.605938,39.509775,1,0
0,0,12,12,7,18,25,72,44,116,0.000333,0.179562,6,3232.123908,179.562439,538.687318,94.710134,1,0
0,0,6,6,16,13,29,44,28,72,0.000333,0.116592,16,5596.394106,310.910784,349.774632,112.105716,2,0
0,0,25,25,12,24,36,178,96,274,0.000333,0.472186,24,33997.42681,1888.745934,1416.55945,153.05865,7,0
0,0,44,44,16,39,55,326,180,506,0.000333,0.975123,32,93611.77648,5200.654249,2925.368015,270.130687,7,0
0,0,36,36,15,33,48,291,158,449,0.000333,0.835883,28,70214.14856,3900.786031,2507.648163,225.068365,8,0
0,0,8,8,14,16,30,66,31,97,0.000333,0.158656,7,3331.778714,185.098817,475.968388,117.302969,4,0
0,0,4,4,10,10,20,31,17,48,0.000333,0.069151,5,1037.262743,57.625708,207.452549,66.438562,1,0
0,0,30,30,18,42,60,240,134,374,0.000333,0.736392,27,59647.78123,3313.765624,2209.177083,301.535982,10,0
0,0,17,17,17,32,49,79,47,126,0.000333,0.235818,8,5659.627523,314.423751,707.45344,229.486868,5,0
0,0,26,26,18,41,59,138,77,215,0.000333,0.421589,9,11382.9143,632.384128,1264.768256,294.718282,9,0
0,0,18,18,11,28,39,116,64,180,0.000333,0.317124,10,9513.723994,528.540222,951.372399,172.659686,1,0
0,0,33,33,13,38,51,202,119,321,0.000333,0.60695,18,32775.27363,1820.848535,1820.848535,247.526962,1,0
0,0,9,9,15,20,35,72,36,108,0.000333,0.184654,7,3877.737961,215.429887,553.962566,145.041921,2,0
0,0,3,3,8,6,14,17,11,28,0.000333,0.035535,4,426.423751,23.690208,106.605938,39.509775,1,0
0,0,52,52,20,54,74,345,199,544,0.000333,1.125981,30,101338.2789,5629.904385,3377.942631,397.202487,3,0
0,0,35,35,18,46,64,231,135,366,0.000333,0.732,18,39528,2196,2196,329.1425,3,0
0,0,6,6,16,13,29,44,28,72,0.000333,0.116592,16,5596.394106,310.910784,349.774632,112.105716,2,0
0,0,9,9,15,19,34,68,35,103,0.000333,0.17467,7,3668.060709,203.78115,524.008673,139.313982,2,0
0,0,6,6,13,13,26,42,21,63,0.000333,0.098709,6,1776.766213,98.709234,296.127702,96.211433,2,0
0,0,15,15,16,22,38,101,51,152,0.000333,0.265895,16,12762.95971,709.053317,797.684982,162.107496,6,0
0,0,8,8,14,16,30,66,31,97,0.000333,0.158656,7,3331.778714,185.098817,475.968388,117.302969,4,0
0,0,4,4,10,10,20,31,17,48,0.000333,0.069151,5,1037.262743,57.625708,207.452549,66.438562,1,0
0,0,3,3,8,6,14,17,11,28,0.000333,0.035535,4,426.423751,23.690208,106.605938,39.509775,1,0
0,0,22,22,16,28,44,155,91,246,0.000333,0.447673,24,32232.48428,1790.693571,1343.020178,198.605938,8,0
0,0,11,11,13,21,34,81,49,130,0.000333,0.220457,12,7936.442032,440.913446,661.370169,140.344382,8,0
0,0,11,11,15,21,36,84,43,127,0.000333,0.21886,14,9192.126653,510.673703,656.580475,150.842025,2,0
0,0,9,9,15,19,34,68,35,103,0.000333,0.17467,7,3668.060709,203.78115,524.008673,139.313982,2,0
0,0,6,6,16,13,29,44,28,72,0.000333,0.116592,16,5596.394106,310.910784,349.774632,112.105716,2,0
0,0,4,4,10,10,20,31,17,48,0.000333,0.069151,5,1037.262743,57.625708,207.452549,66.438562,1,0
0,0,9,9,12,20,32,53,35,88,0.000333,0.146667,6,2640,146.666667,440,129.458112,5,0
0,0,2,2,8,6,14,15,9,24,0.000333,0.030459,4,365.506073,20.305893,91.376518,39.509775,2,0
0,0,3,3,12,6,18,15,7,22,0.000333,0.030579,6,550.4301,30.57945,91.73835,58.529325,3,0
0,0,2,2,12,7,19,19,11,30,0.000333,0.042479,6,764.626952,42.479275,127.437825,62.671034,2,0
0,0,3,3,4,5,9,7,6,13,0.000333,0.013736,2,82.41805,4.578781,41.209025,19.60964,1,0
0,0,6,6,16,13,29,44,28,72,0.000333,0.116592,16,5596.394106,310.910784,349.774632,112.105716,2,0
0,0,4,4,7,8,15,24,15,39,0.000333,0.05079,3,457.1062,25.394789,152.368733,43.651484,2,0
0,0,2,2,7,6,13,15,9,24,0.000333,0.029604,3,266.43166,14.801759,88.810553,35.161259,2,0
0,0,3,3,9,5,14,12,6,18,0.000333,0.022844,4,274.129554,15.22942,68.532389,40.138965,2,0
0,0,2,2,7,5,12,13,8,21,0.000333,0.025095,3,225.852638,12.547369,75.284213,31.261125,1,0
0,0,1,1,7,5,12,8,6,14,0.000333,0.01673,3,150.568425,8.364913,50.189475,31.261125,1,0
0,0,3,3,12,6,18,19,7,26,0.000333,0.036139,6,650.5083,36.13935,108.41805,58.529325,3,0
0,0,3,3,8,6,14,17,11,28,0.000333,0.035535,4,426.423751,23.690208,106.605938,39.509775,1,0
0,0,3,3,4,5,9,7,6,13,0.000333,0.013736,2,82.41805,4.578781,41.209025,19.60964,1,0
0,0,6,6,13,13,26,42,21,63,0.000333,0.098709,6,1776.766213,98.709234,296.127702,96.211433,2,0
0,0,15,15,16,22,38,101,51,152,0.000333,0.265895,16,12762.95971,709.053317,797.684982,162.107496,6,0
0,0,8,8,14,16,30,66,31,97,0.000333,0.158656,7,3331.778714,185.098817,475.968388,117.302969,4,0
0,0,4,4,10,10,20,31,17,48,0.000333,0.069151,5,1037.262743,57.625708,207.452549,66.438562,1,0
0,0,3,3,8,6,14,17,11,28,0.000333,0.035535,4,426.423751,23.690208,106.605938,39.509775,1,0
0,0,11,11,15,21,36,84,43,127,0.000333,0.21886,14,9192.126653,510.673703,656.580475,150.842025,2,0
0,0,9,9,16,21,37,80,46,126,0.000333,0.218797,16,10502.25799,583.458777,656.391124,156.238666,3,0
0,0,9,9,15,19,34,68,35,103,0.000333,0.17467,7,3668.060709,203.78115,524.008673,139.313982,2,0
0,0,3,3,10,9,19,20,13,33,0.000333,0.046727,5,700.90804,38.939336,140.181608,61.748606,2,0
0,0,6,6,16,13,29,44,28,72,0.000333,0.116592,16,5596.394106,310.910784,349.774632,112.105716,2,0
0,0,20,20,19,28,47,154,88,242,0.000333,0.44807,27,36293.68356,2016.315753,1344.210502,215.316561,3,0
0,0,19,19,9,22,31,125,69,194,0.000333,0.320371,12,11533.36901,640.742723,961.114084,126.636821,17,0
0,0,12,12,7,18,25,72,44,116,0.000333,0.179562,6,3232.123908,179.562439,538.687318,94.710134,11,0
0,0,4,4,10,10,20,31,17,48,0.000333,0.069151,5,1037.262743,57.625708,207.452549,66.438562,1,0
0,0,8,8,14,16,30,66,31,97,0.000333,0.158656,7,3331.778714,185.098817,475.968388,117.302969,4,0
0,0,7,7,10,13,23,39,24,63,0.000333,0.094995,5,1424.922016,79.162334,284.984403,81.324997,2,0
0,0,9,9,16,18,34,229,42,271,0.000333,0.459567,16,22059.23888,1225.513271,1378.70243,139.05865,3,0
0,0,6,6,7,11,18,41,25,66,0.000333,0.091738,6,1651.290301,91.73835,275.21505,57.705232,1,0
0,0,19,19,18,24,42,300,82,382,0.000333,0.686622,27,55616.3619,3089.797883,2059.865256,185.09775,3,0
0,0,6,6,16,13,29,44,28,72,0.000333,0.116592,16,5596.394106,310.910784,349.774632,112.105716,2,0
0,0,4,4,7,9,16,227,16,243,0.000333,0.324,3,2916,162,972,48.180809,1,0
0,0,3,3,8,6,14,17,11,28,0.000333,0.035535,4,426.423751,23.690208,106.605938,39.509775,1,0
0,0,33,33,18,45,63,165,109,274,0.000333,0.545925,18,29479.94458,1637.774699,1637.774699,322.192039,9,0
0,0,31,31,18,49,67,167,97,264,0.000333,0.533816,9,14413.02792,800.723773,1601.447546,350.179432,11,0
0,0,9,9,15,19,34,68,35,103,0.000333,0.17467,7,3668.060709,203.78115,524.008673,139.313982,2,0
0,0,11,11,15,21,36,84,43,127,0.000333,0.21886,14,9192.126653,510.673703,656.580475,150.842025,2,0
0,0,18,18,16,24,40,547,64,611,0.000333,1.083899,16,52027.16906,2890.398281,3251.698066,174.0391,16,0
0,0,13,13,17,29,46,85,50,135,0.000333,0.24856,8,5965.446913,331.413717,745.680864,210.368317,5,0
0,0,7,7,10,13,23,39,24,63,0.000333,0.094995,5,1424.922016,79.162334,284.984403,81.324997,2,0
0,0,15,15,16,30,46,108,66,174,0.000333,0.320367,16,15377.59649,854.310916,961.09978,211.206718,3,0
0,0,3,3,8,8,16,17,11,28,0.000333,0.037333,4,448,24.888889,112,48,2,0
0,0,6,6,7,11,18,41,25,66,0.000333,0.091738,6,1651.290301,91.73835,275.21505,57.705232,1,0
0,0,16,16,16,28,44,75,42,117,0.000333,0.212918,8,5110.027995,283.890444,638.753499,198.605938,5,0
0,0,25,25,17,38,55,134,72,206,0.000333,0.396987,8,9527.680808,529.3156,1190.960101,268.908114,9,0
0,0,5,5,11,12,23,36,21,57,0.000333,0.085948,5,1289.215157,71.623064,257.843031,81.073298,1,0
0,0,8,8,14,16,30,66,31,97,0.000333,0.158656,7,3331.778714,185.098817,475.968388,117.302969,4,0
0,0,6,6,16,13,29,44,28,72,0.000333,0.116592,16,5596.394106,310.910784,349.774632,112.105716,2,0
0,0,3,3,8,6,14,17,11,28,0.000333,0.035535,4,426.423751,23.690208,106.605938,39.509775,1,0
0,0,11,11,15,21,36,84,43,127,0.000333,0.21886,14,9192.126653,510.673703,656.580475,150.842025,2,0
0,0,9,9,15,19,34,68,35,103,0.000333,0.17467,7,3668.060709,203.78115,524.008673,139.313982,2,0
0,0,25,25,19,35,54,163,97,260,0.000333,0.498757,18,26932.87351,1496.270751,1496.270751,260.235528,4,0
0,0,36,36,21,42,63,228,136,364,0.000333,0.725243,30,65271.89677,3626.216487,2175.729892,318.715998,4,0
0,0,17,17,14,23,37,85,56,141,0.000333,0.244844,14,10283.46094,571.303386,734.532925,157.344894,2,0
0,0,14,14,16,33,49,86,57,143,0.000333,0.267635,8,6423.228062,356.846003,802.903508,230.465006,5,0
0,0,22,22,18,33,51,132,70,202,0.000333,0.381943,18,20624.93854,1145.829919,1145.829919,241.523656,10,0
0,0,2,2,12,7,19,19,11,30,0.000333,0.042479,6,764.626952,42.479275,127.437825,62.671034,2,0
0,0,3,3,4,5,9,7,6,13,0.000333,0.013736,2,82.41805,4.578781,41.209025,19.60964,1,0
0,0,2,2,7,5,12,13,8,21,0.000333,0.025095,3,225.852638,12.547369,75.284213,31.261125,1,0
0,0,3,3,9,5,14,12,6,18,0.000333,0.022844,4,274.129554,15.22942,68.532389,40.138965,2,0
0,0,2,2,7,6,13,15,9,24,0.000333,0.029604,3,266.43166,14.801759,88.810553,35.161259,2,0
0,0,3,3,12,6,18,15,7,22,0.000333,0.030579,6,550.4301,30.57945,91.73835,58.529325,3,0
0,0,3,3,4,5,9,7,6,13,0.000333,0.013736,2,82.41805,4.578781,41.209025,19.60964,1,0
0,0,3,3,12,6,18,19,7,26,0.000333,0.036139,6,650.5083,36.13935,108.41805,58.529325,3,0
0,0,4,4,7,8,15,24,15,39,0.000333,0.05079,3,457.1062,25.394789,152.368733,43.651484,2,0
0,0,2,2,8,6,14,15,9,24,0.000333,0.030459,4,365.506073,20.305893,91.376518,39.509775,2,0
0,0,9,9,15,19,34,68,35,103,0.000333,0.17467,7,3668.060709,203.78115,524.008673,139.313982,2,0
0,0,1,1,7,5,12,8,6,14,0.000333,0.01673,3,150.568425,8.364913,50.189475,31.261125,1,0
0,0,11,11,15,21,36,84,43,127,0.000333,0.21886,14,9192.126653,510.673703,656.580475,150.842025,2,0
0,0,15,15,16,27,43,71,41,112,0.000333,0.202581,8,4861.93322,270.107401,607.741653,192.381963,5,0
0,0,24,24,17,36,53,130,71,201,0.000333,0.383771,8,9210.496091,511.694227,1151.312011,255.604168,9,0
0,0,4,4,10,15,25,32,21,53,0.000333,0.082041,5,1230.62189,68.367883,246.124378,91.82264,1,0
0,0,9,9,15,20,35,72,36,108,0.000333,0.184654,7,3877.737961,215.429887,553.962566,145.041921,2,0
0,0,5,5,11,12,23,33,21,54,0.000333,0.081424,5,1221.361728,67.853429,244.272346,81.073298,1,0
0,0,9,9,15,19,34,68,35,103,0.000333,0.17467,7,3668.060709,203.78115,524.008673,139.313982,2,0
0,0,25,25,12,35,47,382,213,595,0.000333,1.10166,36,118979.2932,6609.960733,3304.980367,222.544456,4,0
0,0,11,11,12,18,30,69,40,109,0.000333,0.178284,12,6418.212899,356.567383,534.851075,118.0782,2,0
0,0,6,6,13,13,26,42,21,63,0.000333,0.098709,6,1776.766213,98.709234,296.127702,96.211433,2,0
0,0,15,15,16,22,38,101,51,152,0.000333,0.265895,16,12762.95971,709.053317,797.684982,162.107496,6,0
0,0,8,8,14,16,30,66,31,97,0.000333,0.158656,7,3331.778714,185.098817,475.968388,117.302969,4,0
0,0,4,4,10,10,20,31,17,48,0.000333,0.069151,5,1037.262743,57.625708,207.452549,66.438562,1,0
0,0,6,6,16,13,29,44,28,72,0.000333,0.116592,16,5596.394106,310.910784,349.774632,112.105716,2,0
0,0,22,22,17,28,45,163,92,255,0.000333,0.466808,24,33610.14095,1867.230053,1400.42254,204.092806,3,0
0,0,9,9,15,20,35,72,36,108,0.000333,0.184654,7,3877.737961,215.429887,553.962566,145.041921,2,0
0,0,3,3,8,6,14,17,11,28,0.000333,0.035535,4,426.423751,23.690208,106.605938,39.509775,1,0
0,0,9,9,15,19,34,68,35,103,0.000333,0.17467,7,3668.060709,203.78115,524.008673,139.313982,2,0
0,0,11,11,14,21,35,89,50,139,0.000333,0.237657,14,9981.584751,554.532486,712.970339,145.541635,3,0
0,0,15,15,16,26,42,72,40,112,0.000333,0.201313,8,4831.516411,268.417578,603.939551,186.211433,5,0
0,0,24,24,17,35,52,131,70,201,0.000333,0.381929,16,18332.61413,1018.478563,1145.788383,249.011774,9,0
0,0,4,4,10,10,20,31,17,48,0.000333,0.069151,5,1037.262743,57.625708,207.452549,66.438562,1,0
0,0,8,8,14,16,30,66,31,97,0.000333,0.158656,7,3331.778714,185.098817,475.968388,117.302969,4,0
0,0,9,9,15,19,34,68,35,103,0.000333,0.17467,7,3668.060709,203.78115,524.008673,139.313982,2,0
0,0,6,6,16,13,29,44,28,72,0.000333,0.116592,16,5596.394106,310.910784,349.774632,112.105716,2,0
0,0,32,32,19,36,55,242,134,376,0.000333,0.724597,27,58692.36381,3260.686878,2173.791252,266.827923,5,0
0,0,19,19,15,25,40,109,64,173,0.000333,0.306898,14,12889.70985,716.094991,920.69356,174.699764,2,0
0,0,39,39,21,43,64,265,151,416,0.000333,0.832,30,74880,4160,2496,325.56805,4,0
0,0,3,3,8,6,14,17,11,28,0.000333,0.035535,4,426.423751,23.690208,106.605938,39.509775,1,0
0,0,11,11,15,21,36,84,43,127,0.000333,0.21886,14,9192.126653,510.673703,656.580475,150.842025,2,0
0,0,18,18,16,34,50,83,50,133,0.000333,0.250211,8,6005.062986,333.61461,750.632873,236.973737,5,0
0,0,27,27,17,43,60,142,80,222,0.000333,0.43711,8,10490.6377,582.813205,1311.329712,302.816253,9,0
0,0,13,13,17,29,46,85,50,135,0.000333,0.24856,8,5965.446913,331.413717,745.680864,210.368317,5,0
0,0,11,11,15,21,36,84,43,127,0.000333,0.21886,14,9192.126653,510.673703,656.580475,150.842025,2,0
0,0,22,22,19,37,56,139,91,230,0.000333,0.445231,18,24042.44938,1335.691632,1335.691632,273.460397,3,0
0,0,5,5,9,12,21,26,19,45,0.000333,0.065885,4,790.617136,43.923174,197.654284,71.548875,1,0
0,0,9,9,15,19,34,68,35,103,0.000333,0.17467,7,3668.060709,203.78115,524.008673,139.313982,2,0
0,0,23,23,19,42,61,128,85,213,0.000333,0.421082,18,22738.44695,1263.247053,1263.247053,307.187955,5,0
0,0,32,32,20,51,71,187,115,302,0.000333,0.619075,20,37144.4726,2063.581811,1857.22363,375.732254,9,0
0,0,9,9,15,19,34,68,35,103,0.000333,0.17467,7,3668.060709,203.78115,524.008673,139.313982,2,0
0,0,11,11,15,21,36,84,43,127,0.000333,0.21886,14,9192.126653,510.673703,656.580475,150.842025,2,0
0,0,4,4,10,10,20,31,17,48,0.000333,0.069151,5,1037.262743,57.625708,207.452549,66.438562,1,0
0,0,29,29,18,38,56,232,129,361,0.000333,0.698818,27,56604.28843,3144.68269,2096.455127,274.479896,16,0
0,0,8,8,14,16,30,66,31,97,0.000333,0.158656,7,3331.778714,185.098817,475.968388,117.302969,4,0
0,0,23,23,14,28,42,178,102,280,0.000333,0.503283,21,31706.82645,1761.490358,1509.848878,187.908907,9,0
0,0,11,11,8,16,24,61,40,101,0.000333,0.15436,8,3704.649701,205.813872,463.081213,88,1,0
0,0,6,6,16,13,29,44,28,72,0.000333,0.116592,16,5596.394106,310.910784,349.774632,112.105716,2,0
0,0,33,33,17,34,51,237,136,373,0.000333,0.705272,32,67706.06888,3761.448271,2115.814653,242.460605,8,0
0,0,3,3,8,6,14,17,11,28,0.000333,0.035535,4,426.423751,23.690208,106.605938,39.509775,1,0
0,0,8,8,14,16,30,66,31,97,0.000333,0.158656,7,3331.778714,185.098817,475.968388,117.302969,4,0
0,0,7,7,10,13,23,39,24,63,0.000333,0.094995,5,1424.922016,79.162334,284.984403,81.324997,2,0
0,0,4,4,10,10,20,31,17,48,0.000333,0.069151,5,1037.262743,57.625708,207.452549,66.438562,1,0
0,0,6,6,16,13,29,44,28,72,0.000333,0.116592,16,5596.394106,310.910784,349.774632,112.105716,2,0
0,0,8,8,14,17,31,78,40,118,0.000333,0.194865,14,8184.332305,454.685128,584.595165,122.789837,3,0
0,0,4,4,9,9,18,35,15,50,0.000333,0.069499,4,833.985,46.3325,208.49625,57.05865,2,0
0,0,19,19,17,24,41,152,82,234,0.000333,0.417889,24,30088.01206,1671.556225,1253.667169,179.525968,3,0
0,0,6,6,7,11,18,41,25,66,0.000333,0.091738,6,1651.290301,91.73835,275.21505,57.705232,1,0
0,0,3,3,8,6,14,17,11,28,0.000333,0.035535,4,426.423751,23.690208,106.605938,39.509775,1,0
0,0,5,5,11,12,23,33,21,54,0.000333,0.081424,5,1221.361728,67.853429,244.272346,81.073298,1,0
0,0,25,25,12,35,47,382,213,595,0.000333,1.10166,36,118979.2932,6609.960733,3304.980367,222.544456,4,0
0,0,10,10,7,14,21,57,36,93,0.000333,0.136162,6,2450.913122,136.16184,408.48552,72.954453,1,0
0,0,4,4,10,15,25,32,21,53,0.000333,0.082041,5,1230.62189,68.367883,246.124378,91.82264,1,0
0,0,31,31,17,40,57,250,133,383,0.000333,0.744666,24,53615.92501,2978.662501,2233.996875,282.363992,11,0
0,0,8,8,14,16,30,66,31,97,0.000333,0.158656,7,3331.778714,185.098817,475.968388,117.302969,4,0
0,0,4,4,10,10,20,31,17,48,0.000333,0.069151,5,1037.262743,57.625708,207.452549,66.438562,1,0
0,0,35,35,16,36,52,247,140,387,0.000333,0.735357,24,52945.6841,2941.426895,2206.070171,250.1173,3,0
0,0,22,22,15,30,45,155,90,245,0.000333,0.448501,21,28255.58418,1569.754677,1345.504009,205.810077,3,0
0,0,3,3,8,6,14,17,11,28,0.000333,0.035535,4,426.423751,23.690208,106.605938,39.509775,1,0
0,0,13,13,10,18,28,71,44,115,0.000333,0.184282,10,5528.45816,307.136564,552.845816,108.277931,1,0
0,0,6,6,16,13,29,44,28,72,0.000333,0.116592,16,5596.394106,310.910784,349.774632,112.105716,2,0
0,0,8,8,14,16,30,66,31,97,0.000333,0.158656,7,3331.778714,185.098817,475.968388,117.302969,4,0
0,0,4,4,10,10,20,31,17,48,0.000333,0.069151,5,1037.262743,57.625708,207.452549,66.438562,1,0
0,0,16,16,16,27,43,74,41,115,0.000333,0.208007,8,4992.163574,277.342421,624.020447,192.381963,6,0
0,0,25,25,17,36,53,133,71,204,0.000333,0.389499,8,9347.966182,519.331455,1168.495773,255.604168,10,0
0,0,11,11,15,21,36,84,43,127,0.000333,0.21886,14,9192.126653,510.673703,656.580475,150.842025,2,0
0,0,3,3,8,6,14,17,11,28,0.000333,0.035535,4,426.423751,23.690208,106.605938,39.509775,1,0
0,0,6,6,16,13,29,44,28,72,0.000333,0.116592,16,5596.394106,310.910784,349.774632,112.105716,2,0
0,0,33,33,20,42,62,291,124,415,0.000333,0.823664,20,49419.82938,2745.546076,2470.991469,312.915894,11,0
0,0,45,45,22,49,71,368,168,536,0.000333,1.098755,33,108776.7271,6043.151503,3296.264456,373.228278,11,0
0,0,26,26,15,32,47,225,88,313,0.000333,0.579529,14,24340.20835,1352.233797,1738.586311,218.603359,9,0
0,0,9,9,15,19,34,68,35,103,0.000333,0.17467,7,3668.060709,203.78115,524.008673,139.313982,2,0
0,0,14,14,17,31,48,98,54,152,0.000333,0.282971,8,6791.314401,377.295244,848.9143,223.066954,5,0
0,0,15,15,16,27,43,71,41,112,0.000333,0.202581,8,4861.93322,270.107401,607.741653,192.381963,6,0
0,0,24,24,17,36,53,130,71,201,0.000333,0.383771,8,9210.496091,511.694227,1151.312011,255.604168,10,0
0,0,15,15,14,21,35,93,52,145,0.000333,0.247915,14,10412.44452,578.46914,743.746037,145.541635,5,0
0,0,11,11,15,21,36,84,43,127,0.000333,0.21886,14,9192.126653,510.673703,656.580475,150.842025,2,0
0,0,34,34,21,46,67,233,139,372,0.000333,0.752195,30,67697.55537,3760.975298,2256.585179,346.322516,7,0
0,0,9,9,15,19,34,68,35,103,0.000333,0.17467,7,3668.060709,203.78115,524.008673,139.313982,2,0
0,0,6,6,13,13,26,42,21,63,0.000333,0.098709,6,1776.766213,98.709234,296.127702,96.211433,2,0
0,0,4,4,10,10,20,31,17,48,0.000333,0.069151,5,1037.262743,57.625708,207.452549,66.438562,1,0
0,0,15,15,16,22,38,101,51,152,0.000333,0.265895,16,12762.95971,709.053317,797.684982,162.107496,6,0
0,0,8,8,14,16,30,66,31,97,0.000333,0.158656,7,3331.778714,185.098817,475.968388,117.302969,4,0
0,0,20,20,16,28,44,151,87,238,0.000333,0.433115,24,31184.27341,1732.459634,1299.344725,198.605938,3,0
0,0,9,9,15,19,34,68,35,103,0.000333,0.17467,7,3668.060709,203.78115,524.008673,139.313982,2,0
0,0,3,3,8,6,14,17,11,28,0.000333,0.035535,4,426.423751,23.690208,106.605938,39.509775,1,0
0,0,11,11,15,21,36,84,43,127,0.000333,0.21886,14,9192.126653,510.673703,656.580475,150.842025,2,0
0,0,9,9,13,21,34,77,45,122,0.000333,0.20689,12,7448.0456,413.780311,620.670467,140.344382,3,0
0,0,6,6,16,13,29,44,28,72,0.000333,0.116592,16,5596.394106,310.910784,349.774632,112.105716,2,0
0,0,7,7,10,13,23,39,24,63,0.000333,0.094995,5,1424.922016,79.162334,284.984403,81.324997,2,0
0,0,8,8,14,16,30,66,31,97,0.000333,0.158656,7,3331.778714,185.098817,475.968388,117.302969,4,0
0,0,4,4,10,10,20,31,17,48,0.000333,0.069151,5,1037.262743,57.625708,207.452549,66.438562,1,0
0,0,6,6,7,11,18,41,25,66,0.000333,0.091738,6,1651.290301,91.73835,275.21505,57.705232,1,0
0,0,6,6,16,13,29,44,28,72,0.000333,0.116592,16,5596.394106,310.910784,349.774632,112.105716,2,0
0,0,7,7,6,9,15,37,22,59,0.000333,0.076836,6,1383.039271,76.835515,230.506545,44.0391,1,0
0,0,26,26,17,29,46,180,102,282,0.000333,0.519215,24,37383.46732,2076.859295,1557.644472,210.368317,3,0
0,0,16,16,14,22,36,121,68,189,0.000333,0.325705,21,20519.43233,1139.968463,977.115825,151.410465,3,0
0,0,3,3,8,6,14,17,11,28,0.000333,0.035535,4,426.423751,23.690208,106.605938,39.509775,1,0
0,0,25,25,17,37,54,133,73,206,0.000333,0.395169,8,9484.054604,526.891922,1185.506825,262.236643,9,0
0,0,16,16,16,29,45,74,43,117,0.000333,0.214182,8,5140.374498,285.576361,642.546812,204.881449,5,0
0,0,11,11,15,21,36,84,43,127,0.000333,0.21886,14,9192.126653,510.673703,656.580475,150.842025,2,0
0,0,9,9,15,19,34,68,35,103,0.000333,0.17467,7,3668.060709,203.78115,524.008673,139.313982,2,0
0,0,5,5,10,11,21,27,16,43,0.000333,0.062957,5,944.348246,52.463791,188.869649,71.273029,1,0
0,0,15,15,16,22,38,101,51,152,0.000333,0.265895,16,12762.95971,709.053317,797.684982,162.107496,6,0
0,0,8,8,14,16,30,66,31,97,0.000333,0.158656,7,3331.778714,185.098817,475.968388,117.302969,4,0
0,0,6,6,13,13,26,42,21,63,0.000333,0.098709,6,1776.766213,98.709234,296.127702,96.211433,2,0
0,0,4,4,10,10,20,31,17,48,0.000333,0.069151,5,1037.262743,57.625708,207.452549,66.438562,1,0
0,0,12,12,16,21,37,150,51,201,0.000333,0.349033,16,16753.60202,930.755668,1047.100126,156.238666,3,0
0,0,5,5,8,9,17,84,15,99,0.000333,0.134886,4,1618.635285,89.924183,404.658821,52.529325,1,0
0,0,9,9,15,19,34,68,35,103,0.000333,0.17467,7,3668.060709,203.78115,524.008673,139.313982,2,0
0,0,23,23,18,28,46,224,93,317,0.000333,0.583656,27,47276.16678,2626.45371,1750.96914,209.664588,3,0
0,0,11,11,15,21,36,84,43,127,0.000333,0.21886,14,9192.126653,510.673703,656.580475,150.842025,2,0
0,0,6,6,16,13,29,44,28,72,0.000333,0.116592,16,5596.394106,310.910784,349.774632,112.105716,2,0
0,0,3,3,8,6,14,17,11,28,0.000333,0.035535,4,426.423751,23.690208,106.605938,39.509775,1,0
0,0,14,14,15,23,38,66,37,103,0.000333,0.180179,7,3783.755737,210.208652,540.536534,162.645284,5,0
0,0,23,23,17,32,49,125,67,192,0.000333,0.359341,16,17248.38864,958.243813,1078.02429,229.486868,9,0
0,0,4,4,10,10,20,31,17,48,0.000333,0.069151,5,1037.262743,57.625708,207.452549,66.438562,1,0
0,0,8,8,14,16,30,66,31,97,0.000333,0.158656,7,3331.778714,185.098817,475.968388,117.302969,4,0
0,0,28,28,18,38,56,236,126,362,0.000333,0.700754,27,56761.08701,3153.393723,2102.262482,274.479896,11,0
0,0,27,27,18,33,51,201,111,312,0.000333,0.589932,27,47784.51108,2654.69506,1769.796707,241.523656,3,0
0,0,9,9,15,19,34,68,35,103,0.000333,0.17467,7,3668.060709,203.78115,524.008673,139.313982,2,0
0,0,16,16,15,26,41,127,69,196,0.000333,0.350027,14,14701.1227,816.729039,1050.080193,180.814792,3,0
0,0,3,3,8,6,14,17,11,28,0.000333,0.035535,4,426.423751,23.690208,106.605938,39.509775,1,0
0,0,9,9,9,17,26,61,33,94,0.000333,0.14728,4,1767.365334,98.186963,441.841334,98.016193,1,0
0,0,6,6,16,13,29,44,28,72,0.000333,0.116592,16,5596.394106,310.910784,349.774632,112.105716,2,0
0,0,11,11,15,21,36,84,43,127,0.000333,0.21886,14,9192.126653,510.673703,656.580475,150.842025,2,0
0,0,25,25,17,38,55,141,75,216,0.000333,0.416258,8,9990.189585,555.010532,1248.773698,268.908114,10,0
0,0,16,16,16,30,46,82,45,127,0.000333,0.233831,8,5611.938947,311.774386,701.492368,211.206718,6,0
0,0,8,8,13,22,35,52,34,86,0.000333,0.147039,6,2646.710037,147.039446,441.118339,146.213212,4,0
0,0,4,4,10,10,20,31,17,48,0.000333,0.069151,5,1037.262743,57.625708,207.452549,66.438562,1,0
0,0,11,11,15,21,36,84,43,127,0.000333,0.21886,14,9192.126653,510.673703,656.580475,150.842025,2,0
0,0,6,6,16,13,29,44,28,72,0.000333,0.116592,16,5596.394106,310.910784,349.774632,112.105716,2,0
0,0,8,8,13,14,27,51,28,79,0.000333,0.125212,12,4507.633352,250.424075,375.636113,101.408685,2,0
0,0,9,9,15,19,34,68,35,103,0.000333,0.17467,7,3668.060709,203.78115,524.008673,139.313982,2,0
0,0,3,3,8,6,14,17,11,28,0.000333,0.035535,4,426.423751,23.690208,106.605938,39.509775,1,0
0,0,14,14,17,30,47,242,53,295,0.000333,0.546201,8,13108.82969,728.268316,1638.603711,216.693586,5,0
0,0,15,15,16,22,38,101,51,152,0.000333,0.265895,16,12762.95971,709.053317,797.684982,162.107496,6,0
0,0,6,6,13,13,26,42,21,63,0.000333,0.098709,6,1776.766213,98.709234,296.127702,96.211433,2,0
0,0,11,11,15,21,36,84,43,127,0.000333,0.21886,14,9192.126653,510.673703,656.580475,150.842025,2,0
0,0,9,9,15,19,34,68,35,103,0.000333,0.17467,7,3668.060709,203.78115,524.008673,139.313982,2,0
0,0,16,16,17,30,47,287,70,357,0.000333,0.660996,16,31727.81152,1762.656196,1982.98822,216.693586,3,0
0,0,8,8,14,16,30,66,31,97,0.000333,0.158656,7,3331.778714,185.098817,475.968388,117.302969,4,0
0,0,31,31,18,42,60,270,139,409,0.000333,0.805306,27,65229.79285,3623.87738,2415.918254,301.535982,12,0
0,0,4,4,10,10,20,31,17,48,0.000333,0.069151,5,1037.262743,57.625708,207.452549,66.438562,1,0
0,0,6,6,16,13,29,44,28,72,0.000333,0.116592,16,5596.394106,310.910784,349.774632,112.105716,2,0
0,0,18,18,11,21,32,147,77,224,0.000333,0.373333,15,16800,933.333333,1120,130.292414,1,0
0,0,38,38,17,38,55,303,164,467,0.000333,0.899965,32,86396.63956,4799.813309,2699.894986,268.908114,3,0
0,0,27,27,16,32,48,235,126,361,0.000333,0.672057,24,48388.11511,2688.228617,2016.171463,224,4,0
0,0,3,3,8,6,14,17,11,28,0.000333,0.035535,4,426.423751,23.690208,106.605938,39.509775,1,0
0,0,4,4,10,10,20,31,17,48,0.000333,0.069151,5,1037.262743,57.625708,207.452549,66.438562,1,0
0,0,8,8,14,16,30,66,31,97,0.000333,0.158656,7,3331.778714,185.098817,475.968388,117.302969,4,0
0,0,6,6,13,13,26,42,21,63,0.000333,0.098709,6,1776.766213,98.709234,296.127702,96.211433,2,0
0,0,15,15,16,22,38,101,51,152,0.000333,0.265895,16,12762.95971,709.053317,797.684982,162.107496,6,0
0,0,9,9,15,19,34,68,35,103,0.000333,0.17467,7,3668.060709,203.78115,524.008673,139.313982,2,0
0,0,20,20,16,25,41,151,85,236,0.000333,0.421461,24,30345.17455,1685.843031,1264.382273,180.096405,3,0
0,0,9,9,13,18,31,77,43,120,0.000333,0.198168,12,7134.042687,396.335705,594.503557,123.164366,3,0
0,0,3,3,8,6,14,17,11,28,0.000333,0.035535,4,426.423751,23.690208,106.605938,39.509775,1,0
0,0,6,6,16,13,29,44,28,72,0.000333,0.116592,16,5596.394106,310.910784,349.774632,112.105716,2,0
0,0,11,11,15,21,36,84,43,127,0.000333,0.21886,14,9192.126653,510.673703,656.580475,150.842025,2,0
0,0,3,3,6,6,12,15,9,24,0.000333,0.02868,3,258.1173,14.33985,86.0391,31.01955,2,0
0,0,17,17,17,32,49,79,47,126,0.000333,0.235818,8,5659.627523,314.423751,707.45344,229.486868,5,0
0,0,26,26,18,41,59,138,77,215,0.000333,0.421589,9,11382.9143,632.384128,1264.768256,294.718282,9,0
0,0,25,25,19,43,62,171,95,266,0.000333,0.527939,18,28508.69193,1583.816219,1583.816219,314.040007,7,0
0,0,13,13,17,31,48,94,53,147,0.000333,0.273663,8,6567.915901,364.884217,820.989488,223.066954,4,0
0,0,18,18,11,28,39,116,64,180,0.000333,0.317124,10,9513.723994,528.540222,951.372399,172.659686,1,0
0,0,9,9,15,19,34,68,35,103,0.000333,0.17467,7,3668.060709,203.78115,524.008673,139.313982,2,0
0,0,31,31,12,36,48,193,114,307,0.000333,0.571528,18,30862.50278,1714.583488,1714.583488,229.13685,1,0
0,0,11,11,15,21,36,84,43,127,0.000333,0.21886,14,9192.126653,510.673703,656.580475,150.842025,2,0
0,0,40,40,19,50,69,257,156,413,0.000333,0.84094,27,68116.15622,3784.230901,2522.820601,362.903432,3,0
0,0,6,6,13,13,26,42,21,63,0.000333,0.098709,6,1776.766213,98.709234,296.127702,96.211433,2,0
0,0,15,15,16,22,38,101,51,152,0.000333,0.265895,16,12762.95971,709.053317,797.684982,162.107496,6,0
0,0,14,14,17,30,47,102,55,157,0.000333,0.29069,8,6976.563598,387.586867,872.07045,216.693586,5,0
0,0,4,4,5,7,12,28,15,43,0.000333,0.051384,4,616.61355,34.256308,154.153388,31.261125,1,0
0,0,9,9,15,19,34,68,35,103,0.000333,0.17467,7,3668.060709,203.78115,524.008673,139.313982,2,0
0,0,20,20,17,32,49,138,85,223,0.000333,0.41736,16,20033.28472,1112.960262,1252.080295,229.486868,3,0
0,0,11,11,15,21,36,84,43,127,0.000333,0.21886,14,9192.126653,510.673703,656.580475,150.842025,2,0
0,0,12,12,7,18,25,72,44,116,0.000333,0.179562,6,3232.123908,179.562439,538.687318,94.710134,1,0
0,0,24,24,10,24,34,170,93,263,0.000333,0.446001,15,20070.04091,1115.002273,1338.002727,143.258381,1,0
0,0,16,16,16,28,44,73,42,115,0.000333,0.209278,8,5022.677089,279.037616,627.834636,198.605938,5,0
0,0,14,14,19,31,50,94,54,148,0.000333,0.27843,9,7517.616445,417.645358,835.290716,234.290708,5,0
0,0,25,25,17,37,54,132,72,204,0.000333,0.391332,8,9391.976404,521.776467,1173.99705,262.236643,9,0
0,0,37,37,21,51,72,226,142,368,0.000333,0.756844,20,45410.64801,2522.813778,2270.532401,381.532358,3,0
0,0,11,11,15,21,36,84,43,127,0.000333,0.21886,14,9192.126653,510.673703,656.580475,150.842025,2,0
0,0,18,18,13,28,41,96,60,156,0.000333,0.278593,12,10029.33735,557.185408,835.778113,182.711654,1,0
0,0,9,9,15,19,34,68,35,103,0.000333,0.17467,7,3668.060709,203.78115,524.008673,139.313982,2,0
0,0,15,15,16,22,38,101,51,152,0.000333,0.265895,16,12762.95971,709.053317,797.684982,162.107496,6,0
0,0,6,6,13,13,26,42,21,63,0.000333,0.098709,6,1776.766213,98.709234,296.127702,96.211433,2,0
0,0,8,8,14,16,30,66,31,97,0.000333,0.158656,7,3331.778714,185.098817,475.968388,117.302969,4,0
0,0,4,4,10,10,20,31,17,48,0.000333,0.069151,5,1037.262743,57.625708,207.452549,66.438562,1,0
0,0,3,3,8,6,14,17,11,28,0.000333,0.035535,4,426.423751,23.690208,106.605938,39.509775,1,0
0,0,9,9,14,20,34,83,44,127,0.000333,0.215369,14,9045.508932,502.528274,646.107781,139.741531,10,0
0,0,20,20,16,27,43,157,86,243,0.000333,0.439527,24,31645.97605,1758.109781,1318.582335,192.381963,10,0
0,0,9,9,15,19,34,68,35,103,0.000333,0.17467,7,3668.060709,203.78115,524.008673,139.313982,2,0
0,0,11,11,15,21,36,84,43,127,0.000333,0.21886,14,9192.126653,510.673703,656.580475,150.842025,2,0
0,0,3,3,7,8,15,25,11,36,0.000333,0.046883,3,421.944184,23.441344,140.648061,43.651484,5,0
0,0,6,6,16,13,29,44,28,72,0.000333,0.116592,16,5596.394106,310.910784,349.774632,112.105716,2,0
0,0,13,13,16,32,48,80,56,136,0.000333,0.253185,8,6076.439201,337.579956,759.5549,224,5,0
0,0,2,2,8,6,14,15,9,24,0.000333,0.030459,4,365.506073,20.305893,91.376518,39.509775,2,0
0,0,2,2,12,7,19,20,12,32,0.000333,0.045311,6,815.602083,45.311227,135.93368,62.671034,2,0
0,0,4,4,7,8,15,24,15,39,0.000333,0.05079,3,457.1062,25.394789,152.368733,43.651484,2,0
0,0,2,2,12,7,19,19,11,30,0.000333,0.042479,6,764.626952,42.479275,127.437825,62.671034,2,0
0,0,3,3,4,5,9,7,6,13,0.000333,0.013736,2,82.41805,4.578781,41.209025,19.60964,1,0
0,0,3,3,12,6,18,19,7,26,0.000333,0.036139,6,650.5083,36.13935,108.41805,58.529325,3,0
0,0,3,3,12,6,18,15,7,22,0.000333,0.030579,6,550.4301,30.57945,91.73835,58.529325,3,0
0,0,2,2,7,5,12,13,8,21,0.000333,0.025095,3,225.852638,12.547369,75.284213,31.261125,1,0
0,0,3,3,9,5,14,12,6,18,0.000333,0.022844,4,274.129554,15.22942,68.532389,40.138965,2,0
0,0,2,2,7,6,13,15,9,24,0.000333,0.029604,3,266.43166,14.801759,88.810553,35.161259,2,0
0,0,3,3,4,5,9,7,6,13,0.000333,0.013736,2,82.41805,4.578781,41.209025,19.60964,1,0
0,0,34,34,14,41,55,123,79,202,0.000333,0.389278,7,8174.842635,454.157924,1167.834662,272.962601,9,0
0,0,14,14,19,31,50,244,54,298,0.000333,0.560623,9,15136.8223,840.934572,1681.869145,234.290708,5,0
0,0,6,6,7,11,18,41,25,66,0.000333,0.091738,6,1651.290301,91.73835,275.21505,57.705232,1,0
0,0,30,30,8,33,41,247,62,309,0.000333,0.551828,4,6621.934278,367.885238,1655.483569,190.465006,3,0
0,0,15,15,18,30,48,248,59,307,0.000333,0.571528,9,15431.25139,857.291744,1714.583488,222.265368,3,0
0,0,8,8,14,16,30,66,31,97,0.000333,0.158656,7,3331.778714,185.098817,475.968388,117.302969,4,0
0,0,4,4,10,10,20,31,17,48,0.000333,0.069151,5,1037.262743,57.625708,207.452549,66.438562,1,0
0,0,17,17,16,31,47,80,46,126,0.000333,0.233293,8,5599.025562,311.056976,699.878195,217.580086,5,0
0,0,26,26,17,40,57,139,76,215,0.000333,0.418024,8,10032.57082,557.365046,1254.071353,282.363992,9,0
0,0,9,9,15,19,34,68,35,103,0.000333,0.17467,7,3668.060709,203.78115,524.008673,139.313982,2,0
0,0,28,28,19,38,57,207,112,319,0.000333,0.620231,18,33492.45446,1860.691915,1860.691915,280.131868,4,0
0,0,3,3,8,6,14,17,11,28,0.000333,0.035535,4,426.423751,23.690208,106.605938,39.509775,1,0
0,0,20,20,14,26,40,129,71,200,0.000333,0.354795,14,14901.39867,827.855481,1064.385619,175.514402,2,0
0,0,11,11,15,21,36,84,43,127,0.000333,0.21886,14,9192.126653,510.673703,656.580475,150.842025,2,0
0,0,6,6,16,13,29,44,28,72,0.000333,0.116592,16,5596.394106,310.910784,349.774632,112.105716,2,0
0,0,39,39,21,45,66,272,151,423,0.000333,0.85226,30,76703.36138,4261.297854,2556.778712,339.372055,4,0
0,0,14,14,17,30,47,92,53,145,0.000333,0.268472,8,6443.323068,357.962393,805.415383,216.693586,5,0
0,0,24,24,17,36,53,130,71,201,0.000333,0.383771,8,9210.496091,511.694227,1151.312011,255.604168,9,0
0,0,15,15,16,26,42,70,40,110,0.000333,0.197718,8,4745.239332,263.624407,593.154917,186.211433,5,0
0,0,17,17,15,23,38,96,56,152,0.000333,0.265895,14,11167.58975,620.421653,797.684982,162.645284,2,0
0,0,11,11,15,21,36,84,43,127,0.000333,0.21886,14,9192.126653,510.673703,656.580475,150.842025,2,0
0,0,9,9,15,19,34,68,35,103,0.000333,0.17467,7,3668.060709,203.78115,524.008673,139.313982,2,0
0,0,36,36,23,48,71,236,143,379,0.000333,0.776918,22,51276.59148,2848.699527,2330.754158,372.120125,4,0
0,0,13,13,17,30,47,91,52,143,0.000333,0.264769,8,6354.449646,353.02498,794.306206,216.693586,4,0
0,0,22,22,18,37,55,151,80,231,0.000333,0.445165,18,24038.89369,1335.494094,1335.494094,267.808425,7,0
0,0,24,24,17,35,52,129,70,199,0.000333,0.378129,16,18150.20006,1008.344448,1134.387504,249.011774,9,0
0,0,15,15,16,26,42,70,40,110,0.000333,0.197718,8,4745.239332,263.624407,593.154917,186.211433,5,0
0,0,9,9,15,20,35,72,36,108,0.000333,0.184654,7,3877.737961,215.429887,553.962566,145.041921,2,0
0,0,18,18,11,28,39,115,64,179,0.000333,0.315362,10,9460.869972,525.603887,946.086997,172.659686,1,0
0,0,26,26,11,30,41,178,95,273,0.000333,0.487537,15,21939.17546,1218.843081,1462.611697,185.260466,1,0
0,0,39,39,19,49,68,269,157,426,0.000333,0.86442,27,70017.9976,3889.888756,2593.25917,355.831405,3,0
0,0,9,9,15,19,34,68,35,103,0.000333,0.17467,7,3668.060709,203.78115,524.008673,139.313982,2,0
0,0,4,4,10,10,20,31,17,48,0.000333,0.069151,5,1037.262743,57.625708,207.452549,66.438562,1,0
0,0,8,8,14,16,30,66,31,97,0.000333,0.158656,7,3331.778714,185.098817,475.968388,117.302969,4,0
0,0,6,6,13,13,26,42,21,63,0.000333,0.098709,6,1776.766213,98.709234,296.127702,96.211433,2,0
0,0,15,15,16,22,38,101,51,152,0.000333,0.265895,16,12762.95971,709.053317,797.684982,162.107496,6,0
0,0,9,9,15,19,34,68,35,103,0.000333,0.17467,7,3668.060709,203.78115,524.008673,139.313982,2,0
0,0,6,6,16,13,29,44,28,72,0.000333,0.116592,16,5596.394106,310.910784,349.774632,112.105716,2,0
0,0,20,20,16,27,43,157,88,245,0.000333,0.443145,24,31906.43676,1772.57982,1329.434865,192.381963,3,0
0,0,3,3,8,6,14,17,11,28,0.000333,0.035535,4,426.423751,23.690208,106.605938,39.509775,1,0
0,0,11,11,15,21,36,84,43,127,0.000333,0.21886,14,9192.126653,510.673703,656.580475,150.842025,2,0
0,0,9,9,13,20,33,83,46,129,0.000333,0.216909,12,7808.722097,433.817894,650.726841,134.544278,3,0
0,0,3,3,7,8,15,26,13,39,0.000333,0.05079,3,457.1062,25.394789,152.368733,43.651484,2,0
0,0,14,14,15,24,39,65,38,103,0.000333,0.181465,7,3810.775,211.709722,544.396429,168.642459,5,0
0,0,23,23,17,33,50,124,68,192,0.000333,0.361207,16,17337.92622,963.218123,1083.620388,235.951874,9,0
0,0,14,14,17,30,47,97,54,151,0.000333,0.279581,8,6709.943333,372.77463,838.742917,216.693586,5,0
0,0,20,20,18,35,53,139,81,220,0.000333,0.420048,18,22682.565,1260.1425,1260.1425,254.583556,5,0
0,0,11,11,15,21,36,84,43,127,0.000333,0.21886,14,9192.126653,510.673703,656.580475,150.842025,2,0
0,0,9,9,15,19,34,68,35,103,0.000333,0.17467,7,3668.060709,203.78115,524.008673,139.313982,2,0
0,0,24,24,17,35,52,129,70,199,0.000333,0.378129,16,18150.20006,1008.344448,1134.387504,249.011774,9,0
0,0,15,15,16,26,42,70,40,110,0.000333,0.197718,8,4745.239332,263.624407,593.154917,186.211433,5,0
0,0,14,14,17,30,47,92,53,145,0.000333,0.268472,8,6443.323068,357.962393,805.415383,216.693586,5,0
0,0,9,9,15,19,34,68,35,103,0.000333,0.17467,7,3668.060709,203.78115,524.008673,139.313982,2,0
0,0,4,4,10,15,25,32,21,53,0.000333,0.082041,5,1230.62189,68.367883,246.124378,91.82264,1,0
0,0,14,14,11,23,34,85,48,133,0.000333,0.225544,10,6766.325579,375.906977,676.632558,142.095673,1,0
0,0,11,11,15,21,36,84,43,127,0.000333,0.21886,14,9192.126653,510.673703,656.580475,150.842025,2,0
0,0,36,36,19,46,65,246,147,393,0.000333,0.78893,27,63903.34486,3550.185826,2366.790551,334.794473,3,0
0,0,5,5,11,12,23,33,21,54,0.000333,0.081424,5,1221.361728,67.853429,244.272346,81.073298,1,0
0,0,25,25,12,35,47,382,213,595,0.000333,1.10166,36,118979.2932,6609.960733,3304.980367,222.544456,4,0
0,0,14,14,17,30,47,97,54,151,0.000333,0.279581,8,6709.943333,372.77463,838.742917,216.693586,5,0
0,0,6,6,13,13,26,42,21,63,0.000333,0.098709,6,1776.766213,98.709234,296.127702,96.211433,2,0
0,0,15,15,16,22,38,101,51,152,0.000333,0.265895,16,12762.95971,709.053317,797.684982,162.107496,6,0
0,0,11,11,15,21,36,84,43,127,0.000333,0.21886,14,9192.126653,510.673703,656.580475,150.842025,2,0
0,0,3,3,6,6,12,25,11,36,0.000333,0.04302,3,387.17595,21.509775,129.05865,31.01955,2,0
0,0,18,18,16,30,46,126,78,204,0.000333,0.375602,16,18028.90623,1001.605901,1126.806639,211.206718,3,0
0,0,9,9,15,19,34,68,35,103,0.000333,0.17467,7,3668.060709,203.78115,524.008673,139.313982,2,0
0,0,8,8,14,16,30,66,31,97,0.000333,0.158656,7,3331.778714,185.098817,475.968388,117.302969,4,0
0,0,7,7,10,14,24,46,27,73,0.000333,0.111567,5,1673.511313,92.972851,334.702263,86.52225,2,0
0,0,11,11,15,25,40,61,35,96,0.000333,0.170302,7,3576.33568,198.685316,510.905097,174.699764,3,0
0,0,20,20,17,34,51,120,65,185,0.000333,0.3498,8,8395.189506,466.399417,1049.398688,242.460605,7,0
0,0,4,4,10,10,20,31,17,48,0.000333,0.069151,5,1037.262743,57.625708,207.452549,66.438562,1,0
0,0,20,20,16,27,43,152,87,239,0.000333,0.432292,24,31125.05463,1729.169702,1296.877276,192.381963,3,0
0,0,9,9,15,19,34,68,35,103,0.000333,0.17467,7,3668.060709,203.78115,524.008673,139.313982,2,0
0,0,3,3,8,6,14,17,11,28,0.000333,0.035535,4,426.423751,23.690208,106.605938,39.509775,1,0
0,0,9,9,13,20,33,78,45,123,0.000333,0.20682,12,7445.52572,413.640318,620.460477,134.544278,3,0
0,0,3,3,7,8,15,16,11,27,0.000333,0.035162,3,316.458138,17.581008,105.486046,43.651484,2,0
0,0,6,6,16,13,29,44,28,72,0.000333,0.116592,16,5596.394106,310.910784,349.774632,112.105716,2,0
0,0,11,11,15,21,36,84,43,127,0.000333,0.21886,14,9192.126653,510.673703,656.580475,150.842025,2,0
0,0,15,15,12,22,34,99,56,155,0.000333,0.262852,12,9462.680885,525.704494,788.55674,141.127046,2,0
0,0,24,24,19,40,59,133,89,222,0.000333,0.435316,18,23507.04163,1305.946757,1305.946757,293.587747,5,0
0,0,33,33,20,49,69,192,119,311,0.000333,0.63325,20,37995.02212,2110.834562,1899.751106,361.559344,9,0
0,0,11,11,15,21,36,84,43,127,0.000333,0.21886,14,9192.126653,510.673703,656.580475,150.842025,2,0
0,0,7,7,8,14,22,51,25,76,0.000333,0.112972,4,1355.667212,75.314845,338.916803,77.302969,1,0
0,0,9,9,15,19,34,68,35,103,0.000333,0.17467,7,3668.060709,203.78115,524.008673,139.313982,2,0
0,0,7,7,10,13,23,39,24,63,0.000333,0.094995,5,1424.922016,79.162334,284.984403,81.324997,2,0
0,0,3,3,7,8,15,26,13,39,0.000333,0.05079,3,457.1062,25.394789,152.368733,43.651484,2,0
0,0,6,6,7,11,18,41,25,66,0.000333,0.091738,6,1651.290301,91.73835,275.21505,57.705232,1,0
0,0,24,24,17,34,51,128,69,197,0.000333,0.372489,16,17879.48468,993.304704,1117.467792,242.460605,9,0
0,0,8,8,14,16,30,66,31,97,0.000333,0.158656,7,3331.778714,185.098817,475.968388,117.302969,4,0
0,0,15,15,15,25,40,69,39,108,0.000333,0.191589,7,4023.37764,223.52098,574.768234,174.699764,5,0
0,0,4,4,10,10,20,31,17,48,0.000333,0.069151,5,1037.262743,57.625708,207.452549,66.438562,1,0
0,0,9,9,15,19,34,68,35,103,0.000333,0.17467,7,3668.060709,203.78115,524.008673,139.313982,2,0
0,0,18,18,17,27,44,124,71,195,0.000333,0.354863,16,17033.42665,946.301481,1064.589166,197.868831,5,0
0,0,3,3,8,6,14,17,11,28,0.000333,0.035535,4,426.423751,23.690208,106.605938,39.509775,1,0
0,0,11,11,15,21,36,84,43,127,0.000333,0.21886,14,9192.126653,510.673703,656.580475,150.842025,2,0
0,0,28,28,19,34,53,183,105,288,0.000333,0.54988,27,44540.30946,2474.461636,1649.641091,253.684359,5,0
0,0,6,6,16,13,29,44,28,72,0.000333,0.116592,16,5596.394106,310.910784,349.774632,112.105716,2,0
0,0,6,6,13,13,26,42,21,63,0.000333,0.098709,6,1776.766213,98.709234,296.127702,96.211433,2,0
0,0,15,15,16,22,38,101,51,152,0.000333,0.265895,16,12762.95971,709.053317,797.684982,162.107496,6,0
0,0,13,13,6,15,21,75,28,103,0.000333,0.150803,3,1357.226084,75.401449,452.408695,74.113134,6,0
0,0,9,9,15,19,34,68,35,103,0.000333,0.17467,7,3668.060709,203.78115,524.008673,139.313982,2,0
0,0,11,11,15,21,36,84,43,127,0.000333,0.21886,14,9192.126653,510.673703,656.580475,150.842025,2,0
0,0,27,27,17,40,57,254,130,384,0.000333,0.74661,24,53755.91437,2986.439687,2239.829765,282.363992,12,0
0,0,8,8,14,16,30,66,31,97,0.000333,0.158656,7,3331.778714,185.098817,475.968388,117.302969,4,0
0,0,4,4,10,10,20,31,17,48,0.000333,0.069151,5,1037.262743,57.625708,207.452549,66.438562,1,0
0,0,24,24,17,35,52,131,70,201,0.000333,0.381929,16,18332.61413,1018.478563,1145.788383,249.011774,9,0
0,0,15,15,16,26,42,72,40,112,0.000333,0.201313,8,4831.516411,268.417578,603.939551,186.211433,5,0
0,0,23,23,14,31,45,181,95,276,0.000333,0.50525,21,31830.78055,1768.376697,1515.751455,206.883055,7,0
0,0,15,15,12,22,34,99,56,155,0.000333,0.262852,12,9462.680885,525.704494,788.55674,141.127046,2,0
0,0,6,6,16,13,29,44,28,72,0.000333,0.116592,16,5596.394106,310.910784,349.774632,112.105716,2,0
0,0,11,11,15,21,36,84,43,127,0.000333,0.21886,14,9192.126653,510.673703,656.580475,150.842025,2,0
0,0,3,3,8,6,14,17,11,28,0.000333,0.035535,4,426.423751,23.690208,106.605938,39.509775,1,0
0,0,35,35,18,40,58,302,160,462,0.000333,0.902129,36,97429.93991,5412.774439,2706.38722,287.935774,10,0
0,0,9,9,15,19,34,68,35,103,0.000333,0.17467,7,3668.060709,203.78115,524.008673,139.313982,2,0
0,0,43,43,19,47,66,337,182,519,0.000333,1.04568,27,84700.0948,4705.560822,3137.040548,341.776299,9,0
0,0,4,4,10,10,20,31,17,48,0.000333,0.069151,5,1037.262743,57.625708,207.452549,66.438562,1,0
0,0,8,8,14,16,30,66,31,97,0.000333,0.158656,7,3331.778714,185.098817,475.968388,117.302969,4,0
0,0,7,7,10,13,23,39,24,63,0.000333,0.094995,5,1424.922016,79.162334,284.984403,81.324997,2,0
0,0,3,3,8,6,14,17,11,28,0.000333,0.035535,4,426.423751,23.690208,106.605938,39.509775,1,0
0,0,23,23,19,28,47,162,93,255,0.000333,0.47214,27,38243.34424,2124.630236,1416.420157,215.316561,5,0
0,0,6,6,7,11,18,41,25,66,0.000333,0.091738,6,1651.290301,91.73835,275.21505,57.705232,1,0
0,0,13,13,16,21,37,103,59,162,0.000333,0.28131,16,13502.90312,750.161285,843.931445,156.238666,5,0
0,0,4,4,8,9,17,19,13,32,0.000333,0.0436,4,523.195244,29.066402,130.798811,52.529325,3,0
0,0,6,6,16,13,29,44,28,72,0.000333,0.116592,16,5596.394106,310.910784,349.774632,112.105716,2,0
0,0,6,6,13,13,26,42,21,63,0.000333,0.098709,6,1776.766213,98.709234,296.127702,96.211433,2,0
0,0,15,15,16,22,38,101,51,152,0.000333,0.265895,16,12762.95971,709.053317,797.684982,162.107496,6,0
0,0,11,11,15,21,36,84,43,127,0.000333,0.21886,14,9192.126653,510.673703,656.580475,150.842025,2,0
0,0,5,5,12,10,22,28,15,43,0.000333,0.063919,6,1150.533358,63.91852,191.75556,76.238831,3,0
0,0,9,9,15,19,34,68,35,103,0.000333,0.17467,7,3668.060709,203.78115,524.008673,139.313982,2,0
0,0,15,15,16,26,42,72,40,112,0.000333,0.201313,8,4831.516411,268.417578,603.939551,186.211433,5,0
0,0,24,24,17,35,52,131,70,201,0.000333,0.381929,16,18332.61413,1018.478563,1145.788383,249.011774,9,0
0,0,4,4,10,10,20,31,17,48,0.000333,0.069151,5,1037.262743,57.625708,207.452549,66.438562,1,0
0,0,8,8,14,16,30,66,31,97,0.000333,0.158656,7,3331.778714,185.098817,475.968388,117.302969,4,0
0,0,25,25,12,35,47,382,213,595,0.000333,1.10166,36,118979.2932,6609.960733,3304.980367,222.544456,4,0
0,0,5,5,11,12,23,33,21,54,0.000333,0.081424,5,1221.361728,67.853429,244.272346,81.073298,1,0
0,0,6,6,16,13,29,44,28,72,0.000333,0.116592,16,5596.394106,310.910784,349.774632,112.105716,2,0
0,0,9,9,15,20,35,72,36,108,0.000333,0.184654,7,3877.737961,215.429887,553.962566,145.041921,2,0
0,0,31,31,19,37,56,225,127,352,0.000333,0.681396,27,55193.10118,3066.283399,2044.188933,273.460397,4,0
0,0,4,4,10,15,25,32,21,53,0.000333,0.082041,5,1230.62189,68.367883,246.124378,91.82264,1,0
0,0,3,3,8,6,14,17,11,28,0.000333,0.035535,4,426.423751,23.690208,106.605938,39.509775,1,0
0,0,9,9,15,19,34,68,35,103,0.000333,0.17467,7,3668.060709,203.78115,524.008673,139.313982,2,0
0,0,11,11,12,18,30,69,40,109,0.000333,0.178284,12,6418.212899,356.567383,534.851075,118.0782,2,0
0,0,24,24,17,30,47,202,110,312,0.000333,0.577677,24,41592.76132,2310.708962,1733.031722,216.693586,5,0
0,0,5,5,11,12,23,36,21,57,0.000333,0.085948,5,1289.215157,71.623064,257.843031,81.073298,1,0
0,0,6,6,13,13,26,42,21,63,0.000333,0.098709,6,1776.766213,98.709234,296.127702,96.211433,2,0
0,0,15,15,16,22,38,101,51,152,0.000333,0.265895,16,12762.95971,709.053317,797.684982,162.107496,6,0
0,0,8,8,14,16,30,66,31,97,0.000333,0.158656,7,3331.778714,185.098817,475.968388,117.302969,4,0
0,0,3,3,8,6,14,17,11,28,0.000333,0.035535,4,426.423751,23.690208,106.605938,39.509775,1,0
0,0,11,11,15,21,36,84,43,127,0.000333,0.21886,14,9192.126653,510.673703,656.580475,150.842025,2,0
0,0,19,19,17,24,41,149,82,231,0.000333,0.412532,24,29702.26831,1650.126017,1237.594513,179.525968,4,0
0,0,6,6,16,13,29,44,28,72,0.000333,0.116592,16,5596.394106,310.910784,349.774632,112.105716,2,0
0,0,9,9,15,19,34,68,35,103,0.000333,0.17467,7,3668.060709,203.78115,524.008673,139.313982,2,0
0,0,8,8,14,17,31,75,40,115,0.000333,0.189911,14,7976.25606,443.125337,569.732576,122.789837,4,0
0,0,15,15,16,26,42,70,40,110,0.000333,0.197718,8,4745.239332,263.624407,593.154917,186.211433,5,0
0,0,24,24,17,35,52,129,70,199,0.000333,0.378129,16,18150.20006,1008.344448,1134.387504,249.011774,9,0
0,0,2,2,8,6,14,26,9,35,0.000333,0.044419,4,533.029689,29.612761,133.257422,39.509775,2,0
0,0,9,9,15,19,34,68,35,103,0.000333,0.17467,7,3668.060709,203.78115,524.008673,139.313982,2,0
0,0,11,11,15,21,36,84,43,127,0.000333,0.21886,14,9192.126653,510.673703,656.580475,150.842025,2,0
0,0,14,14,16,36,52,89,52,141,0.000333,0.267921,8,6430.096002,357.227556,803.762,250.1173,7,0
0,0,23,23,17,43,60,148,82,230,0.000333,0.452862,8,10868.6787,603.815483,1358.584837,302.816253,11,0
0,0,2,2,7,6,13,15,9,24,0.000333,0.029604,3,266.43166,14.801759,88.810553,35.161259,2,0
0,0,11,11,15,21,36,84,43,127,0.000333,0.21886,14,9192.126653,510.673703,656.580475,150.842025,2,0
0,0,9,9,15,19,34,68,35,103,0.000333,0.17467,7,3668.060709,203.78115,524.008673,139.313982,2,0
0,0,3,3,12,6,18,19,7,26,0.000333,0.036139,6,650.5083,36.13935,108.41805,58.529325,3,0
0,0,1,1,7,5,12,8,6,14,0.000333,0.01673,3,150.568425,8.364913,50.189475,31.261125,1,0
0,0,3,3,9,5,14,12,6,18,0.000333,0.022844,4,274.129554,15.22942,68.532389,40.138965,2,0
0,0,2,2,7,5,12,13,8,21,0.000333,0.025095,3,225.852638,12.547369,75.284213,31.261125,1,0
0,0,3,3,4,5,9,7,6,13,0.000333,0.013736,2,82.41805,4.578781,41.209025,19.60964,1,0
0,0,3,3,4,5,9,7,6,13,0.000333,0.013736,2,82.41805,4.578781,41.209025,19.60964,1,0
0,0,2,2,8,6,14,15,9,24,0.000333,0.030459,4,365.506073,20.305893,91.376518,39.509775,2,0
0,0,2,2,12,7,19,19,11,30,0.000333,0.042479,6,764.626952,42.479275,127.437825,62.671034,2,0
0,0,4,4,7,8,15,24,15,39,0.000333,0.05079,3,457.1062,25.394789,152.368733,43.651484,2,0
0,0,3,3,12,6,18,15,7,22,0.000333,0.030579,6,550.4301,30.57945,91.73835,58.529325,3,0
0,0,19,19,17,31,48,114,62,176,0.000333,0.327651,16,15727.2544,873.736356,982.9534,223.066954,7,0
0,0,7,7,9,16,25,46,29,75,0.000333,0.116096,4,1393.156857,77.397603,348.289214,92.529325,9,0
0,0,10,10,14,22,36,55,32,87,0.000333,0.149928,7,3148.484326,174.915796,449.783475,151.410465,3,0
0,0,3,3,7,8,15,16,11,27,0.000333,0.035162,3,316.458138,17.581008,105.486046,43.651484,3,0
0,0,9,9,15,19,34,68,35,103,0.000333,0.17467,7,3668.060709,203.78115,524.008673,139.313982,2,0
0,0,11,11,15,21,36,84,43,127,0.000333,0.21886,14,9192.126653,510.673703,656.580475,150.842025,2,0
0,0,8,8,14,16,30,66,31,97,0.000333,0.158656,7,3331.778714,185.098817,475.968388,117.302969,4,0
0,0,7,7,10,13,23,39,24,63,0.000333,0.094995,5,1424.922016,79.162334,284.984403,81.324997,2,0
0,0,4,4,10,10,20,31,17,48,0.000333,0.069151,5,1037.262743,57.625708,207.452549,66.438562,1,0
0,0,3,3,8,6,14,17,11,28,0.000333,0.035535,4,426.423751,23.690208,106.605938,39.509775,1,0
0,0,6,6,7,11,18,41,25,66,0.000333,0.091738,6,1651.290301,91.73835,275.21505,57.705232,1,0
0,0,19,19,17,24,41,149,82,231,0.000333,0.412532,24,29702.26831,1650.126017,1237.594513,179.525968,3,0
0,0,6,6,16,13,29,44,28,72,0.000333,0.116592,16,5596.394106,310.910784,349.774632,112.105716,2,0
0,0,2,2,7,5,12,14,7,21,0.000333,0.025095,3,225.852638,12.547369,75.284213,31.261125,2,0
0,0,8,8,14,17,31,75,40,115,0.000333,0.189911,14,7976.25606,443.125337,569.732576,122.789837,3,0
0,0,4,4,10,10,20,31,17,48,0.000333,0.069151,5,1037.262743,57.625708,207.452549,66.438562,1,0
0,0,28,28,17,36,53,226,123,349,0.000333,0.666348,24,47977.06173,2665.392318,1999.044239,255.604168,11,0
0,0,8,8,14,16,30,66,31,97,0.000333,0.158656,7,3331.778714,185.098817,475.968388,117.302969,4,0
0,0,3,3,8,6,14,17,11,28,0.000333,0.035535,4,426.423751,23.690208,106.605938,39.509775,1,0
0,0,32,32,16,32,48,233,132,365,0.000333,0.679504,32,65232.36201,3624.020112,2038.511313,224,3,0
0,0,4,4,10,15,25,32,21,53,0.000333,0.082041,5,1230.62189,68.367883,246.124378,91.82264,1,0
0,0,25,25,12,35,47,382,213,595,0.000333,1.10166,36,118979.2932,6609.960733,3304.980367,222.544456,4,0
0,0,10,10,7,14,21,57,36,93,0.000333,0.136162,6,2450.913122,136.16184,408.48552,72.954453,1,0
0,0,5,5,11,12,23,33,21,54,0.000333,0.081424,5,1221.361728,67.853429,244.272346,81.073298,1,0
0,0,21,21,13,26,39,163,93,256,0.000333,0.451021,18,24355.13343,1353.062968,1353.062968,170.317149,3,0
0,0,6,6,16,13,29,44,28,72,0.000333,0.116592,16,5596.394106,310.910784,349.774632,112.105716,2,0
0,0,14,14,16,37,53,89,53,142,0.000333,0.271122,8,6506.917636,361.495424,813.364705,256.749775,7,0
0,0,23,23,17,44,61,148,83,231,0.000333,0.456667,8,10960.0026,608.889033,1370.000325,309.70186,11,0
0,0,2,2,7,6,13,15,9,24,0.000333,0.029604,3,266.43166,14.801759,88.810553,35.161259,2,0
0,0,2,2,12,7,19,19,11,30,0.000333,0.042479,6,764.626952,42.479275,127.437825,62.671034,2,0
0,0,3,3,12,6,18,19,7,26,0.000333,0.036139,6,650.5083,36.13935,108.41805,58.529325,3,0
0,0,1,1,7,5,12,8,6,14,0.000333,0.01673,3,150.568425,8.364913,50.189475,31.261125,1,0
0,0,3,3,9,5,14,12,6,18,0.000333,0.022844,4,274.129554,15.22942,68.532389,40.138965,2,0
0,0,2,2,7,5,12,13,8,21,0.000333,0.025095,3,225.852638,12.547369,75.284213,31.261125,1,0
0,0,3,3,4,5,9,7,6,13,0.000333,0.013736,2,82.41805,4.578781,41.209025,19.60964,1,0
0,0,3,3,4,5,9,7,6,13,0.000333,0.013736,2,82.41805,4.578781,41.209025,19.60964,1,0
0,0,2,2,8,6,14,15,9,24,0.000333,0.030459,4,365.506073,20.305893,91.376518,39.509775,2,0
0,0,9,9,15,19,34,68,35,103,0.000333,0.17467,7,3668.060709,203.78115,524.008673,139.313982,2,0
0,0,4,4,7,8,15,24,15,39,0.000333,0.05079,3,457.1062,25.394789,152.368733,43.651484,2,0
0,0,3,3,12,6,18,15,7,22,0.000333,0.030579,6,550.4301,30.57945,91.73835,58.529325,3,0
0,0,11,11,15,21,36,84,43,127,0.000333,0.21886,14,9192.126653,510.673703,656.580475,150.842025,2,0
0,0,8,8,14,16,30,66,31,97,0.000333,0.158656,7,3331.778714,185.098817,475.968388,117.302969,4,0
0,0,24,24,17,34,51,130,69,199,0.000333,0.376271,16,18061.00229,1003.389016,1128.812643,242.460605,9,0
0,0,15,15,16,25,41,71,39,110,0.000333,0.196444,8,4714.645764,261.924765,589.330721,180.096405,5,0
0,0,4,4,10,10,20,31,17,48,0.000333,0.069151,5,1037.262743,57.625708,207.452549,66.438562,1,0
0,0,19,19,17,25,42,155,83,238,0.000333,0.427791,24,30800.91712,1711.162062,1283.371547,185.583273,3,0
0,0,11,11,15,21,36,84,43,127,0.000333,0.21886,14,9192.126653,510.673703,656.580475,150.842025,2,0
0,0,9,9,15,19,34,68,35,103,0.000333,0.17467,7,3668.060709,203.78115,524.008673,139.313982,2,0
0,0,8,8,15,18,33,81,41,122,0.000333,0.205139,14,8615.825156,478.656953,615.416083,133.662009,3,0
0,0,2,2,8,6,14,26,9,35,0.000333,0.044419,4,533.029689,29.612761,133.257422,39.509775,2,0
0,0,3,3,8,6,14,17,11,28,0.000333,0.035535,4,426.423751,23.690208,106.605938,39.509775,1,0
0,0,6,6,16,13,29,44,28,72,0.000333,0.116592,16,5596.394106,310.910784,349.774632,112.105716,2,0
0,0,4,4,10,10,20,31,17,48,0.000333,0.069151,5,1037.262743,57.625708,207.452549,66.438562,1,0
0,0,28,28,16,37,53,250,128,378,0.000333,0.721718,24,51963.69436,2886.871909,2165.153932,256.749775,11,0
0,0,8,8,14,16,30,66,31,97,0.000333,0.158656,7,3331.778714,185.098817,475.968388,117.302969,4,0
0,0,14,14,15,23,38,66,37,103,0.000333,0.180179,7,3783.755737,210.208652,540.536534,162.645284,5,0
0,0,23,23,17,32,49,125,67,192,0.000333,0.359341,16,17248.38864,958.243813,1078.02429,229.486868,9,0
0,0,11,11,15,21,36,84,43,127,0.000333,0.21886,14,9192.126653,510.673703,656.580475,150.842025,2,0
0,0,3,3,8,6,14,17,11,28,0.000333,0.035535,4,426.423751,23.690208,106.605938,39.509775,1,0
0,0,26,26,16,32,48,197,107,304,0.000333,0.565943,24,40747.88641,2263.771467,1697.8286,224,3,0
0,0,15,15,15,25,40,123,65,188,0.000333,0.333507,14,14007.31475,778.184153,1000.522482,174.699764,3,0
0,0,9,9,15,19,34,68,35,103,0.000333,0.17467,7,3668.060709,203.78115,524.008673,139.313982,2,0
0,0,8,8,9,16,25,57,29,86,0.000333,0.133124,4,1597.486529,88.749252,399.371632,92.529325,1,0
0,0,6,6,16,13,29,44,28,72,0.000333,0.116592,16,5596.394106,310.910784,349.774632,112.105716,2,0
0,0,11,11,15,21,36,84,43,127,0.000333,0.21886,14,9192.126653,510.673703,656.580475,150.842025,2,0
0,0,9,9,15,19,34,68,35,103,0.000333,0.17467,7,3668.060709,203.78115,524.008673,139.313982,2,0
0,0,21,21,12,31,43,111,71,182,0.000333,0.329193,12,11850.96222,658.38679,987.580185,196.599636,1,0
0,0,17,17,11,26,37,81,49,130,0.000333,0.225743,5,3386.144688,188.119149,677.228938,160.26518,4,0
0,0,11,11,15,25,40,61,35,96,0.000333,0.170302,7,3576.33568,198.685316,510.905097,174.699764,3,0
0,0,20,20,17,34,51,120,65,185,0.000333,0.3498,8,8395.189506,466.399417,1049.398688,242.460605,7,0
0,0,9,9,15,19,34,68,35,103,0.000333,0.17467,7,3668.060709,203.78115,524.008673,139.313982,2,0
0,0,2,2,6,7,13,47,9,56,0.000333,0.069075,3,621.673873,34.537437,207.224624,35.161259,1,0
0,0,15,15,12,22,34,99,56,155,0.000333,0.262852,12,9462.680885,525.704494,788.55674,141.127046,2,0
0,0,11,11,15,21,36,84,43,127,0.000333,0.21886,14,9192.126653,510.673703,656.580475,150.842025,2,0
0,0,18,18,11,28,39,116,64,180,0.000333,0.317124,10,9513.723994,528.540222,951.372399,172.659686,1,0
0,0,31,31,12,37,49,214,119,333,0.000333,0.623233,18,33654.57081,1869.698378,1869.698378,235.769325,1,0
0,0,11,11,15,21,36,84,43,127,0.000333,0.21886,14,9192.126653,510.673703,656.580475,150.842025,2,0
0,0,9,9,15,19,34,68,35,103,0.000333,0.17467,7,3668.060709,203.78115,524.008673,139.313982,2,0
0,0,3,3,4,5,9,7,6,13,0.000333,0.013736,2,82.41805,4.578781,41.209025,19.60964,1,0
0,0,3,3,9,5,14,12,6,18,0.000333,0.022844,4,274.129554,15.22942,68.532389,40.138965,2,0
0,0,2,2,8,6,14,15,9,24,0.000333,0.030459,4,365.506073,20.305893,91.376518,39.509775,2,0
0,0,3,3,12,6,18,15,7,22,0.000333,0.030579,6,550.4301,30.57945,91.73835,58.529325,3,0
0,0,3,3,4,5,9,7,6,13,0.000333,0.013736,2,82.41805,4.578781,41.209025,19.60964,1,0
0,0,4,4,7,8,15,24,15,39,0.000333,0.05079,3,457.1062,25.394789,152.368733,43.651484,2,0
0,0,2,2,7,6,13,15,9,24,0.000333,0.029604,3,266.43166,14.801759,88.810553,35.161259,2,0
0,0,1,1,7,5,12,8,6,14,0.000333,0.01673,3,150.568425,8.364913,50.189475,31.261125,1,0
0,0,2,2,7,5,12,13,8,21,0.000333,0.025095,3,225.852638,12.547369,75.284213,31.261125,1,0
0,0,2,2,12,7,19,19,11,30,0.000333,0.042479,6,764.626952,42.479275,127.437825,62.671034,2,0
0,0,3,3,12,6,18,19,7,26,0.000333,0.036139,6,650.5083,36.13935,108.41805,58.529325,3,0
0,0,15,15,16,22,38,101,51,152,0.000333,0.265895,16,12762.95971,709.053317,797.684982,162.107496,6,0
0,0,6,6,13,13,26,42,21,63,0.000333,0.098709,6,1776.766213,98.709234,296.127702,96.211433,2,0
0,0,8,8,13,13,26,39,26,65,0.000333,0.101843,12,3666.34298,203.685721,305.528582,96.211433,3,0
0,0,9,9,15,19,34,68,35,103,0.000333,0.17467,7,3668.060709,203.78115,524.008673,139.313982,2,0
0,0,11,11,12,22,34,63,38,101,0.000333,0.171278,6,3083.002482,171.277916,513.833747,141.127046,2,0
0,0,11,11,15,21,36,84,43,127,0.000333,0.21886,14,9192.126653,510.673703,656.580475,150.842025,2,0
0,0,16,16,15,26,41,71,43,114,0.000333,0.203587,7,4275.3265,237.518139,610.760929,180.814792,5,0
0,0,25,25,17,35,52,130,73,203,0.000333,0.38573,16,18515.02821,1028.612678,1157.189263,249.011774,9,0
0,0,11,11,15,21,36,84,43,127,0.000333,0.21886,14,9192.126653,510.673703,656.580475,150.842025,2,0
0,0,9,9,15,19,34,68,35,103,0.000333,0.17467,7,3668.060709,203.78115,524.008673,139.313982,2,0
0,0,8,8,13,13,26,39,26,65,0.000333,0.101843,12,3666.34298,203.685721,305.528582,96.211433,3,0
0,0,6,6,13,13,26,42,21,63,0.000333,0.098709,6,1776.766213,98.709234,296.127702,96.211433,2,0
0,0,15,15,16,22,38,101,51,152,0.000333,0.265895,16,12762.95971,709.053317,797.684982,162.107496,6,0
0,0,9,9,15,20,35,72,36,108,0.000333,0.184654,7,3877.737961,215.429887,553.962566,145.041921,2,0
0,0,10,10,13,21,34,64,35,99,0.000333,0.167886,6,3021.952928,167.886274,503.658821,140.344382,4,0
0,0,2,2,5,5,10,18,7,25,0.000333,0.027683,2,166.096405,9.227578,83.048202,23.219281,3,0
0,0,9,9,15,19,34,68,35,103,0.000333,0.17467,7,3668.060709,203.78115,524.008673,139.313982,2,0
0,0,15,15,16,22,38,101,51,152,0.000333,0.265895,16,12762.95971,709.053317,797.684982,162.107496,6,0
0,0,6,6,13,13,26,42,21,63,0.000333,0.098709,6,1776.766213,98.709234,296.127702,96.211433,2,0
0,0,8,8,13,13,26,39,26,65,0.000333,0.101843,12,3666.34298,203.685721,305.528582,96.211433,3,0
0,0,11,11,15,21,36,84,43,127,0.000333,0.21886,14,9192.126653,510.673703,656.580475,150.842025,2,0
0,0,9,9,15,19,34,68,35,103,0.000333,0.17467,7,3668.060709,203.78115,524.008673,139.313982,2,0
0,0,9,9,13,20,33,85,32,117,0.000333,0.196731,6,3541.164672,196.731371,590.194112,134.544278,2,0
0,0,9,9,15,19,34,68,35,103,0.000333,0.17467,7,3668.060709,203.78115,524.008673,139.313982,2,0
0,0,5,5,10,11,21,27,16,43,0.000333,0.062957,5,944.348246,52.463791,188.869649,71.273029,1,0
0,0,11,11,15,21,36,84,43,127,0.000333,0.21886,14,9192.126653,510.673703,656.580475,150.842025,2,0
0,0,36,36,19,42,61,178,127,305,0.000333,0.602958,27,48839.62198,2713.312332,1808.874888,307.187955,14,0
0,0,2,2,12,9,21,18,11,29,0.000333,0.042459,6,764.263232,42.459068,127.377205,71.548875,1,0
0,0,37,37,21,47,68,195,129,324,0.000333,0.657446,20,39446.75921,2191.486623,1972.337961,353.304342,16,0
0,0,11,11,15,21,36,84,43,127,0.000333,0.21886,14,9192.126653,510.673703,656.580475,150.842025,2,0
0,0,9,9,15,19,34,68,35,103,0.000333,0.17467,7,3668.060709,203.78115,524.008673,139.313982,2,0
0,0,28,28,17,31,48,141,75,216,0.000333,0.402117,16,19301.6304,1072.3128,1206.3519,223.066954,10,0
0,0,5,5,12,12,24,36,18,54,0.000333,0.082529,6,1485.52785,82.529325,247.587975,86.0391,2,0
0,0,9,9,15,19,34,68,35,103,0.000333,0.17467,7,3668.060709,203.78115,524.008673,139.313982,2,0
0,0,11,11,15,21,36,84,43,127,0.000333,0.21886,14,9192.126653,510.673703,656.580475,150.842025,2,0
0,0,2,2,12,9,21,18,11,29,0.000333,0.042459,6,764.263232,42.459068,127.377205,71.548875,1,0
0,0,4,4,10,15,25,32,21,53,0.000333,0.082041,5,1230.62189,68.367883,246.124378,91.82264,1,0
0,0,10,10,7,14,21,57,36,93,0.000333,0.136162,6,2450.913122,136.16184,408.48552,72.954453,1,0
0,0,5,5,11,12,23,33,21,54,0.000333,0.081424,5,1221.361728,67.853429,244.272346,81.073298,1,0
0,0,25,25,12,35,47,382,213,595,0.000333,1.10166,36,118979.2932,6609.960733,3304.980367,222.544456,4,0
0,0,7,7,10,13,23,39,24,63,0.000333,0.094995,5,1424.922016,79.162334,284.984403,81.324997,2,0
0,0,8,8,13,13,26,39,26,65,0.000333,0.101843,12,3666.34298,203.685721,305.528582,96.211433,3,0
0,0,9,9,11,18,29,41,32,73,0.000333,0.118211,5,1773.163063,98.509059,354.632613,113.112398,3,0
0,0,17,17,15,32,47,87,60,147,0.000333,0.272175,7,5715.671928,317.537329,816.524561,218.603359,4,0
0,0,6,6,7,11,18,41,25,66,0.000333,0.091738,6,1651.290301,91.73835,275.21505,57.705232,1,0
0,0,6,6,13,13,26,42,21,63,0.000333,0.098709,6,1776.766213,98.709234,296.127702,96.211433,2,0
0,0,15,15,16,22,38,101,51,152,0.000333,0.265895,16,12762.95971,709.053317,797.684982,162.107496,6,0
0,0,4,4,6,8,14,28,15,43,0.000333,0.054572,3,491.148785,27.286044,163.716262,39.509775,1,0
0,0,11,11,15,21,36,84,43,127,0.000333,0.21886,14,9192.126653,510.673703,656.580475,150.842025,2,0
0,0,9,9,15,19,34,68,35,103,0.000333,0.17467,7,3668.060709,203.78115,524.008673,139.313982,2,0
0,0,7,7,10,13,23,39,24,63,0.000333,0.094995,5,1424.922016,79.162334,284.984403,81.324997,2,0
0,0,6,6,7,11,18,41,25,66,0.000333,0.091738,6,1651.290301,91.73835,275.21505,57.705232,1,0
0,0,3,3,7,5,12,25,10,35,0.000333,0.041825,6,752.842125,41.824563,125.473688,31.261125,5,0
0,0,21,21,16,33,49,93,54,147,0.000333,0.275121,8,6602.898777,366.82771,825.362347,230.465006,5,0
0,0,30,30,17,41,58,152,84,236,0.000333,0.460828,16,22119.73624,1228.874235,1382.483515,289.1465,9,0
0,0,11,11,15,21,36,84,43,127,0.000333,0.21886,14,9192.126653,510.673703,656.580475,150.842025,2,0
0,0,9,9,15,19,34,68,35,103,0.000333,0.17467,7,3668.060709,203.78115,524.008673,139.313982,2,0
0,0,20,20,11,29,40,100,61,161,0.000333,0.28561,10,8568.304233,476.016902,856.830423,178.935197,1,0
0,0,8,8,13,13,26,39,26,65,0.000333,0.101843,12,3666.34298,203.685721,305.528582,96.211433,3,0
0,0,9,9,15,19,34,68,35,103,0.000333,0.17467,7,3668.060709,203.78115,524.008673,139.313982,2,0
0,0,11,11,15,21,36,84,43,127,0.000333,0.21886,14,9192.126653,510.673703,656.580475,150.842025,2,0
0,0,32,32,18,41,59,184,110,294,0.000333,0.576499,18,31130.94702,1729.497057,1729.497057,294.718282,10,0
0,0,20,20,17,26,43,115,68,183,0.000333,0.331002,16,15888.1032,882.6724,993.00645,191.698301,4,0
0,0,5,5,12,12,24,36,18,54,0.000333,0.082529,6,1485.52785,82.529325,247.587975,86.0391,2,0
0,0,9,9,15,19,34,68,35,103,0.000333,0.17467,7,3668.060709,203.78115,524.008673,139.313982,2,0
0,0,11,11,15,21,36,84,43,127,0.000333,0.21886,14,9192.126653,510.673703,656.580475,150.842025,2,0
0,0,17,17,16,28,44,76,45,121,0.000333,0.220197,8,5284.729807,293.5961,660.591226,198.605938,5,0
0,0,26,26,17,37,54,135,75,210,0.000333,0.402842,16,19336.42201,1074.245667,1208.526375,262.236643,9,0
0,0,11,11,15,21,36,84,43,127,0.000333,0.21886,14,9192.126653,510.673703,656.580475,150.842025,2,0
0,0,18,18,12,27,39,94,58,152,0.000333,0.267794,12,9640.573647,535.587425,803.381137,171.401513,1,0
0,0,9,9,15,19,34,68,35,103,0.000333,0.17467,7,3668.060709,203.78115,524.008673,139.313982,2,0
0,0,34,34,12,40,52,121,78,199,0.000333,0.378129,6,6806.325023,378.129168,1134.387504,255.896674,11,0
0,0,6,6,7,11,18,41,25,66,0.000333,0.091738,6,1651.290301,91.73835,275.21505,57.705232,1,0
0,0,30,30,6,32,38,245,61,306,0.000333,0.535289,3,4817.597457,267.644303,1605.865819,175.509775,5,0
0,0,6,6,13,13,26,42,21,63,0.000333,0.098709,6,1776.766213,98.709234,296.127702,96.211433,2,0
0,0,15,15,16,22,38,101,51,152,0.000333,0.265895,16,12762.95971,709.053317,797.684982,162.107496,6,0
0,0,5,5,12,12,24,36,18,54,0.000333,0.082529,6,1485.52785,82.529325,247.587975,86.0391,2,0
0,0,2,2,7,5,12,14,7,21,0.000333,0.025095,3,225.852638,12.547369,75.284213,31.261125,4,0
0,0,9,9,15,19,34,68,35,103,0.000333,0.17467,7,3668.060709,203.78115,524.008673,139.313982,2,0
0,0,11,11,15,21,36,84,43,127,0.000333,0.21886,14,9192.126653,510.673703,656.580475,150.842025,2,0
0,0,7,7,10,13,23,39,24,63,0.000333,0.094995,5,1424.922016,79.162334,284.984403,81.324997,3,0
0,0,6,6,7,11,18,41,25,66,0.000333,0.091738,6,1651.290301,91.73835,275.21505,57.705232,1,0
0,0,10,10,11,16,27,44,30,74,0.000333,0.117287,5,1759.308376,97.739354,351.861675,102.053748,7,0
0,0,2,2,12,9,21,18,11,29,0.000333,0.042459,6,764.263232,42.459068,127.377205,71.548875,1,0
0,0,35,35,21,47,68,179,113,292,0.000333,0.592513,20,35550.78299,1975.0435,1777.53915,353.304342,15,0
0,0,34,34,20,43,63,162,113,275,0.000333,0.547917,20,32875.03958,1826.391088,1643.751979,319.767946,13,0
0,0,9,9,15,20,35,72,36,108,0.000333,0.184654,7,3877.737961,215.429887,553.962566,145.041921,2,0
0,0,9,9,15,19,34,68,35,103,0.000333,0.17467,7,3668.060709,203.78115,524.008673,139.313982,2,0
0,0,18,18,12,26,38,112,61,173,0.000333,0.30263,12,10894.69752,605.260973,907.89146,165.230983,3,0
0,0,6,6,13,13,26,42,21,63,0.000333,0.098709,6,1776.766213,98.709234,296.127702,96.211433,2,0
0,0,15,15,16,22,38,101,51,152,0.000333,0.265895,16,12762.95971,709.053317,797.684982,162.107496,6,0
0,0,9,9,15,19,34,68,35,103,0.000333,0.17467,7,3668.060709,203.78115,524.008673,139.313982,2,0
0,0,11,11,15,21,36,84,43,127,0.000333,0.21886,14,9192.126653,510.673703,656.580475,150.842025,2,0
0,0,9,9,15,19,34,68,35,103,0.000333,0.17467,7,3668.060709,203.78115,524.008673,139.313982,2,0
0,0,11,11,15,21,36,84,43,127,0.000333,0.21886,14,9192.126653,510.673703,656.580475,150.842025,2,0
0,0,23,23,14,32,46,116,78,194,0.000333,0.35719,14,15001.99427,833.444126,1071.571019,213.302969,1,0
0,0,15,15,16,22,38,101,51,152,0.000333,0.265895,16,12762.95971,709.053317,797.684982,162.107496,6,0
0,0,6,6,13,13,26,42,21,63,0.000333,0.098709,6,1776.766213,98.709234,296.127702,96.211433,2,0
0,0,5,5,12,12,24,36,18,54,0.000333,0.082529,6,1485.52785,82.529325,247.587975,86.0391,2,0
0,0,11,11,15,21,36,84,43,127,0.000333,0.21886,14,9192.126653,510.673703,656.580475,150.842025,2,0
0,0,5,5,7,8,15,27,15,42,0.000333,0.054696,3,492.268215,27.348234,164.089405,43.651484,1,0
0,0,9,9,15,19,34,68,35,103,0.000333,0.17467,7,3668.060709,203.78115,524.008673,139.313982,2,0
0,0,5,5,12,12,24,36,18,54,0.000333,0.082529,6,1485.52785,82.529325,247.587975,86.0391,2,0
0,0,7,7,10,13,23,39,24,63,0.000333,0.094995,5,1424.922016,79.162334,284.984403,81.324997,2,0
0,0,8,8,11,15,26,37,29,66,0.000333,0.10341,5,1551.145107,86.174728,310.229021,96.657107,1,0
0,0,6,6,7,11,18,41,25,66,0.000333,0.091738,6,1651.290301,91.73835,275.21505,57.705232,1,0
0,0,25,25,17,35,52,132,73,205,0.000333,0.38953,16,18697.44228,1038.746793,1168.590142,249.011774,9,0
0,0,16,16,16,26,42,73,43,116,0.000333,0.208503,8,5004.070568,278.00392,625.508821,186.211433,5,0
0,0,9,9,15,19,34,68,35,103,0.000333,0.17467,7,3668.060709,203.78115,524.008673,139.313982,2,0
0,0,18,18,11,28,39,116,64,180,0.000333,0.317124,10,9513.723994,528.540222,951.372399,172.659686,1,0
0,0,11,11,15,21,36,84,43,127,0.000333,0.21886,14,9192.126653,510.673703,656.580475,150.842025,2,0
0,0,30,30,13,34,47,194,107,301,0.000333,0.55731,18,30094.7624,1671.931244,1671.931244,221.079453,1,0
0,0,6,6,13,13,26,42,21,63,0.000333,0.098709,6,1776.766213,98.709234,296.127702,96.211433,2,0
0,0,5,5,12,12,24,36,18,54,0.000333,0.082529,6,1485.52785,82.529325,247.587975,86.0391,2,0
0,0,15,15,16,22,38,101,51,152,0.000333,0.265895,16,12762.95971,709.053317,797.684982,162.107496,6,0
0,0,9,9,15,19,34,68,35,103,0.000333,0.17467,7,3668.060709,203.78115,524.008673,139.313982,2,0
0,0,11,11,15,21,36,84,43,127,0.000333,0.21886,14,9192.126653,510.673703,656.580475,150.842025,2,0
0,0,3,3,9,7,16,19,11,30,0.000333,0.04,4,480,26.666667,120,48.180809,2,0
0,0,6,6,13,13,26,42,21,63,0.000333,0.098709,6,1776.766213,98.709234,296.127702,96.211433,2,0
0,0,15,15,16,22,38,101,51,152,0.000333,0.265895,16,12762.95971,709.053317,797.684982,162.107496,6,0
0,0,11,11,15,21,36,84,43,127,0.000333,0.21886,14,9192.126653,510.673703,656.580475,150.842025,2,0
0,0,9,9,15,19,34,68,35,103,0.000333,0.17467,7,3668.060709,203.78115,524.008673,139.313982,2,0
0,0,6,6,13,13,26,42,21,63,0.000333,0.098709,6,1776.766213,98.709234,296.127702,96.211433,2,0
0,0,15,15,16,22,38,101,51,152,0.000333,0.265895,16,12762.95971,709.053317,797.684982,162.107496,6,0
0,0,8,8,13,13,26,39,26,65,0.000333,0.101843,12,3666.34298,203.685721,305.528582,96.211433,3,0
0,0,9,9,15,19,34,68,35,103,0.000333,0.17467,7,3668.060709,203.78115,524.008673,139.313982,2,0
0,0,2,2,8,6,14,26,9,35,0.000333,0.044419,4,533.029689,29.612761,133.257422,39.509775,4,0
0,0,11,11,15,21,36,84,43,127,0.000333,0.21886,14,9192.126653,510.673703,656.580475,150.842025,2,0
0,0,9,9,14,21,35,61,33,94,0.000333,0.160718,7,3375.068225,187.50379,482.152604,145.541635,3,0
0,0,17,17,11,20,31,90,54,144,0.000333,0.237801,10,7134.042687,396.335705,713.404269,124.49231,4,0
0,0,11,11,15,21,36,84,43,127,0.000333,0.21886,14,9192.126653,510.673703,656.580475,150.842025,2,0
0,0,9,9,15,19,34,68,35,103,0.000333,0.17467,7,3668.060709,203.78115,524.008673,139.313982,2,0
0,0,7,7,10,13,23,39,24,63,0.000333,0.094995,5,1424.922016,79.162334,284.984403,81.324997,2,0
0,0,17,17,10,24,34,121,71,192,0.000333,0.325598,10,9767.928655,542.662703,976.792866,143.258381,7,0
0,0,6,6,7,11,18,41,25,66,0.000333,0.091738,6,1651.290301,91.73835,275.21505,57.705232,1,0
0,0,4,4,6,10,16,26,15,41,0.000333,0.054667,3,492,27.333333,164,48.729056,1,0
0,0,25,25,12,35,47,382,213,595,0.000333,1.10166,36,118979.2932,6609.960733,3304.980367,222.544456,4,0
0,0,5,5,11,12,23,33,21,54,0.000333,0.081424,5,1221.361728,67.853429,244.272346,81.073298,1,0
0,0,10,10,7,14,21,57,36,93,0.000333,0.136162,6,2450.913122,136.16184,408.48552,72.954453,1,0
0,0,4,4,10,15,25,32,21,53,0.000333,0.082041,5,1230.62189,68.367883,246.124378,91.82264,1,0
0,0,11,11,15,21,36,84,43,127,0.000333,0.21886,14,9192.126653,510.673703,656.580475,150.842025,2,0
0,0,9,9,15,19,34,68,35,103,0.000333,0.17467,7,3668.060709,203.78115,524.008673,139.313982,2,0
0,0,28,28,15,34,49,161,94,255,0.000333,0.47725,14,20044.51414,1113.584119,1431.75101,231.577096,3,0
0,0,9,9,15,19,34,68,35,103,0.000333,0.17467,7,3668.060709,203.78115,524.008673,139.313982,2,0
0,0,9,9,15,20,35,72,36,108,0.000333,0.184654,7,3877.737961,215.429887,553.962566,145.041921,2,0
0,0,2,2,7,5,12,20,7,27,0.000333,0.032265,3,290.381963,16.132331,96.793988,31.261125,2,0
0,0,8,8,13,13,26,39,26,65,0.000333,0.101843,12,3666.34298,203.685721,305.528582,96.211433,3,0
0,0,11,11,15,21,36,84,43,127,0.000333,0.21886,14,9192.126653,510.673703,656.580475,150.842025,2,0
0,0,9,9,15,19,34,68,35,103,0.000333,0.17467,7,3668.060709,203.78115,524.008673,139.313982,2,0
0,0,9,9,14,21,35,61,33,94,0.000333,0.160718,7,3375.068225,187.50379,482.152604,145.541635,2,0
0,0,2,2,8,6,14,26,9,35,0.000333,0.044419,4,533.029689,29.612761,133.257422,39.509775,2,0
0,0,21,21,12,30,42,162,80,242,0.000333,0.43498,12,15659.2898,869.960544,1304.940816,190.226268,1,0
0,0,9,9,15,19,34,68,35,103,0.000333,0.17467,7,3668.060709,203.78115,524.008673,139.313982,2,0
0,0,11,11,15,21,36,84,43,127,0.000333,0.21886,14,9192.126653,510.673703,656.580475,150.842025,2,0
0,0,6,6,13,13,26,42,21,63,0.000333,0.098709,6,1776.766213,98.709234,296.127702,96.211433,2,0
0,0,15,15,16,22,38,101,51,152,0.000333,0.265895,16,12762.95971,709.053317,797.684982,162.107496,6,0
0,0,5,5,12,12,24,36,18,54,0.000333,0.082529,6,1485.52785,82.529325,247.587975,86.0391,2,0
0,0,11,11,15,21,36,84,43,127,0.000333,0.21886,14,9192.126653,510.673703,656.580475,150.842025,2,0
0,0,9,9,15,19,34,68,35,103,0.000333,0.17467,7,3668.060709,203.78115,524.008673,139.313982,2,0
0,0,5,5,12,12,24,36,18,54,0.000333,0.082529,6,1485.52785,82.529325,247.587975,86.0391,2,0
0,0,6,6,13,13,26,42,21,63,0.000333,0.098709,6,1776.766213,98.709234,296.127702,96.211433,2,0
0,0,15,15,16,22,38,101,51,152,0.000333,0.265895,16,12762.95971,709.053317,797.684982,162.107496,6,0
0,0,2,2,7,5,12,14,7,21,0.000333,0.025095,3,225.852638,12.547369,75.284213,31.261125,2,0
0,0,11,11,15,21,36,84,43,127,0.000333,0.21886,14,9192.126653,510.673703,656.580475,150.842025,2,0
0,0,9,9,15,19,34,68,35,103,0.000333,0.17467,7,3668.060709,203.78115,524.008673,139.313982,2,0
0,0,6,6,9,12,21,40,22,62,0.000333,0.090775,4,1089.294721,60.516373,272.32368,71.548875,2,0
0,0,19,19,17,31,48,114,62,176,0.000333,0.327651,16,15727.2544,873.736356,982.9534,223.066954,7,0
0,0,10,10,14,22,36,55,32,87,0.000333,0.149928,7,3148.484326,174.915796,449.783475,151.410465,3,0
0,0,4,4,6,6,12,21,10,31,0.000333,0.037045,3,333.401513,18.522306,111.133838,31.01955,1,0
0,0,11,11,15,21,36,84,43,127,0.000333,0.21886,14,9192.126653,510.673703,656.580475,150.842025,2,0
0,0,9,9,15,19,34,68,35,103,0.000333,0.17467,7,3668.060709,203.78115,524.008673,139.313982,2,0
0,0,3,3,4,5,9,7,6,13,0.000333,0.013736,2,82.41805,4.578781,41.209025,19.60964,1,0
0,0,3,3,9,5,14,12,6,18,0.000333,0.022844,4,274.129554,15.22942,68.532389,40.138965,2,0
0,0,2,2,8,6,14,15,9,24,0.000333,0.030459,4,365.506073,20.305893,91.376518,39.509775,2,0
0,0,3,3,12,6,18,15,7,22,0.000333,0.030579,6,550.4301,30.57945,91.73835,58.529325,3,0
0,0,3,3,4,5,9,7,6,13,0.000333,0.013736,2,82.41805,4.578781,41.209025,19.60964,1,0
0,0,4,4,7,8,15,24,15,39,0.000333,0.05079,3,457.1062,25.394789,152.368733,43.651484,2,0
0,0,2,2,7,6,13,15,9,24,0.000333,0.029604,3,266.43166,14.801759,88.810553,35.161259,2,0
0,0,1,1,7,5,12,8,6,14,0.000333,0.01673,3,150.568425,8.364913,50.189475,31.261125,1,0
0,0,2,2,7,5,12,13,8,21,0.000333,0.025095,3,225.852638,12.547369,75.284213,31.261125,1,0
0,0,2,2,12,7,19,19,11,30,0.000333,0.042479,6,764.626952,42.479275,127.437825,62.671034,2,0
0,0,3,3,12,6,18,19,7,26,0.000333,0.036139,6,650.5083,36.13935,108.41805,58.529325,3,0
0,0,2,2,12,9,21,18,11,29,0.000333,0.042459,6,764.263232,42.459068,127.377205,71.548875,1,0
0,0,34,34,19,44,63,162,115,277,0.000333,0.551902,18,29802.7177,1655.706539,1655.706539,320.925614,14,0
0,0,39,39,21,52,73,203,135,338,0.000333,0.697387,20,41843.21402,2324.623001,2092.160701,388.661531,17,0
0,0,11,11,15,21,36,84,43,127,0.000333,0.21886,14,9192.126653,510.673703,656.580475,150.842025,2,0
0,0,9,9,15,19,34,68,35,103,0.000333,0.17467,7,3668.060709,203.78115,524.008673,139.313982,2,0
0,0,30,30,18,43,61,151,90,241,0.000333,0.476436,18,25727.53857,1429.307698,1429.307698,308.388034,13,0
0,0,21,21,16,34,50,92,60,152,0.000333,0.285955,8,6862.929127,381.27384,857.866141,236.973737,9,0
0,0,7,7,9,14,23,46,27,73,0.000333,0.110073,4,1320.880091,73.382227,330.220023,81.832294,4,0
0,0,11,11,15,21,36,84,43,127,0.000333,0.21886,14,9192.126653,510.673703,656.580475,150.842025,2,0
0,0,9,9,15,19,34,68,35,103,0.000333,0.17467,7,3668.060709,203.78115,524.008673,139.313982,2,0
0,0,5,5,6,11,17,24,18,42,0.000333,0.057224,3,515.020318,28.61224,171.673439,53.563523,5,0
0,0,28,28,19,64,83,217,134,351,0.000333,0.74588,18,40277.49913,2237.63884,2237.63884,464.710623,6,0
0,0,19,19,18,57,75,158,104,262,0.000333,0.543983,9,14687.55447,815.975248,1631.950497,407.533381,2,0
0,0,9,9,15,19,34,68,35,103,0.000333,0.17467,7,3668.060709,203.78115,524.008673,139.313982,2,0
0,0,4,4,4,8,12,15,13,28,0.000333,0.03346,2,200.7579,11.153217,100.37895,32,1,0
0,0,11,11,15,21,36,84,43,127,0.000333,0.21886,14,9192.126653,510.673703,656.580475,150.842025,2,0
0,0,11,11,15,21,36,84,43,127,0.000333,0.21886,14,9192.126653,510.673703,656.580475,150.842025,2,0
0,0,28,28,15,36,51,164,98,262,0.000333,0.495392,14,20806.45615,1155.914231,1486.17544,244.720659,5,0
0,0,9,9,15,19,34,68,35,103,0.000333,0.17467,7,3668.060709,203.78115,524.008673,139.313982,2,0
0,0,16,16,17,38,55,101,58,159,0.000333,0.306412,8,7353.889556,408.54942,919.236194,268.908114,11,0
0,0,25,25,18,44,62,160,88,248,0.000333,0.492214,18,26579.53233,1476.640685,1476.640685,315.273641,15,0
0,0,3,3,4,5,9,7,6,13,0.000333,0.013736,2,82.41805,4.578781,41.209025,19.60964,1,0
0,0,3,3,12,6,18,15,7,22,0.000333,0.030579,6,550.4301,30.57945,91.73835,58.529325,3,0
0,0,4,4,7,8,15,24,15,39,0.000333,0.05079,3,457.1062,25.394789,152.368733,43.651484,2,0
0,0,2,2,7,6,13,15,9,24,0.000333,0.029604,3,266.43166,14.801759,88.810553,35.161259,2,0
0,0,1,1,7,5,12,8,6,14,0.000333,0.01673,3,150.568425,8.364913,50.189475,31.261125,1,0
0,0,9,9,15,19,34,68,35,103,0.000333,0.17467,7,3668.060709,203.78115,524.008673,139.313982,2,0
0,0,3,3,4,5,9,7,6,13,0.000333,0.013736,2,82.41805,4.578781,41.209025,19.60964,1,0
0,0,3,3,9,5,14,12,6,18,0.000333,0.022844,4,274.129554,15.22942,68.532389,40.138965,2,0
0,0,2,2,8,6,14,15,9,24,0.000333,0.030459,4,365.506073,20.305893,91.376518,39.509775,2,0
0,0,11,11,15,21,36,84,43,127,0.000333,0.21886,14,9192.126653,510.673703,656.580475,150.842025,2,0
0,0,2,2,7,5,12,13,8,21,0.000333,0.025095,3,225.852638,12.547369,75.284213,31.261125,1,0
0,0,3,3,12,6,18,19,7,26,0.000333,0.036139,6,650.5083,36.13935,108.41805,58.529325,3,0
0,0,2,2,12,7,19,19,11,30,0.000333,0.042479,6,764.626952,42.479275,127.437825,62.671034,2,0
0,0,34,34,20,44,64,163,114,277,0.000333,0.554,20,33240,1846.666667,1662,326.653553,13,0
0,0,35,35,21,48,69,180,114,294,0.000333,0.598635,20,35918.12381,1995.451323,1795.90619,360.316866,15,0
0,0,2,2,12,9,21,18,11,29,0.000333,0.042459,6,764.263232,42.459068,127.377205,71.548875,1,0
0,0,9,9,15,19,34,68,35,103,0.000333,0.17467,7,3668.060709,203.78115,524.008673,139.313982,2,0
0,0,20,20,12,27,39,115,66,181,0.000333,0.318886,12,11479.89362,637.771868,956.657802,171.401513,1,0
0,0,11,11,15,21,36,84,43,127,0.000333,0.21886,14,9192.126653,510.673703,656.580475,150.842025,2,0
0,0,11,11,15,21,36,84,43,127,0.000333,0.21886,14,9192.126653,510.673703,656.580475,150.842025,2,0
0,0,9,9,15,19,34,68,35,103,0.000333,0.17467,7,3668.060709,203.78115,524.008673,139.313982,2,0
0,0,7,7,10,13,23,39,24,63,0.000333,0.094995,5,1424.922016,79.162334,284.984403,81.324997,2,0
0,0,7,7,10,14,24,46,27,73,0.000333,0.111567,5,1673.511313,92.972851,334.702263,86.52225,2,0
0,0,5,5,12,12,24,36,18,54,0.000333,0.082529,6,1485.52785,82.529325,247.587975,86.0391,2,0
0,0,6,6,7,11,18,41,25,66,0.000333,0.091738,6,1651.290301,91.73835,275.21505,57.705232,1,0
0,0,4,4,6,10,16,26,15,41,0.000333,0.054667,3,492,27.333333,164,48.729056,1,0
0,0,5,5,6,10,16,23,18,41,0.000333,0.054667,3,492,27.333333,164,48.729056,1,0
0,0,25,25,17,35,52,132,73,205,0.000333,0.38953,16,18697.44228,1038.746793,1168.590142,249.011774,10,0
0,0,16,16,16,26,42,73,43,116,0.000333,0.208503,8,5004.070568,278.00392,625.508821,186.211433,6,0
0,0,9,9,15,19,34,68,35,103,0.000333,0.17467,7,3668.060709,203.78115,524.008673,139.313982,2,0
0,0,11,11,15,21,36,84,43,127,0.000333,0.21886,14,9192.126653,510.673703,656.580475,150.842025,2,0
0,0,25,25,12,35,47,382,213,595,0.000333,1.10166,36,118979.2932,6609.960733,3304.980367,222.544456,4,0
0,0,4,4,10,15,25,32,21,53,0.000333,0.082041,5,1230.62189,68.367883,246.124378,91.82264,1,0
0,0,14,14,11,23,34,85,48,133,0.000333,0.225544,10,6766.325579,375.906977,676.632558,142.095673,6,0
0,0,5,5,11,12,23,33,21,54,0.000333,0.081424,5,1221.361728,67.853429,244.272346,81.073298,1,0
0,0,6,6,13,13,26,42,21,63,0.000333,0.098709,6,1776.766213,98.709234,296.127702,96.211433,2,0
0,0,15,15,16,22,38,101,51,152,0.000333,0.265895,16,12762.95971,709.053317,797.684982,162.107496,6,0
0,0,11,11,15,21,36,84,43,127,0.000333,0.21886,14,9192.126653,510.673703,656.580475,150.842025,2,0
0,0,4,4,4,7,11,17,13,30,0.000333,0.034594,2,207.565897,11.531439,103.782949,27.651484,4,0
0,0,9,9,15,19,34,68,35,103,0.000333,0.17467,7,3668.060709,203.78115,524.008673,139.313982,2,0
0,0,16,16,16,26,42,73,43,116,0.000333,0.208503,8,5004.070568,278.00392,625.508821,186.211433,5,0
0,0,25,25,17,35,52,132,73,205,0.000333,0.38953,16,18697.44228,1038.746793,1168.590142,249.011774,9,0
0,0,2,2,8,6,14,26,9,35,0.000333,0.044419,4,533.029689,29.612761,133.257422,39.509775,2,0
0,0,11,11,15,21,36,84,43,127,0.000333,0.21886,14,9192.126653,510.673703,656.580475,150.842025,2,0
0,0,9,9,15,19,34,68,35,103,0.000333,0.17467,7,3668.060709,203.78115,524.008673,139.313982,2,0
0,0,6,6,13,13,26,42,21,63,0.000333,0.098709,6,1776.766213,98.709234,296.127702,96.211433,2,0
0,0,15,15,16,22,38,101,51,152,0.000333,0.265895,16,12762.95971,709.053317,797.684982,162.107496,6,0
0,0,11,11,15,21,36,84,43,127,0.000333,0.21886,14,9192.126653,510.673703,656.580475,150.842025,2,0
0,0,9,9,15,19,34,68,35,103,0.000333,0.17467,7,3668.060709,203.78115,524.008673,139.313982,2,0
0,0,3,3,4,5,9,7,6,13,0.000333,0.013736,2,82.41805,4.578781,41.209025,19.60964,1,0
0,0,3,3,9,5,14,12,6,18,0.000333,0.022844,4,274.129554,15.22942,68.532389,40.138965,2,0
0,0,2,2,8,6,14,15,9,24,0.000333,0.030459,4,365.506073,20.305893,91.376518,39.509775,2,0
0,0,3,3,12,6,18,15,7,22,0.000333,0.030579,6,550.4301,30.57945,91.73835,58.529325,3,0
0,0,3,3,4,5,9,7,6,13,0.000333,0.013736,2,82.41805,4.578781,41.209025,19.60964,1,0
0,0,4,4,7,8,15,24,15,39,0.000333,0.05079,3,457.1062,25.394789,152.368733,43.651484,2,0
0,0,2,2,7,6,13,15,9,24,0.000333,0.029604,3,266.43166,14.801759,88.810553,35.161259,2,0
0,0,1,1,7,5,12,8,6,14,0.000333,0.01673,3,150.568425,8.364913,50.189475,31.261125,1,0
0,0,2,2,7,5,12,13,8,21,0.000333,0.025095,3,225.852638,12.547369,75.284213,31.261125,1,0
0,0,2,2,12,7,19,19,11,30,0.000333,0.042479,6,764.626952,42.479275,127.437825,62.671034,2,0
0,0,3,3,12,6,18,19,7,26,0.000333,0.036139,6,650.5083,36.13935,108.41805,58.529325,3,0
0,0,15,15,16,22,38,101,51,152,0.000333,0.265895,16,12762.95971,709.053317,797.684982,162.107496,6,0
0,0,6,6,13,13,26,42,21,63,0.000333,0.098709,6,1776.766213,98.709234,296.127702,96.211433,2,0
0,0,11,11,15,21,36,84,43,127,0.000333,0.21886,14,9192.126653,510.673703,656.580475,150.842025,2,0
0,0,9,9,15,19,34,68,35,103,0.000333,0.17467,7,3668.060709,203.78115,524.008673,139.313982,2,0
0,0,2,2,7,5,12,20,7,27,0.000333,0.032265,3,290.381963,16.132331,96.793988,31.261125,2,0
0,0,9,9,15,19,34,68,35,103,0.000333,0.17467,7,3668.060709,203.78115,524.008673,139.313982,2,0
0,0,11,11,15,21,36,84,43,127,0.000333,0.21886,14,9192.126653,510.673703,656.580475,150.842025,2,0
0,0,15,15,12,20,32,85,48,133,0.000333,0.221667,12,7980,443.333333,665,129.458112,2,0
0,0,16,16,16,26,42,73,43,116,0.000333,0.208503,8,5004.070568,278.00392,625.508821,186.211433,5,0
0,0,25,25,17,35,52,132,73,205,0.000333,0.38953,16,18697.44228,1038.746793,1168.590142,249.011774,9,0
0,0,9,9,15,19,34,68,35,103,0.000333,0.17467,7,3668.060709,203.78115,524.008673,139.313982,2,0
0,0,19,19,13,27,40,113,65,178,0.000333,0.315768,12,11367.63841,631.535467,947.303201,176.487679,1,0
0,0,11,11,15,21,36,84,43,127,0.000333,0.21886,14,9192.126653,510.673703,656.580475,150.842025,2,0
0,0,7,7,10,13,23,39,24,63,0.000333,0.094995,5,1424.922016,79.162334,284.984403,81.324997,2,0
0,0,6,6,7,11,18,41,25,66,0.000333,0.091738,6,1651.290301,91.73835,275.21505,57.705232,1,0
0,0,5,5,7,11,18,26,18,44,0.000333,0.061159,3,550.4301,30.57945,183.4767,57.705232,1,0
0,0,2,2,12,9,21,18,11,29,0.000333,0.042459,6,764.263232,42.459068,127.377205,71.548875,1,0
0,0,30,30,20,48,68,140,101,241,0.000333,0.489026,20,29341.5709,1630.087272,1467.078545,354.516762,11,0
0,0,31,31,19,50,69,161,95,256,0.000333,0.521261,9,14074.04035,781.89113,1563.782261,362.903432,9,0
0,0,11,11,15,21,36,84,43,127,0.000333,0.21886,14,9192.126653,510.673703,656.580475,150.842025,2,0
0,0,9,9,15,19,34,68,35,103,0.000333,0.17467,7,3668.060709,203.78115,524.008673,139.313982,2,0
0,0,7,7,10,13,23,39,24,63,0.000333,0.094995,5,1424.922016,79.162334,284.984403,81.324997,2,0
0,0,5,5,12,12,24,36,18,54,0.000333,0.082529,6,1485.52785,82.529325,247.587975,86.0391,3,0
0,0,6,6,7,11,18,41,25,66,0.000333,0.091738,6,1651.290301,91.73835,275.21505,57.705232,1,0
0,0,2,2,7,5,12,14,7,21,0.000333,0.025095,3,225.852638,12.547369,75.284213,31.261125,2,0
0,0,8,8,13,13,26,39,26,65,0.000333,0.101843,12,3666.34298,203.685721,305.528582,96.211433,3,0
0,0,9,9,15,19,34,68,35,103,0.000333,0.17467,7,3668.060709,203.78115,524.008673,139.313982,2,0
0,0,26,26,16,37,53,152,92,244,0.000333,0.465871,16,22361.80146,1242.322303,1397.612591,256.749775,10,0
0,0,15,15,15,22,37,87,53,140,0.000333,0.243108,14,10210.5286,567.251589,729.323471,156.710855,8,0
0,0,11,11,15,21,36,84,43,127,0.000333,0.21886,14,9192.126653,510.673703,656.580475,150.842025,2,0
0,0,2,2,12,9,21,18,11,29,0.000333,0.042459,6,764.263232,42.459068,127.377205,71.548875,1,0
0,0,41,41,21,51,72,210,141,351,0.000333,0.721881,20,43312.87351,2406.270751,2165.643676,381.532358,17,0
0,0,40,40,19,46,65,193,139,332,0.000333,0.666475,27,53984.50508,2999.139171,1999.426114,334.794473,15,0
0,0,8,8,8,16,24,57,30,87,0.000333,0.132964,4,1595.56695,88.642608,398.891738,88,1,0
0,0,11,11,15,21,36,84,43,127,0.000333,0.21886,14,9192.126653,510.673703,656.580475,150.842025,2,0
0,0,9,9,15,19,34,68,35,103,0.000333,0.17467,7,3668.060709,203.78115,524.008673,139.313982,2,0
0,0,9,9,15,19,34,68,35,103,0.000333,0.17467,7,3668.060709,203.78115,524.008673,139.313982,2,0
0,0,4,4,10,15,25,32,21,53,0.000333,0.082041,5,1230.62189,68.367883,246.124378,91.82264,1,0
0,0,11,11,15,21,36,84,43,127,0.000333,0.21886,14,9192.126653,510.673703,656.580475,150.842025,2,0
0,0,5,5,11,12,23,33,21,54,0.000333,0.081424,5,1221.361728,67.853429,244.272346,81.073298,1,0
0,0,25,25,12,35,47,382,213,595,0.000333,1.10166,36,118979.2932,6609.960733,3304.980367,222.544456,4,0
0,0,14,14,11,23,34,85,48,133,0.000333,0.225544,10,6766.325579,375.906977,676.632558,142.095673,6,0
0,0,7,7,10,13,23,39,24,63,0.000333,0.094995,5,1424.922016,79.162334,284.984403,81.324997,2,0
0,0,3,3,6,6,12,15,9,24,0.000333,0.02868,3,258.1173,14.33985,86.0391,31.01955,5,0
0,0,6,6,7,11,18,41,25,66,0.000333,0.091738,6,1651.290301,91.73835,275.21505,57.705232,1,0
0,0,2,2,12,9,21,18,11,29,0.000333,0.042459,6,764.263232,42.459068,127.377205,71.548875,1,0
0,0,15,15,16,22,38,101,51,152,0.000333,0.265895,16,12762.95971,709.053317,797.684982,162.107496,6,0
0,0,6,6,13,13,26,42,21,63,0.000333,0.098709,6,1776.766213,98.709234,296.127702,96.211433,2,0
0,0,2,2,7,5,12,20,7,27,0.000333,0.032265,3,290.381963,16.132331,96.793988,31.261125,2,0
0,0,11,11,15,21,36,84,43,127,0.000333,0.21886,14,9192.126653,510.673703,656.580475,150.842025,2,0
0,0,9,9,15,19,34,68,35,103,0.000333,0.17467,7,3668.060709,203.78115,524.008673,139.313982,2,0
0,0,2,2,12,9,21,18,11,29,0.000333,0.042459,6,764.263232,42.459068,127.377205,71.548875,1,0
0,0,38,38,21,49,70,198,131,329,0.000333,0.672178,20,40330.68225,2240.593458,2016.534113,367.359448,16,0
0,0,37,37,19,44,63,181,129,310,0.000333,0.617652,18,33353.22197,1852.956776,1852.956776,320.925614,14,0
0,0,11,11,15,21,36,84,43,127,0.000333,0.21886,14,9192.126653,510.673703,656.580475,150.842025,2,0
0,0,9,9,15,19,34,68,35,103,0.000333,0.17467,7,3668.060709,203.78115,524.008673,139.313982,2,0
0,0,38,38,21,50,71,201,132,333,0.000333,0.682622,20,40957.31582,2275.406434,2047.865791,374.431475,16,0
0,0,2,2,12,9,21,18,11,29,0.000333,0.042459,6,764.263232,42.459068,127.377205,71.548875,1,0
0,0,33,33,20,42,62,160,112,272,0.000333,0.539847,20,32390.82793,1799.49044,1619.541396,312.915894,13,0
0,0,9,9,15,19,34,68,35,103,0.000333,0.17467,7,3668.060709,203.78115,524.008673,139.313982,2,0
0,0,19,19,17,26,43,126,71,197,0.000333,0.356325,16,17103.58651,950.19925,1068.974157,191.698301,3,0
0,0,11,11,15,21,36,84,43,127,0.000333,0.21886,14,9192.126653,510.673703,656.580475,150.842025,2,0
0,0,15,15,16,22,38,101,51,152,0.000333,0.265895,16,12762.95971,709.053317,797.684982,162.107496,6,0
0,0,6,6,13,13,26,42,21,63,0.000333,0.098709,6,1776.766213,98.709234,296.127702,96.211433,2,0
0,0,11,11,15,21,36,84,43,127,0.000333,0.21886,14,9192.126653,510.673703,656.580475,150.842025,2,0
0,0,9,9,15,19,34,68,35,103,0.000333,0.17467,7,3668.060709,203.78115,524.008673,139.313982,2,0
0,0,7,7,10,13,23,39,24,63,0.000333,0.094995,5,1424.922016,79.162334,284.984403,81.324997,2,0
0,0,6,6,7,11,18,41,25,66,0.000333,0.091738,6,1651.290301,91.73835,275.21505,57.705232,1,0
0,0,4,4,7,8,15,19,14,33,0.000333,0.042976,3,386.782169,21.487898,128.92739,43.651484,1,0
0,0,11,11,15,21,36,84,43,127,0.000333,0.21886,14,9192.126653,510.673703,656.580475,150.842025,2,0
0,0,9,9,15,19,34,68,35,103,0.000333,0.17467,7,3668.060709,203.78115,524.008673,139.313982,2,0
0,0,2,2,12,9,21,18,11,29,0.000333,0.042459,6,764.263232,42.459068,127.377205,71.548875,1,0
0,0,6,6,13,13,26,42,21,63,0.000333,0.098709,6,1776.766213,98.709234,296.127702,96.211433,2,0
0,0,15,15,16,22,38,101,51,152,0.000333,0.265895,16,12762.95971,709.053317,797.684982,162.107496,6,0
0,0,4,4,7,8,15,19,14,33,0.000333,0.042976,3,386.782169,21.487898,128.92739,43.651484,2,0
0,0,11,11,15,21,36,84,43,127,0.000333,0.21886,14,9192.126653,510.673703,656.580475,150.842025,2,0
0,0,9,9,15,19,34,68,35,103,0.000333,0.17467,7,3668.060709,203.78115,524.008673,139.313982,2,0
0,0,20,20,13,22,35,117,70,187,0.000333,0.319725,18,17265.16664,959.175924,959.175924,146.213212,4,0
0,0,6,6,13,13,26,42,21,63,0.000333,0.098709,6,1776.766213,98.709234,296.127702,96.211433,2,0
0,0,15,15,16,22,38,101,51,152,0.000333,0.265895,16,12762.95971,709.053317,797.684982,162.107496,6,0
0,0,11,11,15,21,36,84,43,127,0.000333,0.21886,14,9192.126653,510.673703,656.580475,150.842025,2,0
0,0,9,9,15,19,34,68,35,103,0.000333,0.17467,7,3668.060709,203.78115,524.008673,139.313982,2,0
0,0,4,4,7,10,17,24,15,39,0.000333,0.053137,3,478.233152,26.568508,159.411051,52.870765,1,0
0,0,5,5,16,12,28,43,23,66,0.000333,0.105762,8,2538.283399,141.015744,317.285425,107.01955,4,0
0,0,2,2,7,6,13,15,9,24,0.000333,0.029604,3,266.43166,14.801759,88.810553,35.161259,2,0
0,0,3,3,4,5,9,7,6,13,0.000333,0.013736,2,82.41805,4.578781,41.209025,19.60964,1,0
0,0,1,1,7,5,12,8,6,14,0.000333,0.01673,3,150.568425,8.364913,50.189475,31.261125,1,0
0,0,2,2,7,5,12,13,8,21,0.000333,0.025095,3,225.852638,12.547369,75.284213,31.261125,1,0
0,0,9,9,15,19,34,68,35,103,0.000333,0.17467,7,3668.060709,203.78115,524.008673,139.313982,2,0
0,0,3,3,9,5,14,12,6,18,0.000333,0.022844,4,274.129554,15.22942,68.532389,40.138965,2,0
0,0,3,3,4,5,9,7,6,13,0.000333,0.013736,2,82.41805,4.578781,41.209025,19.60964,1,0
0,0,2,2,8,6,14,15,9,24,0.000333,0.030459,4,365.506073,20.305893,91.376518,39.509775,2,0
0,0,4,4,7,8,15,24,15,39,0.000333,0.05079,3,457.1062,25.394789,152.368733,43.651484,2,0
0,0,3,3,12,6,18,19,7,26,0.000333,0.036139,6,650.5083,36.13935,108.41805,58.529325,3,0
0,0,2,2,12,7,19,19,11,30,0.000333,0.042479,6,764.626952,42.479275,127.437825,62.671034,2,0
0,0,11,11,15,21,36,84,43,127,0.000333,0.21886,14,9192.126653,510.673703,656.580475,150.842025,2,0
0,0,3,3,12,6,18,15,7,22,0.000333,0.030579,6,550.4301,30.57945,91.73835,58.529325,3,0
0,0,8,8,13,13,26,39,26,65,0.000333,0.101843,12,3666.34298,203.685721,305.528582,96.211433,3,0
0,0,9,9,15,19,34,68,35,103,0.000333,0.17467,7,3668.060709,203.78115,524.008673,139.313982,2,0
0,0,14,14,11,23,34,85,48,133,0.000333,0.225544,10,6766.325579,375.906977,676.632558,142.095673,1,0
0,0,5,5,11,12,23,33,21,54,0.000333,0.081424,5,1221.361728,67.853429,244.272346,81.073298,1,0
0,0,11,11,15,21,36,84,43,127,0.000333,0.21886,14,9192.126653,510.673703,656.580475,150.842025,2,0
0,0,4,4,10,15,25,32,21,53,0.000333,0.082041,5,1230.62189,68.367883,246.124378,91.82264,1,0
0,0,26,26,15,36,51,154,90,244,0.000333,0.461357,14,19377.00497,1076.500276,1384.071783,244.720659,3,0
0,0,25,25,12,35,47,382,213,595,0.000333,1.10166,36,118979.2932,6609.960733,3304.980367,222.544456,4,0
0,0,15,15,16,22,38,101,51,152,0.000333,0.265895,16,12762.95971,709.053317,797.684982,162.107496,6,0
0,0,6,6,13,13,26,42,21,63,0.000333,0.098709,6,1776.766213,98.709234,296.127702,96.211433,2,0
0,0,9,9,15,19,34,68,35,103,0.000333,0.17467,7,3668.060709,203.78115,524.008673,139.313982,2,0
0,0,4,4,4,7,11,17,13,30,0.000333,0.034594,2,207.565897,11.531439,103.782949,27.651484,1,0
0,0,11,11,15,21,36,84,43,127,0.000333,0.21886,14,9192.126653,510.673703,656.580475,150.842025,2,0
0,0,6,6,13,13,26,42,21,63,0.000333,0.098709,6,1776.766213,98.709234,296.127702,96.211433,2,0
0,0,15,15,16,22,38,101,51,152,0.000333,0.265895,16,12762.95971,709.053317,797.684982,162.107496,6,0
0,0,6,6,9,10,19,31,18,49,0.000333,0.069383,4,832.593793,46.255211,208.148448,61.748606,5,0
0,0,9,9,15,19,34,68,35,103,0.000333,0.17467,7,3668.060709,203.78115,524.008673,139.313982,2,0
0,0,11,11,15,21,36,84,43,127,0.000333,0.21886,14,9192.126653,510.673703,656.580475,150.842025,2,0
0,0,25,25,18,43,61,160,87,247,0.000333,0.488297,18,26368.0582,1464.892122,1464.892122,308.388034,15,0
0,0,16,16,17,36,53,101,57,158,0.000333,0.30167,8,7240.091455,402.227303,905.011432,255.604168,11,0
0,0,2,2,8,6,14,15,9,24,0.000333,0.030459,4,365.506073,20.305893,91.376518,39.509775,2,0
0,0,9,9,15,19,34,68,35,103,0.000333,0.17467,7,3668.060709,203.78115,524.008673,139.313982,2,0
0,0,2,2,7,6,13,15,9,24,0.000333,0.029604,3,266.43166,14.801759,88.810553,35.161259,2,0
0,0,1,1,7,5,12,8,6,14,0.000333,0.01673,3,150.568425,8.364913,50.189475,31.261125,1,0
0,0,2,2,12,7,19,19,11,30,0.000333,0.042479,6,764.626952,42.479275,127.437825,62.671034,2,0
0,0,3,3,9,5,14,12,6,18,0.000333,0.022844,4,274.129554,15.22942,68.532389,40.138965,2,0
0,0,3,3,4,5,9,7,6,13,0.000333,0.013736,2,82.41805,4.578781,41.209025,19.60964,1,0
0,0,4,4,7,8,15,24,15,39,0.000333,0.05079,3,457.1062,25.394789,152.368733,43.651484,2,0
0,0,3,3,12,6,18,15,7,22,0.000333,0.030579,6,550.4301,30.57945,91.73835,58.529325,3,0
0,0,11,11,15,21,36,84,43,127,0.000333,0.21886,14,9192.126653,510.673703,656.580475,150.842025,2,0
0,0,2,2,7,5,12,13,8,21,0.000333,0.025095,3,225.852638,12.547369,75.284213,31.261125,1,0
0,0,3,3,4,5,9,7,6,13,0.000333,0.013736,2,82.41805,4.578781,41.209025,19.60964,1,0
0,0,3,3,12,6,18,19,7,26,0.000333,0.036139,6,650.5083,36.13935,108.41805,58.529325,3,0
0,0,33,33,20,41,61,159,111,270,0.000333,0.533766,20,32025.98162,1779.221201,1601.299081,306.098194,13,0
0,0,38,38,21,49,70,200,131,331,0.000333,0.676264,20,40575.85357,2254.214087,2028.792679,367.359448,16,0
0,0,2,2,12,9,21,18,11,29,0.000333,0.042459,6,764.263232,42.459068,127.377205,71.548875,1,0
0,0,9,9,15,19,34,68,35,103,0.000333,0.17467,7,3668.060709,203.78115,524.008673,139.313982,2,0
0,0,11,11,15,21,36,84,43,127,0.000333,0.21886,14,9192.126653,510.673703,656.580475,150.842025,2,0
0,0,20,20,14,28,42,113,68,181,0.000333,0.325336,14,13664.13235,759.118464,976.009454,187.908907,1,0
0,0,5,5,16,12,28,43,23,66,0.000333,0.105762,8,2538.283399,141.015744,317.285425,107.01955,4,0
0,0,3,3,4,5,9,7,6,13,0.000333,0.013736,2,82.41805,4.578781,41.209025,19.60964,1,0
0,0,3,3,9,5,14,12,6,18,0.000333,0.022844,4,274.129554,15.22942,68.532389,40.138965,2,0
0,0,3,3,12,6,18,15,7,22,0.000333,0.030579,6,550.4301,30.57945,91.73835,58.529325,3,0
0,0,2,2,7,6,13,15,9,24,0.000333,0.029604,3,266.43166,14.801759,88.810553,35.161259,2,0
0,0,1,1,7,5,12,8,6,14,0.000333,0.01673,3,150.568425,8.364913,50.189475,31.261125,1,0
0,0,9,9,15,19,34,68,35,103,0.000333,0.17467,7,3668.060709,203.78115,524.008673,139.313982,2,0
0,0,4,4,7,8,15,24,15,39,0.000333,0.05079,3,457.1062,25.394789,152.368733,43.651484,2,0
0,0,3,3,4,5,9,7,6,13,0.000333,0.013736,2,82.41805,4.578781,41.209025,19.60964,1,0
0,0,11,11,15,21,36,84,43,127,0.000333,0.21886,14,9192.126653,510.673703,656.580475,150.842025,2,0
0,0,2,2,8,6,14,15,9,24,0.000333,0.030459,4,365.506073,20.305893,91.376518,39.509775,2,0
0,0,2,2,7,5,12,13,8,21,0.000333,0.025095,3,225.852638,12.547369,75.284213,31.261125,1,0
0,0,3,3,12,6,18,19,7,26,0.000333,0.036139,6,650.5083,36.13935,108.41805,58.529325,3,0
0,0,2,2,12,7,19,19,11,30,0.000333,0.042479,6,764.626952,42.479275,127.437825,62.671034,2,0
0,0,2,2,12,9,21,18,11,29,0.000333,0.042459,6,764.263232,42.459068,127.377205,71.548875,1,0
0,0,38,38,21,50,71,201,132,333,0.000333,0.682622,20,40957.31582,2275.406434,2047.865791,374.431475,16,0
0,0,33,33,20,42,62,160,112,272,0.000333,0.539847,20,32390.82793,1799.49044,1619.541396,312.915894,13,0
0,0,5,5,11,12,23,33,21,54,0.000333,0.081424,5,1221.361728,67.853429,244.272346,81.073298,1,0
0,0,11,11,12,18,30,69,40,109,0.000333,0.178284,12,6418.212899,356.567383,534.851075,118.0782,2,0
0,0,25,25,12,35,47,382,213,595,0.000333,1.10166,36,118979.2932,6609.960733,3304.980367,222.544456,4,0
0,0,4,4,10,15,25,32,21,53,0.000333,0.082041,5,1230.62189,68.367883,246.124378,91.82264,1,0
0,0,11,11,15,21,36,84,43,127,0.000333,0.21886,14,9192.126653,510.673703,656.580475,150.842025,2,0
0,0,9,9,15,19,34,68,35,103,0.000333,0.17467,7,3668.060709,203.78115,524.008673,139.313982,2,0
0,0,28,28,17,44,61,145,85,230,0.000333,0.45469,8,10912.5567,606.25315,1364.069588,309.70186,9,0
0,0,8,8,13,13,26,39,26,65,0.000333,0.101843,12,3666.34298,203.685721,305.528582,96.211433,3,0
0,0,19,19,16,36,52,86,55,141,0.000333,0.267921,8,6430.096002,357.227556,803.762,250.1173,5,0
0,0,45,45,19,49,68,236,158,394,0.000333,0.799487,27,64758.42971,3597.690539,2398.460359,355.831405,6,0
0,0,45,45,19,49,68,235,156,391,0.000333,0.793399,27,64265.34522,3570.296956,2380.197971,355.831405,6,0
0,0,11,11,15,21,36,84,43,127,0.000333,0.21886,14,9192.126653,510.673703,656.580475,150.842025,2,0
0,0,13,13,15,27,42,73,44,117,0.000333,0.2103,7,4416.307969,245.350443,630.901138,186.985321,5,0
0,0,5,5,10,11,21,27,16,43,0.000333,0.062957,5,944.348246,52.463791,188.869649,71.273029,4,0
0,0,9,9,15,19,34,68,35,103,0.000333,0.17467,7,3668.060709,203.78115,524.008673,139.313982,2,0
0,0,9,9,15,19,34,68,35,103,0.000333,0.17467,7,3668.060709,203.78115,524.008673,139.313982,2,0
0,0,25,25,12,35,47,382,213,595,0.000333,1.10166,36,118979.2932,6609.960733,3304.980367,222.544456,4,0
0,0,5,5,11,12,23,33,21,54,0.000333,0.081424,5,1221.361728,67.853429,244.272346,81.073298,1,0
0,0,4,4,10,15,25,32,21,53,0.000333,0.082041,5,1230.62189,68.367883,246.124378,91.82264,1,0
0,0,11,11,15,21,36,84,43,127,0.000333,0.21886,14,9192.126653,510.673703,656.580475,150.842025,2,0
0,0,38,38,20,78,98,249,158,407,0.000333,0.897396,20,53843.73813,2991.318785,2692.186907,576.699935,10,0
0,0,29,29,20,71,91,190,128,318,0.000333,0.689826,10,20694.78696,1149.710386,2069.478696,523.070607,6,0
0,0,11,11,15,21,36,84,43,127,0.000333,0.21886,14,9192.126653,510.673703,656.580475,150.842025,2,0
0,0,9,9,15,19,34,68,35,103,0.000333,0.17467,7,3668.060709,203.78115,524.008673,139.313982,2,0
0,0,21,21,13,31,44,107,71,178,0.000333,0.323926,12,11661.34594,647.852552,971.778828,201.685802,6,0
0,0,8,8,13,13,26,39,26,65,0.000333,0.101843,12,3666.34298,203.685721,305.528582,96.211433,3,0
0,0,7,7,10,13,23,39,24,63,0.000333,0.094995,5,1424.922016,79.162334,284.984403,81.324997,2,0
0,0,5,5,9,9,18,29,18,47,0.000333,0.065329,8,1567.891801,87.1051,195.986475,57.05865,1,0
0,0,6,6,7,11,18,41,25,66,0.000333,0.091738,6,1651.290301,91.73835,275.21505,57.705232,1,0
0,0,13,13,14,25,39,75,46,121,0.000333,0.213178,7,4476.735679,248.707538,639.533668,169.399374,2,0
0,0,15,15,16,22,38,101,51,152,0.000333,0.265895,16,12762.95971,709.053317,797.684982,162.107496,6,0
0,0,6,6,13,13,26,42,21,63,0.000333,0.098709,6,1776.766213,98.709234,296.127702,96.211433,2,0
0,0,11,11,15,21,36,84,43,127,0.000333,0.21886,14,9192.126653,510.673703,656.580475,150.842025,2,0
0,0,9,9,15,19,34,68,35,103,0.000333,0.17467,7,3668.060709,203.78115,524.008673,139.313982,2,0
0,0,5,5,12,12,24,36,18,54,0.000333,0.082529,6,1485.52785,82.529325,247.587975,86.0391,2,0
0,0,11,11,15,21,36,84,43,127,0.000333,0.21886,14,9192.126653,510.673703,656.580475,150.842025,2,0
0,0,17,17,16,22,38,97,60,157,0.000333,0.274642,16,13182.79391,732.37744,823.92462,162.107496,6,0
0,0,9,9,15,19,34,68,35,103,0.000333,0.17467,7,3668.060709,203.78115,524.008673,139.313982,2,0
0,0,16,16,16,27,43,74,44,118,0.000333,0.213433,8,5122.393928,284.57744,640.299241,192.381963,6,0
0,0,25,25,17,36,53,133,74,207,0.000333,0.395227,16,18970.87255,1053.937364,1185.679534,255.604168,10,0
0,0,18,18,15,23,38,110,65,175,0.000333,0.306129,14,12857.42241,714.301245,918.387315,162.645284,11,0
0,0,11,11,15,21,36,84,43,127,0.000333,0.21886,14,9192.126653,510.673703,656.580475,150.842025,2,0
0,0,9,9,15,19,34,68,35,103,0.000333,0.17467,7,3668.060709,203.78115,524.008673,139.313982,2,0
0,0,5,5,12,12,24,36,18,54,0.000333,0.082529,6,1485.52785,82.529325,247.587975,86.0391,2,0
0,0,7,7,10,13,23,39,24,63,0.000333,0.094995,5,1424.922016,79.162334,284.984403,81.324997,2,0
0,0,5,5,9,9,18,29,18,47,0.000333,0.065329,8,1567.891801,87.1051,195.986475,57.05865,1,0
0,0,5,5,12,12,24,36,18,54,0.000333,0.082529,6,1485.52785,82.529325,247.587975,86.0391,2,0
0,0,9,9,15,19,34,68,35,103,0.000333,0.17467,7,3668.060709,203.78115,524.008673,139.313982,2,0
0,0,4,4,10,15,25,32,21,53,0.000333,0.082041,5,1230.62189,68.367883,246.124378,91.82264,1,0
0,0,11,11,15,21,36,84,43,127,0.000333,0.21886,14,9192.126653,510.673703,656.580475,150.842025,2,0
0,0,5,5,11,12,23,33,21,54,0.000333,0.081424,5,1221.361728,67.853429,244.272346,81.073298,1,0
0,0,14,14,11,23,34,85,48,133,0.000333,0.225544,10,6766.325579,375.906977,676.632558,142.095673,1,0
0,0,25,25,12,35,47,382,213,595,0.000333,1.10166,36,118979.2932,6609.960733,3304.980367,222.544456,4,0
0,0,10,10,7,14,21,57,36,93,0.000333,0.136162,6,2450.913122,136.16184,408.48552,72.954453,1,0
0,0,25,25,12,35,47,382,213,595,0.000333,1.10166,36,118979.2932,6609.960733,3304.980367,222.544456,4,0
0,0,4,4,10,15,25,32,21,53,0.000333,0.082041,5,1230.62189,68.367883,246.124378,91.82264,1,0
0,0,5,5,11,12,23,33,21,54,0.000333,0.081424,5,1221.361728,67.853429,244.272346,81.073298,1,0
0,0,11,11,15,21,36,84,43,127,0.000333,0.21886,14,9192.126653,510.673703,656.580475,150.842025,2,0
0,0,9,9,15,19,34,68,35,103,0.000333,0.17467,7,3668.060709,203.78115,524.008673,139.313982,2,0
0,0,2,2,5,5,10,16,7,23,0.000333,0.025468,2,152.808692,8.489372,76.404346,23.219281,1,0
0,0,6,6,13,13,26,42,21,63,0.000333,0.098709,6,1776.766213,98.709234,296.127702,96.211433,2,0
0,0,15,15,16,22,38,101,51,152,0.000333,0.265895,16,12762.95971,709.053317,797.684982,162.107496,6,0
0,0,11,11,15,21,36,84,43,127,0.000333,0.21886,14,9192.126653,510.673703,656.580475,150.842025,2,0
0,0,9,9,15,19,34,68,35,103,0.000333,0.17467,7,3668.060709,203.78115,524.008673,139.313982,2,0
0,0,6,6,9,10,19,33,19,52,0.000333,0.073631,4,883.568923,49.087162,220.892231,61.748606,1,0
0,0,10,10,14,22,36,55,32,87,0.000333,0.149928,7,3148.484326,174.915796,449.783475,151.410465,3,0
0,0,6,6,9,12,21,40,22,62,0.000333,0.090775,4,1089.294721,60.516373,272.32368,71.548875,2,0
0,0,19,19,17,31,48,114,62,176,0.000333,0.327651,16,15727.2544,873.736356,982.9534,223.066954,7,0
0,0,11,11,15,21,36,84,43,127,0.000333,0.21886,14,9192.126653,510.673703,656.580475,150.842025,2,0
0,0,9,9,15,19,34,68,35,103,0.000333,0.17467,7,3668.060709,203.78115,524.008673,139.313982,2,0
0,0,3,3,6,6,12,15,9,24,0.000333,0.02868,3,258.1173,14.33985,86.0391,31.01955,5,0
0,0,28,28,13,32,45,192,106,298,0.000333,0.545524,18,29458.30001,1636.572223,1636.572223,208.105716,1,0
0,0,9,9,15,19,34,68,35,103,0.000333,0.17467,7,3668.060709,203.78115,524.008673,139.313982,2,0
0,0,18,18,11,28,39,116,64,180,0.000333,0.317124,10,9513.723994,528.540222,951.372399,172.659686,1,0
0,0,11,11,15,21,36,84,43,127,0.000333,0.21886,14,9192.126653,510.673703,656.580475,150.842025,2,0
0,0,26,26,15,31,46,151,88,239,0.000333,0.440044,14,18481.83831,1026.768795,1320.131307,212.183445,1,0
0,0,9,9,15,19,34,68,35,103,0.000333,0.17467,7,3668.060709,203.78115,524.008673,139.313982,2,0
0,0,11,11,15,21,36,84,43,127,0.000333,0.21886,14,9192.126653,510.673703,656.580475,150.842025,2,0
0,0,6,6,13,13,26,42,21,63,0.000333,0.098709,6,1776.766213,98.709234,296.127702,96.211433,2,0
0,0,15,15,16,22,38,101,51,152,0.000333,0.265895,16,12762.95971,709.053317,797.684982,162.107496,6,0
0,0,9,9,15,19,34,68,35,103,0.000333,0.17467,7,3668.060709,203.78115,524.008673,139.313982,2,0
0,0,3,3,6,7,13,14,9,23,0.000333,0.02837,3,255.330341,14.185019,85.110114,35.161259,2,0
0,0,11,11,15,21,36,84,43,127,0.000333,0.21886,14,9192.126653,510.673703,656.580475,150.842025,2,0
0,0,7,7,10,13,23,39,24,63,0.000333,0.094995,5,1424.922016,79.162334,284.984403,81.324997,2,0
0,0,4,4,5,7,12,222,14,236,0.000333,0.282017,4,3384.204601,188.011367,846.05115,31.261125,1,0
0,0,6,6,7,11,18,41,25,66,0.000333,0.091738,6,1651.290301,91.73835,275.21505,57.705232,1,0
0,0,2,2,12,9,21,18,11,29,0.000333,0.042459,6,764.263232,42.459068,127.377205,71.548875,1,0
0,0,40,40,9,31,40,266,121,387,0.000333,0.686529,12,24715.03407,1373.057448,2059.586173,182.109411,1,0
0,0,12,12,7,18,25,72,44,116,0.000333,0.179562,6,3232.123908,179.562439,538.687318,94.710134,1,0
0,0,9,9,15,19,34,68,35,103,0.000333,0.17467,7,3668.060709,203.78115,524.008673,139.313982,2,0
0,0,11,11,15,21,36,84,43,127,0.000333,0.21886,14,9192.126653,510.673703,656.580475,150.842025,2,0
0,0,33,33,20,42,62,160,112,272,0.000333,0.539847,20,32390.82793,1799.49044,1619.541396,312.915894,13,0
0,0,2,2,12,9,21,18,11,29,0.000333,0.042459,6,764.263232,42.459068,127.377205,71.548875,1,0
0,0,38,38,21,50,71,201,132,333,0.000333,0.682622,20,40957.31582,2275.406434,2047.865791,374.431475,16,0
0,0,11,11,15,21,36,84,43,127,0.000333,0.21886,14,9192.126653,510.673703,656.580475,150.842025,2,0
0,0,9,9,15,19,34,68,35,103,0.000333,0.17467,7,3668.060709,203.78115,524.008673,139.313982,2,0
0,0,13,13,12,19,31,82,44,126,0.000333,0.208076,12,7490.744821,416.15249,624.228735,123.730173,2,0
0,0,16,16,16,27,43,74,44,118,0.000333,0.213433,8,5122.393928,284.57744,640.299241,192.381963,5,0
0,0,25,25,17,36,53,133,74,207,0.000333,0.395227,16,18970.87255,1053.937364,1185.679534,255.604168,9,0
0,0,4,4,10,15,25,32,21,53,0.000333,0.082041,5,1230.62189,68.367883,246.124378,91.82264,1,0
0,0,9,9,15,20,35,72,36,108,0.000333,0.184654,7,3877.737961,215.429887,553.962566,145.041921,2,0
0,0,25,25,12,35,47,382,213,595,0.000333,1.10166,36,118979.2932,6609.960733,3304.980367,222.544456,4,0
0,0,9,9,15,19,34,68,35,103,0.000333,0.17467,7,3668.060709,203.78115,524.008673,139.313982,2,0
0,0,11,11,12,18,30,69,40,109,0.000333,0.178284,12,6418.212899,356.567383,534.851075,118.0782,2,0
0,0,5,5,11,12,23,33,21,54,0.000333,0.081424,5,1221.361728,67.853429,244.272346,81.073298,1,0
0,0,16,16,16,27,43,74,44,118,0.000333,0.213433,8,5122.393928,284.57744,640.299241,192.381963,5,0
0,0,25,25,17,36,53,133,74,207,0.000333,0.395227,16,18970.87255,1053.937364,1185.679534,255.604168,9,0
0,0,16,16,14,25,39,121,64,185,0.000333,0.325933,14,13689.19175,760.510653,977.79941,169.399374,12,0
0,0,9,9,15,19,34,68,35,103,0.000333,0.17467,7,3668.060709,203.78115,524.008673,139.313982,2,0
0,0,11,11,15,21,36,84,43,127,0.000333,0.21886,14,9192.126653,510.673703,656.580475,150.842025,2,0
0,0,8,8,13,13,26,39,26,65,0.000333,0.101843,12,3666.34298,203.685721,305.528582,96.211433,3,0
0,0,11,11,15,21,36,84,43,127,0.000333,0.21886,14,9192.126653,510.673703,656.580475,150.842025,2,0
0,0,16,16,11,24,35,90,52,142,0.000333,0.242786,10,7283.581884,404.643438,728.358188,148.092848,1,0
0,0,9,9,15,19,34,68,35,103,0.000333,0.17467,7,3668.060709,203.78115,524.008673,139.313982,2,0
0,0,28,28,15,37,52,159,94,253,0.000333,0.480737,14,20190.95748,1121.71986,1442.211249,251.353133,3,0
0,0,16,16,16,27,43,74,44,118,0.000333,0.213433,8,5122.393928,284.57744,640.299241,192.381963,5,0
0,0,25,25,17,36,53,133,74,207,0.000333,0.395227,16,18970.87255,1053.937364,1185.679534,255.604168,9,0
0,0,11,11,15,21,36,84,43,127,0.000333,0.21886,14,9192.126653,510.673703,656.580475,150.842025,2,0
0,0,18,18,14,26,40,146,72,218,0.000333,0.386727,14,16242.52455,902.362475,1160.180325,175.514402,6,0
0,0,9,9,15,19,34,68,35,103,0.000333,0.17467,7,3668.060709,203.78115,524.008673,139.313982,2,0
0,0,30,30,19,56,75,204,129,333,0.000333,0.691399,18,37335.53923,2074.196624,2074.196624,405.922498,7,0
0,0,21,21,17,48,65,145,99,244,0.000333,0.489819,16,23511.32394,1306.184663,1469.457746,337.565068,3,0
0,0,7,7,9,14,23,46,27,73,0.000333,0.110073,4,1320.880091,73.382227,330.220023,81.832294,4,0
0,0,15,15,12,22,34,99,56,155,0.000333,0.262852,12,9462.680885,525.704494,788.55674,141.127046,2,0
0,0,4,4,4,7,11,17,13,30,0.000333,0.034594,2,207.565897,11.531439,103.782949,27.651484,1,0
0,0,9,9,15,19,34,68,35,103,0.000333,0.17467,7,3668.060709,203.78115,524.008673,139.313982,2,0
0,0,11,11,15,21,36,84,43,127,0.000333,0.21886,14,9192.126653,510.673703,656.580475,150.842025,2,0
0,0,16,16,15,27,42,72,44,116,0.000333,0.208503,7,4378.561747,243.25343,625.508821,186.985321,5,0
0,0,25,25,17,35,52,131,74,205,0.000333,0.38953,16,18697.44228,1038.746793,1168.590142,249.011774,9,0
0,0,11,11,15,21,36,84,43,127,0.000333,0.21886,14,9192.126653,510.673703,656.580475,150.842025,2,0
0,0,9,9,15,19,34,68,35,103,0.000333,0.17467,7,3668.060709,203.78115,524.008673,139.313982,2,0
0,0,8,8,13,13,26,39,26,65,0.000333,0.101843,12,3666.34298,203.685721,305.528582,96.211433,3,0
0,0,20,20,14,27,41,113,68,181,0.000333,0.323239,14,13576.03678,754.224266,969.716913,181.684931,6,0
0,0,9,9,15,19,34,68,35,103,0.000333,0.17467,7,3668.060709,203.78115,524.008673,139.313982,2,0
0,0,31,31,15,42,57,178,107,285,0.000333,0.554125,14,23273.23116,1292.957286,1662.373654,285.080691,8,0
0,0,11,11,15,21,36,84,43,127,0.000333,0.21886,14,9192.126653,510.673703,656.580475,150.842025,2,0
0,0,6,6,13,13,26,42,21,63,0.000333,0.098709,6,1776.766213,98.709234,296.127702,96.211433,2,0
0,0,2,2,10,8,18,19,12,31,0.000333,0.043089,5,646.338375,35.907688,129.267675,57.219281,1,0
0,0,15,15,16,22,38,101,51,152,0.000333,0.265895,16,12762.95971,709.053317,797.684982,162.107496,6,0
0,0,8,8,13,13,26,39,26,65,0.000333,0.101843,12,3666.34298,203.685721,305.528582,96.211433,3,0
0,0,11,11,15,21,36,84,43,127,0.000333,0.21886,14,9192.126653,510.673703,656.580475,150.842025,2,0
0,0,9,9,15,19,34,68,35,103,0.000333,0.17467,7,3668.060709,203.78115,524.008673,139.313982,2,0
0,0,9,9,13,20,33,55,32,87,0.000333,0.146287,6,2633.17373,146.287429,438.862288,134.544278,2,0
0,0,6,6,13,13,26,42,21,63,0.000333,0.098709,6,1776.766213,98.709234,296.127702,96.211433,2,0
0,0,15,15,16,22,38,101,51,152,0.000333,0.265895,16,12762.95971,709.053317,797.684982,162.107496,6,0
0,0,11,11,15,21,36,84,43,127,0.000333,0.21886,14,9192.126653,510.673703,656.580475,150.842025,2,0
0,0,9,9,15,19,34,68,35,103,0.000333,0.17467,7,3668.060709,203.78115,524.008673,139.313982,2,0
0,0,6,6,13,13,26,42,21,63,0.000333,0.098709,6,1776.766213,98.709234,296.127702,96.211433,2,0
0,0,15,15,16,22,38,101,51,152,0.000333,0.265895,16,12762.95971,709.053317,797.684982,162.107496,6,0
0,0,3,3,6,7,13,14,9,23,0.000333,0.02837,3,255.330341,14.185019,85.110114,35.161259,3,0
0,0,11,11,15,21,36,84,43,127,0.000333,0.21886,14,9192.126653,510.673703,656.580475,150.842025,2,0
0,0,9,9,15,19,34,68,35,103,0.000333,0.17467,7,3668.060709,203.78115,524.008673,139.313982,2,0
0,0,33,33,20,41,61,159,111,270,0.000333,0.533766,20,32025.98162,1779.221201,1601.299081,306.098194,14,0
0,0,38,38,21,49,70,200,131,331,0.000333,0.676264,20,40575.85357,2254.214087,2028.792679,367.359448,17,0
0,0,2,2,12,9,21,18,11,29,0.000333,0.042459,6,764.263232,42.459068,127.377205,71.548875,1,0
0,0,9,9,15,19,34,68,35,103,0.000333,0.17467,7,3668.060709,203.78115,524.008673,139.313982,2,0
0,0,20,20,13,28,41,117,68,185,0.000333,0.330382,12,11893.76545,660.764747,991.147121,182.711654,5,0
0,0,11,11,15,21,36,84,43,127,0.000333,0.21886,14,9192.126653,510.673703,656.580475,150.842025,2,0
0,0,11,11,15,21,36,84,43,127,0.000333,0.21886,14,9192.126653,510.673703,656.580475,150.842025,2,0
0,0,9,9,15,19,34,68,35,103,0.000333,0.17467,7,3668.060709,203.78115,524.008673,139.313982,2,0
0,0,2,2,5,5,10,16,7,23,0.000333,0.025468,2,152.808692,8.489372,76.404346,23.219281,1,0
0,0,7,7,10,13,23,39,24,63,0.000333,0.094995,5,1424.922016,79.162334,284.984403,81.324997,2,0
0,0,6,6,7,11,18,41,25,66,0.000333,0.091738,6,1651.290301,91.73835,275.21505,57.705232,1,0
0,0,2,2,7,5,12,14,7,21,0.000333,0.025095,3,225.852638,12.547369,75.284213,31.261125,2,0
0,0,17,17,11,20,31,105,57,162,0.000333,0.267527,10,8025.798023,445.877668,802.579802,124.49231,1,0
0,0,15,15,16,22,38,101,51,152,0.000333,0.265895,16,12762.95971,709.053317,797.684982,162.107496,6,0
0,0,6,6,13,13,26,42,21,63,0.000333,0.098709,6,1776.766213,98.709234,296.127702,96.211433,2,0
0,0,2,2,7,7,14,24,9,33,0.000333,0.041881,3,376.928137,20.940452,125.642712,39.302969,1,0
0,0,11,11,15,21,36,84,43,127,0.000333,0.21886,14,9192.126653,510.673703,656.580475,150.842025,2,0
0,0,9,9,15,19,34,68,35,103,0.000333,0.17467,7,3668.060709,203.78115,524.008673,139.313982,2,0
0,0,6,6,13,13,26,42,21,63,0.000333,0.098709,6,1776.766213,98.709234,296.127702,96.211433,2,0
0,0,15,15,16,22,38,101,51,152,0.000333,0.265895,16,12762.95971,709.053317,797.684982,162.107496,6,0
0,0,5,5,12,12,24,36,18,54,0.000333,0.082529,6,1485.52785,82.529325,247.587975,86.0391,2,0
0,0,9,9,15,19,34,68,35,103,0.000333,0.17467,7,3668.060709,203.78115,524.008673,139.313982,2,0
0,0,15,15,19,22,41,132,73,205,0.000333,0.366099,27,29654.05035,1647.447241,1098.298161,178.818118,3,0
0,0,11,11,15,21,36,84,43,127,0.000333,0.21886,14,9192.126653,510.673703,656.580475,150.842025,2,0
0,0,10,10,14,22,36,51,29,80,0.000333,0.137865,7,2895.158001,160.842111,413.594,151.410465,3,0
0,0,19,19,17,33,50,111,59,170,0.000333,0.319819,8,7675.644418,426.42469,959.455552,235.951874,7,0
0,0,5,5,9,10,19,30,18,48,0.000333,0.067967,4,815.602083,45.311227,203.900521,61.748606,7,0
0,0,7,7,9,10,19,31,18,49,0.000333,0.069383,4,832.593793,46.255211,208.148448,61.748606,1,0
0,0,9,9,15,19,34,68,35,103,0.000333,0.17467,7,3668.060709,203.78115,524.008673,139.313982,2,0
0,0,18,18,11,28,39,115,64,179,0.000333,0.315362,10,9460.869972,525.603887,946.086997,172.659686,3,0
0,0,11,11,15,21,36,84,43,127,0.000333,0.21886,14,9192.126653,510.673703,656.580475,150.842025,2,0
0,0,5,5,12,11,23,33,16,49,0.000333,0.073885,6,1329.927215,73.884845,221.654536,81.073298,2,0
0,0,14,14,16,22,38,93,46,139,0.000333,0.243154,16,11671.39079,648.410599,729.461924,162.107496,6,0
0,0,11,11,15,21,36,84,43,127,0.000333,0.21886,14,9192.126653,510.673703,656.580475,150.842025,2,0
0,0,9,9,15,19,34,68,35,103,0.000333,0.17467,7,3668.060709,203.78115,524.008673,139.313982,2,0
0,0,7,7,13,12,25,37,23,60,0.000333,0.092877,6,1671.788228,92.877124,278.631371,91.125266,3,0
0,0,12,12,10,17,27,69,42,111,0.000333,0.175931,10,5277.925127,293.218063,527.792513,102.706149,1,0
0,0,26,26,15,31,46,167,97,264,0.000333,0.486073,21,30622.62748,1701.257082,1458.220356,212.183445,5,0
0,0,6,6,10,11,21,37,21,58,0.000333,0.084918,5,1273.772053,70.765114,254.754411,71.273029,2,0
0,0,1,1,9,6,15,12,7,19,0.000333,0.024744,4,296.923685,16.49576,74.230921,44.0391,1,0
0,0,4,4,6,10,16,26,15,41,0.000333,0.054667,3,492,27.333333,164,48.729056,1,0
0,0,8,8,7,16,23,50,31,81,0.000333,0.122136,3,1099.225555,61.068086,366.408518,83.651484,1,0
0,0,6,6,7,11,18,41,25,66,0.000333,0.091738,6,1651.290301,91.73835,275.21505,57.705232,1,0
0,0,7,7,13,12,25,37,23,60,0.000333,0.092877,6,1671.788228,92.877124,278.631371,91.125266,3,0
0,0,6,6,10,11,21,37,21,58,0.000333,0.084918,5,1273.772053,70.765114,254.754411,71.273029,2,0
0,0,6,6,7,11,18,41,25,66,0.000333,0.091738,6,1651.290301,91.73835,275.21505,57.705232,1,0
0,0,7,7,8,12,20,41,25,66,0.000333,0.095082,8,2281.978034,126.776557,285.247254,67.01955,1,0
0,0,15,15,14,27,41,87,53,140,0.000333,0.250019,7,5250.400965,291.688942,750.057281,181.684931,2,0
0,0,19,19,17,33,50,111,59,170,0.000333,0.319819,8,7675.644418,426.42469,959.455552,235.951874,7,0
0,0,5,5,9,10,19,30,18,48,0.000333,0.067967,4,815.602083,45.311227,203.900521,61.748606,2,0
0,0,10,10,14,22,36,51,29,80,0.000333,0.137865,7,2895.158001,160.842111,413.594,151.410465,3,0
0,0,9,9,15,19,34,68,35,103,0.000333,0.17467,7,3668.060709,203.78115,524.008673,139.313982,2,0
0,0,18,18,11,28,39,115,64,179,0.000333,0.315362,10,9460.869972,525.603887,946.086997,172.659686,1,0
0,0,2,2,5,4,9,11,6,17,0.000333,0.017963,2,107.77745,5.987636,53.888725,19.60964,1,0
0,0,11,11,15,21,36,84,43,127,0.000333,0.21886,14,9192.126653,510.673703,656.580475,150.842025,2,0
0,0,6,6,10,11,21,37,21,58,0.000333,0.084918,5,1273.772053,70.765114,254.754411,71.273029,2,0
0,0,6,6,7,11,18,41,25,66,0.000333,0.091738,6,1651.290301,91.73835,275.21505,57.705232,1,0
0,0,15,15,14,24,38,62,38,100,0.000333,0.174931,7,3673.549259,204.08607,524.792751,163.342069,5,0
0,0,24,24,17,35,52,122,68,190,0.000333,0.361028,8,8664.668372,481.370465,1083.083546,249.011774,9,0
0,0,11,11,15,21,36,84,43,127,0.000333,0.21886,14,9192.126653,510.673703,656.580475,150.842025,2,0
0,0,9,9,15,19,34,68,35,103,0.000333,0.17467,7,3668.060709,203.78115,524.008673,139.313982,2,0
0,0,11,11,15,21,36,84,43,127,0.000333,0.21886,14,9192.126653,510.673703,656.580475,150.842025,2,0
0,0,25,25,14,34,48,176,99,275,0.000333,0.511955,14,21502.10563,1194.561424,1535.864688,226.276706,12,0
0,0,15,15,12,22,34,99,56,155,0.000333,0.262852,12,9462.680885,525.704494,788.55674,141.127046,4,0
0,0,9,9,15,19,34,68,35,103,0.000333,0.17467,7,3668.060709,203.78115,524.008673,139.313982,2,0
0,0,19,19,11,20,31,566,72,638,0.000333,1.053592,15,47411.65869,2633.981038,3160.777246,124.49231,1,0
0,0,1,1,9,6,15,12,7,19,0.000333,0.024744,4,296.923685,16.49576,74.230921,44.0391,1,0
0,0,1,1,7,5,12,8,6,14,0.000333,0.01673,3,150.568425,8.364913,50.189475,31.261125,1,0
0,0,2,2,7,5,12,13,8,21,0.000333,0.025095,3,225.852638,12.547369,75.284213,31.261125,1,0
0,0,3,3,12,6,18,19,7,26,0.000333,0.036139,6,650.5083,36.13935,108.41805,58.529325,3,0
0,0,4,4,7,8,15,24,15,39,0.000333,0.05079,3,457.1062,25.394789,152.368733,43.651484,2,0
0,0,2,2,7,6,13,15,9,24,0.000333,0.029604,3,266.43166,14.801759,88.810553,35.161259,2,0
0,0,3,3,4,5,9,7,6,13,0.000333,0.013736,2,82.41805,4.578781,41.209025,19.60964,1,0
0,0,3,3,4,5,9,7,6,13,0.000333,0.013736,2,82.41805,4.578781,41.209025,19.60964,1,0
0,0,3,3,9,5,14,12,6,18,0.000333,0.022844,4,274.129554,15.22942,68.532389,40.138965,2,0
0,0,2,2,12,7,19,19,11,30,0.000333,0.042479,6,764.626952,42.479275,127.437825,62.671034,2,0
0,0,2,2,8,6,14,15,9,24,0.000333,0.030459,4,365.506073,20.305893,91.376518,39.509775,2,0
0,0,3,3,12,6,18,15,7,22,0.000333,0.030579,6,550.4301,30.57945,91.73835,58.529325,3,0
0,0,14,14,16,22,38,93,46,139,0.000333,0.243154,16,11671.39079,648.410599,729.461924,162.107496,6,0
0,0,5,5,12,11,23,33,16,49,0.000333,0.073885,6,1329.927215,73.884845,221.654536,81.073298,2,0
0,0,9,9,15,19,34,68,35,103,0.000333,0.17467,7,3668.060709,203.78115,524.008673,139.313982,2,0
0,0,11,11,15,21,36,84,43,127,0.000333,0.21886,14,9192.126653,510.673703,656.580475,150.842025,2,0
0,0,5,5,12,11,23,33,16,49,0.000333,0.073885,6,1329.927215,73.884845,221.654536,81.073298,2,0
0,0,14,14,16,22,38,93,46,139,0.000333,0.243154,16,11671.39079,648.410599,729.461924,162.107496,6,0
0,0,11,11,15,21,36,84,43,127,0.000333,0.21886,14,9192.126653,510.673703,656.580475,150.842025,2,0
0,0,9,9,15,19,34,68,35,103,0.000333,0.17467,7,3668.060709,203.78115,524.008673,139.313982,2,0
0,0,1,1,9,6,15,12,7,19,0.000333,0.024744,4,296.923685,16.49576,74.230921,44.0391,1,0
0,0,37,37,22,53,75,229,123,352,0.000333,0.730848,22,48235.97194,2679.776219,2192.544179,401.68728,18,0
0,0,11,11,15,21,36,84,43,127,0.000333,0.21886,14,9192.126653,510.673703,656.580475,150.842025,2,0
0,0,3,3,12,6,18,15,7,22,0.000333,0.030579,6,550.4301,30.57945,91.73835,58.529325,3,0
0,0,3,3,4,5,9,7,6,13,0.000333,0.013736,2,82.41805,4.578781,41.209025,19.60964,1,0
0,0,3,3,9,5,14,12,6,18,0.000333,0.022844,4,274.129554,15.22942,68.532389,40.138965,2,0
0,0,1,1,7,5,12,8,6,14,0.000333,0.01673,3,150.568425,8.364913,50.189475,31.261125,1,0
0,0,2,2,7,5,12,13,8,21,0.000333,0.025095,3,225.852638,12.547369,75.284213,31.261125,1,0
0,0,2,2,7,6,13,15,9,24,0.000333,0.029604,3,266.43166,14.801759,88.810553,35.161259,2,0
0,0,3,3,4,5,9,7,6,13,0.000333,0.013736,2,82.41805,4.578781,41.209025,19.60964,1,0
0,0,2,2,8,6,14,15,9,24,0.000333,0.030459,4,365.506073,20.305893,91.376518,39.509775,2,0
0,0,4,4,7,8,15,24,15,39,0.000333,0.05079,3,457.1062,25.394789,152.368733,43.651484,2,0
0,0,2,2,12,7,19,19,11,30,0.000333,0.042479,6,764.626952,42.479275,127.437825,62.671034,2,0
0,0,3,3,12,6,18,19,7,26,0.000333,0.036139,6,650.5083,36.13935,108.41805,58.529325,3,0
0,0,9,9,15,19,34,68,35,103,0.000333,0.17467,7,3668.060709,203.78115,524.008673,139.313982,2,0
0,0,4,4,12,10,22,32,15,47,0.000333,0.069864,6,1257.559716,69.864429,209.593286,76.238831,2,0
0,0,11,11,15,21,36,84,43,127,0.000333,0.21886,14,9192.126653,510.673703,656.580475,150.842025,2,0
0,0,9,9,15,19,34,68,35,103,0.000333,0.17467,7,3668.060709,203.78115,524.008673,139.313982,2,0
0,0,21,21,12,31,43,142,76,218,0.000333,0.394309,12,14195.1086,788.617144,1182.925717,196.599636,1,0
0,0,6,6,10,11,21,37,21,58,0.000333,0.084918,5,1273.772053,70.765114,254.754411,71.273029,3,0
0,0,6,6,7,11,18,41,25,66,0.000333,0.091738,6,1651.290301,91.73835,275.21505,57.705232,1,0
0,0,4,4,5,7,12,23,14,37,0.000333,0.044215,4,530.57445,29.476358,132.643613,31.261125,3,0
0,0,4,4,7,8,15,24,15,39,0.000333,0.05079,3,457.1062,25.394789,152.368733,43.651484,2,0
0,0,3,3,4,5,9,7,6,13,0.000333,0.013736,2,82.41805,4.578781,41.209025,19.60964,1,0
0,0,9,9,15,19,34,68,35,103,0.000333,0.17467,7,3668.060709,203.78115,524.008673,139.313982,2,0
0,0,2,2,8,6,14,15,9,24,0.000333,0.030459,4,365.506073,20.305893,91.376518,39.509775,2,0
0,0,3,3,4,5,9,7,6,13,0.000333,0.013736,2,82.41805,4.578781,41.209025,19.60964,1,0
0,0,3,3,9,5,14,12,6,18,0.000333,0.022844,4,274.129554,15.22942,68.532389,40.138965,2,0
0,0,2,2,12,7,19,19,11,30,0.000333,0.042479,6,764.626952,42.479275,127.437825,62.671034,2,0
0,0,2,2,7,6,13,15,9,24,0.000333,0.029604,3,266.43166,14.801759,88.810553,35.161259,2,0
0,0,3,3,12,6,18,15,7,22,0.000333,0.030579,6,550.4301,30.57945,91.73835,58.529325,3,0
0,0,11,11,15,21,36,84,43,127,0.000333,0.21886,14,9192.126653,510.673703,656.580475,150.842025,2,0
0,0,2,2,7,5,12,13,8,21,0.000333,0.025095,3,225.852638,12.547369,75.284213,31.261125,1,0
0,0,1,1,7,5,12,8,6,14,0.000333,0.01673,3,150.568425,8.364913,50.189475,31.261125,1,0
0,0,9,9,15,19,34,68,35,103,0.000333,0.17467,7,3668.060709,203.78115,524.008673,139.313982,2,0
0,0,5,5,6,10,16,22,15,37,0.000333,0.049333,3,444,24.666667,148,48.729056,1,0
0,0,9,9,15,20,35,72,36,108,0.000333,0.184654,7,3877.737961,215.429887,553.962566,145.041921,2,0
0,0,22,22,19,21,40,141,73,214,0.000333,0.379631,27,30750.10053,1708.338918,1138.892612,172.949289,19,0
0,0,10,10,7,14,21,57,36,93,0.000333,0.136162,6,2450.913122,136.16184,408.48552,72.954453,3,0
0,0,4,4,10,15,25,32,21,53,0.000333,0.082041,5,1230.62189,68.367883,246.124378,91.82264,1,0
0,0,5,5,11,12,23,33,21,54,0.000333,0.081424,5,1221.361728,67.853429,244.272346,81.073298,1,0
0,0,25,25,12,35,47,382,213,595,0.000333,1.10166,36,118979.2932,6609.960733,3304.980367,222.544456,4,0
0,0,15,15,15,24,39,64,38,102,0.000333,0.179704,7,3773.777184,209.654288,539.111026,168.642459,5,0
0,0,24,24,17,35,52,124,68,192,0.000333,0.364828,8,8755.875407,486.437523,1094.484426,249.011774,9,0
0,0,16,16,11,24,35,98,52,150,0.000333,0.256464,10,7693.924525,427.440251,769.392453,148.092848,1,0
0,0,9,9,15,19,34,68,35,103,0.000333,0.17467,7,3668.060709,203.78115,524.008673,139.313982,2,0
0,0,11,11,15,21,36,84,43,127,0.000333,0.21886,14,9192.126653,510.673703,656.580475,150.842025,2,0
0,0,27,27,17,46,63,144,83,227,0.000333,0.452281,8,10854.74034,603.04113,1356.842543,323.570718,10,0
0,0,28,28,20,52,72,155,103,258,0.000333,0.530614,10,15918.4065,884.355917,1591.84065,382.861427,6,0
0,0,20,20,14,26,40,115,70,185,0.000333,0.328186,14,13783.79377,765.76632,984.556698,175.514402,6,0
0,0,11,11,15,21,36,84,43,127,0.000333,0.21886,14,9192.126653,510.673703,656.580475,150.842025,2,0
0,0,9,9,15,19,34,68,35,103,0.000333,0.17467,7,3668.060709,203.78115,524.008673,139.313982,2,0
0,0,19,19,17,33,50,111,59,170,0.000333,0.319819,8,7675.644418,426.42469,959.455552,235.951874,7,0
0,0,10,10,14,22,36,51,29,80,0.000333,0.137865,7,2895.158001,160.842111,413.594,151.410465,3,0
0,0,6,6,10,13,23,36,23,59,0.000333,0.088963,5,1334.450777,74.136154,266.890155,81.324997,7,0
0,0,11,11,15,21,36,84,43,127,0.000333,0.21886,14,9192.126653,510.673703,656.580475,150.842025,2,0
0,0,9,9,15,19,34,68,35,103,0.000333,0.17467,7,3668.060709,203.78115,524.008673,139.313982,2,0
0,0,18,18,11,28,39,115,64,179,0.000333,0.315362,10,9460.869972,525.603887,946.086997,172.659686,3,0
0,0,2,2,5,7,12,12,9,21,0.000333,0.025095,2,150.568425,8.364913,75.284213,31.261125,1,0
0,0,5,5,12,11,23,33,16,49,0.000333,0.073885,6,1329.927215,73.884845,221.654536,81.073298,2,0
0,0,14,14,16,22,38,93,46,139,0.000333,0.243154,16,11671.39079,648.410599,729.461924,162.107496,6,0
0,0,1,1,6,5,11,15,5,20,0.000333,0.023063,3,207.565897,11.531439,69.188632,27.119415,2,0
0,0,11,11,15,21,36,84,43,127,0.000333,0.21886,14,9192.126653,510.673703,656.580475,150.842025,2,0
0,0,9,9,15,19,34,68,35,103,0.000333,0.17467,7,3668.060709,203.78115,524.008673,139.313982,2,0
0,0,25,25,17,40,57,133,76,209,0.000333,0.406358,8,9752.592104,541.810672,1219.074013,282.363992,9,0
0,0,11,11,15,21,36,84,43,127,0.000333,0.21886,14,9192.126653,510.673703,656.580475,150.842025,2,0
0,0,9,9,15,19,34,68,35,103,0.000333,0.17467,7,3668.060709,203.78115,524.008673,139.313982,2,0
0,0,23,23,19,23,42,151,79,230,0.000333,0.413411,27,33486.2912,1860.349511,1240.233007,184.752548,14,0
0,0,11,11,9,16,25,63,40,103,0.000333,0.159439,8,3826.5375,212.585417,478.317188,92.529325,1,0
0,0,4,4,12,10,22,32,15,47,0.000333,0.069864,6,1257.559716,69.864429,209.593286,76.238831,2,0
0,0,5,5,12,11,23,33,16,49,0.000333,0.073885,6,1329.927215,73.884845,221.654536,81.073298,2,0
0,0,14,14,16,22,38,93,46,139,0.000333,0.243154,16,11671.39079,648.410599,729.461924,162.107496,6,0
0,0,11,11,15,21,36,84,43,127,0.000333,0.21886,14,9192.126653,510.673703,656.580475,150.842025,2,0
0,0,9,9,15,19,34,68,35,103,0.000333,0.17467,7,3668.060709,203.78115,524.008673,139.313982,2,0
0,0,7,7,13,12,25,37,23,60,0.000333,0.092877,6,1671.788228,92.877124,278.631371,91.125266,3,0
0,0,6,6,10,11,21,37,21,58,0.000333,0.084918,5,1273.772053,70.765114,254.754411,71.273029,2,0
0,0,22,22,15,30,45,120,75,195,0.000333,0.35697,14,14992.75895,832.931053,1070.911354,205.810077,3,0
0,0,9,9,10,15,25,44,30,74,0.000333,0.114548,10,3436.45358,190.914088,343.645358,91.82264,1,0
0,0,6,6,7,11,18,41,25,66,0.000333,0.091738,6,1651.290301,91.73835,275.21505,57.705232,1,0
0,0,5,5,12,11,23,33,16,49,0.000333,0.073885,6,1329.927215,73.884845,221.654536,81.073298,2,0
0,0,14,14,16,22,38,93,46,139,0.000333,0.243154,16,11671.39079,648.410599,729.461924,162.107496,6,0
0,0,7,7,13,12,25,37,23,60,0.000333,0.092877,6,1671.788228,92.877124,278.631371,91.125266,3,0
0,0,9,9,15,19,34,68,35,103,0.000333,0.17467,7,3668.060709,203.78115,524.008673,139.313982,2,0
0,0,10,10,12,22,34,58,37,95,0.000333,0.161103,6,2899.85382,161.10299,483.30897,141.127046,2,0
0,0,11,11,15,21,36,84,43,127,0.000333,0.21886,14,9192.126653,510.673703,656.580475,150.842025,2,0
0,0,5,5,11,12,23,33,21,54,0.000333,0.081424,5,1221.361728,67.853429,244.272346,81.073298,1,0
0,0,9,9,15,20,35,72,36,108,0.000333,0.184654,7,3877.737961,215.429887,553.962566,145.041921,2,0
0,0,4,4,10,15,25,32,21,53,0.000333,0.082041,5,1230.62189,68.367883,246.124378,91.82264,1,0
0,0,25,25,12,35,47,382,213,595,0.000333,1.10166,36,118979.2932,6609.960733,3304.980367,222.544456,4,0
0,0,9,9,15,19,34,68,35,103,0.000333,0.17467,7,3668.060709,203.78115,524.008673,139.313982,2,0
0,0,11,11,12,18,30,69,40,109,0.000333,0.178284,12,6418.212899,356.567383,534.851075,118.0782,2,0
0,0,14,14,16,22,38,93,46,139,0.000333,0.243154,16,11671.39079,648.410599,729.461924,162.107496,6,0
0,0,1,1,9,6,15,12,7,19,0.000333,0.024744,4,296.923685,16.49576,74.230921,44.0391,1,0
0,0,5,5,12,11,23,33,16,49,0.000333,0.073885,6,1329.927215,73.884845,221.654536,81.073298,2,0
0,0,11,11,15,21,36,84,43,127,0.000333,0.21886,14,9192.126653,510.673703,656.580475,150.842025,2,0
0,0,9,9,15,19,34,68,35,103,0.000333,0.17467,7,3668.060709,203.78115,524.008673,139.313982,2,0
0,0,14,14,16,22,38,93,46,139,0.000333,0.243154,16,11671.39079,648.410599,729.461924,162.107496,6,0
0,0,5,5,12,11,23,33,16,49,0.000333,0.073885,6,1329.927215,73.884845,221.654536,81.073298,2,0
0,0,7,7,13,12,25,37,23,60,0.000333,0.092877,6,1671.788228,92.877124,278.631371,91.125266,3,0
0,0,11,11,15,21,36,84,43,127,0.000333,0.21886,14,9192.126653,510.673703,656.580475,150.842025,2,0
0,0,9,9,15,19,34,68,35,103,0.000333,0.17467,7,3668.060709,203.78115,524.008673,139.313982,2,0
0,0,12,12,12,24,36,61,41,102,0.000333,0.175777,6,3163.994101,175.77745,527.33235,153.05865,2,0
0,0,4,4,12,10,22,32,15,47,0.000333,0.069864,6,1257.559716,69.864429,209.593286,76.238831,2,0
0,0,5,5,12,11,23,33,16,49,0.000333,0.073885,6,1329.927215,73.884845,221.654536,81.073298,2,0
0,0,14,14,16,22,38,93,46,139,0.000333,0.243154,16,11671.39079,648.410599,729.461924,162.107496,6,0
0,0,11,11,15,21,36,84,43,127,0.000333,0.21886,14,9192.126653,510.673703,656.580475,150.842025,2,0
0,0,4,4,4,7,11,27,15,42,0.000333,0.048432,4,581.184512,32.288028,145.296128,27.651484,3,0
0,0,9,9,15,19,34,68,35,103,0.000333,0.17467,7,3668.060709,203.78115,524.008673,139.313982,2,0
0,0,5,5,12,11,23,33,16,49,0.000333,0.073885,6,1329.927215,73.884845,221.654536,81.073298,2,0
0,0,14,14,16,22,38,93,46,139,0.000333,0.243154,16,11671.39079,648.410599,729.461924,162.107496,6,0
0,0,11,11,15,21,36,84,43,127,0.000333,0.21886,14,9192.126653,510.673703,656.580475,150.842025,2,0
0,0,9,9,15,19,34,68,35,103,0.000333,0.17467,7,3668.060709,203.78115,524.008673,139.313982,2,0
0,0,5,5,12,11,23,33,16,49,0.000333,0.073885,6,1329.927215,73.884845,221.654536,81.073298,2,0
0,0,14,14,16,22,38,93,46,139,0.000333,0.243154,16,11671.39079,648.410599,729.461924,162.107496,6,0
0,0,11,11,15,21,36,84,43,127,0.000333,0.21886,14,9192.126653,510.673703,656.580475,150.842025,2,0
0,0,2,2,5,7,12,12,9,21,0.000333,0.025095,2,150.568425,8.364913,75.284213,31.261125,3,0
0,0,9,9,15,19,34,68,35,103,0.000333,0.17467,7,3668.060709,203.78115,524.008673,139.313982,2,0
0,0,14,14,16,22,38,93,46,139,0.000333,0.243154,16,11671.39079,648.410599,729.461924,162.107496,6,0
0,0,5,5,12,11,23,33,16,49,0.000333,0.073885,6,1329.927215,73.884845,221.654536,81.073298,2,0
0,0,11,11,15,21,36,84,43,127,0.000333,0.21886,14,9192.126653,510.673703,656.580475,150.842025,2,0
0,0,9,9,15,19,34,68,35,103,0.000333,0.17467,7,3668.060709,203.78115,524.008673,139.313982,2,0
0,0,4,4,12,10,22,32,15,47,0.000333,0.069864,6,1257.559716,69.864429,209.593286,76.238831,2,0
0,0,9,9,15,19,34,68,35,103,0.000333,0.17467,7,3668.060709,203.78115,524.008673,139.313982,2,0
0,0,11,11,15,21,36,84,43,127,0.000333,0.21886,14,9192.126653,510.673703,656.580475,150.842025,2,0
0,0,4,4,12,10,22,32,15,47,0.000333,0.069864,6,1257.559716,69.864429,209.593286,76.238831,2,0
0,0,9,9,15,19,34,68,35,103,0.000333,0.17467,7,3668.060709,203.78115,524.008673,139.313982,2,0
0,0,25,25,13,35,48,124,80,204,0.000333,0.379777,12,13671.9882,759.5549,1139.33235,227.630622,8,0
0,0,11,11,15,21,36,84,43,127,0.000333,0.21886,14,9192.126653,510.673703,656.580475,150.842025,2,0
0,0,17,17,16,23,39,97,60,157,0.000333,0.276603,16,13276.93037,737.607243,829.808148,168.041925,2,0
0,0,9,9,15,19,34,68,35,103,0.000333,0.17467,7,3668.060709,203.78115,524.008673,139.313982,2,0
0,0,9,9,15,20,35,72,36,108,0.000333,0.184654,7,3877.737961,215.429887,553.962566,145.041921,2,0
0,0,7,7,13,12,25,37,23,60,0.000333,0.092877,6,1671.788228,92.877124,278.631371,91.125266,3,0
0,0,12,12,12,23,35,66,39,105,0.000333,0.179525,6,3231.448301,179.524906,538.574717,147.061475,2,0
0,0,9,9,15,19,34,68,35,103,0.000333,0.17467,7,3668.060709,203.78115,524.008673,139.313982,2,0
0,0,11,11,15,21,36,84,43,127,0.000333,0.21886,14,9192.126653,510.673703,656.580475,150.842025,2,0
0,0,7,7,13,12,25,37,23,60,0.000333,0.092877,6,1671.788228,92.877124,278.631371,91.125266,3,0
0,0,5,5,12,11,23,33,16,49,0.000333,0.073885,6,1329.927215,73.884845,221.654536,81.073298,2,0
0,0,14,14,16,22,38,93,46,139,0.000333,0.243154,16,11671.39079,648.410599,729.461924,162.107496,6,0
0,0,9,9,15,19,34,68,35,103,0.000333,0.17467,7,3668.060709,203.78115,524.008673,139.313982,2,0
0,0,9,9,13,21,34,59,33,92,0.000333,0.156016,6,2808.279488,156.015527,468.046581,140.344382,2,0
0,0,2,2,8,7,15,16,9,25,0.000333,0.032557,4,390.68906,21.704948,97.672265,43.651484,1,0
0,0,11,11,15,21,36,84,43,127,0.000333,0.21886,14,9192.126653,510.673703,656.580475,150.842025,2,0
0,0,9,9,15,20,35,72,36,108,0.000333,0.184654,7,3877.737961,215.429887,553.962566,145.041921,2,0
0,0,9,9,15,19,34,68,35,103,0.000333,0.17467,7,3668.060709,203.78115,524.008673,139.313982,2,0
0,0,20,20,12,28,40,105,64,169,0.000333,0.299802,12,10792.87018,599.603899,899.405848,177.625488,7,0
0,0,1,1,9,6,15,12,7,19,0.000333,0.024744,4,296.923685,16.49576,74.230921,44.0391,1,0
0,0,11,11,8,15,23,63,38,101,0.000333,0.152293,8,3655.03806,203.05767,456.879758,82.603359,1,0
0,0,30,30,17,45,62,151,85,236,0.000333,0.468397,8,11241.52263,624.529035,1405.190329,316.620258,9,0
0,0,21,21,15,35,50,91,55,146,0.000333,0.274668,7,5768.021026,320.445613,824.003004,238.128265,5,0
0,0,21,21,17,30,47,119,77,196,0.000333,0.3629,16,17419.19064,967.732813,1088.699415,216.693586,2,0
0,0,11,11,15,21,36,84,43,127,0.000333,0.21886,14,9192.126653,510.673703,656.580475,150.842025,2,0
0,0,9,9,15,19,34,68,35,103,0.000333,0.17467,7,3668.060709,203.78115,524.008673,139.313982,2,0
0,0,15,15,15,25,40,65,39,104,0.000333,0.184494,7,3874.363653,215.242425,553.480522,174.699764,5,0
0,0,24,24,17,36,53,125,69,194,0.000333,0.370406,8,8889.732545,493.87403,1111.216568,255.604168,9,0
0,0,11,11,15,21,36,84,43,127,0.000333,0.21886,14,9192.126653,510.673703,656.580475,150.842025,2,0
0,0,18,18,15,24,39,101,61,162,0.000333,0.285412,14,11987.29223,665.96068,856.235159,168.642459,5,0
0,0,9,9,15,19,34,68,35,103,0.000333,0.17467,7,3668.060709,203.78115,524.008673,139.313982,2,0
0,0,6,6,10,11,21,37,21,58,0.000333,0.084918,5,1273.772053,70.765114,254.754411,71.273029,2,0
0,0,1,1,9,6,15,12,7,19,0.000333,0.024744,4,296.923685,16.49576,74.230921,44.0391,1,0
0,0,7,7,8,13,21,31,21,52,0.000333,0.076134,4,913.602024,50.755668,228.400506,72.105716,3,0
0,0,6,6,7,11,18,41,25,66,0.000333,0.091738,6,1651.290301,91.73835,275.21505,57.705232,1,0
0,0,4,4,12,10,22,32,15,47,0.000333,0.069864,6,1257.559716,69.864429,209.593286,76.238831,2,0
0,0,9,9,15,19,34,68,35,103,0.000333,0.17467,7,3668.060709,203.78115,524.008673,139.313982,2,0
0,0,5,5,10,11,21,27,16,43,0.000333,0.062957,5,944.348246,52.463791,188.869649,71.273029,2,0
0,0,11,11,15,21,36,84,43,127,0.000333,0.21886,14,9192.126653,510.673703,656.580475,150.842025,2,0
0,0,22,22,19,21,40,141,73,214,0.000333,0.379631,27,30750.10053,1708.338918,1138.892612,172.949289,14,0
0,0,10,10,7,14,21,57,36,93,0.000333,0.136162,6,2450.913122,136.16184,408.48552,72.954453,1,0
0,0,5,5,9,10,19,30,18,48,0.000333,0.067967,4,815.602083,45.311227,203.900521,61.748606,3,0
0,0,10,10,14,22,36,51,29,80,0.000333,0.137865,7,2895.158001,160.842111,413.594,151.410465,4,0
0,0,19,19,17,33,50,111,59,170,0.000333,0.319819,8,7675.644418,426.42469,959.455552,235.951874,8,0
0,0,11,11,15,21,36,84,43,127,0.000333,0.21886,14,9192.126653,510.673703,656.580475,150.842025,2,0
0,0,18,18,11,28,39,116,64,180,0.000333,0.317124,10,9513.723994,528.540222,951.372399,172.659686,10,0
0,0,2,2,4,5,9,11,7,18,0.000333,0.01902,2,114.1173,6.33985,57.05865,19.60964,1,0
0,0,9,9,15,19,34,68,35,103,0.000333,0.17467,7,3668.060709,203.78115,524.008673,139.313982,2,0
0,0,22,22,21,29,50,174,83,257,0.000333,0.48349,20,29009.42082,1611.63449,1450.471041,233.120115,9,0
0,0,33,33,18,34,52,268,144,412,0.000333,0.78286,36,84548.9219,4697.162328,2348.581164,248.032387,3,0
0,0,13,13,9,18,27,85,46,131,0.000333,0.20763,8,4983.122102,276.840117,622.890263,103.587975,1,0
0,0,1,1,9,6,15,12,7,19,0.000333,0.024744,4,296.923685,16.49576,74.230921,44.0391,1,0
0,0,37,37,22,52,74,229,122,351,0.000333,0.726506,22,47949.39889,2663.855494,2179.518131,394.530361,18,0
0,0,2,2,7,5,12,13,8,21,0.000333,0.025095,3,225.852638,12.547369,75.284213,31.261125,1,0
0,0,3,3,12,6,18,15,7,22,0.000333,0.030579,6,550.4301,30.57945,91.73835,58.529325,3,0
0,0,9,9,15,19,34,68,35,103,0.000333,0.17467,7,3668.060709,203.78115,524.008673,139.313982,2,0
0,0,3,3,4,5,9,7,6,13,0.000333,0.013736,2,82.41805,4.578781,41.209025,19.60964,1,0
0,0,3,3,9,5,14,12,6,18,0.000333,0.022844,4,274.129554,15.22942,68.532389,40.138965,2,0
0,0,1,1,7,5,12,8,6,14,0.000333,0.01673,3,150.568425,8.364913,50.189475,31.261125,1,0
0,0,11,11,15,21,36,84,43,127,0.000333,0.21886,14,9192.126653,510.673703,656.580475,150.842025,2,0
0,0,3,3,4,5,9,7,6,13,0.000333,0.013736,2,82.41805,4.578781,41.209025,19.60964,1,0
0,0,2,2,8,6,14,15,9,24,0.000333,0.030459,4,365.506073,20.305893,91.376518,39.509775,2,0
0,0,4,4,7,8,15,24,15,39,0.000333,0.05079,3,457.1062,25.394789,152.368733,43.651484,2,0
0,0,2,2,12,7,19,19,11,30,0.000333,0.042479,6,764.626952,42.479275,127.437825,62.671034,2,0
0,0,2,2,7,6,13,15,9,24,0.000333,0.029604,3,266.43166,14.801759,88.810553,35.161259,2,0
0,0,3,3,12,6,18,19,7,26,0.000333,0.036139,6,650.5083,36.13935,108.41805,58.529325,3,0
0,0,23,23,17,33,50,119,66,185,0.000333,0.348038,16,16705.81432,928.100796,1044.113395,235.951874,9,0
0,0,14,14,14,22,36,59,36,95,0.000333,0.163714,7,3438.000126,191.000007,491.142875,151.410465,5,0
0,0,9,9,15,19,34,68,35,103,0.000333,0.17467,7,3668.060709,203.78115,524.008673,139.313982,2,0
0,0,11,11,15,21,36,84,43,127,0.000333,0.21886,14,9192.126653,510.673703,656.580475,150.842025,2,0
0,0,24,24,17,35,52,122,68,190,0.000333,0.361028,8,8664.668372,481.370465,1083.083546,249.011774,9,0
0,0,15,15,14,24,38,62,38,100,0.000333,0.174931,7,3673.549259,204.08607,524.792751,163.342069,5,0
0,0,9,9,15,19,34,68,35,103,0.000333,0.17467,7,3668.060709,203.78115,524.008673,139.313982,2,0
0,0,9,9,15,20,35,72,36,108,0.000333,0.184654,7,3877.737961,215.429887,553.962566,145.041921,2,0
0,0,1,1,9,6,15,12,7,19,0.000333,0.024744,4,296.923685,16.49576,74.230921,44.0391,1,0
0,0,5,5,12,11,23,33,16,49,0.000333,0.073885,6,1329.927215,73.884845,221.654536,81.073298,2,0
0,0,14,14,16,22,38,93,46,139,0.000333,0.243154,16,11671.39079,648.410599,729.461924,162.107496,6,0
0,0,11,11,15,21,36,84,43,127,0.000333,0.21886,14,9192.126653,510.673703,656.580475,150.842025,2,0
0,0,9,9,15,19,34,68,35,103,0.000333,0.17467,7,3668.060709,203.78115,524.008673,139.313982,2,0
0,0,2,2,9,9,18,17,11,28,0.000333,0.038919,4,467.0316,25.9462,116.7579,57.05865,3,0
0,0,3,3,9,5,14,12,6,18,0.000333,0.022844,4,274.129554,15.22942,68.532389,40.138965,2,0
0,0,3,3,12,6,18,19,7,26,0.000333,0.036139,6,650.5083,36.13935,108.41805,58.529325,3,0
0,0,3,3,4,5,9,7,6,13,0.000333,0.013736,2,82.41805,4.578781,41.209025,19.60964,1,0
0,0,1,1,7,5,12,8,6,14,0.000333,0.01673,3,150.568425,8.364913,50.189475,31.261125,1,0
0,0,3,3,12,6,18,15,7,22,0.000333,0.030579,6,550.4301,30.57945,91.73835,58.529325,3,0
0,0,4,4,7,8,15,24,15,39,0.000333,0.05079,3,457.1062,25.394789,152.368733,43.651484,2,0
0,0,2,2,12,7,19,19,11,30,0.000333,0.042479,6,764.626952,42.479275,127.437825,62.671034,2,0
0,0,2,2,8,6,14,15,9,24,0.000333,0.030459,4,365.506073,20.305893,91.376518,39.509775,2,0
0,0,2,2,7,5,12,13,8,21,0.000333,0.025095,3,225.852638,12.547369,75.284213,31.261125,1,0
0,0,21,21,17,29,46,113,63,176,0.000333,0.324049,16,15554.35047,864.130582,972.146904,210.368317,10,0
0,0,11,11,7,15,22,59,38,97,0.000333,0.144188,6,2595.389202,144.188289,432.564867,78.254843,1,0
0,0,11,11,15,21,36,84,43,127,0.000333,0.21886,14,9192.126653,510.673703,656.580475,150.842025,2,0
0,0,15,15,12,22,34,100,56,156,0.000333,0.264548,12,9523.730439,529.096135,793.644203,141.127046,4,0
0,0,20,20,14,27,41,137,77,214,0.000333,0.382172,14,16051.22581,891.734767,1146.516129,181.684931,8,0
0,0,9,9,15,19,34,68,35,103,0.000333,0.17467,7,3668.060709,203.78115,524.008673,139.313982,2,0
0,0,30,30,17,51,68,157,88,245,0.000333,0.497143,8,11931.42717,662.857065,1491.428396,358.780561,10,0
0,0,7,7,13,12,25,37,23,60,0.000333,0.092877,6,1671.788228,92.877124,278.631371,91.125266,3,0
0,0,9,9,15,19,34,68,35,103,0.000333,0.17467,7,3668.060709,203.78115,524.008673,139.313982,2,0
0,0,11,11,15,21,36,84,43,127,0.000333,0.21886,14,9192.126653,510.673703,656.580475,150.842025,2,0
0,0,5,5,6,11,17,29,19,48,0.000333,0.065399,3,588.594649,32.699703,196.198216,53.563523,2,0
0,0,16,16,12,26,38,94,58,152,0.000333,0.265895,12,9572.219785,531.789988,797.684982,165.230983,4,0
0,0,4,4,12,10,22,32,15,47,0.000333,0.069864,6,1257.559716,69.864429,209.593286,76.238831,2,0
0,0,11,11,15,21,36,84,43,127,0.000333,0.21886,14,9192.126653,510.673703,656.580475,150.842025,2,0
0,0,9,9,15,19,34,68,35,103,0.000333,0.17467,7,3668.060709,203.78115,524.008673,139.313982,2,0
0,0,16,16,11,24,35,110,56,166,0.000333,0.28382,10,8514.609808,473.033878,851.460981,148.092848,1,0
0,0,5,5,12,11,23,33,16,49,0.000333,0.073885,6,1329.927215,73.884845,221.654536,81.073298,2,0
0,0,14,14,16,22,38,93,46,139,0.000333,0.243154,16,11671.39079,648.410599,729.461924,162.107496,6,0
0,0,8,8,9,10,19,35,23,58,0.000333,0.082127,8,1971.038366,109.502131,246.379796,61.748606,9,0
0,0,11,11,15,21,36,84,43,127,0.000333,0.21886,14,9192.126653,510.673703,656.580475,150.842025,2,0
0,0,9,9,15,19,34,68,35,103,0.000333,0.17467,7,3668.060709,203.78115,524.008673,139.313982,2,0
0,0,25,25,17,44,61,152,82,234,0.000333,0.462598,8,11102.3403,616.796683,1387.792537,309.70186,15,0
0,0,16,16,15,35,50,92,52,144,0.000333,0.270905,7,5689.007039,316.055947,812.715291,238.128265,11,0
0,0,9,9,15,19,34,68,35,103,0.000333,0.17467,7,3668.060709,203.78115,524.008673,139.313982,2,0
0,0,2,2,12,7,19,19,11,30,0.000333,0.042479,6,764.626952,42.479275,127.437825,62.671034,2,0
0,0,3,3,4,5,9,7,6,13,0.000333,0.013736,2,82.41805,4.578781,41.209025,19.60964,1,0
0,0,3,3,12,6,18,15,7,22,0.000333,0.030579,6,550.4301,30.57945,91.73835,58.529325,3,0
0,0,11,11,15,21,36,84,43,127,0.000333,0.21886,14,9192.126653,510.673703,656.580475,150.842025,2,0
0,0,3,3,12,6,18,19,7,26,0.000333,0.036139,6,650.5083,36.13935,108.41805,58.529325,3,0
0,0,1,1,7,5,12,8,6,14,0.000333,0.01673,3,150.568425,8.364913,50.189475,31.261125,1,0
0,0,2,2,8,6,14,15,9,24,0.000333,0.030459,4,365.506073,20.305893,91.376518,39.509775,2,0
0,0,3,3,9,5,14,12,6,18,0.000333,0.022844,4,274.129554,15.22942,68.532389,40.138965,2,0
0,0,4,4,7,8,15,24,15,39,0.000333,0.05079,3,457.1062,25.394789,152.368733,43.651484,2,0
0,0,2,2,7,5,12,13,8,21,0.000333,0.025095,3,225.852638,12.547369,75.284213,31.261125,1,0
0,0,2,2,7,6,13,15,9,24,0.000333,0.029604,3,266.43166,14.801759,88.810553,35.161259,2,0
0,0,3,3,4,5,9,7,6,13,0.000333,0.013736,2,82.41805,4.578781,41.209025,19.60964,1,0
0,0,5,5,9,10,19,30,18,48,0.000333,0.067967,4,815.602083,45.311227,203.900521,61.748606,2,0
0,0,4,4,12,10,22,32,15,47,0.000333,0.069864,6,1257.559716,69.864429,209.593286,76.238831,2,0
0,0,9,9,13,20,33,46,27,73,0.000333,0.122747,6,2209.444624,122.746924,368.240771,134.544278,3,0
0,0,18,18,17,31,48,106,57,163,0.000333,0.30345,8,7282.791101,404.599506,910.348888,223.066954,7,0
0,0,6,6,9,10,19,31,18,49,0.000333,0.069383,4,832.593793,46.255211,208.148448,61.748606,1,0
0,0,10,10,15,20,35,80,41,121,0.000333,0.206881,14,8689.005431,482.722524,620.643245,145.041921,2,0
0,0,9,9,15,19,34,68,35,103,0.000333,0.17467,7,3668.060709,203.78115,524.008673,139.313982,2,0
0,0,20,20,19,27,46,154,87,241,0.000333,0.443726,27,35941.81765,1996.767647,1331.178431,209.092585,3,0
0,0,18,18,15,32,47,77,48,125,0.000333,0.231441,7,4860.265245,270.014736,694.323606,218.603359,8,0
0,0,27,27,17,43,60,137,78,215,0.000333,0.423327,8,10159.85182,564.436212,1269.981478,302.816253,12,0
0,0,11,11,15,21,36,84,43,127,0.000333,0.21886,14,9192.126653,510.673703,656.580475,150.842025,2,0
0,0,5,5,6,12,18,23,18,41,0.000333,0.056989,3,512.900775,28.494488,170.966925,58.529325,3,0
0,0,9,9,15,19,34,68,35,103,0.000333,0.17467,7,3668.060709,203.78115,524.008673,139.313982,2,0
0,0,14,14,16,22,38,93,46,139,0.000333,0.243154,16,11671.39079,648.410599,729.461924,162.107496,6,0
0,0,5,5,12,11,23,33,16,49,0.000333,0.073885,6,1329.927215,73.884845,221.654536,81.073298,2,0
0,0,11,11,15,21,36,84,43,127,0.000333,0.21886,14,9192.126653,510.673703,656.580475,150.842025,2,0
0,0,9,9,15,19,34,68,35,103,0.000333,0.17467,7,3668.060709,203.78115,524.008673,139.313982,2,0
0,0,1,1,5,4,9,12,4,16,0.000333,0.016906,2,101.4376,5.635422,50.7188,19.60964,2,0
0,0,19,19,16,38,54,112,67,179,0.000333,0.343375,8,8240.998903,457.833272,1030.124863,263.421246,8,0
0,0,28,28,18,47,65,172,97,269,0.000333,0.540006,18,29160.30495,1620.016942,1620.016942,336.124326,12,0
0,0,3,3,4,5,9,7,6,13,0.000333,0.013736,2,82.41805,4.578781,41.209025,19.60964,1,0
0,0,3,3,9,5,14,12,6,18,0.000333,0.022844,4,274.129554,15.22942,68.532389,40.138965,2,0
0,0,3,3,12,6,18,15,7,22,0.000333,0.030579,6,550.4301,30.57945,91.73835,58.529325,3,0
0,0,4,4,7,8,15,24,15,39,0.000333,0.05079,3,457.1062,25.394789,152.368733,43.651484,2,0
0,0,2,2,7,6,13,15,9,24,0.000333,0.029604,3,266.43166,14.801759,88.810553,35.161259,2,0
0,0,12,12,16,22,38,78,43,121,0.000333,0.211666,8,5079.993833,282.22188,634.999229,162.107496,3,0
0,0,5,5,10,9,19,36,18,54,0.000333,0.076463,10,2293.880857,127.437825,229.388086,61.748606,1,0
0,0,18,18,24,23,47,134,74,208,0.000333,0.385118,36,41592.76132,2310.708962,1155.354481,214.081025,4,0
0,0,11,11,15,21,36,84,43,127,0.000333,0.21886,14,9192.126653,510.673703,656.580475,150.842025,2,0
0,0,13,13,16,22,38,89,44,133,0.000333,0.232658,16,11167.58975,620.421653,697.974359,162.107496,5,0
0,0,4,4,10,10,20,29,14,43,0.000333,0.061948,5,929.21454,51.62303,185.842908,66.438562,1,0
0,0,11,11,15,21,36,84,43,127,0.000333,0.21886,14,9192.126653,510.673703,656.580475,150.842025,2,0
0,0,9,9,15,19,34,68,35,103,0.000333,0.17467,7,3668.060709,203.78115,524.008673,139.313982,2,0
0,0,7,7,13,12,25,37,23,60,0.000333,0.092877,6,1671.788228,92.877124,278.631371,91.125266,3,0
0,0,17,17,16,26,42,70,46,116,0.000333,0.208503,8,5004.070568,278.00392,625.508821,186.211433,5,0
0,0,23,23,17,37,54,122,69,191,0.000333,0.366395,8,8793.468103,488.526006,1099.183513,262.236643,8,0
0,0,12,12,16,21,37,85,42,127,0.000333,0.220534,16,10585.60924,588.089402,661.600577,156.238666,4,0
0,0,13,13,16,22,38,89,44,133,0.000333,0.232658,16,11167.58975,620.421653,697.974359,162.107496,5,0
0,0,4,4,10,15,25,32,21,53,0.000333,0.082041,5,1230.62189,68.367883,246.124378,91.82264,1,0
0,0,25,25,12,35,47,382,213,595,0.000333,1.10166,36,118979.2932,6609.960733,3304.980367,222.544456,4,0
0,0,6,6,12,12,24,35,18,53,0.000333,0.081001,6,1458.018075,81.001004,243.003013,86.0391,2,0
0,0,15,15,16,23,39,95,48,143,0.000333,0.251938,16,12093.00028,671.833349,755.812517,168.041925,6,0
0,0,13,13,14,16,30,50,31,81,0.000333,0.132486,7,2782.206968,154.567054,397.458138,117.302969,4,0
0,0,22,22,17,27,44,110,61,171,0.000333,0.311188,16,14937.00491,829.833606,933.562807,197.868831,8,0
0,0,11,11,9,22,31,69,42,111,0.000333,0.183305,4,2199.663162,122.203509,549.91579,126.636821,5,0
0,0,19,19,17,26,43,106,55,161,0.000333,0.29121,16,13978.05801,776.558778,873.628626,191.698301,8,0
0,0,9,9,15,19,34,68,35,103,0.000333,0.17467,7,3668.060709,203.78115,524.008673,139.313982,2,0
0,0,4,4,12,10,22,32,15,47,0.000333,0.069864,6,1257.559716,69.864429,209.593286,76.238831,2,0
0,0,6,6,10,11,21,37,21,58,0.000333,0.084918,5,1273.772053,70.765114,254.754411,71.273029,2,0
0,0,6,6,7,11,18,41,25,66,0.000333,0.091738,6,1651.290301,91.73835,275.21505,57.705232,1,0
0,0,5,5,10,11,21,27,16,43,0.000333,0.062957,5,944.348246,52.463791,188.869649,71.273029,1,0
0,0,24,24,17,31,48,118,65,183,0.000333,0.340683,16,16352.7702,908.487233,1022.048138,223.066954,9,0
0,0,9,9,15,19,34,68,35,103,0.000333,0.17467,7,3668.060709,203.78115,524.008673,139.313982,2,0
0,0,5,5,12,11,23,33,16,49,0.000333,0.073885,6,1329.927215,73.884845,221.654536,81.073298,2,0
0,0,14,14,16,22,38,93,46,139,0.000333,0.243154,16,11671.39079,648.410599,729.461924,162.107496,6,0
0,0,9,9,15,19,34,68,35,103,0.000333,0.17467,7,3668.060709,203.78115,524.008673,139.313982,2,0
0,0,5,5,12,11,23,33,16,49,0.000333,0.073885,6,1329.927215,73.884845,221.654536,81.073298,2,0
0,0,14,14,16,22,38,93,46,139,0.000333,0.243154,16,11671.39079,648.410599,729.461924,162.107496,6,0
0,0,9,9,15,19,34,68,35,103,0.000333,0.17467,7,3668.060709,203.78115,524.008673,139.313982,2,0
0,0,6,6,7,11,18,41,25,66,0.000333,0.091738,6,1651.290301,91.73835,275.21505,57.705232,1,0
0,0,23,23,17,35,52,124,68,192,0.000333,0.364828,8,8755.875407,486.437523,1094.484426,249.011774,9,0
0,0,14,14,15,24,39,64,38,102,0.000333,0.179704,7,3773.777184,209.654288,539.111026,168.642459,5,0
0,0,9,9,15,19,34,68,35,103,0.000333,0.17467,7,3668.060709,203.78115,524.008673,139.313982,2,0
0,0,4,4,10,15,25,32,21,53,0.000333,0.082041,5,1230.62189,68.367883,246.124378,91.82264,1,0
0,0,25,25,12,35,47,382,213,595,0.000333,1.10166,36,118979.2932,6609.960733,3304.980367,222.544456,4,0
0,0,26,26,18,35,53,129,77,206,0.000333,0.393317,18,21239.12905,1179.951614,1179.951614,254.583556,10,0
0,0,7,7,13,12,25,37,23,60,0.000333,0.092877,6,1671.788228,92.877124,278.631371,91.125266,3,0
0,0,9,9,15,19,34,68,35,103,0.000333,0.17467,7,3668.060709,203.78115,524.008673,139.313982,2,0
0,0,25,25,12,35,47,382,213,595,0.000333,1.10166,36,118979.2932,6609.960733,3304.980367,222.544456,4,0
0,0,14,14,15,23,38,93,49,142,0.000333,0.248402,14,10432.8799,579.604439,745.205707,162.645284,3,0
0,0,4,4,10,15,25,32,21,53,0.000333,0.082041,5,1230.62189,68.367883,246.124378,91.82264,1,0
0,0,13,13,12,22,34,68,40,108,0.000333,0.183149,6,3296.675921,183.148662,549.445987,141.127046,6,0
0,0,21,21,17,27,44,109,59,168,0.000333,0.305728,16,14674.95219,815.275122,917.184512,197.868831,8,0
0,0,9,9,15,19,34,68,35,103,0.000333,0.17467,7,3668.060709,203.78115,524.008673,139.313982,2,0
0,0,11,11,9,18,27,53,35,88,0.000333,0.139477,4,1673.720401,92.984467,418.4301,103.587975,1,0
0,0,24,24,18,35,53,121,69,190,0.000333,0.362768,9,9794.743977,544.152443,1088.304886,254.583556,9,0
0,0,7,7,13,12,25,37,23,60,0.000333,0.092877,6,1671.788228,92.877124,278.631371,91.125266,3,0
0,0,13,13,12,26,38,62,41,103,0.000333,0.180179,6,3243.219203,180.178845,540.536534,165.230983,2,0
0,0,9,9,15,19,34,68,35,103,0.000333,0.17467,7,3668.060709,203.78115,524.008673,139.313982,2,0
0,0,26,26,17,38,55,129,76,205,0.000333,0.39506,16,18962.85986,1053.492214,1185.178741,268.908114,9,0
0,0,7,7,13,12,25,37,23,60,0.000333,0.092877,6,1671.788228,92.877124,278.631371,91.125266,3,0
0,0,12,12,15,21,36,87,45,132,0.000333,0.227477,14,9554.021403,530.778967,682.4301,150.842025,2,0
0,0,12,12,13,22,35,68,39,107,0.000333,0.182944,6,3292.999697,182.944428,548.833283,146.213212,2,0
0,0,9,9,15,19,34,68,35,103,0.000333,0.17467,7,3668.060709,203.78115,524.008673,139.313982,2,0
0,0,16,16,15,31,46,379,56,435,0.000333,0.800916,7,16819.24616,934.402564,2402.749451,212.183445,3,0
0,0,7,7,13,12,25,37,23,60,0.000333,0.092877,6,1671.788228,92.877124,278.631371,91.125266,3,0
0,0,6,6,7,11,18,41,25,66,0.000333,0.091738,6,1651.290301,91.73835,275.21505,57.705232,1,0
0,0,13,13,13,22,35,68,41,109,0.000333,0.186364,6,3354.551093,186.36395,559.091849,146.213212,2,0
0,0,6,6,7,11,18,41,25,66,0.000333,0.091738,6,1651.290301,91.73835,275.21505,57.705232,1,0
0,0,5,5,10,11,21,27,16,43,0.000333,0.062957,5,944.348246,52.463791,188.869649,71.273029,1,0
0,0,11,11,11,19,30,77,42,119,0.000333,0.19464,10,5839.199809,324.399989,583.919981,118.764371,2,0
0,0,6,6,7,11,18,41,25,66,0.000333,0.091738,6,1651.290301,91.73835,275.21505,57.705232,1,0
0,0,7,7,13,12,25,37,23,60,0.000333,0.092877,6,1671.788228,92.877124,278.631371,91.125266,3,0
0,0,4,4,10,15,25,32,21,53,0.000333,0.082041,5,1230.62189,68.367883,246.124378,91.82264,1,0
0,0,25,25,12,35,47,382,213,595,0.000333,1.10166,36,118979.2932,6609.960733,3304.980367,222.544456,4,0
0,0,6,6,7,11,18,41,25,66,0.000333,0.091738,6,1651.290301,91.73835,275.21505,57.705232,1,0
0,0,13,13,11,20,31,68,42,110,0.000333,0.181654,10,5449.615941,302.756441,544.961594,124.49231,4,0
0,0,5,5,10,10,20,32,18,50,0.000333,0.072032,5,1080.482024,60.026779,216.096405,66.438562,2,0
0,0,5,5,10,10,20,32,18,50,0.000333,0.072032,5,1080.482024,60.026779,216.096405,66.438562,2,0
0,0,5,5,12,11,23,33,16,49,0.000333,0.073885,6,1329.927215,73.884845,221.654536,81.073298,2,0
0,0,14,14,16,22,38,93,46,139,0.000333,0.243154,16,11671.39079,648.410599,729.461924,162.107496,6,0
0,0,12,12,15,21,36,87,45,132,0.000333,0.227477,14,9554.021403,530.778967,682.4301,150.842025,2,0
0,0,9,9,15,19,34,68,35,103,0.000333,0.17467,7,3668.060709,203.78115,524.008673,139.313982,2,0
0,0,24,24,17,41,58,135,78,213,0.000333,0.415917,8,9981.999616,554.555534,1247.749952,289.1465,9,0
0,0,9,9,15,19,34,68,35,103,0.000333,0.17467,7,3668.060709,203.78115,524.008673,139.313982,2,0
0,0,12,12,15,21,36,87,45,132,0.000333,0.227477,14,9554.021403,530.778967,682.4301,150.842025,2,0
0,0,23,23,15,21,36,90,55,145,0.000333,0.24988,14,10494.94775,583.052653,749.639125,150.842025,8,0
0,0,12,12,16,20,36,84,41,125,0.000333,0.215414,16,10339.85,574.436111,646.240625,150.438562,5,0
0,0,9,9,15,19,34,68,35,103,0.000333,0.17467,7,3668.060709,203.78115,524.008673,139.313982,2,0
0,0,18,18,15,24,39,70,49,119,0.000333,0.209654,14,8805.480097,489.193339,628.962864,168.642459,6,0
0,0,7,7,13,12,25,37,23,60,0.000333,0.092877,6,1671.788228,92.877124,278.631371,91.125266,3,0
0,0,12,12,16,20,36,84,41,125,0.000333,0.215414,16,10339.85,574.436111,646.240625,150.438562,5,0
0,0,11,11,15,19,34,82,42,124,0.000333,0.210282,14,8831.835492,490.657527,630.845392,139.313982,2,0
0,0,9,9,15,19,34,68,35,103,0.000333,0.17467,7,3668.060709,203.78115,524.008673,139.313982,2,0
0,0,12,12,14,17,31,92,39,131,0.000333,0.216333,14,9085.996033,504.777557,648.999717,122.789837,6,0
0,0,5,5,7,11,18,30,19,49,0.000333,0.068109,3,612.978975,34.054388,204.326325,57.705232,1,0
0,0,18,18,15,22,37,70,45,115,0.000333,0.199696,14,8387.219919,465.956662,599.087137,156.710855,6,0
0,0,27,27,18,33,51,130,75,205,0.000333,0.387616,18,20931.24951,1162.847195,1162.847195,241.523656,10,0
0,0,20,20,13,30,43,135,70,205,0.000333,0.370795,12,13348.6113,741.589516,1112.384275,195.312434,2,0
0,0,9,9,15,19,34,68,35,103,0.000333,0.17467,7,3668.060709,203.78115,524.008673,139.313982,2,0
0,0,11,11,15,19,34,82,42,124,0.000333,0.210282,14,8831.835492,490.657527,630.845392,139.313982,2,0
0,0,14,14,11,27,38,89,51,140,0.000333,0.244903,5,3673.549259,204.08607,734.709852,166.43571,1,0
0,0,12,12,16,20,36,84,41,125,0.000333,0.215414,16,10339.85,574.436111,646.240625,150.438562,5,0
0,0,9,9,15,19,34,68,35,103,0.000333,0.17467,7,3668.060709,203.78115,524.008673,139.313982,2,0
0,0,7,7,13,12,25,37,23,60,0.000333,0.092877,6,1671.788228,92.877124,278.631371,91.125266,3,0
0,0,12,12,16,20,36,84,41,125,0.000333,0.215414,16,10339.85,574.436111,646.240625,150.438562,5,0
0,0,11,11,15,19,34,82,42,124,0.000333,0.210282,14,8831.835492,490.657527,630.845392,139.313982,2,0
0,0,9,9,15,19,34,68,35,103,0.000333,0.17467,7,3668.060709,203.78115,524.008673,139.313982,2,0
0,0,16,16,13,28,41,80,50,130,0.000333,0.232161,6,4178.890564,232.160587,696.481761,182.711654,4,0
0,0,3,3,10,8,18,24,11,35,0.000333,0.048649,5,729.736875,40.540938,145.947375,57.219281,1,0
0,0,12,12,16,20,36,84,41,125,0.000333,0.215414,16,10339.85,574.436111,646.240625,150.438562,5,0
0,0,4,4,12,10,22,32,15,47,0.000333,0.069864,6,1257.559716,69.864429,209.593286,76.238831,2,0
0,0,9,9,15,19,34,68,35,103,0.000333,0.17467,7,3668.060709,203.78115,524.008673,139.313982,2,0
0,0,18,18,16,24,40,72,49,121,0.000333,0.214651,16,10303.25279,572.402933,643.953299,174.0391,6,0
0,0,27,27,19,35,54,132,79,211,0.000333,0.40476,18,21857.06273,1214.281263,1214.281263,260.235528,10,0
0,0,20,20,19,29,48,114,68,182,0.000333,0.338821,18,18296.33715,1016.463175,1016.463175,221.592072,10,0
0,0,12,12,10,23,33,69,42,111,0.000333,0.186643,5,2799.638736,155.535485,559.927747,137.261206,4,0
0,0,9,9,15,19,34,68,35,103,0.000333,0.17467,7,3668.060709,203.78115,524.008673,139.313982,2,0
0,0,11,11,15,19,34,82,42,124,0.000333,0.210282,14,8831.835492,490.657527,630.845392,139.313982,2,0
0,0,6,6,15,8,23,33,19,52,0.000333,0.078408,14,3293.153104,182.95295,235.225222,82.603359,3,0
0,0,4,4,12,10,22,28,13,41,0.000333,0.060946,6,1097.020178,60.945565,182.836696,76.238831,2,0
0,0,12,12,16,20,36,84,41,125,0.000333,0.215414,16,10339.85,574.436111,646.240625,150.438562,5,0
0,0,9,9,15,19,34,68,35,103,0.000333,0.17467,7,3668.060709,203.78115,524.008673,139.313982,2,0
0,0,18,18,13,28,41,86,54,140,0.000333,0.250019,6,4500.343684,250.019094,750.057281,182.711654,4,0
0,0,19,19,16,25,41,75,49,124,0.000333,0.221445,8,5314.691589,295.260644,664.336449,180.096405,6,0
0,0,28,28,18,36,54,140,81,221,0.000333,0.423943,18,22892.94248,1271.830138,1271.830138,261.17595,11,0
0,0,9,9,15,19,34,68,35,103,0.000333,0.17467,7,3668.060709,203.78115,524.008673,139.313982,2,0
0,0,11,11,15,19,34,82,42,124,0.000333,0.210282,14,8831.835492,490.657527,630.845392,139.313982,2,0
0,0,9,9,11,15,26,61,30,91,0.000333,0.14258,10,4277.400144,237.633341,427.740014,96.657107,4,0
0,0,12,12,10,20,30,59,39,98,0.000333,0.160292,5,2404.376392,133.576466,480.875278,119.657843,1,0
0,0,5,5,7,11,18,30,19,49,0.000333,0.068109,3,612.978975,34.054388,204.326325,57.705232,1,0
0,0,19,19,16,25,41,75,49,124,0.000333,0.221445,8,5314.691589,295.260644,664.336449,180.096405,6,0
0,0,28,28,18,36,54,140,81,221,0.000333,0.423943,18,22892.94248,1271.830138,1271.830138,261.17595,11,0
0,0,12,12,16,22,38,78,43,121,0.000333,0.211666,8,5079.993833,282.22188,634.999229,162.107496,3,0
0,0,5,5,10,9,19,36,18,54,0.000333,0.076463,10,2293.880857,127.437825,229.388086,61.748606,1,0
0,0,18,18,24,23,47,134,74,208,0.000333,0.385118,36,41592.76132,2310.708962,1155.354481,214.081025,4,0
0,0,11,11,15,19,34,82,42,124,0.000333,0.210282,14,8831.835492,490.657527,630.845392,139.313982,2,0
0,0,12,12,16,20,36,84,41,125,0.000333,0.215414,16,10339.85,574.436111,646.240625,150.438562,5,0
0,0,11,11,15,19,34,82,42,124,0.000333,0.210282,14,8831.835492,490.657527,630.845392,139.313982,2,0
0,0,9,9,15,19,34,68,35,103,0.000333,0.17467,7,3668.060709,203.78115,524.008673,139.313982,2,0
0,0,7,7,13,12,25,37,23,60,0.000333,0.092877,6,1671.788228,92.877124,278.631371,91.125266,3,0
0,0,19,19,16,26,42,76,50,126,0.000333,0.226477,8,5435.455962,301.969776,679.431995,186.211433,6,0
0,0,27,27,19,35,54,132,79,211,0.000333,0.40476,18,21857.06273,1214.281263,1214.281263,260.235528,10,0
0,0,11,11,16,19,35,80,39,119,0.000333,0.203462,16,9766.154864,542.564159,610.384679,144.710623,4,0
0,0,12,12,16,20,36,84,41,125,0.000333,0.215414,16,10339.85,574.436111,646.240625,150.438562,5,0
0,0,4,4,10,15,25,32,21,53,0.000333,0.082041,5,1230.62189,68.367883,246.124378,91.82264,1,0
0,0,25,25,12,35,47,382,213,595,0.000333,1.10166,36,118979.2932,6609.960733,3304.980367,222.544456,4,0
0,0,12,12,16,20,36,84,41,125,0.000333,0.215414,16,10339.85,574.436111,646.240625,150.438562,5,0
0,0,19,19,16,26,42,76,50,126,0.000333,0.226477,8,5435.455962,301.969776,679.431995,186.211433,6,0
0,0,22,22,17,27,44,110,61,171,0.000333,0.311188,16,14937.00491,829.833606,933.562807,197.868831,8,0
0,0,11,11,9,22,31,69,42,111,0.000333,0.183305,4,2199.663162,122.203509,549.91579,126.636821,5,0
0,0,21,21,17,27,44,108,59,167,0.000333,0.303908,16,14587.60129,810.422294,911.72508,197.868831,8,0
0,0,9,9,15,19,34,68,35,103,0.000333,0.17467,7,3668.060709,203.78115,524.008673,139.313982,2,0
0,0,4,4,12,10,22,32,15,47,0.000333,0.069864,6,1257.559716,69.864429,209.593286,76.238831,2,0
0,0,6,6,10,11,21,37,21,58,0.000333,0.084918,5,1273.772053,70.765114,254.754411,71.273029,2,0
0,0,6,6,7,11,18,41,25,66,0.000333,0.091738,6,1651.290301,91.73835,275.21505,57.705232,1,0
0,0,5,5,10,11,21,27,16,43,0.000333,0.062957,5,944.348246,52.463791,188.869649,71.273029,1,0
0,0,24,24,17,31,48,118,65,183,0.000333,0.340683,16,16352.7702,908.487233,1022.048138,223.066954,9,0
0,0,9,9,15,19,34,68,35,103,0.000333,0.17467,7,3668.060709,203.78115,524.008673,139.313982,2,0
0,0,12,12,16,20,36,84,41,125,0.000333,0.215414,16,10339.85,574.436111,646.240625,150.438562,5,0
0,0,9,9,15,19,34,68,35,103,0.000333,0.17467,7,3668.060709,203.78115,524.008673,139.313982,2,0
0,0,12,12,16,20,36,84,41,125,0.000333,0.215414,16,10339.85,574.436111,646.240625,150.438562,5,0
0,0,9,9,15,19,34,68,35,103,0.000333,0.17467,7,3668.060709,203.78115,524.008673,139.313982,2,0
0,0,6,6,7,11,18,41,25,66,0.000333,0.091738,6,1651.290301,91.73835,275.21505,57.705232,1,0
0,0,26,26,18,35,53,129,77,206,0.000333,0.393317,18,21239.12905,1179.951614,1179.951614,254.583556,10,0
0,0,19,19,16,26,42,76,50,126,0.000333,0.226477,8,5435.455962,301.969776,679.431995,186.211433,6,0
0,0,9,9,15,19,34,68,35,103,0.000333,0.17467,7,3668.060709,203.78115,524.008673,139.313982,2,0
0,0,4,4,10,15,25,32,21,53,0.000333,0.082041,5,1230.62189,68.367883,246.124378,91.82264,1,0
0,0,25,25,12,35,47,382,213,595,0.000333,1.10166,36,118979.2932,6609.960733,3304.980367,222.544456,4,0
0,0,26,26,18,35,53,129,77,206,0.000333,0.393317,18,21239.12905,1179.951614,1179.951614,254.583556,10,0
0,0,7,7,13,12,25,37,23,60,0.000333,0.092877,6,1671.788228,92.877124,278.631371,91.125266,3,0
0,0,9,9,15,19,34,68,35,103,0.000333,0.17467,7,3668.060709,203.78115,524.008673,139.313982,2,0
0,0,25,25,12,35,47,382,213,595,0.000333,1.10166,36,118979.2932,6609.960733,3304.980367,222.544456,4,0
0,0,11,11,15,19,34,82,42,124,0.000333,0.210282,14,8831.835492,490.657527,630.845392,139.313982,2,0
0,0,4,4,10,15,25,32,21,53,0.000333,0.082041,5,1230.62189,68.367883,246.124378,91.82264,1,0
0,0,13,13,13,22,35,68,41,109,0.000333,0.186364,6,3354.551093,186.36395,559.091849,146.213212,2,0
0,0,21,21,17,27,44,109,59,168,0.000333,0.305728,16,14674.95219,815.275122,917.184512,197.868831,8,0
0,0,9,9,15,19,34,68,35,103,0.000333,0.17467,7,3668.060709,203.78115,524.008673,139.313982,2,0
0,0,11,11,9,18,27,53,35,88,0.000333,0.139477,4,1673.720401,92.984467,418.4301,103.587975,1,0
0,0,24,24,18,35,53,121,69,190,0.000333,0.362768,9,9794.743977,544.152443,1088.304886,254.583556,9,0
0,0,7,7,13,12,25,37,23,60,0.000333,0.092877,6,1671.788228,92.877124,278.631371,91.125266,3,0
0,0,14,14,12,26,38,65,43,108,0.000333,0.188925,6,3400.657029,188.92539,566.776171,165.230983,2,0
0,0,9,9,15,19,34,68,35,103,0.000333,0.17467,7,3668.060709,203.78115,524.008673,139.313982,2,0
0,0,26,26,17,38,55,129,76,205,0.000333,0.39506,16,18962.85986,1053.492214,1185.178741,268.908114,9,0
0,0,7,7,13,12,25,37,23,60,0.000333,0.092877,6,1671.788228,92.877124,278.631371,91.125266,3,0
0,0,11,11,15,19,34,82,42,124,0.000333,0.210282,14,8831.835492,490.657527,630.845392,139.313982,2,0
0,0,12,12,13,22,35,68,39,107,0.000333,0.182944,6,3292.999697,182.944428,548.833283,146.213212,2,0
0,0,9,9,15,19,34,68,35,103,0.000333,0.17467,7,3668.060709,203.78115,524.008673,139.313982,2,0
0,0,16,16,15,31,46,379,56,435,0.000333,0.800916,7,16819.24616,934.402564,2402.749451,212.183445,3,0
0,0,7,7,13,12,25,37,23,60,0.000333,0.092877,6,1671.788228,92.877124,278.631371,91.125266,3,0
0,0,6,6,7,11,18,41,25,66,0.000333,0.091738,6,1651.290301,91.73835,275.21505,57.705232,1,0
0,0,13,13,13,22,35,68,41,109,0.000333,0.186364,6,3354.551093,186.36395,559.091849,146.213212,2,0
0,0,6,6,7,11,18,41,25,66,0.000333,0.091738,6,1651.290301,91.73835,275.21505,57.705232,1,0
0,0,5,5,10,11,21,27,16,43,0.000333,0.062957,5,944.348246,52.463791,188.869649,71.273029,1,0
0,0,11,11,11,19,30,77,42,119,0.000333,0.19464,10,5839.199809,324.399989,583.919981,118.764371,2,0
0,0,6,6,7,11,18,41,25,66,0.000333,0.091738,6,1651.290301,91.73835,275.21505,57.705232,1,0
0,0,7,7,13,12,25,37,23,60,0.000333,0.092877,6,1671.788228,92.877124,278.631371,91.125266,3,0
0,0,4,4,10,15,25,32,21,53,0.000333,0.082041,5,1230.62189,68.367883,246.124378,91.82264,1,0
0,0,25,25,12,35,47,382,213,595,0.000333,1.10166,36,118979.2932,6609.960733,3304.980367,222.544456,4,0
0,0,6,6,7,11,18,41,25,66,0.000333,0.091738,6,1651.290301,91.73835,275.21505,57.705232,1,0
0,0,13,13,11,20,31,68,42,110,0.000333,0.181654,10,5449.615941,302.756441,544.961594,124.49231,4,0
0,0,5,5,10,10,20,32,18,50,0.000333,0.072032,5,1080.482024,60.026779,216.096405,66.438562,2,0
0,0,5,5,10,10,20,32,18,50,0.000333,0.072032,5,1080.482024,60.026779,216.096405,66.438562,2,0
0,0,12,12,16,20,36,84,41,125,0.000333,0.215414,16,10339.85,574.436111,646.240625,150.438562,5,0
0,0,11,11,15,19,34,82,42,124,0.000333,0.210282,14,8831.835492,490.657527,630.845392,139.313982,2,0
0,0,9,9,15,19,34,68,35,103,0.000333,0.17467,7,3668.060709,203.78115,524.008673,139.313982,2,0
0,0,24,24,17,41,58,135,78,213,0.000333,0.415917,8,9981.999616,554.555534,1247.749952,289.1465,9,0
0,0,9,9,15,19,34,68,35,103,0.000333,0.17467,7,3668.060709,203.78115,524.008673,139.313982,2,0
0,0,11,11,15,19,34,82,42,124,0.000333,0.210282,14,8831.835492,490.657527,630.845392,139.313982,2,0
0,0,19,19,16,26,42,76,50,126,0.000333,0.226477,8,5435.455962,301.969776,679.431995,186.211433,6,0
0,0,12,12,16,20,36,84,41,125,0.000333,0.215414,16,10339.85,574.436111,646.240625,150.438562,5,0
0,0,9,9,15,19,34,68,35,103,0.000333,0.17467,7,3668.060709,203.78115,524.008673,139.313982,2,0
0,0,18,18,15,24,39,70,49,119,0.000333,0.209654,14,8805.480097,489.193339,628.962864,168.642459,6,0
0,0,7,7,13,12,25,37,23,60,0.000333,0.092877,6,1671.788228,92.877124,278.631371,91.125266,3,0
0,0,12,12,16,20,36,84,41,125,0.000333,0.215414,16,10339.85,574.436111,646.240625,150.438562,5,0
0,0,11,11,15,19,34,82,42,124,0.000333,0.210282,14,8831.835492,490.657527,630.845392,139.313982,2,0
0,0,9,9,15,19,34,68,35,103,0.000333,0.17467,7,3668.060709,203.78115,524.008673,139.313982,2,0
0,0,12,12,14,17,31,92,39,131,0.000333,0.216333,14,9085.996033,504.777557,648.999717,122.789837,6,0
0,0,5,5,7,11,18,30,19,49,0.000333,0.068109,3,612.978975,34.054388,204.326325,57.705232,1,0
0,0,18,18,15,22,37,70,45,115,0.000333,0.199696,14,8387.219919,465.956662,599.087137,156.710855,6,0
0,0,27,27,18,33,51,130,75,205,0.000333,0.387616,18,20931.24951,1162.847195,1162.847195,241.523656,10,0
0,0,20,20,13,30,43,135,70,205,0.000333,0.370795,12,13348.6113,741.589516,1112.384275,195.312434,2,0
0,0,9,9,15,19,34,68,35,103,0.000333,0.17467,7,3668.060709,203.78115,524.008673,139.313982,2,0
0,0,11,11,15,19,34,82,42,124,0.000333,0.210282,14,8831.835492,490.657527,630.845392,139.313982,2,0
0,0,14,14,11,27,38,89,51,140,0.000333,0.244903,5,3673.549259,204.08607,734.709852,166.43571,1,0
0,0,12,12,16,20,36,84,41,125,0.000333,0.215414,16,10339.85,574.436111,646.240625,150.438562,5,0
0,0,9,9,15,19,34,68,35,103,0.000333,0.17467,7,3668.060709,203.78115,524.008673,139.313982,2,0
0,0,7,7,13,12,25,37,23,60,0.000333,0.092877,6,1671.788228,92.877124,278.631371,91.125266,3,0
0,0,12,12,16,20,36,84,41,125,0.000333,0.215414,16,10339.85,574.436111,646.240625,150.438562,5,0
0,0,11,11,15,19,34,82,42,124,0.000333,0.210282,14,8831.835492,490.657527,630.845392,139.313982,2,0
0,0,9,9,15,19,34,68,35,103,0.000333,0.17467,7,3668.060709,203.78115,524.008673,139.313982,2,0
0,0,16,16,13,28,41,80,50,130,0.000333,0.232161,6,4178.890564,232.160587,696.481761,182.711654,4,0
0,0,3,3,10,8,18,24,11,35,0.000333,0.048649,5,729.736875,40.540938,145.947375,57.219281,1,0
0,0,12,12,16,20,36,84,41,125,0.000333,0.215414,16,10339.85,574.436111,646.240625,150.438562,5,0
0,0,4,4,12,10,22,32,15,47,0.000333,0.069864,6,1257.559716,69.864429,209.593286,76.238831,2,0
0,0,9,9,15,19,34,68,35,103,0.000333,0.17467,7,3668.060709,203.78115,524.008673,139.313982,2,0
0,0,18,18,16,24,40,72,49,121,0.000333,0.214651,16,10303.25279,572.402933,643.953299,174.0391,6,0
0,0,27,27,19,35,54,132,79,211,0.000333,0.40476,18,21857.06273,1214.281263,1214.281263,260.235528,10,0
0,0,20,20,19,29,48,114,68,182,0.000333,0.338821,18,18296.33715,1016.463175,1016.463175,221.592072,10,0
0,0,12,12,10,23,33,69,42,111,0.000333,0.186643,5,2799.638736,155.535485,559.927747,137.261206,4,0
0,0,9,9,15,19,34,68,35,103,0.000333,0.17467,7,3668.060709,203.78115,524.008673,139.313982,2,0
0,0,11,11,15,19,34,82,42,124,0.000333,0.210282,14,8831.835492,490.657527,630.845392,139.313982,2,0
0,0,6,6,15,8,23,33,19,52,0.000333,0.078408,14,3293.153104,182.95295,235.225222,82.603359,3,0
0,0,4,4,12,10,22,28,13,41,0.000333,0.060946,6,1097.020178,60.945565,182.836696,76.238831,2,0
0,0,12,12,16,20,36,84,41,125,0.000333,0.215414,16,10339.85,574.436111,646.240625,150.438562,5,0
0,0,9,9,15,19,34,68,35,103,0.000333,0.17467,7,3668.060709,203.78115,524.008673,139.313982,2,0
0,0,18,18,13,28,41,86,54,140,0.000333,0.250019,6,4500.343684,250.019094,750.057281,182.711654,4,0
0,0,19,19,16,25,41,75,49,124,0.000333,0.221445,8,5314.691589,295.260644,664.336449,180.096405,6,0
0,0,28,28,18,36,54,140,81,221,0.000333,0.423943,18,22892.94248,1271.830138,1271.830138,261.17595,11,0
0,0,9,9,15,19,34,68,35,103,0.000333,0.17467,7,3668.060709,203.78115,524.008673,139.313982,2,0
0,0,11,11,15,19,34,82,42,124,0.000333,0.210282,14,8831.835492,490.657527,630.845392,139.313982,2,0
0,0,9,9,11,15,26,61,30,91,0.000333,0.14258,10,4277.400144,237.633341,427.740014,96.657107,4,0
0,0,12,12,10,20,30,59,39,98,0.000333,0.160292,5,2404.376392,133.576466,480.875278,119.657843,1,0
0,0,5,5,7,11,18,30,19,49,0.000333,0.068109,3,612.978975,34.054388,204.326325,57.705232,1,0
0,0,28,28,18,37,55,136,80,216,0.000333,0.416258,18,22477.92657,1248.773698,1248.773698,267.808425,11,0
0,0,11,11,15,19,34,82,42,124,0.000333,0.210282,14,8831.835492,490.657527,630.845392,139.313982,2,0
0,0,9,9,15,19,34,68,35,103,0.000333,0.17467,7,3668.060709,203.78115,524.008673,139.313982,2,0
0,0,3,3,10,8,18,24,11,35,0.000333,0.048649,5,729.736875,40.540938,145.947375,57.219281,1,0
0,0,13,13,16,22,38,89,44,133,0.000333,0.232658,16,11167.58975,620.421653,697.974359,162.107496,5,0
0,0,11,11,15,19,34,82,42,124,0.000333,0.210282,14,8831.835492,490.657527,630.845392,139.313982,2,0
0,0,9,9,15,19,34,68,35,103,0.000333,0.17467,7,3668.060709,203.78115,524.008673,139.313982,2,0
0,0,28,28,18,37,55,136,80,216,0.000333,0.416258,18,22477.92657,1248.773698,1248.773698,267.808425,11,0
0,0,19,19,16,26,42,76,50,126,0.000333,0.226477,8,5435.455962,301.969776,679.431995,186.211433,7,0
0,0,11,11,15,19,34,82,42,124,0.000333,0.210282,14,8831.835492,490.657527,630.845392,139.313982,2,0
0,0,9,9,15,19,34,68,35,103,0.000333,0.17467,7,3668.060709,203.78115,524.008673,139.313982,2,0
0,0,12,12,16,20,36,84,41,125,0.000333,0.215414,16,10339.85,574.436111,646.240625,150.438562,5,0
0,0,9,9,15,19,34,68,35,103,0.000333,0.17467,7,3668.060709,203.78115,524.008673,139.313982,2,0
0,0,11,11,15,19,34,82,42,124,0.000333,0.210282,14,8831.835492,490.657527,630.845392,139.313982,2,0
0,0,28,28,18,37,55,136,80,216,0.000333,0.416258,18,22477.92657,1248.773698,1248.773698,267.808425,11,0
0,0,19,19,16,26,42,76,50,126,0.000333,0.226477,8,5435.455962,301.969776,679.431995,186.211433,7,0
0,0,9,9,15,19,34,68,35,103,0.000333,0.17467,7,3668.060709,203.78115,524.008673,139.313982,2,0
0,0,11,11,15,19,34,82,42,124,0.000333,0.210282,14,8831.835492,490.657527,630.845392,139.313982,2,0
0,0,28,28,18,37,55,136,80,216,0.000333,0.416258,18,22477.92657,1248.773698,1248.773698,267.808425,11,0
0,0,7,7,13,12,25,37,23,60,0.000333,0.092877,6,1671.788228,92.877124,278.631371,91.125266,3,0
0,0,19,19,16,26,42,76,50,126,0.000333,0.226477,8,5435.455962,301.969776,679.431995,186.211433,7,0
0,0,9,9,15,19,34,68,35,103,0.000333,0.17467,7,3668.060709,203.78115,524.008673,139.313982,2,0
0,0,19,19,14,28,42,91,55,146,0.000333,0.262426,7,5510.948406,306.1638,787.278344,187.908907,2,0
0,0,11,11,15,19,34,82,42,124,0.000333,0.210282,14,8831.835492,490.657527,630.845392,139.313982,2,0
0,0,9,9,12,16,28,59,33,92,0.000333,0.147426,12,5307.319834,294.851102,442.276653,107.01955,3,0
0,0,5,5,7,11,18,30,19,49,0.000333,0.068109,3,612.978975,34.054388,204.326325,57.705232,1,0
0,0,19,19,16,26,42,76,50,126,0.000333,0.226477,8,5435.455962,301.969776,679.431995,186.211433,6,0
0,0,4,4,12,10,22,32,15,47,0.000333,0.069864,6,1257.559716,69.864429,209.593286,76.238831,2,0
0,0,27,27,18,33,51,130,75,205,0.000333,0.387616,18,20931.24951,1162.847195,1162.847195,241.523656,10,0
0,0,11,11,15,19,34,82,42,124,0.000333,0.210282,14,8831.835492,490.657527,630.845392,139.313982,2,0
0,0,9,9,15,19,34,68,35,103,0.000333,0.17467,7,3668.060709,203.78115,524.008673,139.313982,2,0
0,0,19,19,16,26,42,76,50,126,0.000333,0.226477,8,5435.455962,301.969776,679.431995,186.211433,6,0
0,0,27,27,18,33,51,130,75,205,0.000333,0.387616,18,20931.24951,1162.847195,1162.847195,241.523656,10,0
0,0,9,9,15,19,34,68,35,103,0.000333,0.17467,7,3668.060709,203.78115,524.008673,139.313982,2,0
0,0,11,11,15,19,34,82,42,124,0.000333,0.210282,14,8831.835492,490.657527,630.845392,139.313982,2,0
0,0,27,27,18,33,51,130,75,205,0.000333,0.387616,18,20931.24951,1162.847195,1162.847195,241.523656,10,0
0,0,19,19,16,26,42,76,50,126,0.000333,0.226477,8,5435.455962,301.969776,679.431995,186.211433,6,0
0,0,4,4,12,10,22,32,15,47,0.000333,0.069864,6,1257.559716,69.864429,209.593286,76.238831,2,0
0,0,9,9,15,19,34,68,35,103,0.000333,0.17467,7,3668.060709,203.78115,524.008673,139.313982,2,0
0,0,11,11,15,19,34,82,42,124,0.000333,0.210282,14,8831.835492,490.657527,630.845392,139.313982,2,0
0,0,19,19,16,26,42,76,50,126,0.000333,0.226477,8,5435.455962,301.969776,679.431995,186.211433,6,0
0,0,27,27,18,33,51,130,75,205,0.000333,0.387616,18,20931.24951,1162.847195,1162.847195,241.523656,10,0
0,0,11,11,15,19,34,82,42,124,0.000333,0.210282,14,8831.835492,490.657527,630.845392,139.313982,2,0
0,0,11,11,12,22,34,74,43,117,0.000333,0.198411,6,3571.398915,198.411051,595.233152,141.127046,2,0
0,0,9,9,15,19,34,68,35,103,0.000333,0.17467,7,3668.060709,203.78115,524.008673,139.313982,2,0
0,0,7,7,13,12,25,37,23,60,0.000333,0.092877,6,1671.788228,92.877124,278.631371,91.125266,3,0
0,0,19,19,16,26,42,76,50,126,0.000333,0.226477,8,5435.455962,301.969776,679.431995,186.211433,6,0
0,0,27,27,18,33,51,130,75,205,0.000333,0.387616,18,20931.24951,1162.847195,1162.847195,241.523656,10,0
0,0,11,11,15,19,34,82,42,124,0.000333,0.210282,14,8831.835492,490.657527,630.845392,139.313982,2,0
0,0,9,9,15,19,34,68,35,103,0.000333,0.17467,7,3668.060709,203.78115,524.008673,139.313982,2,0
0,0,18,18,13,28,41,98,54,152,0.000333,0.271449,6,4886.087428,271.449302,814.347905,182.711654,3,0
0,0,19,19,16,26,42,76,50,126,0.000333,0.226477,8,5435.455962,301.969776,679.431995,186.211433,6,0
0,0,27,27,18,33,51,130,75,205,0.000333,0.387616,18,20931.24951,1162.847195,1162.847195,241.523656,10,0
0,0,9,9,15,19,34,68,35,103,0.000333,0.17467,7,3668.060709,203.78115,524.008673,139.313982,2,0
0,0,11,11,15,19,34,82,42,124,0.000333,0.210282,14,8831.835492,490.657527,630.845392,139.313982,2,0
0,0,4,4,12,10,22,32,15,47,0.000333,0.069864,6,1257.559716,69.864429,209.593286,76.238831,2,0
0,0,27,27,18,33,51,130,75,205,0.000333,0.387616,18,20931.24951,1162.847195,1162.847195,241.523656,10,0
0,0,19,19,16,26,42,76,50,126,0.000333,0.226477,8,5435.455962,301.969776,679.431995,186.211433,6,0
0,0,11,11,15,19,34,82,42,124,0.000333,0.210282,14,8831.835492,490.657527,630.845392,139.313982,2,0
0,0,11,11,14,21,35,71,41,112,0.000333,0.191493,7,4021.357885,223.408771,574.479698,145.541635,2,0
0,0,9,9,15,19,34,68,35,103,0.000333,0.17467,7,3668.060709,203.78115,524.008673,139.313982,2,0
0,0,27,27,18,33,51,130,75,205,0.000333,0.387616,18,20931.24951,1162.847195,1162.847195,241.523656,10,0
0,0,19,19,16,26,42,76,50,126,0.000333,0.226477,8,5435.455962,301.969776,679.431995,186.211433,6,0
0,0,18,18,14,28,42,98,60,158,0.000333,0.283995,14,11927.80614,662.655897,851.986153,187.908907,1,0
0,0,11,11,15,19,34,82,42,124,0.000333,0.210282,14,8831.835492,490.657527,630.845392,139.313982,2,0
0,0,9,9,15,19,34,68,35,103,0.000333,0.17467,7,3668.060709,203.78115,524.008673,139.313982,2,0
0,0,12,12,16,20,36,84,41,125,0.000333,0.215414,16,10339.85,574.436111,646.240625,150.438562,5,0
0,0,9,9,15,19,34,68,35,103,0.000333,0.17467,7,3668.060709,203.78115,524.008673,139.313982,2,0
0,0,9,9,15,18,33,70,35,105,0.000333,0.176554,7,3707.629678,205.979427,529.661383,133.662009,2,0
0,0,19,19,16,26,42,76,50,126,0.000333,0.226477,8,5435.455962,301.969776,679.431995,186.211433,6,0
0,0,27,27,18,33,51,130,75,205,0.000333,0.387616,18,20931.24951,1162.847195,1162.847195,241.523656,10,0
0,0,10,10,15,18,33,78,40,118,0.000333,0.198413,14,8333.339085,462.963283,595.238506,133.662009,2,0
0,0,9,9,15,19,34,68,35,103,0.000333,0.17467,7,3668.060709,203.78115,524.008673,139.313982,2,0
0,0,19,19,16,26,42,76,50,126,0.000333,0.226477,8,5435.455962,301.969776,679.431995,186.211433,6,0
0,0,27,27,18,33,51,130,75,205,0.000333,0.387616,18,20931.24951,1162.847195,1162.847195,241.523656,10,0
0,0,7,7,13,12,25,37,23,60,0.000333,0.092877,6,1671.788228,92.877124,278.631371,91.125266,3,0
0,0,11,11,15,19,34,82,42,124,0.000333,0.210282,14,8831.835492,490.657527,630.845392,139.313982,2,0
0,0,4,4,10,15,25,32,21,53,0.000333,0.082041,5,1230.62189,68.367883,246.124378,91.82264,1,0
0,0,9,9,12,18,30,58,35,93,0.000333,0.152114,6,2738.044952,152.113608,456.340825,118.0782,2,0
0,0,25,25,12,35,47,382,213,595,0.000333,1.10166,36,118979.2932,6609.960733,3304.980367,222.544456,4,0
0,0,9,9,15,19,34,68,35,103,0.000333,0.17467,7,3668.060709,203.78115,524.008673,139.313982,2,0
0,0,19,19,16,26,42,76,50,126,0.000333,0.226477,8,5435.455962,301.969776,679.431995,186.211433,6,0
0,0,27,27,18,33,51,130,75,205,0.000333,0.387616,18,20931.24951,1162.847195,1162.847195,241.523656,10,0
0,0,11,11,15,19,34,82,42,124,0.000333,0.210282,14,8831.835492,490.657527,630.845392,139.313982,2,0
0,0,9,9,15,19,34,68,35,103,0.000333,0.17467,7,3668.060709,203.78115,524.008673,139.313982,2,0
0,0,12,12,16,20,36,84,41,125,0.000333,0.215414,16,10339.85,574.436111,646.240625,150.438562,5,0
0,0,11,11,15,19,34,82,42,124,0.000333,0.210282,14,8831.835492,490.657527,630.845392,139.313982,2,0
0,0,9,9,15,19,34,68,35,103,0.000333,0.17467,7,3668.060709,203.78115,524.008673,139.313982,2,0
0,0,27,27,18,33,51,130,75,205,0.000333,0.387616,18,20931.24951,1162.847195,1162.847195,241.523656,10,0
0,0,19,19,16,26,42,76,50,126,0.000333,0.226477,8,5435.455962,301.969776,679.431995,186.211433,6,0
0,0,9,9,15,19,34,68,35,103,0.000333,0.17467,7,3668.060709,203.78115,524.008673,139.313982,2,0
0,0,11,11,15,19,34,82,42,124,0.000333,0.210282,14,8831.835492,490.657527,630.845392,139.313982,2,0
0,0,4,4,10,15,25,32,21,53,0.000333,0.082041,5,1230.62189,68.367883,246.124378,91.82264,1,0
0,0,25,25,12,35,47,382,213,595,0.000333,1.10166,36,118979.2932,6609.960733,3304.980367,222.544456,4,0
0,0,4,4,10,8,18,30,15,45,0.000333,0.062549,5,938.233125,52.124063,187.646625,57.219281,2,0
0,0,5,5,7,11,18,30,19,49,0.000333,0.068109,3,612.978975,34.054388,204.326325,57.705232,1,0
0,0,7,7,13,12,25,37,23,60,0.000333,0.092877,6,1671.788228,92.877124,278.631371,91.125266,3,0
0,0,12,12,16,20,36,84,41,125,0.000333,0.215414,16,10339.85,574.436111,646.240625,150.438562,5,0
0,0,11,11,15,19,34,82,42,124,0.000333,0.210282,14,8831.835492,490.657527,630.845392,139.313982,2,0
0,0,16,16,14,24,38,84,48,132,0.000333,0.230909,14,9698.170045,538.787225,692.726432,163.342069,6,0
0,0,9,9,15,19,34,68,35,103,0.000333,0.17467,7,3668.060709,203.78115,524.008673,139.313982,2,0
0,0,6,6,7,11,18,32,21,53,0.000333,0.073669,3,663.018075,36.834338,221.006025,57.705232,1,0
0,0,7,7,13,12,25,37,23,60,0.000333,0.092877,6,1671.788228,92.877124,278.631371,91.125266,3,0
0,0,12,12,16,20,36,84,41,125,0.000333,0.215414,16,10339.85,574.436111,646.240625,150.438562,5,0
0,0,18,18,16,27,43,90,53,143,0.000333,0.258652,8,6207.646879,344.869271,775.95586,192.381963,3,0
0,0,11,11,15,19,34,82,42,124,0.000333,0.210282,14,8831.835492,490.657527,630.845392,139.313982,2,0
0,0,9,9,15,19,34,68,35,103,0.000333,0.17467,7,3668.060709,203.78115,524.008673,139.313982,2,0
0,0,19,19,16,26,42,76,50,126,0.000333,0.226477,8,5435.455962,301.969776,679.431995,186.211433,6,0
0,0,27,27,18,33,51,130,75,205,0.000333,0.387616,18,20931.24951,1162.847195,1162.847195,241.523656,10,0
0,0,9,9,15,19,34,68,35,103,0.000333,0.17467,7,3668.060709,203.78115,524.008673,139.313982,2,0
0,0,11,11,15,19,34,82,42,124,0.000333,0.210282,14,8831.835492,490.657527,630.845392,139.313982,2,0
0,0,12,12,16,20,36,84,41,125,0.000333,0.215414,16,10339.85,574.436111,646.240625,150.438562,5,0
0,0,7,7,13,12,25,37,23,60,0.000333,0.092877,6,1671.788228,92.877124,278.631371,91.125266,3,0
0,0,11,11,15,19,34,82,42,124,0.000333,0.210282,14,8831.835492,490.657527,630.845392,139.313982,2,0
0,0,9,9,15,19,34,68,35,103,0.000333,0.17467,7,3668.060709,203.78115,524.008673,139.313982,2,0
0,0,18,18,13,28,41,98,54,152,0.000333,0.271449,6,4886.087428,271.449302,814.347905,182.711654,3,0
0,0,12,12,16,20,36,84,41,125,0.000333,0.215414,16,10339.85,574.436111,646.240625,150.438562,5,0
0,0,9,9,15,19,34,68,35,103,0.000333,0.17467,7,3668.060709,203.78115,524.008673,139.313982,2,0
0,0,11,11,15,19,34,82,42,124,0.000333,0.210282,14,8831.835492,490.657527,630.845392,139.313982,2,0
0,0,12,12,16,20,36,84,41,125,0.000333,0.215414,16,10339.85,574.436111,646.240625,150.438562,5,0
0,0,9,9,15,19,34,68,35,103,0.000333,0.17467,7,3668.060709,203.78115,524.008673,139.313982,2,0
0,0,11,11,15,19,34,82,42,124,0.000333,0.210282,14,8831.835492,490.657527,630.845392,139.313982,2,0
0,0,27,27,18,33,51,130,75,205,0.000333,0.387616,18,20931.24951,1162.847195,1162.847195,241.523656,10,0
0,0,19,19,16,26,42,76,50,126,0.000333,0.226477,8,5435.455962,301.969776,679.431995,186.211433,6,0
0,0,12,12,14,23,37,75,45,120,0.000333,0.208378,7,4375.940827,243.107824,625.134404,157.344894,4,0
0,0,9,9,15,19,34,68,35,103,0.000333,0.17467,7,3668.060709,203.78115,524.008673,139.313982,2,0
0,0,11,11,15,19,34,82,42,124,0.000333,0.210282,14,8831.835492,490.657527,630.845392,139.313982,2,0
0,0,4,4,12,10,22,32,15,47,0.000333,0.069864,6,1257.559716,69.864429,209.593286,76.238831,2,0
0,0,27,27,18,33,51,130,75,205,0.000333,0.387616,18,20931.24951,1162.847195,1162.847195,241.523656,10,0
0,0,19,19,16,26,42,76,50,126,0.000333,0.226477,8,5435.455962,301.969776,679.431995,186.211433,6,0
0,0,9,9,15,19,34,68,35,103,0.000333,0.17467,7,3668.060709,203.78115,524.008673,139.313982,2,0
0,0,11,11,15,19,34,82,42,124,0.000333,0.210282,14,8831.835492,490.657527,630.845392,139.313982,2,0
0,0,19,19,16,26,42,76,50,126,0.000333,0.226477,8,5435.455962,301.969776,679.431995,186.211433,6,0
0,0,27,27,18,33,51,130,75,205,0.000333,0.387616,18,20931.24951,1162.847195,1162.847195,241.523656,10,0
0,0,9,9,15,19,34,68,35,103,0.000333,0.17467,7,3668.060709,203.78115,524.008673,139.313982,2,0
0,0,11,11,15,19,34,82,42,124,0.000333,0.210282,14,8831.835492,490.657527,630.845392,139.313982,2,0
0,0,11,11,10,18,28,57,36,93,0.000333,0.149028,10,4470.840078,248.380004,447.084008,108.277931,3,0
0,0,19,19,16,26,42,76,50,126,0.000333,0.226477,8,5435.455962,301.969776,679.431995,186.211433,6,0
0,0,27,27,18,33,51,130,75,205,0.000333,0.387616,18,20931.24951,1162.847195,1162.847195,241.523656,10,0
0,0,9,9,15,18,33,70,35,105,0.000333,0.176554,7,3707.629678,205.979427,529.661383,133.662009,2,0
0,0,9,9,15,19,34,68,35,103,0.000333,0.17467,7,3668.060709,203.78115,524.008673,139.313982,2,0
0,0,9,9,14,16,30,57,32,89,0.000333,0.145571,14,6113.985682,339.665871,436.713263,117.302969,4,0
0,0,4,4,12,10,22,32,15,47,0.000333,0.069864,6,1257.559716,69.864429,209.593286,76.238831,2,0
0,0,5,5,7,11,18,30,19,49,0.000333,0.068109,3,612.978975,34.054388,204.326325,57.705232,1,0
0,0,12,12,16,20,36,84,41,125,0.000333,0.215414,16,10339.85,574.436111,646.240625,150.438562,5,0
0,0,11,11,15,19,34,82,42,124,0.000333,0.210282,14,8831.835492,490.657527,630.845392,139.313982,2,0
0,0,9,9,15,19,34,68,35,103,0.000333,0.17467,7,3668.060709,203.78115,524.008673,139.313982,2,0
0,0,19,19,16,26,42,76,50,126,0.000333,0.226477,8,5435.455962,301.969776,679.431995,186.211433,6,0
0,0,27,27,18,33,51,130,75,205,0.000333,0.387616,18,20931.24951,1162.847195,1162.847195,241.523656,10,0
0,0,11,11,15,19,34,82,42,124,0.000333,0.210282,14,8831.835492,490.657527,630.845392,139.313982,2,0
0,0,9,9,15,19,34,68,35,103,0.000333,0.17467,7,3668.060709,203.78115,524.008673,139.313982,2,0
0,0,19,19,16,26,42,76,50,126,0.000333,0.226477,8,5435.455962,301.969776,679.431995,186.211433,6,0
0,0,27,27,18,33,51,130,75,205,0.000333,0.387616,18,20931.24951,1162.847195,1162.847195,241.523656,10,0
0,0,9,9,15,19,34,68,35,103,0.000333,0.17467,7,3668.060709,203.78115,524.008673,139.313982,2,0
0,0,19,19,16,26,42,76,50,126,0.000333,0.226477,8,5435.455962,301.969776,679.431995,186.211433,6,0
0,0,27,27,18,33,51,130,75,205,0.000333,0.387616,18,20931.24951,1162.847195,1162.847195,241.523656,10,0
0,0,11,11,15,19,34,82,42,124,0.000333,0.210282,14,8831.835492,490.657527,630.845392,139.313982,2,0
0,0,21,21,14,32,46,134,74,208,0.000333,0.382967,14,16084.61242,893.589579,1148.900887,213.302969,6,0
0,0,9,9,15,19,34,68,35,103,0.000333,0.17467,7,3668.060709,203.78115,524.008673,139.313982,2,0
0,0,12,12,16,20,36,84,41,125,0.000333,0.215414,16,10339.85,574.436111,646.240625,150.438562,5,0
0,0,4,4,12,10,22,32,15,47,0.000333,0.069864,6,1257.559716,69.864429,209.593286,76.238831,2,0
0,0,11,11,15,19,34,82,42,124,0.000333,0.210282,14,8831.835492,490.657527,630.845392,139.313982,2,0
0,0,9,9,15,19,34,68,35,103,0.000333,0.17467,7,3668.060709,203.78115,524.008673,139.313982,2,0
0,0,4,4,12,10,22,32,15,47,0.000333,0.069864,6,1257.559716,69.864429,209.593286,76.238831,2,0
0,0,10,10,16,20,36,77,41,118,0.000333,0.20335,16,9760.818403,542.267689,610.05115,150.438562,3,0
0,0,12,12,16,20,36,84,41,125,0.000333,0.215414,16,10339.85,574.436111,646.240625,150.438562,5,0
0,0,9,9,15,19,34,68,35,103,0.000333,0.17467,7,3668.060709,203.78115,524.008673,139.313982,2,0
0,0,11,11,15,19,34,82,42,124,0.000333,0.210282,14,8831.835492,490.657527,630.845392,139.313982,2,0
0,0,8,8,10,16,26,56,30,86,0.000333,0.134746,5,2021.189079,112.288282,404.237816,97.219281,5,0
0,0,16,16,13,26,39,104,59,163,0.000333,0.287174,12,10338.24674,574.347041,861.520562,170.317149,10,0
0,0,5,5,7,11,18,30,19,49,0.000333,0.068109,3,612.978975,34.054388,204.326325,57.705232,1,0
0,0,27,27,18,33,51,130,75,205,0.000333,0.387616,18,20931.24951,1162.847195,1162.847195,241.523656,10,0
0,0,19,19,16,26,42,76,50,126,0.000333,0.226477,8,5435.455962,301.969776,679.431995,186.211433,6,0
0,0,15,15,11,28,39,92,53,145,0.000333,0.255461,5,3831.916609,212.884256,766.383322,172.659686,1,0
0,0,11,11,15,19,34,82,42,124,0.000333,0.210282,14,8831.835492,490.657527,630.845392,139.313982,2,0
0,0,9,9,15,19,34,68,35,103,0.000333,0.17467,7,3668.060709,203.78115,524.008673,139.313982,2,0
0,0,12,12,16,20,36,84,41,125,0.000333,0.215414,16,10339.85,574.436111,646.240625,150.438562,5,0
0,0,9,9,15,19,34,68,35,103,0.000333,0.17467,7,3668.060709,203.78115,524.008673,139.313982,2,0
0,0,11,11,15,19,34,82,42,124,0.000333,0.210282,14,8831.835492,490.657527,630.845392,139.313982,2,0
0,0,7,7,13,12,25,37,23,60,0.000333,0.092877,6,1671.788228,92.877124,278.631371,91.125266,3,0
0,0,19,19,16,26,42,76,50,126,0.000333,0.226477,8,5435.455962,301.969776,679.431995,186.211433,6,0
0,0,27,27,18,33,51,130,75,205,0.000333,0.387616,18,20931.24951,1162.847195,1162.847195,241.523656,10,0
0,0,11,11,15,19,34,82,42,124,0.000333,0.210282,14,8831.835492,490.657527,630.845392,139.313982,2,0
0,0,9,9,15,19,34,68,35,103,0.000333,0.17467,7,3668.060709,203.78115,524.008673,139.313982,2,0
0,0,10,10,9,17,26,51,34,85,0.000333,0.133179,8,3196.299008,177.572167,399.537376,98.016193,3,0
0,0,12,12,16,20,36,84,41,125,0.000333,0.215414,16,10339.85,574.436111,646.240625,150.438562,5,0
0,0,9,9,15,19,34,68,35,103,0.000333,0.17467,7,3668.060709,203.78115,524.008673,139.313982,2,0
0,0,11,11,15,19,34,82,42,124,0.000333,0.210282,14,8831.835492,490.657527,630.845392,139.313982,2,0
0,0,12,12,10,20,30,71,42,113,0.000333,0.184826,10,5544.786373,308.043687,554.478637,119.657843,1,0
0,0,4,4,12,10,22,32,15,47,0.000333,0.069864,6,1257.559716,69.864429,209.593286,76.238831,2,0
0,0,5,5,7,11,18,30,19,49,0.000333,0.068109,3,612.978975,34.054388,204.326325,57.705232,1,0
0,0,8,8,7,14,21,43,28,71,0.000333,0.103952,6,1871.127222,103.951512,311.854537,72.954453,1,0
0,0,4,4,10,15,25,32,21,53,0.000333,0.082041,5,1230.62189,68.367883,246.124378,91.82264,1,0
0,0,27,27,18,33,51,130,75,205,0.000333,0.387616,18,20931.24951,1162.847195,1162.847195,241.523656,10,0
0,0,19,19,16,26,42,76,50,126,0.000333,0.226477,8,5435.455962,301.969776,679.431995,186.211433,6,0
0,0,9,9,15,19,34,68,35,103,0.000333,0.17467,7,3668.060709,203.78115,524.008673,139.313982,2,0
0,0,11,11,15,19,34,82,42,124,0.000333,0.210282,14,8831.835492,490.657527,630.845392,139.313982,2,0
0,0,7,7,13,12,25,37,23,60,0.000333,0.092877,6,1671.788228,92.877124,278.631371,91.125266,3,0
0,0,16,16,12,24,36,100,57,157,0.000333,0.270559,12,9740.138703,541.118817,811.678225,153.05865,2,0
0,0,10,10,7,18,25,58,36,94,0.000333,0.145507,6,2619.134891,145.507494,436.522482,94.710134,1,0
0,0,12,12,16,20,36,84,41,125,0.000333,0.215414,16,10339.85,574.436111,646.240625,150.438562,5,0
0,0,11,11,15,19,34,82,42,124,0.000333,0.210282,14,8831.835492,490.657527,630.845392,139.313982,2,0
0,0,9,9,15,19,34,68,35,103,0.000333,0.17467,7,3668.060709,203.78115,524.008673,139.313982,2,0
0,0,5,5,7,11,18,30,19,49,0.000333,0.068109,3,612.978975,34.054388,204.326325,57.705232,1,0
0,0,19,19,16,26,42,76,50,126,0.000333,0.226477,8,5435.455962,301.969776,679.431995,186.211433,6,0
0,0,27,27,18,33,51,130,75,205,0.000333,0.387616,18,20931.24951,1162.847195,1162.847195,241.523656,10,0
0,0,9,9,15,19,34,68,35,103,0.000333,0.17467,7,3668.060709,203.78115,524.008673,139.313982,2,0
0,0,11,11,15,19,34,82,42,124,0.000333,0.210282,14,8831.835492,490.657527,630.845392,139.313982,2,0
0,0,12,12,16,20,36,84,41,125,0.000333,0.215414,16,10339.85,574.436111,646.240625,150.438562,5,0
0,0,9,9,15,19,34,68,35,103,0.000333,0.17467,7,3668.060709,203.78115,524.008673,139.313982,2,0
0,0,11,11,15,19,34,82,42,124,0.000333,0.210282,14,8831.835492,490.657527,630.845392,139.313982,2,0
0,0,12,12,16,20,36,84,41,125,0.000333,0.215414,16,10339.85,574.436111,646.240625,150.438562,5,0
0,0,9,9,15,19,34,68,35,103,0.000333,0.17467,7,3668.060709,203.78115,524.008673,139.313982,2,0
0,0,11,11,15,19,34,82,42,124,0.000333,0.210282,14,8831.835492,490.657527,630.845392,139.313982,2,0
0,0,27,27,18,33,51,130,75,205,0.000333,0.387616,18,20931.24951,1162.847195,1162.847195,241.523656,10,0
0,0,19,19,16,26,42,76,50,126,0.000333,0.226477,8,5435.455962,301.969776,679.431995,186.211433,6,0
0,0,9,9,15,19,34,68,35,103,0.000333,0.17467,7,3668.060709,203.78115,524.008673,139.313982,2,0
0,0,11,11,15,19,34,82,42,124,0.000333,0.210282,14,8831.835492,490.657527,630.845392,139.313982,2,0
0,0,16,16,11,22,33,104,57,161,0.000333,0.270716,10,8121.474532,451.19303,812.147453,136.161243,2,0
0,0,19,19,16,26,42,76,50,126,0.000333,0.226477,8,5435.455962,301.969776,679.431995,186.211433,6,0
0,0,27,27,18,33,51,130,75,205,0.000333,0.387616,18,20931.24951,1162.847195,1162.847195,241.523656,10,0
0,0,4,4,10,15,25,32,21,53,0.000333,0.082041,5,1230.62189,68.367883,246.124378,91.82264,1,0
0,0,10,10,12,18,30,66,38,104,0.000333,0.170106,12,6123.799463,340.211081,510.316622,118.0782,2,0
0,0,9,9,15,19,34,68,35,103,0.000333,0.17467,7,3668.060709,203.78115,524.008673,139.313982,2,0
0,0,10,10,10,17,27,55,34,89,0.000333,0.141062,10,4231.849877,235.102771,423.184988,102.706149,1,0
0,0,9,9,15,19,34,68,35,103,0.000333,0.17467,7,3668.060709,203.78115,524.008673,139.313982,2,0
0,0,11,11,15,19,34,82,42,124,0.000333,0.210282,14,8831.835492,490.657527,630.845392,139.313982,2,0
0,0,12,12,16,20,36,84,41,125,0.000333,0.215414,16,10339.85,574.436111,646.240625,150.438562,5,0
0,0,9,9,15,19,34,68,35,103,0.000333,0.17467,7,3668.060709,203.78115,524.008673,139.313982,2,0
0,0,11,11,15,19,34,82,42,124,0.000333,0.210282,14,8831.835492,490.657527,630.845392,139.313982,2,0
0,0,19,19,16,26,42,76,50,126,0.000333,0.226477,8,5435.455962,301.969776,679.431995,186.211433,6,0
0,0,27,27,18,33,51,130,75,205,0.000333,0.387616,18,20931.24951,1162.847195,1162.847195,241.523656,10,0
0,0,9,9,15,19,34,68,35,103,0.000333,0.17467,7,3668.060709,203.78115,524.008673,139.313982,2,0
0,0,11,11,15,19,34,82,42,124,0.000333,0.210282,14,8831.835492,490.657527,630.845392,139.313982,2,0
0,0,12,12,15,22,37,76,46,122,0.000333,0.211851,14,8897.746348,494.319242,635.553311,156.710855,4,0
0,0,12,12,16,20,36,84,41,125,0.000333,0.215414,16,10339.85,574.436111,646.240625,150.438562,5,0
0,0,9,9,15,19,34,68,35,103,0.000333,0.17467,7,3668.060709,203.78115,524.008673,139.313982,2,0
0,0,11,11,15,19,34,82,42,124,0.000333,0.210282,14,8831.835492,490.657527,630.845392,139.313982,2,0
0,0,19,19,16,26,42,76,50,126,0.000333,0.226477,8,5435.455962,301.969776,679.431995,186.211433,6,0
0,0,27,27,18,33,51,130,75,205,0.000333,0.387616,18,20931.24951,1162.847195,1162.847195,241.523656,10,0
0,0,9,9,15,19,34,68,35,103,0.000333,0.17467,7,3668.060709,203.78115,524.008673,139.313982,2,0
0,0,11,11,15,19,34,82,42,124,0.000333,0.210282,14,8831.835492,490.657527,630.845392,139.313982,2,0
0,0,7,7,13,12,25,37,23,60,0.000333,0.092877,6,1671.788228,92.877124,278.631371,91.125266,3,0
0,0,27,27,18,33,51,130,75,205,0.000333,0.387616,18,20931.24951,1162.847195,1162.847195,241.523656,10,0
0,0,19,19,16,26,42,76,50,126,0.000333,0.226477,8,5435.455962,301.969776,679.431995,186.211433,6,0
0,0,18,18,13,28,41,98,54,152,0.000333,0.271449,6,4886.087428,271.449302,814.347905,182.711654,3,0
0,0,9,9,15,19,34,68,35,103,0.000333,0.17467,7,3668.060709,203.78115,524.008673,139.313982,2,0
0,0,11,11,15,19,34,82,42,124,0.000333,0.210282,14,8831.835492,490.657527,630.845392,139.313982,2,0
0,0,19,19,16,26,42,76,50,126,0.000333,0.226477,8,5435.455962,301.969776,679.431995,186.211433,6,0
0,0,9,9,15,19,34,68,35,103,0.000333,0.17467,7,3668.060709,203.78115,524.008673,139.313982,2,0
0,0,13,13,15,23,38,77,48,125,0.000333,0.218664,14,9183.873149,510.215175,655.990939,162.645284,10,0
0,0,11,11,15,19,34,82,42,124,0.000333,0.210282,14,8831.835492,490.657527,630.845392,139.313982,2,0
0,0,12,12,16,20,36,84,41,125,0.000333,0.215414,16,10339.85,574.436111,646.240625,150.438562,5,0
0,0,11,11,15,19,34,82,42,124,0.000333,0.210282,14,8831.835492,490.657527,630.845392,139.313982,2,0
0,0,9,9,15,19,34,68,35,103,0.000333,0.17467,7,3668.060709,203.78115,524.008673,139.313982,2,0
0,0,27,27,18,33,51,130,75,205,0.000333,0.387616,18,20931.24951,1162.847195,1162.847195,241.523656,10,0
0,0,19,19,16,26,42,76,50,126,0.000333,0.226477,8,5435.455962,301.969776,679.431995,186.211433,6,0
0,0,9,9,15,19,34,68,35,103,0.000333,0.17467,7,3668.060709,203.78115,524.008673,139.313982,2,0
0,0,4,4,10,15,25,32,21,53,0.000333,0.082041,5,1230.62189,68.367883,246.124378,91.82264,1,0
0,0,11,11,15,19,34,82,42,124,0.000333,0.210282,14,8831.835492,490.657527,630.845392,139.313982,2,0
0,0,19,19,16,26,42,76,50,126,0.000333,0.226477,8,5435.455962,301.969776,679.431995,186.211433,6,0
0,0,27,27,18,33,51,130,75,205,0.000333,0.387616,18,20931.24951,1162.847195,1162.847195,241.523656,10,0
0,0,11,11,15,19,34,82,42,124,0.000333,0.210282,14,8831.835492,490.657527,630.845392,139.313982,2,0
0,0,9,9,15,19,34,68,35,103,0.000333,0.17467,7,3668.060709,203.78115,524.008673,139.313982,2,0
0,0,12,12,16,20,36,84,41,125,0.000333,0.215414,16,10339.85,574.436111,646.240625,150.438562,5,0
0,0,9,9,15,19,34,68,35,103,0.000333,0.17467,7,3668.060709,203.78115,524.008673,139.313982,2,0
0,0,11,11,15,19,34,82,42,124,0.000333,0.210282,14,8831.835492,490.657527,630.845392,139.313982,2,0
0,0,4,4,12,10,22,32,15,47,0.000333,0.069864,6,1257.559716,69.864429,209.593286,76.238831,2,0
0,0,19,19,16,26,42,76,50,126,0.000333,0.226477,8,5435.455962,301.969776,679.431995,186.211433,6,0
0,0,27,27,18,33,51,130,75,205,0.000333,0.387616,18,20931.24951,1162.847195,1162.847195,241.523656,10,0
0,0,11,11,15,19,34,82,42,124,0.000333,0.210282,14,8831.835492,490.657527,630.845392,139.313982,2,0
0,0,9,9,15,19,34,68,35,103,0.000333,0.17467,7,3668.060709,203.78115,524.008673,139.313982,2,0
0,0,11,11,15,19,34,82,42,124,0.000333,0.210282,14,8831.835492,490.657527,630.845392,139.313982,2,0
0,0,9,9,15,19,34,68,35,103,0.000333,0.17467,7,3668.060709,203.78115,524.008673,139.313982,2,0
0,0,19,19,16,26,42,76,50,126,0.000333,0.226477,8,5435.455962,301.969776,679.431995,186.211433,6,0
0,0,27,27,18,33,51,130,75,205,0.000333,0.387616,18,20931.24951,1162.847195,1162.847195,241.523656,10,0
0,0,7,7,13,12,25,37,23,60,0.000333,0.092877,6,1671.788228,92.877124,278.631371,91.125266,3,0
0,0,9,9,15,19,34,68,35,103,0.000333,0.17467,7,3668.060709,203.78115,524.008673,139.313982,2,0
0,0,11,11,15,19,34,82,42,124,0.000333,0.210282,14,8831.835492,490.657527,630.845392,139.313982,2,0
0,0,19,19,16,26,42,76,50,126,0.000333,0.226477,8,5435.455962,301.969776,679.431995,186.211433,6,0
0,0,27,27,18,33,51,130,75,205,0.000333,0.387616,18,20931.24951,1162.847195,1162.847195,241.523656,10,0
0,0,11,11,15,19,34,82,42,124,0.000333,0.210282,14,8831.835492,490.657527,630.845392,139.313982,2,0
0,0,18,18,13,28,41,98,54,152,0.000333,0.271449,6,4886.087428,271.449302,814.347905,182.711654,3,0
0,0,9,9,15,19,34,68,35,103,0.000333,0.17467,7,3668.060709,203.78115,524.008673,139.313982,2,0
0,0,27,27,18,33,51,130,75,205,0.000333,0.387616,18,20931.24951,1162.847195,1162.847195,241.523656,10,0
0,0,19,19,16,26,42,76,50,126,0.000333,0.226477,8,5435.455962,301.969776,679.431995,186.211433,6,0
0,0,11,11,15,19,34,82,42,124,0.000333,0.210282,14,8831.835492,490.657527,630.845392,139.313982,2,0
0,0,9,9,15,19,34,68,35,103,0.000333,0.17467,7,3668.060709,203.78115,524.008673,139.313982,2,0
0,0,19,19,16,26,42,76,50,126,0.000333,0.226477,8,5435.455962,301.969776,679.431995,186.211433,6,0
0,0,27,27,18,33,51,130,75,205,0.000333,0.387616,18,20931.24951,1162.847195,1162.847195,241.523656,10,0
0,0,9,9,15,19,34,68,35,103,0.000333,0.17467,7,3668.060709,203.78115,524.008673,139.313982,2,0
0,0,11,11,15,19,34,82,42,124,0.000333,0.210282,14,8831.835492,490.657527,630.845392,139.313982,2,0
0,0,19,19,16,26,42,76,50,126,0.000333,0.226477,8,5435.455962,301.969776,679.431995,186.211433,6,0
1,0,40,41,19,43,62,234,126,360,0.000333,0.714504,18,38583.19209,2143.510672,2143.510672,314.040007,11,0
0,0,18,18,13,28,41,98,54,152,0.000333,0.271449,6,4886.087428,271.449302,814.347905,182.711654,3,0
0,0,9,9,15,19,34,68,35,103,0.000333,0.17467,7,3668.060709,203.78115,524.008673,139.313982,2,0
0,0,27,27,18,33,51,130,75,205,0.000333,0.387616,18,20931.24951,1162.847195,1162.847195,241.523656,10,0
0,0,19,19,16,26,42,76,50,126,0.000333,0.226477,8,5435.455962,301.969776,679.431995,186.211433,6,0
0,0,11,11,15,19,34,82,42,124,0.000333,0.210282,14,8831.835492,490.657527,630.845392,139.313982,2,0
0,0,9,9,15,19,34,68,35,103,0.000333,0.17467,7,3668.060709,203.78115,524.008673,139.313982,2,0
0,0,4,4,12,10,22,32,15,47,0.000333,0.069864,6,1257.559716,69.864429,209.593286,76.238831,2,0
0,0,11,11,15,19,34,82,42,124,0.000333,0.210282,14,8831.835492,490.657527,630.845392,139.313982,2,0
0,0,9,9,15,19,34,68,35,103,0.000333,0.17467,7,3668.060709,203.78115,524.008673,139.313982,2,0
0,0,19,19,16,26,42,76,50,126,0.000333,0.226477,8,5435.455962,301.969776,679.431995,186.211433,6,0
0,0,27,27,18,33,51,130,75,205,0.000333,0.387616,18,20931.24951,1162.847195,1162.847195,241.523656,10,0
0,0,11,11,15,19,34,82,42,124,0.000333,0.210282,14,8831.835492,490.657527,630.845392,139.313982,2,0
0,0,9,9,15,19,34,68,35,103,0.000333,0.17467,7,3668.060709,203.78115,524.008673,139.313982,2,0
0,0,19,19,16,26,42,76,50,126,0.000333,0.226477,8,5435.455962,301.969776,679.431995,186.211433,6,0
0,0,27,27,18,33,51,130,75,205,0.000333,0.387616,18,20931.24951,1162.847195,1162.847195,241.523656,10,0
0,0,9,9,15,19,34,68,35,103,0.000333,0.17467,7,3668.060709,203.78115,524.008673,139.313982,2,0
0,0,11,11,15,19,34,82,42,124,0.000333,0.210282,14,8831.835492,490.657527,630.845392,139.313982,2,0
0,0,19,19,16,26,42,76,50,126,0.000333,0.226477,8,5435.455962,301.969776,679.431995,186.211433,6,0
0,0,27,27,18,33,51,130,75,205,0.000333,0.387616,18,20931.24951,1162.847195,1162.847195,241.523656,10,0
0,0,19,19,16,26,42,76,50,126,0.000333,0.226477,8,5435.455962,301.969776,679.431995,186.211433,6,0
0,0,27,27,18,33,51,130,75,205,0.000333,0.387616,18,20931.24951,1162.847195,1162.847195,241.523656,10,0
0,0,9,9,15,19,34,68,35,103,0.000333,0.17467,7,3668.060709,203.78115,524.008673,139.313982,2,0
0,0,19,19,16,26,42,76,50,126,0.000333,0.226477,8,5435.455962,301.969776,679.431995,186.211433,6,0
0,0,4,4,12,10,22,32,15,47,0.000333,0.069864,6,1257.559716,69.864429,209.593286,76.238831,2,0
0,0,27,27,18,33,51,130,75,205,0.000333,0.387616,18,20931.24951,1162.847195,1162.847195,241.523656,10,0
0,0,9,9,15,19,34,68,35,103,0.000333,0.17467,7,3668.060709,203.78115,524.008673,139.313982,2,0
0,0,19,19,16,26,42,76,50,126,0.000333,0.226477,8,5435.455962,301.969776,679.431995,186.211433,6,0
0,0,27,27,18,33,51,130,75,205,0.000333,0.387616,18,20931.24951,1162.847195,1162.847195,241.523656,10,0
0,0,4,4,10,15,25,32,21,53,0.000333,0.082041,5,1230.62189,68.367883,246.124378,91.82264,1,0
0,0,9,9,15,18,33,70,35,105,0.000333,0.176554,7,3707.629678,205.979427,529.661383,133.662009,2,0
0,0,9,9,15,19,34,68,35,103,0.000333,0.17467,7,3668.060709,203.78115,524.008673,139.313982,2,0
0,0,27,27,18,33,51,130,75,205,0.000333,0.387616,18,20931.24951,1162.847195,1162.847195,241.523656,10,0
0,0,19,19,16,26,42,76,50,126,0.000333,0.226477,8,5435.455962,301.969776,679.431995,186.211433,6,0
0,0,9,9,15,19,34,68,35,103,0.000333,0.17467,7,3668.060709,203.78115,524.008673,139.313982,2,0
0,0,7,7,13,12,25,37,23,60,0.000333,0.092877,6,1671.788228,92.877124,278.631371,91.125266,3,0
0,0,12,12,16,20,36,84,41,125,0.000333,0.215414,16,10339.85,574.436111,646.240625,150.438562,5,0
0,0,18,18,13,28,41,98,54,152,0.000333,0.271449,6,4886.087428,271.449302,814.347905,182.711654,3,0
0,0,11,11,15,19,34,82,42,124,0.000333,0.210282,14,8831.835492,490.657527,630.845392,139.313982,2,0
0,0,9,9,15,19,34,68,35,103,0.000333,0.17467,7,3668.060709,203.78115,524.008673,139.313982,2,0
0,0,9,9,15,19,34,68,35,103,0.000333,0.17467,7,3668.060709,203.78115,524.008673,139.313982,2,0
0,0,4,4,12,10,22,32,15,47,0.000333,0.069864,6,1257.559716,69.864429,209.593286,76.238831,2,0
0,0,18,18,13,28,41,98,54,152,0.000333,0.271449,6,4886.087428,271.449302,814.347905,182.711654,3,0
0,0,18,18,13,28,41,98,54,152,0.000333,0.271449,6,4886.087428,271.449302,814.347905,182.711654,3,0
0,0,12,12,16,20,36,84,41,125,0.000333,0.215414,16,10339.85,574.436111,646.240625,150.438562,5,0
0,0,15,15,21,16,37,78,47,125,0.000333,0.217061,20,13023.63341,723.53519,651.181671,156.238666,6,0
0,0,20,20,23,21,44,97,65,162,0.000333,0.294809,33,29186.12143,1621.451191,884.427922,196.280591,8,0
0,0,19,19,21,21,42,94,65,159,0.000333,0.285793,30,25721.35411,1428.964117,857.37847,184.477332,8,0
0,0,20,20,22,23,45,96,73,169,0.000333,0.309374,33,30628.06472,1701.559151,928.123173,202.149421,8,0
0,0,19,19,20,23,43,93,73,166,0.000333,0.300253,30,27022.79848,1501.266582,900.759949,190.480487,8,0
0,0,17,17,20,17,37,88,54,142,0.000333,0.246581,30,22192.27134,1232.903963,739.742378,155.92543,7,0
0,0,18,18,20,17,37,96,59,155,0.000333,0.269155,30,24223.95815,1345.775453,807.465272,155.92543,6,0
1,0,18,19,19,16,35,94,55,149,0.000333,0.254754,27,20635.10558,1146.394754,764.26317,144.710623,6,0
1,0,12,13,18,16,34,63,39,102,0.000333,0.172974,18,9340.581777,518.92121,518.92121,139.05865,6,0
0,0,16,16,20,21,41,83,56,139,0.000333,0.248233,20,14893.99457,827.444143,744.699729,178.677228,6,0
0,0,15,15,20,18,38,82,53,135,0.000333,0.236157,20,14169.40429,787.189127,708.470214,161.497212,6,0
1,0,12,13,18,15,33,63,38,101,0.000333,0.169828,18,9170.708509,509.483806,509.483806,133.662009,6,0
0,0,12,12,13,11,24,62,37,99,0.000333,0.151304,18,8170.403176,453.911288,453.911288,86.159464,3,0
1,0,18,19,21,16,37,90,51,141,0.000333,0.244844,30,22035.98774,1224.221541,734.532925,156.238666,7,0
1,0,16,17,19,17,36,88,51,139,0.000333,0.23954,27,19402.72853,1077.929363,718.619575,150.197491,6,0
0,0,16,16,20,19,39,90,57,147,0.000333,0.258985,30,23308.62379,1294.923544,776.954126,167.149185,6,0
1,0,19,20,20,20,40,86,55,141,0.000333,0.250131,20,15007.83723,833.768735,750.391861,172.877124,7,0
0,0,19,19,21,23,44,89,64,153,0.000333,0.278431,20,16705.86075,928.103375,835.293038,196.280591,7,0
0,0,15,15,19,20,39,81,57,138,0.000333,0.243129,18,13128.93911,729.385506,729.385506,167.149185,6,0
0,0,17,17,19,21,40,87,69,156,0.000333,0.27674,27,22415.96114,1245.331174,830.220783,172.949289,6,0
0,0,19,19,19,22,41,93,81,174,0.000333,0.310738,27,25169.77932,1398.321073,932.214049,178.818118,6,0
0,0,21,21,19,23,42,99,93,192,0.000333,0.345108,36,37271.69803,2070.64989,1035.324945,184.752548,6,0
0,0,18,18,21,20,41,92,62,154,0.000333,0.275021,30,24751.89026,1375.105015,825.063009,178.677228,7,0
0,0,18,18,21,22,43,94,63,157,0.000333,0.283975,20,17038.47133,946.581741,851.923566,190.346161,7,0
0,0,17,17,20,22,42,96,64,160,0.000333,0.28759,20,17255.41575,958.634208,862.770788,184.546058,6,0
0,0,16,16,19,21,40,89,61,150,0.000333,0.266096,18,14369.20586,798.289214,798.289214,172.949289,6,0
1,0,16,17,18,19,37,87,55,142,0.000333,0.246581,18,13315.3628,739.742378,739.742378,155.769273,6,0
0,0,18,18,19,23,42,96,67,163,0.000333,0.292983,18,15821.05932,878.94774,878.94774,184.752548,6,0
0,0,18,18,20,23,43,88,70,158,0.000333,0.285783,30,25720.49494,1428.916385,857.349831,190.480487,6,0
0,0,17,17,19,20,39,82,62,144,0.000333,0.253699,27,20549.64383,1141.646879,761.09792,167.149185,6,0
0,0,16,16,23,23,46,88,64,152,0.000333,0.27986,22,18470.79118,1026.155066,839.581417,208.08385,6,0
0,0,16,16,22,23,45,87,64,151,0.000333,0.276423,22,18243.93599,1013.551999,829.269818,202.149421,6,0
0,0,9,9,16,16,32,51,34,85,0.000333,0.141667,16,6800,377.777778,425,128,3,0
0,0,11,11,19,16,35,57,35,92,0.000333,0.157298,18,8494.092676,471.894038,471.894038,144.710623,4,0
0,0,10,10,16,16,32,54,35,89,0.000333,0.148333,16,7120,395.555556,445,128,4,0
0,0,11,11,19,17,36,58,36,94,0.000333,0.161991,18,8747.513102,485.97295,485.97295,150.197491,4,0
0,0,10,10,16,17,33,54,36,90,0.000333,0.151332,16,7263.927532,403.55153,453.995471,133.486868,4,0
0,0,11,11,19,17,36,57,35,92,0.000333,0.158544,18,8561.395802,475.6331,475.6331,150.197491,4,0
0,0,10,10,16,17,33,54,35,89,0.000333,0.14965,16,7183.217226,399.067624,448.951077,133.486868,4,0
0,0,11,11,19,17,36,57,35,92,0.000333,0.158544,18,8561.395802,475.6331,475.6331,150.197491,4,0
0,0,10,10,16,17,33,54,35,89,0.000333,0.14965,16,7183.217226,399.067624,448.951077,133.486868,4,0
0,0,11,11,19,18,37,58,36,94,0.000333,0.16323,18,8814.395095,489.688616,489.688616,155.769273,4,0
0,0,10,10,16,18,34,54,36,90,0.000333,0.152624,16,7325.946491,406.997027,457.871656,139.05865,4,0
0,0,11,11,19,18,37,58,36,94,0.000333,0.16323,18,8814.395095,489.688616,489.688616,155.769273,4,0
0,0,10,10,16,18,34,54,36,90,0.000333,0.152624,16,7325.946491,406.997027,457.871656,139.05865,4,0
0,0,11,11,19,17,36,57,35,92,0.000333,0.158544,18,8561.395802,475.6331,475.6331,150.197491,4,0
0,0,10,10,16,17,33,54,35,89,0.000333,0.14965,16,7183.217226,399.067624,448.951077,133.486868,4,0
0,0,11,11,19,17,36,57,35,92,0.000333,0.158544,18,8561.395802,475.6331,475.6331,150.197491,4,0
0,0,10,10,16,17,33,54,35,89,0.000333,0.14965,16,7183.217226,399.067624,448.951077,133.486868,4,0
0,0,11,11,19,17,36,57,35,92,0.000333,0.158544,18,8561.395802,475.6331,475.6331,150.197491,4,0
0,0,10,10,16,17,33,54,35,89,0.000333,0.14965,16,7183.217226,399.067624,448.951077,133.486868,4,0
0,0,11,11,19,17,36,57,35,92,0.000333,0.158544,18,8561.395802,475.6331,475.6331,150.197491,4,0
0,0,10,10,16,17,33,54,35,89,0.000333,0.14965,16,7183.217226,399.067624,448.951077,133.486868,4,0
0,0,11,11,19,18,37,58,36,94,0.000333,0.16323,18,8814.395095,489.688616,489.688616,155.769273,4,0
0,0,10,10,16,18,34,54,36,90,0.000333,0.152624,16,7325.946491,406.997027,457.871656,139.05865,4,0
0,0,11,11,19,18,37,58,36,94,0.000333,0.16323,18,8814.395095,489.688616,489.688616,155.769273,4,0
0,0,10,10,16,18,34,54,36,90,0.000333,0.152624,16,7325.946491,406.997027,457.871656,139.05865,4,0
0,0,11,11,19,18,37,56,36,92,0.000333,0.159757,18,8626.854773,479.26971,479.26971,155.769273,4,0
0,0,11,11,19,17,36,56,36,92,0.000333,0.158544,18,8561.395802,475.6331,475.6331,150.197491,4,0
0,0,10,10,17,16,33,54,35,89,0.000333,0.14965,16,7183.217226,399.067624,448.951077,133.486868,4,0
0,0,10,10,16,17,33,59,39,98,0.000333,0.164784,16,7909.609979,439.422777,494.350624,133.486868,4,0
0,0,11,11,18,17,35,54,36,90,0.000333,0.153878,18,8309.438487,461.635472,461.635472,144.545518,3,0
0,0,12,12,17,22,39,60,48,108,0.000333,0.190274,16,9133.175034,507.398613,570.82344,167.594364,3,0
0,0,12,12,17,22,39,60,48,108,0.000333,0.190274,16,9133.175034,507.398613,570.82344,167.594364,3,0
0,0,8,8,13,20,33,40,39,79,0.000333,0.132836,6,2391.042813,132.835712,398.507135,134.544278,2,0
0,0,12,12,16,24,40,59,54,113,0.000333,0.200459,16,9622.045996,534.558111,601.377875,174.0391,3,0
0,0,8,8,13,15,28,40,31,71,0.000333,0.113774,12,4095.866394,227.548133,341.322199,106.709075,2,0
0,0,14,14,17,18,35,72,48,120,0.000333,0.205171,16,9848.223393,547.123522,615.513962,144.545518,3,0
0,0,12,12,17,22,39,59,45,104,0.000333,0.183227,16,8794.909292,488.606072,549.681831,167.594364,3,0
0,0,8,8,14,17,31,41,33,74,0.000333,0.122204,7,2566.273689,142.57076,366.610527,122.789837,2,0
0,0,14,14,15,16,31,68,52,120,0.000333,0.198168,21,12484.5747,693.587483,594.503557,122.603359,3,0
0,0,12,12,17,20,37,66,46,112,0.000333,0.194486,16,9335.340431,518.630024,583.458777,155.92543,3,0
0,0,15,15,18,24,42,65,53,118,0.000333,0.212098,18,11453.28221,636.293456,636.293456,185.09775,4,0
0,0,8,8,13,19,32,40,37,77,0.000333,0.128333,6,2310,128.333333,385,128.816339,2,0
0,0,13,13,16,22,38,63,58,121,0.000333,0.211666,16,10159.98767,564.443759,634.999229,162.107496,3,0
0,0,15,15,16,23,39,69,70,139,0.000333,0.24489,24,17632.1018,979.561211,734.670908,168.041925,3,0
0,0,17,17,16,24,40,75,82,157,0.000333,0.278514,24,20053.02506,1114.056948,835.542711,174.0391,3,0
0,0,15,15,14,18,32,71,64,135,0.000333,0.225,21,14175,787.5,675,128.361619,3,0
0,0,9,9,14,20,34,46,40,86,0.000333,0.145841,14,6125.305261,340.294737,437.521804,139.741531,2,0
0,0,10,10,14,21,35,55,44,99,0.000333,0.169266,14,7109.186261,394.954792,507.799019,145.541635,2,0
0,0,12,12,16,22,38,65,50,115,0.000333,0.201171,16,9656.186625,536.454812,603.511664,162.107496,3,0
0,0,10,10,13,21,34,51,44,95,0.000333,0.161103,12,5799.707639,322.20598,483.30897,140.344382,2,0
0,0,11,11,14,22,36,47,50,97,0.000333,0.167161,14,7020.758152,390.04212,501.482725,151.410465,2,0
0,0,9,9,13,19,32,40,38,78,0.000333,0.13,12,4680,260,390,128.816339,2,0
0,0,12,12,20,24,44,64,53,117,0.000333,0.212918,20,12775.06999,709.72611,638.753499,196.477662,3,0
0,0,12,12,19,24,43,63,53,116,0.000333,0.209816,18,11330.04081,629.446712,629.446712,190.749723,3,0
0,0,6,6,13,12,25,38,24,62,0.000333,0.095973,12,3455.029005,191.946056,287.919084,91.125266,3,0
0,0,15,15,20,19,39,76,44,120,0.000333,0.211416,20,12684.96533,704.720296,634.248266,167.149185,6,0
0,0,14,14,17,19,36,73,44,117,0.000333,0.201627,16,9678.099603,537.6722,604.881225,150.197491,6,0
0,0,15,15,20,20,40,77,45,122,0.000333,0.216425,20,12985.50455,721.41692,649.275228,172.877124,6,0
0,0,14,14,17,20,37,73,45,118,0.000333,0.204905,16,9835.447954,546.413775,614.715497,155.92543,6,0
0,0,15,15,20,20,40,76,44,120,0.000333,0.212877,20,12772.62743,709.590413,638.631371,172.877124,6,0
0,0,14,14,17,20,37,73,44,117,0.000333,0.203169,16,9752.0967,541.78315,609.506044,155.92543,6,0
0,0,14,14,17,20,37,73,44,117,0.000333,0.203169,16,9752.0967,541.78315,609.506044,155.92543,6,0
0,0,15,15,20,20,40,76,44,120,0.000333,0.212877,20,12772.62743,709.590413,638.631371,172.877124,6,0
0,0,15,15,20,21,41,77,45,122,0.000333,0.217874,20,13072.42689,726.245938,653.621345,178.677228,6,0
0,0,14,14,17,21,38,73,45,118,0.000333,0.206418,16,9908.087145,550.449286,619.255447,161.725534,6,0
0,0,15,15,20,21,41,77,45,122,0.000333,0.217874,20,13072.42689,726.245938,653.621345,178.677228,6,0
0,0,14,14,17,21,38,73,45,118,0.000333,0.206418,16,9908.087145,550.449286,619.255447,161.725534,6,0
0,0,15,15,20,20,40,76,44,120,0.000333,0.212877,20,12772.62743,709.590413,638.631371,172.877124,6,0
0,0,14,14,17,20,37,73,44,117,0.000333,0.203169,16,9752.0967,541.78315,609.506044,155.92543,6,0
0,0,15,15,20,20,40,76,44,120,0.000333,0.212877,20,12772.62743,709.590413,638.631371,172.877124,6,0
0,0,14,14,17,20,37,73,44,117,0.000333,0.203169,16,9752.0967,541.78315,609.506044,155.92543,6,0
0,0,15,15,20,20,40,76,44,120,0.000333,0.212877,20,12772.62743,709.590413,638.631371,172.877124,6,0
0,0,14,14,17,20,37,73,44,117,0.000333,0.203169,16,9752.0967,541.78315,609.506044,155.92543,6,0
0,0,15,15,20,20,40,76,44,120,0.000333,0.212877,20,12772.62743,709.590413,638.631371,172.877124,6,0
0,0,14,14,17,20,37,73,44,117,0.000333,0.203169,16,9752.0967,541.78315,609.506044,155.92543,6,0
0,0,15,15,20,21,41,77,45,122,0.000333,0.217874,20,13072.42689,726.245938,653.621345,178.677228,6,0
0,0,14,14,17,21,38,73,45,118,0.000333,0.206418,16,9908.087145,550.449286,619.255447,161.725534,6,0
0,0,15,15,20,21,41,77,45,122,0.000333,0.217874,20,13072.42689,726.245938,653.621345,178.677228,6,0
0,0,14,14,17,21,38,73,45,118,0.000333,0.206418,16,9908.087145,550.449286,619.255447,161.725534,6,0
0,0,15,15,20,21,41,75,45,120,0.000333,0.214302,20,12858.12481,714.340267,642.906241,178.677228,6,0
0,0,15,15,20,20,40,75,45,120,0.000333,0.212877,20,12772.62743,709.590413,638.631371,172.877124,6,0
0,0,6,6,13,12,25,38,24,62,0.000333,0.095973,12,3455.029005,191.946056,287.919084,91.125266,3,0
0,0,6,6,13,12,25,38,24,62,0.000333,0.095973,12,3455.029005,191.946056,287.919084,91.125266,3,0
0,0,6,6,13,12,25,38,24,62,0.000333,0.095973,12,3455.029005,191.946056,287.919084,91.125266,3,0
0,0,8,8,15,17,32,45,34,79,0.000333,0.131667,14,5530,307.222222,395,128.090227,3,0
0,0,8,8,15,17,32,45,34,79,0.000333,0.131667,14,5530,307.222222,395,128.090227,3,0
0,0,8,8,14,19,33,44,38,82,0.000333,0.13788,14,5790.964449,321.720247,413.640318,134.013592,3,0
0,0,16,16,17,26,43,78,63,141,0.000333,0.255034,16,12241.65329,680.091849,765.10333,191.698301,5,0
0,0,8,8,14,14,28,44,30,74,0.000333,0.118581,14,4980.419699,276.689983,355.744264,106.605938,3,0
0,0,4,4,9,7,16,22,14,36,0.000333,0.048,8,1152,64,144,48.180809,2,0
0,0,4,4,9,11,20,18,16,34,0.000333,0.048982,4,587.782221,32.654568,146.945555,66.583073,2,0
0,0,8,8,15,16,31,45,32,77,0.000333,0.127158,14,5340.623623,296.701312,381.473116,122.603359,3,0
0,0,18,18,20,22,42,88,56,144,0.000333,0.258831,20,15529.87418,862.770788,776.493709,184.546058,6,0
0,0,16,16,18,23,41,85,55,140,0.000333,0.250019,18,13501.03105,750.057281,750.057281,179.100575,5,0
0,0,9,9,14,19,33,44,37,81,0.000333,0.136199,7,2860.171466,158.898415,408.595924,134.013592,3,0
0,0,8,8,14,18,32,44,36,80,0.000333,0.133333,14,5600,311.111111,400,128.361619,3,0
0,0,17,17,17,25,42,82,67,149,0.000333,0.267818,16,12855.28474,714.182485,803.455296,185.583273,5,0
0,0,19,19,17,26,43,88,79,167,0.000333,0.302062,24,21748.46914,1208.248285,906.186214,191.698301,5,0
0,0,21,21,17,27,44,94,91,185,0.000333,0.336665,24,24239.87639,1346.659799,1009.994849,197.868831,5,0
0,0,18,18,19,24,43,87,60,147,0.000333,0.265887,18,14357.89654,797.660919,797.660919,190.749723,6,0
0,0,9,9,15,19,34,50,39,89,0.000333,0.150928,14,6338.9787,352.165483,452.784193,139.313982,3,0
0,0,10,10,15,20,35,59,43,102,0.000333,0.174396,14,7324.616148,406.923119,523.186868,145.041921,3,0
0,0,16,16,17,25,42,84,59,143,0.000333,0.257034,16,12337.62226,685.423459,771.101391,185.583273,5,0
0,0,10,10,14,20,34,55,43,98,0.000333,0.16619,14,6979.999018,387.777723,498.571358,139.741531,3,0
0,0,11,11,15,21,36,51,49,100,0.000333,0.172331,14,7237.895002,402.105278,516.9925,150.842025,3,0
0,0,9,9,14,18,32,44,37,81,0.000333,0.135,14,5670,315,405,128.361619,3,0
0,0,16,16,21,27,48,83,62,145,0.000333,0.26994,20,16196.39125,899.799514,809.819563,220.620628,5,0
0,0,16,16,20,27,47,82,62,144,0.000333,0.26662,20,15997.21589,888.734216,799.860795,214.820524,5,0
0,0,6,6,12,10,22,34,20,54,0.000333,0.08027,12,2889.711689,160.539538,240.809307,76.238831,2,0
0,0,7,7,13,11,24,37,21,58,0.000333,0.088643,6,1595.56695,88.642608,265.927825,86.159464,3,0
0,0,8,8,16,10,26,40,21,61,0.000333,0.095576,16,4587.629165,254.868287,286.726823,97.219281,3,0
0,0,8,8,17,11,28,41,22,63,0.000333,0.100954,16,4845.813761,269.211876,302.86336,107.540616,3,0
0,0,7,7,13,11,24,37,22,59,0.000333,0.090171,12,3246.153451,180.341858,270.512788,86.159464,3,0
0,0,7,7,13,11,24,37,21,58,0.000333,0.088643,6,1595.56695,88.642608,265.927825,86.159464,3,0
0,0,8,8,16,11,27,40,21,61,0.000333,0.096683,8,2320.385101,128.910283,290.048138,102.053748,3,0
0,0,8,8,16,11,27,40,21,61,0.000333,0.096683,8,2320.385101,128.910283,290.048138,102.053748,3,0
0,0,7,7,13,11,24,37,21,58,0.000333,0.088643,6,1595.56695,88.642608,265.927825,86.159464,3,0
0,0,8,8,17,12,29,41,22,63,0.000333,0.102018,8,2448.422422,136.023468,306.052803,112.506418,3,0
0,0,7,7,13,12,25,37,22,59,0.000333,0.091329,6,1643.925091,91.329172,273.987515,91.125266,3,0
0,0,8,8,17,12,29,41,22,63,0.000333,0.102018,8,2448.422422,136.023468,306.052803,112.506418,3,0
0,0,7,7,13,12,25,37,22,59,0.000333,0.091329,6,1643.925091,91.329172,273.987515,91.125266,3,0
0,0,8,8,16,11,27,40,21,61,0.000333,0.096683,8,2320.385101,128.910283,290.048138,102.053748,3,0
0,0,7,7,13,11,24,37,21,58,0.000333,0.088643,6,1595.56695,88.642608,265.927825,86.159464,3,0
0,0,8,8,16,11,27,40,21,61,0.000333,0.096683,8,2320.385101,128.910283,290.048138,102.053748,3,0
0,0,7,7,13,11,24,37,21,58,0.000333,0.088643,6,1595.56695,88.642608,265.927825,86.159464,3,0
0,0,7,7,13,11,24,37,21,58,0.000333,0.088643,6,1595.56695,88.642608,265.927825,86.159464,3,0
0,0,8,8,16,11,27,40,21,61,0.000333,0.096683,8,2320.385101,128.910283,290.048138,102.053748,3,0
0,0,8,8,16,11,27,40,21,61,0.000333,0.096683,8,2320.385101,128.910283,290.048138,102.053748,3,0
0,0,7,7,13,11,24,37,21,58,0.000333,0.088643,6,1595.56695,88.642608,265.927825,86.159464,3,0
0,0,8,8,17,12,29,41,22,63,0.000333,0.102018,8,2448.422422,136.023468,306.052803,112.506418,3,0
0,0,7,7,13,12,25,37,22,59,0.000333,0.091329,6,1643.925091,91.329172,273.987515,91.125266,3,0
0,0,7,7,13,12,25,37,22,59,0.000333,0.091329,6,1643.925091,91.329172,273.987515,91.125266,3,0
0,0,8,8,17,12,29,41,22,63,0.000333,0.102018,8,2448.422422,136.023468,306.052803,112.506418,3,0
0,0,11,11,17,14,31,47,24,71,0.000333,0.117249,8,2813.983504,156.332417,351.747938,122.789837,3,0
0,0,8,8,15,11,26,39,22,61,0.000333,0.095576,14,4014.175519,223.009751,286.726823,96.657107,3,0
0,0,7,7,13,11,24,37,21,58,0.000333,0.088643,6,1595.56695,88.642608,265.927825,86.159464,3,0
0,0,8,8,12,13,25,43,27,70,0.000333,0.108357,12,3900.839199,216.713289,325.069933,91.125266,3,0